PokerStars Home Game Hand #223924216250: {DaPokaStars}  Hold'em No Limit (50/100) - 2021/02/17 14:54:24 ET
Table 'tonight again' 9-max (Play Money) Seat #2 is the button
Seat 1: color_singleton (10000 in chips) 
Seat 2: manon327 (10000 in chips) 
Seat 9: dhduncan (10000 in chips) 
dhduncan: posts small blind 50
color_singleton: posts big blind 100
*** HOLE CARDS ***
Dealt to dhduncan [8d 8c]
manon327: calls 100
dhduncan: calls 50
color_singleton: checks 
*** FLOP *** [6c 9h 4h]
dhduncan: bets 141
color_singleton: folds 
manon327: raises 141 to 282
dhduncan: raises 141 to 423
manon327: calls 141
*** TURN *** [6c 9h 4h] [Tc]
dhduncan: checks 
manon327: bets 541
dhduncan: folds 
Uncalled bet (541) returned to manon327
manon327 collected 1083 from pot
*** SUMMARY ***
Total pot 1146 | Rake 63 
Board [6c 9h 4h Tc]
Seat 1: color_singleton (big blind) folded on the Flop
Seat 2: manon327 (button) collected (1083)
Seat 9: dhduncan (small blind) folded on the Turn



PokerStars Home Game Hand #223924240764: {DaPokaStars}  Hold'em No Limit (50/100) - 2021/02/17 14:55:00 ET
Table 'tonight again' 9-max (Play Money) Seat #9 is the button
Seat 1: color_singleton (9900 in chips) 
Seat 2: manon327 (10560 in chips) 
Seat 9: dhduncan (9477 in chips) 
color_singleton: posts small blind 50
manon327: posts big blind 100
*** HOLE CARDS ***
Dealt to dhduncan [9c 9h]
dhduncan: calls 100
color_singleton: calls 50
manon327: checks 
*** FLOP *** [5s 3c 6s]
color_singleton: bets 141
manon327: folds 
dhduncan: calls 141
*** TURN *** [5s 3c 6s] [Qs]
color_singleton: bets 550
dhduncan: calls 550
*** RIVER *** [5s 3c 6s Qs] [Ts]
color_singleton: checks 
dhduncan: checks 
*** SHOW DOWN ***
color_singleton: shows [4s 3s] (a flush, Queen high)
dhduncan: mucks hand 
color_singleton collected 1589 from pot
*** SUMMARY ***
Total pot 1682 | Rake 93 
Board [5s 3c 6s Qs Ts]
Seat 1: color_singleton (small blind) showed [4s 3s] and won (1589) with a flush, Queen high
Seat 2: manon327 (big blind) folded on the Flop
Seat 9: dhduncan (button) mucked [9c 9h]



PokerStars Home Game Hand #223924264282: {DaPokaStars}  Hold'em No Limit (50/100) - 2021/02/17 14:55:42 ET
Table 'tonight again' 9-max (Play Money) Seat #1 is the button
Seat 1: color_singleton (10698 in chips) 
Seat 2: manon327 (10460 in chips) 
Seat 9: dhduncan (8686 in chips) 
manon327: posts small blind 50
dhduncan: posts big blind 100
*** HOLE CARDS ***
Dealt to dhduncan [8c Jc]
color_singleton: folds 
manon327: calls 50
dhduncan: checks 
*** FLOP *** [3d Kd Tc]
manon327: checks 
dhduncan: checks 
*** TURN *** [3d Kd Tc] [3h]
manon327: checks 
dhduncan: checks 
*** RIVER *** [3d Kd Tc 3h] [4d]
manon327: checks 
dhduncan: checks 
*** SHOW DOWN ***
manon327: shows [4c Ad] (two pair, Fours and Threes)
dhduncan: mucks hand 
manon327 collected 189 from pot
*** SUMMARY ***
Total pot 200 | Rake 11 
Board [3d Kd Tc 3h 4d]
Seat 1: color_singleton (button) folded before Flop (didn't bet)
Seat 2: manon327 (small blind) showed [4c Ad] and won (189) with two pair, Fours and Threes
Seat 9: dhduncan (big blind) mucked [8c Jc]



PokerStars Home Game Hand #223924279107: {DaPokaStars}  Hold'em No Limit (50/100) - 2021/02/17 14:56:11 ET
Table 'tonight again' 9-max (Play Money) Seat #2 is the button
Seat 1: color_singleton (10698 in chips) 
Seat 2: manon327 (10549 in chips) 
Seat 9: dhduncan (8586 in chips) 
dhduncan: posts small blind 50
color_singleton: posts big blind 100
*** HOLE CARDS ***
Dealt to dhduncan [7h Qh]
manon327: calls 100
dhduncan: calls 50
color_singleton: checks 
*** FLOP *** [Ac Qd 5s]
dhduncan: checks 
color_singleton: checks 
manon327: bets 141
dhduncan: calls 141
color_singleton: folds 
*** TURN *** [Ac Qd 5s] [9s]
dhduncan: bets 100
manon327: raises 375 to 475
dhduncan: calls 375
*** RIVER *** [Ac Qd 5s 9s] [2d]
dhduncan: checks 
manon327: bets 724
dhduncan: calls 724
*** SHOW DOWN ***
manon327: shows [Ah 8d] (a pair of Aces)
dhduncan: mucks hand 
manon327 collected 2816 from pot
*** SUMMARY ***
Total pot 2980 | Rake 164 
Board [Ac Qd 5s 9s 2d]
Seat 1: color_singleton (big blind) folded on the Flop
Seat 2: manon327 (button) showed [Ah 8d] and won (2816) with a pair of Aces
Seat 9: dhduncan (small blind) mucked [7h Qh]



PokerStars Home Game Hand #223924302129: {DaPokaStars}  Hold'em No Limit (50/100) - 2021/02/17 14:56:55 ET
Table 'tonight again' 9-max (Play Money) Seat #9 is the button
Seat 1: color_singleton (10598 in chips) 
Seat 2: manon327 (11925 in chips) 
Seat 9: dhduncan (7146 in chips) 
color_singleton: posts small blind 50
manon327: posts big blind 100
*** HOLE CARDS ***
Dealt to dhduncan [Ad 4d]
dhduncan: calls 100
color_singleton: raises 200 to 300
manon327: folds 
dhduncan: calls 200
*** FLOP *** [7d 2c 3s]
color_singleton: checks 
dhduncan: checks 
*** TURN *** [7d 2c 3s] [Ac]
color_singleton: checks 
dhduncan: bets 100
color_singleton: calls 100
*** RIVER *** [7d 2c 3s Ac] [3d]
color_singleton: bets 500
dhduncan: calls 500
*** SHOW DOWN ***
color_singleton: shows [Jd Ah] (two pair, Aces and Threes)
dhduncan: mucks hand 
color_singleton collected 1795 from pot
*** SUMMARY ***
Total pot 1900 | Rake 105 
Board [7d 2c 3s Ac 3d]
Seat 1: color_singleton (small blind) showed [Jd Ah] and won (1795) with two pair, Aces and Threes
Seat 2: manon327 (big blind) folded before Flop
Seat 9: dhduncan (button) mucked [Ad 4d]



PokerStars Home Game Hand #223924321198: {DaPokaStars}  Hold'em No Limit (50/100) - 2021/02/17 14:57:26 ET
Table 'tonight again' 9-max (Play Money) Seat #1 is the button
Seat 1: color_singleton (11493 in chips) 
Seat 2: manon327 (11825 in chips) 
Seat 9: dhduncan (6246 in chips) 
manon327: posts small blind 50
dhduncan: posts big blind 100
*** HOLE CARDS ***
Dealt to dhduncan [As 4d]
color_singleton: folds 
manon327: folds 
Uncalled bet (50) returned to dhduncan
dhduncan collected 100 from pot
dhduncan: doesn't show hand 
*** SUMMARY ***
Total pot 100 | Rake 0 
Seat 1: color_singleton (button) folded before Flop (didn't bet)
Seat 2: manon327 (small blind) folded before Flop
Seat 9: dhduncan (big blind) collected (100)



PokerStars Home Game Hand #223924326567: {DaPokaStars}  Hold'em No Limit (50/100) - 2021/02/17 14:57:37 ET
Table 'tonight again' 9-max (Play Money) Seat #2 is the button
Seat 1: color_singleton (11493 in chips) 
Seat 2: manon327 (11775 in chips) 
Seat 9: dhduncan (6296 in chips) 
dhduncan: posts small blind 50
color_singleton: posts big blind 100
*** HOLE CARDS ***
Dealt to dhduncan [Ad 4d]
manon327: calls 100
dhduncan: calls 50
color_singleton: checks 
*** FLOP *** [Td Ah As]
dhduncan: checks 
color_singleton: bets 283
manon327: folds 
dhduncan: calls 283
*** TURN *** [Td Ah As] [9s]
dhduncan: checks 
color_singleton: checks 
*** RIVER *** [Td Ah As 9s] [5h]
dhduncan: bets 409
color_singleton: calls 409
*** SHOW DOWN ***
dhduncan: shows [Ad 4d] (three of a kind, Aces)
color_singleton: mucks hand 
dhduncan collected 1591 from pot
*** SUMMARY ***
Total pot 1684 | Rake 93 
Board [Td Ah As 9s 5h]
Seat 1: color_singleton (big blind) mucked [5d Ts]
Seat 2: manon327 (button) folded on the Flop
Seat 9: dhduncan (small blind) showed [Ad 4d] and won (1591) with three of a kind, Aces



PokerStars Home Game Hand #223924343818: {DaPokaStars}  Hold'em No Limit (50/100) - 2021/02/17 14:58:10 ET
Table 'tonight again' 9-max (Play Money) Seat #9 is the button
Seat 1: color_singleton (10701 in chips) 
Seat 2: manon327 (11675 in chips) 
Seat 9: dhduncan (7095 in chips) 
color_singleton: posts small blind 50
manon327: posts big blind 100
*** HOLE CARDS ***
Dealt to dhduncan [9d 6s]
dhduncan: folds 
color_singleton: raises 300 to 400
manon327: folds 
Uncalled bet (300) returned to color_singleton
color_singleton collected 200 from pot
color_singleton: doesn't show hand 
*** SUMMARY ***
Total pot 200 | Rake 0 
Seat 1: color_singleton (small blind) collected (200)
Seat 2: manon327 (big blind) folded before Flop
Seat 9: dhduncan (button) folded before Flop (didn't bet)



PokerStars Home Game Hand #223924348228: {DaPokaStars}  Hold'em No Limit (50/100) - 2021/02/17 14:58:18 ET
Table 'tonight again' 9-max (Play Money) Seat #1 is the button
Seat 1: color_singleton (10801 in chips) 
Seat 2: manon327 (11575 in chips) 
Seat 9: dhduncan (7095 in chips) 
manon327: posts small blind 50
dhduncan: posts big blind 100
*** HOLE CARDS ***
Dealt to dhduncan [Kc Ac]
color_singleton: raises 200 to 300
manon327: folds 
dhduncan: calls 200
*** FLOP *** [9h 8c 7c]
dhduncan: checks 
color_singleton: checks 
*** TURN *** [9h 8c 7c] [6c]
dhduncan: bets 100
color_singleton: raises 300 to 400
dhduncan: calls 300
*** RIVER *** [9h 8c 7c 6c] [4h]
dhduncan: checks 
color_singleton: checks 
*** SHOW DOWN ***
dhduncan: shows [Kc Ac] (a flush, Ace high)
color_singleton: mucks hand 
dhduncan collected 1370 from pot
*** SUMMARY ***
Total pot 1450 | Rake 80 
Board [9h 8c 7c 6c 4h]
Seat 1: color_singleton (button) mucked [5h Qh]
Seat 2: manon327 (small blind) folded before Flop
Seat 9: dhduncan (big blind) showed [Kc Ac] and won (1370) with a flush, Ace high



PokerStars Home Game Hand #223924365954: {DaPokaStars}  Hold'em No Limit (50/100) - 2021/02/17 14:58:50 ET
Table 'tonight again' 9-max (Play Money) Seat #2 is the button
Seat 1: color_singleton (10101 in chips) 
Seat 2: manon327 (11525 in chips) 
Seat 9: dhduncan (7765 in chips) 
dhduncan: posts small blind 50
color_singleton: posts big blind 100
*** HOLE CARDS ***
Dealt to dhduncan [5h Th]
manon327: calls 100
dhduncan: calls 50
color_singleton: checks 
*** FLOP *** [Jd Js 7d]
dhduncan: checks 
color_singleton: checks 
manon327: checks 
*** TURN *** [Jd Js 7d] [Jh]
dhduncan: checks 
color_singleton: checks 
manon327: checks 
*** RIVER *** [Jd Js 7d Jh] [9h]
dhduncan: checks 
color_singleton: checks 
manon327: checks 
*** SHOW DOWN ***
dhduncan: shows [5h Th] (three of a kind, Jacks)
color_singleton: mucks hand 
manon327: shows [2c Qc] (three of a kind, Jacks - Queen kicker)
manon327 collected 283 from pot
*** SUMMARY ***
Total pot 300 | Rake 17 
Board [Jd Js 7d Jh 9h]
Seat 1: color_singleton (big blind) mucked [4s 3c]
Seat 2: manon327 (button) showed [2c Qc] and won (283) with three of a kind, Jacks
Seat 9: dhduncan (small blind) showed [5h Th] and lost with three of a kind, Jacks



PokerStars Home Game Hand #223924382462: {DaPokaStars}  Hold'em No Limit (50/100) - 2021/02/17 14:59:22 ET
Table 'tonight again' 9-max (Play Money) Seat #9 is the button
Seat 1: color_singleton (10001 in chips) 
Seat 2: manon327 (11708 in chips) 
Seat 9: dhduncan (7665 in chips) 
color_singleton: posts small blind 50
manon327: posts big blind 100
*** HOLE CARDS ***
Dealt to dhduncan [As 2d]
dhduncan: raises 100 to 200
color_singleton: folds 
manon327: calls 100
*** FLOP *** [5d 9s 4h]
manon327: checks 
dhduncan: checks 
*** TURN *** [5d 9s 4h] [9d]
manon327: bets 100
dhduncan: calls 100
*** RIVER *** [5d 9s 4h 9d] [Kd]
manon327: checks 
dhduncan: checks 
*** SHOW DOWN ***
manon327: shows [9c 7c] (three of a kind, Nines)
dhduncan: mucks hand 
manon327 collected 614 from pot
*** SUMMARY ***
Total pot 650 | Rake 36 
Board [5d 9s 4h 9d Kd]
Seat 1: color_singleton (small blind) folded before Flop
Seat 2: manon327 (big blind) showed [9c 7c] and won (614) with three of a kind, Nines
Seat 9: dhduncan (button) mucked [As 2d]



PokerStars Home Game Hand #223924395518: {DaPokaStars}  Hold'em No Limit (50/100) - 2021/02/17 14:59:46 ET
Table 'tonight again' 9-max (Play Money) Seat #1 is the button
Seat 1: color_singleton (9951 in chips) 
Seat 2: manon327 (12022 in chips) 
Seat 9: dhduncan (7365 in chips) 
manon327: posts small blind 50
dhduncan: posts big blind 100
*** HOLE CARDS ***
Dealt to dhduncan [3h As]
color_singleton: raises 200 to 300
manon327: folds 
dhduncan: calls 200
*** FLOP *** [4s Ts Kd]
dhduncan: checks 
color_singleton: bets 307
dhduncan: folds 
Uncalled bet (307) returned to color_singleton
color_singleton collected 614 from pot
color_singleton: doesn't show hand 
*** SUMMARY ***
Total pot 650 | Rake 36 
Board [4s Ts Kd]
Seat 1: color_singleton (button) collected (614)
Seat 2: manon327 (small blind) folded before Flop
Seat 9: dhduncan (big blind) folded on the Flop



PokerStars Home Game Hand #223924409254: {DaPokaStars}  Hold'em No Limit (50/100) - 2021/02/17 15:00:12 ET
Table 'tonight again' 9-max (Play Money) Seat #2 is the button
Seat 1: color_singleton (10265 in chips) 
Seat 2: manon327 (11972 in chips) 
Seat 9: dhduncan (7065 in chips) 
dhduncan: posts small blind 50
color_singleton: posts big blind 100
*** HOLE CARDS ***
Dealt to dhduncan [2d 9d]
manon327: calls 100
dhduncan: calls 50
color_singleton: checks 
*** FLOP *** [Jc 6h 6s]
dhduncan: checks 
color_singleton: checks 
JeBoyDirk joins the table at seat #3 
manon327: checks 
*** TURN *** [Jc 6h 6s] [Jh]
dhduncan: checks 
color_singleton: bets 141
manon327: calls 141
dhduncan: folds 
*** RIVER *** [Jc 6h 6s Jh] [7d]
color_singleton: bets 550
manon327: folds 
Uncalled bet (550) returned to color_singleton
color_singleton collected 550 from pot
color_singleton: doesn't show hand 
*** SUMMARY ***
Total pot 582 | Rake 32 
Board [Jc 6h 6s Jh 7d]
Seat 1: color_singleton (big blind) collected (550)
Seat 2: manon327 (button) folded on the River
Seat 9: dhduncan (small blind) folded on the Turn



PokerStars Home Game Hand #223924430253: {DaPokaStars}  Hold'em No Limit (50/100) - 2021/02/17 15:00:51 ET
Table 'tonight again' 9-max (Play Money) Seat #9 is the button
Seat 1: color_singleton (10574 in chips) 
Seat 2: manon327 (11731 in chips) 
Seat 3: JeBoyDirk (10000 in chips) 
Seat 9: dhduncan (6965 in chips) 
color_singleton: posts small blind 50
manon327: posts big blind 100
JeBoyDirk: posts big blind 100
*** HOLE CARDS ***
Dealt to dhduncan [4c 9c]
JeBoyDirk: checks 
dhduncan: calls 100
color_singleton: calls 50
manon327: checks 
*** FLOP *** [3h 5d Ts]
color_singleton: bets 189
manon327: folds 
JeBoyDirk: folds 
dhduncan: folds 
Uncalled bet (189) returned to color_singleton
color_singleton collected 378 from pot
color_singleton: doesn't show hand 
*** SUMMARY ***
Total pot 400 | Rake 22 
Board [3h 5d Ts]
Seat 1: color_singleton (small blind) collected (378)
Seat 2: manon327 (big blind) folded on the Flop
Seat 3: JeBoyDirk folded on the Flop (didn't bet)
Seat 9: dhduncan (button) folded on the Flop



PokerStars Home Game Hand #223924449349: {DaPokaStars}  Hold'em No Limit (50/100) - 2021/02/17 15:01:24 ET
Table 'tonight again' 9-max (Play Money) Seat #1 is the button
Seat 1: color_singleton (10852 in chips) 
Seat 2: manon327 (11631 in chips) 
Seat 3: JeBoyDirk (9900 in chips) 
Seat 9: dhduncan (6865 in chips) 
manon327: posts small blind 50
JeBoyDirk: posts big blind 100
*** HOLE CARDS ***
Dealt to dhduncan [9s 7h]
dhduncan: folds 
color_singleton: folds 
manon327: folds 
Uncalled bet (50) returned to JeBoyDirk
JeBoyDirk collected 100 from pot
*** SUMMARY ***
Total pot 100 | Rake 0 
Seat 1: color_singleton (button) folded before Flop (didn't bet)
Seat 2: manon327 (small blind) folded before Flop
Seat 3: JeBoyDirk (big blind) collected (100)
Seat 9: dhduncan folded before Flop (didn't bet)



PokerStars Home Game Hand #223924458927: {DaPokaStars}  Hold'em No Limit (50/100) - 2021/02/17 15:01:40 ET
Table 'tonight again' 9-max (Play Money) Seat #2 is the button
Seat 1: color_singleton (10852 in chips) 
Seat 2: manon327 (11581 in chips) 
Seat 3: JeBoyDirk (9950 in chips) 
Seat 9: dhduncan (6865 in chips) 
JeBoyDirk: posts small blind 50
dhduncan: posts big blind 100
*** HOLE CARDS ***
Dealt to dhduncan [4c Jd]
color_singleton: raises 200 to 300
manon327: calls 300
JeBoyDirk: raises 200 to 500
dhduncan: folds 
color_singleton: calls 200
manon327: calls 200
*** FLOP *** [9c 4h Jh]
JeBoyDirk: bets 600
color_singleton: raises 800 to 1400
manon327: folds 
JeBoyDirk: raises 1200 to 2600
color_singleton: calls 1200
*** TURN *** [9c 4h Jh] [7c]
JeBoyDirk: bets 2900
color_singleton: raises 2900 to 5800
JeBoyDirk: raises 1050 to 6850 and is all-in
color_singleton: calls 1050
*** RIVER *** [9c 4h Jh 7c] [6d]
*** SHOW DOWN ***
JeBoyDirk: shows [As Ad] (a pair of Aces)
color_singleton: shows [Js Th] (a pair of Jacks)
JeBoyDirk collected 19372 from pot
*** SUMMARY ***
Total pot 20500 | Rake 1128 
Board [9c 4h Jh 7c 6d]
Seat 1: color_singleton showed [Js Th] and lost with a pair of Jacks
Seat 2: manon327 (button) folded on the Flop
Seat 3: JeBoyDirk (small blind) showed [As Ad] and won (19372) with a pair of Aces
Seat 9: dhduncan (big blind) folded before Flop



PokerStars Home Game Hand #223924524561: {DaPokaStars}  Hold'em No Limit (50/100) - 2021/02/17 15:03:21 ET
Table 'tonight again' 9-max (Play Money) Seat #3 is the button
Seat 1: color_singleton (902 in chips) 
Seat 2: manon327 (11081 in chips) 
Seat 3: JeBoyDirk (19372 in chips) 
Seat 9: dhduncan (6765 in chips) 
dhduncan: posts small blind 50
color_singleton: posts big blind 100
*** HOLE CARDS ***
Dealt to dhduncan [Ac Kd]
manon327: folds 
JeBoyDirk: folds 
dhduncan: calls 50
color_singleton: raises 200 to 300
dhduncan: calls 200
*** FLOP *** [7d Qs Ks]
dhduncan: checks 
color_singleton: checks 
*** TURN *** [7d Qs Ks] [2h]
dhduncan: bets 602
color_singleton: folds 
Uncalled bet (602) returned to dhduncan
dhduncan collected 567 from pot
dhduncan: doesn't show hand 
*** SUMMARY ***
Total pot 600 | Rake 33 
Board [7d Qs Ks 2h]
Seat 1: color_singleton (big blind) folded on the Turn
Seat 2: manon327 folded before Flop (didn't bet)
Seat 3: JeBoyDirk (button) folded before Flop (didn't bet)
Seat 9: dhduncan (small blind) collected (567)



PokerStars Home Game Hand #223924554367: {DaPokaStars}  Hold'em No Limit (50/100) - 2021/02/17 15:04:04 ET
Table 'tonight again' 9-max (Play Money) Seat #9 is the button
Seat 1: color_singleton (602 in chips) 
Seat 2: manon327 (11081 in chips) 
Seat 3: JeBoyDirk (19372 in chips) 
Seat 9: dhduncan (7032 in chips) 
color_singleton: posts small blind 50
manon327: posts big blind 100
*** HOLE CARDS ***
Dealt to dhduncan [Js Td]
JeBoyDirk: calls 100
dhduncan: calls 100
color_singleton: calls 50
manon327: checks 
*** FLOP *** [Ah 5d Qd]
color_singleton: checks 
manon327: checks 
JeBoyDirk: bets 300
dhduncan: folds 
color_singleton: folds 
manon327: folds 
Uncalled bet (300) returned to JeBoyDirk
JeBoyDirk collected 378 from pot
*** SUMMARY ***
Total pot 400 | Rake 22 
Board [Ah 5d Qd]
Seat 1: color_singleton (small blind) folded on the Flop
Seat 2: manon327 (big blind) folded on the Flop
Seat 3: JeBoyDirk collected (378)
Seat 9: dhduncan (button) folded on the Flop



PokerStars Home Game Hand #223924572134: {DaPokaStars}  Hold'em No Limit (50/100) - 2021/02/17 15:04:31 ET
Table 'tonight again' 9-max (Play Money) Seat #1 is the button
Seat 1: color_singleton (502 in chips) 
Seat 2: manon327 (10981 in chips) 
Seat 3: JeBoyDirk (19650 in chips) 
Seat 9: dhduncan (6932 in chips) 
manon327: posts small blind 50
JeBoyDirk: posts big blind 100
*** HOLE CARDS ***
Dealt to dhduncan [7c 9s]
dhduncan: folds 
color_singleton: raises 402 to 502 and is all-in
manon327: folds 
JeBoyDirk: folds 
Uncalled bet (402) returned to color_singleton
color_singleton collected 250 from pot
color_singleton: doesn't show hand 
*** SUMMARY ***
Total pot 250 | Rake 0 
Seat 1: color_singleton (button) collected (250)
Seat 2: manon327 (small blind) folded before Flop
Seat 3: JeBoyDirk (big blind) folded before Flop
Seat 9: dhduncan folded before Flop (didn't bet)



PokerStars Home Game Hand #223924579235: {DaPokaStars}  Hold'em No Limit (50/100) - 2021/02/17 15:04:41 ET
Table 'tonight again' 9-max (Play Money) Seat #2 is the button
Seat 1: color_singleton (652 in chips) 
Seat 2: manon327 (10931 in chips) 
Seat 3: JeBoyDirk (19550 in chips) 
Seat 9: dhduncan (6932 in chips) 
JeBoyDirk: posts small blind 50
dhduncan: posts big blind 100
*** HOLE CARDS ***
Dealt to dhduncan [4s 2c]
color_singleton: folds 
manon327: calls 100
JeBoyDirk: calls 50
dhduncan: checks 
*** FLOP *** [6s 9h 7d]
JeBoyDirk: bets 200
dhduncan: folds 
manon327: folds 
Uncalled bet (200) returned to JeBoyDirk
JeBoyDirk collected 283 from pot
*** SUMMARY ***
Total pot 300 | Rake 17 
Board [6s 9h 7d]
Seat 1: color_singleton folded before Flop (didn't bet)
Seat 2: manon327 (button) folded on the Flop
Seat 3: JeBoyDirk (small blind) collected (283)
Seat 9: dhduncan (big blind) folded on the Flop



PokerStars Home Game Hand #223924604276: {DaPokaStars}  Hold'em No Limit (50/100) - 2021/02/17 15:05:05 ET
Table 'tonight again' 9-max (Play Money) Seat #3 is the button
Seat 1: color_singleton (652 in chips) 
Seat 2: manon327 (10831 in chips) 
Seat 3: JeBoyDirk (19733 in chips) 
Seat 9: dhduncan (6832 in chips) 
dhduncan: posts small blind 50
color_singleton: posts big blind 100
*** HOLE CARDS ***
Dealt to dhduncan [As Jd]
manon327: folds 
JeBoyDirk: calls 100
dhduncan: calls 50
color_singleton: raises 552 to 652 and is all-in
JeBoyDirk: calls 552
dhduncan: calls 552
*** FLOP *** [Ah Kc Jh]
dhduncan: checks 
JeBoyDirk: bets 400
dhduncan: raises 400 to 800
JeBoyDirk: calls 400
*** TURN *** [Ah Kc Jh] [3s]
dhduncan: bets 1680
JeBoyDirk: calls 1680
*** RIVER *** [Ah Kc Jh 3s] [5c]
dhduncan: bets 3700 and is all-in
JeBoyDirk: folds 
Uncalled bet (3700) returned to dhduncan
*** SHOW DOWN ***
dhduncan: shows [As Jd] (two pair, Aces and Jacks)
dhduncan collected 4688 from side pot
color_singleton: shows [Ac Qh] (a pair of Aces)
dhduncan collected 1848 from main pot
*** SUMMARY ***
Total pot 6916 Main pot 1848. Side pot 4688. | Rake 380 
Board [Ah Kc Jh 3s 5c]
Seat 1: color_singleton (big blind) showed [Ac Qh] and lost with a pair of Aces
Seat 2: manon327 folded before Flop (didn't bet)
Seat 3: JeBoyDirk (button) folded on the River
Seat 9: dhduncan (small blind) showed [As Jd] and won (6536) with two pair, Aces and Jacks



PokerStars Home Game Hand #223924636934: {DaPokaStars}  Hold'em No Limit (50/100) - 2021/02/17 15:05:52 ET
Table 'tonight again' 9-max (Play Money) Seat #9 is the button
Seat 2: manon327 (10831 in chips) 
Seat 3: JeBoyDirk (16601 in chips) 
Seat 9: dhduncan (10236 in chips) 
manon327: posts small blind 50
JeBoyDirk: posts big blind 100
*** HOLE CARDS ***
Dealt to dhduncan [Qh 6h]
dhduncan: calls 100
manon327: calls 50
JeBoyDirk: checks 
*** FLOP *** [2s 9d 3s]
manon327: checks 
JeBoyDirk: checks 
dhduncan: checks 
*** TURN *** [2s 9d 3s] [4d]
manon327: checks 
JeBoyDirk: checks 
dhduncan: checks 
*** RIVER *** [2s 9d 3s 4d] [Td]
manon327: bets 283
JeBoyDirk: folds 
dhduncan: folds 
Uncalled bet (283) returned to manon327
manon327 collected 283 from pot
*** SUMMARY ***
Total pot 300 | Rake 17 
Board [2s 9d 3s 4d Td]
Seat 2: manon327 (small blind) collected (283)
Seat 3: JeBoyDirk (big blind) folded on the River
Seat 9: dhduncan (button) folded on the River



PokerStars Home Game Hand #223924667072: {DaPokaStars}  Hold'em No Limit (50/100) - 2021/02/17 15:06:35 ET
Table 'tonight again' 9-max (Play Money) Seat #2 is the button
Seat 1: color_singleton (10000 in chips) 
Seat 2: manon327 (11014 in chips) 
Seat 3: JeBoyDirk (16501 in chips) 
Seat 9: dhduncan (10136 in chips) 
JeBoyDirk: posts small blind 50
dhduncan: posts big blind 100
color_singleton: posts small blind 50
*** HOLE CARDS ***
Dealt to dhduncan [6d 9d]
color_singleton: raises 200 to 300
manon327: calls 300
JeBoyDirk: folds 
dhduncan: folds 
*** FLOP *** [8h 8s 6s]
color_singleton: bets 756
manon327: folds 
Uncalled bet (756) returned to color_singleton
color_singleton collected 756 from pot
color_singleton: doesn't show hand 
*** SUMMARY ***
Total pot 800 | Rake 44 
Board [8h 8s 6s]
Seat 1: color_singleton collected (756)
Seat 2: manon327 (button) folded on the Flop
Seat 3: JeBoyDirk (small blind) folded before Flop
Seat 9: dhduncan (big blind) folded before Flop



PokerStars Home Game Hand #223924680042: {DaPokaStars}  Hold'em No Limit (50/100) - 2021/02/17 15:06:53 ET
Table 'tonight again' 9-max (Play Money) Seat #3 is the button
Seat 1: color_singleton (10406 in chips) 
Seat 2: manon327 (10714 in chips) 
Seat 3: JeBoyDirk (16451 in chips) 
Seat 9: dhduncan (10036 in chips) 
dhduncan: posts small blind 50
color_singleton: posts big blind 100
*** HOLE CARDS ***
Dealt to dhduncan [6h 3s]
manon327: calls 100
JeBoyDirk: raises 100 to 200
dhduncan: folds 
color_singleton: calls 100
manon327: calls 100
*** FLOP *** [5h Ts 8d]
color_singleton: checks 
manon327: checks 
JeBoyDirk: checks 
*** TURN *** [5h Ts 8d] [2d]
color_singleton: checks 
manon327: checks 
JeBoyDirk: checks 
*** RIVER *** [5h Ts 8d 2d] [8c]
color_singleton: checks 
manon327: bets 307
JeBoyDirk: folds 
color_singleton: calls 307
*** SHOW DOWN ***
manon327: shows [6c 5c] (two pair, Eights and Fives)
color_singleton: mucks hand 
manon327 collected 1194 from pot
*** SUMMARY ***
Total pot 1264 | Rake 70 
Board [5h Ts 8d 2d 8c]
Seat 1: color_singleton (big blind) mucked [3h As]
Seat 2: manon327 showed [6c 5c] and won (1194) with two pair, Eights and Fives
Seat 3: JeBoyDirk (button) folded on the River
Seat 9: dhduncan (small blind) folded before Flop



PokerStars Home Game Hand #223924713008: {DaPokaStars}  Hold'em No Limit (50/100) - 2021/02/17 15:07:26 ET
Table 'tonight again' 9-max (Play Money) Seat #9 is the button
Seat 1: color_singleton (9899 in chips) 
Seat 2: manon327 (11401 in chips) 
Seat 3: JeBoyDirk (16251 in chips) 
Seat 9: dhduncan (9986 in chips) 
color_singleton: posts small blind 50
manon327: posts big blind 100
*** HOLE CARDS ***
Dealt to dhduncan [As 3s]
JeBoyDirk: folds 
dhduncan: calls 100
color_singleton: folds 
manon327: checks 
*** FLOP *** [2c Ad 8s]
manon327: checks 
dhduncan: checks 
*** TURN *** [2c Ad 8s] [8d]
manon327: checks 
dhduncan: bets 236
manon327: folds 
Uncalled bet (236) returned to dhduncan
dhduncan collected 236 from pot
dhduncan: doesn't show hand 
*** SUMMARY ***
Total pot 250 | Rake 14 
Board [2c Ad 8s 8d]
Seat 1: color_singleton (small blind) folded before Flop
Seat 2: manon327 (big blind) folded on the Turn
Seat 3: JeBoyDirk folded before Flop (didn't bet)
Seat 9: dhduncan (button) collected (236)



PokerStars Home Game Hand #223924730860: {DaPokaStars}  Hold'em No Limit (50/100) - 2021/02/17 15:07:52 ET
Table 'tonight again' 9-max (Play Money) Seat #1 is the button
Seat 1: color_singleton (9849 in chips) 
Seat 2: manon327 (11301 in chips) 
Seat 3: JeBoyDirk (16251 in chips) 
Seat 9: dhduncan (10122 in chips) 
manon327: posts small blind 50
JeBoyDirk: posts big blind 100
*** HOLE CARDS ***
Dealt to dhduncan [6s Tc]
dhduncan: folds 
color_singleton: raises 100 to 200
manon327: calls 150
JeBoyDirk: folds 
*** FLOP *** [Jh 3c 3s]
manon327: checks 
color_singleton: checks 
*** TURN *** [Jh 3c 3s] [Qd]
manon327: checks 
color_singleton: bets 472
manon327: folds 
Uncalled bet (472) returned to color_singleton
color_singleton collected 472 from pot
color_singleton: doesn't show hand 
*** SUMMARY ***
Total pot 500 | Rake 28 
Board [Jh 3c 3s Qd]
Seat 1: color_singleton (button) collected (472)
Seat 2: manon327 (small blind) folded on the Turn
Seat 3: JeBoyDirk (big blind) folded before Flop
Seat 9: dhduncan folded before Flop (didn't bet)



PokerStars Home Game Hand #223924776520: {DaPokaStars}  Hold'em No Limit (50/100) - 2021/02/17 15:08:56 ET
Table 'tonight again' 9-max (Play Money) Seat #1 is the button
Seat 1: color_singleton (10260 in chips) 
Seat 2: manon327 (11001 in chips) 
Seat 3: JeBoyDirk (16101 in chips) 
Seat 9: dhduncan (10122 in chips) 
manon327: posts small blind 50
JeBoyDirk: posts big blind 100
dhduncan: posts small & big blinds 150
*** HOLE CARDS ***
Dealt to dhduncan [5s Qd]
dhduncan: checks 
color_singleton: raises 200 to 300
manon327: folds 
JeBoyDirk: calls 200
dhduncan: calls 200
*** FLOP *** [6d 4h Qs]
JeBoyDirk: checks 
dhduncan: bets 472
color_singleton: folds 
JeBoyDirk: calls 472
*** TURN *** [6d 4h Qs] [Jh]
JeBoyDirk: checks 
dhduncan: checks 
*** RIVER *** [6d 4h Qs Jh] [9s]
JeBoyDirk: bets 700
dhduncan: calls 700
*** SHOW DOWN ***
JeBoyDirk: shows [Qc 8c] (a pair of Queens)
dhduncan: mucks hand 
JeBoyDirk collected 3160 from pot
*** SUMMARY ***
Total pot 3344 | Rake 184 
Board [6d 4h Qs Jh 9s]
Seat 1: color_singleton (button) folded on the Flop
Seat 2: manon327 (small blind) folded before Flop
Seat 3: JeBoyDirk (big blind) showed [Qc 8c] and won (3160) with a pair of Queens
Seat 9: dhduncan mucked [5s Qd]



PokerStars Home Game Hand #223924813809: {DaPokaStars}  Hold'em No Limit (50/100) - 2021/02/17 15:09:50 ET
Table 'tonight again' 9-max (Play Money) Seat #2 is the button
Seat 1: color_singleton (9960 in chips) 
Seat 2: manon327 (10951 in chips) 
Seat 3: JeBoyDirk (17789 in chips) 
Seat 9: dhduncan (8600 in chips) 
JeBoyDirk: posts small blind 50
dhduncan: posts big blind 100
*** HOLE CARDS ***
Dealt to dhduncan [9h 6h]
color_singleton: raises 100 to 200
manon327: calls 200
JeBoyDirk: calls 150
dhduncan: folds 
*** FLOP *** [7c Ts 9d]
JeBoyDirk: checks 
color_singleton: bets 661
manon327: calls 661
JeBoyDirk: calls 661
*** TURN *** [7c Ts 9d] [Qs]
JeBoyDirk: checks 
color_singleton: checks 
manon327: bets 1267
JeBoyDirk: folds 
color_singleton: folds 
Uncalled bet (1267) returned to manon327
manon327 collected 2535 from pot
*** SUMMARY ***
Total pot 2683 | Rake 148 
Board [7c Ts 9d Qs]
Seat 1: color_singleton folded on the Turn
Seat 2: manon327 (button) collected (2535)
Seat 3: JeBoyDirk (small blind) folded on the Turn
Seat 9: dhduncan (big blind) folded before Flop



PokerStars Home Game Hand #223924842675: {DaPokaStars}  Hold'em No Limit (50/100) - 2021/02/17 15:10:30 ET
Table 'tonight again' 9-max (Play Money) Seat #3 is the button
Seat 1: color_singleton (9099 in chips) 
Seat 2: manon327 (12625 in chips) 
Seat 3: JeBoyDirk (16928 in chips) 
Seat 9: dhduncan (8500 in chips) 
dhduncan: posts small blind 50
color_singleton: posts big blind 100
*** HOLE CARDS ***
Dealt to dhduncan [Jc Ks]
manon327: calls 100
JeBoyDirk: folds 
dhduncan: calls 50
color_singleton: checks 
*** FLOP *** [Kc Qd 8s]
dhduncan: bets 100
color_singleton: folds 
manon327: calls 100
*** TURN *** [Kc Qd 8s] [2c]
dhduncan: bets 100
manon327: folds 
Uncalled bet (100) returned to dhduncan
dhduncan collected 472 from pot
dhduncan: doesn't show hand 
*** SUMMARY ***
Total pot 500 | Rake 28 
Board [Kc Qd 8s 2c]
Seat 1: color_singleton (big blind) folded on the Flop
Seat 2: manon327 folded on the Turn
Seat 3: JeBoyDirk (button) folded before Flop (didn't bet)
Seat 9: dhduncan (small blind) collected (472)



PokerStars Home Game Hand #223924864272: {DaPokaStars}  Hold'em No Limit (50/100) - 2021/02/17 15:11:01 ET
Table 'tonight again' 9-max (Play Money) Seat #9 is the button
Seat 1: color_singleton (8999 in chips) 
Seat 2: manon327 (12425 in chips) 
Seat 3: JeBoyDirk (16928 in chips) 
Seat 9: dhduncan (8772 in chips) 
color_singleton: posts small blind 50
manon327: posts big blind 100
*** HOLE CARDS ***
Dealt to dhduncan [8h Tc]
JeBoyDirk: calls 100
dhduncan: folds 
color_singleton: folds 
manon327: checks 
*** FLOP *** [Th 9c Qd]
manon327: checks 
JeBoyDirk: checks 
*** TURN *** [Th 9c Qd] [Js]
manon327: checks 
JeBoyDirk: checks 
*** RIVER *** [Th 9c Qd Js] [3h]
manon327: bets 118
JeBoyDirk: calls 118
*** SHOW DOWN ***
manon327: shows [2c Jc] (a pair of Jacks)
JeBoyDirk: shows [3d 3s] (three of a kind, Threes)
JeBoyDirk collected 459 from pot
*** SUMMARY ***
Total pot 486 | Rake 27 
Board [Th 9c Qd Js 3h]
Seat 1: color_singleton (small blind) folded before Flop
Seat 2: manon327 (big blind) showed [2c Jc] and lost with a pair of Jacks
Seat 3: JeBoyDirk showed [3d 3s] and won (459) with three of a kind, Threes
Seat 9: dhduncan (button) folded before Flop (didn't bet)



PokerStars Home Game Hand #223924882733: {DaPokaStars}  Hold'em No Limit (50/100) - 2021/02/17 15:11:28 ET
Table 'tonight again' 9-max (Play Money) Seat #1 is the button
Seat 1: color_singleton (8949 in chips) 
Seat 2: manon327 (12207 in chips) 
Seat 3: JeBoyDirk (17169 in chips) 
Seat 9: dhduncan (8772 in chips) 
manon327: posts small blind 50
JeBoyDirk: posts big blind 100
*** HOLE CARDS ***
Dealt to dhduncan [7c 3h]
dhduncan: folds 
color_singleton: folds 
manon327: folds 
Uncalled bet (50) returned to JeBoyDirk
JeBoyDirk collected 100 from pot
*** SUMMARY ***
Total pot 100 | Rake 0 
Seat 1: color_singleton (button) folded before Flop (didn't bet)
Seat 2: manon327 (small blind) folded before Flop
Seat 3: JeBoyDirk (big blind) collected (100)
Seat 9: dhduncan folded before Flop (didn't bet)



PokerStars Home Game Hand #223924888027: {DaPokaStars}  Hold'em No Limit (50/100) - 2021/02/17 15:11:35 ET
Table 'tonight again' 9-max (Play Money) Seat #2 is the button
Seat 1: color_singleton (8949 in chips) 
Seat 2: manon327 (12157 in chips) 
Seat 3: JeBoyDirk (17219 in chips) 
Seat 9: dhduncan (8772 in chips) 
JeBoyDirk: posts small blind 50
dhduncan: posts big blind 100
*** HOLE CARDS ***
Dealt to dhduncan [8d Kc]
color_singleton: raises 200 to 300
Klemtonius joins the table at seat #7 
manon327: folds 
JeBoyDirk: folds 
dhduncan: calls 200
*** FLOP *** [8c 6c 2d]
dhduncan: bets 100
color_singleton: calls 100
*** TURN *** [8c 6c 2d] [Qc]
dhduncan: bets 100
color_singleton: calls 100
*** RIVER *** [8c 6c 2d Qc] [As]
dhduncan: bets 100
color_singleton: calls 100
*** SHOW DOWN ***
dhduncan: shows [8d Kc] (a pair of Eights)
color_singleton: shows [Jc Ad] (a pair of Aces)
color_singleton collected 1181 from pot
*** SUMMARY ***
Total pot 1250 | Rake 69 
Board [8c 6c 2d Qc As]
Seat 1: color_singleton showed [Jc Ad] and won (1181) with a pair of Aces
Seat 2: manon327 (button) folded before Flop (didn't bet)
Seat 3: JeBoyDirk (small blind) folded before Flop
Seat 9: dhduncan (big blind) showed [8d Kc] and lost with a pair of Eights



PokerStars Home Game Hand #223924912080: {DaPokaStars}  Hold'em No Limit (50/100) - 2021/02/17 15:12:09 ET
Table 'tonight again' 9-max (Play Money) Seat #3 is the button
Seat 1: color_singleton (9530 in chips) 
Seat 2: manon327 (12157 in chips) 
Seat 3: JeBoyDirk (17169 in chips) 
Seat 9: dhduncan (8172 in chips) 
dhduncan: posts small blind 50
color_singleton: posts big blind 100
*** HOLE CARDS ***
Dealt to dhduncan [3d 3c]
manon327: raises 100 to 200
JeBoyDirk: folds 
dhduncan: folds 
color_singleton: calls 100
*** FLOP *** [4d 2d Kc]
color_singleton: checks 
manon327: bets 212
color_singleton: folds 
Uncalled bet (212) returned to manon327
manon327 collected 425 from pot
*** SUMMARY ***
Total pot 450 | Rake 25 
Board [4d 2d Kc]
Seat 1: color_singleton (big blind) folded on the Flop
Seat 2: manon327 collected (425)
Seat 3: JeBoyDirk (button) folded before Flop (didn't bet)
Seat 9: dhduncan (small blind) folded before Flop



PokerStars Home Game Hand #223924936379: {DaPokaStars}  Hold'em No Limit (50/100) - 2021/02/17 15:12:44 ET
Table 'tonight again' 9-max (Play Money) Seat #9 is the button
Seat 1: color_singleton (9330 in chips) 
Seat 2: manon327 (12382 in chips) 
Seat 3: JeBoyDirk (17169 in chips) 
Seat 7: Klemtonius (10000 in chips) 
Seat 9: dhduncan (8122 in chips) 
color_singleton: posts small blind 50
manon327: posts big blind 100
Klemtonius: posts big blind 100
*** HOLE CARDS ***
Dealt to dhduncan [3s Qc]
JeBoyDirk: calls 100
Klemtonius: checks 
dhduncan: calls 100
color_singleton: raises 400 to 500
manon327: folds 
JeBoyDirk: calls 400
Klemtonius: folds 
dhduncan: folds 
*** FLOP *** [7c 7h 6s]
color_singleton: checks 
JeBoyDirk: checks 
*** TURN *** [7c 7h 6s] [Td]
color_singleton: bets 614
JeBoyDirk: raises 1286 to 1900
color_singleton: folds 
Uncalled bet (1286) returned to JeBoyDirk
JeBoyDirk collected 2389 from pot
*** SUMMARY ***
Total pot 2528 | Rake 139 
Board [7c 7h 6s Td]
Seat 1: color_singleton (small blind) folded on the Turn
Seat 2: manon327 (big blind) folded before Flop
Seat 3: JeBoyDirk collected (2389)
Seat 7: Klemtonius folded before Flop (didn't bet)
Seat 9: dhduncan (button) folded before Flop



PokerStars Home Game Hand #223924966192: {DaPokaStars}  Hold'em No Limit (50/100) - 2021/02/17 15:13:26 ET
Table 'tonight again' 9-max (Play Money) Seat #1 is the button
Seat 1: color_singleton (8216 in chips) 
Seat 2: manon327 (12282 in chips) 
Seat 3: JeBoyDirk (18444 in chips) 
Seat 7: Klemtonius (9900 in chips) 
Seat 9: dhduncan (8022 in chips) 
manon327: posts small blind 50
JeBoyDirk: posts big blind 100
*** HOLE CARDS ***
Dealt to dhduncan [2h 8h]
Klemtonius: raises 100 to 200
dhduncan: folds 
color_singleton: folds 
manon327: calls 150
JeBoyDirk: folds 
*** FLOP *** [Ts Jc 7h]
manon327: checks 
Klemtonius: bets 236
manon327: calls 236
*** TURN *** [Ts Jc 7h] [Kd]
manon327: bets 459
Klemtonius: raises 459 to 918
manon327: calls 459
*** RIVER *** [Ts Jc 7h Kd] [Jh]
manon327: checks 
Klemtonius: bets 2654
manon327: calls 2654
*** SHOW DOWN ***
Klemtonius: shows [Ah Qd] (a straight, Ten to Ace)
manon327: mucks hand 
Klemtonius collected 7670 from pot
*** SUMMARY ***
Total pot 8116 | Rake 446 
Board [Ts Jc 7h Kd Jh]
Seat 1: color_singleton (button) folded before Flop (didn't bet)
Seat 2: manon327 (small blind) mucked [9d Qs]
Seat 3: JeBoyDirk (big blind) folded before Flop
Seat 7: Klemtonius showed [Ah Qd] and won (7670) with a straight, Ten to Ace
Seat 9: dhduncan folded before Flop (didn't bet)



PokerStars Home Game Hand #223925003892: {DaPokaStars}  Hold'em No Limit (50/100) - 2021/02/17 15:14:19 ET
Table 'tonight again' 9-max (Play Money) Seat #2 is the button
Seat 1: color_singleton (8216 in chips) 
Seat 2: manon327 (8274 in chips) 
Seat 3: JeBoyDirk (18344 in chips) 
Seat 7: Klemtonius (13562 in chips) 
Seat 9: dhduncan (8022 in chips) 
JeBoyDirk: posts small blind 50
Klemtonius: posts big blind 100
*** HOLE CARDS ***
Dealt to dhduncan [Js 5d]
dhduncan: folds 
color_singleton: raises 200 to 300
manon327: folds 
JeBoyDirk: folds 
Klemtonius: folds 
Uncalled bet (200) returned to color_singleton
color_singleton collected 250 from pot
color_singleton: doesn't show hand 
*** SUMMARY ***
Total pot 250 | Rake 0 
Seat 1: color_singleton collected (250)
Seat 2: manon327 (button) folded before Flop (didn't bet)
Seat 3: JeBoyDirk (small blind) folded before Flop
Seat 7: Klemtonius (big blind) folded before Flop
Seat 9: dhduncan folded before Flop (didn't bet)



PokerStars Home Game Hand #223925031013: {DaPokaStars}  Hold'em No Limit (50/100) - 2021/02/17 15:14:57 ET
Table 'tonight again' 9-max (Play Money) Seat #3 is the button
Seat 1: color_singleton (8366 in chips) 
Seat 2: manon327 (8274 in chips) 
Seat 3: JeBoyDirk (18294 in chips) 
Seat 7: Klemtonius (13462 in chips) 
Seat 9: dhduncan (8022 in chips) 
Klemtonius: posts small blind 50
dhduncan: posts big blind 100
*** HOLE CARDS ***
Dealt to dhduncan [Kc Qs]
color_singleton: folds 
manon327: calls 100
JeBoyDirk: folds 
Klemtonius: calls 50
dhduncan: checks 
*** FLOP *** [Qh 6c 5s]
Klemtonius: checks 
dhduncan: bets 100
manon327: calls 100
Klemtonius: raises 291 to 391
dhduncan: calls 291
manon327: folds 
*** TURN *** [Qh 6c 5s] [Ac]
Klemtonius: bets 100
dhduncan: calls 100
*** RIVER *** [Qh 6c 5s Ac] [7d]
Klemtonius: bets 653
dhduncan: calls 653
*** SHOW DOWN ***
Klemtonius: shows [2d Qd] (a pair of Queens)
dhduncan: shows [Kc Qs] (a pair of Queens - Ace+King kicker)
dhduncan collected 2540 from pot
*** SUMMARY ***
Total pot 2688 | Rake 148 
Board [Qh 6c 5s Ac 7d]
Seat 1: color_singleton folded before Flop (didn't bet)
Seat 2: manon327 folded on the Flop
Seat 3: JeBoyDirk (button) folded before Flop (didn't bet)
Seat 7: Klemtonius (small blind) showed [2d Qd] and lost with a pair of Queens
Seat 9: dhduncan (big blind) showed [Kc Qs] and won (2540) with a pair of Queens



PokerStars Home Game Hand #223925080349: {DaPokaStars}  Hold'em No Limit (50/100) - 2021/02/17 15:15:53 ET
Table 'tonight again' 9-max (Play Money) Seat #7 is the button
Seat 1: color_singleton (8366 in chips) 
Seat 2: manon327 (8074 in chips) 
Seat 3: JeBoyDirk (18294 in chips) 
Seat 7: Klemtonius (12218 in chips) 
Seat 9: dhduncan (9318 in chips) 
dhduncan: posts small blind 50
color_singleton: posts big blind 100
*** HOLE CARDS ***
Dealt to dhduncan [8c 6s]
manon327: calls 100
JeBoyDirk: folds 
Klemtonius: folds 
dhduncan: folds 
color_singleton: raises 200 to 300
manon327: folds 
Uncalled bet (200) returned to color_singleton
color_singleton collected 250 from pot
color_singleton: doesn't show hand 
*** SUMMARY ***
Total pot 250 | Rake 0 
Seat 1: color_singleton (big blind) collected (250)
Seat 2: manon327 folded before Flop
Seat 3: JeBoyDirk folded before Flop (didn't bet)
Seat 7: Klemtonius (button) folded before Flop (didn't bet)
Seat 9: dhduncan (small blind) folded before Flop



PokerStars Home Game Hand #223925090220: {DaPokaStars}  Hold'em No Limit (50/100) - 2021/02/17 15:16:07 ET
Table 'tonight again' 9-max (Play Money) Seat #9 is the button
Seat 1: color_singleton (8516 in chips) 
Seat 2: manon327 (7974 in chips) 
Seat 3: JeBoyDirk (18294 in chips) 
Seat 7: Klemtonius (12218 in chips) 
Seat 9: dhduncan (9268 in chips) 
color_singleton: posts small blind 50
manon327: posts big blind 100
*** HOLE CARDS ***
Dealt to dhduncan [Qd 3d]
JeBoyDirk: calls 100
Klemtonius: calls 100
dhduncan: calls 100
color_singleton: calls 50
manon327: raises 100 to 200
JeBoyDirk: calls 100
Klemtonius: calls 100
dhduncan: calls 100
color_singleton: calls 100
*** FLOP *** [5h 6s Ac]
color_singleton: checks 
manon327: bets 472
JeBoyDirk: folds 
Klemtonius: calls 472
dhduncan: folds 
color_singleton: calls 472
*** TURN *** [5h 6s Ac] [4d]
color_singleton: checks 
manon327: checks 
Klemtonius: checks 
*** RIVER *** [5h 6s Ac 4d] [Js]
color_singleton: checks 
manon327: bets 2283
Klemtonius: folds 
color_singleton: folds 
Uncalled bet (2283) returned to manon327
manon327 collected 2283 from pot
*** SUMMARY ***
Total pot 2416 | Rake 133 
Board [5h 6s Ac 4d Js]
Seat 1: color_singleton (small blind) folded on the River
Seat 2: manon327 (big blind) collected (2283)
Seat 3: JeBoyDirk folded on the Flop
Seat 7: Klemtonius folded on the River
Seat 9: dhduncan (button) folded on the Flop



PokerStars Home Game Hand #223925141857: {DaPokaStars}  Hold'em No Limit (50/100) - 2021/02/17 15:17:20 ET
Table 'tonight again' 9-max (Play Money) Seat #1 is the button
Seat 1: color_singleton (7844 in chips) 
Seat 2: manon327 (9585 in chips) 
Seat 3: JeBoyDirk (18094 in chips) 
Seat 7: Klemtonius (11546 in chips) 
Seat 9: dhduncan (9068 in chips) 
manon327: posts small blind 50
JeBoyDirk: posts big blind 100
*** HOLE CARDS ***
Dealt to dhduncan [5c 8s]
Klemtonius: calls 100
dhduncan: folds 
color_singleton: raises 200 to 300
manon327: folds 
JeBoyDirk: calls 200
Klemtonius: calls 200
*** FLOP *** [7s 9s 8c]
JeBoyDirk: checks 
Klemtonius: checks 
color_singleton: checks 
*** TURN *** [7s 9s 8c] [Ks]
JeBoyDirk: checks 
Klemtonius: checks 
color_singleton: checks 
*** RIVER *** [7s 9s 8c Ks] [9h]
JeBoyDirk: checks 
Klemtonius: checks 
color_singleton: checks 
*** SHOW DOWN ***
JeBoyDirk: shows [Qd Ts] (a pair of Nines)
Klemtonius: shows [4d As] (a pair of Nines - Ace kicker)
color_singleton: shows [3d Ah] (a pair of Nines)
Klemtonius collected 449 from pot
color_singleton collected 449 from pot
*** SUMMARY ***
Total pot 950 | Rake 52 
Board [7s 9s 8c Ks 9h]
Seat 1: color_singleton (button) showed [3d Ah] and won (449) with a pair of Nines
Seat 2: manon327 (small blind) folded before Flop
Seat 3: JeBoyDirk (big blind) showed [Qd Ts] and lost with a pair of Nines
Seat 7: Klemtonius showed [4d As] and won (449) with a pair of Nines
Seat 9: dhduncan folded before Flop (didn't bet)



PokerStars Home Game Hand #223925176725: {DaPokaStars}  Hold'em No Limit (50/100) - 2021/02/17 15:18:08 ET
Table 'tonight again' 9-max (Play Money) Seat #2 is the button
Seat 1: color_singleton (7993 in chips) 
Seat 2: manon327 (9535 in chips) 
Seat 3: JeBoyDirk (17794 in chips) 
Seat 7: Klemtonius (11695 in chips) 
Seat 9: dhduncan (9068 in chips) 
JeBoyDirk: posts small blind 50
Klemtonius: posts big blind 100
*** HOLE CARDS ***
Dealt to dhduncan [8s Kc]
dhduncan: calls 100
color_singleton: folds 
manon327: folds 
JeBoyDirk: calls 50
Klemtonius: checks 
*** FLOP *** [Ks Kh 5s]
JeBoyDirk: checks 
Klemtonius: checks 
dhduncan: checks 
*** TURN *** [Ks Kh 5s] [Ac]
JeBoyDirk: checks 
Klemtonius: checks 
dhduncan: checks 
*** RIVER *** [Ks Kh 5s Ac] [9s]
JeBoyDirk: checks 
Klemtonius: bets 100
dhduncan: raises 100 to 200
JeBoyDirk: calls 200
Klemtonius: calls 100
*** SHOW DOWN ***
dhduncan: shows [8s Kc] (three of a kind, Kings)
JeBoyDirk: mucks hand 
Klemtonius: mucks hand 
dhduncan collected 850 from pot
*** SUMMARY ***
Total pot 900 | Rake 50 
Board [Ks Kh 5s Ac 9s]
Seat 1: color_singleton folded before Flop (didn't bet)
Seat 2: manon327 (button) folded before Flop (didn't bet)
Seat 3: JeBoyDirk (small blind) mucked [4d Ad]
Seat 7: Klemtonius (big blind) mucked [Jd 9h]
Seat 9: dhduncan showed [8s Kc] and won (850) with three of a kind, Kings



PokerStars Home Game Hand #223925212066: {DaPokaStars}  Hold'em No Limit (50/100) - 2021/02/17 15:18:57 ET
Table 'tonight again' 9-max (Play Money) Seat #3 is the button
Seat 1: color_singleton (7993 in chips) 
Seat 2: manon327 (9535 in chips) 
Seat 3: JeBoyDirk (17494 in chips) 
Seat 7: Klemtonius (11395 in chips) 
Seat 9: dhduncan (9618 in chips) 
Klemtonius: posts small blind 50
dhduncan: posts big blind 100
*** HOLE CARDS ***
Dealt to dhduncan [Qc 5s]
color_singleton: folds 
manon327: calls 100
JeBoyDirk: folds 
Klemtonius: raises 100 to 200
dhduncan: folds 
manon327: calls 100
*** FLOP *** [Kc 9d Ad]
Klemtonius: checks 
manon327: checks 
*** TURN *** [Kc 9d Ad] [4d]
Klemtonius: checks 
manon327: checks 
*** RIVER *** [Kc 9d Ad 4d] [Ah]
Klemtonius: bets 100
manon327: folds 
Uncalled bet (100) returned to Klemtonius
Klemtonius collected 472 from pot
Klemtonius: doesn't show hand 
*** SUMMARY ***
Total pot 500 | Rake 28 
Board [Kc 9d Ad 4d Ah]
Seat 1: color_singleton folded before Flop (didn't bet)
Seat 2: manon327 folded on the River
Seat 3: JeBoyDirk (button) folded before Flop (didn't bet)
Seat 7: Klemtonius (small blind) collected (472)
Seat 9: dhduncan (big blind) folded before Flop



PokerStars Home Game Hand #223925238610: {DaPokaStars}  Hold'em No Limit (50/100) - 2021/02/17 15:19:35 ET
Table 'tonight again' 9-max (Play Money) Seat #7 is the button
Seat 1: color_singleton (7993 in chips) 
Seat 2: manon327 (9335 in chips) 
Seat 3: JeBoyDirk (17494 in chips) 
Seat 7: Klemtonius (11667 in chips) 
Seat 9: dhduncan (9518 in chips) 
dhduncan: posts small blind 50
color_singleton: posts big blind 100
*** HOLE CARDS ***
Dealt to dhduncan [3h 7h]
manon327: calls 100
JeBoyDirk: calls 100
Klemtonius: raises 100 to 200
dhduncan: folds 
color_singleton: calls 100
manon327: calls 100
JeBoyDirk: calls 100
*** FLOP *** [5s 8s 8c]
color_singleton: bets 401
manon327: folds 
JeBoyDirk: folds 
Klemtonius: calls 401
*** TURN *** [5s 8s 8c] [Jc]
color_singleton: bets 780
Klemtonius: raises 3121 to 3901
color_singleton: folds 
Uncalled bet (3121) returned to Klemtonius
Klemtonius collected 3035 from pot
Klemtonius: doesn't show hand 
*** SUMMARY ***
Total pot 3212 | Rake 177 
Board [5s 8s 8c Jc]
Seat 1: color_singleton (big blind) folded on the Turn
Seat 2: manon327 folded on the Flop
Seat 3: JeBoyDirk folded on the Flop
Seat 7: Klemtonius (button) collected (3035)
Seat 9: dhduncan (small blind) folded before Flop



PokerStars Home Game Hand #223925273545: {DaPokaStars}  Hold'em No Limit (50/100) - 2021/02/17 15:20:24 ET
Table 'tonight again' 9-max (Play Money) Seat #9 is the button
Seat 1: color_singleton (6612 in chips) 
Seat 2: manon327 (9135 in chips) 
Seat 3: JeBoyDirk (17294 in chips) 
Seat 7: Klemtonius (13321 in chips) 
Seat 9: dhduncan (9468 in chips) 
color_singleton: posts small blind 50
manon327: posts big blind 100
*** HOLE CARDS ***
Dealt to dhduncan [Td 3s]
JeBoyDirk: calls 100
Klemtonius: calls 100
dhduncan: folds 
color_singleton: calls 50
manon327: raises 100 to 200
JeBoyDirk: calls 100
Klemtonius: calls 100
color_singleton: calls 100
*** FLOP *** [4c Qd 8d]
color_singleton: checks 
manon327: checks 
JeBoyDirk: checks 
Klemtonius: checks 
*** TURN *** [4c Qd 8d] [Ts]
color_singleton: checks 
manon327: checks 
JeBoyDirk: bets 400
Klemtonius: folds 
color_singleton: folds 
manon327: calls 400
*** RIVER *** [4c Qd 8d Ts] [Kd]
manon327: bets 1512
JeBoyDirk: calls 1512
*** SHOW DOWN ***
manon327: shows [Jd Ad] (a flush, Ace high)
JeBoyDirk: mucks hand 
manon327 collected 4370 from pot
*** SUMMARY ***
Total pot 4624 | Rake 254 
Board [4c Qd 8d Ts Kd]
Seat 1: color_singleton (small blind) folded on the Turn
Seat 2: manon327 (big blind) showed [Jd Ad] and won (4370) with a flush, Ace high
Seat 3: JeBoyDirk mucked [8h Th]
Seat 7: Klemtonius folded on the Turn
Seat 9: dhduncan (button) folded before Flop (didn't bet)



PokerStars Home Game Hand #223925311966: {DaPokaStars}  Hold'em No Limit (50/100) - 2021/02/17 15:21:18 ET
Table 'tonight again' 9-max (Play Money) Seat #1 is the button
Seat 1: color_singleton (6412 in chips) 
Seat 2: manon327 (11393 in chips) 
Seat 3: JeBoyDirk (15182 in chips) 
Seat 7: Klemtonius (13121 in chips) 
Seat 9: dhduncan (9468 in chips) 
manon327: posts small blind 50
JeBoyDirk: posts big blind 100
*** HOLE CARDS ***
Dealt to dhduncan [4s Qh]
Klemtonius: calls 100
dhduncan: folds 
color_singleton: raises 100 to 200
manon327: folds 
JeBoyDirk: calls 100
Klemtonius: calls 100
*** FLOP *** [6h 9h 4c]
JeBoyDirk: checks 
Klemtonius: checks 
color_singleton: checks 
*** TURN *** [6h 9h 4c] [Kd]
JeBoyDirk: checks 
Klemtonius: checks 
color_singleton: checks 
*** RIVER *** [6h 9h 4c Kd] [9d]
JeBoyDirk: checks 
Klemtonius: bets 307
color_singleton: folds 
JeBoyDirk: calls 307
*** SHOW DOWN ***
Klemtonius: shows [2c Qc] (a pair of Nines)
JeBoyDirk: shows [Ts 9s] (three of a kind, Nines)
JeBoyDirk collected 1194 from pot
*** SUMMARY ***
Total pot 1264 | Rake 70 
Board [6h 9h 4c Kd 9d]
Seat 1: color_singleton (button) folded on the River
Seat 2: manon327 (small blind) folded before Flop
Seat 3: JeBoyDirk (big blind) showed [Ts 9s] and won (1194) with three of a kind, Nines
Seat 7: Klemtonius showed [2c Qc] and lost with a pair of Nines
Seat 9: dhduncan folded before Flop (didn't bet)



PokerStars Home Game Hand #223925352175: {DaPokaStars}  Hold'em No Limit (50/100) - 2021/02/17 15:22:15 ET
Table 'tonight again' 9-max (Play Money) Seat #2 is the button
Seat 1: color_singleton (6212 in chips) 
Seat 2: manon327 (11343 in chips) 
Seat 3: JeBoyDirk (15869 in chips) 
Seat 7: Klemtonius (12614 in chips) 
Seat 9: dhduncan (9468 in chips) 
JeBoyDirk: posts small blind 50
Klemtonius: posts big blind 100
*** HOLE CARDS ***
Dealt to dhduncan [Kd Th]
dhduncan: calls 100
color_singleton: calls 100
manon327: calls 100
JeBoyDirk: calls 50
Klemtonius: checks 
*** FLOP *** [6s 3s 2h]
JeBoyDirk: checks 
Klemtonius: bets 472
dhduncan: folds 
color_singleton: calls 472
manon327: folds 
JeBoyDirk: folds 
*** TURN *** [6s 3s 2h] [5s]
Klemtonius: bets 1365
color_singleton: calls 1365
*** RIVER *** [6s 3s 2h 5s] [2d]
Klemtonius: checks 
color_singleton: checks 
*** SHOW DOWN ***
Klemtonius: shows [6h Qc] (two pair, Sixes and Deuces)
color_singleton: shows [As 4c] (a straight, Deuce to Six)
color_singleton collected 3944 from pot
*** SUMMARY ***
Total pot 4174 | Rake 230 
Board [6s 3s 2h 5s 2d]
Seat 1: color_singleton showed [As 4c] and won (3944) with a straight, Deuce to Six
Seat 2: manon327 (button) folded on the Flop
Seat 3: JeBoyDirk (small blind) folded on the Flop
Seat 7: Klemtonius (big blind) showed [6h Qc] and lost with two pair, Sixes and Deuces
Seat 9: dhduncan folded on the Flop



PokerStars Home Game Hand #223925389617: {DaPokaStars}  Hold'em No Limit (50/100) - 2021/02/17 15:23:07 ET
Table 'tonight again' 9-max (Play Money) Seat #3 is the button
Seat 1: color_singleton (8219 in chips) 
Seat 2: manon327 (11243 in chips) 
Seat 3: JeBoyDirk (15769 in chips) 
Seat 7: Klemtonius (10677 in chips) 
Seat 9: dhduncan (9368 in chips) 
Klemtonius: posts small blind 50
dhduncan: posts big blind 100
*** HOLE CARDS ***
Dealt to dhduncan [Js 4c]
color_singleton: raises 200 to 300
manon327: calls 300
JeBoyDirk: folds 
Klemtonius: raises 200 to 500
dhduncan: folds 
color_singleton: calls 200
manon327: calls 200
*** FLOP *** [3c 5s 3d]
Klemtonius: bets 1512
color_singleton: folds 
manon327: folds 
Uncalled bet (1512) returned to Klemtonius
Klemtonius collected 1512 from pot
Klemtonius: doesn't show hand 
*** SUMMARY ***
Total pot 1600 | Rake 88 
Board [3c 5s 3d]
Seat 1: color_singleton folded on the Flop
Seat 2: manon327 folded on the Flop
Seat 3: JeBoyDirk (button) folded before Flop (didn't bet)
Seat 7: Klemtonius (small blind) collected (1512)
Seat 9: dhduncan (big blind) folded before Flop



PokerStars Home Game Hand #223925420513: {DaPokaStars}  Hold'em No Limit (50/100) - 2021/02/17 15:23:51 ET
Table 'tonight again' 9-max (Play Money) Seat #7 is the button
Seat 1: color_singleton (7719 in chips) 
Seat 2: manon327 (10743 in chips) 
Seat 3: JeBoyDirk (15769 in chips) 
Seat 7: Klemtonius (11689 in chips) 
Seat 9: dhduncan (9268 in chips) 
dhduncan: posts small blind 50
color_singleton: posts big blind 100
*** HOLE CARDS ***
Dealt to dhduncan [9c 8s]
manon327: calls 100
JeBoyDirk: calls 100
Klemtonius: calls 100
dhduncan: folds 
color_singleton: checks 
*** FLOP *** [Td 4d 4h]
color_singleton: checks 
manon327: checks 
JeBoyDirk: checks 
Klemtonius: checks 
*** TURN *** [Td 4d 4h] [5h]
color_singleton: bets 212
manon327: folds 
JeBoyDirk: folds 
Klemtonius: folds 
Uncalled bet (212) returned to color_singleton
color_singleton collected 425 from pot
color_singleton: doesn't show hand 
*** SUMMARY ***
Total pot 450 | Rake 25 
Board [Td 4d 4h 5h]
Seat 1: color_singleton (big blind) collected (425)
Seat 2: manon327 folded on the Turn
Seat 3: JeBoyDirk folded on the Turn
Seat 7: Klemtonius (button) folded on the Turn
Seat 9: dhduncan (small blind) folded before Flop



PokerStars Home Game Hand #223925441946: {DaPokaStars}  Hold'em No Limit (50/100) - 2021/02/17 15:24:21 ET
Table 'tonight again' 9-max (Play Money) Seat #9 is the button
Seat 1: color_singleton (8044 in chips) 
Seat 2: manon327 (10643 in chips) 
Seat 3: JeBoyDirk (15669 in chips) 
Seat 7: Klemtonius (11589 in chips) 
Seat 9: dhduncan (9218 in chips) 
color_singleton: posts small blind 50
manon327: posts big blind 100
*** HOLE CARDS ***
Dealt to dhduncan [3h 3s]
JeBoyDirk: folds 
Klemtonius: raises 100 to 200
dhduncan: folds 
color_singleton: calls 150
manon327: folds 
*** FLOP *** [5h 8d Jc]
color_singleton: bets 236
Klemtonius: raises 236 to 472
color_singleton: calls 236
*** TURN *** [5h 8d Jc] [9c]
color_singleton: checks 
Klemtonius: bets 10917 and is all-in
color_singleton: folds 
Uncalled bet (10917) returned to Klemtonius
Klemtonius collected 1365 from pot
Klemtonius: doesn't show hand 
*** SUMMARY ***
Total pot 1444 | Rake 79 
Board [5h 8d Jc 9c]
Seat 1: color_singleton (small blind) folded on the Turn
Seat 2: manon327 (big blind) folded before Flop
Seat 3: JeBoyDirk folded before Flop (didn't bet)
Seat 7: Klemtonius collected (1365)
Seat 9: dhduncan (button) folded before Flop (didn't bet)



PokerStars Home Game Hand #223925471036: {DaPokaStars}  Hold'em No Limit (50/100) - 2021/02/17 15:25:02 ET
Table 'tonight again' 9-max (Play Money) Seat #1 is the button
Seat 1: color_singleton (7372 in chips) 
Seat 2: manon327 (10543 in chips) 
Seat 3: JeBoyDirk (15669 in chips) 
Seat 7: Klemtonius (12282 in chips) 
Seat 9: dhduncan (9218 in chips) 
manon327: posts small blind 50
JeBoyDirk: posts big blind 100
*** HOLE CARDS ***
Dealt to dhduncan [8s Ad]
Klemtonius: calls 100
dhduncan: calls 100
color_singleton: folds 
manon327: calls 50
JeBoyDirk: checks 
*** FLOP *** [7d Jc Ts]
manon327: checks 
JeBoyDirk: checks 
Klemtonius: checks 
dhduncan: checks 
*** TURN *** [7d Jc Ts] [7c]
manon327: checks 
JeBoyDirk: bets 100
Klemtonius: calls 100
dhduncan: folds 
manon327: folds 
*** RIVER *** [7d Jc Ts 7c] [5d]
JeBoyDirk: checks 
Klemtonius: bets 283
JeBoyDirk: folds 
Uncalled bet (283) returned to Klemtonius
Klemtonius collected 567 from pot
Klemtonius: doesn't show hand 
*** SUMMARY ***
Total pot 600 | Rake 33 
Board [7d Jc Ts 7c 5d]
Seat 1: color_singleton (button) folded before Flop (didn't bet)
Seat 2: manon327 (small blind) folded on the Turn
Seat 3: JeBoyDirk (big blind) folded on the River
Seat 7: Klemtonius collected (567)
Seat 9: dhduncan folded on the Turn



PokerStars Home Game Hand #223925513744: {DaPokaStars}  Hold'em No Limit (50/100) - 2021/02/17 15:26:02 ET
Table 'tonight again' 9-max (Play Money) Seat #2 is the button
Seat 1: color_singleton (7372 in chips) 
Seat 2: manon327 (10443 in chips) 
Seat 3: JeBoyDirk (15469 in chips) 
Seat 7: Klemtonius (12649 in chips) 
Seat 9: dhduncan (9118 in chips) 
JeBoyDirk: posts small blind 50
Klemtonius: posts big blind 100
*** HOLE CARDS ***
Dealt to dhduncan [7h 4h]
dhduncan: calls 100
color_singleton: calls 100
manon327: calls 100
JeBoyDirk: folds 
Klemtonius: checks 
*** FLOP *** [Ks 6s Tc]
Klemtonius: checks 
dhduncan: checks 
color_singleton: checks 
manon327: bets 212
Klemtonius: folds 
dhduncan: folds 
color_singleton: calls 212
*** TURN *** [Ks 6s Tc] [Ad]
color_singleton: checks 
manon327: bets 413
color_singleton: folds 
Uncalled bet (413) returned to manon327
manon327 collected 826 from pot
*** SUMMARY ***
Total pot 874 | Rake 48 
Board [Ks 6s Tc Ad]
Seat 1: color_singleton folded on the Turn
Seat 2: manon327 (button) collected (826)
Seat 3: JeBoyDirk (small blind) folded before Flop
Seat 7: Klemtonius (big blind) folded on the Flop
Seat 9: dhduncan folded on the Flop



PokerStars Home Game Hand #223925544697: {DaPokaStars}  Hold'em No Limit (50/100) - 2021/02/17 15:26:45 ET
Table 'tonight again' 9-max (Play Money) Seat #3 is the button
Seat 1: color_singleton (7060 in chips) 
Seat 2: manon327 (10957 in chips) 
Seat 3: JeBoyDirk (15419 in chips) 
Seat 7: Klemtonius (12549 in chips) 
Seat 9: dhduncan (9018 in chips) 
Klemtonius: posts small blind 50
dhduncan: posts big blind 100
*** HOLE CARDS ***
Dealt to dhduncan [As 8c]
color_singleton: raises 200 to 300
manon327: folds 
JeBoyDirk: folds 
Klemtonius: raises 200 to 500
dhduncan: folds 
color_singleton: calls 200
*** FLOP *** [Td Kd 9c]
Klemtonius: checks 
color_singleton: bets 1039
Klemtonius: folds 
Uncalled bet (1039) returned to color_singleton
color_singleton collected 1039 from pot
color_singleton: doesn't show hand 
*** SUMMARY ***
Total pot 1100 | Rake 61 
Board [Td Kd 9c]
Seat 1: color_singleton collected (1039)
Seat 2: manon327 folded before Flop (didn't bet)
Seat 3: JeBoyDirk (button) folded before Flop (didn't bet)
Seat 7: Klemtonius (small blind) folded on the Flop
Seat 9: dhduncan (big blind) folded before Flop



PokerStars Home Game Hand #223925571721: {DaPokaStars}  Hold'em No Limit (50/100) - 2021/02/17 15:27:23 ET
Table 'tonight again' 9-max (Play Money) Seat #7 is the button
Seat 1: color_singleton (7599 in chips) 
Seat 2: manon327 (10957 in chips) 
Seat 3: JeBoyDirk (15419 in chips) 
Seat 7: Klemtonius (12049 in chips) 
Seat 9: dhduncan (8918 in chips) 
dhduncan: posts small blind 50
color_singleton: posts big blind 100
*** HOLE CARDS ***
Dealt to dhduncan [Kd Qd]
manon327: folds 
JeBoyDirk: folds 
Klemtonius: calls 100
dhduncan: calls 50
color_singleton: checks 
*** FLOP *** [8c 2h Qs]
dhduncan: bets 100
color_singleton: calls 100
Klemtonius: folds 
*** TURN *** [8c 2h Qs] [3d]
dhduncan: bets 100
color_singleton: raises 100 to 200
dhduncan: calls 100
*** RIVER *** [8c 2h Qs 3d] [4d]
dhduncan: bets 100
color_singleton: calls 100
*** SHOW DOWN ***
dhduncan: shows [Kd Qd] (a pair of Queens)
color_singleton: mucks hand 
dhduncan collected 1039 from pot
*** SUMMARY ***
Total pot 1100 | Rake 61 
Board [8c 2h Qs 3d 4d]
Seat 1: color_singleton (big blind) mucked [8h Ts]
Seat 2: manon327 folded before Flop (didn't bet)
Seat 3: JeBoyDirk folded before Flop (didn't bet)
Seat 7: Klemtonius (button) folded on the Flop
Seat 9: dhduncan (small blind) showed [Kd Qd] and won (1039) with a pair of Queens



PokerStars Home Game Hand #223925597099: {DaPokaStars}  Hold'em No Limit (50/100) - 2021/02/17 15:27:59 ET
Table 'tonight again' 9-max (Play Money) Seat #9 is the button
Seat 1: color_singleton (7099 in chips) 
Seat 2: manon327 (10957 in chips) 
Seat 3: JeBoyDirk (15419 in chips) 
Seat 7: Klemtonius (11949 in chips) 
Seat 9: dhduncan (9457 in chips) 
color_singleton: posts small blind 50
manon327: posts big blind 100
*** HOLE CARDS ***
Dealt to dhduncan [3d 7s]
JeBoyDirk: calls 100
Klemtonius: calls 100
dhduncan: folds 
color_singleton: folds 
manon327: checks 
*** FLOP *** [Jd 9c 8c]
manon327: checks 
JeBoyDirk: checks 
Klemtonius: bets 165
manon327: folds 
JeBoyDirk: calls 165
*** TURN *** [Jd 9c 8c] [4c]
JeBoyDirk: checks 
Klemtonius: bets 321
JeBoyDirk: folds 
Uncalled bet (321) returned to Klemtonius
Klemtonius collected 643 from pot
Klemtonius: doesn't show hand 
*** SUMMARY ***
Total pot 680 | Rake 37 
Board [Jd 9c 8c 4c]
Seat 1: color_singleton (small blind) folded before Flop
Seat 2: manon327 (big blind) folded on the Flop
Seat 3: JeBoyDirk folded on the Turn
Seat 7: Klemtonius collected (643)
Seat 9: dhduncan (button) folded before Flop (didn't bet)



PokerStars Home Game Hand #223925630261: {DaPokaStars}  Hold'em No Limit (50/100) - 2021/02/17 15:28:46 ET
Table 'tonight again' 9-max (Play Money) Seat #1 is the button
Seat 1: color_singleton (7049 in chips) 
Seat 2: manon327 (10857 in chips) 
Seat 3: JeBoyDirk (15154 in chips) 
Seat 7: Klemtonius (12327 in chips) 
Seat 9: dhduncan (9457 in chips) 
manon327: posts small blind 50
JeBoyDirk: posts big blind 100
*** HOLE CARDS ***
Dealt to dhduncan [Ad 4c]
Klemtonius: raises 100 to 200
dhduncan: calls 200
color_singleton: folds 
manon327: folds 
JeBoyDirk: folds 
*** FLOP *** [5d 9s 8d]
Klemtonius: checks 
dhduncan: checks 
*** TURN *** [5d 9s 8d] [9h]
Klemtonius: bets 520
dhduncan: folds 
Uncalled bet (520) returned to Klemtonius
Klemtonius collected 520 from pot
Klemtonius: doesn't show hand 
*** SUMMARY ***
Total pot 550 | Rake 30 
Board [5d 9s 8d 9h]
Seat 1: color_singleton (button) folded before Flop (didn't bet)
Seat 2: manon327 (small blind) folded before Flop
Seat 3: JeBoyDirk (big blind) folded before Flop
Seat 7: Klemtonius collected (520)
Seat 9: dhduncan folded on the Turn



PokerStars Home Game Hand #223925653257: {DaPokaStars}  Hold'em No Limit (50/100) - 2021/02/17 15:29:18 ET
Table 'tonight again' 9-max (Play Money) Seat #2 is the button
Seat 1: color_singleton (7049 in chips) 
Seat 2: manon327 (10807 in chips) 
Seat 3: JeBoyDirk (15054 in chips) 
Seat 7: Klemtonius (12647 in chips) 
Seat 9: dhduncan (9257 in chips) 
JeBoyDirk: posts small blind 50
Klemtonius: posts big blind 100
*** HOLE CARDS ***
Dealt to dhduncan [2d 3s]
dhduncan: folds 
color_singleton: folds 
manon327: folds 
JeBoyDirk: raises 200 to 300
Klemtonius: calls 200
*** FLOP *** [6d 3c Ks]
JeBoyDirk: bets 500
Klemtonius: folds 
Uncalled bet (500) returned to JeBoyDirk
JeBoyDirk collected 567 from pot
*** SUMMARY ***
Total pot 600 | Rake 33 
Board [6d 3c Ks]
Seat 1: color_singleton folded before Flop (didn't bet)
Seat 2: manon327 (button) folded before Flop (didn't bet)
Seat 3: JeBoyDirk (small blind) collected (567)
Seat 7: Klemtonius (big blind) folded on the Flop
Seat 9: dhduncan folded before Flop (didn't bet)



PokerStars Home Game Hand #223925682882: {DaPokaStars}  Hold'em No Limit (50/100) - 2021/02/17 15:30:00 ET
Table 'tonight again' 9-max (Play Money) Seat #3 is the button
Seat 1: color_singleton (7049 in chips) 
Seat 2: manon327 (10807 in chips) 
Seat 3: JeBoyDirk (15321 in chips) 
Seat 7: Klemtonius (12347 in chips) 
Seat 9: dhduncan (9257 in chips) 
Klemtonius: posts small blind 50
dhduncan: posts big blind 100
*** HOLE CARDS ***
Dealt to dhduncan [8d Jh]
color_singleton has timed out
color_singleton: folds 
manon327: folds 
JeBoyDirk: folds 
Klemtonius: calls 50
dhduncan: checks 
*** FLOP *** [6h 9d 4d]
Klemtonius: checks 
dhduncan: checks 
*** TURN *** [6h 9d 4d] [3c]
Klemtonius: bets 100
dhduncan: folds 
Uncalled bet (100) returned to Klemtonius
Klemtonius collected 189 from pot
Klemtonius: doesn't show hand 
*** SUMMARY ***
Total pot 200 | Rake 11 
Board [6h 9d 4d 3c]
Seat 1: color_singleton folded before Flop (didn't bet)
Seat 2: manon327 folded before Flop (didn't bet)
Seat 3: JeBoyDirk (button) folded before Flop (didn't bet)
Seat 7: Klemtonius (small blind) collected (189)
Seat 9: dhduncan (big blind) folded on the Turn



PokerStars Home Game Hand #223925715727: {DaPokaStars}  Hold'em No Limit (50/100) - 2021/02/17 15:30:47 ET
Table 'tonight again' 9-max (Play Money) Seat #7 is the button
Seat 1: color_singleton (7049 in chips) 
Seat 2: manon327 (10807 in chips) 
Seat 3: JeBoyDirk (15321 in chips) 
Seat 7: Klemtonius (12436 in chips) 
Seat 9: dhduncan (9157 in chips) 
dhduncan: posts small blind 50
color_singleton: posts big blind 100
*** HOLE CARDS ***
Dealt to dhduncan [9c 7h]
manon327: calls 100
JeBoyDirk: folds 
Klemtonius: calls 100
dhduncan: folds 
color_singleton: raises 200 to 300
manon327: folds 
Klemtonius: calls 200
*** FLOP *** [Th 8s Ac]
color_singleton: bets 354
Klemtonius: folds 
Uncalled bet (354) returned to color_singleton
color_singleton collected 709 from pot
color_singleton: doesn't show hand 
*** SUMMARY ***
Total pot 750 | Rake 41 
Board [Th 8s Ac]
Seat 1: color_singleton (big blind) collected (709)
Seat 2: manon327 folded before Flop
Seat 3: JeBoyDirk folded before Flop (didn't bet)
Seat 7: Klemtonius (button) folded on the Flop
Seat 9: dhduncan (small blind) folded before Flop



PokerStars Home Game Hand #223925743536: {DaPokaStars}  Hold'em No Limit (50/100) - 2021/02/17 15:31:26 ET
Table 'tonight again' 9-max (Play Money) Seat #9 is the button
Seat 1: color_singleton (7458 in chips) 
Seat 2: manon327 (10707 in chips) 
Seat 3: JeBoyDirk (15321 in chips) 
Seat 7: Klemtonius (12136 in chips) 
Seat 9: dhduncan (9107 in chips) 
color_singleton: posts small blind 50
manon327: posts big blind 100
*** HOLE CARDS ***
Dealt to dhduncan [Td 7d]
JeBoyDirk: folds 
Klemtonius: calls 100
dhduncan: calls 100
color_singleton: calls 50
manon327: checks 
*** FLOP *** [Qh Ts Qs]
color_singleton: checks 
manon327: checks 
Klemtonius: checks 
dhduncan: bets 100
color_singleton: folds 
manon327: folds 
Klemtonius: calls 100
*** TURN *** [Qh Ts Qs] [5c]
Klemtonius: checks 
dhduncan: checks 
*** RIVER *** [Qh Ts Qs 5c] [6c]
Klemtonius: checks 
dhduncan: bets 283
Klemtonius: folds 
Uncalled bet (283) returned to dhduncan
dhduncan collected 567 from pot
dhduncan: doesn't show hand 
*** SUMMARY ***
Total pot 600 | Rake 33 
Board [Qh Ts Qs 5c 6c]
Seat 1: color_singleton (small blind) folded on the Flop
Seat 2: manon327 (big blind) folded on the Flop
Seat 3: JeBoyDirk folded before Flop (didn't bet)
Seat 7: Klemtonius folded on the River
Seat 9: dhduncan (button) collected (567)



PokerStars Home Game Hand #223925787057: {DaPokaStars}  Hold'em No Limit (50/100) - 2021/02/17 15:32:29 ET
Table 'tonight again' 9-max (Play Money) Seat #1 is the button
Seat 1: color_singleton (7358 in chips) 
Seat 2: manon327 (10607 in chips) 
Seat 3: JeBoyDirk (15321 in chips) 
Seat 7: Klemtonius (11936 in chips) 
Seat 9: dhduncan (9474 in chips) 
manon327: posts small blind 50
JeBoyDirk: posts big blind 100
*** HOLE CARDS ***
Dealt to dhduncan [7c Kh]
Klemtonius: raises 250 to 350
dhduncan: calls 350
color_singleton: folds 
manon327: folds 
JeBoyDirk: folds 
*** FLOP *** [Ks 9s Jc]
Klemtonius: bets 401
dhduncan: calls 401
*** TURN *** [Ks 9s Jc] [7h]
Klemtonius: bets 1561
dhduncan: calls 1561
*** RIVER *** [Ks 9s Jc 7h] [3s]
Klemtonius: checks 
dhduncan: bets 100
Klemtonius: calls 100
*** SHOW DOWN ***
dhduncan: shows [7c Kh] (two pair, Kings and Sevens)
Klemtonius: mucks hand 
dhduncan collected 4700 from pot
*** SUMMARY ***
Total pot 4974 | Rake 274 
Board [Ks 9s Jc 7h 3s]
Seat 1: color_singleton (button) folded before Flop (didn't bet)
Seat 2: manon327 (small blind) folded before Flop
Seat 3: JeBoyDirk (big blind) folded before Flop
Seat 7: Klemtonius mucked [Qc Js]
Seat 9: dhduncan showed [7c Kh] and won (4700) with two pair, Kings and Sevens



PokerStars Home Game Hand #223925809744: {DaPokaStars}  Hold'em No Limit (50/100) - 2021/02/17 15:33:01 ET
Table 'tonight again' 9-max (Play Money) Seat #2 is the button
Seat 1: color_singleton (7358 in chips) 
Seat 2: manon327 (10557 in chips) 
Seat 3: JeBoyDirk (15221 in chips) 
Seat 7: Klemtonius (9524 in chips) 
Seat 9: dhduncan (11762 in chips) 
JeBoyDirk: posts small blind 50
Klemtonius: posts big blind 100
*** HOLE CARDS ***
Dealt to dhduncan [Td 9d]
dhduncan: calls 100
color_singleton: calls 100
manon327: folds 
JeBoyDirk: calls 50
Klemtonius: checks 
*** FLOP *** [9c 4c 6s]
JeBoyDirk: checks 
Klemtonius: checks 
dhduncan: checks 
color_singleton: checks 
*** TURN *** [9c 4c 6s] [Ac]
JeBoyDirk: checks 
Klemtonius: checks 
dhduncan: checks 
color_singleton: checks 
*** RIVER *** [9c 4c 6s Ac] [8h]
JeBoyDirk: checks 
Klemtonius: checks 
dhduncan: checks 
color_singleton: checks 
*** SHOW DOWN ***
JeBoyDirk: shows [Jd As] (a pair of Aces)
Klemtonius: mucks hand 
dhduncan: mucks hand 
color_singleton: mucks hand 
JeBoyDirk collected 378 from pot
*** SUMMARY ***
Total pot 400 | Rake 22 
Board [9c 4c 6s Ac 8h]
Seat 1: color_singleton mucked [Jh 5h]
Seat 2: manon327 (button) folded before Flop (didn't bet)
Seat 3: JeBoyDirk (small blind) showed [Jd As] and won (378) with a pair of Aces
Seat 7: Klemtonius (big blind) mucked [3h Ks]
Seat 9: dhduncan mucked [Td 9d]



PokerStars Home Game Hand #223925845110: {DaPokaStars}  Hold'em No Limit (50/100) - 2021/02/17 15:33:51 ET
Table 'tonight again' 9-max (Play Money) Seat #3 is the button
Seat 1: color_singleton (7258 in chips) 
Seat 2: manon327 (10557 in chips) 
Seat 3: JeBoyDirk (15499 in chips) 
Seat 7: Klemtonius (9424 in chips) 
Seat 9: dhduncan (11662 in chips) 
Klemtonius: posts small blind 50
dhduncan: posts big blind 100
*** HOLE CARDS ***
Dealt to dhduncan [3s Kd]
color_singleton: folds 
manon327: calls 100
JeBoyDirk: folds 
Klemtonius: calls 50
dhduncan: checks 
*** FLOP *** [2c 6s 5d]
Klemtonius: bets 100
dhduncan: folds 
manon327: calls 100
*** TURN *** [2c 6s 5d] [Td]
Klemtonius: checks 
manon327: checks 
*** RIVER *** [2c 6s 5d Td] [Qh]
Klemtonius: checks 
manon327: bets 236
Klemtonius: calls 236
*** SHOW DOWN ***
manon327: shows [Kh 5s] (a pair of Fives)
Klemtonius: mucks hand 
manon327 collected 919 from pot
*** SUMMARY ***
Total pot 972 | Rake 53 
Board [2c 6s 5d Td Qh]
Seat 1: color_singleton folded before Flop (didn't bet)
Seat 2: manon327 showed [Kh 5s] and won (919) with a pair of Fives
Seat 3: JeBoyDirk (button) folded before Flop (didn't bet)
Seat 7: Klemtonius (small blind) mucked [5c 9s]
Seat 9: dhduncan (big blind) folded on the Flop



PokerStars Home Game Hand #223925870087: {DaPokaStars}  Hold'em No Limit (50/100) - 2021/02/17 15:34:27 ET
Table 'tonight again' 9-max (Play Money) Seat #7 is the button
Seat 1: color_singleton (7258 in chips) 
Seat 2: manon327 (11040 in chips) 
Seat 3: JeBoyDirk (15499 in chips) 
Seat 7: Klemtonius (8988 in chips) 
Seat 9: dhduncan (11562 in chips) 
dhduncan: posts small blind 50
color_singleton: posts big blind 100
*** HOLE CARDS ***
Dealt to dhduncan [Ts 5d]
manon327: folds 
JeBoyDirk: folds 
Klemtonius: folds 
dhduncan: folds 
Uncalled bet (50) returned to color_singleton
color_singleton collected 100 from pot
color_singleton: doesn't show hand 
*** SUMMARY ***
Total pot 100 | Rake 0 
Seat 1: color_singleton (big blind) collected (100)
Seat 2: manon327 folded before Flop (didn't bet)
Seat 3: JeBoyDirk folded before Flop (didn't bet)
Seat 7: Klemtonius (button) folded before Flop (didn't bet)
Seat 9: dhduncan (small blind) folded before Flop



PokerStars Home Game Hand #223925880210: {DaPokaStars}  Hold'em No Limit (50/100) - 2021/02/17 15:34:41 ET
Table 'tonight again' 9-max (Play Money) Seat #9 is the button
Seat 1: color_singleton (7308 in chips) 
Seat 2: manon327 (11040 in chips) 
Seat 3: JeBoyDirk (15499 in chips) 
Seat 7: Klemtonius (8988 in chips) 
Seat 9: dhduncan (11512 in chips) 
color_singleton: posts small blind 50
manon327: posts big blind 100
*** HOLE CARDS ***
Dealt to dhduncan [6d 9h]
JeBoyDirk: folds 
Klemtonius: raises 250 to 350
dhduncan: folds 
color_singleton: folds 
manon327: folds 
Uncalled bet (250) returned to Klemtonius
Klemtonius collected 250 from pot
Klemtonius: doesn't show hand 
*** SUMMARY ***
Total pot 250 | Rake 0 
Seat 1: color_singleton (small blind) folded before Flop
Seat 2: manon327 (big blind) folded before Flop
Seat 3: JeBoyDirk folded before Flop (didn't bet)
Seat 7: Klemtonius collected (250)
Seat 9: dhduncan (button) folded before Flop (didn't bet)



PokerStars Home Game Hand #223925892370: {DaPokaStars}  Hold'em No Limit (50/100) - 2021/02/17 15:34:58 ET
Table 'tonight again' 9-max (Play Money) Seat #1 is the button
Seat 1: color_singleton (7258 in chips) 
Seat 2: manon327 (10940 in chips) 
Seat 3: JeBoyDirk (15499 in chips) 
Seat 7: Klemtonius (9138 in chips) 
Seat 9: dhduncan (11512 in chips) 
manon327: posts small blind 50
JeBoyDirk: posts big blind 100
*** HOLE CARDS ***
Dealt to dhduncan [6h 6d]
Klemtonius: folds 
dhduncan: calls 100
color_singleton: raises 200 to 300
manon327: folds 
JeBoyDirk: folds 
dhduncan: calls 200
*** FLOP *** [Kc 9d 5c]
dhduncan: checks 
color_singleton: checks 
*** TURN *** [Kc 9d 5c] [4c]
dhduncan: checks 
color_singleton: bets 354
dhduncan: folds 
Uncalled bet (354) returned to color_singleton
color_singleton collected 709 from pot
color_singleton: doesn't show hand 
*** SUMMARY ***
Total pot 750 | Rake 41 
Board [Kc 9d 5c 4c]
Seat 1: color_singleton (button) collected (709)
Seat 2: manon327 (small blind) folded before Flop
Seat 3: JeBoyDirk (big blind) folded before Flop
Seat 7: Klemtonius folded before Flop (didn't bet)
Seat 9: dhduncan folded on the Turn



PokerStars Home Game Hand #223925913076: {DaPokaStars}  Hold'em No Limit (50/100) - 2021/02/17 15:35:28 ET
Table 'tonight again' 9-max (Play Money) Seat #2 is the button
Seat 1: color_singleton (7667 in chips) 
Seat 2: manon327 (10890 in chips) 
Seat 3: JeBoyDirk (15399 in chips) 
Seat 7: Klemtonius (9138 in chips) 
Seat 9: dhduncan (11212 in chips) 
JeBoyDirk: posts small blind 50
Klemtonius: posts big blind 100
*** HOLE CARDS ***
Dealt to dhduncan [4d 3s]
dhduncan: folds 
color_singleton: raises 200 to 300
manon327: folds 
JeBoyDirk: folds 
Klemtonius: calls 200
*** FLOP *** [Kc 7h 2c]
Klemtonius: bets 307
color_singleton: calls 307
*** TURN *** [Kc 7h 2c] [5d]
Klemtonius: bets 597
color_singleton: calls 597
*** RIVER *** [Kc 7h 2c 5d] [9c]
Klemtonius: checks 
color_singleton: bets 1161
Klemtonius: folds 
Uncalled bet (1161) returned to color_singleton
color_singleton collected 2323 from pot
color_singleton: doesn't show hand 
*** SUMMARY ***
Total pot 2458 | Rake 135 
Board [Kc 7h 2c 5d 9c]
Seat 1: color_singleton collected (2323)
Seat 2: manon327 (button) folded before Flop (didn't bet)
Seat 3: JeBoyDirk (small blind) folded before Flop
Seat 7: Klemtonius (big blind) folded on the River
Seat 9: dhduncan folded before Flop (didn't bet)



PokerStars Home Game Hand #223925942888: {DaPokaStars}  Hold'em No Limit (50/100) - 2021/02/17 15:36:10 ET
Table 'tonight again' 9-max (Play Money) Seat #3 is the button
Seat 1: color_singleton (8786 in chips) 
Seat 2: manon327 (10890 in chips) 
Seat 3: JeBoyDirk (15349 in chips) 
Seat 7: Klemtonius (7934 in chips) 
Seat 9: dhduncan (11212 in chips) 
Klemtonius: posts small blind 50
dhduncan: posts big blind 100
*** HOLE CARDS ***
Dealt to dhduncan [Kc Kh]
color_singleton: folds 
manon327: folds 
JeBoyDirk: folds 
Klemtonius: calls 50
dhduncan: raises 100 to 200
Klemtonius: raises 100 to 300
dhduncan: raises 100 to 400
Klemtonius: raises 100 to 500
dhduncan: raises 100 to 600
Klemtonius: calls 100
*** FLOP *** [8s 6c Jc]
Klemtonius: bets 1134
dhduncan: raises 3402 to 4536
Klemtonius: calls 3402
*** TURN *** [8s 6c Jc] [5c]
Klemtonius: checks 
dhduncan: bets 6076 and is all-in
manon327 is disconnected 
Klemtonius: folds 
Uncalled bet (6076) returned to dhduncan
dhduncan collected 9707 from pot
dhduncan: doesn't show hand 
*** SUMMARY ***
Total pot 10272 | Rake 565 
Board [8s 6c Jc 5c]
Seat 1: color_singleton folded before Flop (didn't bet)
Seat 2: manon327 folded before Flop (didn't bet)
Seat 3: JeBoyDirk (button) folded before Flop (didn't bet)
Seat 7: Klemtonius (small blind) folded on the Turn
Seat 9: dhduncan (big blind) collected (9707)



PokerStars Home Game Hand #223925988827: {DaPokaStars}  Hold'em No Limit (50/100) - 2021/02/17 15:37:12 ET
Table 'tonight again' 9-max (Play Money) Seat #7 is the button
Seat 1: color_singleton (8786 in chips) 
Seat 2: manon327 (10890 in chips) 
Seat 3: JeBoyDirk (15349 in chips) 
Seat 7: Klemtonius (2798 in chips) 
Seat 9: dhduncan (15783 in chips) 
dhduncan: posts small blind 50
color_singleton: posts big blind 100
*** HOLE CARDS ***
Dealt to dhduncan [As Qs]
manon327 has timed out while disconnected
manon327: folds 
JeBoyDirk: folds 
Klemtonius: folds 
dhduncan: calls 50
color_singleton: raises 200 to 300
dhduncan: calls 200
*** FLOP *** [6d Kh 5s]
dhduncan: checks 
color_singleton: bets 283
dhduncan: folds 
Uncalled bet (283) returned to color_singleton
color_singleton collected 567 from pot
color_singleton: doesn't show hand 
*** SUMMARY ***
Total pot 600 | Rake 33 
Board [6d Kh 5s]
Seat 1: color_singleton (big blind) collected (567)
Seat 2: manon327 folded before Flop (didn't bet)
Seat 3: JeBoyDirk folded before Flop (didn't bet)
Seat 7: Klemtonius (button) folded before Flop (didn't bet)
Seat 9: dhduncan (small blind) folded on the Flop



PokerStars Home Game Hand #223926017482: {DaPokaStars}  Hold'em No Limit (50/100) - 2021/02/17 15:37:53 ET
Table 'tonight again' 9-max (Play Money) Seat #9 is the button
Seat 1: color_singleton (9053 in chips) 
Seat 2: manon327 (10890 in chips) 
Seat 3: JeBoyDirk (15349 in chips) 
Seat 7: Klemtonius (2798 in chips) 
Seat 9: dhduncan (15483 in chips) 
color_singleton: posts small blind 50
manon327: posts big blind 100
*** HOLE CARDS ***
Dealt to dhduncan [7d 9c]
JeBoyDirk: calls 100
Klemtonius: calls 100
dhduncan: folds 
color_singleton: raises 200 to 300
manon327: calls 200
JeBoyDirk: calls 200
Klemtonius: calls 200
*** FLOP *** [Qh Jh 6s]
color_singleton: checks 
manon327: checks 
JeBoyDirk: checks 
Klemtonius: checks 
*** TURN *** [Qh Jh 6s] [2d]
color_singleton: checks 
manon327: checks 
JeBoyDirk: checks 
Klemtonius: checks 
*** RIVER *** [Qh Jh 6s 2d] [Kh]
color_singleton: checks 
manon327: bets 1134
JeBoyDirk: folds 
Klemtonius: folds 
color_singleton: folds 
Uncalled bet (1134) returned to manon327
manon327 collected 1134 from pot
*** SUMMARY ***
Total pot 1200 | Rake 66 
Board [Qh Jh 6s 2d Kh]
Seat 1: color_singleton (small blind) folded on the River
Seat 2: manon327 (big blind) collected (1134)
Seat 3: JeBoyDirk folded on the River
Seat 7: Klemtonius folded on the River
Seat 9: dhduncan (button) folded before Flop (didn't bet)



PokerStars Home Game Hand #223926074097: {DaPokaStars}  Hold'em No Limit (50/100) - 2021/02/17 15:39:05 ET
Table 'tonight again' 9-max (Play Money) Seat #1 is the button
Seat 1: color_singleton (8753 in chips) 
Seat 2: manon327 (11724 in chips) 
Seat 3: JeBoyDirk (15049 in chips) 
Seat 7: Klemtonius (2498 in chips) 
Seat 9: dhduncan (15483 in chips) 
manon327: posts small blind 50
JeBoyDirk: posts big blind 100
*** HOLE CARDS ***
Dealt to dhduncan [Jc 9h]
Klemtonius: calls 100
dhduncan: calls 100
color_singleton: folds 
manon327: calls 50
JeBoyDirk: checks 
*** FLOP *** [9c Ac Tc]
manon327: bets 378
JeBoyDirk: folds 
Klemtonius: calls 378
dhduncan: folds 
*** TURN *** [9c Ac Tc] [3h]
manon327: bets 1092
Klemtonius: calls 1092
*** RIVER *** [9c Ac Tc 3h] [Jh]
manon327: checks 
Klemtonius: bets 928 and is all-in
manon327: calls 928
*** SHOW DOWN ***
Klemtonius: shows [4c 6h] (high card Ace)
manon327: shows [Ah 6s] (a pair of Aces)
manon327 collected 4910 from pot
*** SUMMARY ***
Total pot 5196 | Rake 286 
Board [9c Ac Tc 3h Jh]
Seat 1: color_singleton (button) folded before Flop (didn't bet)
Seat 2: manon327 (small blind) showed [Ah 6s] and won (4910) with a pair of Aces
Seat 3: JeBoyDirk (big blind) folded on the Flop
Seat 7: Klemtonius showed [4c 6h] and lost with high card Ace
Seat 9: dhduncan folded on the Flop



PokerStars Home Game Hand #223926118888: {DaPokaStars}  Hold'em No Limit (50/100) - 2021/02/17 15:40:09 ET
Table 'tonight again' 9-max (Play Money) Seat #2 is the button
Seat 1: color_singleton (8753 in chips) 
Seat 2: manon327 (14136 in chips) 
Seat 3: JeBoyDirk (14949 in chips) 
Seat 9: dhduncan (15383 in chips) 
JeBoyDirk: posts small blind 50
dhduncan: posts big blind 100
*** HOLE CARDS ***
Dealt to dhduncan [Jd 3h]
color_singleton has timed out
color_singleton: folds 
manon327: calls 100
JeBoyDirk: folds 
dhduncan: checks 
*** FLOP *** [8d Ah 8h]
dhduncan: checks 
manon327: bets 118
dhduncan: folds 
Uncalled bet (118) returned to manon327
manon327 collected 236 from pot
*** SUMMARY ***
Total pot 250 | Rake 14 
Board [8d Ah 8h]
Seat 1: color_singleton folded before Flop (didn't bet)
Seat 2: manon327 (button) collected (236)
Seat 3: JeBoyDirk (small blind) folded before Flop
Seat 9: dhduncan (big blind) folded on the Flop



PokerStars Home Game Hand #223926142731: {DaPokaStars}  Hold'em No Limit (50/100) - 2021/02/17 15:40:43 ET
Table 'tonight again' 9-max (Play Money) Seat #3 is the button
Seat 2: manon327 (14272 in chips) 
Seat 3: JeBoyDirk (14899 in chips) 
Seat 9: dhduncan (15283 in chips) 
dhduncan: posts small blind 50
manon327: posts big blind 100
*** HOLE CARDS ***
Dealt to dhduncan [Td 8h]
JeBoyDirk: folds 
dhduncan: folds 
Uncalled bet (50) returned to manon327
manon327 collected 100 from pot
*** SUMMARY ***
Total pot 100 | Rake 0 
Seat 2: manon327 (big blind) collected (100)
Seat 3: JeBoyDirk (button) folded before Flop (didn't bet)
Seat 9: dhduncan (small blind) folded before Flop



PokerStars Home Game Hand #223926148353: {DaPokaStars}  Hold'em No Limit (50/100) - 2021/02/17 15:40:51 ET
Table 'tonight again' 9-max (Play Money) Seat #9 is the button
Seat 2: manon327 (14322 in chips) 
Seat 3: JeBoyDirk (14899 in chips) 
Seat 9: dhduncan (15233 in chips) 
manon327: posts small blind 50
JeBoyDirk: posts big blind 100
*** HOLE CARDS ***
Dealt to dhduncan [9s 2c]
dhduncan: folds 
manon327: raises 100 to 200
JeBoyDirk: calls 100
*** FLOP *** [8c 4h As]
manon327: bets 189
JeBoyDirk: folds 
Uncalled bet (189) returned to manon327
manon327 collected 378 from pot
*** SUMMARY ***
Total pot 400 | Rake 22 
Board [8c 4h As]
Seat 2: manon327 (small blind) collected (378)
Seat 3: JeBoyDirk (big blind) folded on the Flop
Seat 9: dhduncan (button) folded before Flop (didn't bet)



PokerStars Home Game Hand #223926161488: {DaPokaStars}  Hold'em No Limit (50/100) - 2021/02/17 15:41:09 ET
Table 'tonight again' 9-max (Play Money) Seat #2 is the button
Seat 2: manon327 (14500 in chips) 
Seat 3: JeBoyDirk (14699 in chips) 
Seat 9: dhduncan (15233 in chips) 
JeBoyDirk: posts small blind 50
dhduncan: posts big blind 100
*** HOLE CARDS ***
Dealt to dhduncan [Qh 9s]
manon327: folds 
JeBoyDirk: folds 
Uncalled bet (50) returned to dhduncan
dhduncan collected 100 from pot
dhduncan: doesn't show hand 
*** SUMMARY ***
Total pot 100 | Rake 0 
Seat 2: manon327 (button) folded before Flop (didn't bet)
Seat 3: JeBoyDirk (small blind) folded before Flop
Seat 9: dhduncan (big blind) collected (100)



PokerStars Home Game Hand #223926167094: {DaPokaStars}  Hold'em No Limit (50/100) - 2021/02/17 15:41:17 ET
Table 'tonight again' 9-max (Play Money) Seat #3 is the button
Seat 1: color_singleton (8753 in chips) 
Seat 2: manon327 (14500 in chips) 
Seat 3: JeBoyDirk (14649 in chips) 
Seat 9: dhduncan (15283 in chips) 
dhduncan: posts small blind 50
color_singleton: posts big blind 100
*** HOLE CARDS ***
Dealt to dhduncan [Th 9h]
manon327: folds 
JeBoyDirk: calls 100
dhduncan: calls 50
color_singleton: checks 
*** FLOP *** [3c 4h 3s]
dhduncan: checks 
color_singleton: bets 283
JeBoyDirk: folds 
dhduncan: calls 283
*** TURN *** [3c 4h 3s] [3d]
dhduncan: checks 
color_singleton: bets 818
dhduncan: folds 
Uncalled bet (818) returned to color_singleton
color_singleton collected 818 from pot
color_singleton: doesn't show hand 
*** SUMMARY ***
Total pot 866 | Rake 48 
Board [3c 4h 3s 3d]
Seat 1: color_singleton (big blind) collected (818)
Seat 2: manon327 folded before Flop (didn't bet)
Seat 3: JeBoyDirk (button) folded on the Flop
Seat 9: dhduncan (small blind) folded on the Turn



PokerStars Home Game Hand #223926202035: {DaPokaStars}  Hold'em No Limit (50/100) - 2021/02/17 15:42:01 ET
Table 'tonight again' 9-max (Play Money) Seat #9 is the button
Seat 1: color_singleton (9188 in chips) 
Seat 2: manon327 (14500 in chips) 
Seat 3: JeBoyDirk (14549 in chips) 
Seat 7: Klemtonius (10000 in chips) 
Seat 9: dhduncan (14900 in chips) 
color_singleton: posts small blind 50
manon327: posts big blind 100
Klemtonius: posts small & big blinds 150
*** HOLE CARDS ***
Dealt to dhduncan [2s 7c]
JeBoyDirk: folds 
Klemtonius: checks 
dhduncan: folds 
color_singleton: calls 50
manon327: checks 
*** FLOP *** [Kc 9c 9d]
color_singleton: checks 
manon327: checks 
Klemtonius: checks 
*** TURN *** [Kc 9c 9d] [6c]
color_singleton: checks 
manon327: checks 
Klemtonius: bets 331
color_singleton: folds 
manon327: folds 
Uncalled bet (331) returned to Klemtonius
Klemtonius collected 331 from pot
Klemtonius: doesn't show hand 
*** SUMMARY ***
Total pot 350 | Rake 19 
Board [Kc 9c 9d 6c]
Seat 1: color_singleton (small blind) folded on the Turn
Seat 2: manon327 (big blind) folded on the Turn
Seat 3: JeBoyDirk folded before Flop (didn't bet)
Seat 7: Klemtonius collected (331)
Seat 9: dhduncan (button) folded before Flop (didn't bet)



PokerStars Home Game Hand #223926250149: {DaPokaStars}  Hold'em No Limit (50/100) - 2021/02/17 15:43:09 ET
Table 'tonight again' 9-max (Play Money) Seat #1 is the button
Seat 1: color_singleton (9088 in chips) 
Seat 2: manon327 (14400 in chips) 
Seat 3: JeBoyDirk (14549 in chips) 
Seat 7: Klemtonius (10181 in chips) 
Seat 9: dhduncan (14900 in chips) 
manon327: posts small blind 50
JeBoyDirk: posts big blind 100
*** HOLE CARDS ***
Dealt to dhduncan [9d 6s]
Klemtonius: calls 100
dhduncan: folds 
color_singleton: calls 100
manon327 has timed out
manon327: folds 
JeBoyDirk: checks 
*** FLOP *** [2s 8h 3d]
JeBoyDirk: checks 
Klemtonius: bets 100
color_singleton: raises 200 to 300
JeBoyDirk: folds 
Klemtonius: calls 200
*** TURN *** [2s 8h 3d] [Jh]
Klemtonius: checks 
color_singleton: checks 
*** RIVER *** [2s 8h 3d Jh] [7d]
Klemtonius: checks 
color_singleton: checks 
*** SHOW DOWN ***
Klemtonius: shows [3s Qd] (a pair of Threes)
color_singleton: shows [Tc 8c] (a pair of Eights)
color_singleton collected 898 from pot
*** SUMMARY ***
Total pot 950 | Rake 52 
Board [2s 8h 3d Jh 7d]
Seat 1: color_singleton (button) showed [Tc 8c] and won (898) with a pair of Eights
Seat 2: manon327 (small blind) folded before Flop
Seat 3: JeBoyDirk (big blind) folded on the Flop
Seat 7: Klemtonius showed [3s Qd] and lost with a pair of Threes
Seat 9: dhduncan folded before Flop (didn't bet)



PokerStars Home Game Hand #223926296913: {DaPokaStars}  Hold'em No Limit (50/100) - 2021/02/17 15:44:17 ET
Table 'tonight again' 9-max (Play Money) Seat #2 is the button
Seat 1: color_singleton (9586 in chips) 
Seat 2: manon327 (14350 in chips) 
Seat 3: JeBoyDirk (14449 in chips) 
Seat 7: Klemtonius (9781 in chips) 
Seat 9: dhduncan (14900 in chips) 
JeBoyDirk: posts small blind 50
Klemtonius: posts big blind 100
*** HOLE CARDS ***
Dealt to dhduncan [Qd 5c]
dhduncan: folds 
color_singleton: folds 
manon327 is connected 
manon327 has timed out
manon327: folds 
JeBoyDirk: folds 
Uncalled bet (50) returned to Klemtonius
Klemtonius collected 100 from pot
Klemtonius: doesn't show hand 
*** SUMMARY ***
Total pot 100 | Rake 0 
Seat 1: color_singleton folded before Flop (didn't bet)
Seat 2: manon327 (button) folded before Flop (didn't bet)
Seat 3: JeBoyDirk (small blind) folded before Flop
Seat 7: Klemtonius (big blind) collected (100)
Seat 9: dhduncan folded before Flop (didn't bet)



PokerStars Home Game Hand #223926319811: {DaPokaStars}  Hold'em No Limit (50/100) - 2021/02/17 15:44:50 ET
Table 'tonight again' 9-max (Play Money) Seat #3 is the button
Seat 1: color_singleton (9586 in chips) 
Seat 3: JeBoyDirk (14399 in chips) 
Seat 7: Klemtonius (9831 in chips) 
Seat 9: dhduncan (14900 in chips) 
Klemtonius: posts small blind 50
dhduncan: posts big blind 100
*** HOLE CARDS ***
Dealt to dhduncan [2h 3d]
color_singleton: folds 
JeBoyDirk: raises 200 to 300
Klemtonius: folds 
dhduncan: folds 
Uncalled bet (200) returned to JeBoyDirk
JeBoyDirk collected 250 from pot
*** SUMMARY ***
Total pot 250 | Rake 0 
Seat 1: color_singleton folded before Flop (didn't bet)
Seat 3: JeBoyDirk (button) collected (250)
Seat 7: Klemtonius (small blind) folded before Flop
Seat 9: dhduncan (big blind) folded before Flop



PokerStars Home Game Hand #223926325752: {DaPokaStars}  Hold'em No Limit (50/100) - 2021/02/17 15:44:59 ET
Table 'tonight again' 9-max (Play Money) Seat #7 is the button
Seat 1: color_singleton (9586 in chips) 
Seat 2: manon327 (14350 in chips) 
Seat 3: JeBoyDirk (14549 in chips) 
Seat 7: Klemtonius (9781 in chips) 
Seat 9: dhduncan (14800 in chips) 
dhduncan: posts small blind 50
color_singleton: posts big blind 100
*** HOLE CARDS ***
Dealt to dhduncan [Jh Ah]
manon327: folds 
JeBoyDirk: folds 
Klemtonius: calls 100
dhduncan: calls 50
color_singleton: raises 200 to 300
Klemtonius: calls 200
dhduncan: calls 200
*** FLOP *** [8h 3h 8s]
dhduncan: checks 
color_singleton: bets 425
Klemtonius: calls 425
dhduncan: calls 425
*** TURN *** [8h 3h 8s] [7d]
dhduncan: checks 
color_singleton: bets 1300
Klemtonius: folds 
dhduncan: folds 
Uncalled bet (1300) returned to color_singleton
color_singleton collected 2055 from pot
color_singleton: doesn't show hand 
*** SUMMARY ***
Total pot 2175 | Rake 120 
Board [8h 3h 8s 7d]
Seat 1: color_singleton (big blind) collected (2055)
Seat 2: manon327 folded before Flop (didn't bet)
Seat 3: JeBoyDirk folded before Flop (didn't bet)
Seat 7: Klemtonius (button) folded on the Turn
Seat 9: dhduncan (small blind) folded on the Turn



PokerStars Home Game Hand #223926359780: {DaPokaStars}  Hold'em No Limit (50/100) - 2021/02/17 15:45:48 ET
Table 'tonight again' 9-max (Play Money) Seat #9 is the button
Seat 1: color_singleton (10916 in chips) 
Seat 2: manon327 (14350 in chips) 
Seat 3: JeBoyDirk (14549 in chips) 
Seat 7: Klemtonius (9056 in chips) 
Seat 9: dhduncan (14075 in chips) 
color_singleton: posts small blind 50
manon327: posts big blind 100
*** HOLE CARDS ***
Dealt to dhduncan [Th 2h]
JeBoyDirk: folds 
Klemtonius: calls 100
dhduncan: folds 
color_singleton: raises 100 to 200
manon327: calls 100
Klemtonius: calls 100
*** FLOP *** [As 5h Jd]
color_singleton: bets 283
manon327 has timed out
manon327: folds 
Klemtonius: folds 
Uncalled bet (283) returned to color_singleton
color_singleton collected 567 from pot
color_singleton: doesn't show hand 
*** SUMMARY ***
Total pot 600 | Rake 33 
Board [As 5h Jd]
Seat 1: color_singleton (small blind) collected (567)
Seat 2: manon327 (big blind) folded on the Flop
Seat 3: JeBoyDirk folded before Flop (didn't bet)
Seat 7: Klemtonius folded on the Flop
Seat 9: dhduncan (button) folded before Flop (didn't bet)



PokerStars Home Game Hand #223926396815: {DaPokaStars}  Hold'em No Limit (50/100) - 2021/02/17 15:46:41 ET
Table 'tonight again' 9-max (Play Money) Seat #1 is the button
Seat 1: color_singleton (11283 in chips) 
Seat 3: JeBoyDirk (14549 in chips) 
Seat 7: Klemtonius (8856 in chips) 
Seat 9: dhduncan (14075 in chips) 
JeBoyDirk: posts small blind 50
Klemtonius: posts big blind 100
*** HOLE CARDS ***
Dealt to dhduncan [Kd Tc]
dhduncan: calls 100
color_singleton: raises 200 to 300
JeBoyDirk: folds 
Klemtonius: folds 
dhduncan: calls 200
*** FLOP *** [Ks 3d 5h]
dhduncan: bets 354
color_singleton: calls 354
*** TURN *** [Ks 3d 5h] [6s]
dhduncan: checks 
color_singleton: bets 689
dhduncan: calls 689
*** RIVER *** [Ks 3d 5h 6s] [Ts]
dhduncan: checks 
color_singleton: checks 
*** SHOW DOWN ***
dhduncan: shows [Kd Tc] (two pair, Kings and Tens)
color_singleton: mucks hand 
dhduncan collected 2680 from pot
*** SUMMARY ***
Total pot 2836 | Rake 156 
Board [Ks 3d 5h 6s Ts]
Seat 1: color_singleton (button) mucked [Kc Qh]
Seat 3: JeBoyDirk (small blind) folded before Flop
Seat 7: Klemtonius (big blind) folded before Flop
Seat 9: dhduncan showed [Kd Tc] and won (2680) with two pair, Kings and Tens



PokerStars Home Game Hand #223926427881: {DaPokaStars}  Hold'em No Limit (50/100) - 2021/02/17 15:47:26 ET
Table 'tonight again' 9-max (Play Money) Seat #3 is the button
Seat 1: color_singleton (9940 in chips) 
Seat 2: manon327 (14150 in chips) 
Seat 3: JeBoyDirk (14499 in chips) 
Seat 7: Klemtonius (8756 in chips) 
Seat 9: dhduncan (15412 in chips) 
Klemtonius: posts small blind 50
dhduncan: posts big blind 100
manon327: posts small blind 50
*** HOLE CARDS ***
Dealt to dhduncan [Td 4h]
color_singleton: raises 200 to 300
manon327: folds 
JeBoyDirk: folds 
Klemtonius: folds 
dhduncan: folds 
Uncalled bet (200) returned to color_singleton
color_singleton collected 300 from pot
color_singleton: doesn't show hand 
*** SUMMARY ***
Total pot 300 | Rake 0 
Seat 1: color_singleton collected (300)
Seat 2: manon327 folded before Flop (didn't bet)
Seat 3: JeBoyDirk (button) folded before Flop (didn't bet)
Seat 7: Klemtonius (small blind) folded before Flop
Seat 9: dhduncan (big blind) folded before Flop



PokerStars Home Game Hand #223926436405: {DaPokaStars}  Hold'em No Limit (50/100) - 2021/02/17 15:47:38 ET
Table 'tonight again' 9-max (Play Money) Seat #7 is the button
Seat 1: color_singleton (10140 in chips) 
Seat 2: manon327 (14100 in chips) 
Seat 3: JeBoyDirk (14499 in chips) 
Seat 7: Klemtonius (8706 in chips) 
Seat 9: dhduncan (15312 in chips) 
dhduncan: posts small blind 50
color_singleton: posts big blind 100
*** HOLE CARDS ***
Dealt to dhduncan [3d Jd]
manon327: calls 100
JeBoyDirk: folds 
Klemtonius: calls 100
dhduncan: calls 50
color_singleton: checks 
*** FLOP *** [8d Qc 2h]
dhduncan: checks 
color_singleton: bets 189
manon327: folds 
Klemtonius: calls 189
dhduncan: folds 
*** TURN *** [8d Qc 2h] [5d]
color_singleton: bets 735
Klemtonius: folds 
Uncalled bet (735) returned to color_singleton
color_singleton collected 735 from pot
color_singleton: doesn't show hand 
*** SUMMARY ***
Total pot 778 | Rake 43 
Board [8d Qc 2h 5d]
Seat 1: color_singleton (big blind) collected (735)
Seat 2: manon327 folded on the Flop
Seat 3: JeBoyDirk folded before Flop (didn't bet)
Seat 7: Klemtonius (button) folded on the Turn
Seat 9: dhduncan (small blind) folded on the Flop



PokerStars Home Game Hand #223926474220: {DaPokaStars}  Hold'em No Limit (50/100) - 2021/02/17 15:48:32 ET
Table 'tonight again' 9-max (Play Money) Seat #9 is the button
Seat 1: color_singleton (10586 in chips) 
Seat 2: manon327 (14000 in chips) 
Seat 3: JeBoyDirk (14499 in chips) 
Seat 7: Klemtonius (8417 in chips) 
Seat 9: dhduncan (15212 in chips) 
color_singleton: posts small blind 50
manon327: posts big blind 100
*** HOLE CARDS ***
Dealt to dhduncan [Kd 5c]
JeBoyDirk: folds 
Klemtonius: calls 100
dhduncan: calls 100
color_singleton: calls 50
manon327: checks 
*** FLOP *** [3h Jd Ad]
color_singleton: checks 
manon327: checks 
Klemtonius: checks 
dhduncan: checks 
*** TURN *** [3h Jd Ad] [Ts]
color_singleton: checks 
manon327: checks 
Klemtonius: checks 
dhduncan: checks 
*** RIVER *** [3h Jd Ad Ts] [Td]
color_singleton: checks 
manon327: checks 
Klemtonius: checks 
dhduncan: checks 
*** SHOW DOWN ***
color_singleton: shows [6s Ks] (a pair of Tens)
manon327: mucks hand 
Klemtonius: mucks hand 
dhduncan: shows [Kd 5c] (a pair of Tens)
color_singleton collected 189 from pot
dhduncan collected 189 from pot
*** SUMMARY ***
Total pot 400 | Rake 22 
Board [3h Jd Ad Ts Td]
Seat 1: color_singleton (small blind) showed [6s Ks] and won (189) with a pair of Tens
Seat 2: manon327 (big blind) mucked [Qs 5s]
Seat 3: JeBoyDirk folded before Flop (didn't bet)
Seat 7: Klemtonius mucked [6h 5h]
Seat 9: dhduncan (button) showed [Kd 5c] and won (189) with a pair of Tens



PokerStars Home Game Hand #223926510535: {DaPokaStars}  Hold'em No Limit (50/100) - 2021/02/17 15:49:25 ET
Table 'tonight again' 9-max (Play Money) Seat #1 is the button
Seat 1: color_singleton (10675 in chips) 
Seat 2: manon327 (13900 in chips) 
Seat 3: JeBoyDirk (14499 in chips) 
Seat 7: Klemtonius (8317 in chips) 
Seat 9: dhduncan (15301 in chips) 
manon327: posts small blind 50
JeBoyDirk: posts big blind 100
*** HOLE CARDS ***
Dealt to dhduncan [Qs 6s]
Klemtonius: calls 100
dhduncan: calls 100
color_singleton: folds 
manon327: folds 
JeBoyDirk: raises 200 to 300
Klemtonius: folds 
dhduncan: folds 
Uncalled bet (200) returned to JeBoyDirk
JeBoyDirk collected 350 from pot
*** SUMMARY ***
Total pot 350 | Rake 0 
Seat 1: color_singleton (button) folded before Flop (didn't bet)
Seat 2: manon327 (small blind) folded before Flop
Seat 3: JeBoyDirk (big blind) collected (350)
Seat 7: Klemtonius folded before Flop
Seat 9: dhduncan folded before Flop



PokerStars Home Game Hand #223926537367: {DaPokaStars}  Hold'em No Limit (50/100) - 2021/02/17 15:50:03 ET
Table 'tonight again' 9-max (Play Money) Seat #2 is the button
Seat 1: color_singleton (10675 in chips) 
Seat 2: manon327 (13850 in chips) 
Seat 3: JeBoyDirk (14749 in chips) 
Seat 7: Klemtonius (8217 in chips) 
Seat 9: dhduncan (15201 in chips) 
JeBoyDirk: posts small blind 50
Klemtonius: posts big blind 100
*** HOLE CARDS ***
Dealt to dhduncan [4s Tc]
dhduncan: folds 
color_singleton: calls 100
manon327: calls 100
JeBoyDirk: calls 50
Klemtonius: checks 
*** FLOP *** [Ac Qc 3s]
JeBoyDirk: checks 
Klemtonius: checks 
color_singleton: checks 
manon327: checks 
*** TURN *** [Ac Qc 3s] [8s]
JeBoyDirk: checks 
Klemtonius: checks 
color_singleton: checks 
manon327: checks 
*** RIVER *** [Ac Qc 3s 8s] [Jc]
JeBoyDirk: bets 100
Klemtonius: calls 100
color_singleton: calls 100
manon327: folds 
*** SHOW DOWN ***
JeBoyDirk: shows [7c 9c] (a flush, Ace high)
Klemtonius: mucks hand 
color_singleton: mucks hand 
JeBoyDirk collected 661 from pot
*** SUMMARY ***
Total pot 700 | Rake 39 
Board [Ac Qc 3s 8s Jc]
Seat 1: color_singleton mucked [3h 9h]
Seat 2: manon327 (button) folded on the River
Seat 3: JeBoyDirk (small blind) showed [7c 9c] and won (661) with a flush, Ace high
Seat 7: Klemtonius (big blind) mucked [2h Qd]
Seat 9: dhduncan folded before Flop (didn't bet)



PokerStars Home Game Hand #223926578587: {DaPokaStars}  Hold'em No Limit (50/100) - 2021/02/17 15:51:02 ET
Table 'tonight again' 9-max (Play Money) Seat #3 is the button
Seat 1: color_singleton (10475 in chips) 
Seat 2: manon327 (13750 in chips) 
Seat 3: JeBoyDirk (15210 in chips) 
Seat 7: Klemtonius (8017 in chips) 
Seat 9: dhduncan (15201 in chips) 
Klemtonius: posts small blind 50
dhduncan: posts big blind 100
*** HOLE CARDS ***
Dealt to dhduncan [3d 6c]
color_singleton: folds 
manon327: folds 
JeBoyDirk: folds 
Klemtonius: raises 100 to 200
dhduncan: folds 
Uncalled bet (100) returned to Klemtonius
Klemtonius collected 200 from pot
Klemtonius: doesn't show hand 
*** SUMMARY ***
Total pot 200 | Rake 0 
Seat 1: color_singleton folded before Flop (didn't bet)
Seat 2: manon327 folded before Flop (didn't bet)
Seat 3: JeBoyDirk (button) folded before Flop (didn't bet)
Seat 7: Klemtonius (small blind) collected (200)
Seat 9: dhduncan (big blind) folded before Flop



PokerStars Home Game Hand #223926590521: {DaPokaStars}  Hold'em No Limit (50/100) - 2021/02/17 15:51:19 ET
Table 'tonight again' 9-max (Play Money) Seat #7 is the button
Seat 1: color_singleton (10475 in chips) 
Seat 2: manon327 (13750 in chips) 
Seat 3: JeBoyDirk (15210 in chips) 
Seat 7: Klemtonius (8117 in chips) 
Seat 9: dhduncan (15101 in chips) 
dhduncan: posts small blind 50
color_singleton: posts big blind 100
*** HOLE CARDS ***
Dealt to dhduncan [8c 2c]
manon327: folds 
JeBoyDirk: folds 
Klemtonius: raises 100 to 200
dhduncan: calls 150
color_singleton: calls 100
*** FLOP *** [9h 3h 8h]
dhduncan: checks 
color_singleton: checks 
Klemtonius: checks 
*** TURN *** [9h 3h 8h] [2h]
dhduncan: checks 
color_singleton has timed out
color_singleton: checks 
Klemtonius: checks 
*** RIVER *** [9h 3h 8h 2h] [Ts]
dhduncan: bets 100
color_singleton: folds 
Klemtonius: folds 
Uncalled bet (100) returned to dhduncan
dhduncan collected 567 from pot
dhduncan: doesn't show hand 
*** SUMMARY ***
Total pot 600 | Rake 33 
Board [9h 3h 8h 2h Ts]
Seat 1: color_singleton (big blind) folded on the River
Seat 2: manon327 folded before Flop (didn't bet)
Seat 3: JeBoyDirk folded before Flop (didn't bet)
Seat 7: Klemtonius (button) folded on the River
Seat 9: dhduncan (small blind) collected (567)



PokerStars Home Game Hand #223926639617: {DaPokaStars}  Hold'em No Limit (50/100) - 2021/02/17 15:52:30 ET
Table 'tonight again' 9-max (Play Money) Seat #9 is the button
Seat 1: color_singleton (10275 in chips) 
Seat 2: manon327 (13750 in chips) 
Seat 3: JeBoyDirk (15210 in chips) 
Seat 7: Klemtonius (7917 in chips) 
Seat 9: dhduncan (15468 in chips) 
color_singleton: posts small blind 50
manon327: posts big blind 100
*** HOLE CARDS ***
Dealt to dhduncan [Jd 2c]
JeBoyDirk: raises 200 to 300
Klemtonius: calls 300
dhduncan: folds 
color_singleton: calls 250
manon327: folds 
*** FLOP *** [7d Th 8c]
color_singleton: checks 
JeBoyDirk: bets 600
Klemtonius: calls 600
color_singleton: folds 
*** TURN *** [7d Th 8c] [4c]
JeBoyDirk: bets 2300
Klemtonius: calls 2300
*** RIVER *** [7d Th 8c 4c] [2s]
JeBoyDirk: bets 5100
Klemtonius: calls 4717 and is all-in
Uncalled bet (383) returned to JeBoyDirk
*** SHOW DOWN ***
JeBoyDirk: shows [As Ks] (high card Ace)
Klemtonius: shows [Jc 9d] (a straight, Seven to Jack)
Klemtonius collected 15341 from pot
*** SUMMARY ***
Total pot 16234 | Rake 893 
Board [7d Th 8c 4c 2s]
Seat 1: color_singleton (small blind) folded on the Flop
Seat 2: manon327 (big blind) folded before Flop
Seat 3: JeBoyDirk showed [As Ks] and lost with high card Ace
Seat 7: Klemtonius showed [Jc 9d] and won (15341) with a straight, Seven to Jack
Seat 9: dhduncan (button) folded before Flop (didn't bet)



PokerStars Home Game Hand #223926695208: {DaPokaStars}  Hold'em No Limit (50/100) - 2021/02/17 15:53:50 ET
Table 'tonight again' 9-max (Play Money) Seat #1 is the button
Seat 1: color_singleton (9975 in chips) 
Seat 2: manon327 (13650 in chips) 
Seat 3: JeBoyDirk (7293 in chips) 
Seat 7: Klemtonius (15341 in chips) 
Seat 9: dhduncan (15468 in chips) 
manon327: posts small blind 50
JeBoyDirk: posts big blind 100
*** HOLE CARDS ***
Dealt to dhduncan [2s Js]
Klemtonius: folds 
dhduncan: calls 100
color_singleton: raises 100 to 200
manon327: folds 
JeBoyDirk: calls 100
dhduncan: folds 
*** FLOP *** [2h 8h Qd]
JeBoyDirk: checks 
color_singleton: bets 260
JeBoyDirk: calls 260
*** TURN *** [2h 8h Qd] [6c]
JeBoyDirk: checks 
color_singleton: bets 505
JeBoyDirk: calls 505
*** RIVER *** [2h 8h Qd 6c] [Ks]
JeBoyDirk: checks 
color_singleton: checks 
*** SHOW DOWN ***
JeBoyDirk: shows [Ac Kh] (a pair of Kings)
color_singleton: mucks hand 
JeBoyDirk collected 1966 from pot
*** SUMMARY ***
Total pot 2080 | Rake 114 
Board [2h 8h Qd 6c Ks]
Seat 1: color_singleton (button) mucked [Qh 9h]
Seat 2: manon327 (small blind) folded before Flop
Seat 3: JeBoyDirk (big blind) showed [Ac Kh] and won (1966) with a pair of Kings
Seat 7: Klemtonius folded before Flop (didn't bet)
Seat 9: dhduncan folded before Flop



PokerStars Home Game Hand #223926742200: {DaPokaStars}  Hold'em No Limit (50/100) - 2021/02/17 15:54:58 ET
Table 'tonight again' 9-max (Play Money) Seat #2 is the button
Seat 1: color_singleton (9010 in chips) 
Seat 2: manon327 (13600 in chips) 
Seat 3: JeBoyDirk (8294 in chips) 
Seat 7: Klemtonius (15341 in chips) 
Seat 9: dhduncan (15368 in chips) 
JeBoyDirk: posts small blind 50
Klemtonius: posts big blind 100
*** HOLE CARDS ***
Dealt to dhduncan [7c 7h]
dhduncan: folds 
color_singleton: raises 200 to 300
manon327: calls 300
JeBoyDirk: folds 
Klemtonius: calls 200
*** FLOP *** [Qs Jh 7d]
Klemtonius: checks 
color_singleton: bets 449
manon327: folds 
Klemtonius: folds 
Uncalled bet (449) returned to color_singleton
color_singleton collected 898 from pot
color_singleton: doesn't show hand 
*** SUMMARY ***
Total pot 950 | Rake 52 
Board [Qs Jh 7d]
Seat 1: color_singleton collected (898)
Seat 2: manon327 (button) folded on the Flop
Seat 3: JeBoyDirk (small blind) folded before Flop
Seat 7: Klemtonius (big blind) folded on the Flop
Seat 9: dhduncan folded before Flop (didn't bet)



PokerStars Home Game Hand #223926767187: {DaPokaStars}  Hold'em No Limit (50/100) - 2021/02/17 15:55:40 ET
Table 'tonight again' 9-max (Play Money) Seat #3 is the button
Seat 1: color_singleton (9608 in chips) 
Seat 2: manon327 (13300 in chips) 
Seat 3: JeBoyDirk (8244 in chips) 
Seat 7: Klemtonius (15041 in chips) 
Seat 9: dhduncan (15368 in chips) 
Klemtonius: posts small blind 50
dhduncan: posts big blind 100
*** HOLE CARDS ***
Dealt to dhduncan [Jc 8c]
color_singleton: folds 
manon327: calls 100
JeBoyDirk: folds 
Klemtonius: calls 50
dhduncan: checks 
*** FLOP *** [9d Jh Tc]
Klemtonius: bets 100
dhduncan: raises 100 to 200
manon327: folds 
Klemtonius: calls 100
*** TURN *** [9d Jh Tc] [4c]
Klemtonius: bets 661
dhduncan: folds 
Uncalled bet (661) returned to Klemtonius
Klemtonius collected 661 from pot
Klemtonius: doesn't show hand 
*** SUMMARY ***
Total pot 700 | Rake 39 
Board [9d Jh Tc 4c]
Seat 1: color_singleton folded before Flop (didn't bet)
Seat 2: manon327 folded on the Flop
Seat 3: JeBoyDirk (button) folded before Flop (didn't bet)
Seat 7: Klemtonius (small blind) collected (661)
Seat 9: dhduncan (big blind) folded on the Turn



PokerStars Home Game Hand #223926803441: {DaPokaStars}  Hold'em No Limit (50/100) - 2021/02/17 15:56:49 ET
Table 'tonight again' 9-max (Play Money) Seat #7 is the button
Seat 1: color_singleton (9608 in chips) 
Seat 2: manon327 (13200 in chips) 
Seat 3: JeBoyDirk (8244 in chips) 
Seat 7: Klemtonius (15402 in chips) 
Seat 9: dhduncan (15068 in chips) 
dhduncan: posts small blind 50
color_singleton: posts big blind 100
*** HOLE CARDS ***
Dealt to dhduncan [Td 3s]
manon327: calls 100
JeBoyDirk: folds 
Klemtonius: calls 100
dhduncan: folds 
color_singleton: checks 
*** FLOP *** [4c 6s 9c]
color_singleton: bets 331
manon327: folds 
Klemtonius: folds 
Uncalled bet (331) returned to color_singleton
color_singleton collected 331 from pot
color_singleton: doesn't show hand 
*** SUMMARY ***
Total pot 350 | Rake 19 
Board [4c 6s 9c]
Seat 1: color_singleton (big blind) collected (331)
Seat 2: manon327 folded on the Flop
Seat 3: JeBoyDirk folded before Flop (didn't bet)
Seat 7: Klemtonius (button) folded on the Flop
Seat 9: dhduncan (small blind) folded before Flop



PokerStars Home Game Hand #223926816281: {DaPokaStars}  Hold'em No Limit (50/100) - 2021/02/17 15:57:13 ET
Table 'tonight again' 9-max (Play Money) Seat #9 is the button
Seat 1: color_singleton (9839 in chips) 
Seat 2: manon327 (13100 in chips) 
Seat 3: JeBoyDirk (8244 in chips) 
Seat 7: Klemtonius (15302 in chips) 
Seat 9: dhduncan (15018 in chips) 
color_singleton: posts small blind 50
manon327: posts big blind 100
*** HOLE CARDS ***
Dealt to dhduncan [2h 3s]
JeBoyDirk: calls 100
Klemtonius: calls 100
dhduncan: folds 
color_singleton: calls 50
manon327: checks 
*** FLOP *** [Qd Ts 7s]
color_singleton: bets 378
manon327: folds 
JeBoyDirk: calls 378
Klemtonius: calls 378
*** TURN *** [Qd Ts 7s] [6h]
color_singleton: bets 1450
JeBoyDirk: calls 1450
Klemtonius: folds 
*** RIVER *** [Qd Ts 7s 6h] [Kh]
color_singleton: checks 
JeBoyDirk: bets 2000
color_singleton: calls 2000
*** SHOW DOWN ***
JeBoyDirk: shows [Qc 6c] (two pair, Queens and Sixes)
color_singleton: mucks hand 
JeBoyDirk collected 7970 from pot
*** SUMMARY ***
Total pot 8434 | Rake 464 
Board [Qd Ts 7s 6h Kh]
Seat 1: color_singleton (small blind) mucked [5d Qs]
Seat 2: manon327 (big blind) folded on the Flop
Seat 3: JeBoyDirk showed [Qc 6c] and won (7970) with two pair, Queens and Sixes
Seat 7: Klemtonius folded on the Turn
Seat 9: dhduncan (button) folded before Flop (didn't bet)



PokerStars Home Game Hand #223926873507: {DaPokaStars}  Hold'em No Limit (50/100) - 2021/02/17 15:58:29 ET
Table 'tonight again' 9-max (Play Money) Seat #1 is the button
Seat 1: color_singleton (5911 in chips) 
Seat 2: manon327 (13000 in chips) 
Seat 3: JeBoyDirk (12286 in chips) 
Seat 7: Klemtonius (14824 in chips) 
Seat 9: dhduncan (15018 in chips) 
manon327: posts small blind 50
JeBoyDirk: posts big blind 100
*** HOLE CARDS ***
Dealt to dhduncan [Qc 2c]
Klemtonius: calls 100
dhduncan: calls 100
color_singleton: raises 200 to 300
manon327: calls 250
JeBoyDirk: calls 200
Klemtonius: calls 200
dhduncan: folds 
*** FLOP *** [8c Td 9s]
manon327: checks 
JeBoyDirk: checks 
Klemtonius: checks 
color_singleton: bets 1228
manon327: folds 
JeBoyDirk: folds 
Klemtonius: calls 1228
*** TURN *** [8c Td 9s] [2s]
Klemtonius: checks 
color_singleton: checks 
*** RIVER *** [8c Td 9s 2s] [9d]
Klemtonius: bets 1774
color_singleton: calls 1774
*** SHOW DOWN ***
Klemtonius: shows [6h Qh] (a pair of Nines)
color_singleton: shows [Qs 9c] (three of a kind, Nines)
color_singleton collected 6902 from pot
*** SUMMARY ***
Total pot 7304 | Rake 402 
Board [8c Td 9s 2s 9d]
Seat 1: color_singleton (button) showed [Qs 9c] and won (6902) with three of a kind, Nines
Seat 2: manon327 (small blind) folded on the Flop
Seat 3: JeBoyDirk (big blind) folded on the Flop
Seat 7: Klemtonius showed [6h Qh] and lost with a pair of Nines
Seat 9: dhduncan folded before Flop



PokerStars Home Game Hand #223926918147: {DaPokaStars}  Hold'em No Limit (50/100) - 2021/02/17 15:59:53 ET
Table 'tonight again' 9-max (Play Money) Seat #2 is the button
Seat 1: color_singleton (9511 in chips) 
Seat 2: manon327 (12700 in chips) 
Seat 3: JeBoyDirk (11986 in chips) 
Seat 7: Klemtonius (11522 in chips) 
Seat 9: dhduncan (14918 in chips) 
JeBoyDirk: posts small blind 50
Klemtonius: posts big blind 100
*** HOLE CARDS ***
Dealt to dhduncan [6s 3c]
dhduncan: folds 
color_singleton: raises 200 to 300
manon327: folds 
JeBoyDirk: folds 
Klemtonius: calls 200
*** FLOP *** [6d 5h 4c]
Klemtonius: checks 
color_singleton: checks 
*** TURN *** [6d 5h 4c] [Tc]
Klemtonius: checks 
color_singleton: checks 
*** RIVER *** [6d 5h 4c Tc] [8h]
Klemtonius: checks 
color_singleton: checks 
*** SHOW DOWN ***
Klemtonius: shows [5d 9d] (a pair of Fives)
color_singleton: mucks hand 
Klemtonius collected 614 from pot
*** SUMMARY ***
Total pot 650 | Rake 36 
Board [6d 5h 4c Tc 8h]
Seat 1: color_singleton mucked [9h Kc]
Seat 2: manon327 (button) folded before Flop (didn't bet)
Seat 3: JeBoyDirk (small blind) folded before Flop
Seat 7: Klemtonius (big blind) showed [5d 9d] and won (614) with a pair of Fives
Seat 9: dhduncan folded before Flop (didn't bet)



PokerStars Home Game Hand #223926935751: {DaPokaStars}  Hold'em No Limit (50/100) - 2021/02/17 16:00:24 ET
Table 'tonight again' 9-max (Play Money) Seat #3 is the button
Seat 1: color_singleton (9211 in chips) 
Seat 2: manon327 (12700 in chips) 
Seat 3: JeBoyDirk (11936 in chips) 
Seat 7: Klemtonius (11836 in chips) 
Seat 9: dhduncan (14918 in chips) 
Klemtonius: posts small blind 50
dhduncan: posts big blind 100
*** HOLE CARDS ***
Dealt to dhduncan [Kh 8d]
color_singleton: folds 
manon327: folds 
JeBoyDirk: folds 
Klemtonius: calls 50
dhduncan: checks 
*** FLOP *** [3s Kd Ks]
Klemtonius: checks 
dhduncan: checks 
*** TURN *** [3s Kd Ks] [8s]
Klemtonius: bets 100
dhduncan: raises 100 to 200
Klemtonius: calls 100
*** RIVER *** [3s Kd Ks 8s] [5s]
Klemtonius: checks 
dhduncan: bets 567
Klemtonius: folds 
Uncalled bet (567) returned to dhduncan
dhduncan collected 567 from pot
dhduncan: doesn't show hand 
*** SUMMARY ***
Total pot 600 | Rake 33 
Board [3s Kd Ks 8s 5s]
Seat 1: color_singleton folded before Flop (didn't bet)
Seat 2: manon327 folded before Flop (didn't bet)
Seat 3: JeBoyDirk (button) folded before Flop (didn't bet)
Seat 7: Klemtonius (small blind) folded on the River
Seat 9: dhduncan (big blind) collected (567)



PokerStars Home Game Hand #223926961116: {DaPokaStars}  Hold'em No Limit (50/100) - 2021/02/17 16:01:07 ET
Table 'tonight again' 9-max (Play Money) Seat #7 is the button
Seat 1: color_singleton (9211 in chips) 
Seat 2: manon327 (12700 in chips) 
Seat 3: JeBoyDirk (11936 in chips) 
Seat 7: Klemtonius (11536 in chips) 
Seat 9: dhduncan (15185 in chips) 
dhduncan: posts small blind 50
color_singleton: posts big blind 100
*** HOLE CARDS ***
Dealt to dhduncan [9d Kh]
manon327: folds 
JeBoyDirk: folds 
Klemtonius: raises 100 to 200
dhduncan: calls 150
color_singleton: raises 300 to 500
Klemtonius: calls 300
dhduncan: folds 
*** FLOP *** [4d 7s 7h]
color_singleton: checks 
Klemtonius: checks 
*** TURN *** [4d 7s 7h] [Tc]
color_singleton: checks 
Klemtonius: checks 
*** RIVER *** [4d 7s 7h Tc] [Jc]
color_singleton: checks 
Klemtonius: bets 1134
color_singleton: folds 
Uncalled bet (1134) returned to Klemtonius
Klemtonius collected 1134 from pot
Klemtonius: doesn't show hand 
*** SUMMARY ***
Total pot 1200 | Rake 66 
Board [4d 7s 7h Tc Jc]
Seat 1: color_singleton (big blind) folded on the River
Seat 2: manon327 folded before Flop (didn't bet)
Seat 3: JeBoyDirk folded before Flop (didn't bet)
Seat 7: Klemtonius (button) collected (1134)
Seat 9: dhduncan (small blind) folded before Flop



PokerStars Home Game Hand #223926991562: {DaPokaStars}  Hold'em No Limit (50/100) - 2021/02/17 16:01:55 ET
Table 'tonight again' 9-max (Play Money) Seat #9 is the button
Seat 1: color_singleton (8711 in chips) 
Seat 2: manon327 (12700 in chips) 
Seat 3: JeBoyDirk (11936 in chips) 
Seat 7: Klemtonius (12170 in chips) 
Seat 9: dhduncan (14985 in chips) 
color_singleton: posts small blind 50
manon327: posts big blind 100
*** HOLE CARDS ***
Dealt to dhduncan [Qd 8d]
JeBoyDirk: calls 100
Klemtonius: calls 100
dhduncan: calls 100
color_singleton: folds 
manon327: checks 
*** FLOP *** [Kd 3d 6c]
manon327: checks 
JeBoyDirk: checks 
Klemtonius: bets 212
dhduncan: calls 212
manon327: calls 212
JeBoyDirk: folds 
*** TURN *** [Kd 3d 6c] [3s]
manon327: checks 
Klemtonius: bets 513
dhduncan: folds 
manon327: folds 
Uncalled bet (513) returned to Klemtonius
Klemtonius collected 1026 from pot
Klemtonius: doesn't show hand 
*** SUMMARY ***
Total pot 1086 | Rake 60 
Board [Kd 3d 6c 3s]
Seat 1: color_singleton (small blind) folded before Flop
Seat 2: manon327 (big blind) folded on the Turn
Seat 3: JeBoyDirk folded on the Flop
Seat 7: Klemtonius collected (1026)
Seat 9: dhduncan (button) folded on the Turn



PokerStars Home Game Hand #223927034997: {DaPokaStars}  Hold'em No Limit (50/100) - 2021/02/17 16:02:58 ET
Table 'tonight again' 9-max (Play Money) Seat #1 is the button
Seat 1: color_singleton (8661 in chips) 
Seat 2: manon327 (12388 in chips) 
Seat 3: JeBoyDirk (11836 in chips) 
Seat 7: Klemtonius (12884 in chips) 
Seat 9: dhduncan (14673 in chips) 
manon327: posts small blind 50
JeBoyDirk: posts big blind 100
*** HOLE CARDS ***
Dealt to dhduncan [8d 7s]
Klemtonius: raises 300 to 400
dhduncan: folds 
color_singleton: folds 
manon327: calls 350
JeBoyDirk: folds 
*** FLOP *** [9d Ks 9c]
manon327: bets 425
Klemtonius: calls 425
*** TURN *** [9d Ks 9c] [Jc]
manon327: bets 827
Klemtonius: folds 
Uncalled bet (827) returned to manon327
manon327 collected 1654 from pot
*** SUMMARY ***
Total pot 1750 | Rake 96 
Board [9d Ks 9c Jc]
Seat 1: color_singleton (button) folded before Flop (didn't bet)
Seat 2: manon327 (small blind) collected (1654)
Seat 3: JeBoyDirk (big blind) folded before Flop
Seat 7: Klemtonius folded on the Turn
Seat 9: dhduncan folded before Flop (didn't bet)



PokerStars Home Game Hand #223927064213: {DaPokaStars}  Hold'em No Limit (50/100) - 2021/02/17 16:03:39 ET
Table 'tonight again' 9-max (Play Money) Seat #2 is the button
Seat 1: color_singleton (8661 in chips) 
Seat 2: manon327 (13217 in chips) 
Seat 3: JeBoyDirk (11736 in chips) 
Seat 7: Klemtonius (12059 in chips) 
Seat 9: dhduncan (14673 in chips) 
JeBoyDirk: posts small blind 50
Klemtonius: posts big blind 100
*** HOLE CARDS ***
Dealt to dhduncan [Qs 2s]
dhduncan: calls 100
color_singleton: folds 
manon327: calls 100
JeBoyDirk: folds 
Klemtonius: checks 
*** FLOP *** [9s 9d 4s]
Klemtonius: checks 
dhduncan: checks 
manon327: checks 
*** TURN *** [9s 9d 4s] [Ah]
Klemtonius: checks 
dhduncan: checks 
manon327: checks 
*** RIVER *** [9s 9d 4s Ah] [Tc]
Klemtonius: checks 
dhduncan: checks 
manon327: bets 331
Klemtonius: folds 
dhduncan: folds 
Uncalled bet (331) returned to manon327
manon327 collected 331 from pot
*** SUMMARY ***
Total pot 350 | Rake 19 
Board [9s 9d 4s Ah Tc]
Seat 1: color_singleton folded before Flop (didn't bet)
Seat 2: manon327 (button) collected (331)
Seat 3: JeBoyDirk (small blind) folded before Flop
Seat 7: Klemtonius (big blind) folded on the River
Seat 9: dhduncan folded on the River



PokerStars Home Game Hand #223927090480: {DaPokaStars}  Hold'em No Limit (50/100) - 2021/02/17 16:04:17 ET
Table 'tonight again' 9-max (Play Money) Seat #3 is the button
Seat 1: color_singleton (8661 in chips) 
Seat 2: manon327 (13448 in chips) 
Seat 3: JeBoyDirk (11686 in chips) 
Seat 7: Klemtonius (11959 in chips) 
Seat 9: dhduncan (14573 in chips) 
Klemtonius: posts small blind 50
dhduncan: posts big blind 100
*** HOLE CARDS ***
Dealt to dhduncan [Ts Js]
color_singleton: raises 200 to 300
manon327: folds 
JeBoyDirk: folds 
Klemtonius: calls 250
dhduncan: calls 200
*** FLOP *** [4h Jd 9d]
Klemtonius: checks 
dhduncan: bets 425
color_singleton: calls 425
Klemtonius: folds 
*** TURN *** [4h Jd 9d] [Th]
dhduncan: bets 827
color_singleton: calls 827
*** RIVER *** [4h Jd 9d Th] [2d]
dhduncan: checks 
color_singleton: checks 
*** SHOW DOWN ***
dhduncan: shows [Ts Js] (two pair, Jacks and Tens)
color_singleton: shows [9c 9s] (three of a kind, Nines)
color_singleton collected 3217 from pot
*** SUMMARY ***
Total pot 3404 | Rake 187 
Board [4h Jd 9d Th 2d]
Seat 1: color_singleton showed [9c 9s] and won (3217) with three of a kind, Nines
Seat 2: manon327 folded before Flop (didn't bet)
Seat 3: JeBoyDirk (button) folded before Flop (didn't bet)
Seat 7: Klemtonius (small blind) folded on the Flop
Seat 9: dhduncan (big blind) showed [Ts Js] and lost with two pair, Jacks and Tens



PokerStars Home Game Hand #223927120568: {DaPokaStars}  Hold'em No Limit (50/100) - 2021/02/17 16:05:00 ET
Table 'tonight again' 9-max (Play Money) Seat #7 is the button
Seat 1: color_singleton (10326 in chips) 
Seat 2: manon327 (13448 in chips) 
Seat 3: JeBoyDirk (11686 in chips) 
Seat 7: Klemtonius (11659 in chips) 
Seat 9: dhduncan (13021 in chips) 
dhduncan: posts small blind 50
color_singleton: posts big blind 100
*** HOLE CARDS ***
Dealt to dhduncan [5c 9c]
manon327: folds 
JeBoyDirk: folds 
Klemtonius: calls 100
dhduncan: folds 
color_singleton: checks 
*** FLOP *** [Js 2d Ac]
color_singleton: checks 
Klemtonius: checks 
*** TURN *** [Js 2d Ac] [7c]
color_singleton: checks 
Klemtonius: checks 
*** RIVER *** [Js 2d Ac 7c] [Qc]
color_singleton: checks 
Klemtonius: bets 236
color_singleton: folds 
Uncalled bet (236) returned to Klemtonius
Klemtonius collected 236 from pot
Klemtonius: doesn't show hand 
*** SUMMARY ***
Total pot 250 | Rake 14 
Board [Js 2d Ac 7c Qc]
Seat 1: color_singleton (big blind) folded on the River
Seat 2: manon327 folded before Flop (didn't bet)
Seat 3: JeBoyDirk folded before Flop (didn't bet)
Seat 7: Klemtonius (button) collected (236)
Seat 9: dhduncan (small blind) folded before Flop



PokerStars Home Game Hand #223927149611: {DaPokaStars}  Hold'em No Limit (50/100) - 2021/02/17 16:05:41 ET
Table 'tonight again' 9-max (Play Money) Seat #9 is the button
Seat 1: color_singleton (10226 in chips) 
Seat 2: manon327 (13448 in chips) 
Seat 3: JeBoyDirk (11686 in chips) 
Seat 7: Klemtonius (11795 in chips) 
Seat 9: dhduncan (12971 in chips) 
color_singleton: posts small blind 50
manon327: posts big blind 100
*** HOLE CARDS ***
Dealt to dhduncan [Jc 4d]
JeBoyDirk: calls 100
Klemtonius: folds 
dhduncan: calls 100
color_singleton: raises 200 to 300
manon327: calls 200
JeBoyDirk: calls 200
dhduncan: folds 
*** FLOP *** [9h Jd Ad]
color_singleton: bets 472
manon327: folds 
JeBoyDirk: calls 472
*** TURN *** [9h Jd Ad] [Ts]
color_singleton: bets 918
JeBoyDirk: folds 
Uncalled bet (918) returned to color_singleton
color_singleton collected 1837 from pot
color_singleton: doesn't show hand 
*** SUMMARY ***
Total pot 1944 | Rake 107 
Board [9h Jd Ad Ts]
Seat 1: color_singleton (small blind) collected (1837)
Seat 2: manon327 (big blind) folded on the Flop
Seat 3: JeBoyDirk folded on the Turn
Seat 7: Klemtonius folded before Flop (didn't bet)
Seat 9: dhduncan (button) folded before Flop



PokerStars Home Game Hand #223927178740: {DaPokaStars}  Hold'em No Limit (50/100) - 2021/02/17 16:06:23 ET
Table 'tonight again' 9-max (Play Money) Seat #1 is the button
Seat 1: color_singleton (11291 in chips) 
Seat 2: manon327 (13148 in chips) 
Seat 3: JeBoyDirk (10914 in chips) 
Seat 7: Klemtonius (11795 in chips) 
Seat 9: dhduncan (12871 in chips) 
manon327: posts small blind 50
JeBoyDirk: posts big blind 100
*** HOLE CARDS ***
Dealt to dhduncan [Qd 8h]
Klemtonius: raises 100 to 200
dhduncan: folds 
color_singleton: folds 
manon327: calls 150
JeBoyDirk: folds 
*** FLOP *** [2d 9d 7s]
manon327: checks 
Klemtonius: checks 
*** TURN *** [2d 9d 7s] [8s]
manon327: checks 
Klemtonius: checks 
*** RIVER *** [2d 9d 7s 8s] [2s]
manon327: checks 
Klemtonius: checks 
*** SHOW DOWN ***
manon327: shows [Th Ad] (a pair of Deuces)
Klemtonius: mucks hand 
manon327 collected 472 from pot
*** SUMMARY ***
Total pot 500 | Rake 28 
Board [2d 9d 7s 8s 2s]
Seat 1: color_singleton (button) folded before Flop (didn't bet)
Seat 2: manon327 (small blind) showed [Th Ad] and won (472) with a pair of Deuces
Seat 3: JeBoyDirk (big blind) folded before Flop
Seat 7: Klemtonius mucked [6c Ah]
Seat 9: dhduncan folded before Flop (didn't bet)



PokerStars Home Game Hand #223927200123: {DaPokaStars}  Hold'em No Limit (50/100) - 2021/02/17 16:06:54 ET
Table 'tonight again' 9-max (Play Money) Seat #2 is the button
Seat 1: color_singleton (11291 in chips) 
Seat 2: manon327 (13420 in chips) 
Seat 3: JeBoyDirk (10814 in chips) 
Seat 7: Klemtonius (11595 in chips) 
Seat 9: dhduncan (12871 in chips) 
JeBoyDirk: posts small blind 50
Klemtonius: posts big blind 100
*** HOLE CARDS ***
Dealt to dhduncan [3h 3s]
dhduncan: folds 
color_singleton: calls 100
manon327: folds 
JeBoyDirk: folds 
Klemtonius: checks 
*** FLOP *** [2d Td 8d]
Klemtonius: checks 
color_singleton: bets 118
Klemtonius: calls 118
*** TURN *** [2d Td 8d] [6d]
Klemtonius: bets 459
color_singleton: calls 459
*** RIVER *** [2d Td 8d 6d] [Kd]
Klemtonius: checks 
color_singleton: bets 663
Klemtonius: calls 663
*** SHOW DOWN ***
color_singleton: shows [Jd 8c] (a flush, King high)
Klemtonius: mucks hand 
color_singleton collected 2580 from pot
*** SUMMARY ***
Total pot 2730 | Rake 150 
Board [2d Td 8d 6d Kd]
Seat 1: color_singleton showed [Jd 8c] and won (2580) with a flush, King high
Seat 2: manon327 (button) folded before Flop (didn't bet)
Seat 3: JeBoyDirk (small blind) folded before Flop
Seat 7: Klemtonius (big blind) mucked [7d 3d]
Seat 9: dhduncan folded before Flop (didn't bet)



PokerStars Home Game Hand #223927242068: {DaPokaStars}  Hold'em No Limit (50/100) - 2021/02/17 16:07:54 ET
Table 'tonight again' 9-max (Play Money) Seat #3 is the button
Seat 1: color_singleton (12531 in chips) 
Seat 2: manon327 (13420 in chips) 
Seat 3: JeBoyDirk (10764 in chips) 
Seat 7: Klemtonius (10255 in chips) 
Seat 9: dhduncan (12871 in chips) 
Klemtonius: posts small blind 50
dhduncan: posts big blind 100
*** HOLE CARDS ***
Dealt to dhduncan [7h 3h]
color_singleton: folds 
manon327: calls 100
JeBoyDirk: folds 
Klemtonius: calls 50
dhduncan: checks 
*** FLOP *** [6s Th 6c]
Klemtonius: checks 
dhduncan: checks 
manon327: bets 141
Klemtonius: folds 
dhduncan: folds 
Uncalled bet (141) returned to manon327
manon327 collected 283 from pot
*** SUMMARY ***
Total pot 300 | Rake 17 
Board [6s Th 6c]
Seat 1: color_singleton folded before Flop (didn't bet)
Seat 2: manon327 collected (283)
Seat 3: JeBoyDirk (button) folded before Flop (didn't bet)
Seat 7: Klemtonius (small blind) folded on the Flop
Seat 9: dhduncan (big blind) folded on the Flop



PokerStars Home Game Hand #223927266414: {DaPokaStars}  Hold'em No Limit (50/100) - 2021/02/17 16:08:28 ET
Table 'tonight again' 9-max (Play Money) Seat #7 is the button
Seat 1: color_singleton (12531 in chips) 
Seat 2: manon327 (13603 in chips) 
Seat 3: JeBoyDirk (10764 in chips) 
Seat 7: Klemtonius (10155 in chips) 
Seat 9: dhduncan (12771 in chips) 
dhduncan: posts small blind 50
color_singleton: posts big blind 100
*** HOLE CARDS ***
Dealt to dhduncan [7c 7s]
manon327: calls 100
JeBoyDirk: calls 100
Klemtonius: calls 100
dhduncan: calls 50
color_singleton: checks 
*** FLOP *** [Qd Ts 5c]
dhduncan: checks 
color_singleton: bets 300
manon327: calls 300
JeBoyDirk: folds 
Klemtonius: folds 
dhduncan: folds 
*** TURN *** [Qd Ts 5c] [9c]
color_singleton: bets 1039
manon327: folds 
Uncalled bet (1039) returned to color_singleton
color_singleton collected 1039 from pot
color_singleton: doesn't show hand 
*** SUMMARY ***
Total pot 1100 | Rake 61 
Board [Qd Ts 5c 9c]
Seat 1: color_singleton (big blind) collected (1039)
Seat 2: manon327 folded on the Turn
Seat 3: JeBoyDirk folded on the Flop
Seat 7: Klemtonius (button) folded on the Flop
Seat 9: dhduncan (small blind) folded on the Flop



PokerStars Home Game Hand #223927298002: {DaPokaStars}  Hold'em No Limit (50/100) - 2021/02/17 16:09:14 ET
Table 'tonight again' 9-max (Play Money) Seat #9 is the button
Seat 1: color_singleton (13170 in chips) 
Seat 2: manon327 (13203 in chips) 
Seat 3: JeBoyDirk (10664 in chips) 
Seat 7: Klemtonius (10055 in chips) 
Seat 9: dhduncan (12671 in chips) 
color_singleton: posts small blind 50
manon327: posts big blind 100
*** HOLE CARDS ***
Dealt to dhduncan [6d Jc]
JeBoyDirk: calls 100
Klemtonius: calls 100
dhduncan: calls 100
color_singleton: calls 50
manon327: checks 
*** FLOP *** [Qs 3h 5c]
color_singleton: checks 
manon327: checks 
JeBoyDirk: checks 
Klemtonius: checks 
dhduncan: checks 
*** TURN *** [Qs 3h 5c] [Td]
color_singleton: checks 
manon327: checks 
JeBoyDirk: checks 
Klemtonius: checks 
dhduncan: checks 
*** RIVER *** [Qs 3h 5c Td] [Ks]
color_singleton: checks 
manon327: checks 
JeBoyDirk: checks 
Klemtonius: checks 
dhduncan: checks 
*** SHOW DOWN ***
color_singleton: shows [9c 5s] (a pair of Fives)
manon327: shows [Th 3s] (two pair, Tens and Threes)
JeBoyDirk: mucks hand 
Klemtonius: mucks hand 
dhduncan: mucks hand 
manon327 collected 472 from pot
*** SUMMARY ***
Total pot 500 | Rake 28 
Board [Qs 3h 5c Td Ks]
Seat 1: color_singleton (small blind) showed [9c 5s] and lost with a pair of Fives
Seat 2: manon327 (big blind) showed [Th 3s] and won (472) with two pair, Tens and Threes
Seat 3: JeBoyDirk mucked [4c 3c]
Seat 7: Klemtonius mucked [8c Jh]
Seat 9: dhduncan (button) mucked [6d Jc]



PokerStars Home Game Hand #223927341091: {DaPokaStars}  Hold'em No Limit (50/100) - 2021/02/17 16:10:16 ET
Table 'tonight again' 9-max (Play Money) Seat #1 is the button
Seat 1: color_singleton (13070 in chips) 
Seat 2: manon327 (13575 in chips) 
Seat 3: JeBoyDirk (10564 in chips) 
Seat 7: Klemtonius (9955 in chips) 
Seat 9: dhduncan (12571 in chips) 
manon327: posts small blind 50
JeBoyDirk: posts big blind 100
*** HOLE CARDS ***
Dealt to dhduncan [8h Ad]
Klemtonius: calls 100
dhduncan: calls 100
color_singleton: folds 
manon327: calls 50
JeBoyDirk: checks 
*** FLOP *** [3d 5c Ac]
manon327: checks 
JeBoyDirk: checks 
Klemtonius: checks 
dhduncan: checks 
*** TURN *** [3d 5c Ac] [8d]
manon327: checks 
JeBoyDirk: checks 
Klemtonius: checks 
dhduncan: bets 100
manon327: calls 100
JeBoyDirk: calls 100
Klemtonius: folds 
*** RIVER *** [3d 5c Ac 8d] [Ks]
manon327: checks 
JeBoyDirk: checks 
dhduncan: bets 661
manon327: folds 
JeBoyDirk: folds 
Uncalled bet (661) returned to dhduncan
dhduncan collected 661 from pot
dhduncan: doesn't show hand 
*** SUMMARY ***
Total pot 700 | Rake 39 
Board [3d 5c Ac 8d Ks]
Seat 1: color_singleton (button) folded before Flop (didn't bet)
Seat 2: manon327 (small blind) folded on the River
Seat 3: JeBoyDirk (big blind) folded on the River
Seat 7: Klemtonius folded on the Turn
Seat 9: dhduncan collected (661)



PokerStars Home Game Hand #223927378908: {DaPokaStars}  Hold'em No Limit (50/100) - 2021/02/17 16:11:10 ET
Table 'tonight again' 9-max (Play Money) Seat #2 is the button
Seat 1: color_singleton (13070 in chips) 
Seat 2: manon327 (13375 in chips) 
Seat 3: JeBoyDirk (10364 in chips) 
Seat 7: Klemtonius (9855 in chips) 
Seat 9: dhduncan (13032 in chips) 
JeBoyDirk: posts small blind 50
Klemtonius: posts big blind 100
*** HOLE CARDS ***
Dealt to dhduncan [4s 9s]
dhduncan: folds 
color_singleton: folds 
manon327: calls 100
JeBoyDirk: folds 
Klemtonius: raises 100 to 200
manon327: calls 100
*** FLOP *** [Ks As 9d]
Klemtonius: bets 212
manon327: calls 212
*** TURN *** [Ks As 9d] [Kd]
Klemtonius: bets 826
manon327: folds 
Uncalled bet (826) returned to Klemtonius
Klemtonius collected 826 from pot
Klemtonius: doesn't show hand 
*** SUMMARY ***
Total pot 874 | Rake 48 
Board [Ks As 9d Kd]
Seat 1: color_singleton folded before Flop (didn't bet)
Seat 2: manon327 (button) folded on the Turn
Seat 3: JeBoyDirk (small blind) folded before Flop
Seat 7: Klemtonius (big blind) collected (826)
Seat 9: dhduncan folded before Flop (didn't bet)



PokerStars Home Game Hand #223927401445: {DaPokaStars}  Hold'em No Limit (50/100) - 2021/02/17 16:11:42 ET
Table 'tonight again' 9-max (Play Money) Seat #3 is the button
Seat 1: color_singleton (13070 in chips) 
Seat 2: manon327 (12963 in chips) 
Seat 3: JeBoyDirk (10314 in chips) 
Seat 7: Klemtonius (10269 in chips) 
Seat 9: dhduncan (13032 in chips) 
Klemtonius: posts small blind 50
dhduncan: posts big blind 100
*** HOLE CARDS ***
Dealt to dhduncan [5s Ad]
color_singleton: folds 
manon327: folds 
JeBoyDirk: folds 
Klemtonius: raises 100 to 200
dhduncan: calls 100
*** FLOP *** [Ah 9c Ac]
Klemtonius: bets 378
dhduncan: calls 378
*** TURN *** [Ah 9c Ac] [4s]
Klemtonius: bets 1092
dhduncan: calls 1092
*** RIVER *** [Ah 9c Ac 4s] [6c]
Klemtonius: bets 100
dhduncan: raises 1678 to 1778
Klemtonius: folds 
Uncalled bet (1678) returned to dhduncan
dhduncan collected 3345 from pot
dhduncan: doesn't show hand 
*** SUMMARY ***
Total pot 3540 | Rake 195 
Board [Ah 9c Ac 4s 6c]
Seat 1: color_singleton folded before Flop (didn't bet)
Seat 2: manon327 folded before Flop (didn't bet)
Seat 3: JeBoyDirk (button) folded before Flop (didn't bet)
Seat 7: Klemtonius (small blind) folded on the River
Seat 9: dhduncan (big blind) collected (3345)



PokerStars Home Game Hand #223927432218: {DaPokaStars}  Hold'em No Limit (50/100) - 2021/02/17 16:12:26 ET
Table 'tonight again' 9-max (Play Money) Seat #7 is the button
Seat 1: color_singleton (13070 in chips) 
Seat 2: manon327 (12963 in chips) 
Seat 3: JeBoyDirk (10314 in chips) 
Seat 7: Klemtonius (8499 in chips) 
Seat 9: dhduncan (14607 in chips) 
dhduncan: posts small blind 50
color_singleton: posts big blind 100
*** HOLE CARDS ***
Dealt to dhduncan [8s 9h]
manon327: folds 
JeBoyDirk: calls 100
Klemtonius: calls 100
dhduncan: folds 
color_singleton: checks 
*** FLOP *** [Ts Jc As]
color_singleton: checks 
JeBoyDirk: bets 200
Klemtonius: raises 200 to 400
color_singleton: folds 
JeBoyDirk: calls 200
*** TURN *** [Ts Jc As] [9d]
JeBoyDirk: checks 
Klemtonius: bets 543
JeBoyDirk: folds 
Uncalled bet (543) returned to Klemtonius
Klemtonius collected 1087 from pot
Klemtonius: doesn't show hand 
*** SUMMARY ***
Total pot 1150 | Rake 63 
Board [Ts Jc As 9d]
Seat 1: color_singleton (big blind) folded on the Flop
Seat 2: manon327 folded before Flop (didn't bet)
Seat 3: JeBoyDirk folded on the Turn
Seat 7: Klemtonius (button) collected (1087)
Seat 9: dhduncan (small blind) folded before Flop



PokerStars Home Game Hand #223927458481: {DaPokaStars}  Hold'em No Limit (50/100) - 2021/02/17 16:13:04 ET
Table 'tonight again' 9-max (Play Money) Seat #9 is the button
Seat 1: color_singleton (12970 in chips) 
Seat 2: manon327 (12963 in chips) 
Seat 3: JeBoyDirk (9814 in chips) 
Seat 7: Klemtonius (9086 in chips) 
Seat 9: dhduncan (14557 in chips) 
color_singleton: posts small blind 50
manon327: posts big blind 100
*** HOLE CARDS ***
Dealt to dhduncan [Kd Td]
JeBoyDirk: folds 
Klemtonius: raises 250 to 350
dhduncan: calls 350
color_singleton: calls 300
manon327: folds 
*** FLOP *** [3d Jh Ad]
color_singleton: checks 
Klemtonius: bets 1087
dhduncan: folds 
color_singleton: calls 1087
*** TURN *** [3d Jh Ad] [3s]
color_singleton: checks 
Klemtonius: bets 3141
color_singleton: folds 
Uncalled bet (3141) returned to Klemtonius
Klemtonius collected 3141 from pot
Klemtonius: doesn't show hand 
*** SUMMARY ***
Total pot 3324 | Rake 183 
Board [3d Jh Ad 3s]
Seat 1: color_singleton (small blind) folded on the Turn
Seat 2: manon327 (big blind) folded before Flop
Seat 3: JeBoyDirk folded before Flop (didn't bet)
Seat 7: Klemtonius collected (3141)
Seat 9: dhduncan (button) folded on the Flop



PokerStars Home Game Hand #223927495176: {DaPokaStars}  Hold'em No Limit (50/100) - 2021/02/17 16:13:57 ET
Table 'tonight again' 9-max (Play Money) Seat #1 is the button
Seat 1: color_singleton (11533 in chips) 
Seat 2: manon327 (12863 in chips) 
Seat 3: JeBoyDirk (9814 in chips) 
Seat 7: Klemtonius (10790 in chips) 
Seat 9: dhduncan (14207 in chips) 
manon327: posts small blind 50
JeBoyDirk: posts big blind 100
*** HOLE CARDS ***
Dealt to dhduncan [9s 6c]
Klemtonius: calls 100
dhduncan: folds 
color_singleton: raises 200 to 300
manon327 has timed out
manon327: folds 
JeBoyDirk: folds 
Klemtonius: calls 200
*** FLOP *** [7d 2d Td]
Klemtonius: bets 354
color_singleton: calls 354
*** TURN *** [7d 2d Td] [9h]
Klemtonius: bets 689
color_singleton: folds 
Uncalled bet (689) returned to Klemtonius
Klemtonius collected 1378 from pot
Klemtonius: doesn't show hand 
*** SUMMARY ***
Total pot 1458 | Rake 80 
Board [7d 2d Td 9h]
Seat 1: color_singleton (button) folded on the Turn
Seat 2: manon327 (small blind) folded before Flop
Seat 3: JeBoyDirk (big blind) folded before Flop
Seat 7: Klemtonius collected (1378)
Seat 9: dhduncan folded before Flop (didn't bet)



PokerStars Home Game Hand #223927628273: {DaPokaStars}  Hold'em No Limit (50/100) - 2021/02/17 16:17:05 ET
Table 'tonight again' 9-max (Play Money) Seat #1 is the button
Seat 1: color_singleton (11766 in chips) 
Seat 2: manon327 (12013 in chips) 
Seat 3: JeBoyDirk (9245 in chips) 
Seat 7: Klemtonius (11689 in chips) 
Seat 9: dhduncan (14207 in chips) 
manon327: posts small blind 50
JeBoyDirk: posts big blind 100
dhduncan: posts small & big blinds 150
*** HOLE CARDS ***
Dealt to dhduncan [Ah Kd]
Klemtonius: raises 100 to 200
dhduncan: calls 100
color_singleton: calls 200
manon327: calls 150
JeBoyDirk: calls 100
*** FLOP *** [4d 2c 9s]
manon327: checks 
JeBoyDirk: checks 
Klemtonius: bets 100
dhduncan: calls 100
color_singleton: raises 800 to 900
manon327: folds 
JeBoyDirk: folds 
Klemtonius: folds 
dhduncan: folds 
Uncalled bet (800) returned to color_singleton
color_singleton collected 1276 from pot
color_singleton: doesn't show hand 
*** SUMMARY ***
Total pot 1350 | Rake 74 
Board [4d 2c 9s]
Seat 1: color_singleton (button) collected (1276)
Seat 2: manon327 (small blind) folded on the Flop
Seat 3: JeBoyDirk (big blind) folded on the Flop
Seat 7: Klemtonius folded on the Flop
Seat 9: dhduncan folded on the Flop



PokerStars Home Game Hand #223927673621: {DaPokaStars}  Hold'em No Limit (50/100) - 2021/02/17 16:18:09 ET
Table 'tonight again' 9-max (Play Money) Seat #2 is the button
Seat 1: color_singleton (12742 in chips) 
Seat 2: manon327 (11813 in chips) 
Seat 3: JeBoyDirk (9045 in chips) 
Seat 7: Klemtonius (11389 in chips) 
Seat 9: dhduncan (13857 in chips) 
JeBoyDirk: posts small blind 50
Klemtonius: posts big blind 100
*** HOLE CARDS ***
Dealt to dhduncan [5s As]
dhduncan: calls 100
color_singleton: folds 
manon327: calls 100
JeBoyDirk: folds 
Klemtonius: raises 350 to 450
dhduncan: calls 350
manon327: calls 350
*** FLOP *** [6h 2d Ad]
Klemtonius: bets 1323
dhduncan: folds 
manon327: folds 
Uncalled bet (1323) returned to Klemtonius
Klemtonius collected 1323 from pot
Klemtonius: doesn't show hand 
*** SUMMARY ***
Total pot 1400 | Rake 77 
Board [6h 2d Ad]
Seat 1: color_singleton folded before Flop (didn't bet)
Seat 2: manon327 (button) folded on the Flop
Seat 3: JeBoyDirk (small blind) folded before Flop
Seat 7: Klemtonius (big blind) collected (1323)
Seat 9: dhduncan folded on the Flop



PokerStars Home Game Hand #223927707357: {DaPokaStars}  Hold'em No Limit (50/100) - 2021/02/17 16:18:56 ET
Table 'tonight again' 9-max (Play Money) Seat #3 is the button
Seat 1: color_singleton (12742 in chips) 
Seat 2: manon327 (11363 in chips) 
Seat 3: JeBoyDirk (8995 in chips) 
Seat 7: Klemtonius (12262 in chips) 
Seat 9: dhduncan (13407 in chips) 
Klemtonius: posts small blind 50
dhduncan: posts big blind 100
*** HOLE CARDS ***
Dealt to dhduncan [5c 9c]
color_singleton has timed out
color_singleton: folds 
manon327: calls 100
JeBoyDirk: calls 100
Klemtonius: calls 50
dhduncan: checks 
*** FLOP *** [6c Qs Jd]
Klemtonius: checks 
dhduncan has timed out
dhduncan: checks 
manon327: checks 
JeBoyDirk: checks 
*** TURN *** [6c Qs Jd] [Js]
Klemtonius: checks 
dhduncan: checks 
manon327: bets 378
JeBoyDirk has timed out
JeBoyDirk: folds 
Klemtonius: folds 
dhduncan: folds 
Uncalled bet (378) returned to manon327
manon327 collected 378 from pot
*** SUMMARY ***
Total pot 400 | Rake 22 
Board [6c Qs Jd Js]
Seat 1: color_singleton folded before Flop (didn't bet)
Seat 2: manon327 collected (378)
Seat 3: JeBoyDirk (button) folded on the Turn
Seat 7: Klemtonius (small blind) folded on the Turn
Seat 9: dhduncan (big blind) folded on the Turn



PokerStars Home Game Hand #223927763117: {DaPokaStars}  Hold'em No Limit (50/100) - 2021/02/17 16:20:14 ET
Table 'tonight again' 9-max (Play Money) Seat #7 is the button
Seat 1: color_singleton (12742 in chips) 
Seat 2: manon327 (11641 in chips) 
Seat 7: Klemtonius (12162 in chips) 
Seat 9: dhduncan (13307 in chips) 
dhduncan: posts small blind 50
color_singleton: posts big blind 100
*** HOLE CARDS ***
Dealt to dhduncan [Qd 4d]
manon327: calls 100
Klemtonius: calls 100
dhduncan: calls 50
color_singleton: raises 200 to 300
manon327: folds 
Klemtonius: calls 200
dhduncan: calls 200
*** FLOP *** [9d 8h 4h]
dhduncan: checks 
color_singleton: checks 
Klemtonius: bets 945
dhduncan: folds 
color_singleton: folds 
Uncalled bet (945) returned to Klemtonius
Klemtonius collected 945 from pot
Klemtonius: doesn't show hand 
*** SUMMARY ***
Total pot 1000 | Rake 55 
Board [9d 8h 4h]
Seat 1: color_singleton (big blind) folded on the Flop
Seat 2: manon327 folded before Flop
Seat 7: Klemtonius (button) collected (945)
Seat 9: dhduncan (small blind) folded on the Flop



PokerStars Home Game Hand #223927803013: {DaPokaStars}  Hold'em No Limit (50/100) - 2021/02/17 16:21:10 ET
Table 'tonight again' 9-max (Play Money) Seat #9 is the button
Seat 1: color_singleton (12442 in chips) 
Seat 2: manon327 (11541 in chips) 
Seat 3: JeBoyDirk (8895 in chips) 
Seat 7: Klemtonius (12807 in chips) 
Seat 9: dhduncan (13007 in chips) 
color_singleton: posts small blind 50
manon327: posts big blind 100
*** HOLE CARDS ***
Dealt to dhduncan [9h Th]
JeBoyDirk: raises 100 to 200
Klemtonius: calls 200
dhduncan: folds 
color_singleton: folds 
manon327: folds 
*** FLOP *** [2s 8d 5d]
JeBoyDirk: checks 
Klemtonius: bets 260
JeBoyDirk: calls 260
*** TURN *** [2s 8d 5d] [4h]
JeBoyDirk: bets 300
Klemtonius: folds 
Uncalled bet (300) returned to JeBoyDirk
JeBoyDirk collected 1011 from pot
*** SUMMARY ***
Total pot 1070 | Rake 59 
Board [2s 8d 5d 4h]
Seat 1: color_singleton (small blind) folded before Flop
Seat 2: manon327 (big blind) folded before Flop
Seat 3: JeBoyDirk collected (1011)
Seat 7: Klemtonius folded on the Turn
Seat 9: dhduncan (button) folded before Flop (didn't bet)



PokerStars Home Game Hand #223927838851: {DaPokaStars}  Hold'em No Limit (50/100) - 2021/02/17 16:21:53 ET
Table 'tonight again' 9-max (Play Money) Seat #1 is the button
Seat 1: color_singleton (12392 in chips) 
Seat 2: manon327 (11441 in chips) 
Seat 3: JeBoyDirk (9446 in chips) 
Seat 7: Klemtonius (12347 in chips) 
Seat 9: dhduncan (13007 in chips) 
manon327: posts small blind 50
JeBoyDirk: posts big blind 100
*** HOLE CARDS ***
Dealt to dhduncan [5c Tc]
Klemtonius: calls 100
dhduncan: calls 100
color_singleton: folds 
manon327: calls 50
JeBoyDirk: checks 
*** FLOP *** [9s Kc 5h]
manon327: checks 
JeBoyDirk: checks 
Klemtonius: bets 378
dhduncan: folds 
manon327: folds 
JeBoyDirk: folds 
Uncalled bet (378) returned to Klemtonius
Klemtonius collected 378 from pot
Klemtonius: doesn't show hand 
*** SUMMARY ***
Total pot 400 | Rake 22 
Board [9s Kc 5h]
Seat 1: color_singleton (button) folded before Flop (didn't bet)
Seat 2: manon327 (small blind) folded on the Flop
Seat 3: JeBoyDirk (big blind) folded on the Flop
Seat 7: Klemtonius collected (378)
Seat 9: dhduncan folded on the Flop



PokerStars Home Game Hand #223927867503: {DaPokaStars}  Hold'em No Limit (50/100) - 2021/02/17 16:22:33 ET
Table 'tonight again' 9-max (Play Money) Seat #2 is the button
Seat 1: color_singleton (12392 in chips) 
Seat 2: manon327 (11341 in chips) 
Seat 3: JeBoyDirk (9346 in chips) 
Seat 7: Klemtonius (12625 in chips) 
Seat 9: dhduncan (12907 in chips) 
JeBoyDirk: posts small blind 50
Klemtonius: posts big blind 100
*** HOLE CARDS ***
Dealt to dhduncan [Ac 2d]
dhduncan: calls 100
color_singleton: raises 200 to 300
manon327: folds 
JeBoyDirk: calls 250
Klemtonius: folds 
dhduncan: folds 
*** FLOP *** [7s 9d Qc]
JeBoyDirk: checks 
color_singleton: checks 
*** TURN *** [7s 9d Qc] [8d]
JeBoyDirk: checks 
color_singleton: bets 756
JeBoyDirk: calls 756
*** RIVER *** [7s 9d Qc 8d] [Ks]
JeBoyDirk: checks 
color_singleton: checks 
*** SHOW DOWN ***
JeBoyDirk: shows [4d Ad] (high card Ace)
color_singleton: shows [Jd Kd] (a pair of Kings)
color_singleton collected 2185 from pot
*** SUMMARY ***
Total pot 2312 | Rake 127 
Board [7s 9d Qc 8d Ks]
Seat 1: color_singleton showed [Jd Kd] and won (2185) with a pair of Kings
Seat 2: manon327 (button) folded before Flop (didn't bet)
Seat 3: JeBoyDirk (small blind) showed [4d Ad] and lost with high card Ace
Seat 7: Klemtonius (big blind) folded before Flop
Seat 9: dhduncan folded before Flop



PokerStars Home Game Hand #223927901584: {DaPokaStars}  Hold'em No Limit (50/100) - 2021/02/17 16:23:20 ET
Table 'tonight again' 9-max (Play Money) Seat #3 is the button
Seat 1: color_singleton (13521 in chips) 
Seat 2: manon327 (11341 in chips) 
Seat 3: JeBoyDirk (8290 in chips) 
Seat 7: Klemtonius (12525 in chips) 
Seat 9: dhduncan (12807 in chips) 
Klemtonius: posts small blind 50
dhduncan: posts big blind 100
*** HOLE CARDS ***
Dealt to dhduncan [3h 4s]
color_singleton: raises 200 to 300
manon327: calls 300
JeBoyDirk: folds 
Klemtonius has timed out
Klemtonius: folds 
dhduncan: folds 
*** FLOP *** [4d 5s 6h]
color_singleton: checks 
manon327: checks 
*** TURN *** [4d 5s 6h] [7d]
color_singleton: bets 354
manon327: calls 354
*** RIVER *** [4d 5s 6h 7d] [3s]
color_singleton: bets 689
manon327: calls 689
*** SHOW DOWN ***
color_singleton: shows [Qd 9h] (a straight, Three to Seven)
manon327: shows [Js 7s] (a straight, Three to Seven)
color_singleton collected 1340 from pot
manon327 collected 1340 from pot
*** SUMMARY ***
Total pot 2836 | Rake 156 
Board [4d 5s 6h 7d 3s]
Seat 1: color_singleton showed [Qd 9h] and won (1340) with a straight, Three to Seven
Seat 2: manon327 showed [Js 7s] and won (1340) with a straight, Three to Seven
Seat 3: JeBoyDirk (button) folded before Flop (didn't bet)
Seat 7: Klemtonius (small blind) folded before Flop
Seat 9: dhduncan (big blind) folded before Flop



PokerStars Home Game Hand #223927939173: {DaPokaStars}  Hold'em No Limit (50/100) - 2021/02/17 16:24:13 ET
Table 'tonight again' 9-max (Play Money) Seat #9 is the button
Seat 1: color_singleton (13518 in chips) 
Seat 2: manon327 (11338 in chips) 
Seat 3: JeBoyDirk (8290 in chips) 
Seat 9: dhduncan (12707 in chips) 
color_singleton: posts small blind 50
manon327: posts big blind 100
*** HOLE CARDS ***
Dealt to dhduncan [Td Qd]
JeBoyDirk: raises 100 to 200
dhduncan: calls 200
color_singleton: calls 150
manon327: calls 100
*** FLOP *** [7c 8c 9d]
color_singleton: bets 378
manon327: calls 378
JeBoyDirk: folds 
dhduncan: folds 
*** TURN *** [7c 8c 9d] [Qc]
color_singleton: checks 
manon327: checks 
*** RIVER *** [7c 8c 9d Qc] [7s]
color_singleton: bets 1470
manon327: folds 
Uncalled bet (1470) returned to color_singleton
color_singleton collected 1470 from pot
color_singleton: doesn't show hand 
*** SUMMARY ***
Total pot 1556 | Rake 86 
Board [7c 8c 9d Qc 7s]
Seat 1: color_singleton (small blind) collected (1470)
Seat 2: manon327 (big blind) folded on the River
Seat 3: JeBoyDirk folded on the Flop
Seat 9: dhduncan (button) folded on the Flop



PokerStars Home Game Hand #223927971896: {DaPokaStars}  Hold'em No Limit (50/100) - 2021/02/17 16:24:58 ET
Table 'tonight again' 9-max (Play Money) Seat #1 is the button
Seat 1: color_singleton (14410 in chips) 
Seat 2: manon327 (10760 in chips) 
Seat 3: JeBoyDirk (8090 in chips) 
Seat 9: dhduncan (12507 in chips) 
manon327: posts small blind 50
JeBoyDirk: posts big blind 100
*** HOLE CARDS ***
Dealt to dhduncan [2d Ad]
dhduncan: calls 100
color_singleton: folds 
manon327: calls 50
JeBoyDirk: checks 
*** FLOP *** [9c 4h 3s]
manon327: checks 
JeBoyDirk: checks 
dhduncan: checks 
*** TURN *** [9c 4h 3s] [9s]
manon327: checks 
JeBoyDirk: checks 
dhduncan: checks 
*** RIVER *** [9c 4h 3s 9s] [8d]
manon327: checks 
JeBoyDirk: checks 
dhduncan: checks 
*** SHOW DOWN ***
manon327: shows [Jd 2s] (a pair of Nines)
JeBoyDirk: shows [3h 7c] (two pair, Nines and Threes)
dhduncan: mucks hand 
JeBoyDirk collected 283 from pot
*** SUMMARY ***
Total pot 300 | Rake 17 
Board [9c 4h 3s 9s 8d]
Seat 1: color_singleton (button) folded before Flop (didn't bet)
Seat 2: manon327 (small blind) showed [Jd 2s] and lost with a pair of Nines
Seat 3: JeBoyDirk (big blind) showed [3h 7c] and won (283) with two pair, Nines and Threes
Seat 9: dhduncan mucked [2d Ad]



PokerStars Home Game Hand #223927997499: {DaPokaStars}  Hold'em No Limit (50/100) - 2021/02/17 16:25:34 ET
Table 'tonight again' 9-max (Play Money) Seat #2 is the button
Seat 1: color_singleton (14410 in chips) 
Seat 2: manon327 (10660 in chips) 
Seat 3: JeBoyDirk (8273 in chips) 
Seat 9: dhduncan (12407 in chips) 
JeBoyDirk: posts small blind 50
dhduncan: posts big blind 100
*** HOLE CARDS ***
Dealt to dhduncan [Kh Kc]
color_singleton: raises 200 to 300
manon327: folds 
JeBoyDirk: folds 
dhduncan: calls 200
*** FLOP *** [6s Kd 5h]
dhduncan: checks 
color_singleton: checks 
*** TURN *** [6s Kd 5h] [3s]
dhduncan: bets 200
color_singleton: calls 200
*** RIVER *** [6s Kd 5h 3s] [Jc]
dhduncan: bets 496
color_singleton: calls 496
*** SHOW DOWN ***
dhduncan: shows [Kh Kc] (three of a kind, Kings)
color_singleton: mucks hand 
dhduncan collected 1930 from pot
*** SUMMARY ***
Total pot 2042 | Rake 112 
Board [6s Kd 5h 3s Jc]
Seat 1: color_singleton mucked [Js Ah]
Seat 2: manon327 (button) folded before Flop (didn't bet)
Seat 3: JeBoyDirk (small blind) folded before Flop
Seat 9: dhduncan (big blind) showed [Kh Kc] and won (1930) with three of a kind, Kings



PokerStars Home Game Hand #223928027891: {DaPokaStars}  Hold'em No Limit (50/100) - 2021/02/17 16:26:16 ET
Table 'tonight again' 9-max (Play Money) Seat #3 is the button
Seat 1: color_singleton (13414 in chips) 
Seat 2: manon327 (10660 in chips) 
Seat 3: JeBoyDirk (8223 in chips) 
Seat 9: dhduncan (13341 in chips) 
dhduncan: posts small blind 50
color_singleton: posts big blind 100
*** HOLE CARDS ***
Dealt to dhduncan [Ah Jd]
manon327: calls 100
JeBoyDirk: calls 100
dhduncan: calls 50
color_singleton: checks 
*** FLOP *** [Ad Kc Kd]
dhduncan: checks 
color_singleton: checks 
manon327: checks 
JeBoyDirk: checks 
*** TURN *** [Ad Kc Kd] [5c]
dhduncan: bets 100
color_singleton: folds 
manon327: raises 289 to 389
JeBoyDirk: folds 
dhduncan: calls 289
*** RIVER *** [Ad Kc Kd 5c] [2s]
dhduncan: checks 
manon327: bets 556
dhduncan: calls 556
*** SHOW DOWN ***
manon327: shows [5h Qs] (two pair, Kings and Fives)
dhduncan: shows [Ah Jd] (two pair, Aces and Kings)
dhduncan collected 2164 from pot
*** SUMMARY ***
Total pot 2290 | Rake 126 
Board [Ad Kc Kd 5c 2s]
Seat 1: color_singleton (big blind) folded on the Turn
Seat 2: manon327 showed [5h Qs] and lost with two pair, Kings and Fives
Seat 3: JeBoyDirk (button) folded on the Turn
Seat 9: dhduncan (small blind) showed [Ah Jd] and won (2164) with two pair, Aces and Kings



PokerStars Home Game Hand #223928065619: {DaPokaStars}  Hold'em No Limit (50/100) - 2021/02/17 16:27:03 ET
Table 'tonight again' 9-max (Play Money) Seat #9 is the button
Seat 1: color_singleton (13314 in chips) 
Seat 2: manon327 (9615 in chips) 
Seat 3: JeBoyDirk (8123 in chips) 
Seat 7: Klemtonius (12475 in chips) 
Seat 9: dhduncan (14460 in chips) 
color_singleton: posts small blind 50
manon327: posts big blind 100
Klemtonius: posts small & big blinds 150
*** HOLE CARDS ***
Dealt to dhduncan [4d 6c]
JeBoyDirk: calls 100
Klemtonius: checks 
dhduncan: folds 
color_singleton: raises 300 to 400
manon327: folds 
JeBoyDirk: calls 300
Klemtonius: folds 
*** FLOP *** [Ks Kd 5h]
color_singleton: bets 496
JeBoyDirk: folds 
Uncalled bet (496) returned to color_singleton
color_singleton collected 992 from pot
color_singleton: doesn't show hand 
*** SUMMARY ***
Total pot 1050 | Rake 58 
Board [Ks Kd 5h]
Seat 1: color_singleton (small blind) collected (992)
Seat 2: manon327 (big blind) folded before Flop
Seat 3: JeBoyDirk folded on the Flop
Seat 7: Klemtonius folded before Flop (didn't bet)
Seat 9: dhduncan (button) folded before Flop (didn't bet)



PokerStars Home Game Hand #223928089791: {DaPokaStars}  Hold'em No Limit (50/100) - 2021/02/17 16:27:37 ET
Table 'tonight again' 9-max (Play Money) Seat #1 is the button
Seat 1: color_singleton (13906 in chips) 
Seat 2: manon327 (9515 in chips) 
Seat 3: JeBoyDirk (7723 in chips) 
Seat 7: Klemtonius (12325 in chips) 
Seat 9: dhduncan (14460 in chips) 
manon327: posts small blind 50
JeBoyDirk: posts big blind 100
*** HOLE CARDS ***
Dealt to dhduncan [8h Kc]
Klemtonius: folds 
dhduncan: calls 100
color_singleton: raises 200 to 300
manon327: folds 
JeBoyDirk: calls 200
dhduncan: calls 200
*** FLOP *** [9s Ts 4s]
JeBoyDirk: checks 
dhduncan: checks 
color_singleton: bets 449
JeBoyDirk: calls 449
dhduncan: folds 
*** TURN *** [9s Ts 4s] [6d]
JeBoyDirk: checks 
color_singleton: checks 
*** RIVER *** [9s Ts 4s 6d] [Qs]
JeBoyDirk: checks 
color_singleton: checks 
*** SHOW DOWN ***
JeBoyDirk: shows [Qd Tc] (two pair, Queens and Tens)
color_singleton: mucks hand 
JeBoyDirk collected 1746 from pot
*** SUMMARY ***
Total pot 1848 | Rake 102 
Board [9s Ts 4s 6d Qs]
Seat 1: color_singleton (button) mucked [9d 8d]
Seat 2: manon327 (small blind) folded before Flop
Seat 3: JeBoyDirk (big blind) showed [Qd Tc] and won (1746) with two pair, Queens and Tens
Seat 7: Klemtonius folded before Flop (didn't bet)
Seat 9: dhduncan folded on the Flop



PokerStars Home Game Hand #223928121990: {DaPokaStars}  Hold'em No Limit (50/100) - 2021/02/17 16:28:22 ET
Table 'tonight again' 9-max (Play Money) Seat #2 is the button
Seat 1: color_singleton (13157 in chips) 
Seat 2: manon327 (9465 in chips) 
Seat 3: JeBoyDirk (8720 in chips) 
Seat 7: Klemtonius (12325 in chips) 
Seat 9: dhduncan (14160 in chips) 
JeBoyDirk: posts small blind 50
Klemtonius: posts big blind 100
*** HOLE CARDS ***
Dealt to dhduncan [7d 9s]
dhduncan: folds 
color_singleton: folds 
manon327: calls 100
JeBoyDirk: folds 
Klemtonius: checks 
*** FLOP *** [8c 7h 4d]
Klemtonius: checks 
manon327: checks 
*** TURN *** [8c 7h 4d] [2s]
Klemtonius: checks 
manon327: checks 
*** RIVER *** [8c 7h 4d 2s] [6h]
Klemtonius: bets 236
manon327: raises 236 to 472
Klemtonius: raises 236 to 708
manon327: raises 236 to 944
Klemtonius: calls 236
*** SHOW DOWN ***
manon327: shows [Kd 5d] (a straight, Four to Eight)
Klemtonius: shows [Th 5s] (a straight, Four to Eight)
Klemtonius collected 1010 from pot
manon327 collected 1010 from pot
*** SUMMARY ***
Total pot 2138 | Rake 118 
Board [8c 7h 4d 2s 6h]
Seat 1: color_singleton folded before Flop (didn't bet)
Seat 2: manon327 (button) showed [Kd 5d] and won (1010) with a straight, Four to Eight
Seat 3: JeBoyDirk (small blind) folded before Flop
Seat 7: Klemtonius (big blind) showed [Th 5s] and won (1010) with a straight, Four to Eight
Seat 9: dhduncan folded before Flop (didn't bet)



PokerStars Home Game Hand #223928158656: {DaPokaStars}  Hold'em No Limit (50/100) - 2021/02/17 16:29:14 ET
Table 'tonight again' 9-max (Play Money) Seat #3 is the button
Seat 1: color_singleton (13157 in chips) 
Seat 2: manon327 (9431 in chips) 
Seat 3: JeBoyDirk (8670 in chips) 
Seat 7: Klemtonius (12291 in chips) 
Seat 9: dhduncan (14160 in chips) 
Klemtonius: posts small blind 50
dhduncan: posts big blind 100
*** HOLE CARDS ***
Dealt to dhduncan [Kd 7s]
color_singleton: raises 200 to 300
manon327: calls 300
JeBoyDirk: folds 
Klemtonius: calls 250
dhduncan: folds 
*** FLOP *** [8s 2c 4c]
Klemtonius: checks 
color_singleton: checks 
manon327: checks 
*** TURN *** [8s 2c 4c] [6h]
Klemtonius: checks 
color_singleton: checks 
manon327: checks 
*** RIVER *** [8s 2c 4c 6h] [Td]
Klemtonius: checks 
color_singleton: checks 
manon327: checks 
*** SHOW DOWN ***
Klemtonius: shows [9c Qh] (high card Queen)
color_singleton: mucks hand 
manon327: mucks hand 
Klemtonius collected 945 from pot
*** SUMMARY ***
Total pot 1000 | Rake 55 
Board [8s 2c 4c 6h Td]
Seat 1: color_singleton mucked [9h Jh]
Seat 2: manon327 mucked [Jc 5d]
Seat 3: JeBoyDirk (button) folded before Flop (didn't bet)
Seat 7: Klemtonius (small blind) showed [9c Qh] and won (945) with high card Queen
Seat 9: dhduncan (big blind) folded before Flop



PokerStars Home Game Hand #223928192949: {DaPokaStars}  Hold'em No Limit (50/100) - 2021/02/17 16:30:02 ET
Table 'tonight again' 9-max (Play Money) Seat #7 is the button
Seat 1: color_singleton (12857 in chips) 
Seat 2: manon327 (9131 in chips) 
Seat 3: JeBoyDirk (8670 in chips) 
Seat 7: Klemtonius (12936 in chips) 
Seat 9: dhduncan (14060 in chips) 
dhduncan: posts small blind 50
color_singleton: posts big blind 100
*** HOLE CARDS ***
Dealt to dhduncan [9s Jc]
manon327: calls 100
JeBoyDirk: folds 
Klemtonius: calls 100
dhduncan: calls 50
color_singleton: checks 
*** FLOP *** [3s 5d 9d]
dhduncan: bets 189
color_singleton: calls 189
manon327: calls 189
Klemtonius: raises 189 to 378
dhduncan: folds 
color_singleton: calls 189
manon327: calls 189
*** TURN *** [3s 5d 9d] [Ts]
color_singleton: checks 
manon327: checks 
Klemtonius: bets 1628
color_singleton: folds 
manon327: folds 
Uncalled bet (1628) returned to Klemtonius
Klemtonius collected 1628 from pot
Klemtonius: doesn't show hand 
*** SUMMARY ***
Total pot 1723 | Rake 95 
Board [3s 5d 9d Ts]
Seat 1: color_singleton (big blind) folded on the Turn
Seat 2: manon327 folded on the Turn
Seat 3: JeBoyDirk folded before Flop (didn't bet)
Seat 7: Klemtonius (button) collected (1628)
Seat 9: dhduncan (small blind) folded on the Flop



PokerStars Home Game Hand #223928240766: {DaPokaStars}  Hold'em No Limit (50/100) - 2021/02/17 16:30:58 ET
Table 'tonight again' 9-max (Play Money) Seat #9 is the button
Seat 1: color_singleton (12379 in chips) 
Seat 2: manon327 (8653 in chips) 
Seat 3: JeBoyDirk (8670 in chips) 
Seat 7: Klemtonius (14086 in chips) 
Seat 9: dhduncan (13771 in chips) 
color_singleton: posts small blind 50
manon327: posts big blind 100
*** HOLE CARDS ***
Dealt to dhduncan [Js 2s]
JeBoyDirk: folds 
Klemtonius: calls 100
dhduncan: calls 100
color_singleton: calls 50
manon327: checks 
*** FLOP *** [6d Ac 3c]
color_singleton: bets 189
manon327: calls 189
Klemtonius: folds 
dhduncan: folds 
*** TURN *** [6d Ac 3c] [Th]
color_singleton: checks 
manon327: checks 
*** RIVER *** [6d Ac 3c Th] [4h]
color_singleton: bets 367
manon327: folds 
Uncalled bet (367) returned to color_singleton
color_singleton collected 735 from pot
color_singleton: doesn't show hand 
*** SUMMARY ***
Total pot 778 | Rake 43 
Board [6d Ac 3c Th 4h]
Seat 1: color_singleton (small blind) collected (735)
Seat 2: manon327 (big blind) folded on the River
Seat 3: JeBoyDirk folded before Flop (didn't bet)
Seat 7: Klemtonius folded on the Flop
Seat 9: dhduncan (button) folded on the Flop



PokerStars Home Game Hand #223928263651: {DaPokaStars}  Hold'em No Limit (50/100) - 2021/02/17 16:31:31 ET
Table 'tonight again' 9-max (Play Money) Seat #1 is the button
Seat 1: color_singleton (12825 in chips) 
Seat 2: manon327 (8364 in chips) 
Seat 3: JeBoyDirk (8670 in chips) 
Seat 7: Klemtonius (13986 in chips) 
Seat 9: dhduncan (13671 in chips) 
manon327: posts small blind 50
JeBoyDirk: posts big blind 100
*** HOLE CARDS ***
Dealt to dhduncan [7d 3s]
Klemtonius: calls 100
dhduncan: folds 
color_singleton: folds 
manon327: calls 50
JeBoyDirk: checks 
*** FLOP *** [7c 9h Ac]
manon327: checks 
JeBoyDirk: checks 
Klemtonius: bets 283
manon327: folds 
JeBoyDirk: folds 
Uncalled bet (283) returned to Klemtonius
Klemtonius collected 283 from pot
Klemtonius: doesn't show hand 
*** SUMMARY ***
Total pot 300 | Rake 17 
Board [7c 9h Ac]
Seat 1: color_singleton (button) folded before Flop (didn't bet)
Seat 2: manon327 (small blind) folded on the Flop
Seat 3: JeBoyDirk (big blind) folded on the Flop
Seat 7: Klemtonius collected (283)
Seat 9: dhduncan folded before Flop (didn't bet)



PokerStars Home Game Hand #223928281374: {DaPokaStars}  Hold'em No Limit (50/100) - 2021/02/17 16:31:56 ET
Table 'tonight again' 9-max (Play Money) Seat #2 is the button
Seat 1: color_singleton (12825 in chips) 
Seat 2: manon327 (8264 in chips) 
Seat 3: JeBoyDirk (8570 in chips) 
Seat 7: Klemtonius (14169 in chips) 
Seat 9: dhduncan (13671 in chips) 
JeBoyDirk: posts small blind 50
Klemtonius: posts big blind 100
*** HOLE CARDS ***
Dealt to dhduncan [Kd 2c]
dhduncan: calls 100
color_singleton: folds 
manon327: calls 100
JeBoyDirk: folds 
Klemtonius: checks 
*** FLOP *** [2s 7h 4c]
Klemtonius: checks 
dhduncan: checks 
manon327: checks 
*** TURN *** [2s 7h 4c] [Qc]
Klemtonius: bets 331
dhduncan: folds 
manon327: folds 
Uncalled bet (331) returned to Klemtonius
Klemtonius collected 331 from pot
Klemtonius: doesn't show hand 
*** SUMMARY ***
Total pot 350 | Rake 19 
Board [2s 7h 4c Qc]
Seat 1: color_singleton folded before Flop (didn't bet)
Seat 2: manon327 (button) folded on the Turn
Seat 3: JeBoyDirk (small blind) folded before Flop
Seat 7: Klemtonius (big blind) collected (331)
Seat 9: dhduncan folded on the Turn



PokerStars Home Game Hand #223928299971: {DaPokaStars}  Hold'em No Limit (50/100) - 2021/02/17 16:32:22 ET
Table 'tonight again' 9-max (Play Money) Seat #3 is the button
Seat 1: color_singleton (12825 in chips) 
Seat 2: manon327 (8164 in chips) 
Seat 3: JeBoyDirk (8520 in chips) 
Seat 7: Klemtonius (14400 in chips) 
Seat 9: dhduncan (13571 in chips) 
Klemtonius: posts small blind 50
dhduncan: posts big blind 100
*** HOLE CARDS ***
Dealt to dhduncan [4s As]
color_singleton: raises 200 to 300
manon327: calls 300
JeBoyDirk: folds 
Klemtonius: calls 250
dhduncan: calls 200
*** FLOP *** [Qc Ts Th]
Klemtonius: bets 1134
dhduncan: folds 
color_singleton: folds 
manon327: folds 
Uncalled bet (1134) returned to Klemtonius
Klemtonius collected 1134 from pot
Klemtonius: doesn't show hand 
*** SUMMARY ***
Total pot 1200 | Rake 66 
Board [Qc Ts Th]
Seat 1: color_singleton folded on the Flop
Seat 2: manon327 folded on the Flop
Seat 3: JeBoyDirk (button) folded before Flop (didn't bet)
Seat 7: Klemtonius (small blind) collected (1134)
Seat 9: dhduncan (big blind) folded on the Flop



PokerStars Home Game Hand #223928315296: {DaPokaStars}  Hold'em No Limit (50/100) - 2021/02/17 16:32:44 ET
Table 'tonight again' 9-max (Play Money) Seat #7 is the button
Seat 1: color_singleton (12525 in chips) 
Seat 2: manon327 (7864 in chips) 
Seat 3: JeBoyDirk (8520 in chips) 
Seat 7: Klemtonius (15234 in chips) 
Seat 9: dhduncan (13271 in chips) 
dhduncan: posts small blind 50
color_singleton: posts big blind 100
*** HOLE CARDS ***
Dealt to dhduncan [5c Jh]
manon327: calls 100
JeBoyDirk: calls 100
Klemtonius: calls 100
dhduncan: folds 
color_singleton: checks 
*** FLOP *** [3h 7c 6s]
color_singleton: checks 
manon327: checks 
JeBoyDirk: checks 
Klemtonius: bets 425
color_singleton: folds 
manon327: folds 
JeBoyDirk: folds 
Uncalled bet (425) returned to Klemtonius
Klemtonius collected 425 from pot
Klemtonius: doesn't show hand 
*** SUMMARY ***
Total pot 450 | Rake 25 
Board [3h 7c 6s]
Seat 1: color_singleton (big blind) folded on the Flop
Seat 2: manon327 folded on the Flop
Seat 3: JeBoyDirk folded on the Flop
Seat 7: Klemtonius (button) collected (425)
Seat 9: dhduncan (small blind) folded before Flop



PokerStars Home Game Hand #223928338659: {DaPokaStars}  Hold'em No Limit (50/100) - 2021/02/17 16:33:17 ET
Table 'tonight again' 9-max (Play Money) Seat #9 is the button
Seat 1: color_singleton (12425 in chips) 
Seat 2: manon327 (7764 in chips) 
Seat 3: JeBoyDirk (8420 in chips) 
Seat 7: Klemtonius (15559 in chips) 
Seat 9: dhduncan (13221 in chips) 
color_singleton: posts small blind 50
manon327: posts big blind 100
*** HOLE CARDS ***
Dealt to dhduncan [Qd Qh]
JeBoyDirk: folds 
Klemtonius: folds 
dhduncan: calls 100
color_singleton: calls 50
manon327: checks 
*** FLOP *** [8c Qc 7h]
color_singleton: checks 
manon327: checks 
dhduncan: bets 100
color_singleton: folds 
manon327: calls 100
*** TURN *** [8c Qc 7h] [5h]
manon327: checks 
dhduncan: bets 100
manon327: calls 100
*** RIVER *** [8c Qc 7h 5h] [Js]
manon327: checks 
dhduncan: bets 661
manon327: folds 
Uncalled bet (661) returned to dhduncan
dhduncan collected 661 from pot
dhduncan: doesn't show hand 
*** SUMMARY ***
Total pot 700 | Rake 39 
Board [8c Qc 7h 5h Js]
Seat 1: color_singleton (small blind) folded on the Flop
Seat 2: manon327 (big blind) folded on the River
Seat 3: JeBoyDirk folded before Flop (didn't bet)
Seat 7: Klemtonius folded before Flop (didn't bet)
Seat 9: dhduncan (button) collected (661)



PokerStars Home Game Hand #223928372214: {DaPokaStars}  Hold'em No Limit (50/100) - 2021/02/17 16:34:05 ET
Table 'tonight again' 9-max (Play Money) Seat #1 is the button
Seat 1: color_singleton (12325 in chips) 
Seat 2: manon327 (7464 in chips) 
Seat 3: JeBoyDirk (8420 in chips) 
Seat 7: Klemtonius (15559 in chips) 
Seat 9: dhduncan (13582 in chips) 
manon327: posts small blind 50
JeBoyDirk: posts big blind 100
*** HOLE CARDS ***
Dealt to dhduncan [7c Ah]
Klemtonius: raises 100 to 200
dhduncan: calls 200
color_singleton: folds 
manon327: calls 150
JeBoyDirk: folds 
*** FLOP *** [6d 9h As]
manon327: checks 
Klemtonius: checks 
dhduncan: bets 330
manon327: folds 
Klemtonius: folds 
Uncalled bet (330) returned to dhduncan
dhduncan collected 661 from pot
*** SUMMARY ***
Total pot 700 | Rake 39 
Board [6d 9h As]
Seat 1: color_singleton (button) folded before Flop (didn't bet)
Seat 2: manon327 (small blind) folded on the Flop
Seat 3: JeBoyDirk (big blind) folded before Flop
Seat 7: Klemtonius folded on the Flop
Seat 9: dhduncan collected (661)



PokerStars Home Game Hand #223928405367: {DaPokaStars}  Hold'em No Limit (50/100) - 2021/02/17 16:34:53 ET
Table 'tonight again' 9-max (Play Money) Seat #2 is the button
Seat 1: color_singleton (12325 in chips) 
Seat 2: manon327 (7264 in chips) 
Seat 3: JeBoyDirk (8320 in chips) 
Seat 7: Klemtonius (15359 in chips) 
Seat 9: dhduncan (14043 in chips) 
JeBoyDirk: posts small blind 50
Klemtonius: posts big blind 100
*** HOLE CARDS ***
Dealt to dhduncan [5s Qd]
dhduncan: folds 
color_singleton: folds 
manon327: folds 
JeBoyDirk: calls 50
Klemtonius: checks 
*** FLOP *** [8c 2s 5h]
JeBoyDirk: checks 
Klemtonius: checks 
*** TURN *** [8c 2s 5h] [Ac]
JeBoyDirk: checks 
Klemtonius: checks 
*** RIVER *** [8c 2s 5h Ac] [9h]
JeBoyDirk: bets 200
Klemtonius: folds 
Uncalled bet (200) returned to JeBoyDirk
JeBoyDirk collected 189 from pot
*** SUMMARY ***
Total pot 200 | Rake 11 
Board [8c 2s 5h Ac 9h]
Seat 1: color_singleton folded before Flop (didn't bet)
Seat 2: manon327 (button) folded before Flop (didn't bet)
Seat 3: JeBoyDirk (small blind) collected (189)
Seat 7: Klemtonius (big blind) folded on the River
Seat 9: dhduncan folded before Flop (didn't bet)



PokerStars Home Game Hand #223928426752: {DaPokaStars}  Hold'em No Limit (50/100) - 2021/02/17 16:35:22 ET
Table 'tonight again' 9-max (Play Money) Seat #3 is the button
Seat 1: color_singleton (12325 in chips) 
Seat 2: manon327 (7264 in chips) 
Seat 3: JeBoyDirk (8409 in chips) 
Seat 7: Klemtonius (15259 in chips) 
Seat 9: dhduncan (14043 in chips) 
Klemtonius: posts small blind 50
dhduncan: posts big blind 100
*** HOLE CARDS ***
Dealt to dhduncan [6d Ts]
color_singleton: folds 
manon327: calls 100
JeBoyDirk: folds 
Klemtonius: calls 50
dhduncan: checks 
*** FLOP *** [2d Ad 5c]
Klemtonius: checks 
dhduncan: checks 
manon327: checks 
*** TURN *** [2d Ad 5c] [As]
Klemtonius: checks 
dhduncan: checks 
manon327: checks 
*** RIVER *** [2d Ad 5c As] [9d]
Klemtonius: bets 283
dhduncan: folds 
manon327: folds 
Uncalled bet (283) returned to Klemtonius
Klemtonius collected 283 from pot
Klemtonius: doesn't show hand 
*** SUMMARY ***
Total pot 300 | Rake 17 
Board [2d Ad 5c As 9d]
Seat 1: color_singleton folded before Flop (didn't bet)
Seat 2: manon327 folded on the River
Seat 3: JeBoyDirk (button) folded before Flop (didn't bet)
Seat 7: Klemtonius (small blind) collected (283)
Seat 9: dhduncan (big blind) folded on the River



PokerStars Home Game Hand #223928453010: {DaPokaStars}  Hold'em No Limit (50/100) - 2021/02/17 16:36:00 ET
Table 'tonight again' 9-max (Play Money) Seat #7 is the button
Seat 1: color_singleton (12325 in chips) 
Seat 2: manon327 (7164 in chips) 
Seat 3: JeBoyDirk (8409 in chips) 
Seat 7: Klemtonius (15442 in chips) 
Seat 9: dhduncan (13943 in chips) 
dhduncan: posts small blind 50
color_singleton: posts big blind 100
*** HOLE CARDS ***
Dealt to dhduncan [2h 7c]
manon327: raises 100 to 200
JeBoyDirk: folds 
Klemtonius: raises 550 to 750
dhduncan: folds 
color_singleton: folds 
manon327: calls 550
*** FLOP *** [Js 5s 5h]
manon327: bets 779
Klemtonius: raises 3821 to 4600
manon327: raises 1814 to 6414 and is all-in
Klemtonius: calls 1814
*** TURN *** [Js 5s 5h] [7s]
*** RIVER *** [Js 5s 5h 7s] [8s]
*** SHOW DOWN ***
manon327: shows [Jc Jd] (a full house, Jacks full of Fives)
Klemtonius: shows [Ts 9s] (a straight flush, Seven to Jack)
Klemtonius collected 13682 from pot
*** SUMMARY ***
Total pot 14478 | Rake 796 
Board [Js 5s 5h 7s 8s]
Seat 1: color_singleton (big blind) folded before Flop
Seat 2: manon327 showed [Jc Jd] and lost with a full house, Jacks full of Fives
Seat 3: JeBoyDirk folded before Flop (didn't bet)
Seat 7: Klemtonius (button) showed [Ts 9s] and won (13682) with a straight flush, Seven to Jack
Seat 9: dhduncan (small blind) folded before Flop



PokerStars Home Game Hand #223928478698: {DaPokaStars}  Hold'em No Limit (50/100) - 2021/02/17 16:36:37 ET
Table 'tonight again' 9-max (Play Money) Seat #9 is the button
Seat 1: color_singleton (12225 in chips) 
Seat 3: JeBoyDirk (8409 in chips) 
Seat 7: Klemtonius (21960 in chips) 
Seat 9: dhduncan (13893 in chips) 
color_singleton: posts small blind 50
JeBoyDirk: posts big blind 100
*** HOLE CARDS ***
Dealt to dhduncan [2d 8s]
Klemtonius: raises 100 to 200
dhduncan: folds 
color_singleton: calls 150
JeBoyDirk: folds 
*** FLOP *** [6h 4c Kc]
color_singleton: checks 
Klemtonius: bets 100
color_singleton: folds 
Uncalled bet (100) returned to Klemtonius
Klemtonius collected 472 from pot
Klemtonius: doesn't show hand 
*** SUMMARY ***
Total pot 500 | Rake 28 
Board [6h 4c Kc]
Seat 1: color_singleton (small blind) folded on the Flop
Seat 3: JeBoyDirk (big blind) folded before Flop
Seat 7: Klemtonius collected (472)
Seat 9: dhduncan (button) folded before Flop (didn't bet)



PokerStars Home Game Hand #223928504811: {DaPokaStars}  Hold'em No Limit (50/100) - 2021/02/17 16:37:15 ET
Table 'tonight again' 9-max (Play Money) Seat #1 is the button
Seat 1: color_singleton (12025 in chips) 
Seat 3: JeBoyDirk (8309 in chips) 
Seat 7: Klemtonius (22232 in chips) 
Seat 9: dhduncan (13893 in chips) 
JeBoyDirk: posts small blind 50
Klemtonius: posts big blind 100
*** HOLE CARDS ***
Dealt to dhduncan [8s 6h]
dhduncan: folds 
color_singleton: raises 200 to 300
JeBoyDirk: folds 
Klemtonius: calls 200
*** FLOP *** [5c 8h 9h]
Klemtonius: checks 
color_singleton: bets 307
Klemtonius: folds 
Uncalled bet (307) returned to color_singleton
color_singleton collected 614 from pot
color_singleton: doesn't show hand 
*** SUMMARY ***
Total pot 650 | Rake 36 
Board [5c 8h 9h]
Seat 1: color_singleton (button) collected (614)
Seat 3: JeBoyDirk (small blind) folded before Flop
Seat 7: Klemtonius (big blind) folded on the Flop
Seat 9: dhduncan folded before Flop (didn't bet)



PokerStars Home Game Hand #223928538775: {DaPokaStars}  Hold'em No Limit (50/100) - 2021/02/17 16:38:03 ET
Table 'tonight again' 9-max (Play Money) Seat #3 is the button
Seat 1: color_singleton (12339 in chips) 
Seat 2: manon327 (10000 in chips) 
Seat 3: JeBoyDirk (8259 in chips) 
Seat 7: Klemtonius (21932 in chips) 
Seat 9: dhduncan (13893 in chips) 
Klemtonius: posts small blind 50
dhduncan: posts big blind 100
manon327: posts small & big blinds 150
*** HOLE CARDS ***
Dealt to dhduncan [9c 9s]
color_singleton: calls 100
manon327: checks 
JeBoyDirk: folds 
Klemtonius: calls 50
dhduncan: checks 
*** FLOP *** [7h Kc Ac]
Klemtonius: bets 425
dhduncan: folds 
color_singleton: folds 
manon327: folds 
Uncalled bet (425) returned to Klemtonius
Klemtonius collected 425 from pot
Klemtonius: doesn't show hand 
*** SUMMARY ***
Total pot 450 | Rake 25 
Board [7h Kc Ac]
Seat 1: color_singleton folded on the Flop
Seat 2: manon327 folded on the Flop (didn't bet)
Seat 3: JeBoyDirk (button) folded before Flop (didn't bet)
Seat 7: Klemtonius (small blind) collected (425)
Seat 9: dhduncan (big blind) folded on the Flop



PokerStars Home Game Hand #223928577850: {DaPokaStars}  Hold'em No Limit (50/100) - 2021/02/17 16:38:56 ET
Table 'tonight again' 9-max (Play Money) Seat #7 is the button
Seat 1: color_singleton (12239 in chips) 
Seat 2: manon327 (9850 in chips) 
Seat 3: JeBoyDirk (8259 in chips) 
Seat 7: Klemtonius (22257 in chips) 
Seat 9: dhduncan (13793 in chips) 
dhduncan: posts small blind 50
color_singleton: posts big blind 100
*** HOLE CARDS ***
Dealt to dhduncan [5s Ts]
manon327: raises 100 to 200
JeBoyDirk: calls 200
Klemtonius: folds 
dhduncan: folds 
color_singleton: calls 100
*** FLOP *** [5h 9s Ac]
color_singleton: checks 
manon327: checks 
JeBoyDirk: checks 
*** TURN *** [5h 9s Ac] [5d]
color_singleton: checks 
manon327: checks 
JeBoyDirk: checks 
*** RIVER *** [5h 9s Ac 5d] [6d]
color_singleton: bets 900
manon327: calls 900
JeBoyDirk: folds 
*** SHOW DOWN ***
color_singleton: shows [6s 6c] (a full house, Sixes full of Fives)
manon327: mucks hand 
color_singleton collected 2315 from pot
*** SUMMARY ***
Total pot 2450 | Rake 135 
Board [5h 9s Ac 5d 6d]
Seat 1: color_singleton (big blind) showed [6s 6c] and won (2315) with a full house, Sixes full of Fives
Seat 2: manon327 mucked [Kh Qs]
Seat 3: JeBoyDirk folded on the River
Seat 7: Klemtonius (button) folded before Flop (didn't bet)
Seat 9: dhduncan (small blind) folded before Flop



PokerStars Home Game Hand #223928618168: {DaPokaStars}  Hold'em No Limit (50/100) - 2021/02/17 16:39:54 ET
Table 'tonight again' 9-max (Play Money) Seat #9 is the button
Seat 1: color_singleton (13454 in chips) 
Seat 2: manon327 (8750 in chips) 
Seat 3: JeBoyDirk (8059 in chips) 
Seat 7: Klemtonius (22257 in chips) 
Seat 9: dhduncan (13743 in chips) 
color_singleton: posts small blind 50
manon327: posts big blind 100
*** HOLE CARDS ***
Dealt to dhduncan [Ad 7d]
JeBoyDirk: folds 
Klemtonius: raises 100 to 200
dhduncan: calls 200
color_singleton: calls 150
manon327: calls 100
*** FLOP *** [2c 6h 9c]
color_singleton: bets 378
manon327: calls 378
Klemtonius: folds 
dhduncan: folds 
*** TURN *** [2c 6h 9c] [Ts]
color_singleton: bets 735
manon327: calls 735
*** RIVER *** [2c 6h 9c Ts] [5s]
color_singleton: bets 1430
manon327: folds 
Uncalled bet (1430) returned to color_singleton
color_singleton collected 2860 from pot
color_singleton: doesn't show hand 
*** SUMMARY ***
Total pot 3026 | Rake 166 
Board [2c 6h 9c Ts 5s]
Seat 1: color_singleton (small blind) collected (2860)
Seat 2: manon327 (big blind) folded on the River
Seat 3: JeBoyDirk folded before Flop (didn't bet)
Seat 7: Klemtonius folded on the Flop
Seat 9: dhduncan (button) folded on the Flop



PokerStars Home Game Hand #223928650630: {DaPokaStars}  Hold'em No Limit (50/100) - 2021/02/17 16:40:41 ET
Table 'tonight again' 9-max (Play Money) Seat #1 is the button
Seat 1: color_singleton (15001 in chips) 
Seat 2: manon327 (7437 in chips) 
Seat 3: JeBoyDirk (8059 in chips) 
Seat 7: Klemtonius (22057 in chips) 
Seat 9: dhduncan (13543 in chips) 
manon327: posts small blind 50
JeBoyDirk: posts big blind 100
*** HOLE CARDS ***
Dealt to dhduncan [Kd Td]
Klemtonius: raises 100 to 200
dhduncan: calls 200
color_singleton: folds 
manon327: calls 150
JeBoyDirk: calls 100
*** FLOP *** [5h 8d Jc]
manon327: checks 
JeBoyDirk: bets 300
Klemtonius: calls 300
dhduncan: folds 
manon327: calls 300
*** TURN *** [5h 8d Jc] [9c]
manon327: checks 
JeBoyDirk: bets 500
Klemtonius: folds 
manon327: calls 500
*** RIVER *** [5h 8d Jc 9c] [2d]
manon327: checks 
JeBoyDirk: checks 
*** SHOW DOWN ***
manon327: shows [7d Jd] (a pair of Jacks)
JeBoyDirk: shows [Qd Js] (a pair of Jacks - Queen kicker)
JeBoyDirk collected 2551 from pot
*** SUMMARY ***
Total pot 2700 | Rake 149 
Board [5h 8d Jc 9c 2d]
Seat 1: color_singleton (button) folded before Flop (didn't bet)
Seat 2: manon327 (small blind) showed [7d Jd] and lost with a pair of Jacks
Seat 3: JeBoyDirk (big blind) showed [Qd Js] and won (2551) with a pair of Jacks
Seat 7: Klemtonius folded on the Turn
Seat 9: dhduncan folded on the Flop



PokerStars Home Game Hand #223928699397: {DaPokaStars}  Hold'em No Limit (50/100) - 2021/02/17 16:41:53 ET
Table 'tonight again' 9-max (Play Money) Seat #2 is the button
Seat 1: color_singleton (15001 in chips) 
Seat 2: manon327 (6437 in chips) 
Seat 3: JeBoyDirk (9610 in chips) 
Seat 7: Klemtonius (21557 in chips) 
Seat 9: dhduncan (13343 in chips) 
JeBoyDirk: posts small blind 50
Klemtonius: posts big blind 100
*** HOLE CARDS ***
Dealt to dhduncan [Kh 5s]
dhduncan: calls 100
color_singleton: folds 
manon327: calls 100
JeBoyDirk: folds 
Klemtonius: checks 
*** FLOP *** [3d 4s 4c]
Klemtonius: bets 331
dhduncan: folds 
manon327: folds 
Uncalled bet (331) returned to Klemtonius
Klemtonius collected 331 from pot
Klemtonius: doesn't show hand 
*** SUMMARY ***
Total pot 350 | Rake 19 
Board [3d 4s 4c]
Seat 1: color_singleton folded before Flop (didn't bet)
Seat 2: manon327 (button) folded on the Flop
Seat 3: JeBoyDirk (small blind) folded before Flop
Seat 7: Klemtonius (big blind) collected (331)
Seat 9: dhduncan folded on the Flop



PokerStars Home Game Hand #223928715218: {DaPokaStars}  Hold'em No Limit (50/100) - 2021/02/17 16:42:17 ET
Table 'tonight again' 9-max (Play Money) Seat #3 is the button
Seat 1: color_singleton (15001 in chips) 
Seat 2: manon327 (6337 in chips) 
Seat 3: JeBoyDirk (9560 in chips) 
Seat 7: Klemtonius (21788 in chips) 
Seat 9: dhduncan (13243 in chips) 
Klemtonius: posts small blind 50
dhduncan: posts big blind 100
*** HOLE CARDS ***
Dealt to dhduncan [8h Qd]
color_singleton: calls 100
manon327: folds 
JeBoyDirk: calls 100
Klemtonius: calls 50
dhduncan: checks 
*** FLOP *** [Td 6d 6c]
Klemtonius: checks 
dhduncan: checks 
color_singleton: bets 189
JeBoyDirk: folds 
Klemtonius: folds 
dhduncan: folds 
Uncalled bet (189) returned to color_singleton
color_singleton collected 378 from pot
color_singleton: doesn't show hand 
*** SUMMARY ***
Total pot 400 | Rake 22 
Board [Td 6d 6c]
Seat 1: color_singleton collected (378)
Seat 2: manon327 folded before Flop (didn't bet)
Seat 3: JeBoyDirk (button) folded on the Flop
Seat 7: Klemtonius (small blind) folded on the Flop
Seat 9: dhduncan (big blind) folded on the Flop



PokerStars Home Game Hand #223928740608: {DaPokaStars}  Hold'em No Limit (50/100) - 2021/02/17 16:42:55 ET
Table 'tonight again' 9-max (Play Money) Seat #7 is the button
Seat 1: color_singleton (15279 in chips) 
Seat 2: manon327 (6337 in chips) 
Seat 3: JeBoyDirk (9460 in chips) 
Seat 7: Klemtonius (21688 in chips) 
Seat 9: dhduncan (13143 in chips) 
dhduncan: posts small blind 50
color_singleton: posts big blind 100
*** HOLE CARDS ***
Dealt to dhduncan [9s 7h]
manon327: calls 100
JeBoyDirk: calls 100
Klemtonius: calls 100
dhduncan: folds 
color_singleton: checks 
*** FLOP *** [Ts Qd 5h]
color_singleton: bets 212
manon327: calls 212
JeBoyDirk: folds 
Klemtonius: folds 
*** TURN *** [Ts Qd 5h] [5d]
color_singleton: checks 
manon327: checks 
*** RIVER *** [Ts Qd 5h 5d] [3d]
color_singleton: bets 826
manon327: folds 
Uncalled bet (826) returned to color_singleton
color_singleton collected 826 from pot
color_singleton: doesn't show hand 
*** SUMMARY ***
Total pot 874 | Rake 48 
Board [Ts Qd 5h 5d 3d]
Seat 1: color_singleton (big blind) collected (826)
Seat 2: manon327 folded on the River
Seat 3: JeBoyDirk folded on the Flop
Seat 7: Klemtonius (button) folded on the Flop
Seat 9: dhduncan (small blind) folded before Flop



PokerStars Home Game Hand #223928770997: {DaPokaStars}  Hold'em No Limit (50/100) - 2021/02/17 16:43:40 ET
Table 'tonight again' 9-max (Play Money) Seat #9 is the button
Seat 1: color_singleton (15793 in chips) 
Seat 2: manon327 (6025 in chips) 
Seat 3: JeBoyDirk (9360 in chips) 
Seat 7: Klemtonius (21588 in chips) 
Seat 9: dhduncan (13093 in chips) 
color_singleton: posts small blind 50
manon327: posts big blind 100
*** HOLE CARDS ***
Dealt to dhduncan [4c Th]
JeBoyDirk: calls 100
Klemtonius: raises 100 to 200
dhduncan: folds 
color_singleton: folds 
manon327: calls 100
JeBoyDirk: calls 100
*** FLOP *** [As Ah Td]
manon327: checks 
JeBoyDirk: checks 
Klemtonius: bets 100
manon327: calls 100
JeBoyDirk: calls 100
*** TURN *** [As Ah Td] [4h]
manon327: checks 
JeBoyDirk: checks 
Klemtonius: bets 449
manon327: folds 
JeBoyDirk: folds 
Uncalled bet (449) returned to Klemtonius
Klemtonius collected 898 from pot
Klemtonius: doesn't show hand 
*** SUMMARY ***
Total pot 950 | Rake 52 
Board [As Ah Td 4h]
Seat 1: color_singleton (small blind) folded before Flop
Seat 2: manon327 (big blind) folded on the Turn
Seat 3: JeBoyDirk folded on the Turn
Seat 7: Klemtonius collected (898)
Seat 9: dhduncan (button) folded before Flop (didn't bet)



PokerStars Home Game Hand #223928803553: {DaPokaStars}  Hold'em No Limit (50/100) - 2021/02/17 16:44:29 ET
Table 'tonight again' 9-max (Play Money) Seat #1 is the button
Seat 1: color_singleton (15743 in chips) 
Seat 2: manon327 (5725 in chips) 
Seat 3: JeBoyDirk (9060 in chips) 
Seat 7: Klemtonius (22186 in chips) 
Seat 9: dhduncan (13093 in chips) 
manon327: posts small blind 50
JeBoyDirk: posts big blind 100
*** HOLE CARDS ***
Dealt to dhduncan [Jc 7s]
Klemtonius: raises 100 to 200
dhduncan: folds 
color_singleton: calls 200
manon327: folds 
JeBoyDirk: calls 100
*** FLOP *** [4d 2s 2h]
JeBoyDirk: checks 
Klemtonius: bets 100
color_singleton: calls 100
JeBoyDirk: calls 100
*** TURN *** [4d 2s 2h] [9c]
JeBoyDirk: checks 
Klemtonius: checks 
color_singleton: checks 
*** RIVER *** [4d 2s 2h 9c] [3c]
JeBoyDirk: checks 
Klemtonius: checks 
color_singleton: checks 
*** SHOW DOWN ***
JeBoyDirk: shows [Ad Jd] (a pair of Deuces)
Klemtonius: mucks hand 
color_singleton: mucks hand 
JeBoyDirk collected 898 from pot
*** SUMMARY ***
Total pot 950 | Rake 52 
Board [4d 2s 2h 9c 3c]
Seat 1: color_singleton (button) mucked [Ks 5h]
Seat 2: manon327 (small blind) folded before Flop
Seat 3: JeBoyDirk (big blind) showed [Ad Jd] and won (898) with a pair of Deuces
Seat 7: Klemtonius mucked [Td Kd]
Seat 9: dhduncan folded before Flop (didn't bet)



PokerStars Home Game Hand #223928838088: {DaPokaStars}  Hold'em No Limit (50/100) - 2021/02/17 16:45:10 ET
Table 'tonight again' 9-max (Play Money) Seat #2 is the button
Seat 1: color_singleton (15443 in chips) 
Seat 2: manon327 (5675 in chips) 
Seat 3: JeBoyDirk (9658 in chips) 
Seat 7: Klemtonius (21886 in chips) 
Seat 9: dhduncan (13093 in chips) 
JeBoyDirk: posts small blind 50
Klemtonius: posts big blind 100
*** HOLE CARDS ***
Dealt to dhduncan [6c Ts]
dhduncan: folds 
color_singleton: raises 200 to 300
manon327: calls 300
JeBoyDirk: folds 
Klemtonius: calls 200
*** FLOP *** [8d 8s Tc]
Klemtonius: checks 
color_singleton: bets 449
manon327: folds 
Klemtonius: folds 
Uncalled bet (449) returned to color_singleton
color_singleton collected 898 from pot
color_singleton: doesn't show hand 
*** SUMMARY ***
Total pot 950 | Rake 52 
Board [8d 8s Tc]
Seat 1: color_singleton collected (898)
Seat 2: manon327 (button) folded on the Flop
Seat 3: JeBoyDirk (small blind) folded before Flop
Seat 7: Klemtonius (big blind) folded on the Flop
Seat 9: dhduncan folded before Flop (didn't bet)



PokerStars Home Game Hand #223928864403: {DaPokaStars}  Hold'em No Limit (50/100) - 2021/02/17 16:45:49 ET
Table 'tonight again' 9-max (Play Money) Seat #3 is the button
Seat 1: color_singleton (16041 in chips) 
Seat 2: manon327 (5375 in chips) 
Seat 3: JeBoyDirk (9608 in chips) 
Seat 7: Klemtonius (21586 in chips) 
Seat 9: dhduncan (13093 in chips) 
Klemtonius: posts small blind 50
dhduncan: posts big blind 100
*** HOLE CARDS ***
Dealt to dhduncan [8h 5c]
color_singleton: raises 200 to 300
manon327: calls 300
JeBoyDirk: calls 300
Klemtonius: calls 250
dhduncan: folds 
*** FLOP *** [4c 8c 3s]
Klemtonius: checks 
color_singleton: checks 
manon327: checks 
JeBoyDirk: checks 
*** TURN *** [4c 8c 3s] [Qh]
Klemtonius: checks 
color_singleton: bets 700
manon327: folds 
JeBoyDirk: folds 
Klemtonius: folds 
Uncalled bet (700) returned to color_singleton
color_singleton collected 1228 from pot
color_singleton: doesn't show hand 
*** SUMMARY ***
Total pot 1300 | Rake 72 
Board [4c 8c 3s Qh]
Seat 1: color_singleton collected (1228)
Seat 2: manon327 folded on the Turn
Seat 3: JeBoyDirk (button) folded on the Turn
Seat 7: Klemtonius (small blind) folded on the Turn
Seat 9: dhduncan (big blind) folded before Flop



PokerStars Home Game Hand #223928896468: {DaPokaStars}  Hold'em No Limit (50/100) - 2021/02/17 16:46:36 ET
Table 'tonight again' 9-max (Play Money) Seat #7 is the button
Seat 1: color_singleton (16969 in chips) 
Seat 2: manon327 (5075 in chips) 
Seat 3: JeBoyDirk (9308 in chips) 
Seat 7: Klemtonius (21286 in chips) 
Seat 9: dhduncan (12993 in chips) 
dhduncan: posts small blind 50
color_singleton: posts big blind 100
*** HOLE CARDS ***
Dealt to dhduncan [4d 2c]
manon327: folds 
JeBoyDirk: folds 
Klemtonius: raises 100 to 200
dhduncan: folds 
color_singleton: calls 100
*** FLOP *** [7h Js Th]
color_singleton: checks 
Klemtonius: bets 212
color_singleton: calls 212
*** TURN *** [7h Js Th] [3s]
color_singleton: bets 413
Klemtonius: raises 1652 to 2065
color_singleton: folds 
Uncalled bet (1652) returned to Klemtonius
Klemtonius collected 1606 from pot
Klemtonius: doesn't show hand 
*** SUMMARY ***
Total pot 1700 | Rake 94 
Board [7h Js Th 3s]
Seat 1: color_singleton (big blind) folded on the Turn
Seat 2: manon327 folded before Flop (didn't bet)
Seat 3: JeBoyDirk folded before Flop (didn't bet)
Seat 7: Klemtonius (button) collected (1606)
Seat 9: dhduncan (small blind) folded before Flop



PokerStars Home Game Hand #223928915671: {DaPokaStars}  Hold'em No Limit (50/100) - 2021/02/17 16:47:04 ET
Table 'tonight again' 9-max (Play Money) Seat #9 is the button
Seat 1: color_singleton (16144 in chips) 
Seat 2: manon327 (5075 in chips) 
Seat 3: JeBoyDirk (9308 in chips) 
Seat 7: Klemtonius (22067 in chips) 
Seat 9: dhduncan (12943 in chips) 
color_singleton: posts small blind 50
manon327: posts big blind 100
*** HOLE CARDS ***
Dealt to dhduncan [3h Kc]
JeBoyDirk: folds 
Klemtonius: folds 
dhduncan: calls 100
color_singleton: calls 50
manon327: checks 
*** FLOP *** [7s 7d Ac]
color_singleton: bets 141
manon327: calls 141
dhduncan: folds 
*** TURN *** [7s 7d Ac] [4s]
color_singleton: bets 275
manon327: calls 275
*** RIVER *** [7s 7d Ac 4s] [Jh]
color_singleton: bets 535
manon327: calls 535
*** SHOW DOWN ***
color_singleton: shows [2d Ah] (two pair, Aces and Sevens)
manon327: mucks hand 
color_singleton collected 2081 from pot
*** SUMMARY ***
Total pot 2202 | Rake 121 
Board [7s 7d Ac 4s Jh]
Seat 1: color_singleton (small blind) showed [2d Ah] and won (2081) with two pair, Aces and Sevens
Seat 2: manon327 (big blind) mucked [6d 6s]
Seat 3: JeBoyDirk folded before Flop (didn't bet)
Seat 7: Klemtonius folded before Flop (didn't bet)
Seat 9: dhduncan (button) folded on the Flop



PokerStars Home Game Hand #223928947125: {DaPokaStars}  Hold'em No Limit (50/100) - 2021/02/17 16:47:50 ET
Table 'tonight again' 9-max (Play Money) Seat #1 is the button
Seat 1: color_singleton (17174 in chips) 
Seat 2: manon327 (4024 in chips) 
Seat 3: JeBoyDirk (9308 in chips) 
Seat 7: Klemtonius (22067 in chips) 
Seat 9: dhduncan (12843 in chips) 
manon327: posts small blind 50
JeBoyDirk: posts big blind 100
*** HOLE CARDS ***
Dealt to dhduncan [6h Kc]
Klemtonius: raises 100 to 200
dhduncan: calls 200
color_singleton: calls 200
manon327: folds 
JeBoyDirk: folds 
*** FLOP *** [Qh 3c Kh]
Klemtonius: checks 
dhduncan: bets 354
color_singleton: calls 354
Klemtonius: folds 
*** TURN *** [Qh 3c Kh] [2h]
dhduncan: checks 
color_singleton: checks 
*** RIVER *** [Qh 3c Kh 2h] [6c]
dhduncan: bets 400
color_singleton: calls 400
*** SHOW DOWN ***
dhduncan: shows [6h Kc] (two pair, Kings and Sixes)
color_singleton: mucks hand 
dhduncan collected 2134 from pot
*** SUMMARY ***
Total pot 2258 | Rake 124 
Board [Qh 3c Kh 2h 6c]
Seat 1: color_singleton (button) mucked [7c 7h]
Seat 2: manon327 (small blind) folded before Flop
Seat 3: JeBoyDirk (big blind) folded before Flop
Seat 7: Klemtonius folded on the Flop
Seat 9: dhduncan showed [6h Kc] and won (2134) with two pair, Kings and Sixes



PokerStars Home Game Hand #223928987473: {DaPokaStars}  Hold'em No Limit (50/100) - 2021/02/17 16:48:50 ET
Table 'tonight again' 9-max (Play Money) Seat #2 is the button
Seat 1: color_singleton (16220 in chips) 
Seat 2: manon327 (3974 in chips) 
Seat 3: JeBoyDirk (9208 in chips) 
Seat 7: Klemtonius (21867 in chips) 
Seat 9: dhduncan (14023 in chips) 
JeBoyDirk: posts small blind 50
Klemtonius: posts big blind 100
*** HOLE CARDS ***
Dealt to dhduncan [Qh 8c]
dhduncan: calls 100
color_singleton: raises 100 to 200
manon327: calls 200
JeBoyDirk: folds 
Klemtonius: calls 100
dhduncan: calls 100
*** FLOP *** [Ts 5s 2h]
Klemtonius: checks 
dhduncan: checks 
color_singleton: checks 
manon327: checks 
*** TURN *** [Ts 5s 2h] [8h]
Klemtonius: checks 
dhduncan: checks 
color_singleton: checks 
manon327: checks 
*** RIVER *** [Ts 5s 2h 8h] [As]
Klemtonius: checks 
dhduncan: checks 
color_singleton: bets 401
manon327: raises 401 to 802
Klemtonius: folds 
dhduncan: folds 
color_singleton: calls 401
*** SHOW DOWN ***
manon327: shows [Jd Ac] (a pair of Aces)
color_singleton: mucks hand 
manon327 collected 2319 from pot
*** SUMMARY ***
Total pot 2454 | Rake 135 
Board [Ts 5s 2h 8h As]
Seat 1: color_singleton mucked [Ad 7h]
Seat 2: manon327 (button) showed [Jd Ac] and won (2319) with a pair of Aces
Seat 3: JeBoyDirk (small blind) folded before Flop
Seat 7: Klemtonius (big blind) folded on the River
Seat 9: dhduncan folded on the River



PokerStars Home Game Hand #223929028491: {DaPokaStars}  Hold'em No Limit (50/100) - 2021/02/17 16:49:51 ET
Table 'tonight again' 9-max (Play Money) Seat #3 is the button
Seat 1: color_singleton (15218 in chips) 
Seat 2: manon327 (5291 in chips) 
Seat 3: JeBoyDirk (9158 in chips) 
Seat 7: Klemtonius (21667 in chips) 
Seat 9: dhduncan (13823 in chips) 
Klemtonius: posts small blind 50
dhduncan: posts big blind 100
*** HOLE CARDS ***
Dealt to dhduncan [7h 4d]
color_singleton: folds 
manon327: folds 
JeBoyDirk: folds 
Klemtonius: calls 50
dhduncan: checks 
*** FLOP *** [4h 4s Kd]
Klemtonius: checks 
dhduncan: checks 
*** TURN *** [4h 4s Kd] [8c]
Klemtonius: checks 
dhduncan: bets 400
Klemtonius: folds 
Uncalled bet (400) returned to dhduncan
dhduncan collected 189 from pot
dhduncan: doesn't show hand 
*** SUMMARY ***
Total pot 200 | Rake 11 
Board [4h 4s Kd 8c]
Seat 1: color_singleton folded before Flop (didn't bet)
Seat 2: manon327 folded before Flop (didn't bet)
Seat 3: JeBoyDirk (button) folded before Flop (didn't bet)
Seat 7: Klemtonius (small blind) folded on the Turn
Seat 9: dhduncan (big blind) collected (189)



PokerStars Home Game Hand #223929060651: {DaPokaStars}  Hold'em No Limit (50/100) - 2021/02/17 16:50:39 ET
Table 'tonight again' 9-max (Play Money) Seat #7 is the button
Seat 1: color_singleton (15218 in chips) 
Seat 2: manon327 (5291 in chips) 
Seat 3: JeBoyDirk (9158 in chips) 
Seat 7: Klemtonius (21567 in chips) 
Seat 9: dhduncan (13912 in chips) 
dhduncan: posts small blind 50
color_singleton: posts big blind 100
*** HOLE CARDS ***
Dealt to dhduncan [2c 3h]
manon327: folds 
JeBoyDirk: folds 
Klemtonius: calls 100
dhduncan: folds 
color_singleton: raises 300 to 400
Klemtonius: folds 
Uncalled bet (300) returned to color_singleton
color_singleton collected 250 from pot
color_singleton: doesn't show hand 
*** SUMMARY ***
Total pot 250 | Rake 0 
Seat 1: color_singleton (big blind) collected (250)
Seat 2: manon327 folded before Flop (didn't bet)
Seat 3: JeBoyDirk folded before Flop (didn't bet)
Seat 7: Klemtonius (button) folded before Flop
Seat 9: dhduncan (small blind) folded before Flop



PokerStars Home Game Hand #223929072845: {DaPokaStars}  Hold'em No Limit (50/100) - 2021/02/17 16:50:58 ET
Table 'tonight again' 9-max (Play Money) Seat #9 is the button
Seat 1: color_singleton (15368 in chips) 
Seat 2: manon327 (5291 in chips) 
Seat 3: JeBoyDirk (9158 in chips) 
Seat 7: Klemtonius (21467 in chips) 
Seat 9: dhduncan (13862 in chips) 
color_singleton: posts small blind 50
manon327: posts big blind 100
*** HOLE CARDS ***
Dealt to dhduncan [2c Ac]
JeBoyDirk: folds 
Klemtonius: raises 250 to 350
dhduncan: calls 350
color_singleton: folds 
manon327: calls 250
*** FLOP *** [2h Js Ad]
manon327: checks 
Klemtonius: bets 1039
dhduncan: calls 1039
manon327: folds 
*** TURN *** [2h Js Ad] [5s]
Klemtonius: bets 3003
dhduncan: calls 3003
*** RIVER *** [2h Js Ad 5s] [2d]
Klemtonius: checks 
dhduncan: bets 9470 and is all-in
Klemtonius: folds 
Uncalled bet (9470) returned to dhduncan
dhduncan collected 8679 from pot
dhduncan: doesn't show hand 
*** SUMMARY ***
Total pot 9184 | Rake 505 
Board [2h Js Ad 5s 2d]
Seat 1: color_singleton (small blind) folded before Flop
Seat 2: manon327 (big blind) folded on the Flop
Seat 3: JeBoyDirk folded before Flop (didn't bet)
Seat 7: Klemtonius folded on the River
Seat 9: dhduncan (button) collected (8679)



PokerStars Home Game Hand #223929116174: {DaPokaStars}  Hold'em No Limit (50/100) - 2021/02/17 16:52:03 ET
Table 'tonight again' 9-max (Play Money) Seat #1 is the button
Seat 1: color_singleton (15318 in chips) 
Seat 2: manon327 (4941 in chips) 
Seat 3: JeBoyDirk (9158 in chips) 
Seat 7: Klemtonius (17075 in chips) 
Seat 9: dhduncan (18149 in chips) 
manon327: posts small blind 50
JeBoyDirk: posts big blind 100
*** HOLE CARDS ***
Dealt to dhduncan [Kh Tc]
Klemtonius: raises 100 to 200
dhduncan: calls 200
color_singleton: calls 200
manon327: folds 
JeBoyDirk: folds 
*** FLOP *** [5h Jd 2h]
Klemtonius: bets 709
dhduncan: folds 
color_singleton: folds 
Uncalled bet (709) returned to Klemtonius
Klemtonius collected 709 from pot
Klemtonius: doesn't show hand 
*** SUMMARY ***
Total pot 750 | Rake 41 
Board [5h Jd 2h]
Seat 1: color_singleton (button) folded on the Flop
Seat 2: manon327 (small blind) folded before Flop
Seat 3: JeBoyDirk (big blind) folded before Flop
Seat 7: Klemtonius collected (709)
Seat 9: dhduncan folded on the Flop



PokerStars Home Game Hand #223929134519: {DaPokaStars}  Hold'em No Limit (50/100) - 2021/02/17 16:52:30 ET
Table 'tonight again' 9-max (Play Money) Seat #2 is the button
Seat 1: color_singleton (15118 in chips) 
Seat 2: manon327 (4891 in chips) 
Seat 3: JeBoyDirk (9058 in chips) 
Seat 7: Klemtonius (17584 in chips) 
Seat 9: dhduncan (17949 in chips) 
JeBoyDirk: posts small blind 50
Klemtonius: posts big blind 100
*** HOLE CARDS ***
Dealt to dhduncan [4c Ac]
dhduncan: calls 100
color_singleton: folds 
manon327: calls 100
JeBoyDirk: folds 
Klemtonius: checks 
*** FLOP *** [7s 9h 5d]
Klemtonius: bets 331
dhduncan: folds 
manon327: calls 331
*** TURN *** [7s 9h 5d] [8h]
Klemtonius: bets 956
manon327: calls 956
*** RIVER *** [7s 9h 5d 8h] [Jh]
Klemtonius: bets 2763
manon327: calls 2763
*** SHOW DOWN ***
Klemtonius: shows [Qd 9c] (a pair of Nines)
manon327: shows [6s Kd] (a straight, Five to Nine)
manon327 collected 7985 from pot
*** SUMMARY ***
Total pot 8450 | Rake 465 
Board [7s 9h 5d 8h Jh]
Seat 1: color_singleton folded before Flop (didn't bet)
Seat 2: manon327 (button) showed [6s Kd] and won (7985) with a straight, Five to Nine
Seat 3: JeBoyDirk (small blind) folded before Flop
Seat 7: Klemtonius (big blind) showed [Qd 9c] and lost with a pair of Nines
Seat 9: dhduncan folded on the Flop



PokerStars Home Game Hand #223929160899: {DaPokaStars}  Hold'em No Limit (50/100) - 2021/02/17 16:53:11 ET
Table 'tonight again' 9-max (Play Money) Seat #3 is the button
Seat 1: color_singleton (15118 in chips) 
Seat 2: manon327 (8726 in chips) 
Seat 3: JeBoyDirk (9008 in chips) 
Seat 7: Klemtonius (13434 in chips) 
Seat 9: dhduncan (17849 in chips) 
Klemtonius: posts small blind 50
dhduncan: posts big blind 100
*** HOLE CARDS ***
Dealt to dhduncan [6h 6d]
color_singleton: folds 
manon327: calls 100
JeBoyDirk: folds 
Klemtonius: calls 50
dhduncan: checks 
*** FLOP *** [Jd 5s Qd]
Klemtonius: checks 
dhduncan: checks 
manon327: bets 141
Klemtonius: calls 141
dhduncan: folds 
*** TURN *** [Jd 5s Qd] [7h]
Klemtonius: checks 
manon327: bets 275
Klemtonius: calls 275
*** RIVER *** [Jd 5s Qd 7h] [As]
Klemtonius: checks 
manon327: bets 535
Klemtonius: folds 
Uncalled bet (535) returned to manon327
manon327 collected 1070 from pot
*** SUMMARY ***
Total pot 1132 | Rake 62 
Board [Jd 5s Qd 7h As]
Seat 1: color_singleton folded before Flop (didn't bet)
Seat 2: manon327 collected (1070)
Seat 3: JeBoyDirk (button) folded before Flop (didn't bet)
Seat 7: Klemtonius (small blind) folded on the River
Seat 9: dhduncan (big blind) folded on the Flop



PokerStars Home Game Hand #223929214641: {DaPokaStars}  Hold'em No Limit (50/100) - 2021/02/17 16:54:32 ET
Table 'tonight again' 9-max (Play Money) Seat #7 is the button
Seat 1: color_singleton (15118 in chips) 
Seat 2: manon327 (9280 in chips) 
Seat 3: JeBoyDirk (9008 in chips) 
Seat 7: Klemtonius (12918 in chips) 
Seat 9: dhduncan (17749 in chips) 
dhduncan: posts small blind 50
color_singleton: posts big blind 100
*** HOLE CARDS ***
Dealt to dhduncan [5s 8c]
manon327: folds 
JeBoyDirk: calls 100
Klemtonius: raises 100 to 200
dhduncan: folds 
color_singleton: calls 100
JeBoyDirk: calls 100
*** FLOP *** [5d Jc 4d]
color_singleton: bets 307
JeBoyDirk: folds 
Klemtonius: calls 307
*** TURN *** [5d Jc 4d] [2s]
color_singleton: bets 597
Klemtonius: folds 
Uncalled bet (597) returned to color_singleton
color_singleton collected 1194 from pot
color_singleton: doesn't show hand 
*** SUMMARY ***
Total pot 1264 | Rake 70 
Board [5d Jc 4d 2s]
Seat 1: color_singleton (big blind) collected (1194)
Seat 2: manon327 folded before Flop (didn't bet)
Seat 3: JeBoyDirk folded on the Flop
Seat 7: Klemtonius (button) folded on the Turn
Seat 9: dhduncan (small blind) folded before Flop



PokerStars Home Game Hand #223929234070: {DaPokaStars}  Hold'em No Limit (50/100) - 2021/02/17 16:55:02 ET
Table 'tonight again' 9-max (Play Money) Seat #9 is the button
Seat 1: color_singleton (15805 in chips) 
Seat 2: manon327 (9280 in chips) 
Seat 3: JeBoyDirk (8808 in chips) 
Seat 7: Klemtonius (12411 in chips) 
Seat 9: dhduncan (17699 in chips) 
color_singleton: posts small blind 50
manon327: posts big blind 100
*** HOLE CARDS ***
Dealt to dhduncan [Jh 9c]
JeBoyDirk: raises 100 to 200
Klemtonius: calls 200
dhduncan: calls 200
color_singleton: calls 150
manon327: calls 100
*** FLOP *** [Js 7s 6s]
color_singleton: checks 
manon327: checks 
JeBoyDirk: bets 300
Klemtonius: folds 
dhduncan: calls 300
color_singleton: folds 
manon327: folds 
*** TURN *** [Js 7s 6s] [9s]
JeBoyDirk: checks 
dhduncan has timed out
dhduncan: checks 
*** RIVER *** [Js 7s 6s 9s] [5d]
JeBoyDirk: bets 1000
dhduncan: calls 1000
*** SHOW DOWN ***
JeBoyDirk: shows [As Jd] (a flush, Ace high)
dhduncan: mucks hand 
JeBoyDirk collected 3402 from pot
*** SUMMARY ***
Total pot 3600 | Rake 198 
Board [Js 7s 6s 9s 5d]
Seat 1: color_singleton (small blind) folded on the Flop
Seat 2: manon327 (big blind) folded on the Flop
Seat 3: JeBoyDirk showed [As Jd] and won (3402) with a flush, Ace high
Seat 7: Klemtonius folded on the Flop
Seat 9: dhduncan (button) mucked [Jh 9c]



PokerStars Home Game Hand #223929268687: {DaPokaStars}  Hold'em No Limit (50/100) - 2021/02/17 16:56:09 ET
Table 'tonight again' 9-max (Play Money) Seat #1 is the button
Seat 1: color_singleton (15605 in chips) 
Seat 2: manon327 (9080 in chips) 
Seat 3: JeBoyDirk (10710 in chips) 
Seat 7: Klemtonius (12211 in chips) 
Seat 9: dhduncan (16199 in chips) 
manon327: posts small blind 50
JeBoyDirk: posts big blind 100
*** HOLE CARDS ***
Dealt to dhduncan [8h 9d]
Klemtonius: calls 100
dhduncan: folds 
color_singleton: folds 
manon327: calls 50
JeBoyDirk: checks 
*** FLOP *** [Tc 9c 6d]
manon327: checks 
JeBoyDirk: checks 
Klemtonius: checks 
*** TURN *** [Tc 9c 6d] [Ks]
manon327: checks 
JeBoyDirk: checks 
Klemtonius: bets 283
manon327: calls 283
JeBoyDirk: folds 
*** RIVER *** [Tc 9c 6d Ks] [2h]
manon327: checks 
Klemtonius: bets 818
manon327: folds 
Uncalled bet (818) returned to Klemtonius
Klemtonius collected 818 from pot
Klemtonius: doesn't show hand 
*** SUMMARY ***
Total pot 866 | Rake 48 
Board [Tc 9c 6d Ks 2h]
Seat 1: color_singleton (button) folded before Flop (didn't bet)
Seat 2: manon327 (small blind) folded on the River
Seat 3: JeBoyDirk (big blind) folded on the Turn
Seat 7: Klemtonius collected (818)
Seat 9: dhduncan folded before Flop (didn't bet)



PokerStars Home Game Hand #223929287671: {DaPokaStars}  Hold'em No Limit (50/100) - 2021/02/17 16:56:48 ET
Table 'tonight again' 9-max (Play Money) Seat #2 is the button
Seat 1: color_singleton (15605 in chips) 
Seat 2: manon327 (8697 in chips) 
Seat 3: JeBoyDirk (10610 in chips) 
Seat 7: Klemtonius (12646 in chips) 
Seat 9: dhduncan (16199 in chips) 
JeBoyDirk: posts small blind 50
Klemtonius: posts big blind 100
*** HOLE CARDS ***
Dealt to dhduncan [7d 5s]
dhduncan: folds 
color_singleton: folds 
manon327: folds 
JeBoyDirk: folds 
Uncalled bet (50) returned to Klemtonius
Klemtonius collected 100 from pot
Klemtonius: doesn't show hand 
*** SUMMARY ***
Total pot 100 | Rake 0 
Seat 1: color_singleton folded before Flop (didn't bet)
Seat 2: manon327 (button) folded before Flop (didn't bet)
Seat 3: JeBoyDirk (small blind) folded before Flop
Seat 7: Klemtonius (big blind) collected (100)
Seat 9: dhduncan folded before Flop (didn't bet)



PokerStars Home Game Hand #223929291538: {DaPokaStars}  Hold'em No Limit (50/100) - 2021/02/17 16:56:56 ET
Table 'tonight again' 9-max (Play Money) Seat #3 is the button
Seat 1: color_singleton (15605 in chips) 
Seat 2: manon327 (8697 in chips) 
Seat 3: JeBoyDirk (10560 in chips) 
Seat 7: Klemtonius (12696 in chips) 
Seat 9: dhduncan (16199 in chips) 
Klemtonius: posts small blind 50
dhduncan: posts big blind 100
*** HOLE CARDS ***
Dealt to dhduncan [9c 3c]
color_singleton: raises 100 to 200
manon327: calls 200
JeBoyDirk: folds 
Klemtonius: folds 
dhduncan: calls 100
*** FLOP *** [3h 4s Td]
dhduncan: checks 
color_singleton: bets 307
manon327: calls 307
dhduncan: folds 
*** TURN *** [3h 4s Td] [Jd]
color_singleton: bets 597
manon327: calls 597
*** RIVER *** [3h 4s Td Jd] [Qc]
color_singleton: checks 
manon327: checks 
*** SHOW DOWN ***
color_singleton: shows [5s 6d] (high card Queen)
manon327: shows [8s Ah] (high card Ace)
manon327 collected 2323 from pot
*** SUMMARY ***
Total pot 2458 | Rake 135 
Board [3h 4s Td Jd Qc]
Seat 1: color_singleton showed [5s 6d] and lost with high card Queen
Seat 2: manon327 showed [8s Ah] and won (2323) with high card Ace
Seat 3: JeBoyDirk (button) folded before Flop (didn't bet)
Seat 7: Klemtonius (small blind) folded before Flop
Seat 9: dhduncan (big blind) folded on the Flop



PokerStars Home Game Hand #223929309044: {DaPokaStars}  Hold'em No Limit (50/100) - 2021/02/17 16:57:31 ET
Table 'tonight again' 9-max (Play Money) Seat #7 is the button
Seat 1: color_singleton (14501 in chips) 
Seat 2: manon327 (9916 in chips) 
Seat 3: JeBoyDirk (10560 in chips) 
Seat 7: Klemtonius (12646 in chips) 
Seat 9: dhduncan (15999 in chips) 
dhduncan: posts small blind 50
color_singleton: posts big blind 100
*** HOLE CARDS ***
Dealt to dhduncan [9h 4c]
manon327: calls 100
JeBoyDirk: folds 
Klemtonius: calls 100
dhduncan: folds 
color_singleton: checks 
*** FLOP *** [9d 5s 8h]
color_singleton: checks 
manon327: checks 
Klemtonius: checks 
*** TURN *** [9d 5s 8h] [Ac]
color_singleton: checks 
manon327: bets 165
Klemtonius: folds 
color_singleton: folds 
Uncalled bet (165) returned to manon327
manon327 collected 331 from pot
*** SUMMARY ***
Total pot 350 | Rake 19 
Board [9d 5s 8h Ac]
Seat 1: color_singleton (big blind) folded on the Turn
Seat 2: manon327 collected (331)
Seat 3: JeBoyDirk folded before Flop (didn't bet)
Seat 7: Klemtonius (button) folded on the Turn
Seat 9: dhduncan (small blind) folded before Flop



PokerStars Home Game Hand #223929328799: {DaPokaStars}  Hold'em No Limit (50/100) - 2021/02/17 16:58:10 ET
Table 'tonight again' 9-max (Play Money) Seat #9 is the button
Seat 1: color_singleton (14401 in chips) 
Seat 2: manon327 (10147 in chips) 
Seat 3: JeBoyDirk (10560 in chips) 
Seat 7: Klemtonius (12546 in chips) 
Seat 9: dhduncan (15949 in chips) 
color_singleton: posts small blind 50
manon327: posts big blind 100
*** HOLE CARDS ***
Dealt to dhduncan [Ad 8h]
JeBoyDirk: calls 100
Klemtonius: calls 100
dhduncan: calls 100
color_singleton: calls 50
manon327: checks 
*** FLOP *** [Tc 5h Jd]
color_singleton: bets 236
manon327: calls 236
JeBoyDirk: folds 
Klemtonius: folds 
dhduncan: folds 
*** TURN *** [Tc 5h Jd] [7d]
color_singleton: bets 459
manon327: folds 
Uncalled bet (459) returned to color_singleton
color_singleton collected 919 from pot
color_singleton: doesn't show hand 
*** SUMMARY ***
Total pot 972 | Rake 53 
Board [Tc 5h Jd 7d]
Seat 1: color_singleton (small blind) collected (919)
Seat 2: manon327 (big blind) folded on the Turn
Seat 3: JeBoyDirk folded on the Flop
Seat 7: Klemtonius folded on the Flop
Seat 9: dhduncan (button) folded on the Flop



PokerStars Home Game Hand #223929349213: {DaPokaStars}  Hold'em No Limit (50/100) - 2021/02/17 16:58:47 ET
Table 'tonight again' 9-max (Play Money) Seat #1 is the button
Seat 1: color_singleton (14984 in chips) 
Seat 2: manon327 (9811 in chips) 
Seat 3: JeBoyDirk (10460 in chips) 
Seat 7: Klemtonius (12446 in chips) 
Seat 9: dhduncan (15849 in chips) 
manon327: posts small blind 50
JeBoyDirk: posts big blind 100
*** HOLE CARDS ***
Dealt to dhduncan [3d Ac]
Klemtonius: raises 100 to 200
dhduncan: calls 200
color_singleton: calls 200
manon327: folds 
JeBoyDirk: folds 
*** FLOP *** [8s 6d 6s]
Klemtonius: checks 
dhduncan: checks 
color_singleton: bets 709
Klemtonius: folds 
dhduncan: folds 
Uncalled bet (709) returned to color_singleton
color_singleton collected 709 from pot
color_singleton: doesn't show hand 
*** SUMMARY ***
Total pot 750 | Rake 41 
Board [8s 6d 6s]
Seat 1: color_singleton (button) collected (709)
Seat 2: manon327 (small blind) folded before Flop
Seat 3: JeBoyDirk (big blind) folded before Flop
Seat 7: Klemtonius folded on the Flop
Seat 9: dhduncan folded on the Flop



PokerStars Home Game Hand #223929368281: {DaPokaStars}  Hold'em No Limit (50/100) - 2021/02/17 16:59:25 ET
Table 'tonight again' 9-max (Play Money) Seat #2 is the button
Seat 1: color_singleton (15493 in chips) 
Seat 2: manon327 (9761 in chips) 
Seat 3: JeBoyDirk (10360 in chips) 
Seat 7: Klemtonius (12246 in chips) 
Seat 9: dhduncan (15649 in chips) 
JeBoyDirk: posts small blind 50
Klemtonius: posts big blind 100
*** HOLE CARDS ***
Dealt to dhduncan [8h Jh]
dhduncan: calls 100
color_singleton: folds 
manon327: calls 100
JeBoyDirk: calls 50
Klemtonius: raises 400 to 500
dhduncan: calls 400
manon327: calls 400
JeBoyDirk: folds 
*** FLOP *** [6h Td 9d]
Klemtonius: checks 
dhduncan: checks 
manon327: checks 
*** TURN *** [6h Td 9d] [Qd]
Klemtonius: bets 1512
dhduncan: folds 
manon327: folds 
Uncalled bet (1512) returned to Klemtonius
Klemtonius collected 1512 from pot
Klemtonius: doesn't show hand 
*** SUMMARY ***
Total pot 1600 | Rake 88 
Board [6h Td 9d Qd]
Seat 1: color_singleton folded before Flop (didn't bet)
Seat 2: manon327 (button) folded on the Turn
Seat 3: JeBoyDirk (small blind) folded before Flop
Seat 7: Klemtonius (big blind) collected (1512)
Seat 9: dhduncan folded on the Turn



PokerStars Home Game Hand #223929389722: {DaPokaStars}  Hold'em No Limit (50/100) - 2021/02/17 17:00:07 ET
Table 'tonight again' 9-max (Play Money) Seat #3 is the button
Seat 1: color_singleton (15493 in chips) 
Seat 2: manon327 (9261 in chips) 
Seat 3: JeBoyDirk (10260 in chips) 
Seat 7: Klemtonius (13258 in chips) 
Seat 9: dhduncan (15149 in chips) 
Klemtonius: posts small blind 50
dhduncan: posts big blind 100
*** HOLE CARDS ***
Dealt to dhduncan [Jh 3c]
color_singleton: folds 
manon327: raises 100 to 200
JeBoyDirk: folds 
Klemtonius: calls 150
dhduncan: calls 100
*** FLOP *** [8d 6h 9h]
Klemtonius: checks 
dhduncan: checks 
manon327: checks 
*** TURN *** [8d 6h 9h] [5c]
Klemtonius: checks 
dhduncan: checks 
manon327: checks 
*** RIVER *** [8d 6h 9h 5c] [7h]
Klemtonius: bets 283
dhduncan: folds 
manon327: folds 
Uncalled bet (283) returned to Klemtonius
Klemtonius collected 567 from pot
Klemtonius: doesn't show hand 
*** SUMMARY ***
Total pot 600 | Rake 33 
Board [8d 6h 9h 5c 7h]
Seat 1: color_singleton folded before Flop (didn't bet)
Seat 2: manon327 folded on the River
Seat 3: JeBoyDirk (button) folded before Flop (didn't bet)
Seat 7: Klemtonius (small blind) collected (567)
Seat 9: dhduncan (big blind) folded on the River



PokerStars Home Game Hand #223929423937: {DaPokaStars}  Hold'em No Limit (50/100) - 2021/02/17 17:01:10 ET
Table 'tonight again' 9-max (Play Money) Seat #7 is the button
Seat 1: color_singleton (15493 in chips) 
Seat 2: manon327 (9061 in chips) 
Seat 3: JeBoyDirk (10260 in chips) 
Seat 7: Klemtonius (13625 in chips) 
Seat 9: dhduncan (14949 in chips) 
dhduncan: posts small blind 50
color_singleton: posts big blind 100
*** HOLE CARDS ***
Dealt to dhduncan [Ac Jc]
manon327: calls 100
JeBoyDirk: folds 
Klemtonius: calls 100
dhduncan: calls 50
color_singleton: checks 
*** FLOP *** [Qc 2s 7h]
dhduncan: checks 
color_singleton: checks 
manon327: checks 
Klemtonius: checks 
*** TURN *** [Qc 2s 7h] [5s]
dhduncan: checks 
color_singleton: checks 
manon327: checks 
Klemtonius: checks 
*** RIVER *** [Qc 2s 7h 5s] [Tc]
dhduncan: checks 
color_singleton: checks 
manon327: checks 
Klemtonius: checks 
*** SHOW DOWN ***
dhduncan: shows [Ac Jc] (high card Ace)
color_singleton: shows [3c Ts] (a pair of Tens)
manon327: mucks hand 
Klemtonius: mucks hand 
color_singleton collected 378 from pot
*** SUMMARY ***
Total pot 400 | Rake 22 
Board [Qc 2s 7h 5s Tc]
Seat 1: color_singleton (big blind) showed [3c Ts] and won (378) with a pair of Tens
Seat 2: manon327 mucked [Jd 9h]
Seat 3: JeBoyDirk folded before Flop (didn't bet)
Seat 7: Klemtonius (button) mucked [9c 6s]
Seat 9: dhduncan (small blind) showed [Ac Jc] and lost with high card Ace



PokerStars Home Game Hand #223929466852: {DaPokaStars}  Hold'em No Limit (50/100) - 2021/02/17 17:02:17 ET
Table 'tonight again' 9-max (Play Money) Seat #9 is the button
Seat 1: color_singleton (15771 in chips) 
Seat 2: manon327 (8961 in chips) 
Seat 3: JeBoyDirk (10260 in chips) 
Seat 7: Klemtonius (13525 in chips) 
Seat 9: dhduncan (14849 in chips) 
color_singleton: posts small blind 50
manon327: posts big blind 100
*** HOLE CARDS ***
Dealt to dhduncan [4c 9c]
JeBoyDirk: folds 
Klemtonius: calls 100
dhduncan: calls 100
color_singleton: raises 200 to 300
manon327: folds 
Klemtonius: calls 200
dhduncan: folds 
*** FLOP *** [Jc 8d Kc]
color_singleton: bets 378
Klemtonius: calls 378
*** TURN *** [Jc 8d Kc] [6h]
color_singleton: checks 
Klemtonius: checks 
*** RIVER *** [Jc 8d Kc 6h] [Jh]
color_singleton: checks 
Klemtonius: checks 
*** SHOW DOWN ***
color_singleton: shows [2d As] (a pair of Jacks)
Klemtonius: mucks hand 
color_singleton collected 1470 from pot
*** SUMMARY ***
Total pot 1556 | Rake 86 
Board [Jc 8d Kc 6h Jh]
Seat 1: color_singleton (small blind) showed [2d As] and won (1470) with a pair of Jacks
Seat 2: manon327 (big blind) folded before Flop
Seat 3: JeBoyDirk folded before Flop (didn't bet)
Seat 7: Klemtonius mucked [3s 9s]
Seat 9: dhduncan (button) folded before Flop



PokerStars Home Game Hand #223929497381: {DaPokaStars}  Hold'em No Limit (50/100) - 2021/02/17 17:02:55 ET
Table 'tonight again' 9-max (Play Money) Seat #1 is the button
Seat 1: color_singleton (16563 in chips) 
Seat 2: manon327 (8861 in chips) 
Seat 3: JeBoyDirk (10260 in chips) 
Seat 7: Klemtonius (12847 in chips) 
Seat 9: dhduncan (14749 in chips) 
manon327: posts small blind 50
JeBoyDirk: posts big blind 100
*** HOLE CARDS ***
Dealt to dhduncan [Td 2s]
Klemtonius: raises 100 to 200
dhduncan: folds 
color_singleton: calls 200
manon327: folds 
JeBoyDirk: calls 100
*** FLOP *** [5h 3s 7h]
JeBoyDirk: checks 
Klemtonius: bets 100
color_singleton: calls 100
JeBoyDirk: calls 100
*** TURN *** [5h 3s 7h] [Ah]
JeBoyDirk: checks 
Klemtonius: bets 449
color_singleton: calls 449
JeBoyDirk: calls 449
*** RIVER *** [5h 3s 7h Ah] [3c]
JeBoyDirk: checks 
Klemtonius: bets 2171
color_singleton: calls 2171
JeBoyDirk: folds 
*** SHOW DOWN ***
Klemtonius: shows [Ad 6d] (two pair, Aces and Threes)
color_singleton: shows [3h Kh] (a flush, Ace high)
color_singleton collected 6274 from pot
*** SUMMARY ***
Total pot 6639 | Rake 365 
Board [5h 3s 7h Ah 3c]
Seat 1: color_singleton (button) showed [3h Kh] and won (6274) with a flush, Ace high
Seat 2: manon327 (small blind) folded before Flop
Seat 3: JeBoyDirk (big blind) folded on the River
Seat 7: Klemtonius showed [Ad 6d] and lost with two pair, Aces and Threes
Seat 9: dhduncan folded before Flop (didn't bet)



PokerStars Home Game Hand #223929540781: {DaPokaStars}  Hold'em No Limit (50/100) - 2021/02/17 17:03:49 ET
Table 'tonight again' 9-max (Play Money) Seat #2 is the button
Seat 1: color_singleton (19917 in chips) 
Seat 2: manon327 (8811 in chips) 
Seat 3: JeBoyDirk (9511 in chips) 
Seat 7: Klemtonius (9927 in chips) 
Seat 9: dhduncan (14749 in chips) 
JeBoyDirk: posts small blind 50
Klemtonius: posts big blind 100
*** HOLE CARDS ***
Dealt to dhduncan [5s Qh]
dhduncan: folds 
color_singleton: raises 100 to 200
manon327: folds 
JeBoyDirk: folds 
Klemtonius: folds 
Uncalled bet (100) returned to color_singleton
color_singleton collected 250 from pot
color_singleton: doesn't show hand 
*** SUMMARY ***
Total pot 250 | Rake 0 
Seat 1: color_singleton collected (250)
Seat 2: manon327 (button) folded before Flop (didn't bet)
Seat 3: JeBoyDirk (small blind) folded before Flop
Seat 7: Klemtonius (big blind) folded before Flop
Seat 9: dhduncan folded before Flop (didn't bet)



PokerStars Home Game Hand #223929548366: {DaPokaStars}  Hold'em No Limit (50/100) - 2021/02/17 17:04:01 ET
Table 'tonight again' 9-max (Play Money) Seat #3 is the button
Seat 1: color_singleton (20067 in chips) 
Seat 2: manon327 (8811 in chips) 
Seat 3: JeBoyDirk (9461 in chips) 
Seat 7: Klemtonius (9827 in chips) 
Seat 9: dhduncan (14749 in chips) 
Klemtonius: posts small blind 50
dhduncan: posts big blind 100
*** HOLE CARDS ***
Dealt to dhduncan [Ac 2c]
color_singleton: raises 200 to 300
manon327: folds 
JeBoyDirk: folds 
Klemtonius: calls 250
dhduncan: calls 200
*** FLOP *** [5d As 6s]
Klemtonius: checks 
dhduncan: checks 
color_singleton: bets 425
Klemtonius: folds 
dhduncan: calls 425
*** TURN *** [5d As 6s] [Qh]
dhduncan: checks 
color_singleton: checks 
*** RIVER *** [5d As 6s Qh] [7h]
dhduncan: checks 
color_singleton: checks 
*** SHOW DOWN ***
dhduncan: shows [Ac 2c] (a pair of Aces)
color_singleton: mucks hand 
dhduncan collected 1654 from pot
*** SUMMARY ***
Total pot 1750 | Rake 96 
Board [5d As 6s Qh 7h]
Seat 1: color_singleton mucked [2h 2s]
Seat 2: manon327 folded before Flop (didn't bet)
Seat 3: JeBoyDirk (button) folded before Flop (didn't bet)
Seat 7: Klemtonius (small blind) folded on the Flop
Seat 9: dhduncan (big blind) showed [Ac 2c] and won (1654) with a pair of Aces



PokerStars Home Game Hand #223929591356: {DaPokaStars}  Hold'em No Limit (50/100) - 2021/02/17 17:04:52 ET
Table 'tonight again' 9-max (Play Money) Seat #7 is the button
Seat 1: color_singleton (19342 in chips) 
Seat 2: manon327 (8811 in chips) 
Seat 3: JeBoyDirk (9461 in chips) 
Seat 7: Klemtonius (9527 in chips) 
Seat 9: dhduncan (15678 in chips) 
dhduncan: posts small blind 50
color_singleton: posts big blind 100
*** HOLE CARDS ***
Dealt to dhduncan [Jc 8s]
manon327: calls 100
JeBoyDirk: folds 
Klemtonius: calls 100
dhduncan: calls 50
color_singleton: checks 
*** FLOP *** [7d Ac 7h]
dhduncan: checks 
color_singleton: checks 
manon327: checks 
Klemtonius: bets 100
dhduncan: calls 100
color_singleton: calls 100
manon327: calls 100
*** TURN *** [7d Ac 7h] [Ad]
dhduncan: checks 
color_singleton: bets 378
manon327: calls 378
Klemtonius: raises 378 to 756
dhduncan: folds 
color_singleton: calls 378
manon327: folds 
*** RIVER *** [7d Ac 7h Ad] [3d]
color_singleton: bets 1271
Klemtonius: calls 1271
*** SHOW DOWN ***
color_singleton: shows [Qd 8d] (a flush, Ace high)
Klemtonius: shows [Kd 7c] (a full house, Sevens full of Aces)
Klemtonius collected 4944 from pot
*** SUMMARY ***
Total pot 5232 | Rake 288 
Board [7d Ac 7h Ad 3d]
Seat 1: color_singleton (big blind) showed [Qd 8d] and lost with a flush, Ace high
Seat 2: manon327 folded on the Turn
Seat 3: JeBoyDirk folded before Flop (didn't bet)
Seat 7: Klemtonius (button) showed [Kd 7c] and won (4944) with a full house, Sevens full of Aces
Seat 9: dhduncan (small blind) folded on the Turn



PokerStars Home Game Hand #223929633479: {DaPokaStars}  Hold'em No Limit (50/100) - 2021/02/17 17:05:55 ET
Table 'tonight again' 9-max (Play Money) Seat #9 is the button
Seat 1: color_singleton (17115 in chips) 
Seat 2: manon327 (8233 in chips) 
Seat 3: JeBoyDirk (9461 in chips) 
Seat 7: Klemtonius (12244 in chips) 
Seat 9: dhduncan (15478 in chips) 
color_singleton: posts small blind 50
manon327: posts big blind 100
*** HOLE CARDS ***
Dealt to dhduncan [4h 2d]
JeBoyDirk: folds 
Klemtonius: raises 100 to 200
dhduncan: folds 
color_singleton: calls 150
manon327: calls 100
*** FLOP *** [Tc 7s 3c]
color_singleton: checks 
manon327: checks 
Klemtonius: bets 567
color_singleton: folds 
manon327: calls 567
*** TURN *** [Tc 7s 3c] [Ts]
manon327: checks 
Klemtonius: checks 
*** RIVER *** [Tc 7s 3c Ts] [9h]
manon327: checks 
Klemtonius: bets 100
manon327: raises 100 to 200
Klemtonius: folds 
Uncalled bet (100) returned to manon327
manon327 collected 1828 from pot
*** SUMMARY ***
Total pot 1934 | Rake 106 
Board [Tc 7s 3c Ts 9h]
Seat 1: color_singleton (small blind) folded on the Flop
Seat 2: manon327 (big blind) collected (1828)
Seat 3: JeBoyDirk folded before Flop (didn't bet)
Seat 7: Klemtonius folded on the River
Seat 9: dhduncan (button) folded before Flop (didn't bet)



PokerStars Home Game Hand #223929672426: {DaPokaStars}  Hold'em No Limit (50/100) - 2021/02/17 17:06:53 ET
Table 'tonight again' 9-max (Play Money) Seat #1 is the button
Seat 1: color_singleton (16915 in chips) 
Seat 2: manon327 (9194 in chips) 
Seat 3: JeBoyDirk (9461 in chips) 
Seat 7: Klemtonius (11377 in chips) 
Seat 9: dhduncan (15478 in chips) 
manon327: posts small blind 50
JeBoyDirk: posts big blind 100
*** HOLE CARDS ***
Dealt to dhduncan [Qs Kh]
Klemtonius: raises 250 to 350
dhduncan: calls 350
color_singleton: folds 
manon327: folds 
JeBoyDirk: folds 
*** FLOP *** [4d Jc 5h]
Klemtonius: checks 
dhduncan: checks 
*** TURN *** [4d Jc 5h] [4c]
Klemtonius: checks 
dhduncan: checks 
*** RIVER *** [4d Jc 5h 4c] [8c]
Klemtonius: bets 803
dhduncan: folds 
Uncalled bet (803) returned to Klemtonius
Klemtonius collected 803 from pot
Klemtonius: doesn't show hand 
*** SUMMARY ***
Total pot 850 | Rake 47 
Board [4d Jc 5h 4c 8c]
Seat 1: color_singleton (button) folded before Flop (didn't bet)
Seat 2: manon327 (small blind) folded before Flop
Seat 3: JeBoyDirk (big blind) folded before Flop
Seat 7: Klemtonius collected (803)
Seat 9: dhduncan folded on the River



PokerStars Home Game Hand #223929693665: {DaPokaStars}  Hold'em No Limit (50/100) - 2021/02/17 17:07:24 ET
Table 'tonight again' 9-max (Play Money) Seat #2 is the button
Seat 1: color_singleton (16915 in chips) 
Seat 2: manon327 (9144 in chips) 
Seat 3: JeBoyDirk (9361 in chips) 
Seat 7: Klemtonius (11830 in chips) 
Seat 9: dhduncan (15128 in chips) 
JeBoyDirk: posts small blind 50
Klemtonius: posts big blind 100
*** HOLE CARDS ***
Dealt to dhduncan [8d 3h]
dhduncan: folds 
color_singleton: raises 200 to 300
manon327: calls 300
JeBoyDirk: calls 250
Klemtonius: calls 200
*** FLOP *** [Th Kc Ac]
JeBoyDirk: checks 
Klemtonius: checks 
color_singleton: bets 567
manon327: folds 
JeBoyDirk: calls 567
Klemtonius: folds 
*** TURN *** [Th Kc Ac] [4d]
JeBoyDirk: checks 
color_singleton: checks 
*** RIVER *** [Th Kc Ac 4d] [Qd]
JeBoyDirk: checks 
color_singleton: checks 
*** SHOW DOWN ***
JeBoyDirk: shows [9c Tc] (a pair of Tens)
color_singleton: shows [Kd 9d] (a pair of Kings)
color_singleton collected 2206 from pot
*** SUMMARY ***
Total pot 2334 | Rake 128 
Board [Th Kc Ac 4d Qd]
Seat 1: color_singleton showed [Kd 9d] and won (2206) with a pair of Kings
Seat 2: manon327 (button) folded on the Flop
Seat 3: JeBoyDirk (small blind) showed [9c Tc] and lost with a pair of Tens
Seat 7: Klemtonius (big blind) folded on the Flop
Seat 9: dhduncan folded before Flop (didn't bet)



PokerStars Home Game Hand #223929736253: {DaPokaStars}  Hold'em No Limit (50/100) - 2021/02/17 17:08:28 ET
Table 'tonight again' 9-max (Play Money) Seat #3 is the button
Seat 1: color_singleton (18254 in chips) 
Seat 2: manon327 (8844 in chips) 
Seat 3: JeBoyDirk (8494 in chips) 
Seat 7: Klemtonius (11530 in chips) 
Seat 9: dhduncan (15128 in chips) 
Klemtonius: posts small blind 50
dhduncan: posts big blind 100
*** HOLE CARDS ***
Dealt to dhduncan [7s Ts]
color_singleton: folds 
manon327: calls 100
JeBoyDirk: calls 100
Klemtonius: calls 50
dhduncan: checks 
*** FLOP *** [4c 3c Ac]
Klemtonius: bets 100
dhduncan: folds 
manon327: raises 100 to 200
JeBoyDirk: folds 
Klemtonius: raises 100 to 300
manon327: calls 100
*** TURN *** [4c 3c Ac] [5d]
Klemtonius: bets 945
manon327: calls 945
*** RIVER *** [4c 3c Ac 5d] [5c]
Klemtonius: bets 10185 and is all-in
manon327: calls 7499 and is all-in
Uncalled bet (2686) returned to Klemtonius
*** SHOW DOWN ***
Klemtonius: shows [2c 8h] (a straight flush, Ace to Five)
manon327: shows [Js Ad] (two pair, Aces and Fives)
Klemtonius collected 16904 from pot
*** SUMMARY ***
Total pot 17888 | Rake 984 
Board [4c 3c Ac 5d 5c]
Seat 1: color_singleton folded before Flop (didn't bet)
Seat 2: manon327 showed [Js Ad] and lost with two pair, Aces and Fives
Seat 3: JeBoyDirk (button) folded on the Flop
Seat 7: Klemtonius (small blind) showed [2c 8h] and won (16904) with a straight flush, Ace to Five
Seat 9: dhduncan (big blind) folded on the Flop



PokerStars Home Game Hand #223929776466: {DaPokaStars}  Hold'em No Limit (50/100) - 2021/02/17 17:09:28 ET
Table 'tonight again' 9-max (Play Money) Seat #7 is the button
Seat 1: color_singleton (18254 in chips) 
Seat 3: JeBoyDirk (8394 in chips) 
Seat 7: Klemtonius (19590 in chips) 
Seat 9: dhduncan (15028 in chips) 
dhduncan: posts small blind 50
color_singleton: posts big blind 100
*** HOLE CARDS ***
Dealt to dhduncan [Jd Kh]
JeBoyDirk: folds 
Klemtonius: raises 100 to 200
dhduncan: calls 150
color_singleton: calls 100
*** FLOP *** [Js 6s 8h]
dhduncan: checks 
color_singleton: checks 
Klemtonius: checks 
*** TURN *** [Js 6s 8h] [8d]
dhduncan: checks 
color_singleton: checks 
Klemtonius: checks 
*** RIVER *** [Js 6s 8h 8d] [3h]
dhduncan: checks 
color_singleton: checks 
Klemtonius: checks 
*** SHOW DOWN ***
dhduncan: shows [Jd Kh] (two pair, Jacks and Eights)
color_singleton: mucks hand 
Klemtonius: mucks hand 
dhduncan collected 567 from pot
*** SUMMARY ***
Total pot 600 | Rake 33 
Board [Js 6s 8h 8d 3h]
Seat 1: color_singleton (big blind) mucked [Ac 9d]
Seat 3: JeBoyDirk folded before Flop (didn't bet)
Seat 7: Klemtonius (button) mucked [As 3d]
Seat 9: dhduncan (small blind) showed [Jd Kh] and won (567) with two pair, Jacks and Eights



PokerStars Home Game Hand #223929819935: {DaPokaStars}  Hold'em No Limit (50/100) - 2021/02/17 17:10:34 ET
Table 'tonight again' 9-max (Play Money) Seat #9 is the button
Seat 1: color_singleton (18054 in chips) 
Seat 3: JeBoyDirk (8394 in chips) 
Seat 7: Klemtonius (19390 in chips) 
Seat 9: dhduncan (15395 in chips) 
color_singleton: posts small blind 50
JeBoyDirk: posts big blind 100
*** HOLE CARDS ***
Dealt to dhduncan [Qc 4h]
Klemtonius: raises 250 to 350
dhduncan: folds 
color_singleton: folds 
JeBoyDirk: calls 250
*** FLOP *** [2h 4c 2c]
JeBoyDirk: checks 
Klemtonius: checks 
*** TURN *** [2h 4c 2c] [9c]
JeBoyDirk: bets 500
Klemtonius: folds 
Uncalled bet (500) returned to JeBoyDirk
JeBoyDirk collected 709 from pot
*** SUMMARY ***
Total pot 750 | Rake 41 
Board [2h 4c 2c 9c]
Seat 1: color_singleton (small blind) folded before Flop
Seat 3: JeBoyDirk (big blind) collected (709)
Seat 7: Klemtonius folded on the Turn
Seat 9: dhduncan (button) folded before Flop (didn't bet)



PokerStars Home Game Hand #223929843174: {DaPokaStars}  Hold'em No Limit (50/100) - 2021/02/17 17:11:09 ET
Table 'tonight again' 9-max (Play Money) Seat #1 is the button
Seat 1: color_singleton (18004 in chips) 
Seat 3: JeBoyDirk (8753 in chips) 
Seat 7: Klemtonius (19040 in chips) 
Seat 9: dhduncan (15395 in chips) 
JeBoyDirk: posts small blind 50
Klemtonius: posts big blind 100
*** HOLE CARDS ***
Dealt to dhduncan [Js 5s]
dhduncan: calls 100
color_singleton: raises 200 to 300
JeBoyDirk: folds 
Klemtonius: calls 200
dhduncan: calls 200
*** FLOP *** [2s 5d 6d]
Klemtonius: checks 
dhduncan: checks 
color_singleton: checks 
*** TURN *** [2s 5d 6d] [Ts]
Klemtonius: checks 
dhduncan: checks 
color_singleton: checks 
*** RIVER *** [2s 5d 6d Ts] [7d]
Klemtonius: checks 
dhduncan: checks 
color_singleton: checks 
*** SHOW DOWN ***
Klemtonius: shows [5c 5h] (three of a kind, Fives)
dhduncan: mucks hand 
color_singleton: mucks hand 
Klemtonius collected 898 from pot
*** SUMMARY ***
Total pot 950 | Rake 52 
Board [2s 5d 6d Ts 7d]
Seat 1: color_singleton (button) mucked [Kc 9h]
Seat 3: JeBoyDirk (small blind) folded before Flop
Seat 7: Klemtonius (big blind) showed [5c 5h] and won (898) with three of a kind, Fives
Seat 9: dhduncan mucked [Js 5s]



PokerStars Home Game Hand #223929870538: {DaPokaStars}  Hold'em No Limit (50/100) - 2021/02/17 17:11:50 ET
Table 'tonight again' 9-max (Play Money) Seat #3 is the button
Seat 1: color_singleton (17704 in chips) 
Seat 3: JeBoyDirk (8703 in chips) 
Seat 7: Klemtonius (19638 in chips) 
Seat 9: dhduncan (15095 in chips) 
Klemtonius: posts small blind 50
dhduncan: posts big blind 100
*** HOLE CARDS ***
Dealt to dhduncan [2h Qc]
color_singleton: folds 
JeBoyDirk: folds 
Klemtonius: calls 50
dhduncan: checks 
*** FLOP *** [2s Qs 6s]
Klemtonius: bets 100
dhduncan: raises 100 to 200
Klemtonius: calls 100
*** TURN *** [2s Qs 6s] [Ad]
Klemtonius: checks 
dhduncan: bets 283
Klemtonius: calls 283
*** RIVER *** [2s Qs 6s Ad] [3s]
Klemtonius: checks 
dhduncan: bets 1102
Klemtonius: folds 
Uncalled bet (1102) returned to dhduncan
dhduncan collected 1102 from pot
dhduncan: doesn't show hand 
*** SUMMARY ***
Total pot 1166 | Rake 64 
Board [2s Qs 6s Ad 3s]
Seat 1: color_singleton folded before Flop (didn't bet)
Seat 3: JeBoyDirk (button) folded before Flop (didn't bet)
Seat 7: Klemtonius (small blind) folded on the River
Seat 9: dhduncan (big blind) collected (1102)



PokerStars Home Game Hand #223929899585: {DaPokaStars}  Hold'em No Limit (50/100) - 2021/02/17 17:12:34 ET
Table 'tonight again' 9-max (Play Money) Seat #7 is the button
Seat 1: color_singleton (17704 in chips) 
Seat 3: JeBoyDirk (8703 in chips) 
Seat 7: Klemtonius (19055 in chips) 
Seat 9: dhduncan (15614 in chips) 
dhduncan: posts small blind 50
color_singleton: posts big blind 100
*** HOLE CARDS ***
Dealt to dhduncan [7d 2s]
JeBoyDirk: folds 
Klemtonius: raises 250 to 350
dhduncan: folds 
color_singleton: folds 
Uncalled bet (250) returned to Klemtonius
Klemtonius collected 250 from pot
Klemtonius: doesn't show hand 
*** SUMMARY ***
Total pot 250 | Rake 0 
Seat 1: color_singleton (big blind) folded before Flop
Seat 3: JeBoyDirk folded before Flop (didn't bet)
Seat 7: Klemtonius (button) collected (250)
Seat 9: dhduncan (small blind) folded before Flop



PokerStars Home Game Hand #223929905210: {DaPokaStars}  Hold'em No Limit (50/100) - 2021/02/17 17:12:43 ET
Table 'tonight again' 9-max (Play Money) Seat #9 is the button
Seat 1: color_singleton (17604 in chips) 
Seat 2: manon327 (10000 in chips) 
Seat 3: JeBoyDirk (8703 in chips) 
Seat 7: Klemtonius (19205 in chips) 
Seat 9: dhduncan (15564 in chips) 
color_singleton: posts small blind 50
manon327: posts big blind 100
*** HOLE CARDS ***
Dealt to dhduncan [7c 6h]
JeBoyDirk: calls 100
Klemtonius: raises 100 to 200
dhduncan: folds 
color_singleton: folds 
manon327: calls 100
JeBoyDirk: calls 100
*** FLOP *** [5d Js As]
manon327: bets 100
JeBoyDirk: calls 100
Klemtonius: raises 457 to 557
manon327: calls 457
JeBoyDirk: folds 
*** TURN *** [5d Js As] [9c]
manon327: bets 880
Klemtonius: calls 880
*** RIVER *** [5d Js As 9c] [6d]
manon327: checks 
Klemtonius: checks 
*** SHOW DOWN ***
manon327: shows [9h Ah] (two pair, Aces and Nines)
Klemtonius: mucks hand 
manon327 collected 3425 from pot
*** SUMMARY ***
Total pot 3624 | Rake 199 
Board [5d Js As 9c 6d]
Seat 1: color_singleton (small blind) folded before Flop
Seat 2: manon327 (big blind) showed [9h Ah] and won (3425) with two pair, Aces and Nines
Seat 3: JeBoyDirk folded on the Flop
Seat 7: Klemtonius mucked [8s Qs]
Seat 9: dhduncan (button) folded before Flop (didn't bet)



PokerStars Home Game Hand #223929951391: {DaPokaStars}  Hold'em No Limit (50/100) - 2021/02/17 17:13:52 ET
Table 'tonight again' 9-max (Play Money) Seat #1 is the button
Seat 1: color_singleton (17554 in chips) 
Seat 2: manon327 (11788 in chips) 
Seat 3: JeBoyDirk (8403 in chips) 
Seat 7: Klemtonius (17568 in chips) 
Seat 9: dhduncan (15564 in chips) 
manon327: posts small blind 50
JeBoyDirk: posts big blind 100
*** HOLE CARDS ***
Dealt to dhduncan [Ac 2d]
Klemtonius: calls 100
dhduncan: calls 100
color_singleton: raises 300 to 400
manon327: folds 
JeBoyDirk: calls 300
Klemtonius: folds 
dhduncan: calls 300
*** FLOP *** [2h 7h 6c]
JeBoyDirk: checks 
dhduncan: checks 
color_singleton: bets 638
JeBoyDirk: folds 
dhduncan: calls 638
*** TURN *** [2h 7h 6c] [3d]
dhduncan: checks 
color_singleton: checks 
*** RIVER *** [2h 7h 6c 3d] [3h]
dhduncan: checks 
color_singleton: checks 
*** SHOW DOWN ***
dhduncan: shows [Ac 2d] (two pair, Threes and Deuces)
color_singleton: shows [4c 4d] (two pair, Fours and Threes)
color_singleton collected 2482 from pot
*** SUMMARY ***
Total pot 2626 | Rake 144 
Board [2h 7h 6c 3d 3h]
Seat 1: color_singleton (button) showed [4c 4d] and won (2482) with two pair, Fours and Threes
Seat 2: manon327 (small blind) folded before Flop
Seat 3: JeBoyDirk (big blind) folded on the Flop
Seat 7: Klemtonius folded before Flop
Seat 9: dhduncan showed [Ac 2d] and lost with two pair, Threes and Deuces



PokerStars Home Game Hand #223929988517: {DaPokaStars}  Hold'em No Limit (50/100) - 2021/02/17 17:14:48 ET
Table 'tonight again' 9-max (Play Money) Seat #2 is the button
Seat 1: color_singleton (18998 in chips) 
Seat 2: manon327 (11738 in chips) 
Seat 3: JeBoyDirk (8003 in chips) 
Seat 7: Klemtonius (17468 in chips) 
Seat 9: dhduncan (14526 in chips) 
JeBoyDirk: posts small blind 50
Klemtonius: posts big blind 100
*** HOLE CARDS ***
Dealt to dhduncan [Kd 8h]
dhduncan: calls 100
color_singleton: folds 
manon327: folds 
JeBoyDirk: raises 300 to 400
Klemtonius: folds 
dhduncan: folds 
Uncalled bet (300) returned to JeBoyDirk
JeBoyDirk collected 300 from pot
*** SUMMARY ***
Total pot 300 | Rake 0 
Seat 1: color_singleton folded before Flop (didn't bet)
Seat 2: manon327 (button) folded before Flop (didn't bet)
Seat 3: JeBoyDirk (small blind) collected (300)
Seat 7: Klemtonius (big blind) folded before Flop
Seat 9: dhduncan folded before Flop



PokerStars Home Game Hand #223930008394: {DaPokaStars}  Hold'em No Limit (50/100) - 2021/02/17 17:15:18 ET
Table 'tonight again' 9-max (Play Money) Seat #3 is the button
Seat 1: color_singleton (18998 in chips) 
Seat 2: manon327 (11738 in chips) 
Seat 3: JeBoyDirk (8203 in chips) 
Seat 7: Klemtonius (17368 in chips) 
Seat 9: dhduncan (14426 in chips) 
Klemtonius: posts small blind 50
dhduncan: posts big blind 100
*** HOLE CARDS ***
Dealt to dhduncan [Qc 3c]
color_singleton: folds 
manon327: folds 
JeBoyDirk: folds 
Klemtonius: raises 100 to 200
dhduncan: calls 100
*** FLOP *** [6c Ac Ad]
Klemtonius: checks 
dhduncan: checks 
*** TURN *** [6c Ac Ad] [Ah]
Klemtonius: bets 100
dhduncan: calls 100
*** RIVER *** [6c Ac Ad Ah] [3d]
Klemtonius: checks 
dhduncan: checks 
*** SHOW DOWN ***
Klemtonius: shows [As 9h] (four of a kind, Aces)
dhduncan: mucks hand 
Klemtonius collected 567 from pot
*** SUMMARY ***
Total pot 600 | Rake 33 
Board [6c Ac Ad Ah 3d]
Seat 1: color_singleton folded before Flop (didn't bet)
Seat 2: manon327 folded before Flop (didn't bet)
Seat 3: JeBoyDirk (button) folded before Flop (didn't bet)
Seat 7: Klemtonius (small blind) showed [As 9h] and won (567) with four of a kind, Aces
Seat 9: dhduncan (big blind) mucked [Qc 3c]



PokerStars Home Game Hand #223930034453: {DaPokaStars}  Hold'em No Limit (50/100) - 2021/02/17 17:15:58 ET
Table 'tonight again' 9-max (Play Money) Seat #7 is the button
Seat 1: color_singleton (18998 in chips) 
Seat 2: manon327 (11738 in chips) 
Seat 3: JeBoyDirk (8203 in chips) 
Seat 7: Klemtonius (17635 in chips) 
Seat 9: dhduncan (14126 in chips) 
dhduncan: posts small blind 50
color_singleton: posts big blind 100
*** HOLE CARDS ***
Dealt to dhduncan [6s 3d]
manon327: folds 
JeBoyDirk: calls 100
Klemtonius: raises 100 to 200
dhduncan: folds 
color_singleton: calls 100
JeBoyDirk: calls 100
*** FLOP *** [4d 3s Qc]
color_singleton: checks 
JeBoyDirk: checks 
Klemtonius: checks 
*** TURN *** [4d 3s Qc] [8h]
color_singleton: checks 
JeBoyDirk: checks 
Klemtonius: bets 100
color_singleton: folds 
JeBoyDirk: calls 100
*** RIVER *** [4d 3s Qc 8h] [5d]
JeBoyDirk: checks 
Klemtonius: checks 
*** SHOW DOWN ***
JeBoyDirk: shows [3c Kc] (a pair of Threes)
Klemtonius: mucks hand 
JeBoyDirk collected 803 from pot
*** SUMMARY ***
Total pot 850 | Rake 47 
Board [4d 3s Qc 8h 5d]
Seat 1: color_singleton (big blind) folded on the Turn
Seat 2: manon327 folded before Flop (didn't bet)
Seat 3: JeBoyDirk showed [3c Kc] and won (803) with a pair of Threes
Seat 7: Klemtonius (button) mucked [Td 9d]
Seat 9: dhduncan (small blind) folded before Flop



PokerStars Home Game Hand #223930063063: {DaPokaStars}  Hold'em No Limit (50/100) - 2021/02/17 17:16:41 ET
Table 'tonight again' 9-max (Play Money) Seat #9 is the button
Seat 1: color_singleton (18798 in chips) 
Seat 2: manon327 (11738 in chips) 
Seat 3: JeBoyDirk (8706 in chips) 
Seat 7: Klemtonius (17335 in chips) 
Seat 9: dhduncan (14076 in chips) 
color_singleton: posts small blind 50
manon327: posts big blind 100
*** HOLE CARDS ***
Dealt to dhduncan [2c 3h]
JeBoyDirk: folds 
Klemtonius: raises 100 to 200
dhduncan: folds 
color_singleton: folds 
manon327: folds 
Uncalled bet (100) returned to Klemtonius
Klemtonius collected 250 from pot
Klemtonius: doesn't show hand 
*** SUMMARY ***
Total pot 250 | Rake 0 
Seat 1: color_singleton (small blind) folded before Flop
Seat 2: manon327 (big blind) folded before Flop
Seat 3: JeBoyDirk folded before Flop (didn't bet)
Seat 7: Klemtonius collected (250)
Seat 9: dhduncan (button) folded before Flop (didn't bet)



PokerStars Home Game Hand #223930072739: {DaPokaStars}  Hold'em No Limit (50/100) - 2021/02/17 17:16:56 ET
Table 'tonight again' 9-max (Play Money) Seat #1 is the button
Seat 1: color_singleton (18748 in chips) 
Seat 2: manon327 (11638 in chips) 
Seat 3: JeBoyDirk (8706 in chips) 
Seat 7: Klemtonius (17485 in chips) 
Seat 9: dhduncan (14076 in chips) 
manon327: posts small blind 50
JeBoyDirk: posts big blind 100
*** HOLE CARDS ***
Dealt to dhduncan [Th 2s]
Klemtonius: folds 
dhduncan: folds 
color_singleton: raises 100 to 200
manon327: calls 150
JeBoyDirk: raises 200 to 400
color_singleton: calls 200
manon327: calls 200
*** FLOP *** [Qd Qc 8c]
manon327: checks 
JeBoyDirk: bets 500
color_singleton: folds 
manon327: folds 
Uncalled bet (500) returned to JeBoyDirk
JeBoyDirk collected 1134 from pot
*** SUMMARY ***
Total pot 1200 | Rake 66 
Board [Qd Qc 8c]
Seat 1: color_singleton (button) folded on the Flop
Seat 2: manon327 (small blind) folded on the Flop
Seat 3: JeBoyDirk (big blind) collected (1134)
Seat 7: Klemtonius folded before Flop (didn't bet)
Seat 9: dhduncan folded before Flop (didn't bet)



PokerStars Home Game Hand #223930095794: {DaPokaStars}  Hold'em No Limit (50/100) - 2021/02/17 17:17:25 ET
Table 'tonight again' 9-max (Play Money) Seat #2 is the button
Seat 1: color_singleton (18348 in chips) 
Seat 2: manon327 (11238 in chips) 
Seat 3: JeBoyDirk (9440 in chips) 
Seat 7: Klemtonius (17485 in chips) 
Seat 9: dhduncan (14076 in chips) 
JeBoyDirk: posts small blind 50
Klemtonius: posts big blind 100
*** HOLE CARDS ***
Dealt to dhduncan [4c 6d]
dhduncan: folds 
color_singleton: folds 
manon327: calls 100
JeBoyDirk: folds 
Klemtonius: checks 
*** FLOP *** [5s 4s 3c]
Klemtonius: checks 
manon327: checks 
*** TURN *** [5s 4s 3c] [3s]
Klemtonius: checks 
manon327: checks 
*** RIVER *** [5s 4s 3c 3s] [8h]
Klemtonius: checks 
manon327: checks 
*** SHOW DOWN ***
Klemtonius: shows [2d Qc] (a pair of Threes)
manon327: mucks hand 
Klemtonius collected 236 from pot
*** SUMMARY ***
Total pot 250 | Rake 14 
Board [5s 4s 3c 3s 8h]
Seat 1: color_singleton folded before Flop (didn't bet)
Seat 2: manon327 (button) mucked [Th Jc]
Seat 3: JeBoyDirk (small blind) folded before Flop
Seat 7: Klemtonius (big blind) showed [2d Qc] and won (236) with a pair of Threes
Seat 9: dhduncan folded before Flop (didn't bet)



PokerStars Home Game Hand #223930115329: {DaPokaStars}  Hold'em No Limit (50/100) - 2021/02/17 17:17:55 ET
Table 'tonight again' 9-max (Play Money) Seat #3 is the button
Seat 1: color_singleton (18348 in chips) 
Seat 2: manon327 (11138 in chips) 
Seat 3: JeBoyDirk (9390 in chips) 
Seat 7: Klemtonius (17621 in chips) 
Seat 9: dhduncan (14076 in chips) 
Klemtonius: posts small blind 50
dhduncan: posts big blind 100
*** HOLE CARDS ***
Dealt to dhduncan [2h 4h]
color_singleton: folds 
manon327: calls 100
JeBoyDirk: folds 
Klemtonius: calls 50
dhduncan: checks 
*** FLOP *** [5h 2c 4s]
Klemtonius: checks 
dhduncan: bets 100
manon327: folds 
Klemtonius: calls 100
*** TURN *** [5h 2c 4s] [6s]
Klemtonius: checks 
dhduncan: checks 
*** RIVER *** [5h 2c 4s 6s] [Kh]
Klemtonius: checks 
dhduncan: checks 
*** SHOW DOWN ***
Klemtonius: shows [4c 8s] (a pair of Fours)
dhduncan: shows [2h 4h] (two pair, Fours and Deuces)
dhduncan collected 472 from pot
*** SUMMARY ***
Total pot 500 | Rake 28 
Board [5h 2c 4s 6s Kh]
Seat 1: color_singleton folded before Flop (didn't bet)
Seat 2: manon327 folded on the Flop
Seat 3: JeBoyDirk (button) folded before Flop (didn't bet)
Seat 7: Klemtonius (small blind) showed [4c 8s] and lost with a pair of Fours
Seat 9: dhduncan (big blind) showed [2h 4h] and won (472) with two pair, Fours and Deuces



PokerStars Home Game Hand #223930145614: {DaPokaStars}  Hold'em No Limit (50/100) - 2021/02/17 17:18:41 ET
Table 'tonight again' 9-max (Play Money) Seat #7 is the button
Seat 1: color_singleton (18348 in chips) 
Seat 2: manon327 (11038 in chips) 
Seat 3: JeBoyDirk (9390 in chips) 
Seat 7: Klemtonius (17421 in chips) 
Seat 9: dhduncan (14348 in chips) 
dhduncan: posts small blind 50
color_singleton: posts big blind 100
*** HOLE CARDS ***
Dealt to dhduncan [6h 6s]
manon327: folds 
JeBoyDirk: folds 
Klemtonius: calls 100
dhduncan: calls 50
color_singleton: checks 
*** FLOP *** [Qd Tc Jh]
dhduncan: checks 
color_singleton: bets 141
Klemtonius: calls 141
dhduncan: folds 
*** TURN *** [Qd Tc Jh] [Th]
color_singleton: checks 
Klemtonius: checks 
*** RIVER *** [Qd Tc Jh Th] [7c]
color_singleton: checks 
Klemtonius: bets 550
color_singleton has timed out
color_singleton: folds 
Uncalled bet (550) returned to Klemtonius
Klemtonius collected 550 from pot
Klemtonius: doesn't show hand 
*** SUMMARY ***
Total pot 582 | Rake 32 
Board [Qd Tc Jh Th 7c]
Seat 1: color_singleton (big blind) folded on the River
Seat 2: manon327 folded before Flop (didn't bet)
Seat 3: JeBoyDirk folded before Flop (didn't bet)
Seat 7: Klemtonius (button) collected (550)
Seat 9: dhduncan (small blind) folded on the Flop



PokerStars Home Game Hand #223930185586: {DaPokaStars}  Hold'em No Limit (50/100) - 2021/02/17 17:19:43 ET
Table 'tonight again' 9-max (Play Money) Seat #9 is the button
Seat 2: manon327 (11038 in chips) 
Seat 3: JeBoyDirk (9390 in chips) 
Seat 7: Klemtonius (17730 in chips) 
Seat 9: dhduncan (14248 in chips) 
manon327: posts small blind 50
JeBoyDirk: posts big blind 100
*** HOLE CARDS ***
Dealt to dhduncan [4s 9h]
Klemtonius: calls 100
dhduncan: folds 
manon327: folds 
JeBoyDirk: checks 
*** FLOP *** [Qc 3c As]
JeBoyDirk: bets 100
Klemtonius: folds 
Uncalled bet (100) returned to JeBoyDirk
JeBoyDirk collected 236 from pot
*** SUMMARY ***
Total pot 250 | Rake 14 
Board [Qc 3c As]
Seat 2: manon327 (small blind) folded before Flop
Seat 3: JeBoyDirk (big blind) collected (236)
Seat 7: Klemtonius folded on the Flop
Seat 9: dhduncan (button) folded before Flop (didn't bet)



PokerStars Home Game Hand #223930197728: {DaPokaStars}  Hold'em No Limit (50/100) - 2021/02/17 17:20:01 ET
Table 'tonight again' 9-max (Play Money) Seat #2 is the button
Seat 1: color_singleton (18107 in chips) 
Seat 2: manon327 (10988 in chips) 
Seat 3: JeBoyDirk (9526 in chips) 
Seat 7: Klemtonius (17630 in chips) 
Seat 9: dhduncan (14248 in chips) 
JeBoyDirk: posts small blind 50
Klemtonius: posts big blind 100
color_singleton: posts small blind 50
*** HOLE CARDS ***
Dealt to dhduncan [4s Ah]
dhduncan: calls 100
color_singleton: calls 100
manon327: calls 100
JeBoyDirk: raises 200 to 300
Klemtonius: folds 
dhduncan: folds 
color_singleton: calls 200
manon327: folds 
*** FLOP *** [6c 9h 7c]
JeBoyDirk: bets 400
color_singleton: calls 400
*** TURN *** [6c 9h 7c] [Qd]
JeBoyDirk: bets 900
color_singleton: folds 
Uncalled bet (900) returned to JeBoyDirk
JeBoyDirk collected 1654 from pot
*** SUMMARY ***
Total pot 1750 | Rake 96 
Board [6c 9h 7c Qd]
Seat 1: color_singleton folded on the Turn
Seat 2: manon327 (button) folded before Flop
Seat 3: JeBoyDirk (small blind) collected (1654)
Seat 7: Klemtonius (big blind) folded before Flop
Seat 9: dhduncan folded before Flop



PokerStars Home Game Hand #223930224145: {DaPokaStars}  Hold'em No Limit (50/100) - 2021/02/17 17:20:42 ET
Table 'tonight again' 9-max (Play Money) Seat #3 is the button
Seat 1: color_singleton (17357 in chips) 
Seat 2: manon327 (10888 in chips) 
Seat 3: JeBoyDirk (10480 in chips) 
Seat 7: Klemtonius (17530 in chips) 
Seat 9: dhduncan (14148 in chips) 
Klemtonius: posts small blind 50
dhduncan: posts big blind 100
*** HOLE CARDS ***
Dealt to dhduncan [Jd Ac]
color_singleton: folds 
manon327: calls 100
JeBoyDirk: folds 
Klemtonius: calls 50
dhduncan: checks 
*** FLOP *** [2h Kd 3s]
Klemtonius: checks 
dhduncan: checks 
manon327: bets 100
Klemtonius: folds 
dhduncan: calls 100
*** TURN *** [2h Kd 3s] [Qs]
dhduncan: checks 
manon327: bets 236
dhduncan: folds 
Uncalled bet (236) returned to manon327
manon327 collected 472 from pot
*** SUMMARY ***
Total pot 500 | Rake 28 
Board [2h Kd 3s Qs]
Seat 1: color_singleton folded before Flop (didn't bet)
Seat 2: manon327 collected (472)
Seat 3: JeBoyDirk (button) folded before Flop (didn't bet)
Seat 7: Klemtonius (small blind) folded on the Flop
Seat 9: dhduncan (big blind) folded on the Turn



PokerStars Home Game Hand #223930246693: {DaPokaStars}  Hold'em No Limit (50/100) - 2021/02/17 17:21:17 ET
Table 'tonight again' 9-max (Play Money) Seat #9 is the button
Seat 1: color_singleton (17357 in chips) 
Seat 2: manon327 (11160 in chips) 
Seat 3: JeBoyDirk (10480 in chips) 
Seat 9: dhduncan (13948 in chips) 
color_singleton: posts small blind 50
manon327: posts big blind 100
*** HOLE CARDS ***
Dealt to dhduncan [Qs Td]
JeBoyDirk: calls 100
dhduncan: calls 100
color_singleton: folds 
manon327: checks 
*** FLOP *** [3s Js 9s]
manon327: checks 
JeBoyDirk: checks 
dhduncan: checks 
*** TURN *** [3s Js 9s] [Ac]
manon327: checks 
JeBoyDirk: checks 
dhduncan: checks 
*** RIVER *** [3s Js 9s Ac] [Kc]
manon327: bets 331
JeBoyDirk: folds 
dhduncan: calls 331
*** SHOW DOWN ***
manon327: shows [Ks 7d] (a pair of Kings)
dhduncan: shows [Qs Td] (a straight, Ten to Ace)
dhduncan collected 956 from pot
*** SUMMARY ***
Total pot 1012 | Rake 56 
Board [3s Js 9s Ac Kc]
Seat 1: color_singleton (small blind) folded before Flop
Seat 2: manon327 (big blind) showed [Ks 7d] and lost with a pair of Kings
Seat 3: JeBoyDirk folded on the River
Seat 9: dhduncan (button) showed [Qs Td] and won (956) with a straight, Ten to Ace



PokerStars Home Game Hand #223930268311: {DaPokaStars}  Hold'em No Limit (50/100) - 2021/02/17 17:21:50 ET
Table 'tonight again' 9-max (Play Money) Seat #1 is the button
Seat 1: color_singleton (17307 in chips) 
Seat 2: manon327 (10729 in chips) 
Seat 3: JeBoyDirk (10380 in chips) 
Seat 9: dhduncan (14473 in chips) 
manon327: posts small blind 50
JeBoyDirk: posts big blind 100
*** HOLE CARDS ***
Dealt to dhduncan [7c Ks]
dhduncan: calls 100
color_singleton has timed out
color_singleton: folds 
manon327: calls 50
JeBoyDirk: checks 
*** FLOP *** [8d Kd Kh]
manon327: checks 
JeBoyDirk has timed out
JeBoyDirk: checks 
dhduncan: bets 100
manon327: calls 100
JeBoyDirk has timed out
JeBoyDirk: folds 
*** TURN *** [8d Kd Kh] [9d]
manon327: checks 
dhduncan: bets 236
manon327: folds 
Uncalled bet (236) returned to dhduncan
dhduncan collected 472 from pot
dhduncan: doesn't show hand 
*** SUMMARY ***
Total pot 500 | Rake 28 
Board [8d Kd Kh 9d]
Seat 1: color_singleton (button) folded before Flop (didn't bet)
Seat 2: manon327 (small blind) folded on the Turn
Seat 3: JeBoyDirk (big blind) folded on the Flop
Seat 9: dhduncan collected (472)



PokerStars Home Game Hand #223930320511: {DaPokaStars}  Hold'em No Limit (50/100) - 2021/02/17 17:23:11 ET
Table 'tonight again' 9-max (Play Money) Seat #2 is the button
Seat 2: manon327 (10529 in chips) 
Seat 9: dhduncan (14745 in chips) 
manon327: posts small blind 50
dhduncan: posts big blind 100
*** HOLE CARDS ***
Dealt to dhduncan [2c 7d]
manon327: calls 50
dhduncan: checks 
*** FLOP *** [2h 7c Js]
dhduncan: bets 100
manon327: folds 
Uncalled bet (100) returned to dhduncan
dhduncan collected 189 from pot
dhduncan: doesn't show hand 
*** SUMMARY ***
Total pot 200 | Rake 11 
Board [2h 7c Js]
Seat 2: manon327 (button) (small blind) folded on the Flop
Seat 9: dhduncan (big blind) collected (189)



PokerStars Home Game Hand #223930331168: {DaPokaStars}  Hold'em No Limit (50/100) - 2021/02/17 17:23:27 ET
Table 'tonight again' 9-max (Play Money) Seat #9 is the button
Seat 2: manon327 (10429 in chips) 
Seat 3: JeBoyDirk (10280 in chips) 
Seat 9: dhduncan (14834 in chips) 
manon327: posts small blind 50
JeBoyDirk: posts big blind 100
*** HOLE CARDS ***
Dealt to dhduncan [8s Qd]
dhduncan: calls 100
manon327: folds 
JeBoyDirk: checks 
*** FLOP *** [Qs Ad 6h]
JeBoyDirk: checks 
dhduncan: bets 100
JeBoyDirk: calls 100
*** TURN *** [Qs Ad 6h] [3h]
JeBoyDirk: checks 
dhduncan: checks 
*** RIVER *** [Qs Ad 6h 3h] [9d]
JeBoyDirk: bets 400
dhduncan: folds 
Uncalled bet (400) returned to JeBoyDirk
JeBoyDirk collected 425 from pot
*** SUMMARY ***
Total pot 450 | Rake 25 
Board [Qs Ad 6h 3h 9d]
Seat 2: manon327 (small blind) folded before Flop
Seat 3: JeBoyDirk (big blind) collected (425)
Seat 9: dhduncan (button) folded on the River



PokerStars Home Game Hand #223930360672: {DaPokaStars}  Hold'em No Limit (50/100) - 2021/02/17 17:24:13 ET
Table 'tonight again' 9-max (Play Money) Seat #2 is the button
Seat 1: color_singleton (17307 in chips) 
Seat 2: manon327 (10379 in chips) 
Seat 3: JeBoyDirk (10505 in chips) 
Seat 9: dhduncan (14634 in chips) 
JeBoyDirk: posts small blind 50
dhduncan: posts big blind 100
color_singleton: posts small & big blinds 150
*** HOLE CARDS ***
Dealt to dhduncan [4h 2d]
color_singleton: checks 
manon327: folds 
JeBoyDirk: raises 100 to 200
dhduncan: folds 
color_singleton: calls 100
*** FLOP *** [Js 5s 5h]
JeBoyDirk: bets 500
color_singleton: folds 
Uncalled bet (500) returned to JeBoyDirk
JeBoyDirk collected 520 from pot
*** SUMMARY ***
Total pot 550 | Rake 30 
Board [Js 5s 5h]
Seat 1: color_singleton folded on the Flop
Seat 2: manon327 (button) folded before Flop (didn't bet)
Seat 3: JeBoyDirk (small blind) collected (520)
Seat 9: dhduncan (big blind) folded before Flop



PokerStars Home Game Hand #223930375788: {DaPokaStars}  Hold'em No Limit (50/100) - 2021/02/17 17:24:37 ET
Table 'tonight again' 9-max (Play Money) Seat #3 is the button
Seat 1: color_singleton (17057 in chips) 
Seat 2: manon327 (10379 in chips) 
Seat 3: JeBoyDirk (10825 in chips) 
Seat 9: dhduncan (14534 in chips) 
dhduncan: posts small blind 50
color_singleton: posts big blind 100
*** HOLE CARDS ***
Dealt to dhduncan [3s 6s]
manon327: folds 
JeBoyDirk: calls 100
dhduncan: calls 50
color_singleton: checks 
*** FLOP *** [Jh Ad As]
dhduncan: checks 
color_singleton: checks 
JeBoyDirk: checks 
*** TURN *** [Jh Ad As] [Kh]
dhduncan: checks 
color_singleton: checks 
JeBoyDirk: checks 
*** RIVER *** [Jh Ad As Kh] [8d]
dhduncan: checks 
color_singleton: checks 
JeBoyDirk: checks 
*** SHOW DOWN ***
dhduncan: shows [3s 6s] (a pair of Aces)
color_singleton: shows [9d 6d] (a pair of Aces - King+Jack+Nine kicker)
JeBoyDirk: shows [9s Th] (a pair of Aces - King+Jack+Ten kicker)
JeBoyDirk collected 283 from pot
*** SUMMARY ***
Total pot 300 | Rake 17 
Board [Jh Ad As Kh 8d]
Seat 1: color_singleton (big blind) showed [9d 6d] and lost with a pair of Aces
Seat 2: manon327 folded before Flop (didn't bet)
Seat 3: JeBoyDirk (button) showed [9s Th] and won (283) with a pair of Aces
Seat 9: dhduncan (small blind) showed [3s 6s] and lost with a pair of Aces



PokerStars Home Game Hand #223930391599: {DaPokaStars}  Hold'em No Limit (50/100) - 2021/02/17 17:25:02 ET
Table 'tonight again' 9-max (Play Money) Seat #9 is the button
Seat 1: color_singleton (16957 in chips) 
Seat 2: manon327 (10379 in chips) 
Seat 3: JeBoyDirk (11008 in chips) 
Seat 9: dhduncan (14434 in chips) 
color_singleton: posts small blind 50
manon327: posts big blind 100
*** HOLE CARDS ***
Dealt to dhduncan [4c 3d]
JeBoyDirk: folds 
dhduncan: folds 
color_singleton: raises 200 to 300
manon327: folds 
Uncalled bet (200) returned to color_singleton
color_singleton collected 200 from pot
color_singleton: doesn't show hand 
*** SUMMARY ***
Total pot 200 | Rake 0 
Seat 1: color_singleton (small blind) collected (200)
Seat 2: manon327 (big blind) folded before Flop
Seat 3: JeBoyDirk folded before Flop (didn't bet)
Seat 9: dhduncan (button) folded before Flop (didn't bet)



PokerStars Home Game Hand #223930396857: {DaPokaStars}  Hold'em No Limit (50/100) - 2021/02/17 17:25:10 ET
Table 'tonight again' 9-max (Play Money) Seat #1 is the button
Seat 1: color_singleton (17057 in chips) 
Seat 2: manon327 (10279 in chips) 
Seat 3: JeBoyDirk (11008 in chips) 
Seat 9: dhduncan (14434 in chips) 
manon327: posts small blind 50
JeBoyDirk: posts big blind 100
*** HOLE CARDS ***
Dealt to dhduncan [2s 4s]
dhduncan: folds 
color_singleton: folds 
manon327: calls 50
JeBoyDirk: checks 
*** FLOP *** [6d Js 2d]
manon327: checks 
JeBoyDirk: checks 
*** TURN *** [6d Js 2d] [9d]
manon327: checks 
JeBoyDirk: checks 
*** RIVER *** [6d Js 2d 9d] [Kd]
manon327: bets 189
JeBoyDirk: calls 189
*** SHOW DOWN ***
manon327: shows [As Qd] (a flush, King high)
JeBoyDirk: mucks hand 
manon327 collected 546 from pot
*** SUMMARY ***
Total pot 578 | Rake 32 
Board [6d Js 2d 9d Kd]
Seat 1: color_singleton (button) folded before Flop (didn't bet)
Seat 2: manon327 (small blind) showed [As Qd] and won (546) with a flush, King high
Seat 3: JeBoyDirk (big blind) mucked [3d Kh]
Seat 9: dhduncan folded before Flop (didn't bet)



PokerStars Home Game Hand #223930414530: {DaPokaStars}  Hold'em No Limit (50/100) - 2021/02/17 17:25:38 ET
Table 'tonight again' 9-max (Play Money) Seat #2 is the button
Seat 1: color_singleton (17057 in chips) 
Seat 2: manon327 (10536 in chips) 
Seat 3: JeBoyDirk (10719 in chips) 
Seat 9: dhduncan (14434 in chips) 
JeBoyDirk: posts small blind 50
dhduncan: posts big blind 100
*** HOLE CARDS ***
Dealt to dhduncan [Kd 7h]
color_singleton: folds 
manon327: folds 
JeBoyDirk: folds 
Uncalled bet (50) returned to dhduncan
dhduncan collected 100 from pot
dhduncan: doesn't show hand 
*** SUMMARY ***
Total pot 100 | Rake 0 
Seat 1: color_singleton folded before Flop (didn't bet)
Seat 2: manon327 (button) folded before Flop (didn't bet)
Seat 3: JeBoyDirk (small blind) folded before Flop
Seat 9: dhduncan (big blind) collected (100)



PokerStars Home Game Hand #223930418428: {DaPokaStars}  Hold'em No Limit (50/100) - 2021/02/17 17:25:44 ET
Table 'tonight again' 9-max (Play Money) Seat #3 is the button
Seat 1: color_singleton (17057 in chips) 
Seat 2: manon327 (10536 in chips) 
Seat 3: JeBoyDirk (10669 in chips) 
Seat 9: dhduncan (14484 in chips) 
dhduncan: posts small blind 50
color_singleton: posts big blind 100
*** HOLE CARDS ***
Dealt to dhduncan [3h Kh]
manon327: calls 100
JeBoyDirk: folds 
dhduncan: calls 50
color_singleton: checks 
*** FLOP *** [Qd 4h Th]
dhduncan: checks 
color_singleton: checks 
manon327: checks 
*** TURN *** [Qd 4h Th] [Ad]
dhduncan: checks 
color_singleton: checks 
manon327: bets 283
dhduncan: folds 
color_singleton: folds 
Uncalled bet (283) returned to manon327
manon327 collected 283 from pot
*** SUMMARY ***
Total pot 300 | Rake 17 
Board [Qd 4h Th Ad]
Seat 1: color_singleton (big blind) folded on the Turn
Seat 2: manon327 collected (283)
Seat 3: JeBoyDirk (button) folded before Flop (didn't bet)
Seat 9: dhduncan (small blind) folded on the Turn



PokerStars Home Game Hand #223930454030: {DaPokaStars}  Hold'em No Limit (50/100) - 2021/02/17 17:26:40 ET
Table 'tonight again' 9-max (Play Money) Seat #9 is the button
Seat 1: color_singleton (16957 in chips) 
Seat 2: manon327 (10719 in chips) 
Seat 3: JeBoyDirk (10669 in chips) 
Seat 9: dhduncan (14384 in chips) 
color_singleton: posts small blind 50
manon327: posts big blind 100
*** HOLE CARDS ***
Dealt to dhduncan [Kh Ac]
JeBoyDirk: folds 
dhduncan: calls 100
color_singleton: calls 50
manon327: checks 
*** FLOP *** [As 7s 2d]
color_singleton: checks 
manon327: checks 
dhduncan: bets 100
color_singleton: folds 
manon327: folds 
Uncalled bet (100) returned to dhduncan
dhduncan collected 283 from pot
dhduncan: doesn't show hand 
*** SUMMARY ***
Total pot 300 | Rake 17 
Board [As 7s 2d]
Seat 1: color_singleton (small blind) folded on the Flop
Seat 2: manon327 (big blind) folded on the Flop
Seat 3: JeBoyDirk folded before Flop (didn't bet)
Seat 9: dhduncan (button) collected (283)



PokerStars Home Game Hand #223930485795: {DaPokaStars}  Hold'em No Limit (50/100) - 2021/02/17 17:27:18 ET
Table 'tonight again' 9-max (Play Money) Seat #1 is the button
Seat 1: color_singleton (16857 in chips) 
Seat 2: manon327 (10619 in chips) 
Seat 3: JeBoyDirk (10669 in chips) 
Seat 9: dhduncan (14567 in chips) 
manon327: posts small blind 50
JeBoyDirk: posts big blind 100
*** HOLE CARDS ***
Dealt to dhduncan [8c 7s]
dhduncan: folds 
color_singleton: folds 
manon327: folds 
Uncalled bet (50) returned to JeBoyDirk
JeBoyDirk collected 100 from pot
*** SUMMARY ***
Total pot 100 | Rake 0 
Seat 1: color_singleton (button) folded before Flop (didn't bet)
Seat 2: manon327 (small blind) folded before Flop
Seat 3: JeBoyDirk (big blind) collected (100)
Seat 9: dhduncan folded before Flop (didn't bet)



PokerStars Home Game Hand #223930490711: {DaPokaStars}  Hold'em No Limit (50/100) - 2021/02/17 17:27:26 ET
Table 'tonight again' 9-max (Play Money) Seat #2 is the button
Seat 1: color_singleton (16857 in chips) 
Seat 2: manon327 (10569 in chips) 
Seat 3: JeBoyDirk (10719 in chips) 
Seat 9: dhduncan (14567 in chips) 
JeBoyDirk: posts small blind 50
dhduncan: posts big blind 100
*** HOLE CARDS ***
Dealt to dhduncan [2c Kh]
color_singleton: raises 200 to 300
manon327: calls 300
JeBoyDirk: folds 
dhduncan: calls 200
*** FLOP *** [8s Ac 8c]
dhduncan: checks 
color_singleton: checks 
manon327: bets 449
dhduncan: folds 
color_singleton: folds 
Uncalled bet (449) returned to manon327
manon327 collected 898 from pot
*** SUMMARY ***
Total pot 950 | Rake 52 
Board [8s Ac 8c]
Seat 1: color_singleton folded on the Flop
Seat 2: manon327 (button) collected (898)
Seat 3: JeBoyDirk (small blind) folded before Flop
Seat 9: dhduncan (big blind) folded on the Flop



PokerStars Home Game Hand #223930505090: {DaPokaStars}  Hold'em No Limit (50/100) - 2021/02/17 17:27:49 ET
Table 'tonight again' 9-max (Play Money) Seat #3 is the button
Seat 1: color_singleton (16557 in chips) 
Seat 2: manon327 (11167 in chips) 
Seat 3: JeBoyDirk (10669 in chips) 
Seat 9: dhduncan (14267 in chips) 
dhduncan: posts small blind 50
color_singleton: posts big blind 100
*** HOLE CARDS ***
Dealt to dhduncan [Jd Kc]
manon327: folds 
JeBoyDirk: folds 
dhduncan: calls 50
color_singleton: checks 
*** FLOP *** [Th Jc 2h]
dhduncan: checks 
color_singleton: bets 189
dhduncan: calls 189
*** TURN *** [Th Jc 2h] [Ts]
dhduncan: checks 
color_singleton: bets 273
dhduncan: calls 273
*** RIVER *** [Th Jc 2h Ts] [3h]
dhduncan: checks 
color_singleton: bets 531
dhduncan: folds 
Uncalled bet (531) returned to color_singleton
color_singleton collected 1062 from pot
color_singleton: doesn't show hand 
*** SUMMARY ***
Total pot 1124 | Rake 62 
Board [Th Jc 2h Ts 3h]
Seat 1: color_singleton (big blind) collected (1062)
Seat 2: manon327 folded before Flop (didn't bet)
Seat 3: JeBoyDirk (button) folded before Flop (didn't bet)
Seat 9: dhduncan (small blind) folded on the River



PokerStars Home Game Hand #223930534217: {DaPokaStars}  Hold'em No Limit (50/100) - 2021/02/17 17:28:34 ET
Table 'tonight again' 9-max (Play Money) Seat #9 is the button
Seat 1: color_singleton (17057 in chips) 
Seat 2: manon327 (11167 in chips) 
Seat 3: JeBoyDirk (10669 in chips) 
Seat 9: dhduncan (13705 in chips) 
color_singleton: posts small blind 50
manon327: posts big blind 100
*** HOLE CARDS ***
Dealt to dhduncan [8h 3h]
JeBoyDirk: raises 100 to 200
dhduncan: folds 
color_singleton: calls 150
manon327: folds 
*** FLOP *** [9c 3s 5d]
color_singleton: checks 
JeBoyDirk: checks 
*** TURN *** [9c 3s 5d] [5h]
color_singleton: checks 
JeBoyDirk: checks 
*** RIVER *** [9c 3s 5d 5h] [5s]
color_singleton: checks 
JeBoyDirk: checks 
*** SHOW DOWN ***
color_singleton: shows [Ts 8d] (three of a kind, Fives)
JeBoyDirk: shows [Td Ad] (three of a kind, Fives - Ace kicker)
JeBoyDirk collected 472 from pot
*** SUMMARY ***
Total pot 500 | Rake 28 
Board [9c 3s 5d 5h 5s]
Seat 1: color_singleton (small blind) showed [Ts 8d] and lost with three of a kind, Fives
Seat 2: manon327 (big blind) folded before Flop
Seat 3: JeBoyDirk showed [Td Ad] and won (472) with three of a kind, Fives
Seat 9: dhduncan (button) folded before Flop (didn't bet)



PokerStars Home Game Hand #223930547932: {DaPokaStars}  Hold'em No Limit (50/100) - 2021/02/17 17:28:56 ET
Table 'tonight again' 9-max (Play Money) Seat #1 is the button
Seat 1: color_singleton (16857 in chips) 
Seat 2: manon327 (11067 in chips) 
Seat 3: JeBoyDirk (10941 in chips) 
Seat 9: dhduncan (13705 in chips) 
manon327: posts small blind 50
JeBoyDirk: posts big blind 100
*** HOLE CARDS ***
Dealt to dhduncan [5c 4h]
dhduncan: folds 
color_singleton: folds 
manon327: calls 50
JeBoyDirk: checks 
*** FLOP *** [2h Jc 5h]
manon327: bets 100
JeBoyDirk: folds 
Uncalled bet (100) returned to manon327
manon327 collected 189 from pot
*** SUMMARY ***
Total pot 200 | Rake 11 
Board [2h Jc 5h]
Seat 1: color_singleton (button) folded before Flop (didn't bet)
Seat 2: manon327 (small blind) collected (189)
Seat 3: JeBoyDirk (big blind) folded on the Flop
Seat 9: dhduncan folded before Flop (didn't bet)



PokerStars Home Game Hand #223930556435: {DaPokaStars}  Hold'em No Limit (50/100) - 2021/02/17 17:29:09 ET
Table 'tonight again' 9-max (Play Money) Seat #2 is the button
Seat 1: color_singleton (16857 in chips) 
Seat 2: manon327 (11156 in chips) 
Seat 3: JeBoyDirk (10841 in chips) 
Seat 9: dhduncan (13705 in chips) 
JeBoyDirk: posts small blind 50
dhduncan: posts big blind 100
*** HOLE CARDS ***
Dealt to dhduncan [2c Kh]
color_singleton: raises 200 to 300
manon327: calls 300
JeBoyDirk: calls 250
dhduncan: folds 
*** FLOP *** [8d 2d 8s]
JeBoyDirk: bets 400
color_singleton: calls 400
manon327: calls 400
*** TURN *** [8d 2d 8s] [Ks]
JeBoyDirk: checks 
color_singleton: bets 1039
manon327: folds 
JeBoyDirk: folds 
Uncalled bet (1039) returned to color_singleton
color_singleton collected 2079 from pot
color_singleton: doesn't show hand 
*** SUMMARY ***
Total pot 2200 | Rake 121 
Board [8d 2d 8s Ks]
Seat 1: color_singleton collected (2079)
Seat 2: manon327 (button) folded on the Turn
Seat 3: JeBoyDirk (small blind) folded on the Turn
Seat 9: dhduncan (big blind) folded before Flop



PokerStars Home Game Hand #223930590198: {DaPokaStars}  Hold'em No Limit (50/100) - 2021/02/17 17:30:03 ET
Table 'tonight again' 9-max (Play Money) Seat #3 is the button
Seat 1: color_singleton (18236 in chips) 
Seat 2: manon327 (10456 in chips) 
Seat 3: JeBoyDirk (10141 in chips) 
Seat 9: dhduncan (13605 in chips) 
dhduncan: posts small blind 50
color_singleton: posts big blind 100
*** HOLE CARDS ***
Dealt to dhduncan [3d 8c]
manon327: calls 100
JeBoyDirk: calls 100
dhduncan: folds 
color_singleton: raises 200 to 300
manon327: folds 
JeBoyDirk: calls 200
*** FLOP *** [6c Qc Ac]
color_singleton: bets 709
JeBoyDirk: folds 
Uncalled bet (709) returned to color_singleton
color_singleton collected 709 from pot
color_singleton: doesn't show hand 
*** SUMMARY ***
Total pot 750 | Rake 41 
Board [6c Qc Ac]
Seat 1: color_singleton (big blind) collected (709)
Seat 2: manon327 folded before Flop
Seat 3: JeBoyDirk (button) folded on the Flop
Seat 9: dhduncan (small blind) folded before Flop



PokerStars Home Game Hand #223930608024: {DaPokaStars}  Hold'em No Limit (50/100) - 2021/02/17 17:30:31 ET
Table 'tonight again' 9-max (Play Money) Seat #9 is the button
Seat 1: color_singleton (18645 in chips) 
Seat 2: manon327 (10356 in chips) 
Seat 3: JeBoyDirk (9841 in chips) 
Seat 9: dhduncan (13555 in chips) 
color_singleton: posts small blind 50
manon327: posts big blind 100
*** HOLE CARDS ***
Dealt to dhduncan [7s 5c]
JeBoyDirk: folds 
dhduncan: folds 
color_singleton: raises 200 to 300
manon327: calls 200
*** FLOP *** [Js Ks 7h]
color_singleton: bets 283
manon327: calls 283
*** TURN *** [Js Ks 7h] [7d]
color_singleton: checks 
manon327: checks 
*** RIVER *** [Js Ks 7h 7d] [6h]
color_singleton: checks 
manon327: checks 
*** SHOW DOWN ***
color_singleton: shows [Qd Tc] (a pair of Sevens)
manon327: shows [9s Qc] (a pair of Sevens)
color_singleton collected 551 from pot
manon327 collected 551 from pot
*** SUMMARY ***
Total pot 1166 | Rake 64 
Board [Js Ks 7h 7d 6h]
Seat 1: color_singleton (small blind) showed [Qd Tc] and won (551) with a pair of Sevens
Seat 2: manon327 (big blind) showed [9s Qc] and won (551) with a pair of Sevens
Seat 3: JeBoyDirk folded before Flop (didn't bet)
Seat 9: dhduncan (button) folded before Flop (didn't bet)



PokerStars Home Game Hand #223930634205: {DaPokaStars}  Hold'em No Limit (50/100) - 2021/02/17 17:30:58 ET
Table 'tonight again' 9-max (Play Money) Seat #1 is the button
Seat 1: color_singleton (18613 in chips) 
Seat 2: manon327 (10324 in chips) 
Seat 3: JeBoyDirk (9841 in chips) 
Seat 9: dhduncan (13555 in chips) 
manon327: posts small blind 50
JeBoyDirk: posts big blind 100
*** HOLE CARDS ***
Dealt to dhduncan [Kc 5c]
dhduncan: calls 100
color_singleton: calls 100
manon327: raises 100 to 200
JeBoyDirk: calls 100
dhduncan: calls 100
color_singleton: calls 100
*** FLOP *** [Ts 7s Th]
manon327: bets 756
JeBoyDirk: folds 
dhduncan: folds 
color_singleton: folds 
Uncalled bet (756) returned to manon327
manon327 collected 756 from pot
*** SUMMARY ***
Total pot 800 | Rake 44 
Board [Ts 7s Th]
Seat 1: color_singleton (button) folded on the Flop
Seat 2: manon327 (small blind) collected (756)
Seat 3: JeBoyDirk (big blind) folded on the Flop
Seat 9: dhduncan folded on the Flop



PokerStars Home Game Hand #223930657004: {DaPokaStars}  Hold'em No Limit (50/100) - 2021/02/17 17:31:34 ET
Table 'tonight again' 9-max (Play Money) Seat #2 is the button
Seat 1: color_singleton (18413 in chips) 
Seat 2: manon327 (10880 in chips) 
Seat 3: JeBoyDirk (9641 in chips) 
Seat 9: dhduncan (13355 in chips) 
JeBoyDirk: posts small blind 50
dhduncan: posts big blind 100
*** HOLE CARDS ***
Dealt to dhduncan [Td 4d]
color_singleton: folds 
manon327: calls 100
JeBoyDirk: calls 50
dhduncan: checks 
*** FLOP *** [6h Ts Qs]
JeBoyDirk: checks 
dhduncan: checks 
manon327: bets 283
JeBoyDirk: folds 
dhduncan: folds 
Uncalled bet (283) returned to manon327
manon327 collected 283 from pot
*** SUMMARY ***
Total pot 300 | Rake 17 
Board [6h Ts Qs]
Seat 1: color_singleton folded before Flop (didn't bet)
Seat 2: manon327 (button) collected (283)
Seat 3: JeBoyDirk (small blind) folded on the Flop
Seat 9: dhduncan (big blind) folded on the Flop



PokerStars Home Game Hand #223930676833: {DaPokaStars}  Hold'em No Limit (50/100) - 2021/02/17 17:32:06 ET
Table 'tonight again' 9-max (Play Money) Seat #3 is the button
Seat 1: color_singleton (18413 in chips) 
Seat 2: manon327 (11063 in chips) 
Seat 3: JeBoyDirk (9541 in chips) 
Seat 9: dhduncan (13255 in chips) 
dhduncan: posts small blind 50
color_singleton: posts big blind 100
*** HOLE CARDS ***
Dealt to dhduncan [Ts 7c]
manon327: folds 
JeBoyDirk: calls 100
dhduncan: folds 
color_singleton: checks 
*** FLOP *** [Jc 3c 9c]
color_singleton: checks 
JeBoyDirk: bets 300
color_singleton: folds 
Uncalled bet (300) returned to JeBoyDirk
JeBoyDirk collected 236 from pot
*** SUMMARY ***
Total pot 250 | Rake 14 
Board [Jc 3c 9c]
Seat 1: color_singleton (big blind) folded on the Flop
Seat 2: manon327 folded before Flop (didn't bet)
Seat 3: JeBoyDirk (button) collected (236)
Seat 9: dhduncan (small blind) folded before Flop



PokerStars Home Game Hand #223930690015: {DaPokaStars}  Hold'em No Limit (50/100) - 2021/02/17 17:32:27 ET
Table 'tonight again' 9-max (Play Money) Seat #9 is the button
Seat 1: color_singleton (18313 in chips) 
Seat 2: manon327 (11063 in chips) 
Seat 3: JeBoyDirk (9677 in chips) 
Seat 9: dhduncan (13205 in chips) 
color_singleton: posts small blind 50
manon327: posts big blind 100
*** HOLE CARDS ***
Dealt to dhduncan [9s Qc]
JeBoyDirk: calls 100
dhduncan: calls 100
color_singleton: calls 50
manon327: raises 100 to 200
JeBoyDirk: calls 100
dhduncan: calls 100
color_singleton: calls 100
*** FLOP *** [8s Tc 7d]
color_singleton: checks 
manon327: bets 756
JeBoyDirk: folds 
dhduncan: folds 
color_singleton: raises 1134 to 1890
manon327: folds 
Uncalled bet (1134) returned to color_singleton
color_singleton collected 2185 from pot
color_singleton: doesn't show hand 
*** SUMMARY ***
Total pot 2312 | Rake 127 
Board [8s Tc 7d]
Seat 1: color_singleton (small blind) collected (2185)
Seat 2: manon327 (big blind) folded on the Flop
Seat 3: JeBoyDirk folded on the Flop
Seat 9: dhduncan (button) folded on the Flop



PokerStars Home Game Hand #223930816836: {DaPokaStars}  Hold'em No Limit (50/100) - 2021/02/17 17:35:51 ET
Table 'tonight again' 9-max (Play Money) Seat #2 is the button
Seat 1: color_singleton (19080 in chips) 
Seat 2: manon327 (10271 in chips) 
Seat 3: JeBoyDirk (9510 in chips) 
Seat 7: Klemtonius (17616 in chips) 
Seat 9: dhduncan (13005 in chips) 
JeBoyDirk: posts small blind 50
Klemtonius: posts big blind 100
dhduncan: posts small & big blinds 150
*** HOLE CARDS ***
Dealt to dhduncan [Ad Qd]
dhduncan: checks 
color_singleton: folds 
manon327: folds 
JeBoyDirk: folds 
Klemtonius: checks 
*** FLOP *** [Ks 3h 5h]
Klemtonius: checks 
dhduncan: checks 
*** TURN *** [Ks 3h 5h] [3c]
Klemtonius: checks 
dhduncan: checks 
*** RIVER *** [Ks 3h 5h 3c] [Js]
Klemtonius: bets 100
dhduncan: folds 
Uncalled bet (100) returned to Klemtonius
Klemtonius collected 283 from pot
Klemtonius: doesn't show hand 
*** SUMMARY ***
Total pot 300 | Rake 17 
Board [Ks 3h 5h 3c Js]
Seat 1: color_singleton folded before Flop (didn't bet)
Seat 2: manon327 (button) folded before Flop (didn't bet)
Seat 3: JeBoyDirk (small blind) folded before Flop
Seat 7: Klemtonius (big blind) collected (283)
Seat 9: dhduncan folded on the River (didn't bet)



PokerStars Home Game Hand #223930845125: {DaPokaStars}  Hold'em No Limit (50/100) - 2021/02/17 17:36:37 ET
Table 'tonight again' 9-max (Play Money) Seat #3 is the button
Seat 1: color_singleton (19080 in chips) 
Seat 2: manon327 (10271 in chips) 
Seat 3: JeBoyDirk (9460 in chips) 
Seat 7: Klemtonius (17799 in chips) 
Seat 9: dhduncan (12855 in chips) 
Klemtonius: posts small blind 50
dhduncan: posts big blind 100
*** HOLE CARDS ***
Dealt to dhduncan [6h 4c]
color_singleton: raises 200 to 300
manon327: calls 300
JeBoyDirk: folds 
Klemtonius: calls 250
dhduncan: folds 
*** FLOP *** [Kh Td 2c]
Klemtonius: checks 
color_singleton: bets 472
manon327: calls 472
Klemtonius: calls 472
*** TURN *** [Kh Td 2c] [6s]
Klemtonius: checks 
color_singleton: checks 
manon327: bets 1141
Klemtonius: raises 1141 to 2282
color_singleton: folds 
manon327: calls 1141
*** RIVER *** [Kh Td 2c 6s] [8d]
Klemtonius: checks 
manon327: checks 
*** SHOW DOWN ***
Klemtonius: shows [2d 2h] (three of a kind, Deuces)
manon327: mucks hand 
Klemtonius collected 6596 from pot
*** SUMMARY ***
Total pot 6980 | Rake 384 
Board [Kh Td 2c 6s 8d]
Seat 1: color_singleton folded on the Turn
Seat 2: manon327 mucked [Kc Qs]
Seat 3: JeBoyDirk (button) folded before Flop (didn't bet)
Seat 7: Klemtonius (small blind) showed [2d 2h] and won (6596) with three of a kind, Deuces
Seat 9: dhduncan (big blind) folded before Flop



PokerStars Home Game Hand #223930874389: {DaPokaStars}  Hold'em No Limit (50/100) - 2021/02/17 17:37:25 ET
Table 'tonight again' 9-max (Play Money) Seat #7 is the button
Seat 1: color_singleton (18308 in chips) 
Seat 2: manon327 (7217 in chips) 
Seat 3: JeBoyDirk (9460 in chips) 
Seat 7: Klemtonius (21341 in chips) 
Seat 9: dhduncan (12755 in chips) 
dhduncan: posts small blind 50
color_singleton: posts big blind 100
*** HOLE CARDS ***
Dealt to dhduncan [7c Kd]
manon327: folds 
JeBoyDirk: folds 
Klemtonius: calls 100
dhduncan: calls 50
color_singleton: checks 
*** FLOP *** [Tc Ad 3c]
dhduncan: checks 
color_singleton: bets 283
Klemtonius: calls 283
dhduncan: folds 
*** TURN *** [Tc Ad 3c] [6s]
color_singleton: checks 
Klemtonius: checks 
*** RIVER *** [Tc Ad 3c 6s] [6d]
color_singleton: checks 
Klemtonius: checks 
*** SHOW DOWN ***
color_singleton: shows [Td 7d] (two pair, Tens and Sixes)
Klemtonius: mucks hand 
color_singleton collected 818 from pot
*** SUMMARY ***
Total pot 866 | Rake 48 
Board [Tc Ad 3c 6s 6d]
Seat 1: color_singleton (big blind) showed [Td 7d] and won (818) with two pair, Tens and Sixes
Seat 2: manon327 folded before Flop (didn't bet)
Seat 3: JeBoyDirk folded before Flop (didn't bet)
Seat 7: Klemtonius (button) mucked [3h 5h]
Seat 9: dhduncan (small blind) folded on the Flop



PokerStars Home Game Hand #223930901261: {DaPokaStars}  Hold'em No Limit (50/100) - 2021/02/17 17:38:09 ET
Table 'tonight again' 9-max (Play Money) Seat #9 is the button
Seat 1: color_singleton (18743 in chips) 
Seat 2: manon327 (7217 in chips) 
Seat 3: JeBoyDirk (9460 in chips) 
Seat 7: Klemtonius (20958 in chips) 
Seat 9: dhduncan (12655 in chips) 
color_singleton: posts small blind 50
manon327: posts big blind 100
*** HOLE CARDS ***
Dealt to dhduncan [Js Kh]
JeBoyDirk: folds 
Klemtonius: calls 100
dhduncan: calls 100
color_singleton: calls 50
manon327: checks 
*** FLOP *** [Jd As 7d]
color_singleton: bets 189
manon327: folds 
Klemtonius: folds 
dhduncan: calls 189
*** TURN *** [Jd As 7d] [6h]
color_singleton: bets 367
dhduncan: calls 367
*** RIVER *** [Jd As 7d 6h] [5h]
color_singleton: checks 
dhduncan: checks 
*** SHOW DOWN ***
color_singleton: shows [2s Ah] (a pair of Aces)
dhduncan: mucks hand 
color_singleton collected 1429 from pot
*** SUMMARY ***
Total pot 1512 | Rake 83 
Board [Jd As 7d 6h 5h]
Seat 1: color_singleton (small blind) showed [2s Ah] and won (1429) with a pair of Aces
Seat 2: manon327 (big blind) folded on the Flop
Seat 3: JeBoyDirk folded before Flop (didn't bet)
Seat 7: Klemtonius folded on the Flop
Seat 9: dhduncan (button) mucked [Js Kh]



PokerStars Home Game Hand #223930925772: {DaPokaStars}  Hold'em No Limit (50/100) - 2021/02/17 17:38:49 ET
Table 'tonight again' 9-max (Play Money) Seat #1 is the button
Seat 1: color_singleton (19516 in chips) 
Seat 2: manon327 (7117 in chips) 
Seat 3: JeBoyDirk (9460 in chips) 
Seat 7: Klemtonius (20858 in chips) 
Seat 9: dhduncan (11999 in chips) 
manon327: posts small blind 50
JeBoyDirk: posts big blind 100
*** HOLE CARDS ***
Dealt to dhduncan [Jd 4c]
Klemtonius: raises 250 to 350
dhduncan: calls 350
color_singleton: calls 350
manon327: folds 
JeBoyDirk: folds 
*** FLOP *** [Ts 6h Jc]
Klemtonius: checks 
dhduncan: checks 
color_singleton: bets 567
Klemtonius: calls 567
dhduncan: folds 
*** TURN *** [Ts 6h Jc] [Js]
Klemtonius: checks 
color_singleton: checks 
*** RIVER *** [Ts 6h Jc Js] [8s]
Klemtonius: checks 
color_singleton: checks 
*** SHOW DOWN ***
Klemtonius: shows [Kd Ac] (a pair of Jacks)
color_singleton: shows [Tc Qd] (two pair, Jacks and Tens)
color_singleton collected 2206 from pot
*** SUMMARY ***
Total pot 2334 | Rake 128 
Board [Ts 6h Jc Js 8s]
Seat 1: color_singleton (button) showed [Tc Qd] and won (2206) with two pair, Jacks and Tens
Seat 2: manon327 (small blind) folded before Flop
Seat 3: JeBoyDirk (big blind) folded before Flop
Seat 7: Klemtonius showed [Kd Ac] and lost with a pair of Jacks
Seat 9: dhduncan folded on the Flop



PokerStars Home Game Hand #223930967041: {DaPokaStars}  Hold'em No Limit (50/100) - 2021/02/17 17:39:56 ET
Table 'tonight again' 9-max (Play Money) Seat #2 is the button
Seat 1: color_singleton (20805 in chips) 
Seat 2: manon327 (7067 in chips) 
Seat 3: JeBoyDirk (9360 in chips) 
Seat 7: Klemtonius (19941 in chips) 
Seat 9: dhduncan (11649 in chips) 
JeBoyDirk: posts small blind 50
Klemtonius: posts big blind 100
*** HOLE CARDS ***
Dealt to dhduncan [Kd 5d]
dhduncan: calls 100
color_singleton: folds 
manon327: folds 
JeBoyDirk: folds 
Klemtonius: raises 100 to 200
dhduncan: calls 100
*** FLOP *** [3h Ts Jd]
Klemtonius: checks 
dhduncan: checks 
*** TURN *** [3h Ts Jd] [Tc]
Klemtonius: checks 
dhduncan: checks 
*** RIVER *** [3h Ts Jd Tc] [8h]
Klemtonius: checks 
dhduncan: checks 
*** SHOW DOWN ***
Klemtonius: shows [7c As] (a pair of Tens)
dhduncan: mucks hand 
Klemtonius collected 425 from pot
*** SUMMARY ***
Total pot 450 | Rake 25 
Board [3h Ts Jd Tc 8h]
Seat 1: color_singleton folded before Flop (didn't bet)
Seat 2: manon327 (button) folded before Flop (didn't bet)
Seat 3: JeBoyDirk (small blind) folded before Flop
Seat 7: Klemtonius (big blind) showed [7c As] and won (425) with a pair of Tens
Seat 9: dhduncan mucked [Kd 5d]



PokerStars Home Game Hand #223930992348: {DaPokaStars}  Hold'em No Limit (50/100) - 2021/02/17 17:40:38 ET
Table 'tonight again' 9-max (Play Money) Seat #3 is the button
Seat 1: color_singleton (20805 in chips) 
Seat 2: manon327 (7067 in chips) 
Seat 3: JeBoyDirk (9310 in chips) 
Seat 7: Klemtonius (20166 in chips) 
Seat 9: dhduncan (11449 in chips) 
Klemtonius: posts small blind 50
dhduncan: posts big blind 100
*** HOLE CARDS ***
Dealt to dhduncan [3d Td]
color_singleton: folds 
manon327: calls 100
JeBoyDirk: calls 100
Klemtonius: calls 50
dhduncan: checks 
*** FLOP *** [7d 8d Ks]
Klemtonius: checks 
dhduncan: checks 
manon327: checks 
JeBoyDirk: checks 
*** TURN *** [7d 8d Ks] [Qc]
Klemtonius: bets 378
dhduncan: folds 
manon327: folds 
JeBoyDirk: folds 
Uncalled bet (378) returned to Klemtonius
Klemtonius collected 378 from pot
Klemtonius: doesn't show hand 
*** SUMMARY ***
Total pot 400 | Rake 22 
Board [7d 8d Ks Qc]
Seat 1: color_singleton folded before Flop (didn't bet)
Seat 2: manon327 folded on the Turn
Seat 3: JeBoyDirk (button) folded on the Turn
Seat 7: Klemtonius (small blind) collected (378)
Seat 9: dhduncan (big blind) folded on the Turn



PokerStars Home Game Hand #223931013493: {DaPokaStars}  Hold'em No Limit (50/100) - 2021/02/17 17:41:12 ET
Table 'tonight again' 9-max (Play Money) Seat #7 is the button
Seat 1: color_singleton (20805 in chips) 
Seat 2: manon327 (6967 in chips) 
Seat 3: JeBoyDirk (9210 in chips) 
Seat 7: Klemtonius (20444 in chips) 
Seat 9: dhduncan (11349 in chips) 
dhduncan: posts small blind 50
color_singleton: posts big blind 100
*** HOLE CARDS ***
Dealt to dhduncan [Kh Th]
manon327: folds 
JeBoyDirk: folds 
Klemtonius: raises 250 to 350
dhduncan: calls 300
color_singleton: calls 250
*** FLOP *** [4c 7d Qs]
dhduncan: checks 
color_singleton: checks 
Klemtonius: checks 
*** TURN *** [4c 7d Qs] [7c]
dhduncan: checks 
color_singleton: checks 
Klemtonius: bets 992
dhduncan: folds 
color_singleton: folds 
Uncalled bet (992) returned to Klemtonius
Klemtonius collected 992 from pot
Klemtonius: doesn't show hand 
*** SUMMARY ***
Total pot 1050 | Rake 58 
Board [4c 7d Qs 7c]
Seat 1: color_singleton (big blind) folded on the Turn
Seat 2: manon327 folded before Flop (didn't bet)
Seat 3: JeBoyDirk folded before Flop (didn't bet)
Seat 7: Klemtonius (button) collected (992)
Seat 9: dhduncan (small blind) folded on the Turn



PokerStars Home Game Hand #223931028902: {DaPokaStars}  Hold'em No Limit (50/100) - 2021/02/17 17:41:38 ET
Table 'tonight again' 9-max (Play Money) Seat #9 is the button
Seat 1: color_singleton (20455 in chips) 
Seat 2: manon327 (6967 in chips) 
Seat 3: JeBoyDirk (9210 in chips) 
Seat 7: Klemtonius (21086 in chips) 
Seat 9: dhduncan (10999 in chips) 
color_singleton: posts small blind 50
manon327: posts big blind 100
*** HOLE CARDS ***
Dealt to dhduncan [3c Tc]
JeBoyDirk: folds 
Klemtonius: raises 250 to 350
dhduncan: folds 
color_singleton: folds 
manon327: calls 250
*** FLOP *** [8s Kh 4s]
manon327: checks 
Klemtonius: bets 100
manon327: folds 
Uncalled bet (100) returned to Klemtonius
Klemtonius collected 709 from pot
Klemtonius: doesn't show hand 
*** SUMMARY ***
Total pot 750 | Rake 41 
Board [8s Kh 4s]
Seat 1: color_singleton (small blind) folded before Flop
Seat 2: manon327 (big blind) folded on the Flop
Seat 3: JeBoyDirk folded before Flop (didn't bet)
Seat 7: Klemtonius collected (709)
Seat 9: dhduncan (button) folded before Flop (didn't bet)



PokerStars Home Game Hand #223931042854: {DaPokaStars}  Hold'em No Limit (50/100) - 2021/02/17 17:42:01 ET
Table 'tonight again' 9-max (Play Money) Seat #1 is the button
Seat 1: color_singleton (20405 in chips) 
Seat 2: manon327 (6617 in chips) 
Seat 3: JeBoyDirk (9210 in chips) 
Seat 7: Klemtonius (21445 in chips) 
Seat 9: dhduncan (10999 in chips) 
manon327: posts small blind 50
JeBoyDirk: posts big blind 100
*** HOLE CARDS ***
Dealt to dhduncan [3h Jc]
Klemtonius: raises 250 to 350
dhduncan: folds 
color_singleton: folds 
manon327: calls 300
JeBoyDirk: calls 250
*** FLOP *** [3c 2d Ks]
manon327: checks 
JeBoyDirk: checks 
Klemtonius: bets 992
manon327: calls 992
JeBoyDirk: folds 
*** TURN *** [3c 2d Ks] [9h]
manon327: checks 
Klemtonius: bets 2867
manon327: folds 
Uncalled bet (2867) returned to Klemtonius
Klemtonius collected 2867 from pot
Klemtonius: doesn't show hand 
*** SUMMARY ***
Total pot 3034 | Rake 167 
Board [3c 2d Ks 9h]
Seat 1: color_singleton (button) folded before Flop (didn't bet)
Seat 2: manon327 (small blind) folded on the Turn
Seat 3: JeBoyDirk (big blind) folded on the Flop
Seat 7: Klemtonius collected (2867)
Seat 9: dhduncan folded before Flop (didn't bet)



PokerStars Home Game Hand #223931071581: {DaPokaStars}  Hold'em No Limit (50/100) - 2021/02/17 17:42:48 ET
Table 'tonight again' 9-max (Play Money) Seat #2 is the button
Seat 1: color_singleton (20405 in chips) 
Seat 2: manon327 (5275 in chips) 
Seat 3: JeBoyDirk (8860 in chips) 
Seat 7: Klemtonius (22970 in chips) 
Seat 9: dhduncan (10999 in chips) 
JeBoyDirk: posts small blind 50
Klemtonius: posts big blind 100
*** HOLE CARDS ***
Dealt to dhduncan [3h Qd]
dhduncan: folds 
color_singleton: folds 
manon327: folds 
JeBoyDirk: calls 50
Klemtonius: checks 
*** FLOP *** [5c Kc 7s]
JeBoyDirk: checks 
Klemtonius: bets 189
JeBoyDirk: folds 
Uncalled bet (189) returned to Klemtonius
Klemtonius collected 189 from pot
Klemtonius: doesn't show hand 
*** SUMMARY ***
Total pot 200 | Rake 11 
Board [5c Kc 7s]
Seat 1: color_singleton folded before Flop (didn't bet)
Seat 2: manon327 (button) folded before Flop (didn't bet)
Seat 3: JeBoyDirk (small blind) folded on the Flop
Seat 7: Klemtonius (big blind) collected (189)
Seat 9: dhduncan folded before Flop (didn't bet)



PokerStars Home Game Hand #223931087895: {DaPokaStars}  Hold'em No Limit (50/100) - 2021/02/17 17:43:15 ET
Table 'tonight again' 9-max (Play Money) Seat #3 is the button
Seat 1: color_singleton (20405 in chips) 
Seat 2: manon327 (5275 in chips) 
Seat 3: JeBoyDirk (8760 in chips) 
Seat 7: Klemtonius (23059 in chips) 
Seat 9: dhduncan (10999 in chips) 
Klemtonius: posts small blind 50
dhduncan: posts big blind 100
*** HOLE CARDS ***
Dealt to dhduncan [9s Qd]
color_singleton: raises 200 to 300
manon327: calls 300
JeBoyDirk: folds 
Klemtonius: folds 
dhduncan: folds 
*** FLOP *** [8s Js Jc]
color_singleton: bets 709
manon327: folds 
Uncalled bet (709) returned to color_singleton
color_singleton collected 709 from pot
color_singleton: doesn't show hand 
*** SUMMARY ***
Total pot 750 | Rake 41 
Board [8s Js Jc]
Seat 1: color_singleton collected (709)
Seat 2: manon327 folded on the Flop
Seat 3: JeBoyDirk (button) folded before Flop (didn't bet)
Seat 7: Klemtonius (small blind) folded before Flop
Seat 9: dhduncan (big blind) folded before Flop



PokerStars Home Game Hand #223931105108: {DaPokaStars}  Hold'em No Limit (50/100) - 2021/02/17 17:43:44 ET
Table 'tonight again' 9-max (Play Money) Seat #7 is the button
Seat 1: color_singleton (20814 in chips) 
Seat 2: manon327 (4975 in chips) 
Seat 3: JeBoyDirk (8760 in chips) 
Seat 7: Klemtonius (23009 in chips) 
Seat 9: dhduncan (10899 in chips) 
dhduncan: posts small blind 50
color_singleton: posts big blind 100
*** HOLE CARDS ***
Dealt to dhduncan [Qd 7h]
manon327: calls 100
JeBoyDirk: folds 
Klemtonius: folds 
dhduncan: folds 
color_singleton: raises 200 to 300
manon327: calls 200
*** FLOP *** [Qh 9h 5h]
color_singleton: checks 
manon327: checks 
*** TURN *** [Qh 9h 5h] [Ah]
color_singleton: checks 
manon327: checks 
*** RIVER *** [Qh 9h 5h Ah] [9s]
color_singleton: bets 307
manon327: folds 
Uncalled bet (307) returned to color_singleton
color_singleton collected 614 from pot
color_singleton: doesn't show hand 
*** SUMMARY ***
Total pot 650 | Rake 36 
Board [Qh 9h 5h Ah 9s]
Seat 1: color_singleton (big blind) collected (614)
Seat 2: manon327 folded on the River
Seat 3: JeBoyDirk folded before Flop (didn't bet)
Seat 7: Klemtonius (button) folded before Flop (didn't bet)
Seat 9: dhduncan (small blind) folded before Flop



PokerStars Home Game Hand #223931123732: {DaPokaStars}  Hold'em No Limit (50/100) - 2021/02/17 17:44:15 ET
Table 'tonight again' 9-max (Play Money) Seat #9 is the button
Seat 1: color_singleton (21128 in chips) 
Seat 2: manon327 (4675 in chips) 
Seat 3: JeBoyDirk (8760 in chips) 
Seat 7: Klemtonius (23009 in chips) 
Seat 9: dhduncan (10849 in chips) 
color_singleton: posts small blind 50
manon327: posts big blind 100
*** HOLE CARDS ***
Dealt to dhduncan [8c 2d]
JeBoyDirk: raises 100 to 200
Klemtonius: raises 100 to 300
dhduncan: folds 
color_singleton: calls 250
manon327: folds 
JeBoyDirk: calls 100
*** FLOP *** [Qd 6h Qh]
color_singleton: bets 945
JeBoyDirk: folds 
Klemtonius: folds 
Uncalled bet (945) returned to color_singleton
color_singleton collected 945 from pot
color_singleton: doesn't show hand 
*** SUMMARY ***
Total pot 1000 | Rake 55 
Board [Qd 6h Qh]
Seat 1: color_singleton (small blind) collected (945)
Seat 2: manon327 (big blind) folded before Flop
Seat 3: JeBoyDirk folded on the Flop
Seat 7: Klemtonius folded on the Flop
Seat 9: dhduncan (button) folded before Flop (didn't bet)



PokerStars Home Game Hand #223931143069: {DaPokaStars}  Hold'em No Limit (50/100) - 2021/02/17 17:44:47 ET
Table 'tonight again' 9-max (Play Money) Seat #1 is the button
Seat 1: color_singleton (21773 in chips) 
Seat 2: manon327 (4575 in chips) 
Seat 3: JeBoyDirk (8460 in chips) 
Seat 7: Klemtonius (22709 in chips) 
Seat 9: dhduncan (10849 in chips) 
manon327: posts small blind 50
JeBoyDirk: posts big blind 100
*** HOLE CARDS ***
Dealt to dhduncan [Ks Qc]
Klemtonius: folds 
dhduncan: calls 100
color_singleton: calls 100
manon327: calls 50
JeBoyDirk: checks 
*** FLOP *** [4h 7s Jh]
manon327: checks 
JeBoyDirk: checks 
dhduncan: checks 
color_singleton: checks 
*** TURN *** [4h 7s Jh] [Qs]
manon327: checks 
JeBoyDirk: bets 200
dhduncan: calls 200
color_singleton: calls 200
manon327: folds 
*** RIVER *** [4h 7s Jh Qs] [3c]
JeBoyDirk: bets 472
dhduncan: calls 472
color_singleton: folds 
*** SHOW DOWN ***
JeBoyDirk: shows [9h Qh] (a pair of Queens)
dhduncan: shows [Ks Qc] (a pair of Queens - King kicker)
dhduncan collected 1837 from pot
*** SUMMARY ***
Total pot 1944 | Rake 107 
Board [4h 7s Jh Qs 3c]
Seat 1: color_singleton (button) folded on the River
Seat 2: manon327 (small blind) folded on the Turn
Seat 3: JeBoyDirk (big blind) showed [9h Qh] and lost with a pair of Queens
Seat 7: Klemtonius folded before Flop (didn't bet)
Seat 9: dhduncan showed [Ks Qc] and won (1837) with a pair of Queens



PokerStars Home Game Hand #223931166862: {DaPokaStars}  Hold'em No Limit (50/100) - 2021/02/17 17:45:27 ET
Table 'tonight again' 9-max (Play Money) Seat #2 is the button
Seat 1: color_singleton (21473 in chips) 
Seat 2: manon327 (4475 in chips) 
Seat 3: JeBoyDirk (7688 in chips) 
Seat 7: Klemtonius (22709 in chips) 
Seat 9: dhduncan (11914 in chips) 
JeBoyDirk: posts small blind 50
Klemtonius: posts big blind 100
*** HOLE CARDS ***
Dealt to dhduncan [9d Td]
dhduncan: calls 100
color_singleton: folds 
manon327: folds 
JeBoyDirk: folds 
Klemtonius: checks 
*** FLOP *** [Ad Qh Jh]
Klemtonius: checks 
dhduncan: checks 
*** TURN *** [Ad Qh Jh] [Ah]
Klemtonius: checks 
dhduncan: checks 
*** RIVER *** [Ad Qh Jh Ah] [6s]
Klemtonius: checks 
dhduncan: checks 
*** SHOW DOWN ***
Klemtonius: shows [3s 9h] (a pair of Aces)
dhduncan: shows [9d Td] (a pair of Aces - Queen+Jack+Ten kicker)
dhduncan collected 236 from pot
*** SUMMARY ***
Total pot 250 | Rake 14 
Board [Ad Qh Jh Ah 6s]
Seat 1: color_singleton folded before Flop (didn't bet)
Seat 2: manon327 (button) folded before Flop (didn't bet)
Seat 3: JeBoyDirk (small blind) folded before Flop
Seat 7: Klemtonius (big blind) showed [3s 9h] and lost with a pair of Aces
Seat 9: dhduncan showed [9d Td] and won (236) with a pair of Aces



PokerStars Home Game Hand #223931200134: {DaPokaStars}  Hold'em No Limit (50/100) - 2021/02/17 17:46:22 ET
Table 'tonight again' 9-max (Play Money) Seat #3 is the button
Seat 1: color_singleton (21473 in chips) 
Seat 2: manon327 (4475 in chips) 
Seat 3: JeBoyDirk (7638 in chips) 
Seat 7: Klemtonius (22609 in chips) 
Seat 9: dhduncan (12050 in chips) 
Klemtonius: posts small blind 50
dhduncan: posts big blind 100
*** HOLE CARDS ***
Dealt to dhduncan [3c 5s]
color_singleton: folds 
manon327: folds 
JeBoyDirk: raises 100 to 200
Klemtonius: folds 
dhduncan: folds 
Uncalled bet (100) returned to JeBoyDirk
JeBoyDirk collected 250 from pot
*** SUMMARY ***
Total pot 250 | Rake 0 
Seat 1: color_singleton folded before Flop (didn't bet)
Seat 2: manon327 folded before Flop (didn't bet)
Seat 3: JeBoyDirk (button) collected (250)
Seat 7: Klemtonius (small blind) folded before Flop
Seat 9: dhduncan (big blind) folded before Flop



PokerStars Home Game Hand #223931211028: {DaPokaStars}  Hold'em No Limit (50/100) - 2021/02/17 17:46:41 ET
Table 'tonight again' 9-max (Play Money) Seat #7 is the button
Seat 1: color_singleton (21473 in chips) 
Seat 2: manon327 (4475 in chips) 
Seat 3: JeBoyDirk (7788 in chips) 
Seat 7: Klemtonius (22559 in chips) 
Seat 9: dhduncan (11950 in chips) 
dhduncan: posts small blind 50
color_singleton: posts big blind 100
*** HOLE CARDS ***
Dealt to dhduncan [Js 9s]
manon327: folds 
JeBoyDirk: calls 100
Klemtonius: raises 200 to 300
dhduncan: calls 250
color_singleton: folds 
JeBoyDirk: calls 200
*** FLOP *** [Kd 4h Jh]
dhduncan: checks 
JeBoyDirk: checks 
Klemtonius: checks 
*** TURN *** [Kd 4h Jh] [4c]
dhduncan: checks 
JeBoyDirk: bets 600
Klemtonius: folds 
dhduncan: folds 
Uncalled bet (600) returned to JeBoyDirk
JeBoyDirk collected 945 from pot
*** SUMMARY ***
Total pot 1000 | Rake 55 
Board [Kd 4h Jh 4c]
Seat 1: color_singleton (big blind) folded before Flop
Seat 2: manon327 folded before Flop (didn't bet)
Seat 3: JeBoyDirk collected (945)
Seat 7: Klemtonius (button) folded on the Turn
Seat 9: dhduncan (small blind) folded on the Turn



PokerStars Home Game Hand #223931241803: {DaPokaStars}  Hold'em No Limit (50/100) - 2021/02/17 17:47:29 ET
Table 'tonight again' 9-max (Play Money) Seat #9 is the button
Seat 1: color_singleton (21373 in chips) 
Seat 2: manon327 (4475 in chips) 
Seat 3: JeBoyDirk (8433 in chips) 
Seat 7: Klemtonius (22259 in chips) 
Seat 9: dhduncan (11650 in chips) 
color_singleton: posts small blind 50
manon327: posts big blind 100
*** HOLE CARDS ***
Dealt to dhduncan [Kc 2s]
JeBoyDirk: folds 
Klemtonius: calls 100
dhduncan: calls 100
color_singleton: calls 50
manon327: checks 
*** FLOP *** [8c 3h 8s]
color_singleton: checks 
manon327: bets 189
Klemtonius: folds 
dhduncan: folds 
color_singleton: calls 189
*** TURN *** [8c 3h 8s] [5d]
color_singleton: checks 
manon327: bets 367
color_singleton: folds 
Uncalled bet (367) returned to manon327
manon327 collected 735 from pot
*** SUMMARY ***
Total pot 778 | Rake 43 
Board [8c 3h 8s 5d]
Seat 1: color_singleton (small blind) folded on the Turn
Seat 2: manon327 (big blind) collected (735)
Seat 3: JeBoyDirk folded before Flop (didn't bet)
Seat 7: Klemtonius folded on the Flop
Seat 9: dhduncan (button) folded on the Flop



PokerStars Home Game Hand #223931264803: {DaPokaStars}  Hold'em No Limit (50/100) - 2021/02/17 17:48:08 ET
Table 'tonight again' 9-max (Play Money) Seat #1 is the button
Seat 1: color_singleton (21084 in chips) 
Seat 2: manon327 (4921 in chips) 
Seat 3: JeBoyDirk (8433 in chips) 
Seat 7: Klemtonius (22159 in chips) 
Seat 9: dhduncan (11550 in chips) 
manon327: posts small blind 50
JeBoyDirk: posts big blind 100
*** HOLE CARDS ***
Dealt to dhduncan [5h 4s]
Klemtonius: calls 100
dhduncan: folds 
color_singleton: folds 
manon327: raises 100 to 200
JeBoyDirk: folds 
Klemtonius: calls 100
*** FLOP *** [9c 7c 3d]
manon327: checks 
Klemtonius: checks 
*** TURN *** [9c 7c 3d] [Kh]
manon327: checks 
Klemtonius: bets 100
manon327: calls 100
*** RIVER *** [9c 7c 3d Kh] [5c]
manon327: checks 
Klemtonius: bets 661
manon327: calls 661
*** SHOW DOWN ***
Klemtonius: shows [Kd 4c] (a pair of Kings)
manon327: mucks hand 
Klemtonius collected 1911 from pot
*** SUMMARY ***
Total pot 2022 | Rake 111 
Board [9c 7c 3d Kh 5c]
Seat 1: color_singleton (button) folded before Flop (didn't bet)
Seat 2: manon327 (small blind) mucked [Qh Qd]
Seat 3: JeBoyDirk (big blind) folded before Flop
Seat 7: Klemtonius showed [Kd 4c] and won (1911) with a pair of Kings
Seat 9: dhduncan folded before Flop (didn't bet)



PokerStars Home Game Hand #223931287846: {DaPokaStars}  Hold'em No Limit (50/100) - 2021/02/17 17:48:47 ET
Table 'tonight again' 9-max (Play Money) Seat #2 is the button
Seat 1: color_singleton (21084 in chips) 
Seat 2: manon327 (3960 in chips) 
Seat 3: JeBoyDirk (8333 in chips) 
Seat 7: Klemtonius (23109 in chips) 
Seat 9: dhduncan (11550 in chips) 
JeBoyDirk: posts small blind 50
Klemtonius: posts big blind 100
*** HOLE CARDS ***
Dealt to dhduncan [Ks Js]
dhduncan: calls 100
color_singleton: folds 
manon327: folds 
JeBoyDirk: raises 300 to 400
Klemtonius: folds 
dhduncan: calls 300
*** FLOP *** [Qc 9d 6d]
JeBoyDirk: bets 500
dhduncan: folds 
Uncalled bet (500) returned to JeBoyDirk
JeBoyDirk collected 850 from pot
*** SUMMARY ***
Total pot 900 | Rake 50 
Board [Qc 9d 6d]
Seat 1: color_singleton folded before Flop (didn't bet)
Seat 2: manon327 (button) folded before Flop (didn't bet)
Seat 3: JeBoyDirk (small blind) collected (850)
Seat 7: Klemtonius (big blind) folded before Flop
Seat 9: dhduncan folded on the Flop



PokerStars Home Game Hand #223931302131: {DaPokaStars}  Hold'em No Limit (50/100) - 2021/02/17 17:49:11 ET
Table 'tonight again' 9-max (Play Money) Seat #3 is the button
Seat 1: color_singleton (21084 in chips) 
Seat 2: manon327 (3960 in chips) 
Seat 3: JeBoyDirk (8783 in chips) 
Seat 7: Klemtonius (23009 in chips) 
Seat 9: dhduncan (11150 in chips) 
Klemtonius: posts small blind 50
dhduncan: posts big blind 100
*** HOLE CARDS ***
Dealt to dhduncan [2h 7s]
color_singleton: raises 200 to 300
manon327: folds 
JeBoyDirk: folds 
Klemtonius: raises 200 to 500
dhduncan: folds 
color_singleton: calls 200
*** FLOP *** [3d 5h 9d]
Klemtonius: bets 519
color_singleton: raises 519 to 1038
Klemtonius: raises 21471 to 22509 and is all-in
color_singleton has timed out
color_singleton: folds 
Uncalled bet (21471) returned to Klemtonius
Klemtonius collected 3001 from pot
Klemtonius: doesn't show hand 
*** SUMMARY ***
Total pot 3176 | Rake 175 
Board [3d 5h 9d]
Seat 1: color_singleton folded on the Flop
Seat 2: manon327 folded before Flop (didn't bet)
Seat 3: JeBoyDirk (button) folded before Flop (didn't bet)
Seat 7: Klemtonius (small blind) collected (3001)
Seat 9: dhduncan (big blind) folded before Flop



PokerStars Home Game Hand #223931342950: {DaPokaStars}  Hold'em No Limit (50/100) - 2021/02/17 17:50:20 ET
Table 'tonight again' 9-max (Play Money) Seat #7 is the button
Seat 2: manon327 (3960 in chips) 
Seat 3: JeBoyDirk (8783 in chips) 
Seat 7: Klemtonius (24472 in chips) 
Seat 9: dhduncan (11050 in chips) 
dhduncan: posts small blind 50
manon327: posts big blind 100
*** HOLE CARDS ***
Dealt to dhduncan [6h 6s]
JeBoyDirk: raises 300 to 400
Klemtonius: calls 400
dhduncan: folds 
manon327: folds 
*** FLOP *** [Jd Js 5c]
JeBoyDirk: bets 500
Klemtonius: folds 
Uncalled bet (500) returned to JeBoyDirk
JeBoyDirk collected 898 from pot
*** SUMMARY ***
Total pot 950 | Rake 52 
Board [Jd Js 5c]
Seat 2: manon327 (big blind) folded before Flop
Seat 3: JeBoyDirk collected (898)
Seat 7: Klemtonius (button) folded on the Flop
Seat 9: dhduncan (small blind) folded before Flop



PokerStars Home Game Hand #223931360954: {DaPokaStars}  Hold'em No Limit (50/100) - 2021/02/17 17:50:52 ET
Table 'tonight again' 9-max (Play Money) Seat #9 is the button
Seat 2: manon327 (3860 in chips) 
Seat 3: JeBoyDirk (9281 in chips) 
Seat 7: Klemtonius (24072 in chips) 
Seat 9: dhduncan (11000 in chips) 
manon327: posts small blind 50
JeBoyDirk: posts big blind 100
*** HOLE CARDS ***
Dealt to dhduncan [Ah 8h]
Klemtonius: folds 
dhduncan: calls 100
manon327: calls 50
JeBoyDirk: checks 
*** FLOP *** [5s 2d 3d]
manon327: checks 
JeBoyDirk: checks 
dhduncan: checks 
*** TURN *** [5s 2d 3d] [9d]
manon327: checks 
JeBoyDirk: checks 
dhduncan: checks 
*** RIVER *** [5s 2d 3d 9d] [8s]
manon327: bets 100
JeBoyDirk: folds 
dhduncan: calls 100
*** SHOW DOWN ***
manon327: shows [Jc 8c] (a pair of Eights)
dhduncan: shows [Ah 8h] (a pair of Eights - Ace kicker)
dhduncan collected 472 from pot
*** SUMMARY ***
Total pot 500 | Rake 28 
Board [5s 2d 3d 9d 8s]
Seat 2: manon327 (small blind) showed [Jc 8c] and lost with a pair of Eights
Seat 3: JeBoyDirk (big blind) folded on the River
Seat 7: Klemtonius folded before Flop (didn't bet)
Seat 9: dhduncan (button) showed [Ah 8h] and won (472) with a pair of Eights



PokerStars Home Game Hand #223931377903: {DaPokaStars}  Hold'em No Limit (50/100) - 2021/02/17 17:51:21 ET
Table 'tonight again' 9-max (Play Money) Seat #2 is the button
Seat 1: color_singleton (19546 in chips) 
Seat 2: manon327 (3660 in chips) 
Seat 3: JeBoyDirk (9181 in chips) 
Seat 7: Klemtonius (24072 in chips) 
Seat 9: dhduncan (11272 in chips) 
JeBoyDirk: posts small blind 50
Klemtonius: posts big blind 100
color_singleton: posts small & big blinds 150
*** HOLE CARDS ***
Dealt to dhduncan [7s 3c]
dhduncan: folds 
color_singleton: raises 200 to 300
manon327: calls 300
JeBoyDirk: calls 250
Klemtonius: folds 
*** FLOP *** [Js 2d Ah]
JeBoyDirk: checks 
color_singleton: bets 496
manon327: calls 496
JeBoyDirk: folds 
*** TURN *** [Js 2d Ah] [4c]
color_singleton: checks 
manon327: checks 
*** RIVER *** [Js 2d Ah 4c] [Kc]
color_singleton: checks 
manon327: checks 
*** SHOW DOWN ***
color_singleton: shows [6d Kh] (a pair of Kings)
manon327: mucks hand 
color_singleton collected 1930 from pot
*** SUMMARY ***
Total pot 2042 | Rake 112 
Board [Js 2d Ah 4c Kc]
Seat 1: color_singleton showed [6d Kh] and won (1930) with a pair of Kings
Seat 2: manon327 (button) mucked [7c 7d]
Seat 3: JeBoyDirk (small blind) folded on the Flop
Seat 7: Klemtonius (big blind) folded before Flop
Seat 9: dhduncan folded before Flop (didn't bet)



PokerStars Home Game Hand #223931404821: {DaPokaStars}  Hold'em No Limit (50/100) - 2021/02/17 17:52:08 ET
Table 'tonight again' 9-max (Play Money) Seat #3 is the button
Seat 1: color_singleton (20630 in chips) 
Seat 2: manon327 (2864 in chips) 
Seat 3: JeBoyDirk (8881 in chips) 
Seat 7: Klemtonius (23972 in chips) 
Seat 9: dhduncan (11272 in chips) 
Klemtonius: posts small blind 50
dhduncan: posts big blind 100
*** HOLE CARDS ***
Dealt to dhduncan [Kh Jh]
color_singleton: folds 
manon327: folds 
JeBoyDirk: folds 
Klemtonius: calls 50
dhduncan: checks 
*** FLOP *** [Tc Th Js]
Klemtonius: checks 
dhduncan: bets 189
Klemtonius: folds 
Uncalled bet (189) returned to dhduncan
dhduncan collected 189 from pot
dhduncan: doesn't show hand 
*** SUMMARY ***
Total pot 200 | Rake 11 
Board [Tc Th Js]
Seat 1: color_singleton folded before Flop (didn't bet)
Seat 2: manon327 folded before Flop (didn't bet)
Seat 3: JeBoyDirk (button) folded before Flop (didn't bet)
Seat 7: Klemtonius (small blind) folded on the Flop
Seat 9: dhduncan (big blind) collected (189)



PokerStars Home Game Hand #223931422427: {DaPokaStars}  Hold'em No Limit (50/100) - 2021/02/17 17:52:38 ET
Table 'tonight again' 9-max (Play Money) Seat #7 is the button
Seat 1: color_singleton (20630 in chips) 
Seat 2: manon327 (2864 in chips) 
Seat 3: JeBoyDirk (8881 in chips) 
Seat 7: Klemtonius (23872 in chips) 
Seat 9: dhduncan (11361 in chips) 
dhduncan: posts small blind 50
color_singleton: posts big blind 100
*** HOLE CARDS ***
Dealt to dhduncan [Qc 2d]
manon327: calls 100
JeBoyDirk: folds 
Klemtonius: calls 100
dhduncan: folds 
color_singleton: raises 200 to 300
manon327: folds 
Klemtonius: folds 
Uncalled bet (200) returned to color_singleton
color_singleton collected 350 from pot
color_singleton: doesn't show hand 
*** SUMMARY ***
Total pot 350 | Rake 0 
Seat 1: color_singleton (big blind) collected (350)
Seat 2: manon327 folded before Flop
Seat 3: JeBoyDirk folded before Flop (didn't bet)
Seat 7: Klemtonius (button) folded before Flop
Seat 9: dhduncan (small blind) folded before Flop



PokerStars Home Game Hand #223931437424: {DaPokaStars}  Hold'em No Limit (50/100) - 2021/02/17 17:53:04 ET
Table 'tonight again' 9-max (Play Money) Seat #9 is the button
Seat 1: color_singleton (20880 in chips) 
Seat 2: manon327 (2764 in chips) 
Seat 3: JeBoyDirk (8881 in chips) 
Seat 7: Klemtonius (23772 in chips) 
Seat 9: dhduncan (11311 in chips) 
color_singleton: posts small blind 50
manon327: posts big blind 100
*** HOLE CARDS ***
Dealt to dhduncan [4c 8d]
JeBoyDirk: folds 
Klemtonius: calls 100
dhduncan: folds 
color_singleton: calls 50
manon327: checks 
*** FLOP *** [2d Kd 4d]
color_singleton: checks 
manon327: checks 
Klemtonius: checks 
*** TURN *** [2d Kd 4d] [6c]
color_singleton: checks 
manon327: checks 
Klemtonius: checks 
*** RIVER *** [2d Kd 4d 6c] [6h]
color_singleton: checks 
manon327: checks 
Klemtonius: bets 141
color_singleton: folds 
manon327: calls 141
*** SHOW DOWN ***
Klemtonius: shows [2h 5h] (two pair, Sixes and Deuces)
manon327: mucks hand 
Klemtonius collected 550 from pot
*** SUMMARY ***
Total pot 582 | Rake 32 
Board [2d Kd 4d 6c 6h]
Seat 1: color_singleton (small blind) folded on the River
Seat 2: manon327 (big blind) mucked [As Th]
Seat 3: JeBoyDirk folded before Flop (didn't bet)
Seat 7: Klemtonius showed [2h 5h] and won (550) with two pair, Sixes and Deuces
Seat 9: dhduncan (button) folded before Flop (didn't bet)



PokerStars Home Game Hand #223931462876: {DaPokaStars}  Hold'em No Limit (50/100) - 2021/02/17 17:53:41 ET
Table 'tonight again' 9-max (Play Money) Seat #1 is the button
Seat 1: color_singleton (20780 in chips) 
Seat 2: manon327 (2523 in chips) 
Seat 3: JeBoyDirk (8881 in chips) 
Seat 7: Klemtonius (24081 in chips) 
Seat 9: dhduncan (11311 in chips) 
manon327: posts small blind 50
JeBoyDirk: posts big blind 100
*** HOLE CARDS ***
Dealt to dhduncan [3d As]
Klemtonius: raises 250 to 350
dhduncan: folds 
color_singleton: folds 
manon327: calls 300
JeBoyDirk: calls 250
*** FLOP *** [6c 3c Qd]
manon327: checks 
JeBoyDirk: checks 
Klemtonius: checks 
*** TURN *** [6c 3c Qd] [6h]
manon327: checks 
JeBoyDirk: checks 
Klemtonius: bets 496
manon327: folds 
JeBoyDirk: folds 
Uncalled bet (496) returned to Klemtonius
Klemtonius collected 992 from pot
Klemtonius: doesn't show hand 
*** SUMMARY ***
Total pot 1050 | Rake 58 
Board [6c 3c Qd 6h]
Seat 1: color_singleton (button) folded before Flop (didn't bet)
Seat 2: manon327 (small blind) folded on the Turn
Seat 3: JeBoyDirk (big blind) folded on the Turn
Seat 7: Klemtonius collected (992)
Seat 9: dhduncan folded before Flop (didn't bet)



PokerStars Home Game Hand #223931480228: {DaPokaStars}  Hold'em No Limit (50/100) - 2021/02/17 17:54:12 ET
Table 'tonight again' 9-max (Play Money) Seat #2 is the button
Seat 1: color_singleton (20780 in chips) 
Seat 2: manon327 (2173 in chips) 
Seat 3: JeBoyDirk (8531 in chips) 
Seat 7: Klemtonius (24723 in chips) 
Seat 9: dhduncan (11311 in chips) 
JeBoyDirk: posts small blind 50
Klemtonius: posts big blind 100
*** HOLE CARDS ***
Dealt to dhduncan [6c 3c]
dhduncan: folds 
color_singleton: folds 
manon327: calls 100
JeBoyDirk: calls 50
Klemtonius: checks 
*** FLOP *** [6h Ad Jc]
JeBoyDirk: bets 100
Klemtonius: folds 
manon327: calls 100
*** TURN *** [6h Ad Jc] [As]
JeBoyDirk: checks 
manon327: bets 100
JeBoyDirk: calls 100
*** RIVER *** [6h Ad Jc As] [7c]
JeBoyDirk: bets 400
manon327: folds 
Uncalled bet (400) returned to JeBoyDirk
JeBoyDirk collected 661 from pot
*** SUMMARY ***
Total pot 700 | Rake 39 
Board [6h Ad Jc As 7c]
Seat 1: color_singleton folded before Flop (didn't bet)
Seat 2: manon327 (button) folded on the River
Seat 3: JeBoyDirk (small blind) collected (661)
Seat 7: Klemtonius (big blind) folded on the Flop
Seat 9: dhduncan folded before Flop (didn't bet)



PokerStars Home Game Hand #223931509799: {DaPokaStars}  Hold'em No Limit (50/100) - 2021/02/17 17:55:04 ET
Table 'tonight again' 9-max (Play Money) Seat #3 is the button
Seat 1: color_singleton (20780 in chips) 
Seat 2: manon327 (1873 in chips) 
Seat 3: JeBoyDirk (8892 in chips) 
Seat 7: Klemtonius (24623 in chips) 
Seat 9: dhduncan (11311 in chips) 
Klemtonius: posts small blind 50
dhduncan: posts big blind 100
*** HOLE CARDS ***
Dealt to dhduncan [Ts Qs]
color_singleton: folds 
manon327: calls 100
JeBoyDirk: calls 100
Klemtonius: calls 50
dhduncan: checks 
*** FLOP *** [Qd Ah 2h]
Klemtonius: checks 
dhduncan: checks 
manon327: bets 100
JeBoyDirk: calls 100
Klemtonius: folds 
dhduncan: calls 100
*** TURN *** [Qd Ah 2h] [7s]
dhduncan: checks 
manon327: bets 100
JeBoyDirk: calls 100
dhduncan: calls 100
*** RIVER *** [Qd Ah 2h 7s] [Jh]
dhduncan: checks 
manon327: checks 
JeBoyDirk: bets 500
dhduncan: folds 
manon327: calls 500
*** SHOW DOWN ***
JeBoyDirk: shows [5h 9h] (a flush, Ace high)
manon327: mucks hand 
JeBoyDirk collected 1890 from pot
*** SUMMARY ***
Total pot 2000 | Rake 110 
Board [Qd Ah 2h 7s Jh]
Seat 1: color_singleton folded before Flop (didn't bet)
Seat 2: manon327 mucked [Qh 9d]
Seat 3: JeBoyDirk (button) showed [5h 9h] and won (1890) with a flush, Ace high
Seat 7: Klemtonius (small blind) folded on the Flop
Seat 9: dhduncan (big blind) folded on the River



PokerStars Home Game Hand #223931537876: {DaPokaStars}  Hold'em No Limit (50/100) - 2021/02/17 17:56:04 ET
Table 'tonight again' 9-max (Play Money) Seat #7 is the button
Seat 1: color_singleton (20780 in chips) 
Seat 2: manon327 (1073 in chips) 
Seat 3: JeBoyDirk (9982 in chips) 
Seat 7: Klemtonius (24523 in chips) 
Seat 9: dhduncan (11011 in chips) 
dhduncan: posts small blind 50
color_singleton: posts big blind 100
*** HOLE CARDS ***
Dealt to dhduncan [3h Kc]
manon327: calls 100
JeBoyDirk: calls 100
Klemtonius: raises 450 to 550
dhduncan: folds 
color_singleton: folds 
manon327: folds 
JeBoyDirk: calls 450
*** FLOP *** [4s Jd Ad]
JeBoyDirk: checks 
Klemtonius: checks 
*** TURN *** [4s Jd Ad] [9s]
JeBoyDirk: checks 
Klemtonius: bets 1276
JeBoyDirk: folds 
Uncalled bet (1276) returned to Klemtonius
Klemtonius collected 1276 from pot
Klemtonius: doesn't show hand 
*** SUMMARY ***
Total pot 1350 | Rake 74 
Board [4s Jd Ad 9s]
Seat 1: color_singleton (big blind) folded before Flop
Seat 2: manon327 folded before Flop
Seat 3: JeBoyDirk folded on the Turn
Seat 7: Klemtonius (button) collected (1276)
Seat 9: dhduncan (small blind) folded before Flop



PokerStars Home Game Hand #223931554184: {DaPokaStars}  Hold'em No Limit (50/100) - 2021/02/17 17:56:40 ET
Table 'tonight again' 9-max (Play Money) Seat #9 is the button
Seat 1: color_singleton (20680 in chips) 
Seat 2: manon327 (973 in chips) 
Seat 3: JeBoyDirk (9432 in chips) 
Seat 7: Klemtonius (25249 in chips) 
Seat 9: dhduncan (10961 in chips) 
color_singleton: posts small blind 50
manon327: posts big blind 100
*** HOLE CARDS ***
Dealt to dhduncan [Td Jh]
JeBoyDirk: raises 400 to 500
Klemtonius: calls 500
dhduncan: calls 500
color_singleton: folds 
manon327: raises 400 to 900
JeBoyDirk: raises 1100 to 2000
Klemtonius: calls 1500
dhduncan: folds 
manon327: calls 73 and is all-in
*** FLOP *** [Js Kd 9c]
JeBoyDirk: checks 
Klemtonius: bets 9300
JeBoyDirk: calls 7432 and is all-in
Uncalled bet (1868) returned to Klemtonius
*** TURN *** [Js Kd 9c] [3h]
*** RIVER *** [Js Kd 9c 3h] [4s]
*** SHOW DOWN ***
JeBoyDirk: shows [Ks Kc] (three of a kind, Kings)
Klemtonius: shows [Qc Tc] (a straight, Nine to King)
Klemtonius collected 15988 from side pot
manon327: shows [7h Kh] (a pair of Kings)
Klemtonius collected 3278 from main pot
*** SUMMARY ***
Total pot 20387 Main pot 3278. Side pot 15988. | Rake 1121 
Board [Js Kd 9c 3h 4s]
Seat 1: color_singleton (small blind) folded before Flop
Seat 2: manon327 (big blind) showed [7h Kh] and lost with a pair of Kings
Seat 3: JeBoyDirk showed [Ks Kc] and lost with three of a kind, Kings
Seat 7: Klemtonius showed [Qc Tc] and won (19266) with a straight, Nine to King
Seat 9: dhduncan (button) folded before Flop



PokerStars Home Game Hand #223931581130: {DaPokaStars}  Hold'em No Limit (50/100) - 2021/02/17 17:57:41 ET
Table 'tonight again' 9-max (Play Money) Seat #1 is the button
Seat 1: color_singleton (20630 in chips) 
Seat 7: Klemtonius (35083 in chips) 
Seat 9: dhduncan (10461 in chips) 
Klemtonius: posts small blind 50
dhduncan: posts big blind 100
*** HOLE CARDS ***
Dealt to dhduncan [2c 2d]
color_singleton: folds 
Klemtonius: raises 100 to 200
dhduncan: folds 
Uncalled bet (100) returned to Klemtonius
Klemtonius collected 200 from pot
Klemtonius: doesn't show hand 
*** SUMMARY ***
Total pot 200 | Rake 0 
Seat 1: color_singleton (button) folded before Flop (didn't bet)
Seat 7: Klemtonius (small blind) collected (200)
Seat 9: dhduncan (big blind) folded before Flop



PokerStars Home Game Hand #223931589185: {DaPokaStars}  Hold'em No Limit (50/100) - 2021/02/17 17:57:59 ET
Table 'tonight again' 9-max (Play Money) Seat #7 is the button
Seat 1: color_singleton (20630 in chips) 
Seat 7: Klemtonius (35183 in chips) 
Seat 9: dhduncan (10361 in chips) 
dhduncan: posts small blind 50
color_singleton: posts big blind 100
*** HOLE CARDS ***
Dealt to dhduncan [Kd 7s]
JeBoyDirk leaves the table
Klemtonius: raises 100 to 200
dhduncan: folds 
color_singleton: calls 100
*** FLOP *** [4s 6c 7c]
color_singleton: bets 212
Klemtonius: folds 
Uncalled bet (212) returned to color_singleton
color_singleton collected 425 from pot
color_singleton: doesn't show hand 
*** SUMMARY ***
Total pot 450 | Rake 25 
Board [4s 6c 7c]
Seat 1: color_singleton (big blind) collected (425)
Seat 7: Klemtonius (button) folded on the Flop
Seat 9: dhduncan (small blind) folded before Flop



PokerStars Home Game Hand #223931606448: {DaPokaStars}  Hold'em No Limit (50/100) - 2021/02/17 17:58:38 ET
Table 'tonight again' 9-max (Play Money) Seat #9 is the button
Seat 1: color_singleton (20855 in chips) 
Seat 7: Klemtonius (34983 in chips) 
Seat 9: dhduncan (10311 in chips) 
color_singleton: posts small blind 50
Klemtonius: posts big blind 100
*** HOLE CARDS ***
Dealt to dhduncan [8c 9d]
dhduncan: folds 
color_singleton: calls 50
Klemtonius: checks 
*** FLOP *** [5d 7d 5s]
color_singleton: bets 189
Klemtonius: folds 
Uncalled bet (189) returned to color_singleton
color_singleton collected 189 from pot
color_singleton: doesn't show hand 
*** SUMMARY ***
Total pot 200 | Rake 11 
Board [5d 7d 5s]
Seat 1: color_singleton (small blind) collected (189)
Seat 7: Klemtonius (big blind) folded on the Flop
Seat 9: dhduncan (button) folded before Flop (didn't bet)



PokerStars Home Game Hand #223931614783: {DaPokaStars}  Hold'em No Limit (50/100) - 2021/02/17 17:58:57 ET
Table 'tonight again' 9-max (Play Money) Seat #1 is the button
Seat 1: color_singleton (20944 in chips) 
Seat 7: Klemtonius (34883 in chips) 
Seat 9: dhduncan (10311 in chips) 
Klemtonius: posts small blind 50
dhduncan: posts big blind 100
*** HOLE CARDS ***
Dealt to dhduncan [8d 9h]
color_singleton: folds 
Klemtonius: calls 50
dhduncan: checks 
*** FLOP *** [8s Jh Kc]
Klemtonius: checks 
dhduncan: checks 
*** TURN *** [8s Jh Kc] [Ts]
Klemtonius: bets 100
dhduncan: calls 100
*** RIVER *** [8s Jh Kc Ts] [Qc]
Klemtonius: bets 378
dhduncan: raises 378 to 756
Klemtonius: folds 
Uncalled bet (378) returned to dhduncan
dhduncan collected 1092 from pot
dhduncan: doesn't show hand 
*** SUMMARY ***
Total pot 1156 | Rake 64 
Board [8s Jh Kc Ts Qc]
Seat 1: color_singleton (button) folded before Flop (didn't bet)
Seat 7: Klemtonius (small blind) folded on the River
Seat 9: dhduncan (big blind) collected (1092)



PokerStars Home Game Hand #223931641440: {DaPokaStars}  Hold'em No Limit (50/100) - 2021/02/17 17:59:57 ET
Table 'tonight again' 9-max (Play Money) Seat #7 is the button
Seat 1: color_singleton (20944 in chips) 
Seat 7: Klemtonius (34305 in chips) 
Seat 9: dhduncan (10825 in chips) 
dhduncan: posts small blind 50
color_singleton: posts big blind 100
*** HOLE CARDS ***
Dealt to dhduncan [Kh Js]
Klemtonius: raises 100 to 200
dhduncan: calls 150
color_singleton: calls 100
*** FLOP *** [Kc 9s Kd]
dhduncan: bets 100
color_singleton: folds 
Klemtonius: folds 
Uncalled bet (100) returned to dhduncan
dhduncan collected 567 from pot
dhduncan: doesn't show hand 
*** SUMMARY ***
Total pot 600 | Rake 33 
Board [Kc 9s Kd]
Seat 1: color_singleton (big blind) folded on the Flop
Seat 7: Klemtonius (button) folded on the Flop
Seat 9: dhduncan (small blind) collected (567)



PokerStars Home Game Hand #223931658065: {DaPokaStars}  Hold'em No Limit (50/100) - 2021/02/17 18:00:33 ET
Table 'tonight again' 9-max (Play Money) Seat #9 is the button
Seat 1: color_singleton (20744 in chips) 
Seat 2: manon327 (10000 in chips) 
Seat 7: Klemtonius (34105 in chips) 
Seat 9: dhduncan (11192 in chips) 
color_singleton: posts small blind 50
manon327: posts big blind 100
*** HOLE CARDS ***
Dealt to dhduncan [7s 9s]
Klemtonius: raises 250 to 350
dhduncan: folds 
color_singleton: folds 
manon327: folds 
Uncalled bet (250) returned to Klemtonius
Klemtonius collected 250 from pot
Klemtonius: doesn't show hand 
*** SUMMARY ***
Total pot 250 | Rake 0 
Seat 1: color_singleton (small blind) folded before Flop
Seat 2: manon327 (big blind) folded before Flop
Seat 7: Klemtonius collected (250)
Seat 9: dhduncan (button) folded before Flop (didn't bet)



PokerStars Home Game Hand #223931663559: {DaPokaStars}  Hold'em No Limit (50/100) - 2021/02/17 18:00:45 ET
Table 'tonight again' 9-max (Play Money) Seat #1 is the button
Seat 1: color_singleton (20694 in chips) 
Seat 2: manon327 (9900 in chips) 
Seat 7: Klemtonius (34255 in chips) 
Seat 9: dhduncan (11192 in chips) 
manon327: posts small blind 50
Klemtonius: posts big blind 100
*** HOLE CARDS ***
Dealt to dhduncan [3h Ad]
dhduncan: calls 100
color_singleton: raises 200 to 300
manon327: folds 
Klemtonius: calls 200
dhduncan: calls 200
*** FLOP *** [8c 8h 4d]
Klemtonius: checks 
dhduncan: checks 
color_singleton: checks 
*** TURN *** [8c 8h 4d] [3c]
Klemtonius: checks 
dhduncan: checks 
color_singleton: checks 
*** RIVER *** [8c 8h 4d 3c] [7h]
Klemtonius: checks 
dhduncan: checks 
color_singleton: checks 
*** SHOW DOWN ***
Klemtonius: shows [9d Jh] (a pair of Eights)
dhduncan: shows [3h Ad] (two pair, Eights and Threes)
color_singleton: shows [Ac 7s] (two pair, Eights and Sevens)
color_singleton collected 898 from pot
*** SUMMARY ***
Total pot 950 | Rake 52 
Board [8c 8h 4d 3c 7h]
Seat 1: color_singleton (button) showed [Ac 7s] and won (898) with two pair, Eights and Sevens
Seat 2: manon327 (small blind) folded before Flop
Seat 7: Klemtonius (big blind) showed [9d Jh] and lost with a pair of Eights
Seat 9: dhduncan showed [3h Ad] and lost with two pair, Eights and Threes



PokerStars Home Game Hand #223931709290: {DaPokaStars}  Hold'em No Limit (50/100) - 2021/02/17 18:01:39 ET
Table 'tonight again' 9-max (Play Money) Seat #2 is the button
Seat 1: color_singleton (21292 in chips) 
Seat 2: manon327 (9850 in chips) 
Seat 7: Klemtonius (33955 in chips) 
Seat 9: dhduncan (10892 in chips) 
Klemtonius: posts small blind 50
dhduncan: posts big blind 100
*** HOLE CARDS ***
Dealt to dhduncan [7h Js]
color_singleton: folds 
manon327: calls 100
Klemtonius: folds 
dhduncan: checks 
*** FLOP *** [3c Qs 2s]
dhduncan: checks 
manon327: checks 
*** TURN *** [3c Qs 2s] [4c]
dhduncan: checks 
manon327: checks 
*** RIVER *** [3c Qs 2s 4c] [2h]
dhduncan: checks 
manon327: checks 
*** SHOW DOWN ***
dhduncan: shows [7h Js] (a pair of Deuces)
manon327: shows [Ad 6h] (a pair of Deuces - Ace kicker)
manon327 collected 236 from pot
*** SUMMARY ***
Total pot 250 | Rake 14 
Board [3c Qs 2s 4c 2h]
Seat 1: color_singleton folded before Flop (didn't bet)
Seat 2: manon327 (button) showed [Ad 6h] and won (236) with a pair of Deuces
Seat 7: Klemtonius (small blind) folded before Flop
Seat 9: dhduncan (big blind) showed [7h Js] and lost with a pair of Deuces



PokerStars Home Game Hand #223931727869: {DaPokaStars}  Hold'em No Limit (50/100) - 2021/02/17 18:02:14 ET
Table 'tonight again' 9-max (Play Money) Seat #7 is the button
Seat 1: color_singleton (21292 in chips) 
Seat 2: manon327 (9986 in chips) 
Seat 7: Klemtonius (33905 in chips) 
Seat 9: dhduncan (10792 in chips) 
dhduncan: posts small blind 50
color_singleton: posts big blind 100
*** HOLE CARDS ***
Dealt to dhduncan [Ac 3d]
manon327: calls 100
Klemtonius: calls 100
dhduncan: calls 50
color_singleton: checks 
*** FLOP *** [Jc 3h Jd]
dhduncan: checks 
color_singleton: bets 189
manon327: calls 189
Klemtonius: folds 
dhduncan: folds 
*** TURN *** [Jc 3h Jd] [7s]
color_singleton: bets 367
manon327: folds 
Uncalled bet (367) returned to color_singleton
color_singleton collected 735 from pot
color_singleton: doesn't show hand 
*** SUMMARY ***
Total pot 778 | Rake 43 
Board [Jc 3h Jd 7s]
Seat 1: color_singleton (big blind) collected (735)
Seat 2: manon327 folded on the Turn
Seat 7: Klemtonius (button) folded on the Flop
Seat 9: dhduncan (small blind) folded on the Flop



PokerStars Home Game Hand #223931757716: {DaPokaStars}  Hold'em No Limit (50/100) - 2021/02/17 18:03:09 ET
Table 'tonight again' 9-max (Play Money) Seat #9 is the button
Seat 1: color_singleton (21738 in chips) 
Seat 2: manon327 (9697 in chips) 
Seat 7: Klemtonius (33805 in chips) 
Seat 9: dhduncan (10692 in chips) 
color_singleton: posts small blind 50
manon327: posts big blind 100
*** HOLE CARDS ***
Dealt to dhduncan [4h Jh]
Klemtonius: raises 100 to 200
dhduncan: calls 200
color_singleton: calls 150
manon327: calls 100
*** FLOP *** [Qc 5s 6d]
color_singleton: checks 
manon327: bets 100
Klemtonius: folds 
dhduncan: folds 
color_singleton: calls 100
*** TURN *** [Qc 5s 6d] [Ad]
color_singleton: checks 
manon327: bets 100
color_singleton: raises 300 to 400
manon327: calls 300
*** RIVER *** [Qc 5s 6d Ad] [9d]
color_singleton: checks 
manon327: checks 
*** SHOW DOWN ***
color_singleton: shows [Ah 5h] (two pair, Aces and Fives)
manon327: mucks hand 
color_singleton collected 1701 from pot
*** SUMMARY ***
Total pot 1800 | Rake 99 
Board [Qc 5s 6d Ad 9d]
Seat 1: color_singleton (small blind) showed [Ah 5h] and won (1701) with two pair, Aces and Fives
Seat 2: manon327 (big blind) mucked [Js Kd]
Seat 7: Klemtonius folded on the Flop
Seat 9: dhduncan (button) folded on the Flop



PokerStars Home Game Hand #223931786819: {DaPokaStars}  Hold'em No Limit (50/100) - 2021/02/17 18:04:02 ET
Table 'tonight again' 9-max (Play Money) Seat #1 is the button
Seat 1: color_singleton (22739 in chips) 
Seat 2: manon327 (8997 in chips) 
Seat 7: Klemtonius (33605 in chips) 
Seat 9: dhduncan (10492 in chips) 
manon327: posts small blind 50
Klemtonius: posts big blind 100
*** HOLE CARDS ***
Dealt to dhduncan [Kc 5d]
dhduncan: calls 100
color_singleton: folds 
manon327: folds 
Klemtonius: checks 
*** FLOP *** [6c Qd Jd]
Klemtonius: bets 236
dhduncan: folds 
Uncalled bet (236) returned to Klemtonius
Klemtonius collected 236 from pot
Klemtonius: doesn't show hand 
*** SUMMARY ***
Total pot 250 | Rake 14 
Board [6c Qd Jd]
Seat 1: color_singleton (button) folded before Flop (didn't bet)
Seat 2: manon327 (small blind) folded before Flop
Seat 7: Klemtonius (big blind) collected (236)
Seat 9: dhduncan folded on the Flop



PokerStars Home Game Hand #223931803201: {DaPokaStars}  Hold'em No Limit (50/100) - 2021/02/17 18:04:31 ET
Table 'tonight again' 9-max (Play Money) Seat #2 is the button
Seat 1: color_singleton (22739 in chips) 
Seat 2: manon327 (8947 in chips) 
Seat 7: Klemtonius (33741 in chips) 
Seat 9: dhduncan (10392 in chips) 
Klemtonius: posts small blind 50
dhduncan: posts big blind 100
*** HOLE CARDS ***
Dealt to dhduncan [Jc Qc]
color_singleton: folds 
manon327: calls 100
Klemtonius: calls 50
dhduncan: checks 
*** FLOP *** [Jd 8d 8h]
Klemtonius: checks 
dhduncan: checks 
manon327: checks 
*** TURN *** [Jd 8d 8h] [8c]
Klemtonius: checks 
dhduncan: bets 100
manon327: calls 100
Klemtonius: calls 100
*** RIVER *** [Jd 8d 8h 8c] [Kc]
Klemtonius: checks 
dhduncan: checks 
manon327: checks 
*** SHOW DOWN ***
Klemtonius: shows [5c Qh] (three of a kind, Eights)
dhduncan: shows [Jc Qc] (a full house, Eights full of Jacks)
manon327: mucks hand 
dhduncan collected 567 from pot
*** SUMMARY ***
Total pot 600 | Rake 33 
Board [Jd 8d 8h 8c Kc]
Seat 1: color_singleton folded before Flop (didn't bet)
Seat 2: manon327 (button) mucked [2h Ac]
Seat 7: Klemtonius (small blind) showed [5c Qh] and lost with three of a kind, Eights
Seat 9: dhduncan (big blind) showed [Jc Qc] and won (567) with a full house, Eights full of Jacks



PokerStars Home Game Hand #223931832446: {DaPokaStars}  Hold'em No Limit (50/100) - 2021/02/17 18:05:24 ET
Table 'tonight again' 9-max (Play Money) Seat #7 is the button
Seat 1: color_singleton (22739 in chips) 
Seat 2: manon327 (8747 in chips) 
Seat 7: Klemtonius (33541 in chips) 
Seat 9: dhduncan (10759 in chips) 
dhduncan: posts small blind 50
color_singleton: posts big blind 100
*** HOLE CARDS ***
Dealt to dhduncan [4c Ac]
manon327: calls 100
Klemtonius: calls 100
dhduncan: calls 50
color_singleton: checks 
*** FLOP *** [4s 2h 3d]
dhduncan: checks 
color_singleton: bets 189
manon327: folds 
Klemtonius: folds 
dhduncan: calls 189
*** TURN *** [4s 2h 3d] [2s]
dhduncan: checks 
color_singleton: bets 367
dhduncan: folds 
Uncalled bet (367) returned to color_singleton
color_singleton collected 735 from pot
color_singleton: doesn't show hand 
*** SUMMARY ***
Total pot 778 | Rake 43 
Board [4s 2h 3d 2s]
Seat 1: color_singleton (big blind) collected (735)
Seat 2: manon327 folded on the Flop
Seat 7: Klemtonius (button) folded on the Flop
Seat 9: dhduncan (small blind) folded on the Turn



PokerStars Home Game Hand #223931854066: {DaPokaStars}  Hold'em No Limit (50/100) - 2021/02/17 18:06:04 ET
Table 'tonight again' 9-max (Play Money) Seat #9 is the button
Seat 1: color_singleton (23185 in chips) 
Seat 2: manon327 (8647 in chips) 
Seat 7: Klemtonius (33441 in chips) 
Seat 9: dhduncan (10470 in chips) 
color_singleton: posts small blind 50
manon327: posts big blind 100
*** HOLE CARDS ***
Dealt to dhduncan [6c 6d]
Klemtonius: raises 100 to 200
dhduncan: folds 
color_singleton: calls 150
manon327: calls 100
*** FLOP *** [8h 5d Ah]
color_singleton: checks 
manon327: checks 
Klemtonius: checks 
*** TURN *** [8h 5d Ah] [3h]
color_singleton: checks 
manon327: checks 
Klemtonius: checks 
*** RIVER *** [8h 5d Ah 3h] [Ad]
color_singleton: checks 
manon327: checks 
Klemtonius: checks 
*** SHOW DOWN ***
color_singleton: shows [7d 9h] (a pair of Aces)
manon327: shows [3c 8s] (two pair, Aces and Eights)
Klemtonius: mucks hand 
manon327 collected 567 from pot
*** SUMMARY ***
Total pot 600 | Rake 33 
Board [8h 5d Ah 3h Ad]
Seat 1: color_singleton (small blind) showed [7d 9h] and lost with a pair of Aces
Seat 2: manon327 (big blind) showed [3c 8s] and won (567) with two pair, Aces and Eights
Seat 7: Klemtonius mucked [Kh Jc]
Seat 9: dhduncan (button) folded before Flop (didn't bet)



PokerStars Home Game Hand #223931882431: {DaPokaStars}  Hold'em No Limit (50/100) - 2021/02/17 18:06:53 ET
Table 'tonight again' 9-max (Play Money) Seat #1 is the button
Seat 1: color_singleton (22985 in chips) 
Seat 2: manon327 (9014 in chips) 
Seat 7: Klemtonius (33241 in chips) 
Seat 9: dhduncan (10470 in chips) 
manon327: posts small blind 50
Klemtonius: posts big blind 100
*** HOLE CARDS ***
Dealt to dhduncan [Td 7s]
dhduncan: folds 
color_singleton: folds 
manon327: calls 50
Klemtonius: raises 100 to 200
manon327: calls 100
*** FLOP *** [3d 5d 8c]
manon327: checks 
Klemtonius: checks 
*** TURN *** [3d 5d 8c] [2d]
manon327: checks 
Klemtonius: checks 
*** RIVER *** [3d 5d 8c 2d] [2h]
manon327: checks 
Klemtonius: checks 
*** SHOW DOWN ***
manon327: shows [5c Kd] (two pair, Fives and Deuces)
Klemtonius: mucks hand 
manon327 collected 378 from pot
*** SUMMARY ***
Total pot 400 | Rake 22 
Board [3d 5d 8c 2d 2h]
Seat 1: color_singleton (button) folded before Flop (didn't bet)
Seat 2: manon327 (small blind) showed [5c Kd] and won (378) with two pair, Fives and Deuces
Seat 7: Klemtonius (big blind) mucked [Qs 7c]
Seat 9: dhduncan folded before Flop (didn't bet)



PokerStars Home Game Hand #223931901325: {DaPokaStars}  Hold'em No Limit (50/100) - 2021/02/17 18:07:28 ET
Table 'tonight again' 9-max (Play Money) Seat #2 is the button
Seat 1: color_singleton (22985 in chips) 
Seat 2: manon327 (9192 in chips) 
Seat 7: Klemtonius (33041 in chips) 
Seat 9: dhduncan (10470 in chips) 
Klemtonius: posts small blind 50
dhduncan: posts big blind 100
*** HOLE CARDS ***
Dealt to dhduncan [Ac 2d]
color_singleton: raises 200 to 300
manon327: calls 300
Klemtonius: calls 250
dhduncan: calls 200
*** FLOP *** [4h 9c Ad]
Klemtonius: checks 
dhduncan: bets 567
color_singleton: calls 567
manon327: folds 
Klemtonius: folds 
*** TURN *** [4h 9c Ad] [7c]
dhduncan: checks 
color_singleton: checks 
*** RIVER *** [4h 9c Ad 7c] [4c]
dhduncan: checks 
color_singleton: checks 
*** SHOW DOWN ***
dhduncan: shows [Ac 2d] (two pair, Aces and Fours)
color_singleton: mucks hand 
dhduncan collected 2206 from pot
*** SUMMARY ***
Total pot 2334 | Rake 128 
Board [4h 9c Ad 7c 4c]
Seat 1: color_singleton mucked [Kc Kh]
Seat 2: manon327 (button) folded on the Flop
Seat 7: Klemtonius (small blind) folded on the Flop
Seat 9: dhduncan (big blind) showed [Ac 2d] and won (2206) with two pair, Aces and Fours



PokerStars Home Game Hand #223931918156: {DaPokaStars}  Hold'em No Limit (50/100) - 2021/02/17 18:07:59 ET
Table 'tonight again' 9-max (Play Money) Seat #7 is the button
Seat 1: color_singleton (22118 in chips) 
Seat 2: manon327 (8892 in chips) 
Seat 7: Klemtonius (32741 in chips) 
Seat 9: dhduncan (11809 in chips) 
dhduncan: posts small blind 50
color_singleton: posts big blind 100
*** HOLE CARDS ***
Dealt to dhduncan [7d Ts]
manon327: folds 
Klemtonius: calls 100
dhduncan: folds 
color_singleton: raises 200 to 300
Klemtonius: calls 200
*** FLOP *** [2s As Kc]
color_singleton: bets 307
Klemtonius: calls 307
*** TURN *** [2s As Kc] [8h]
color_singleton: checks 
Klemtonius: checks 
*** RIVER *** [2s As Kc 8h] [3d]
color_singleton: bets 1194
Klemtonius: raises 1194 to 2388
color_singleton: calls 1194
*** SHOW DOWN ***
Klemtonius: shows [Ks 8c] (two pair, Kings and Eights)
color_singleton: shows [3h 3c] (three of a kind, Threes)
color_singleton collected 5708 from pot
*** SUMMARY ***
Total pot 6040 | Rake 332 
Board [2s As Kc 8h 3d]
Seat 1: color_singleton (big blind) showed [3h 3c] and won (5708) with three of a kind, Threes
Seat 2: manon327 folded before Flop (didn't bet)
Seat 7: Klemtonius (button) showed [Ks 8c] and lost with two pair, Kings and Eights
Seat 9: dhduncan (small blind) folded before Flop



PokerStars Home Game Hand #223931945159: {DaPokaStars}  Hold'em No Limit (50/100) - 2021/02/17 18:08:49 ET
Table 'tonight again' 9-max (Play Money) Seat #9 is the button
Seat 1: color_singleton (24831 in chips) 
Seat 2: manon327 (8892 in chips) 
Seat 7: Klemtonius (29746 in chips) 
Seat 9: dhduncan (11759 in chips) 
color_singleton: posts small blind 50
manon327: posts big blind 100
*** HOLE CARDS ***
Dealt to dhduncan [Th 8s]
Klemtonius: folds 
dhduncan: folds 
color_singleton: raises 200 to 300
manon327: folds 
Uncalled bet (200) returned to color_singleton
color_singleton collected 200 from pot
color_singleton: doesn't show hand 
*** SUMMARY ***
Total pot 200 | Rake 0 
Seat 1: color_singleton (small blind) collected (200)
Seat 2: manon327 (big blind) folded before Flop
Seat 7: Klemtonius folded before Flop (didn't bet)
Seat 9: dhduncan (button) folded before Flop (didn't bet)



PokerStars Home Game Hand #223931951973: {DaPokaStars}  Hold'em No Limit (50/100) - 2021/02/17 18:09:02 ET
Table 'tonight again' 9-max (Play Money) Seat #1 is the button
Seat 1: color_singleton (24931 in chips) 
Seat 2: manon327 (8792 in chips) 
Seat 7: Klemtonius (29746 in chips) 
Seat 9: dhduncan (11759 in chips) 
manon327: posts small blind 50
Klemtonius: posts big blind 100
*** HOLE CARDS ***
Dealt to dhduncan [Kd 7d]
dhduncan: calls 100
color_singleton: raises 200 to 300
manon327: calls 250
Klemtonius: folds 
dhduncan: calls 200
*** FLOP *** [2s 8h Jd]
manon327: checks 
dhduncan: checks 
color_singleton: checks 
*** TURN *** [2s 8h Jd] [Jc]
manon327: checks 
dhduncan: checks 
color_singleton: checks 
*** RIVER *** [2s 8h Jd Jc] [Js]
manon327: bets 945
dhduncan: folds 
color_singleton: folds 
Uncalled bet (945) returned to manon327
manon327 collected 945 from pot
*** SUMMARY ***
Total pot 1000 | Rake 55 
Board [2s 8h Jd Jc Js]
Seat 1: color_singleton (button) folded on the River
Seat 2: manon327 (small blind) collected (945)
Seat 7: Klemtonius (big blind) folded before Flop
Seat 9: dhduncan folded on the River



PokerStars Home Game Hand #223931971446: {DaPokaStars}  Hold'em No Limit (50/100) - 2021/02/17 18:09:38 ET
Table 'tonight again' 9-max (Play Money) Seat #2 is the button
Seat 1: color_singleton (24631 in chips) 
Seat 2: manon327 (9437 in chips) 
Seat 7: Klemtonius (29646 in chips) 
Seat 9: dhduncan (11459 in chips) 
Klemtonius: posts small blind 50
dhduncan: posts big blind 100
*** HOLE CARDS ***
Dealt to dhduncan [Js 9s]
color_singleton: raises 200 to 300
manon327: folds 
Klemtonius: folds 
dhduncan: calls 200
*** FLOP *** [6d 8h 7d]
dhduncan: bets 100
color_singleton: raises 500 to 600
dhduncan: calls 500
*** TURN *** [6d 8h 7d] [4c]
dhduncan: checks 
color_singleton: bets 1748
dhduncan: folds 
Uncalled bet (1748) returned to color_singleton
color_singleton collected 1748 from pot
color_singleton: doesn't show hand 
*** SUMMARY ***
Total pot 1850 | Rake 102 
Board [6d 8h 7d 4c]
Seat 1: color_singleton collected (1748)
Seat 2: manon327 (button) folded before Flop (didn't bet)
Seat 7: Klemtonius (small blind) folded before Flop
Seat 9: dhduncan (big blind) folded on the Turn



PokerStars Home Game Hand #223931988813: {DaPokaStars}  Hold'em No Limit (50/100) - 2021/02/17 18:10:10 ET
Table 'tonight again' 9-max (Play Money) Seat #7 is the button
Seat 1: color_singleton (25479 in chips) 
Seat 2: manon327 (9437 in chips) 
Seat 7: Klemtonius (29596 in chips) 
Seat 9: dhduncan (10559 in chips) 
dhduncan: posts small blind 50
color_singleton: posts big blind 100
*** HOLE CARDS ***
Dealt to dhduncan [7s 6c]
manon327: folds 
Klemtonius: calls 100
dhduncan: folds 
color_singleton: checks 
*** FLOP *** [Ts 6h As]
color_singleton: checks 
Klemtonius: bets 100
color_singleton: calls 100
*** TURN *** [Ts 6h As] [Jc]
color_singleton: bets 212
Klemtonius: calls 212
*** RIVER *** [Ts 6h As Jc] [8s]
color_singleton: bets 826
Klemtonius: calls 826
*** SHOW DOWN ***
color_singleton: shows [9s Qc] (a straight, Eight to Queen)
Klemtonius: mucks hand 
color_singleton collected 2387 from pot
*** SUMMARY ***
Total pot 2526 | Rake 139 
Board [Ts 6h As Jc 8s]
Seat 1: color_singleton (big blind) showed [9s Qc] and won (2387) with a straight, Eight to Queen
Seat 2: manon327 folded before Flop (didn't bet)
Seat 7: Klemtonius (button) mucked [4d Ac]
Seat 9: dhduncan (small blind) folded before Flop



PokerStars Home Game Hand #223932027710: {DaPokaStars}  Hold'em No Limit (50/100) - 2021/02/17 18:11:08 ET
Table 'tonight again' 9-max (Play Money) Seat #9 is the button
Seat 1: color_singleton (26628 in chips) 
Seat 2: manon327 (9437 in chips) 
Seat 7: Klemtonius (28358 in chips) 
Seat 9: dhduncan (10509 in chips) 
color_singleton: posts small blind 50
manon327: posts big blind 100
*** HOLE CARDS ***
Dealt to dhduncan [Kh Ah]
Klemtonius: calls 100
dhduncan: calls 100
color_singleton: calls 50
manon327: checks 
*** FLOP *** [Jh Ks 2h]
color_singleton: checks 
manon327: bets 100
Klemtonius: folds 
dhduncan: calls 100
color_singleton: folds 
*** TURN *** [Jh Ks 2h] [Td]
manon327: bets 100
dhduncan: calls 100
*** RIVER *** [Jh Ks 2h Td] [2s]
manon327: bets 100
dhduncan: raises 100 to 200
manon327: calls 100
*** SHOW DOWN ***
dhduncan: shows [Kh Ah] (two pair, Kings and Deuces)
manon327: mucks hand 
dhduncan collected 1134 from pot
*** SUMMARY ***
Total pot 1200 | Rake 66 
Board [Jh Ks 2h Td 2s]
Seat 1: color_singleton (small blind) folded on the Flop
Seat 2: manon327 (big blind) mucked [9c 9s]
Seat 7: Klemtonius folded on the Flop
Seat 9: dhduncan (button) showed [Kh Ah] and won (1134) with two pair, Kings and Deuces



PokerStars Home Game Hand #223932047342: {DaPokaStars}  Hold'em No Limit (50/100) - 2021/02/17 18:11:45 ET
Table 'tonight again' 9-max (Play Money) Seat #1 is the button
Seat 1: color_singleton (26528 in chips) 
Seat 2: manon327 (8937 in chips) 
Seat 7: Klemtonius (28258 in chips) 
Seat 9: dhduncan (11143 in chips) 
manon327: posts small blind 50
Klemtonius: posts big blind 100
*** HOLE CARDS ***
Dealt to dhduncan [Qd Js]
dhduncan: calls 100
color_singleton: raises 200 to 300
manon327: folds 
Klemtonius: calls 200
dhduncan: calls 200
*** FLOP *** [3d Ts Jc]
Klemtonius: bets 100
dhduncan: calls 100
color_singleton: folds 
*** TURN *** [3d Ts Jc] [9d]
Klemtonius: bets 100
dhduncan: calls 100
*** RIVER *** [3d Ts Jc 9d] [5c]
Klemtonius: checks 
dhduncan: checks 
*** SHOW DOWN ***
Klemtonius: shows [Kc Ac] (high card Ace)
dhduncan: shows [Qd Js] (a pair of Jacks)
dhduncan collected 1276 from pot
*** SUMMARY ***
Total pot 1350 | Rake 74 
Board [3d Ts Jc 9d 5c]
Seat 1: color_singleton (button) folded on the Flop
Seat 2: manon327 (small blind) folded before Flop
Seat 7: Klemtonius (big blind) showed [Kc Ac] and lost with high card Ace
Seat 9: dhduncan showed [Qd Js] and won (1276) with a pair of Jacks



PokerStars Home Game Hand #223932074130: {DaPokaStars}  Hold'em No Limit (50/100) - 2021/02/17 18:12:35 ET
Table 'tonight again' 9-max (Play Money) Seat #2 is the button
Seat 1: color_singleton (26228 in chips) 
Seat 2: manon327 (8887 in chips) 
Seat 7: Klemtonius (27758 in chips) 
Seat 9: dhduncan (11919 in chips) 
Klemtonius: posts small blind 50
dhduncan: posts big blind 100
*** HOLE CARDS ***
Dealt to dhduncan [9d 8d]
color_singleton: raises 200 to 300
manon327: folds 
Klemtonius: folds 
dhduncan: folds 
Uncalled bet (200) returned to color_singleton
color_singleton collected 250 from pot
color_singleton: doesn't show hand 
*** SUMMARY ***
Total pot 250 | Rake 0 
Seat 1: color_singleton collected (250)
Seat 2: manon327 (button) folded before Flop (didn't bet)
Seat 7: Klemtonius (small blind) folded before Flop
Seat 9: dhduncan (big blind) folded before Flop



PokerStars Home Game Hand #223932084086: {DaPokaStars}  Hold'em No Limit (50/100) - 2021/02/17 18:12:54 ET
Table 'tonight again' 9-max (Play Money) Seat #7 is the button
Seat 1: color_singleton (26378 in chips) 
Seat 2: manon327 (8887 in chips) 
Seat 7: Klemtonius (27708 in chips) 
Seat 9: dhduncan (11819 in chips) 
dhduncan: posts small blind 50
color_singleton: posts big blind 100
*** HOLE CARDS ***
Dealt to dhduncan [3s Th]
manon327: folds 
Klemtonius: calls 100
dhduncan: folds 
color_singleton: checks 
*** FLOP *** [4s Qd Jh]
color_singleton: bets 236
Klemtonius: folds 
Uncalled bet (236) returned to color_singleton
color_singleton collected 236 from pot
color_singleton: doesn't show hand 
*** SUMMARY ***
Total pot 250 | Rake 14 
Board [4s Qd Jh]
Seat 1: color_singleton (big blind) collected (236)
Seat 2: manon327 folded before Flop (didn't bet)
Seat 7: Klemtonius (button) folded on the Flop
Seat 9: dhduncan (small blind) folded before Flop



PokerStars Home Game Hand #223932099835: {DaPokaStars}  Hold'em No Limit (50/100) - 2021/02/17 18:13:24 ET
Table 'tonight again' 9-max (Play Money) Seat #9 is the button
Seat 1: color_singleton (26514 in chips) 
Seat 2: manon327 (8887 in chips) 
Seat 7: Klemtonius (27608 in chips) 
Seat 9: dhduncan (11769 in chips) 
color_singleton: posts small blind 50
manon327: posts big blind 100
*** HOLE CARDS ***
Dealt to dhduncan [6d 4d]
Klemtonius: folds 
dhduncan: folds 
color_singleton: calls 50
manon327: checks 
*** FLOP *** [8s 7d 2d]
color_singleton: checks 
manon327: checks 
*** TURN *** [8s 7d 2d] [8c]
color_singleton: bets 189
manon327: folds 
Uncalled bet (189) returned to color_singleton
color_singleton collected 189 from pot
color_singleton: doesn't show hand 
*** SUMMARY ***
Total pot 200 | Rake 11 
Board [8s 7d 2d 8c]
Seat 1: color_singleton (small blind) collected (189)
Seat 2: manon327 (big blind) folded on the Turn
Seat 7: Klemtonius folded before Flop (didn't bet)
Seat 9: dhduncan (button) folded before Flop (didn't bet)



PokerStars Home Game Hand #223932116466: {DaPokaStars}  Hold'em No Limit (50/100) - 2021/02/17 18:13:55 ET
Table 'tonight again' 9-max (Play Money) Seat #1 is the button
Seat 1: color_singleton (26603 in chips) 
Seat 2: manon327 (8787 in chips) 
Seat 7: Klemtonius (27608 in chips) 
Seat 9: dhduncan (11769 in chips) 
manon327: posts small blind 50
Klemtonius: posts big blind 100
*** HOLE CARDS ***
Dealt to dhduncan [Kd 3h]
dhduncan: calls 100
color_singleton: folds 
manon327: folds 
Klemtonius: raises 100 to 200
dhduncan: folds 
Uncalled bet (100) returned to Klemtonius
Klemtonius collected 250 from pot
Klemtonius: doesn't show hand 
*** SUMMARY ***
Total pot 250 | Rake 0 
Seat 1: color_singleton (button) folded before Flop (didn't bet)
Seat 2: manon327 (small blind) folded before Flop
Seat 7: Klemtonius (big blind) collected (250)
Seat 9: dhduncan folded before Flop



PokerStars Home Game Hand #223932123405: {DaPokaStars}  Hold'em No Limit (50/100) - 2021/02/17 18:14:09 ET
Table 'tonight again' 9-max (Play Money) Seat #2 is the button
Seat 1: color_singleton (26603 in chips) 
Seat 2: manon327 (8737 in chips) 
Seat 7: Klemtonius (27758 in chips) 
Seat 9: dhduncan (11669 in chips) 
Klemtonius: posts small blind 50
dhduncan: posts big blind 100
*** HOLE CARDS ***
Dealt to dhduncan [Tc 4s]
color_singleton: raises 200 to 300
manon327: calls 300
Klemtonius: calls 250
dhduncan: folds 
*** FLOP *** [4c 3s 3c]
Klemtonius: bets 100
color_singleton: calls 100
manon327: calls 100
*** TURN *** [4c 3s 3c] [6h]
Klemtonius: bets 100
color_singleton: calls 100
manon327: calls 100
*** RIVER *** [4c 3s 3c 6h] [4h]
Klemtonius: checks 
color_singleton: checks 
manon327: checks 
*** SHOW DOWN ***
Klemtonius: shows [6s Jd] (two pair, Sixes and Fours)
color_singleton: mucks hand 
manon327: shows [6c Ac] (two pair, Sixes and Fours - Ace kicker)
manon327 collected 1512 from pot
*** SUMMARY ***
Total pot 1600 | Rake 88 
Board [4c 3s 3c 6h 4h]
Seat 1: color_singleton mucked [Ah 2c]
Seat 2: manon327 (button) showed [6c Ac] and won (1512) with two pair, Sixes and Fours
Seat 7: Klemtonius (small blind) showed [6s Jd] and lost with two pair, Sixes and Fours
Seat 9: dhduncan (big blind) folded before Flop



PokerStars Home Game Hand #223932146308: {DaPokaStars}  Hold'em No Limit (50/100) - 2021/02/17 18:14:52 ET
Table 'tonight again' 9-max (Play Money) Seat #7 is the button
Seat 1: color_singleton (26103 in chips) 
Seat 2: manon327 (9749 in chips) 
Seat 7: Klemtonius (27258 in chips) 
Seat 9: dhduncan (11569 in chips) 
dhduncan: posts small blind 50
color_singleton: posts big blind 100
*** HOLE CARDS ***
Dealt to dhduncan [Ts 3d]
manon327: folds 
Klemtonius: raises 250 to 350
dhduncan: folds 
color_singleton: calls 250
*** FLOP *** [6d Tc 4s]
color_singleton: bets 354
Klemtonius: raises 354 to 708
color_singleton: calls 354
*** TURN *** [6d Tc 4s] [9c]
color_singleton: checks 
Klemtonius: bets 2047
color_singleton: folds 
Uncalled bet (2047) returned to Klemtonius
Klemtonius collected 2047 from pot
Klemtonius: doesn't show hand 
*** SUMMARY ***
Total pot 2166 | Rake 119 
Board [6d Tc 4s 9c]
Seat 1: color_singleton (big blind) folded on the Turn
Seat 2: manon327 folded before Flop (didn't bet)
Seat 7: Klemtonius (button) collected (2047)
Seat 9: dhduncan (small blind) folded before Flop



PokerStars Home Game Hand #223932167011: {DaPokaStars}  Hold'em No Limit (50/100) - 2021/02/17 18:15:32 ET
Table 'tonight again' 9-max (Play Money) Seat #9 is the button
Seat 1: color_singleton (25045 in chips) 
Seat 2: manon327 (9749 in chips) 
Seat 7: Klemtonius (28247 in chips) 
Seat 9: dhduncan (11519 in chips) 
color_singleton: posts small blind 50
manon327: posts big blind 100
*** HOLE CARDS ***
Dealt to dhduncan [Js 7c]
Klemtonius: raises 100 to 200
dhduncan: folds 
color_singleton: folds 
manon327: folds 
Uncalled bet (100) returned to Klemtonius
Klemtonius collected 250 from pot
Klemtonius: doesn't show hand 
*** SUMMARY ***
Total pot 250 | Rake 0 
Seat 1: color_singleton (small blind) folded before Flop
Seat 2: manon327 (big blind) folded before Flop
Seat 7: Klemtonius collected (250)
Seat 9: dhduncan (button) folded before Flop (didn't bet)



PokerStars Home Game Hand #223932175303: {DaPokaStars}  Hold'em No Limit (50/100) - 2021/02/17 18:15:48 ET
Table 'tonight again' 9-max (Play Money) Seat #1 is the button
Seat 1: color_singleton (24995 in chips) 
Seat 2: manon327 (9649 in chips) 
Seat 7: Klemtonius (28397 in chips) 
Seat 9: dhduncan (11519 in chips) 
manon327: posts small blind 50
Klemtonius: posts big blind 100
*** HOLE CARDS ***
Dealt to dhduncan [5c 9h]
dhduncan: folds 
color_singleton: raises 200 to 300
manon327: calls 250
Klemtonius: folds 
*** FLOP *** [Jd Qh 2c]
manon327: bets 661
color_singleton: calls 661
*** TURN *** [Jd Qh 2c] [Ah]
manon327: bets 1911
color_singleton: calls 1911
*** RIVER *** [Jd Qh 2c Ah] [4c]
manon327: checks 
color_singleton: checks 
*** SHOW DOWN ***
manon327: shows [Ad Qs] (two pair, Aces and Queens)
color_singleton: mucks hand 
manon327 collected 5523 from pot
*** SUMMARY ***
Total pot 5844 | Rake 321 
Board [Jd Qh 2c Ah 4c]
Seat 1: color_singleton (button) mucked [Qd Jh]
Seat 2: manon327 (small blind) showed [Ad Qs] and won (5523) with two pair, Aces and Queens
Seat 7: Klemtonius (big blind) folded before Flop
Seat 9: dhduncan folded before Flop (didn't bet)



PokerStars Home Game Hand #223932198818: {DaPokaStars}  Hold'em No Limit (50/100) - 2021/02/17 18:16:33 ET
Table 'tonight again' 9-max (Play Money) Seat #2 is the button
Seat 1: color_singleton (22123 in chips) 
Seat 2: manon327 (12300 in chips) 
Seat 7: Klemtonius (28297 in chips) 
Seat 9: dhduncan (11519 in chips) 
Klemtonius: posts small blind 50
dhduncan: posts big blind 100
*** HOLE CARDS ***
Dealt to dhduncan [Ts 2s]
color_singleton: raises 200 to 300
manon327: calls 300
Klemtonius: raises 200 to 500
dhduncan: folds 
color_singleton: calls 200
manon327: folds 
*** FLOP *** [2h 8s 6c]
Klemtonius: bets 100
color_singleton: calls 100
*** TURN *** [2h 8s 6c] [Ad]
Klemtonius: bets 756
color_singleton: folds 
Uncalled bet (756) returned to Klemtonius
Klemtonius collected 1512 from pot
Klemtonius: doesn't show hand 
*** SUMMARY ***
Total pot 1600 | Rake 88 
Board [2h 8s 6c Ad]
Seat 1: color_singleton folded on the Turn
Seat 2: manon327 (button) folded before Flop
Seat 7: Klemtonius (small blind) collected (1512)
Seat 9: dhduncan (big blind) folded before Flop



PokerStars Home Game Hand #223932215408: {DaPokaStars}  Hold'em No Limit (50/100) - 2021/02/17 18:17:05 ET
Table 'tonight again' 9-max (Play Money) Seat #7 is the button
Seat 1: color_singleton (21523 in chips) 
Seat 2: manon327 (12000 in chips) 
Seat 7: Klemtonius (29209 in chips) 
Seat 9: dhduncan (11419 in chips) 
dhduncan: posts small blind 50
color_singleton: posts big blind 100
*** HOLE CARDS ***
Dealt to dhduncan [5c Ts]
manon327: folds 
Klemtonius: folds 
dhduncan: folds 
Uncalled bet (50) returned to color_singleton
color_singleton collected 100 from pot
color_singleton: doesn't show hand 
*** SUMMARY ***
Total pot 100 | Rake 0 
Seat 1: color_singleton (big blind) collected (100)
Seat 2: manon327 folded before Flop (didn't bet)
Seat 7: Klemtonius (button) folded before Flop (didn't bet)
Seat 9: dhduncan (small blind) folded before Flop



PokerStars Home Game Hand #223932220208: {DaPokaStars}  Hold'em No Limit (50/100) - 2021/02/17 18:17:14 ET
Table 'tonight again' 9-max (Play Money) Seat #9 is the button
Seat 1: color_singleton (21573 in chips) 
Seat 2: manon327 (12000 in chips) 
Seat 7: Klemtonius (29209 in chips) 
Seat 9: dhduncan (11369 in chips) 
color_singleton: posts small blind 50
manon327: posts big blind 100
*** HOLE CARDS ***
Dealt to dhduncan [Jh Qc]
Klemtonius: raises 100 to 200
dhduncan: calls 200
color_singleton: folds 
manon327: calls 100
*** FLOP *** [2c Ts Qd]
manon327: checks 
Klemtonius: checks 
dhduncan: bets 100
manon327: calls 100
Klemtonius: calls 100
*** TURN *** [2c Ts Qd] [8d]
manon327: checks 
Klemtonius: bets 449
dhduncan: calls 449
manon327: folds 
*** RIVER *** [2c Ts Qd 8d] [Jc]
Klemtonius: bets 1746
dhduncan: calls 1746
*** SHOW DOWN ***
Klemtonius: shows [2d Jd] (two pair, Jacks and Deuces)
dhduncan: shows [Jh Qc] (two pair, Queens and Jacks)
dhduncan collected 5046 from pot
*** SUMMARY ***
Total pot 5340 | Rake 294 
Board [2c Ts Qd 8d Jc]
Seat 1: color_singleton (small blind) folded before Flop
Seat 2: manon327 (big blind) folded on the Turn
Seat 7: Klemtonius showed [2d Jd] and lost with two pair, Jacks and Deuces
Seat 9: dhduncan (button) showed [Jh Qc] and won (5046) with two pair, Queens and Jacks



PokerStars Home Game Hand #223932246336: {DaPokaStars}  Hold'em No Limit (50/100) - 2021/02/17 18:18:04 ET
Table 'tonight again' 9-max (Play Money) Seat #1 is the button
Seat 1: color_singleton (21523 in chips) 
Seat 2: manon327 (11700 in chips) 
Seat 7: Klemtonius (26714 in chips) 
Seat 9: dhduncan (13920 in chips) 
manon327: posts small blind 50
Klemtonius: posts big blind 100
*** HOLE CARDS ***
Dealt to dhduncan [6d Js]
dhduncan: folds 
color_singleton: raises 200 to 300
manon327: calls 250
Klemtonius: calls 200
*** FLOP *** [8c 2s 9c]
manon327: checks 
Klemtonius: checks 
color_singleton: checks 
*** TURN *** [8c 2s 9c] [Ts]
manon327: checks 
Klemtonius: bets 425
color_singleton: calls 425
manon327: folds 
*** RIVER *** [8c 2s 9c Ts] [Qd]
Klemtonius: checks 
color_singleton: bets 827
Klemtonius: calls 827
*** SHOW DOWN ***
color_singleton: shows [Kc Qh] (a pair of Queens)
Klemtonius: shows [6c 7d] (a straight, Six to Ten)
Klemtonius collected 3217 from pot
*** SUMMARY ***
Total pot 3404 | Rake 187 
Board [8c 2s 9c Ts Qd]
Seat 1: color_singleton (button) showed [Kc Qh] and lost with a pair of Queens
Seat 2: manon327 (small blind) folded on the Turn
Seat 7: Klemtonius (big blind) showed [6c 7d] and won (3217) with a straight, Six to Ten
Seat 9: dhduncan folded before Flop (didn't bet)



PokerStars Home Game Hand #223932272459: {DaPokaStars}  Hold'em No Limit (50/100) - 2021/02/17 18:18:55 ET
Table 'tonight again' 9-max (Play Money) Seat #2 is the button
Seat 1: color_singleton (19971 in chips) 
Seat 2: manon327 (11400 in chips) 
Seat 7: Klemtonius (28379 in chips) 
Seat 9: dhduncan (13920 in chips) 
Klemtonius: posts small blind 50
dhduncan: posts big blind 100
*** HOLE CARDS ***
Dealt to dhduncan [Ad Qh]
color_singleton: raises 200 to 300
manon327: calls 300
Klemtonius: calls 250
dhduncan: calls 200
*** FLOP *** [9h 2h 5d]
Klemtonius: checks 
dhduncan: checks 
color_singleton: bets 567
manon327: calls 567
Klemtonius: folds 
dhduncan: calls 567
*** TURN *** [9h 2h 5d] [Kc]
dhduncan: checks 
color_singleton: checks 
manon327: checks 
*** RIVER *** [9h 2h 5d Kc] [Kh]
dhduncan: checks 
color_singleton: checks 
manon327: checks 
*** SHOW DOWN ***
dhduncan: shows [Ad Qh] (a pair of Kings)
color_singleton: shows [Qs Ac] (a pair of Kings)
manon327: shows [9d Jd] (two pair, Kings and Nines)
manon327 collected 2741 from pot
*** SUMMARY ***
Total pot 2901 | Rake 160 
Board [9h 2h 5d Kc Kh]
Seat 1: color_singleton showed [Qs Ac] and lost with a pair of Kings
Seat 2: manon327 (button) showed [9d Jd] and won (2741) with two pair, Kings and Nines
Seat 7: Klemtonius (small blind) folded on the Flop
Seat 9: dhduncan (big blind) showed [Ad Qh] and lost with a pair of Kings



PokerStars Home Game Hand #223932296827: {DaPokaStars}  Hold'em No Limit (50/100) - 2021/02/17 18:19:42 ET
Table 'tonight again' 9-max (Play Money) Seat #7 is the button
Seat 1: color_singleton (19104 in chips) 
Seat 2: manon327 (13274 in chips) 
Seat 7: Klemtonius (28079 in chips) 
Seat 9: dhduncan (13053 in chips) 
dhduncan: posts small blind 50
color_singleton: posts big blind 100
*** HOLE CARDS ***
Dealt to dhduncan [Ad Ac]
manon327: calls 100
Klemtonius: raises 100 to 200
dhduncan: raises 100 to 300
color_singleton: folds 
manon327: folds 
Klemtonius: calls 100
*** FLOP *** [8s 3c Jh]
dhduncan: bets 756
Klemtonius: folds 
Uncalled bet (756) returned to dhduncan
dhduncan collected 756 from pot
dhduncan: doesn't show hand 
*** SUMMARY ***
Total pot 800 | Rake 44 
Board [8s 3c Jh]
Seat 1: color_singleton (big blind) folded before Flop
Seat 2: manon327 folded before Flop
Seat 7: Klemtonius (button) folded on the Flop
Seat 9: dhduncan (small blind) collected (756)



PokerStars Home Game Hand #223932312056: {DaPokaStars}  Hold'em No Limit (50/100) - 2021/02/17 18:20:12 ET
Table 'tonight again' 9-max (Play Money) Seat #9 is the button
Seat 1: color_singleton (19004 in chips) 
Seat 2: manon327 (13174 in chips) 
Seat 7: Klemtonius (27779 in chips) 
Seat 9: dhduncan (13509 in chips) 
color_singleton: posts small blind 50
manon327: posts big blind 100
*** HOLE CARDS ***
Dealt to dhduncan [8h 7c]
Klemtonius: calls 100
dhduncan: folds 
color_singleton: raises 200 to 300
manon327: folds 
Klemtonius: calls 200
*** FLOP *** [5s 6s Ks]
color_singleton: bets 661
Klemtonius: folds 
Uncalled bet (661) returned to color_singleton
color_singleton collected 661 from pot
color_singleton: doesn't show hand 
*** SUMMARY ***
Total pot 700 | Rake 39 
Board [5s 6s Ks]
Seat 1: color_singleton (small blind) collected (661)
Seat 2: manon327 (big blind) folded before Flop
Seat 7: Klemtonius folded on the Flop
Seat 9: dhduncan (button) folded before Flop (didn't bet)



PokerStars Home Game Hand #223932319978: {DaPokaStars}  Hold'em No Limit (50/100) - 2021/02/17 18:20:27 ET
Table 'tonight again' 9-max (Play Money) Seat #1 is the button
Seat 1: color_singleton (19365 in chips) 
Seat 2: manon327 (13074 in chips) 
Seat 7: Klemtonius (27479 in chips) 
Seat 9: dhduncan (13509 in chips) 
manon327: posts small blind 50
Klemtonius: posts big blind 100
*** HOLE CARDS ***
Dealt to dhduncan [Jd Ac]
dhduncan: calls 100
color_singleton: raises 200 to 300
manon327: folds 
Klemtonius: raises 750 to 1050
dhduncan: folds 
color_singleton: folds 
Uncalled bet (750) returned to Klemtonius
Klemtonius collected 750 from pot
Klemtonius: doesn't show hand 
*** SUMMARY ***
Total pot 750 | Rake 0 
Seat 1: color_singleton (button) folded before Flop
Seat 2: manon327 (small blind) folded before Flop
Seat 7: Klemtonius (big blind) collected (750)
Seat 9: dhduncan folded before Flop



PokerStars Home Game Hand #223932334216: {DaPokaStars}  Hold'em No Limit (50/100) - 2021/02/17 18:20:54 ET
Table 'tonight again' 9-max (Play Money) Seat #2 is the button
Seat 1: color_singleton (19065 in chips) 
Seat 2: manon327 (13024 in chips) 
Seat 7: Klemtonius (27929 in chips) 
Seat 9: dhduncan (13409 in chips) 
Klemtonius: posts small blind 50
dhduncan: posts big blind 100
*** HOLE CARDS ***
Dealt to dhduncan [6c 4s]
color_singleton: raises 200 to 300
manon327: folds 
Klemtonius: calls 250
dhduncan: folds 
*** FLOP *** [Kc Ts 8s]
Klemtonius: checks 
color_singleton: bets 330
Klemtonius: folds 
Uncalled bet (330) returned to color_singleton
color_singleton collected 661 from pot
color_singleton: doesn't show hand 
*** SUMMARY ***
Total pot 700 | Rake 39 
Board [Kc Ts 8s]
Seat 1: color_singleton collected (661)
Seat 2: manon327 (button) folded before Flop (didn't bet)
Seat 7: Klemtonius (small blind) folded on the Flop
Seat 9: dhduncan (big blind) folded before Flop



PokerStars Home Game Hand #223932344009: {DaPokaStars}  Hold'em No Limit (50/100) - 2021/02/17 18:21:13 ET
Table 'tonight again' 9-max (Play Money) Seat #7 is the button
Seat 1: color_singleton (19426 in chips) 
Seat 2: manon327 (13024 in chips) 
Seat 7: Klemtonius (27629 in chips) 
Seat 9: dhduncan (13309 in chips) 
dhduncan: posts small blind 50
color_singleton: posts big blind 100
*** HOLE CARDS ***
Dealt to dhduncan [3c 3d]
manon327: calls 100
Klemtonius: calls 100
dhduncan: folds 
color_singleton: checks 
*** FLOP *** [4c 5s Qh]
color_singleton: bets 331
manon327: folds 
Klemtonius: folds 
Uncalled bet (331) returned to color_singleton
color_singleton collected 331 from pot
color_singleton: doesn't show hand 
*** SUMMARY ***
Total pot 350 | Rake 19 
Board [4c 5s Qh]
Seat 1: color_singleton (big blind) collected (331)
Seat 2: manon327 folded on the Flop
Seat 7: Klemtonius (button) folded on the Flop
Seat 9: dhduncan (small blind) folded before Flop



PokerStars Home Game Hand #223932363655: {DaPokaStars}  Hold'em No Limit (50/100) - 2021/02/17 18:21:52 ET
Table 'tonight again' 9-max (Play Money) Seat #9 is the button
Seat 1: color_singleton (19657 in chips) 
Seat 2: manon327 (12924 in chips) 
Seat 7: Klemtonius (27529 in chips) 
Seat 9: dhduncan (13259 in chips) 
color_singleton: posts small blind 50
manon327: posts big blind 100
*** HOLE CARDS ***
Dealt to dhduncan [Kh 9d]
Klemtonius: raises 250 to 350
dhduncan: folds 
color_singleton: calls 300
manon327: folds 
*** FLOP *** [Ks 5d 6c]
color_singleton: checks 
Klemtonius: bets 378
color_singleton: folds 
Uncalled bet (378) returned to Klemtonius
Klemtonius collected 756 from pot
Klemtonius: doesn't show hand 
*** SUMMARY ***
Total pot 800 | Rake 44 
Board [Ks 5d 6c]
Seat 1: color_singleton (small blind) folded on the Flop
Seat 2: manon327 (big blind) folded before Flop
Seat 7: Klemtonius collected (756)
Seat 9: dhduncan (button) folded before Flop (didn't bet)



PokerStars Home Game Hand #223932374072: {DaPokaStars}  Hold'em No Limit (50/100) - 2021/02/17 18:22:12 ET
Table 'tonight again' 9-max (Play Money) Seat #1 is the button
Seat 1: color_singleton (19307 in chips) 
Seat 2: manon327 (12824 in chips) 
Seat 7: Klemtonius (27935 in chips) 
Seat 9: dhduncan (13259 in chips) 
manon327: posts small blind 50
Klemtonius: posts big blind 100
*** HOLE CARDS ***
Dealt to dhduncan [9h Qd]
dhduncan: folds 
color_singleton: folds 
manon327: calls 50
Klemtonius: checks 
*** FLOP *** [6d 2h 7s]
manon327: bets 189
Klemtonius: folds 
Uncalled bet (189) returned to manon327
manon327 collected 189 from pot
*** SUMMARY ***
Total pot 200 | Rake 11 
Board [6d 2h 7s]
Seat 1: color_singleton (button) folded before Flop (didn't bet)
Seat 2: manon327 (small blind) collected (189)
Seat 7: Klemtonius (big blind) folded on the Flop
Seat 9: dhduncan folded before Flop (didn't bet)



PokerStars Home Game Hand #223932382287: {DaPokaStars}  Hold'em No Limit (50/100) - 2021/02/17 18:22:28 ET
Table 'tonight again' 9-max (Play Money) Seat #2 is the button
Seat 1: color_singleton (19307 in chips) 
Seat 2: manon327 (12913 in chips) 
Seat 7: Klemtonius (27835 in chips) 
Seat 9: dhduncan (13259 in chips) 
Klemtonius: posts small blind 50
dhduncan: posts big blind 100
*** HOLE CARDS ***
Dealt to dhduncan [Ah Js]
color_singleton: folds 
manon327: calls 100
Klemtonius: calls 50
dhduncan: checks 
*** FLOP *** [Tc 2s 4h]
Klemtonius: checks 
dhduncan: checks 
manon327: checks 
*** TURN *** [Tc 2s 4h] [6c]
Klemtonius: bets 100
dhduncan: folds 
manon327: calls 100
*** RIVER *** [Tc 2s 4h 6c] [3s]
Klemtonius: checks 
manon327: bets 472
Klemtonius: folds 
Uncalled bet (472) returned to manon327
manon327 collected 472 from pot
*** SUMMARY ***
Total pot 500 | Rake 28 
Board [Tc 2s 4h 6c 3s]
Seat 1: color_singleton folded before Flop (didn't bet)
Seat 2: manon327 (button) collected (472)
Seat 7: Klemtonius (small blind) folded on the River
Seat 9: dhduncan (big blind) folded on the Turn



PokerStars Home Game Hand #223932403215: {DaPokaStars}  Hold'em No Limit (50/100) - 2021/02/17 18:23:09 ET
Table 'tonight again' 9-max (Play Money) Seat #7 is the button
Seat 1: color_singleton (19307 in chips) 
Seat 2: manon327 (13185 in chips) 
Seat 7: Klemtonius (27635 in chips) 
Seat 9: dhduncan (13159 in chips) 
dhduncan: posts small blind 50
color_singleton: posts big blind 100
*** HOLE CARDS ***
Dealt to dhduncan [9h Qc]
manon327: calls 100
Klemtonius: folds 
dhduncan: calls 50
color_singleton: raises 200 to 300
manon327: calls 200
dhduncan: calls 200
*** FLOP *** [Qd Th 6d]
dhduncan: checks 
color_singleton: bets 850
manon327: folds 
dhduncan: folds 
Uncalled bet (850) returned to color_singleton
color_singleton collected 850 from pot
color_singleton: doesn't show hand 
*** SUMMARY ***
Total pot 900 | Rake 50 
Board [Qd Th 6d]
Seat 1: color_singleton (big blind) collected (850)
Seat 2: manon327 folded on the Flop
Seat 7: Klemtonius (button) folded before Flop (didn't bet)
Seat 9: dhduncan (small blind) folded on the Flop



PokerStars Home Game Hand #223932422224: {DaPokaStars}  Hold'em No Limit (50/100) - 2021/02/17 18:23:46 ET
Table 'tonight again' 9-max (Play Money) Seat #9 is the button
Seat 1: color_singleton (19857 in chips) 
Seat 2: manon327 (12885 in chips) 
Seat 7: Klemtonius (27635 in chips) 
Seat 9: dhduncan (12859 in chips) 
color_singleton: posts small blind 50
manon327: posts big blind 100
*** HOLE CARDS ***
Dealt to dhduncan [Ah Js]
Klemtonius: calls 100
dhduncan: calls 100
color_singleton: calls 50
manon327: checks 
*** FLOP *** [7h Ad Kd]
color_singleton: checks 
manon327: checks 
Klemtonius: checks 
dhduncan: bets 100
color_singleton: folds 
manon327: folds 
Klemtonius: calls 100
*** TURN *** [7h Ad Kd] [Jc]
Klemtonius: bets 283
dhduncan: calls 283
*** RIVER *** [7h Ad Kd Jc] [Tc]
Klemtonius: bets 551
dhduncan: raises 1251 to 1802
Klemtonius: calls 1251
*** SHOW DOWN ***
dhduncan: shows [Ah Js] (two pair, Aces and Jacks)
Klemtonius: shows [8d Qs] (a straight, Ten to Ace)
Klemtonius collected 4508 from pot
*** SUMMARY ***
Total pot 4770 | Rake 262 
Board [7h Ad Kd Jc Tc]
Seat 1: color_singleton (small blind) folded on the Flop
Seat 2: manon327 (big blind) folded on the Flop
Seat 7: Klemtonius showed [8d Qs] and won (4508) with a straight, Ten to Ace
Seat 9: dhduncan (button) showed [Ah Js] and lost with two pair, Aces and Jacks



PokerStars Home Game Hand #223932457222: {DaPokaStars}  Hold'em No Limit (50/100) - 2021/02/17 18:24:54 ET
Table 'tonight again' 9-max (Play Money) Seat #1 is the button
Seat 1: color_singleton (19757 in chips) 
Seat 2: manon327 (12785 in chips) 
Seat 7: Klemtonius (29858 in chips) 
Seat 9: dhduncan (10574 in chips) 
manon327: posts small blind 50
Klemtonius: posts big blind 100
*** HOLE CARDS ***
Dealt to dhduncan [Ks Td]
dhduncan: calls 100
color_singleton: calls 100
manon327: calls 50
Klemtonius: checks 
*** FLOP *** [7d 8d Tc]
manon327: checks 
Klemtonius: checks 
dhduncan: checks 
color_singleton: checks 
*** TURN *** [7d 8d Tc] [7c]
manon327: checks 
Klemtonius: checks 
dhduncan: bets 100
color_singleton: calls 100
manon327: folds 
Klemtonius: folds 
*** RIVER *** [7d 8d Tc 7c] [3c]
dhduncan: bets 100
color_singleton: raises 400 to 500
dhduncan: calls 400
*** SHOW DOWN ***
color_singleton: shows [5c Qc] (a flush, Queen high)
dhduncan: mucks hand 
color_singleton collected 1512 from pot
*** SUMMARY ***
Total pot 1600 | Rake 88 
Board [7d 8d Tc 7c 3c]
Seat 1: color_singleton (button) showed [5c Qc] and won (1512) with a flush, Queen high
Seat 2: manon327 (small blind) folded on the Turn
Seat 7: Klemtonius (big blind) folded on the Turn
Seat 9: dhduncan mucked [Ks Td]



PokerStars Home Game Hand #223932494519: {DaPokaStars}  Hold'em No Limit (50/100) - 2021/02/17 18:26:08 ET
Table 'tonight again' 9-max (Play Money) Seat #2 is the button
Seat 1: color_singleton (20569 in chips) 
Seat 2: manon327 (12685 in chips) 
Seat 7: Klemtonius (29758 in chips) 
Seat 9: dhduncan (9874 in chips) 
Klemtonius: posts small blind 50
dhduncan: posts big blind 100
*** HOLE CARDS ***
Dealt to dhduncan [3c 4s]
color_singleton: folds 
manon327: calls 100
Klemtonius: calls 50
dhduncan: checks 
*** FLOP *** [Jd 9s Kc]
Klemtonius: checks 
dhduncan: checks 
manon327: checks 
*** TURN *** [Jd 9s Kc] [Ac]
Klemtonius: checks 
dhduncan: checks 
manon327: bets 283
Klemtonius: calls 283
dhduncan: folds 
*** RIVER *** [Jd 9s Kc Ac] [5d]
Klemtonius: checks 
manon327: bets 818
Klemtonius: folds 
Uncalled bet (818) returned to manon327
manon327 collected 818 from pot
*** SUMMARY ***
Total pot 866 | Rake 48 
Board [Jd 9s Kc Ac 5d]
Seat 1: color_singleton folded before Flop (didn't bet)
Seat 2: manon327 (button) collected (818)
Seat 7: Klemtonius (small blind) folded on the River
Seat 9: dhduncan (big blind) folded on the Turn



PokerStars Home Game Hand #223932519991: {DaPokaStars}  Hold'em No Limit (50/100) - 2021/02/17 18:26:58 ET
Table 'tonight again' 9-max (Play Money) Seat #7 is the button
Seat 1: color_singleton (20569 in chips) 
Seat 2: manon327 (13120 in chips) 
Seat 7: Klemtonius (29375 in chips) 
Seat 9: dhduncan (9774 in chips) 
dhduncan: posts small blind 50
color_singleton: posts big blind 100
*** HOLE CARDS ***
Dealt to dhduncan [7d 8h]
manon327: calls 100
Klemtonius: folds 
dhduncan: folds 
color_singleton: checks 
*** FLOP *** [7c Kc 5d]
color_singleton: bets 118
manon327: calls 118
*** TURN *** [7c Kc 5d] [Qh]
color_singleton: checks 
manon327: bets 229
color_singleton: folds 
Uncalled bet (229) returned to manon327
manon327 collected 459 from pot
*** SUMMARY ***
Total pot 486 | Rake 27 
Board [7c Kc 5d Qh]
Seat 1: color_singleton (big blind) folded on the Turn
Seat 2: manon327 collected (459)
Seat 7: Klemtonius (button) folded before Flop (didn't bet)
Seat 9: dhduncan (small blind) folded before Flop



PokerStars Home Game Hand #223932533224: {DaPokaStars}  Hold'em No Limit (50/100) - 2021/02/17 18:27:24 ET
Table 'tonight again' 9-max (Play Money) Seat #9 is the button
Seat 1: color_singleton (20351 in chips) 
Seat 2: manon327 (13361 in chips) 
Seat 7: Klemtonius (29375 in chips) 
Seat 9: dhduncan (9724 in chips) 
color_singleton: posts small blind 50
manon327: posts big blind 100
*** HOLE CARDS ***
Dealt to dhduncan [Tc 6s]
Klemtonius: raises 100 to 200
dhduncan: folds 
color_singleton: folds 
manon327: calls 100
*** FLOP *** [8c 3c 6h]
manon327: checks 
Klemtonius: bets 425
manon327: folds 
Uncalled bet (425) returned to Klemtonius
Klemtonius collected 425 from pot
Klemtonius: doesn't show hand 
*** SUMMARY ***
Total pot 450 | Rake 25 
Board [8c 3c 6h]
Seat 1: color_singleton (small blind) folded before Flop
Seat 2: manon327 (big blind) folded on the Flop
Seat 7: Klemtonius collected (425)
Seat 9: dhduncan (button) folded before Flop (didn't bet)



PokerStars Home Game Hand #223932544450: {DaPokaStars}  Hold'em No Limit (50/100) - 2021/02/17 18:27:46 ET
Table 'tonight again' 9-max (Play Money) Seat #1 is the button
Seat 1: color_singleton (20301 in chips) 
Seat 2: manon327 (13161 in chips) 
Seat 7: Klemtonius (29600 in chips) 
Seat 9: dhduncan (9724 in chips) 
manon327: posts small blind 50
Klemtonius: posts big blind 100
*** HOLE CARDS ***
Dealt to dhduncan [6s Tc]
dhduncan: folds 
color_singleton: raises 200 to 300
manon327: folds 
Klemtonius: calls 200
*** FLOP *** [Kd 3h 6h]
Klemtonius: checks 
color_singleton: checks 
*** TURN *** [Kd 3h 6h] [9c]
Klemtonius: checks 
color_singleton: checks 
*** RIVER *** [Kd 3h 6h 9c] [Ah]
Klemtonius: checks 
color_singleton: checks 
*** SHOW DOWN ***
Klemtonius: shows [Jc Qd] (high card Ace)
color_singleton: shows [5d 5c] (a pair of Fives)
color_singleton collected 614 from pot
*** SUMMARY ***
Total pot 650 | Rake 36 
Board [Kd 3h 6h 9c Ah]
Seat 1: color_singleton (button) showed [5d 5c] and won (614) with a pair of Fives
Seat 2: manon327 (small blind) folded before Flop
Seat 7: Klemtonius (big blind) showed [Jc Qd] and lost with high card Ace
Seat 9: dhduncan folded before Flop (didn't bet)



PokerStars Home Game Hand #223932557076: {DaPokaStars}  Hold'em No Limit (50/100) - 2021/02/17 18:28:12 ET
Table 'tonight again' 9-max (Play Money) Seat #2 is the button
Seat 1: color_singleton (20615 in chips) 
Seat 2: manon327 (13111 in chips) 
Seat 7: Klemtonius (29300 in chips) 
Seat 9: dhduncan (9724 in chips) 
Klemtonius: posts small blind 50
dhduncan: posts big blind 100
*** HOLE CARDS ***
Dealt to dhduncan [Kh 8s]
color_singleton: folds 
manon327: calls 100
Klemtonius: calls 50
dhduncan: checks 
*** FLOP *** [Td 2c 4s]
Klemtonius: checks 
dhduncan: checks 
manon327: checks 
*** TURN *** [Td 2c 4s] [Qd]
Klemtonius: checks 
dhduncan: checks 
manon327: bets 141
Klemtonius: calls 141
dhduncan: folds 
*** RIVER *** [Td 2c 4s Qd] [3h]
Klemtonius: bets 550
manon327: calls 550
*** SHOW DOWN ***
Klemtonius: shows [3s 4d] (two pair, Fours and Threes)
manon327: shows [Qs 3c] (two pair, Queens and Threes)
manon327 collected 1589 from pot
*** SUMMARY ***
Total pot 1682 | Rake 93 
Board [Td 2c 4s Qd 3h]
Seat 1: color_singleton folded before Flop (didn't bet)
Seat 2: manon327 (button) showed [Qs 3c] and won (1589) with two pair, Queens and Threes
Seat 7: Klemtonius (small blind) showed [3s 4d] and lost with two pair, Fours and Threes
Seat 9: dhduncan (big blind) folded on the Turn



PokerStars Home Game Hand #223932588757: {DaPokaStars}  Hold'em No Limit (50/100) - 2021/02/17 18:29:11 ET
Table 'tonight again' 9-max (Play Money) Seat #7 is the button
Seat 1: color_singleton (20615 in chips) 
Seat 2: manon327 (13909 in chips) 
Seat 7: Klemtonius (28509 in chips) 
Seat 9: dhduncan (9624 in chips) 
dhduncan: posts small blind 50
color_singleton: posts big blind 100
*** HOLE CARDS ***
Dealt to dhduncan [Js 2c]
manon327: folds 
Klemtonius: calls 100
dhduncan: folds 
color_singleton: checks 
*** FLOP *** [Qh Ah Ad]
color_singleton: checks 
Klemtonius: bets 100
color_singleton: folds 
Uncalled bet (100) returned to Klemtonius
Klemtonius collected 236 from pot
Klemtonius: doesn't show hand 
*** SUMMARY ***
Total pot 250 | Rake 14 
Board [Qh Ah Ad]
Seat 1: color_singleton (big blind) folded on the Flop
Seat 2: manon327 folded before Flop (didn't bet)
Seat 7: Klemtonius (button) collected (236)
Seat 9: dhduncan (small blind) folded before Flop



PokerStars Home Game Hand #223932601481: {DaPokaStars}  Hold'em No Limit (50/100) - 2021/02/17 18:29:36 ET
Table 'tonight again' 9-max (Play Money) Seat #9 is the button
Seat 1: color_singleton (20515 in chips) 
Seat 2: manon327 (13909 in chips) 
Seat 7: Klemtonius (28645 in chips) 
Seat 9: dhduncan (9574 in chips) 
color_singleton: posts small blind 50
manon327: posts big blind 100
*** HOLE CARDS ***
Dealt to dhduncan [7c 3c]
Klemtonius: folds 
dhduncan: calls 100
color_singleton: calls 50
manon327: checks 
*** FLOP *** [Jc 7h 4h]
color_singleton: checks 
manon327: bets 141
dhduncan: calls 141
color_singleton: folds 
*** TURN *** [Jc 7h 4h] [Tc]
manon327: bets 275
dhduncan: folds 
Uncalled bet (275) returned to manon327
manon327 collected 550 from pot
*** SUMMARY ***
Total pot 582 | Rake 32 
Board [Jc 7h 4h Tc]
Seat 1: color_singleton (small blind) folded on the Flop
Seat 2: manon327 (big blind) collected (550)
Seat 7: Klemtonius folded before Flop (didn't bet)
Seat 9: dhduncan (button) folded on the Turn



PokerStars Home Game Hand #223932616016: {DaPokaStars}  Hold'em No Limit (50/100) - 2021/02/17 18:30:06 ET
Table 'tonight again' 9-max (Play Money) Seat #1 is the button
Seat 1: color_singleton (20415 in chips) 
Seat 2: manon327 (14218 in chips) 
Seat 7: Klemtonius (28645 in chips) 
Seat 9: dhduncan (9333 in chips) 
manon327: posts small blind 50
Klemtonius: posts big blind 100
*** HOLE CARDS ***
Dealt to dhduncan [9d 4c]
dhduncan: folds 
color_singleton: folds 
manon327: calls 50
Klemtonius: checks 
*** FLOP *** [Ks 5c Qh]
manon327: checks 
Klemtonius: checks 
*** TURN *** [Ks 5c Qh] [5h]
manon327: checks 
Klemtonius: checks 
*** RIVER *** [Ks 5c Qh 5h] [Qc]
manon327: checks 
Klemtonius: checks 
*** SHOW DOWN ***
manon327: shows [8d Js] (two pair, Queens and Fives)
Klemtonius: shows [4d Ts] (two pair, Queens and Fives)
manon327 collected 95 from pot
Klemtonius collected 94 from pot
*** SUMMARY ***
Total pot 200 | Rake 11 
Board [Ks 5c Qh 5h Qc]
Seat 1: color_singleton (button) folded before Flop (didn't bet)
Seat 2: manon327 (small blind) showed [8d Js] and won (95) with two pair, Queens and Fives
Seat 7: Klemtonius (big blind) showed [4d Ts] and won (94) with two pair, Queens and Fives
Seat 9: dhduncan folded before Flop (didn't bet)



PokerStars Home Game Hand #223932631725: {DaPokaStars}  Hold'em No Limit (50/100) - 2021/02/17 18:30:36 ET
Table 'tonight again' 9-max (Play Money) Seat #2 is the button
Seat 1: color_singleton (20415 in chips) 
Seat 2: manon327 (14213 in chips) 
Seat 7: Klemtonius (28639 in chips) 
Seat 9: dhduncan (9333 in chips) 
Klemtonius: posts small blind 50
dhduncan: posts big blind 100
*** HOLE CARDS ***
Dealt to dhduncan [5d 6h]
color_singleton: folds 
manon327: calls 100
Klemtonius: calls 50
dhduncan: checks 
*** FLOP *** [Ah 4h 2h]
Klemtonius: checks 
dhduncan: checks 
manon327: checks 
*** TURN *** [Ah 4h 2h] [Th]
Klemtonius: checks 
dhduncan: checks 
manon327: checks 
*** RIVER *** [Ah 4h 2h Th] [Td]
Klemtonius: checks 
dhduncan: bets 400
manon327: folds 
Klemtonius: calls 400
*** SHOW DOWN ***
dhduncan: shows [5d 6h] (a flush, Ace high)
Klemtonius: mucks hand 
dhduncan collected 1039 from pot
*** SUMMARY ***
Total pot 1100 | Rake 61 
Board [Ah 4h 2h Th Td]
Seat 1: color_singleton folded before Flop (didn't bet)
Seat 2: manon327 (button) folded on the River
Seat 7: Klemtonius (small blind) mucked [4d 9d]
Seat 9: dhduncan (big blind) showed [5d 6h] and won (1039) with a flush, Ace high



PokerStars Home Game Hand #223932656673: {DaPokaStars}  Hold'em No Limit (50/100) - 2021/02/17 18:31:26 ET
Table 'tonight again' 9-max (Play Money) Seat #7 is the button
Seat 1: color_singleton (20415 in chips) 
Seat 2: manon327 (14113 in chips) 
Seat 7: Klemtonius (28139 in chips) 
Seat 9: dhduncan (9872 in chips) 
dhduncan: posts small blind 50
color_singleton: posts big blind 100
*** HOLE CARDS ***
Dealt to dhduncan [8s Ts]
manon327: calls 100
Klemtonius: calls 100
dhduncan: calls 50
color_singleton: checks 
*** FLOP *** [6d 5h Kc]
dhduncan: checks 
color_singleton: bets 189
manon327: calls 189
Klemtonius: calls 189
dhduncan: folds 
*** TURN *** [6d 5h Kc] [2h]
color_singleton: checks 
manon327: checks 
Klemtonius: bets 457
color_singleton: folds 
manon327: folds 
Uncalled bet (457) returned to Klemtonius
Klemtonius collected 914 from pot
Klemtonius: doesn't show hand 
*** SUMMARY ***
Total pot 967 | Rake 53 
Board [6d 5h Kc 2h]
Seat 1: color_singleton (big blind) folded on the Turn
Seat 2: manon327 folded on the Turn
Seat 7: Klemtonius (button) collected (914)
Seat 9: dhduncan (small blind) folded on the Flop



PokerStars Home Game Hand #223932683191: {DaPokaStars}  Hold'em No Limit (50/100) - 2021/02/17 18:32:04 ET
Table 'tonight again' 9-max (Play Money) Seat #9 is the button
Seat 1: color_singleton (20126 in chips) 
Seat 2: manon327 (13824 in chips) 
Seat 7: Klemtonius (28764 in chips) 
Seat 9: dhduncan (9772 in chips) 
color_singleton: posts small blind 50
manon327: posts big blind 100
*** HOLE CARDS ***
Dealt to dhduncan [8d Kd]
Klemtonius: calls 100
dhduncan: calls 100
color_singleton: raises 200 to 300
manon327: folds 
Klemtonius: calls 200
dhduncan: calls 200
*** FLOP *** [5d 7s 2d]
color_singleton: bets 472
Klemtonius: calls 472
dhduncan: calls 472
*** TURN *** [5d 7s 2d] [9d]
color_singleton: checks 
Klemtonius: checks 
dhduncan: bets 2283
color_singleton: folds 
Klemtonius: folds 
Uncalled bet (2283) returned to dhduncan
dhduncan collected 2283 from pot
dhduncan: doesn't show hand 
*** SUMMARY ***
Total pot 2416 | Rake 133 
Board [5d 7s 2d 9d]
Seat 1: color_singleton (small blind) folded on the Turn
Seat 2: manon327 (big blind) folded before Flop
Seat 7: Klemtonius folded on the Turn
Seat 9: dhduncan (button) collected (2283)



PokerStars Home Game Hand #223932707907: {DaPokaStars}  Hold'em No Limit (50/100) - 2021/02/17 18:32:53 ET
Table 'tonight again' 9-max (Play Money) Seat #1 is the button
Seat 1: color_singleton (19354 in chips) 
Seat 2: manon327 (13724 in chips) 
Seat 7: Klemtonius (27992 in chips) 
Seat 9: dhduncan (11283 in chips) 
manon327: posts small blind 50
Klemtonius: posts big blind 100
*** HOLE CARDS ***
Dealt to dhduncan [Kd 3c]
dhduncan: calls 100
color_singleton: raises 200 to 300
manon327: calls 250
Klemtonius: calls 200
dhduncan: calls 200
*** FLOP *** [7h 4d 6d]
manon327: checks 
Klemtonius: bets 567
dhduncan: folds 
color_singleton: calls 567
manon327: calls 567
*** TURN *** [7h 4d 6d] [Js]
manon327: bets 1370
Klemtonius: folds 
color_singleton: calls 1370
*** RIVER *** [7h 4d 6d Js] [8h]
manon327: checks 
color_singleton: checks 
*** SHOW DOWN ***
manon327: shows [Jh 7d] (two pair, Jacks and Sevens)
color_singleton: mucks hand 
manon327 collected 5331 from pot
*** SUMMARY ***
Total pot 5641 | Rake 310 
Board [7h 4d 6d Js 8h]
Seat 1: color_singleton (button) mucked [Jc Qc]
Seat 2: manon327 (small blind) showed [Jh 7d] and won (5331) with two pair, Jacks and Sevens
Seat 7: Klemtonius (big blind) folded on the Turn
Seat 9: dhduncan folded on the Flop



PokerStars Home Game Hand #223932737464: {DaPokaStars}  Hold'em No Limit (50/100) - 2021/02/17 18:33:52 ET
Table 'tonight again' 9-max (Play Money) Seat #2 is the button
Seat 1: color_singleton (17117 in chips) 
Seat 2: manon327 (16818 in chips) 
Seat 7: Klemtonius (27125 in chips) 
Seat 9: dhduncan (10983 in chips) 
Klemtonius: posts small blind 50
dhduncan: posts big blind 100
*** HOLE CARDS ***
Dealt to dhduncan [9c 4c]
color_singleton: raises 100 to 200
manon327: calls 200
Klemtonius: calls 150
dhduncan: calls 100
*** FLOP *** [Js 9s Ts]
Klemtonius: bets 756
dhduncan: folds 
color_singleton: calls 756
manon327: calls 756
*** TURN *** [Js 9s Ts] [5d]
Klemtonius: bets 2899
color_singleton: folds 
manon327: folds 
Uncalled bet (2899) returned to Klemtonius
Klemtonius collected 2899 from pot
Klemtonius: doesn't show hand 
*** SUMMARY ***
Total pot 3068 | Rake 169 
Board [Js 9s Ts 5d]
Seat 1: color_singleton folded on the Turn
Seat 2: manon327 (button) folded on the Turn
Seat 7: Klemtonius (small blind) collected (2899)
Seat 9: dhduncan (big blind) folded on the Flop



PokerStars Home Game Hand #223932755847: {DaPokaStars}  Hold'em No Limit (50/100) - 2021/02/17 18:34:29 ET
Table 'tonight again' 9-max (Play Money) Seat #7 is the button
Seat 1: color_singleton (16161 in chips) 
Seat 2: manon327 (15862 in chips) 
Seat 7: Klemtonius (29068 in chips) 
Seat 9: dhduncan (10783 in chips) 
dhduncan: posts small blind 50
color_singleton: posts big blind 100
*** HOLE CARDS ***
Dealt to dhduncan [Qh 6c]
manon327: calls 100
Klemtonius: calls 100
dhduncan: calls 50
color_singleton: raises 300 to 400
manon327: folds 
Klemtonius: calls 300
dhduncan: folds 
*** FLOP *** [Td 8h Ks]
color_singleton: bets 945
Klemtonius: calls 945
*** TURN *** [Td 8h Ks] [3d]
color_singleton: checks 
Klemtonius: checks 
*** RIVER *** [Td 8h Ks 3d] [7d]
color_singleton: checks 
Klemtonius: checks 
*** SHOW DOWN ***
color_singleton: shows [2c 2s] (a pair of Deuces)
Klemtonius: shows [2d Kh] (a pair of Kings)
Klemtonius collected 2731 from pot
*** SUMMARY ***
Total pot 2890 | Rake 159 
Board [Td 8h Ks 3d 7d]
Seat 1: color_singleton (big blind) showed [2c 2s] and lost with a pair of Deuces
Seat 2: manon327 folded before Flop
Seat 7: Klemtonius (button) showed [2d Kh] and won (2731) with a pair of Kings
Seat 9: dhduncan (small blind) folded before Flop



