PokerStars Home Game Hand #226727994151: {DaPokaStars}  Hold'em No Limit (50/100) - 2021/05/13 16:38:36 ET
Table 'again and again' 9-max (Play Money) Seat #2 is the button
Seat 2: Jackall23 (30302 in chips) 
Seat 4: Klemtonius (6200 in chips) 
Seat 5: PokerStarsMan12 (10000 in chips) 
Seat 8: MaFak2019 (37794 in chips) 
Seat 9: manon327 (15018 in chips) 
Klemtonius: posts small blind 50
PokerStarsMan12: posts big blind 100
*** HOLE CARDS ***
Dealt to PokerStarsMan12 [9d Jd]
MaFak2019: calls 100
manon327: calls 100
Jackall23: calls 100
Klemtonius: calls 50
PokerStarsMan12: checks 
*** FLOP *** [7h Kd 3d]
Klemtonius: checks 
PokerStarsMan12: bets 300
MaFak2019: folds 
manon327: calls 300
Jackall23: folds 
Klemtonius: folds 
*** TURN *** [7h Kd 3d] [Qh]
PokerStarsMan12: bets 700
manon327: calls 700
*** RIVER *** [7h Kd 3d Qh] [Td]
PokerStarsMan12: bets 2300
manon327: folds 
Uncalled bet (2300) returned to PokerStarsMan12
PokerStarsMan12 collected 2362 from pot
*** SUMMARY ***
Total pot 2500 | Rake 138 
Board [7h Kd 3d Qh Td]
Seat 2: Jackall23 (button) folded on the Flop
Seat 4: Klemtonius (small blind) folded on the Flop
Seat 5: PokerStarsMan12 (big blind) collected (2362)
Seat 8: MaFak2019 folded on the Flop
Seat 9: manon327 folded on the River



PokerStars Home Game Hand #226728049717: {DaPokaStars}  Hold'em No Limit (50/100) - 2021/05/13 16:39:43 ET
Table 'again and again' 9-max (Play Money) Seat #4 is the button
Seat 1: color_singleton (10000 in chips) 
Seat 2: Jackall23 (30202 in chips) 
Seat 4: Klemtonius (6100 in chips) 
Seat 5: PokerStarsMan12 (11262 in chips) 
Seat 8: MaFak2019 (37694 in chips) 
Seat 9: manon327 (13918 in chips) 
PokerStarsMan12: posts small blind 50
MaFak2019: posts big blind 100
*** HOLE CARDS ***
Dealt to PokerStarsMan12 [2h 6c]
manon327: folds 
color_singleton has timed out
color_singleton: folds 
Jackall23: calls 100
Klemtonius: calls 100
PokerStarsMan12: calls 50
MaFak2019: checks 
*** FLOP *** [Qc 8h 3s]
PokerStarsMan12: checks 
MaFak2019: checks 
Jackall23: bets 189
Klemtonius: raises 756 to 945
PokerStarsMan12: folds 
MaFak2019: folds 
Jackall23: folds 
Uncalled bet (756) returned to Klemtonius
Klemtonius collected 735 from pot
Klemtonius: doesn't show hand 
*** SUMMARY ***
Total pot 778 | Rake 43 
Board [Qc 8h 3s]
Seat 1: color_singleton folded before Flop (didn't bet)
Seat 2: Jackall23 folded on the Flop
Seat 4: Klemtonius (button) collected (735)
Seat 5: PokerStarsMan12 (small blind) folded on the Flop
Seat 8: MaFak2019 (big blind) folded on the Flop
Seat 9: manon327 folded before Flop (didn't bet)



PokerStars Home Game Hand #226728087108: {DaPokaStars}  Hold'em No Limit (50/100) - 2021/05/13 16:40:37 ET
Table 'again and again' 9-max (Play Money) Seat #5 is the button
Seat 2: Jackall23 (29913 in chips) 
Seat 4: Klemtonius (6546 in chips) 
Seat 5: PokerStarsMan12 (11162 in chips) 
Seat 8: MaFak2019 (37594 in chips) 
Seat 9: manon327 (13918 in chips) 
MaFak2019: posts small blind 50
manon327: posts big blind 100
*** HOLE CARDS ***
Dealt to PokerStarsMan12 [6h 7s]
Jackall23: calls 100
Klemtonius: raises 100 to 200
PokerStarsMan12: calls 200
MaFak2019: calls 150
manon327: calls 100
Jackall23: calls 100
*** FLOP *** [4c Tc 9s]
MaFak2019: bets 900
manon327: folds 
Jackall23: folds 
Klemtonius: folds 
PokerStarsMan12: folds 
Uncalled bet (900) returned to MaFak2019
MaFak2019 collected 945 from pot
MaFak2019: doesn't show hand 
*** SUMMARY ***
Total pot 1000 | Rake 55 
Board [4c Tc 9s]
Seat 2: Jackall23 folded on the Flop
Seat 4: Klemtonius folded on the Flop
Seat 5: PokerStarsMan12 (button) folded on the Flop
Seat 8: MaFak2019 (small blind) collected (945)
Seat 9: manon327 (big blind) folded on the Flop



PokerStars Home Game Hand #226728112445: {DaPokaStars}  Hold'em No Limit (50/100) - 2021/05/13 16:41:15 ET
Table 'again and again' 9-max (Play Money) Seat #8 is the button
Seat 2: Jackall23 (29713 in chips) 
Seat 4: Klemtonius (6346 in chips) 
Seat 5: PokerStarsMan12 (10962 in chips) 
Seat 8: MaFak2019 (38339 in chips) 
Seat 9: manon327 (13718 in chips) 
manon327: posts small blind 50
Jackall23: posts big blind 100
*** HOLE CARDS ***
Dealt to PokerStarsMan12 [Qh Ah]
Klemtonius: raises 100 to 200
PokerStarsMan12: calls 200
MaFak2019: folds 
manon327: calls 150
Jackall23: folds 
*** FLOP *** [Qc 4d 2s]
manon327: checks 
Klemtonius: checks 
PokerStarsMan12: bets 500
manon327: folds 
Klemtonius: folds 
Uncalled bet (500) returned to PokerStarsMan12
PokerStarsMan12 collected 661 from pot
*** SUMMARY ***
Total pot 700 | Rake 39 
Board [Qc 4d 2s]
Seat 2: Jackall23 (big blind) folded before Flop
Seat 4: Klemtonius folded on the Flop
Seat 5: PokerStarsMan12 collected (661)
Seat 8: MaFak2019 (button) folded before Flop (didn't bet)
Seat 9: manon327 (small blind) folded on the Flop



PokerStars Home Game Hand #226728138599: {DaPokaStars}  Hold'em No Limit (50/100) - 2021/05/13 16:41:57 ET
Table 'again and again' 9-max (Play Money) Seat #9 is the button
Seat 2: Jackall23 (29613 in chips) 
Seat 4: Klemtonius (6146 in chips) 
Seat 5: PokerStarsMan12 (11423 in chips) 
Seat 8: MaFak2019 (38339 in chips) 
Seat 9: manon327 (13518 in chips) 
Jackall23: posts small blind 50
Klemtonius: posts big blind 100
*** HOLE CARDS ***
Dealt to PokerStarsMan12 [4d Qh]
PokerStarsMan12: folds 
MaFak2019: calls 100
manon327: calls 100
Jackall23: folds 
Klemtonius: checks 
*** FLOP *** [Qc Ks 5d]
Klemtonius: checks 
MaFak2019: checks 
manon327: checks 
*** TURN *** [Qc Ks 5d] [Kd]
Klemtonius: bets 331
MaFak2019: calls 331
manon327: folds 
*** RIVER *** [Qc Ks 5d Kd] [Kc]
Klemtonius: bets 956
MaFak2019: calls 956
*** SHOW DOWN ***
Klemtonius: shows [Ad 4h] (three of a kind, Kings)
MaFak2019: shows [Ah 2h] (three of a kind, Kings)
Klemtonius collected 1382 from pot
MaFak2019 collected 1381 from pot
*** SUMMARY ***
Total pot 2924 | Rake 161 
Board [Qc Ks 5d Kd Kc]
Seat 2: Jackall23 (small blind) folded before Flop
Seat 4: Klemtonius (big blind) showed [Ad 4h] and won (1382) with three of a kind, Kings
Seat 5: PokerStarsMan12 folded before Flop (didn't bet)
Seat 8: MaFak2019 showed [Ah 2h] and won (1381) with three of a kind, Kings
Seat 9: manon327 (button) folded on the Turn



PokerStars Home Game Hand #226728166256: {DaPokaStars}  Hold'em No Limit (50/100) - 2021/05/13 16:42:38 ET
Table 'again and again' 9-max (Play Money) Seat #2 is the button
Seat 1: color_singleton (10000 in chips) 
Seat 2: Jackall23 (29563 in chips) 
Seat 4: Klemtonius (6141 in chips) 
Seat 5: PokerStarsMan12 (11423 in chips) 
Seat 8: MaFak2019 (38333 in chips) 
Seat 9: manon327 (13418 in chips) 
Klemtonius: posts small blind 50
PokerStarsMan12: posts big blind 100
color_singleton: posts small & big blinds 150
*** HOLE CARDS ***
Dealt to PokerStarsMan12 [Kh 8d]
MaFak2019: calls 100
manon327: folds 
color_singleton: checks 
Jackall23: calls 100
Klemtonius: calls 50
PokerStarsMan12: checks 
*** FLOP *** [Ah Jc 2h]
Klemtonius: checks 
PokerStarsMan12: checks 
MaFak2019: checks 
color_singleton: checks 
Jackall23: checks 
*** TURN *** [Ah Jc 2h] [9h]
Klemtonius: checks 
PokerStarsMan12: checks 
MaFak2019: checks 
color_singleton: checks 
Jackall23: checks 
*** RIVER *** [Ah Jc 2h 9h] [2s]
Klemtonius: checks 
PokerStarsMan12: checks 
MaFak2019: checks 
color_singleton: checks 
Jackall23: checks 
*** SHOW DOWN ***
Klemtonius: shows [4h Qd] (a pair of Deuces)
PokerStarsMan12: shows [Kh 8d] (a pair of Deuces - Ace+King kicker)
MaFak2019: mucks hand 
color_singleton: shows [9c 6c] (two pair, Nines and Deuces)
Jackall23: mucks hand 
color_singleton collected 520 from pot
*** SUMMARY ***
Total pot 550 | Rake 30 
Board [Ah Jc 2h 9h 2s]
Seat 1: color_singleton showed [9c 6c] and won (520) with two pair, Nines and Deuces
Seat 2: Jackall23 (button) mucked [5c 6h]
Seat 4: Klemtonius (small blind) showed [4h Qd] and lost with a pair of Deuces
Seat 5: PokerStarsMan12 (big blind) showed [Kh 8d] and lost with a pair of Deuces
Seat 8: MaFak2019 mucked [Qh 6d]
Seat 9: manon327 folded before Flop (didn't bet)



PokerStars Home Game Hand #226728208670: {DaPokaStars}  Hold'em No Limit (50/100) - 2021/05/13 16:43:41 ET
Table 'again and again' 9-max (Play Money) Seat #4 is the button
Seat 1: color_singleton (10370 in chips) 
Seat 2: Jackall23 (29463 in chips) 
Seat 4: Klemtonius (6041 in chips) 
Seat 5: PokerStarsMan12 (11323 in chips) 
Seat 8: MaFak2019 (38233 in chips) 
Seat 9: manon327 (13418 in chips) 
PokerStarsMan12: posts small blind 50
MaFak2019: posts big blind 100
*** HOLE CARDS ***
Dealt to PokerStarsMan12 [Tc Kc]
manon327: folds 
color_singleton: folds 
Jackall23: calls 100
Klemtonius: calls 100
PokerStarsMan12: calls 50
MaFak2019: checks 
*** FLOP *** [3c 6h 2s]
PokerStarsMan12: checks 
MaFak2019: checks 
Jackall23: checks 
Klemtonius: checks 
*** TURN *** [3c 6h 2s] [Qd]
PokerStarsMan12: checks 
MaFak2019: checks 
Jackall23: checks 
Klemtonius: checks 
*** RIVER *** [3c 6h 2s Qd] [5d]
PokerStarsMan12: checks 
MaFak2019: checks 
Jackall23: checks 
Klemtonius: checks 
*** SHOW DOWN ***
PokerStarsMan12: shows [Tc Kc] (high card King)
MaFak2019: shows [6c Jc] (a pair of Sixes)
Jackall23: mucks hand 
Klemtonius: mucks hand 
MaFak2019 collected 378 from pot
*** SUMMARY ***
Total pot 400 | Rake 22 
Board [3c 6h 2s Qd 5d]
Seat 1: color_singleton folded before Flop (didn't bet)
Seat 2: Jackall23 mucked [3s Ah]
Seat 4: Klemtonius (button) mucked [9c Ks]
Seat 5: PokerStarsMan12 (small blind) showed [Tc Kc] and lost with high card King
Seat 8: MaFak2019 (big blind) showed [6c Jc] and won (378) with a pair of Sixes
Seat 9: manon327 folded before Flop (didn't bet)



PokerStars Home Game Hand #226728236865: {DaPokaStars}  Hold'em No Limit (50/100) - 2021/05/13 16:44:23 ET
Table 'again and again' 9-max (Play Money) Seat #5 is the button
Seat 1: color_singleton (10370 in chips) 
Seat 2: Jackall23 (29363 in chips) 
Seat 4: Klemtonius (5941 in chips) 
Seat 5: PokerStarsMan12 (11223 in chips) 
Seat 8: MaFak2019 (38511 in chips) 
Seat 9: manon327 (13418 in chips) 
MaFak2019: posts small blind 50
manon327: posts big blind 100
*** HOLE CARDS ***
Dealt to PokerStarsMan12 [Jc 3c]
color_singleton: folds 
Jackall23: folds 
Klemtonius: raises 100 to 200
PokerStarsMan12: folds 
MaFak2019: calls 150
manon327: calls 100
*** FLOP *** [4c 2s 6h]
MaFak2019: checks 
manon327: checks 
Klemtonius: checks 
*** TURN *** [4c 2s 6h] [Qd]
MaFak2019: checks 
manon327: checks 
Klemtonius: checks 
*** RIVER *** [4c 2s 6h Qd] [8h]
MaFak2019: checks 
manon327: checks 
Klemtonius: checks 
*** SHOW DOWN ***
MaFak2019: shows [Ah 8c] (a pair of Eights)
manon327: mucks hand 
Klemtonius: mucks hand 
MaFak2019 collected 567 from pot
*** SUMMARY ***
Total pot 600 | Rake 33 
Board [4c 2s 6h Qd 8h]
Seat 1: color_singleton folded before Flop (didn't bet)
Seat 2: Jackall23 folded before Flop (didn't bet)
Seat 4: Klemtonius mucked [9h Kh]
Seat 5: PokerStarsMan12 (button) folded before Flop (didn't bet)
Seat 8: MaFak2019 (small blind) showed [Ah 8c] and won (567) with a pair of Eights
Seat 9: manon327 (big blind) mucked [9c Js]



PokerStars Home Game Hand #226728264201: {DaPokaStars}  Hold'em No Limit (50/100) - 2021/05/13 16:45:03 ET
Table 'again and again' 9-max (Play Money) Seat #8 is the button
Seat 1: color_singleton (10370 in chips) 
Seat 2: Jackall23 (29363 in chips) 
Seat 4: Klemtonius (5741 in chips) 
Seat 5: PokerStarsMan12 (11223 in chips) 
Seat 8: MaFak2019 (38878 in chips) 
Seat 9: manon327 (13218 in chips) 
manon327: posts small blind 50
color_singleton: posts big blind 100
*** HOLE CARDS ***
Dealt to PokerStarsMan12 [Td 9d]
Jackall23: folds 
Klemtonius: folds 
PokerStarsMan12: raises 200 to 300
MaFak2019: calls 300
manon327: folds 
color_singleton: calls 200
*** FLOP *** [Kh As 9s]
color_singleton: checks 
PokerStarsMan12: checks 
MaFak2019: checks 
*** TURN *** [Kh As 9s] [Kd]
color_singleton: bets 449
PokerStarsMan12: folds 
MaFak2019: folds 
Uncalled bet (449) returned to color_singleton
color_singleton collected 898 from pot
color_singleton: doesn't show hand 
*** SUMMARY ***
Total pot 950 | Rake 52 
Board [Kh As 9s Kd]
Seat 1: color_singleton (big blind) collected (898)
Seat 2: Jackall23 folded before Flop (didn't bet)
Seat 4: Klemtonius folded before Flop (didn't bet)
Seat 5: PokerStarsMan12 folded on the Turn
Seat 8: MaFak2019 (button) folded on the Turn
Seat 9: manon327 (small blind) folded before Flop



PokerStars Home Game Hand #226728295523: {DaPokaStars}  Hold'em No Limit (50/100) - 2021/05/13 16:45:49 ET
Table 'again and again' 9-max (Play Money) Seat #9 is the button
Seat 1: color_singleton (10968 in chips) 
Seat 2: Jackall23 (29363 in chips) 
Seat 4: Klemtonius (5741 in chips) 
Seat 5: PokerStarsMan12 (10923 in chips) 
Seat 8: MaFak2019 (38578 in chips) 
Seat 9: manon327 (13168 in chips) 
color_singleton: posts small blind 50
Jackall23: posts big blind 100
*** HOLE CARDS ***
Dealt to PokerStarsMan12 [8c 2c]
Klemtonius: raises 100 to 200
PokerStarsMan12: folds 
MaFak2019: raises 300 to 500
manon327: calls 500
color_singleton: folds 
Jackall23: calls 400
Klemtonius: calls 300
*** FLOP *** [5c 3h Jc]
Jackall23: checks 
Klemtonius: bets 1937
MaFak2019: folds 
manon327: folds 
Jackall23: raises 1937 to 3874
Klemtonius: calls 1937
*** TURN *** [5c 3h Jc] [6s]
Jackall23: checks 
Klemtonius: checks 
*** RIVER *** [5c 3h Jc 6s] [Kd]
Jackall23: bets 24989 and is all-in
Klemtonius: folds 
Uncalled bet (24989) returned to Jackall23
Jackall23 collected 9259 from pot
*** SUMMARY ***
Total pot 9798 | Rake 539 
Board [5c 3h Jc 6s Kd]
Seat 1: color_singleton (small blind) folded before Flop
Seat 2: Jackall23 (big blind) collected (9259)
Seat 4: Klemtonius folded on the River
Seat 5: PokerStarsMan12 folded before Flop (didn't bet)
Seat 8: MaFak2019 folded on the Flop
Seat 9: manon327 (button) folded on the Flop



PokerStars Home Game Hand #226728339943: {DaPokaStars}  Hold'em No Limit (50/100) - 2021/05/13 16:46:55 ET
Table 'again and again' 9-max (Play Money) Seat #1 is the button
Seat 1: color_singleton (10918 in chips) 
Seat 2: Jackall23 (34248 in chips) 
Seat 4: Klemtonius (1367 in chips) 
Seat 5: PokerStarsMan12 (10923 in chips) 
Seat 8: MaFak2019 (38078 in chips) 
Seat 9: manon327 (12668 in chips) 
Jackall23: posts small blind 50
Klemtonius: posts big blind 100
*** HOLE CARDS ***
Dealt to PokerStarsMan12 [7s 9h]
PokerStarsMan12: calls 100
MaFak2019: calls 100
manon327: calls 100
color_singleton: raises 200 to 300
Jackall23: calls 250
Klemtonius: calls 200
PokerStarsMan12: calls 200
MaFak2019: calls 200
manon327: calls 200
*** FLOP *** [4d As 7d]
Jackall23: checks 
Klemtonius: checks 
PokerStarsMan12: checks 
MaFak2019: checks 
manon327: checks 
color_singleton: bets 850
Jackall23: folds 
Klemtonius: folds 
PokerStarsMan12: folds 
MaFak2019: folds 
manon327: folds 
Uncalled bet (850) returned to color_singleton
color_singleton collected 1701 from pot
color_singleton: doesn't show hand 
*** SUMMARY ***
Total pot 1800 | Rake 99 
Board [4d As 7d]
Seat 1: color_singleton (button) collected (1701)
Seat 2: Jackall23 (small blind) folded on the Flop
Seat 4: Klemtonius (big blind) folded on the Flop
Seat 5: PokerStarsMan12 folded on the Flop
Seat 8: MaFak2019 folded on the Flop
Seat 9: manon327 folded on the Flop



PokerStars Home Game Hand #226728943506: {DaPokaStars}  Hold'em No Limit (50/100) - 2021/05/13 17:03:33 ET
Table 'again and again' 9-max (Play Money) Seat #2 is the button
Seat 1: color_singleton (29807 in chips) 
Seat 2: Jackall23 (33746 in chips) 
Seat 4: Klemtonius (5899 in chips) 
Seat 5: PokerStarsMan12 (10000 in chips) 
Seat 8: MaFak2019 (28565 in chips) 
Seat 9: manon327 (6211 in chips) 
Klemtonius: posts small blind 50
PokerStarsMan12: posts big blind 100
*** HOLE CARDS ***
Dealt to PokerStarsMan12 [7h 4s]
MaFak2019: raises 300 to 400
manon327: calls 400
color_singleton: calls 400
Jackall23: folds 
Klemtonius: calls 350
PokerStarsMan12: folds 
*** FLOP *** [Qs 2s 3c]
Klemtonius: bets 1606
MaFak2019: calls 1606
manon327: calls 1606
color_singleton: folds 
*** TURN *** [Qs 2s 3c] [Ac]
Klemtonius: checks 
MaFak2019: bets 2345
manon327: calls 2345
Klemtonius: folds 
*** RIVER *** [Qs 2s 3c Ac] [6c]
MaFak2019: bets 24214 and is all-in
manon327: calls 1860 and is all-in
Uncalled bet (22354) returned to MaFak2019
*** SHOW DOWN ***
MaFak2019: shows [Qd Ad] (two pair, Aces and Queens)
manon327: shows [Ks Ah] (a pair of Aces)
MaFak2019 collected 14107 from pot
*** SUMMARY ***
Total pot 14928 | Rake 821 
Board [Qs 2s 3c Ac 6c]
Seat 1: color_singleton folded on the Flop
Seat 2: Jackall23 (button) folded before Flop (didn't bet)
Seat 4: Klemtonius (small blind) folded on the Turn
Seat 5: PokerStarsMan12 (big blind) folded before Flop
Seat 8: MaFak2019 showed [Qd Ad] and won (14107) with two pair, Aces and Queens
Seat 9: manon327 showed [Ks Ah] and lost with a pair of Aces



PokerStars Home Game Hand #226728983795: {DaPokaStars}  Hold'em No Limit (50/100) - 2021/05/13 17:04:38 ET
Table 'again and again' 9-max (Play Money) Seat #4 is the button
Seat 1: color_singleton (29407 in chips) 
Seat 2: Jackall23 (33746 in chips) 
Seat 4: Klemtonius (3893 in chips) 
Seat 5: PokerStarsMan12 (9900 in chips) 
Seat 8: MaFak2019 (36461 in chips) 
PokerStarsMan12: posts small blind 50
MaFak2019: posts big blind 100
*** HOLE CARDS ***
Dealt to PokerStarsMan12 [7h 9s]
color_singleton: folds 
Jackall23: calls 100
Klemtonius: raises 100 to 200
PokerStarsMan12: calls 150
MaFak2019: calls 100
Jackall23: calls 100
*** FLOP *** [3h 7d Tc]
PokerStarsMan12: checks 
MaFak2019: checks 
Jackall23: checks 
Klemtonius: checks 
*** TURN *** [3h 7d Tc] [9d]
PokerStarsMan12: bets 500
MaFak2019: calls 500
Jackall23: folds 
Klemtonius: calls 500
*** RIVER *** [3h 7d Tc 9d] [Ac]
PokerStarsMan12: checks 
MaFak2019: checks 
Klemtonius: checks 
*** SHOW DOWN ***
PokerStarsMan12: shows [7h 9s] (two pair, Nines and Sevens)
MaFak2019: mucks hand 
Klemtonius: mucks hand 
PokerStarsMan12 collected 2173 from pot
*** SUMMARY ***
Total pot 2300 | Rake 127 
Board [3h 7d Tc 9d Ac]
Seat 1: color_singleton folded before Flop (didn't bet)
Seat 2: Jackall23 folded on the Turn
Seat 4: Klemtonius (button) mucked [7s 8s]
Seat 5: PokerStarsMan12 (small blind) showed [7h 9s] and won (2173) with two pair, Nines and Sevens
Seat 8: MaFak2019 (big blind) mucked [Jd 5h]



PokerStars Home Game Hand #226729017945: {DaPokaStars}  Hold'em No Limit (50/100) - 2021/05/13 17:05:32 ET
Table 'again and again' 9-max (Play Money) Seat #5 is the button
Seat 1: color_singleton (29407 in chips) 
Seat 2: Jackall23 (33546 in chips) 
Seat 4: Klemtonius (3193 in chips) 
Seat 5: PokerStarsMan12 (11373 in chips) 
Seat 8: MaFak2019 (35761 in chips) 
Seat 9: manon327 (10000 in chips) 
MaFak2019: posts small blind 50
manon327: posts big blind 100
*** HOLE CARDS ***
Dealt to PokerStarsMan12 [Jh Jc]
color_singleton: folds 
Jackall23: folds 
Klemtonius: calls 100
PokerStarsMan12: raises 300 to 400
MaFak2019: raises 300 to 700
manon327: calls 600
Klemtonius: calls 600
PokerStarsMan12: calls 300
*** FLOP *** [2c 9h Kh]
MaFak2019: bets 1700
manon327: folds 
Klemtonius: folds 
PokerStarsMan12: calls 1700
*** TURN *** [2c 9h Kh] [Js]
MaFak2019: bets 2300
PokerStarsMan12: raises 6673 to 8973 and is all-in
MaFak2019: calls 6673
*** RIVER *** [2c 9h Kh Js] [9c]
*** SHOW DOWN ***
MaFak2019: shows [Ac Ad] (two pair, Aces and Nines)
PokerStarsMan12: shows [Jh Jc] (a full house, Jacks full of Nines)
PokerStarsMan12 collected 22818 from pot
*** SUMMARY ***
Total pot 24146 | Rake 1328 
Board [2c 9h Kh Js 9c]
Seat 1: color_singleton folded before Flop (didn't bet)
Seat 2: Jackall23 folded before Flop (didn't bet)
Seat 4: Klemtonius folded on the Flop
Seat 5: PokerStarsMan12 (button) showed [Jh Jc] and won (22818) with a full house, Jacks full of Nines
Seat 8: MaFak2019 (small blind) showed [Ac Ad] and lost with two pair, Aces and Nines
Seat 9: manon327 (big blind) folded on the Flop



PokerStars Home Game Hand #226729060907: {DaPokaStars}  Hold'em No Limit (50/100) - 2021/05/13 17:06:36 ET
Table 'again and again' 9-max (Play Money) Seat #8 is the button
Seat 1: color_singleton (29407 in chips) 
Seat 2: Jackall23 (33546 in chips) 
Seat 4: Klemtonius (2493 in chips) 
Seat 5: PokerStarsMan12 (22818 in chips) 
Seat 8: MaFak2019 (24388 in chips) 
Seat 9: manon327 (9300 in chips) 
manon327: posts small blind 50
color_singleton: posts big blind 100
*** HOLE CARDS ***
Dealt to PokerStarsMan12 [8s 4c]
Jackall23: calls 100
Klemtonius: raises 350 to 450
PokerStarsMan12: folds 
MaFak2019: calls 450
manon327: folds 
color_singleton: folds 
Jackall23: calls 350
*** FLOP *** [4h 5d Th]
Jackall23: checks 
Klemtonius: checks 
MaFak2019: checks 
*** TURN *** [4h 5d Th] [Js]
Jackall23: checks 
Klemtonius: bets 2043 and is all-in
MaFak2019: calls 2043
Jackall23: folds 
*** RIVER *** [4h 5d Th Js] [9h]
*** SHOW DOWN ***
Klemtonius: shows [2s 2c] (a pair of Deuces)
MaFak2019: shows [Qh 9s] (a pair of Nines)
MaFak2019 collected 5279 from pot
*** SUMMARY ***
Total pot 5586 | Rake 307 
Board [4h 5d Th Js 9h]
Seat 1: color_singleton (big blind) folded before Flop
Seat 2: Jackall23 folded on the Turn
Seat 4: Klemtonius showed [2s 2c] and lost with a pair of Deuces
Seat 5: PokerStarsMan12 folded before Flop (didn't bet)
Seat 8: MaFak2019 (button) showed [Qh 9s] and won (5279) with a pair of Nines
Seat 9: manon327 (small blind) folded before Flop



PokerStars Home Game Hand #226729084665: {DaPokaStars}  Hold'em No Limit (50/100) - 2021/05/13 17:07:16 ET
Table 'again and again' 9-max (Play Money) Seat #9 is the button
Seat 1: color_singleton (29307 in chips) 
Seat 2: Jackall23 (33096 in chips) 
Seat 5: PokerStarsMan12 (22818 in chips) 
Seat 8: MaFak2019 (27174 in chips) 
Seat 9: manon327 (9250 in chips) 
color_singleton: posts small blind 50
Jackall23: posts big blind 100
*** HOLE CARDS ***
Dealt to PokerStarsMan12 [7c 4h]
PokerStarsMan12: folds 
MaFak2019: raises 100 to 200
manon327: calls 200
color_singleton: calls 150
Jackall23: calls 100
*** FLOP *** [Ks 3s 8c]
color_singleton: checks 
Jackall23: checks 
MaFak2019: checks 
manon327: checks 
*** TURN *** [Ks 3s 8c] [3h]
color_singleton: checks 
Jackall23: checks 
MaFak2019: checks 
manon327: checks 
*** RIVER *** [Ks 3s 8c 3h] [6c]
color_singleton: checks 
Jackall23: checks 
MaFak2019: checks 
manon327: checks 
*** SHOW DOWN ***
color_singleton: shows [Qc 7d] (a pair of Threes)
Jackall23: mucks hand 
MaFak2019: mucks hand 
manon327: shows [Jd Qh] (a pair of Threes - King+Queen+Jack kicker)
manon327 collected 756 from pot
*** SUMMARY ***
Total pot 800 | Rake 44 
Board [Ks 3s 8c 3h 6c]
Seat 1: color_singleton (small blind) showed [Qc 7d] and lost with a pair of Threes
Seat 2: Jackall23 (big blind) mucked [5s 4d]
Seat 5: PokerStarsMan12 folded before Flop (didn't bet)
Seat 8: MaFak2019 mucked [9h Jh]
Seat 9: manon327 (button) showed [Jd Qh] and won (756) with a pair of Threes



PokerStars Home Game Hand #226729107296: {DaPokaStars}  Hold'em No Limit (50/100) - 2021/05/13 17:07:54 ET
Table 'again and again' 9-max (Play Money) Seat #1 is the button
Seat 1: color_singleton (29107 in chips) 
Seat 2: Jackall23 (32896 in chips) 
Seat 4: Klemtonius (10000 in chips) 
Seat 5: PokerStarsMan12 (22818 in chips) 
Seat 8: MaFak2019 (26974 in chips) 
Seat 9: manon327 (9806 in chips) 
Jackall23: posts small blind 50
Klemtonius: posts big blind 100
*** HOLE CARDS ***
Dealt to PokerStarsMan12 [Js Td]
PokerStarsMan12: calls 100
MaFak2019: folds 
manon327: calls 100
color_singleton: calls 100
Jackall23: folds 
Klemtonius: raises 450 to 550
PokerStarsMan12: calls 450
manon327: calls 450
color_singleton: calls 450
*** FLOP *** [5s 3s Kc]
Klemtonius: checks 
PokerStarsMan12: checks 
manon327: checks 
color_singleton: checks 
*** TURN *** [5s 3s Kc] [9h]
Klemtonius: checks 
PokerStarsMan12: checks 
manon327: checks 
color_singleton: checks 
*** RIVER *** [5s 3s Kc 9h] [5c]
Klemtonius: bets 1063
PokerStarsMan12: folds 
manon327: folds 
color_singleton: folds 
Uncalled bet (1063) returned to Klemtonius
Klemtonius collected 2126 from pot
Klemtonius: doesn't show hand 
*** SUMMARY ***
Total pot 2250 | Rake 124 
Board [5s 3s Kc 9h 5c]
Seat 1: color_singleton (button) folded on the River
Seat 2: Jackall23 (small blind) folded before Flop
Seat 4: Klemtonius (big blind) collected (2126)
Seat 5: PokerStarsMan12 folded on the River
Seat 8: MaFak2019 folded before Flop (didn't bet)
Seat 9: manon327 folded on the River



PokerStars Home Game Hand #226729140271: {DaPokaStars}  Hold'em No Limit (50/100) - 2021/05/13 17:08:52 ET
Table 'again and again' 9-max (Play Money) Seat #2 is the button
Seat 1: color_singleton (28557 in chips) 
Seat 2: Jackall23 (32846 in chips) 
Seat 4: Klemtonius (11576 in chips) 
Seat 5: PokerStarsMan12 (22268 in chips) 
Seat 8: MaFak2019 (26974 in chips) 
Seat 9: manon327 (9256 in chips) 
Klemtonius: posts small blind 50
PokerStarsMan12: posts big blind 100
*** HOLE CARDS ***
Dealt to PokerStarsMan12 [Ah Qh]
MaFak2019: calls 100
manon327: folds 
color_singleton: calls 100
Jackall23: folds 
Klemtonius: calls 50
PokerStarsMan12: checks 
*** FLOP *** [Ad 4d As]
Klemtonius: checks 
PokerStarsMan12: checks 
MaFak2019: checks 
color_singleton: checks 
*** TURN *** [Ad 4d As] [6c]
Klemtonius: checks 
PokerStarsMan12: bets 300
MaFak2019: folds 
color_singleton: folds 
Klemtonius: folds 
Uncalled bet (300) returned to PokerStarsMan12
PokerStarsMan12 collected 378 from pot
*** SUMMARY ***
Total pot 400 | Rake 22 
Board [Ad 4d As 6c]
Seat 1: color_singleton folded on the Turn
Seat 2: Jackall23 (button) folded before Flop (didn't bet)
Seat 4: Klemtonius (small blind) folded on the Turn
Seat 5: PokerStarsMan12 (big blind) collected (378)
Seat 8: MaFak2019 folded on the Turn
Seat 9: manon327 folded before Flop (didn't bet)



PokerStars Home Game Hand #226729167857: {DaPokaStars}  Hold'em No Limit (50/100) - 2021/05/13 17:09:43 ET
Table 'again and again' 9-max (Play Money) Seat #4 is the button
Seat 1: color_singleton (28457 in chips) 
Seat 2: Jackall23 (32846 in chips) 
Seat 4: Klemtonius (11476 in chips) 
Seat 5: PokerStarsMan12 (22546 in chips) 
Seat 8: MaFak2019 (26874 in chips) 
Seat 9: manon327 (9256 in chips) 
PokerStarsMan12: posts small blind 50
MaFak2019: posts big blind 100
*** HOLE CARDS ***
Dealt to PokerStarsMan12 [7d Kc]
manon327: calls 100
color_singleton: folds 
Jackall23: calls 100
Klemtonius: calls 100
PokerStarsMan12: calls 50
MaFak2019: checks 
*** FLOP *** [8s 9h 6c]
PokerStarsMan12: bets 300
MaFak2019: calls 300
manon327: calls 300
Jackall23: folds 
Klemtonius: folds 
*** TURN *** [8s 9h 6c] [3d]
PokerStarsMan12: checks 
MaFak2019: checks 
manon327: checks 
*** RIVER *** [8s 9h 6c 3d] [3s]
PokerStarsMan12: checks 
MaFak2019: checks 
manon327: checks 
*** SHOW DOWN ***
PokerStarsMan12: shows [7d Kc] (a pair of Threes)
MaFak2019: shows [As 9d] (two pair, Nines and Threes)
manon327: mucks hand 
MaFak2019 collected 1323 from pot
*** SUMMARY ***
Total pot 1400 | Rake 77 
Board [8s 9h 6c 3d 3s]
Seat 1: color_singleton folded before Flop (didn't bet)
Seat 2: Jackall23 folded on the Flop
Seat 4: Klemtonius (button) folded on the Flop
Seat 5: PokerStarsMan12 (small blind) showed [7d Kc] and lost with a pair of Threes
Seat 8: MaFak2019 (big blind) showed [As 9d] and won (1323) with two pair, Nines and Threes
Seat 9: manon327 mucked [7s Ac]



PokerStars Home Game Hand #226729191315: {DaPokaStars}  Hold'em No Limit (50/100) - 2021/05/13 17:10:25 ET
Table 'again and again' 9-max (Play Money) Seat #5 is the button
Seat 1: color_singleton (28457 in chips) 
Seat 2: Jackall23 (32746 in chips) 
Seat 4: Klemtonius (11376 in chips) 
Seat 5: PokerStarsMan12 (22146 in chips) 
Seat 8: MaFak2019 (27797 in chips) 
Seat 9: manon327 (8856 in chips) 
MaFak2019: posts small blind 50
manon327: posts big blind 100
*** HOLE CARDS ***
Dealt to PokerStarsMan12 [4c Tc]
color_singleton: raises 200 to 300
Jackall23: calls 300
Klemtonius: calls 300
PokerStarsMan12: folds 
MaFak2019: calls 250
manon327: calls 200
*** FLOP *** [2d Jd 8c]
MaFak2019: checks 
manon327: checks 
color_singleton: bets 708
Jackall23: folds 
Klemtonius: folds 
MaFak2019: calls 708
manon327: calls 708
*** TURN *** [2d Jd 8c] [Ks]
MaFak2019: checks 
manon327: bets 3425
color_singleton: folds 
MaFak2019: calls 3425
*** RIVER *** [2d Jd 8c Ks] [7s]
MaFak2019: checks 
manon327: checks 
*** SHOW DOWN ***
MaFak2019: shows [Qh Ts] (high card King)
manon327: shows [Kd Ac] (a pair of Kings)
manon327 collected 9898 from pot
*** SUMMARY ***
Total pot 10474 | Rake 576 
Board [2d Jd 8c Ks 7s]
Seat 1: color_singleton folded on the Turn
Seat 2: Jackall23 folded on the Flop
Seat 4: Klemtonius folded on the Flop
Seat 5: PokerStarsMan12 (button) folded before Flop (didn't bet)
Seat 8: MaFak2019 (small blind) showed [Qh Ts] and lost with high card King
Seat 9: manon327 (big blind) showed [Kd Ac] and won (9898) with a pair of Kings



PokerStars Home Game Hand #226729224666: {DaPokaStars}  Hold'em No Limit (50/100) - 2021/05/13 17:11:25 ET
Table 'again and again' 9-max (Play Money) Seat #8 is the button
Seat 1: color_singleton (27449 in chips) 
Seat 2: Jackall23 (32446 in chips) 
Seat 5: PokerStarsMan12 (22146 in chips) 
Seat 8: MaFak2019 (23364 in chips) 
Seat 9: manon327 (14321 in chips) 
manon327: posts small blind 50
color_singleton: posts big blind 100
*** HOLE CARDS ***
Dealt to PokerStarsMan12 [Ah Qd]
Jackall23: calls 100
PokerStarsMan12: raises 300 to 400
MaFak2019: calls 400
manon327: calls 350
color_singleton: folds 
Jackall23: calls 300
*** FLOP *** [8h 6c 3d]
manon327: checks 
Jackall23: checks 
PokerStarsMan12: checks 
MaFak2019: bets 500
manon327: folds 
Jackall23: calls 500
PokerStarsMan12: calls 500
*** TURN *** [8h 6c 3d] [3h]
Jackall23: checks 
PokerStarsMan12: checks 
MaFak2019: checks 
*** RIVER *** [8h 6c 3d 3h] [Th]
Jackall23: checks 
PokerStarsMan12: bets 1200
MaFak2019: folds 
Jackall23: folds 
Uncalled bet (1200) returned to PokerStarsMan12
PokerStarsMan12 collected 3024 from pot
*** SUMMARY ***
Total pot 3200 | Rake 176 
Board [8h 6c 3d 3h Th]
Seat 1: color_singleton (big blind) folded before Flop
Seat 2: Jackall23 folded on the River
Seat 5: PokerStarsMan12 collected (3024)
Seat 8: MaFak2019 (button) folded on the River
Seat 9: manon327 (small blind) folded on the Flop



PokerStars Home Game Hand #226729251385: {DaPokaStars}  Hold'em No Limit (50/100) - 2021/05/13 17:12:14 ET
Table 'again and again' 9-max (Play Money) Seat #9 is the button
Seat 1: color_singleton (27349 in chips) 
Seat 2: Jackall23 (31546 in chips) 
Seat 5: PokerStarsMan12 (24270 in chips) 
Seat 8: MaFak2019 (22464 in chips) 
Seat 9: manon327 (13921 in chips) 
color_singleton: posts small blind 50
Jackall23: posts big blind 100
*** HOLE CARDS ***
Dealt to PokerStarsMan12 [4c Td]
PokerStarsMan12: folds 
MaFak2019: calls 100
manon327: calls 100
color_singleton: raises 200 to 300
Jackall23: calls 200
MaFak2019: calls 200
manon327: calls 200
*** FLOP *** [7d 4s Kd]
color_singleton: checks 
Jackall23: checks 
MaFak2019: checks 
manon327: checks 
*** TURN *** [7d 4s Kd] [Qd]
color_singleton: bets 567
Jackall23: folds 
MaFak2019: calls 567
manon327: folds 
*** RIVER *** [7d 4s Kd Qd] [Th]
color_singleton: checks 
MaFak2019: checks 
*** SHOW DOWN ***
color_singleton: shows [Js Qh] (a pair of Queens)
MaFak2019: mucks hand 
color_singleton collected 2206 from pot
*** SUMMARY ***
Total pot 2334 | Rake 128 
Board [7d 4s Kd Qd Th]
Seat 1: color_singleton (small blind) showed [Js Qh] and won (2206) with a pair of Queens
Seat 2: Jackall23 (big blind) folded on the Turn
Seat 5: PokerStarsMan12 folded before Flop (didn't bet)
Seat 8: MaFak2019 mucked [5h 6s]
Seat 9: manon327 (button) folded on the Turn



PokerStars Home Game Hand #226729277496: {DaPokaStars}  Hold'em No Limit (50/100) - 2021/05/13 17:13:02 ET
Table 'again and again' 9-max (Play Money) Seat #1 is the button
Seat 1: color_singleton (28688 in chips) 
Seat 2: Jackall23 (31246 in chips) 
Seat 5: PokerStarsMan12 (24270 in chips) 
Seat 8: MaFak2019 (21597 in chips) 
Seat 9: manon327 (13621 in chips) 
Jackall23: posts small blind 50
PokerStarsMan12: posts big blind 100
*** HOLE CARDS ***
Dealt to PokerStarsMan12 [5c Qh]
MaFak2019: folds 
manon327: calls 100
color_singleton: folds 
Jackall23: calls 50
PokerStarsMan12: checks 
*** FLOP *** [8s Ks Jd]
Jackall23: checks 
PokerStarsMan12: checks 
manon327: checks 
*** TURN *** [8s Ks Jd] [8d]
Jackall23: bets 141
PokerStarsMan12: folds 
manon327: calls 141
*** RIVER *** [8s Ks Jd 8d] [Jh]
Jackall23: bets 275
manon327: raises 275 to 550
Jackall23: raises 275 to 825
manon327: raises 275 to 1100
Jackall23: raises 275 to 1375
manon327: raises 275 to 1650
Jackall23: raises 275 to 1925
manon327: raises 275 to 2200
Jackall23: raises 275 to 2475
manon327: calls 275
*** SHOW DOWN ***
Jackall23: shows [3c 8c] (a full house, Eights full of Jacks)
manon327: shows [Jc 3s] (a full house, Jacks full of Eights)
manon327 collected 5228 from pot
*** SUMMARY ***
Total pot 5532 | Rake 304 
Board [8s Ks Jd 8d Jh]
Seat 1: color_singleton (button) folded before Flop (didn't bet)
Seat 2: Jackall23 (small blind) showed [3c 8c] and lost with a full house, Eights full of Jacks
Seat 5: PokerStarsMan12 (big blind) folded on the Turn
Seat 8: MaFak2019 folded before Flop (didn't bet)
Seat 9: manon327 showed [Jc 3s] and won (5228) with a full house, Jacks full of Eights



PokerStars Home Game Hand #226729310446: {DaPokaStars}  Hold'em No Limit (50/100) - 2021/05/13 17:14:04 ET
Table 'again and again' 9-max (Play Money) Seat #2 is the button
Seat 1: color_singleton (28688 in chips) 
Seat 2: Jackall23 (28530 in chips) 
Seat 5: PokerStarsMan12 (24170 in chips) 
Seat 8: MaFak2019 (21597 in chips) 
Seat 9: manon327 (16133 in chips) 
PokerStarsMan12: posts small blind 50
MaFak2019: posts big blind 100
*** HOLE CARDS ***
Dealt to PokerStarsMan12 [2h 2d]
manon327: folds 
color_singleton: raises 200 to 300
Jackall23: folds 
PokerStarsMan12: calls 250
MaFak2019: raises 200 to 500
color_singleton: calls 200
PokerStarsMan12: calls 200
*** FLOP *** [4h 9h Tc]
PokerStarsMan12: checks 
MaFak2019: checks 
color_singleton: checks 
*** TURN *** [4h 9h Tc] [5d]
PokerStarsMan12: bets 1000
MaFak2019: calls 1000
color_singleton: calls 1000
*** RIVER *** [4h 9h Tc 5d] [Kc]
PokerStarsMan12: checks 
MaFak2019: checks 
color_singleton: checks 
*** SHOW DOWN ***
PokerStarsMan12: shows [2h 2d] (a pair of Deuces)
MaFak2019: shows [3h 3c] (a pair of Threes)
color_singleton: shows [5h 7h] (a pair of Fives)
color_singleton collected 4252 from pot
*** SUMMARY ***
Total pot 4500 | Rake 248 
Board [4h 9h Tc 5d Kc]
Seat 1: color_singleton showed [5h 7h] and won (4252) with a pair of Fives
Seat 2: Jackall23 (button) folded before Flop (didn't bet)
Seat 5: PokerStarsMan12 (small blind) showed [2h 2d] and lost with a pair of Deuces
Seat 8: MaFak2019 (big blind) showed [3h 3c] and lost with a pair of Threes
Seat 9: manon327 folded before Flop (didn't bet)



PokerStars Home Game Hand #226729338186: {DaPokaStars}  Hold'em No Limit (50/100) - 2021/05/13 17:14:56 ET
Table 'again and again' 9-max (Play Money) Seat #5 is the button
Seat 1: color_singleton (31440 in chips) 
Seat 2: Jackall23 (28530 in chips) 
Seat 5: PokerStarsMan12 (22670 in chips) 
Seat 8: MaFak2019 (20097 in chips) 
Seat 9: manon327 (16133 in chips) 
MaFak2019: posts small blind 50
manon327: posts big blind 100
*** HOLE CARDS ***
Dealt to PokerStarsMan12 [6h 3h]
color_singleton: folds 
Jackall23: folds 
PokerStarsMan12: calls 100
MaFak2019: raises 400 to 500
manon327: calls 400
PokerStarsMan12: folds 
*** FLOP *** [Kh As 8d]
MaFak2019: bets 1000
manon327: folds 
Uncalled bet (1000) returned to MaFak2019
MaFak2019 collected 1039 from pot
MaFak2019: doesn't show hand 
*** SUMMARY ***
Total pot 1100 | Rake 61 
Board [Kh As 8d]
Seat 1: color_singleton folded before Flop (didn't bet)
Seat 2: Jackall23 folded before Flop (didn't bet)
Seat 5: PokerStarsMan12 (button) folded before Flop
Seat 8: MaFak2019 (small blind) collected (1039)
Seat 9: manon327 (big blind) folded on the Flop



PokerStars Home Game Hand #226729350772: {DaPokaStars}  Hold'em No Limit (50/100) - 2021/05/13 17:15:20 ET
Table 'again and again' 9-max (Play Money) Seat #8 is the button
Seat 1: color_singleton (31440 in chips) 
Seat 2: Jackall23 (28530 in chips) 
Seat 5: PokerStarsMan12 (22570 in chips) 
Seat 8: MaFak2019 (20636 in chips) 
Seat 9: manon327 (15633 in chips) 
manon327: posts small blind 50
color_singleton: posts big blind 100
*** HOLE CARDS ***
Dealt to PokerStarsMan12 [3d 2c]
Jackall23: folds 
PokerStarsMan12: folds 
MaFak2019: calls 100
manon327: calls 50
color_singleton: raises 300 to 400
MaFak2019: folds 
manon327: calls 300
*** FLOP *** [Ad Ks 2d]
manon327: bets 425
color_singleton: calls 425
*** TURN *** [Ad Ks 2d] [8s]
manon327: bets 827
color_singleton: calls 827
*** RIVER *** [Ad Ks 2d 8s] [7s]
manon327: bets 3217
color_singleton: calls 3217
*** SHOW DOWN ***
manon327: shows [7d Kd] (two pair, Kings and Sevens)
color_singleton: mucks hand 
manon327 collected 9297 from pot
*** SUMMARY ***
Total pot 9838 | Rake 541 
Board [Ad Ks 2d 8s 7s]
Seat 1: color_singleton (big blind) mucked [Ts Ah]
Seat 2: Jackall23 folded before Flop (didn't bet)
Seat 5: PokerStarsMan12 folded before Flop (didn't bet)
Seat 8: MaFak2019 (button) folded before Flop
Seat 9: manon327 (small blind) showed [7d Kd] and won (9297) with two pair, Kings and Sevens



PokerStars Home Game Hand #226729384795: {DaPokaStars}  Hold'em No Limit (50/100) - 2021/05/13 17:16:24 ET
Table 'again and again' 9-max (Play Money) Seat #9 is the button
Seat 1: color_singleton (26571 in chips) 
Seat 2: Jackall23 (28530 in chips) 
Seat 5: PokerStarsMan12 (22570 in chips) 
Seat 8: MaFak2019 (20536 in chips) 
Seat 9: manon327 (20061 in chips) 
color_singleton: posts small blind 50
Jackall23: posts big blind 100
*** HOLE CARDS ***
Dealt to PokerStarsMan12 [2s 6h]
PokerStarsMan12: folds 
MaFak2019: folds 
manon327: calls 100
color_singleton: raises 200 to 300
Jackall23: folds 
manon327: folds 
Uncalled bet (200) returned to color_singleton
color_singleton collected 300 from pot
color_singleton: doesn't show hand 
*** SUMMARY ***
Total pot 300 | Rake 0 
Seat 1: color_singleton (small blind) collected (300)
Seat 2: Jackall23 (big blind) folded before Flop
Seat 5: PokerStarsMan12 folded before Flop (didn't bet)
Seat 8: MaFak2019 folded before Flop (didn't bet)
Seat 9: manon327 (button) folded before Flop



PokerStars Home Game Hand #226729393906: {DaPokaStars}  Hold'em No Limit (50/100) - 2021/05/13 17:16:41 ET
Table 'again and again' 9-max (Play Money) Seat #1 is the button
Seat 1: color_singleton (26771 in chips) 
Seat 2: Jackall23 (28430 in chips) 
Seat 5: PokerStarsMan12 (22570 in chips) 
Seat 8: MaFak2019 (20536 in chips) 
Seat 9: manon327 (19961 in chips) 
Jackall23: posts small blind 50
PokerStarsMan12: posts big blind 100
*** HOLE CARDS ***
Dealt to PokerStarsMan12 [3s 6h]
MaFak2019: calls 100
manon327: folds 
color_singleton: raises 100 to 200
Jackall23: folds 
PokerStarsMan12: folds 
MaFak2019: calls 100
*** FLOP *** [3c 9d 8c]
MaFak2019: checks 
color_singleton: checks 
*** TURN *** [3c 9d 8c] [Js]
MaFak2019: checks 
color_singleton: bets 520
MaFak2019: folds 
Uncalled bet (520) returned to color_singleton
color_singleton collected 520 from pot
color_singleton: doesn't show hand 
*** SUMMARY ***
Total pot 550 | Rake 30 
Board [3c 9d 8c Js]
Seat 1: color_singleton (button) collected (520)
Seat 2: Jackall23 (small blind) folded before Flop
Seat 5: PokerStarsMan12 (big blind) folded before Flop
Seat 8: MaFak2019 folded on the Turn
Seat 9: manon327 folded before Flop (didn't bet)



PokerStars Home Game Hand #226729405971: {DaPokaStars}  Hold'em No Limit (50/100) - 2021/05/13 17:17:04 ET
Table 'again and again' 9-max (Play Money) Seat #2 is the button
Seat 1: color_singleton (27091 in chips) 
Seat 2: Jackall23 (28380 in chips) 
Seat 5: PokerStarsMan12 (22470 in chips) 
Seat 8: MaFak2019 (20336 in chips) 
Seat 9: manon327 (19961 in chips) 
PokerStarsMan12: posts small blind 50
MaFak2019: posts big blind 100
*** HOLE CARDS ***
Dealt to PokerStarsMan12 [7h Th]
manon327: calls 100
color_singleton: folds 
Jackall23: calls 100
PokerStarsMan12: calls 50
MaFak2019: checks 
*** FLOP *** [4h Tc 8c]
PokerStarsMan12: bets 300
MaFak2019: raises 300 to 600
manon327: calls 600
Jackall23: folds 
PokerStarsMan12: calls 300
*** TURN *** [4h Tc 8c] [Ts]
PokerStarsMan12: checks 
MaFak2019: checks 
manon327: checks 
*** RIVER *** [4h Tc 8c Ts] [2h]
PokerStarsMan12: bets 2100
MaFak2019: folds 
manon327: folds 
Uncalled bet (2100) returned to PokerStarsMan12
PokerStarsMan12 collected 2079 from pot
*** SUMMARY ***
Total pot 2200 | Rake 121 
Board [4h Tc 8c Ts 2h]
Seat 1: color_singleton folded before Flop (didn't bet)
Seat 2: Jackall23 (button) folded on the Flop
Seat 5: PokerStarsMan12 (small blind) collected (2079)
Seat 8: MaFak2019 (big blind) folded on the River
Seat 9: manon327 folded on the River



PokerStars Home Game Hand #226729435504: {DaPokaStars}  Hold'em No Limit (50/100) - 2021/05/13 17:17:59 ET
Table 'again and again' 9-max (Play Money) Seat #5 is the button
Seat 1: color_singleton (27091 in chips) 
Seat 2: Jackall23 (28280 in chips) 
Seat 5: PokerStarsMan12 (23849 in chips) 
Seat 8: MaFak2019 (19636 in chips) 
Seat 9: manon327 (19261 in chips) 
MaFak2019: posts small blind 50
manon327: posts big blind 100
*** HOLE CARDS ***
Dealt to PokerStarsMan12 [Ks 6s]
color_singleton: folds 
Jackall23: calls 100
PokerStarsMan12: calls 100
MaFak2019: raises 300 to 400
manon327: calls 300
Jackall23: folds 
PokerStarsMan12: folds 
*** FLOP *** [3h 9s 8c]
MaFak2019: bets 1500
manon327: folds 
Uncalled bet (1500) returned to MaFak2019
MaFak2019 collected 945 from pot
MaFak2019: doesn't show hand 
*** SUMMARY ***
Total pot 1000 | Rake 55 
Board [3h 9s 8c]
Seat 1: color_singleton folded before Flop (didn't bet)
Seat 2: Jackall23 folded before Flop
Seat 5: PokerStarsMan12 (button) folded before Flop
Seat 8: MaFak2019 (small blind) collected (945)
Seat 9: manon327 (big blind) folded on the Flop



PokerStars Home Game Hand #226729454418: {DaPokaStars}  Hold'em No Limit (50/100) - 2021/05/13 17:18:34 ET
Table 'again and again' 9-max (Play Money) Seat #8 is the button
Seat 1: color_singleton (27091 in chips) 
Seat 2: Jackall23 (28180 in chips) 
Seat 5: PokerStarsMan12 (23749 in chips) 
Seat 8: MaFak2019 (20181 in chips) 
Seat 9: manon327 (18861 in chips) 
manon327: posts small blind 50
color_singleton: posts big blind 100
*** HOLE CARDS ***
Dealt to PokerStarsMan12 [3s 2d]
Jackall23: folds 
PokerStarsMan12: folds 
MaFak2019: calls 100
manon327: calls 50
color_singleton: checks 
*** FLOP *** [Kd 4d Js]
manon327: bets 141
color_singleton: folds 
MaFak2019: calls 141
*** TURN *** [Kd 4d Js] [6h]
manon327: bets 275
MaFak2019: calls 275
*** RIVER *** [Kd 4d Js 6h] [Tc]
manon327: bets 1070
MaFak2019: raises 1070 to 2140
manon327: calls 1070
*** SHOW DOWN ***
MaFak2019: shows [Td 4c] (two pair, Tens and Fours)
manon327: shows [6s Jh] (two pair, Jacks and Sixes)
manon327 collected 5114 from pot
*** SUMMARY ***
Total pot 5412 | Rake 298 
Board [Kd 4d Js 6h Tc]
Seat 1: color_singleton (big blind) folded on the Flop
Seat 2: Jackall23 folded before Flop (didn't bet)
Seat 5: PokerStarsMan12 folded before Flop (didn't bet)
Seat 8: MaFak2019 (button) showed [Td 4c] and lost with two pair, Tens and Fours
Seat 9: manon327 (small blind) showed [6s Jh] and won (5114) with two pair, Jacks and Sixes



PokerStars Home Game Hand #226729476001: {DaPokaStars}  Hold'em No Limit (50/100) - 2021/05/13 17:19:15 ET
Table 'again and again' 9-max (Play Money) Seat #9 is the button
Seat 1: color_singleton (26991 in chips) 
Seat 2: Jackall23 (28180 in chips) 
Seat 5: PokerStarsMan12 (23749 in chips) 
Seat 8: MaFak2019 (17525 in chips) 
Seat 9: manon327 (21319 in chips) 
color_singleton: posts small blind 50
Jackall23: posts big blind 100
*** HOLE CARDS ***
Dealt to PokerStarsMan12 [3h 5h]
PokerStarsMan12: calls 100
MaFak2019: raises 700 to 800
manon327: folds 
color_singleton: folds 
Jackall23: folds 
PokerStarsMan12: folds 
Uncalled bet (700) returned to MaFak2019
MaFak2019 collected 350 from pot
MaFak2019: doesn't show hand 
*** SUMMARY ***
Total pot 350 | Rake 0 
Seat 1: color_singleton (small blind) folded before Flop
Seat 2: Jackall23 (big blind) folded before Flop
Seat 5: PokerStarsMan12 folded before Flop
Seat 8: MaFak2019 collected (350)
Seat 9: manon327 (button) folded before Flop (didn't bet)



PokerStars Home Game Hand #226729488145: {DaPokaStars}  Hold'em No Limit (50/100) - 2021/05/13 17:19:38 ET
Table 'again and again' 9-max (Play Money) Seat #1 is the button
Seat 1: color_singleton (26941 in chips) 
Seat 2: Jackall23 (28080 in chips) 
Seat 5: PokerStarsMan12 (23649 in chips) 
Seat 8: MaFak2019 (17775 in chips) 
Seat 9: manon327 (21319 in chips) 
Jackall23: posts small blind 50
PokerStarsMan12: posts big blind 100
*** HOLE CARDS ***
Dealt to PokerStarsMan12 [Kc 4d]
MaFak2019: calls 100
manon327: calls 100
color_singleton: folds 
Jackall23: folds 
PokerStarsMan12: checks 
*** FLOP *** [7d Jc 7h]
PokerStarsMan12: checks 
MaFak2019: checks 
manon327: bets 165
PokerStarsMan12: folds 
MaFak2019: calls 165
*** TURN *** [7d Jc 7h] [Kd]
MaFak2019: checks 
manon327: bets 643
MaFak2019: raises 643 to 1286
manon327: calls 643
*** RIVER *** [7d Jc 7h Kd] [2s]
MaFak2019: checks 
manon327: bets 3073
MaFak2019: raises 13151 to 16224 and is all-in
manon327: calls 13151
*** SHOW DOWN ***
MaFak2019: shows [Kh 4s] (two pair, Kings and Sevens)
manon327: shows [Jh 3h] (two pair, Jacks and Sevens)
MaFak2019 collected 33736 from pot
*** SUMMARY ***
Total pot 35700 | Rake 1964 
Board [7d Jc 7h Kd 2s]
Seat 1: color_singleton (button) folded before Flop (didn't bet)
Seat 2: Jackall23 (small blind) folded before Flop
Seat 5: PokerStarsMan12 (big blind) folded on the Flop
Seat 8: MaFak2019 showed [Kh 4s] and won (33736) with two pair, Kings and Sevens
Seat 9: manon327 showed [Jh 3h] and lost with two pair, Jacks and Sevens



PokerStars Home Game Hand #226729517620: {DaPokaStars}  Hold'em No Limit (50/100) - 2021/05/13 17:20:34 ET
Table 'again and again' 9-max (Play Money) Seat #2 is the button
Seat 1: color_singleton (26941 in chips) 
Seat 2: Jackall23 (28030 in chips) 
Seat 5: PokerStarsMan12 (23549 in chips) 
Seat 8: MaFak2019 (33736 in chips) 
Seat 9: manon327 (3544 in chips) 
PokerStarsMan12: posts small blind 50
MaFak2019: posts big blind 100
*** HOLE CARDS ***
Dealt to PokerStarsMan12 [Ah 7d]
manon327: calls 100
color_singleton: raises 100 to 200
Jackall23: calls 200
PokerStarsMan12: calls 150
MaFak2019: calls 100
manon327: calls 100
*** FLOP *** [Qd 6h 7c]
PokerStarsMan12: checks 
MaFak2019: checks 
manon327: checks 
color_singleton: checks 
Jackall23: checks 
*** TURN *** [Qd 6h 7c] [9s]
PokerStarsMan12: bets 500
MaFak2019: folds 
manon327: folds 
color_singleton: calls 500
Jackall23: folds 
*** RIVER *** [Qd 6h 7c 9s] [7s]
PokerStarsMan12: bets 1400
color_singleton: folds 
Uncalled bet (1400) returned to PokerStarsMan12
PokerStarsMan12 collected 1890 from pot
*** SUMMARY ***
Total pot 2000 | Rake 110 
Board [Qd 6h 7c 9s 7s]
Seat 1: color_singleton folded on the River
Seat 2: Jackall23 (button) folded on the Turn
Seat 5: PokerStarsMan12 (small blind) collected (1890)
Seat 8: MaFak2019 (big blind) folded on the Turn
Seat 9: manon327 folded on the Turn



PokerStars Home Game Hand #226729550201: {DaPokaStars}  Hold'em No Limit (50/100) - 2021/05/13 17:21:24 ET
Table 'again and again' 9-max (Play Money) Seat #5 is the button
Seat 1: color_singleton (26241 in chips) 
Seat 2: Jackall23 (27830 in chips) 
Seat 5: PokerStarsMan12 (24739 in chips) 
Seat 8: MaFak2019 (33536 in chips) 
Seat 9: manon327 (3344 in chips) 
MaFak2019: posts small blind 50
manon327: posts big blind 100
*** HOLE CARDS ***
Dealt to PokerStarsMan12 [6d 5h]
color_singleton: folds 
Jackall23: folds 
PokerStarsMan12: calls 100
MaFak2019: calls 50
manon327: checks 
*** FLOP *** [Jc Js Td]
MaFak2019: checks 
manon327: checks 
PokerStarsMan12: checks 
*** TURN *** [Jc Js Td] [Ac]
MaFak2019: checks 
manon327: checks 
PokerStarsMan12: checks 
*** RIVER *** [Jc Js Td Ac] [Kc]
MaFak2019: bets 1021
manon327: folds 
PokerStarsMan12: folds 
Uncalled bet (1021) returned to MaFak2019
MaFak2019 collected 283 from pot
MaFak2019: doesn't show hand 
*** SUMMARY ***
Total pot 300 | Rake 17 
Board [Jc Js Td Ac Kc]
Seat 1: color_singleton folded before Flop (didn't bet)
Seat 2: Jackall23 folded before Flop (didn't bet)
Seat 5: PokerStarsMan12 (button) folded on the River
Seat 8: MaFak2019 (small blind) collected (283)
Seat 9: manon327 (big blind) folded on the River



PokerStars Home Game Hand #226729586334: {DaPokaStars}  Hold'em No Limit (50/100) - 2021/05/13 17:22:29 ET
Table 'again and again' 9-max (Play Money) Seat #8 is the button
Seat 1: color_singleton (26241 in chips) 
Seat 2: Jackall23 (27830 in chips) 
Seat 4: Klemtonius (11076 in chips) 
Seat 5: PokerStarsMan12 (24639 in chips) 
Seat 8: MaFak2019 (33719 in chips) 
Seat 9: manon327 (3244 in chips) 
manon327: posts small blind 50
color_singleton: posts big blind 100
Klemtonius: posts small & big blinds 150
*** HOLE CARDS ***
Dealt to PokerStarsMan12 [6h Ts]
Jackall23: calls 100
Klemtonius: checks 
PokerStarsMan12: folds 
MaFak2019: calls 100
manon327: folds 
color_singleton: raises 200 to 300
Jackall23: calls 200
Klemtonius: calls 200
MaFak2019: calls 200
*** FLOP *** [6d 4c Kh]
color_singleton: checks 
Jackall23: checks 
Klemtonius: checks 
MaFak2019: checks 
*** TURN *** [6d 4c Kh] [2h]
color_singleton: checks 
Jackall23: checks 
Klemtonius: checks 
MaFak2019: checks 
*** RIVER *** [6d 4c Kh 2h] [Ac]
color_singleton: checks 
Jackall23: bets 614
Klemtonius: folds 
MaFak2019: folds 
color_singleton: folds 
Uncalled bet (614) returned to Jackall23
Jackall23 collected 1228 from pot
*** SUMMARY ***
Total pot 1300 | Rake 72 
Board [6d 4c Kh 2h Ac]
Seat 1: color_singleton (big blind) folded on the River
Seat 2: Jackall23 collected (1228)
Seat 4: Klemtonius folded on the River
Seat 5: PokerStarsMan12 folded before Flop (didn't bet)
Seat 8: MaFak2019 (button) folded on the River
Seat 9: manon327 (small blind) folded before Flop



PokerStars Home Game Hand #226729613992: {DaPokaStars}  Hold'em No Limit (50/100) - 2021/05/13 17:23:21 ET
Table 'again and again' 9-max (Play Money) Seat #9 is the button
Seat 1: color_singleton (25941 in chips) 
Seat 2: Jackall23 (28758 in chips) 
Seat 4: Klemtonius (10726 in chips) 
Seat 5: PokerStarsMan12 (24639 in chips) 
Seat 8: MaFak2019 (33419 in chips) 
Seat 9: manon327 (3194 in chips) 
color_singleton: posts small blind 50
Jackall23: posts big blind 100
*** HOLE CARDS ***
Dealt to PokerStarsMan12 [9s As]
Klemtonius: raises 250 to 350
PokerStarsMan12: calls 350
MaFak2019: folds 
manon327: folds 
color_singleton: calls 300
Jackall23: folds 
*** FLOP *** [Qc Tc 8d]
color_singleton: checks 
Klemtonius: bets 1087
PokerStarsMan12: folds 
color_singleton: folds 
Uncalled bet (1087) returned to Klemtonius
Klemtonius collected 1087 from pot
Klemtonius: doesn't show hand 
*** SUMMARY ***
Total pot 1150 | Rake 63 
Board [Qc Tc 8d]
Seat 1: color_singleton (small blind) folded on the Flop
Seat 2: Jackall23 (big blind) folded before Flop
Seat 4: Klemtonius collected (1087)
Seat 5: PokerStarsMan12 folded on the Flop
Seat 8: MaFak2019 folded before Flop (didn't bet)
Seat 9: manon327 (button) folded before Flop (didn't bet)



PokerStars Home Game Hand #226729635941: {DaPokaStars}  Hold'em No Limit (50/100) - 2021/05/13 17:24:03 ET
Table 'again and again' 9-max (Play Money) Seat #1 is the button
Seat 1: color_singleton (25591 in chips) 
Seat 2: Jackall23 (28658 in chips) 
Seat 4: Klemtonius (11463 in chips) 
Seat 5: PokerStarsMan12 (24289 in chips) 
Seat 9: manon327 (3194 in chips) 
Jackall23: posts small blind 50
Klemtonius: posts big blind 100
*** HOLE CARDS ***
Dealt to PokerStarsMan12 [Td Qc]
PokerStarsMan12: calls 100
manon327: folds 
color_singleton: raises 200 to 300
Jackall23: folds 
Klemtonius: calls 200
PokerStarsMan12: calls 200
*** FLOP *** [Kc 9s 4s]
Klemtonius: checks 
PokerStarsMan12: checks 
color_singleton: checks 
*** TURN *** [Kc 9s 4s] [Jc]
Klemtonius: checks 
PokerStarsMan12: bets 600
color_singleton: raises 600 to 1200
Klemtonius: folds 
PokerStarsMan12: calls 600
*** RIVER *** [Kc 9s 4s Jc] [9d]
PokerStarsMan12: checks 
color_singleton: checks 
*** SHOW DOWN ***
PokerStarsMan12: shows [Td Qc] (a straight, Nine to King)
color_singleton: mucks hand 
PokerStarsMan12 collected 3166 from pot
*** SUMMARY ***
Total pot 3350 | Rake 184 
Board [Kc 9s 4s Jc 9d]
Seat 1: color_singleton (button) mucked [Ad Ah]
Seat 2: Jackall23 (small blind) folded before Flop
Seat 4: Klemtonius (big blind) folded on the Turn
Seat 5: PokerStarsMan12 showed [Td Qc] and won (3166) with a straight, Nine to King
Seat 9: manon327 folded before Flop (didn't bet)



PokerStars Home Game Hand #226729659950: {DaPokaStars}  Hold'em No Limit (50/100) - 2021/05/13 17:24:49 ET
Table 'again and again' 9-max (Play Money) Seat #2 is the button
Seat 1: color_singleton (24091 in chips) 
Seat 2: Jackall23 (28608 in chips) 
Seat 4: Klemtonius (11163 in chips) 
Seat 5: PokerStarsMan12 (25955 in chips) 
Seat 9: manon327 (3194 in chips) 
Klemtonius: posts small blind 50
PokerStarsMan12: posts big blind 100
*** HOLE CARDS ***
Dealt to PokerStarsMan12 [8h 8c]
manon327 has timed out
manon327: folds 
color_singleton: folds 
Jackall23: calls 100
Klemtonius: calls 50
PokerStarsMan12: raises 300 to 400
Jackall23: calls 300
Klemtonius: calls 300
*** FLOP *** [Ah 3h Qs]
Klemtonius: checks 
PokerStarsMan12: bets 700
Jackall23: raises 700 to 1400
Klemtonius: folds 
PokerStarsMan12: folds 
Uncalled bet (700) returned to Jackall23
Jackall23 collected 2457 from pot
*** SUMMARY ***
Total pot 2600 | Rake 143 
Board [Ah 3h Qs]
Seat 1: color_singleton folded before Flop (didn't bet)
Seat 2: Jackall23 (button) collected (2457)
Seat 4: Klemtonius (small blind) folded on the Flop
Seat 5: PokerStarsMan12 (big blind) folded on the Flop
Seat 9: manon327 folded before Flop (didn't bet)



PokerStars Home Game Hand #226729683936: {DaPokaStars}  Hold'em No Limit (50/100) - 2021/05/13 17:25:35 ET
Table 'again and again' 9-max (Play Money) Seat #4 is the button
Seat 1: color_singleton (24091 in chips) 
Seat 2: Jackall23 (29965 in chips) 
Seat 4: Klemtonius (10763 in chips) 
Seat 5: PokerStarsMan12 (24855 in chips) 
Seat 8: MaFak2019 (33419 in chips) 
PokerStarsMan12: posts small blind 50
MaFak2019: posts big blind 100
*** HOLE CARDS ***
Dealt to PokerStarsMan12 [Qd 3c]
color_singleton: raises 200 to 300
Jackall23: folds 
Klemtonius: folds 
PokerStarsMan12: folds 
MaFak2019: calls 200
*** FLOP *** [7d Ac Ts]
MaFak2019: checks 
color_singleton: bets 307
MaFak2019: folds 
Uncalled bet (307) returned to color_singleton
color_singleton collected 614 from pot
color_singleton: doesn't show hand 
*** SUMMARY ***
Total pot 650 | Rake 36 
Board [7d Ac Ts]
Seat 1: color_singleton collected (614)
Seat 2: Jackall23 folded before Flop (didn't bet)
Seat 4: Klemtonius (button) folded before Flop (didn't bet)
Seat 5: PokerStarsMan12 (small blind) folded before Flop
Seat 8: MaFak2019 (big blind) folded on the Flop



PokerStars Home Game Hand #226729695850: {DaPokaStars}  Hold'em No Limit (50/100) - 2021/05/13 17:25:57 ET
Table 'again and again' 9-max (Play Money) Seat #5 is the button
Seat 1: color_singleton (24405 in chips) 
Seat 2: Jackall23 (29965 in chips) 
Seat 4: Klemtonius (10763 in chips) 
Seat 5: PokerStarsMan12 (24805 in chips) 
Seat 8: MaFak2019 (33119 in chips) 
MaFak2019: posts small blind 50
color_singleton: posts big blind 100
*** HOLE CARDS ***
Dealt to PokerStarsMan12 [6h 4c]
Jackall23: folds 
Klemtonius: calls 100
PokerStarsMan12: calls 100
MaFak2019: calls 50
color_singleton: checks 
*** FLOP *** [Ah 9c Jh]
MaFak2019: checks 
color_singleton: checks 
Klemtonius: checks 
PokerStarsMan12: checks 
*** TURN *** [Ah 9c Jh] [Th]
MaFak2019: checks 
color_singleton: bets 378
Klemtonius: folds 
PokerStarsMan12: folds 
MaFak2019: calls 378
*** RIVER *** [Ah 9c Jh Th] [8h]
MaFak2019: checks 
color_singleton: bets 1092
MaFak2019: folds 
Uncalled bet (1092) returned to color_singleton
color_singleton collected 1092 from pot
color_singleton: doesn't show hand 
*** SUMMARY ***
Total pot 1156 | Rake 64 
Board [Ah 9c Jh Th 8h]
Seat 1: color_singleton (big blind) collected (1092)
Seat 2: Jackall23 folded before Flop (didn't bet)
Seat 4: Klemtonius folded on the Turn
Seat 5: PokerStarsMan12 (button) folded on the Turn
Seat 8: MaFak2019 (small blind) folded on the River



PokerStars Home Game Hand #226729719526: {DaPokaStars}  Hold'em No Limit (50/100) - 2021/05/13 17:26:43 ET
Table 'again and again' 9-max (Play Money) Seat #1 is the button
Seat 1: color_singleton (25019 in chips) 
Seat 2: Jackall23 (29965 in chips) 
Seat 4: Klemtonius (10663 in chips) 
Seat 5: PokerStarsMan12 (24705 in chips) 
Seat 9: manon327 (3194 in chips) 
Jackall23: posts small blind 50
Klemtonius: posts big blind 100
manon327: posts big blind 100
*** HOLE CARDS ***
Dealt to PokerStarsMan12 [6s 3s]
PokerStarsMan12: folds 
manon327 has timed out
manon327: checks 
color_singleton: calls 100
Jackall23: raises 100 to 200
Klemtonius: folds 
manon327: folds 
color_singleton: calls 100
*** FLOP *** [Ks Jd As]
Jackall23: checks 
color_singleton: checks 
*** TURN *** [Ks Jd As] [7h]
Jackall23: checks 
color_singleton: bets 283
Jackall23: folds 
Uncalled bet (283) returned to color_singleton
color_singleton collected 567 from pot
color_singleton: doesn't show hand 
*** SUMMARY ***
Total pot 600 | Rake 33 
Board [Ks Jd As 7h]
Seat 1: color_singleton (button) collected (567)
Seat 2: Jackall23 (small blind) folded on the Turn
Seat 4: Klemtonius (big blind) folded before Flop
Seat 5: PokerStarsMan12 folded before Flop (didn't bet)
Seat 9: manon327 folded before Flop (didn't bet)



PokerStars Home Game Hand #226729750178: {DaPokaStars}  Hold'em No Limit (50/100) - 2021/05/13 17:27:41 ET
Table 'again and again' 9-max (Play Money) Seat #2 is the button
Seat 1: color_singleton (25386 in chips) 
Seat 2: Jackall23 (29765 in chips) 
Seat 4: Klemtonius (10563 in chips) 
Seat 5: PokerStarsMan12 (24705 in chips) 
Seat 8: MaFak2019 (32641 in chips) 
Seat 9: manon327 (3094 in chips) 
Klemtonius: posts small blind 50
PokerStarsMan12: posts big blind 100
*** HOLE CARDS ***
Dealt to PokerStarsMan12 [7s 3s]
MaFak2019: folds 
manon327: calls 100
color_singleton: raises 200 to 300
Jackall23: calls 300
Klemtonius: folds 
PokerStarsMan12: calls 200
manon327: folds 
*** FLOP *** [8s 6c Ac]
PokerStarsMan12: checks 
color_singleton: bets 496
Jackall23: calls 496
PokerStarsMan12: folds 
*** TURN *** [8s 6c Ac] [Ts]
color_singleton: bets 965
Jackall23: folds 
Uncalled bet (965) returned to color_singleton
color_singleton collected 1930 from pot
color_singleton: doesn't show hand 
*** SUMMARY ***
Total pot 2042 | Rake 112 
Board [8s 6c Ac Ts]
Seat 1: color_singleton collected (1930)
Seat 2: Jackall23 (button) folded on the Turn
Seat 4: Klemtonius (small blind) folded before Flop
Seat 5: PokerStarsMan12 (big blind) folded on the Flop
Seat 8: MaFak2019 folded before Flop (didn't bet)
Seat 9: manon327 folded before Flop



PokerStars Home Game Hand #226729784955: {DaPokaStars}  Hold'em No Limit (50/100) - 2021/05/13 17:28:41 ET
Table 'again and again' 9-max (Play Money) Seat #4 is the button
Seat 1: color_singleton (26520 in chips) 
Seat 2: Jackall23 (28969 in chips) 
Seat 4: Klemtonius (10513 in chips) 
Seat 5: PokerStarsMan12 (24405 in chips) 
Seat 8: MaFak2019 (32641 in chips) 
Seat 9: manon327 (2994 in chips) 
PokerStarsMan12: posts small blind 50
MaFak2019: posts big blind 100
*** HOLE CARDS ***
Dealt to PokerStarsMan12 [4c 6c]
manon327: calls 100
color_singleton: calls 100
Jackall23: folds 
Klemtonius: calls 100
PokerStarsMan12: calls 50
MaFak2019: raises 400 to 500
manon327: calls 400
color_singleton: calls 400
Klemtonius: folds 
PokerStarsMan12: folds 
*** FLOP *** [Kd 6h Jc]
MaFak2019: bets 1400
manon327: folds 
color_singleton: folds 
Uncalled bet (1400) returned to MaFak2019
MaFak2019 collected 1606 from pot
MaFak2019: doesn't show hand 
*** SUMMARY ***
Total pot 1700 | Rake 94 
Board [Kd 6h Jc]
Seat 1: color_singleton folded on the Flop
Seat 2: Jackall23 folded before Flop (didn't bet)
Seat 4: Klemtonius (button) folded before Flop
Seat 5: PokerStarsMan12 (small blind) folded before Flop
Seat 8: MaFak2019 (big blind) collected (1606)
Seat 9: manon327 folded on the Flop



PokerStars Home Game Hand #226729803778: {DaPokaStars}  Hold'em No Limit (50/100) - 2021/05/13 17:29:18 ET
Table 'again and again' 9-max (Play Money) Seat #5 is the button
Seat 1: color_singleton (26020 in chips) 
Seat 2: Jackall23 (28969 in chips) 
Seat 4: Klemtonius (10413 in chips) 
Seat 5: PokerStarsMan12 (24305 in chips) 
Seat 9: manon327 (2494 in chips) 
manon327: posts small blind 50
color_singleton: posts big blind 100
*** HOLE CARDS ***
Dealt to PokerStarsMan12 [6d Ks]
Jackall23: calls 100
Klemtonius: folds 
PokerStarsMan12: folds 
manon327: calls 50
color_singleton: checks 
*** FLOP *** [2h Td 4h]
manon327: checks 
color_singleton: checks 
Jackall23: checks 
*** TURN *** [2h Td 4h] [7h]
manon327: bets 141
color_singleton: folds 
Jackall23: calls 141
*** RIVER *** [2h Td 4h 7h] [Qh]
manon327: bets 550
Jackall23: calls 550
*** SHOW DOWN ***
manon327: shows [3h 6h] (a flush, Queen high)
Jackall23: shows [Kd Jh] (a flush, Queen high - Jack higher)
Jackall23 collected 1589 from pot
*** SUMMARY ***
Total pot 1682 | Rake 93 
Board [2h Td 4h 7h Qh]
Seat 1: color_singleton (big blind) folded on the Turn
Seat 2: Jackall23 showed [Kd Jh] and won (1589) with a flush, Queen high
Seat 4: Klemtonius folded before Flop (didn't bet)
Seat 5: PokerStarsMan12 (button) folded before Flop (didn't bet)
Seat 9: manon327 (small blind) showed [3h 6h] and lost with a flush, Queen high



PokerStars Home Game Hand #226729819313: {DaPokaStars}  Hold'em No Limit (50/100) - 2021/05/13 17:29:48 ET
Table 'again and again' 9-max (Play Money) Seat #9 is the button
Seat 1: color_singleton (25920 in chips) 
Seat 2: Jackall23 (29767 in chips) 
Seat 4: Klemtonius (10413 in chips) 
Seat 5: PokerStarsMan12 (24305 in chips) 
Seat 9: manon327 (1703 in chips) 
color_singleton: posts small blind 50
Jackall23: posts big blind 100
*** HOLE CARDS ***
Dealt to PokerStarsMan12 [3h 3c]
Klemtonius: raises 250 to 350
PokerStarsMan12: calls 350
manon327 has timed out
manon327: folds 
color_singleton: folds 
Jackall23: folds 
*** FLOP *** [Jc Kd 5s]
Klemtonius: checks 
PokerStarsMan12: bets 500
Klemtonius: raises 500 to 1000
PokerStarsMan12: calls 500
*** TURN *** [Jc Kd 5s] [Tc]
Klemtonius: bets 2200
PokerStarsMan12: folds 
Uncalled bet (2200) returned to Klemtonius
Klemtonius collected 2693 from pot
Klemtonius: doesn't show hand 
*** SUMMARY ***
Total pot 2850 | Rake 157 
Board [Jc Kd 5s Tc]
Seat 1: color_singleton (small blind) folded before Flop
Seat 2: Jackall23 (big blind) folded before Flop
Seat 4: Klemtonius collected (2693)
Seat 5: PokerStarsMan12 folded on the Turn
Seat 9: manon327 (button) folded before Flop (didn't bet)



PokerStars Home Game Hand #226729850627: {DaPokaStars}  Hold'em No Limit (50/100) - 2021/05/13 17:30:48 ET
Table 'again and again' 9-max (Play Money) Seat #1 is the button
Seat 1: color_singleton (25870 in chips) 
Seat 2: Jackall23 (29667 in chips) 
Seat 4: Klemtonius (11756 in chips) 
Seat 5: PokerStarsMan12 (22955 in chips) 
Jackall23: posts small blind 50
Klemtonius: posts big blind 100
*** HOLE CARDS ***
Dealt to PokerStarsMan12 [Jc Kd]
PokerStarsMan12: raises 200 to 300
color_singleton: raises 200 to 500
Jackall23: folds 
Klemtonius: folds 
PokerStarsMan12: calls 200
*** FLOP *** [4d 9h 5h]
PokerStarsMan12: checks 
color_singleton: bets 500
PokerStarsMan12: calls 500
*** TURN *** [4d 9h 5h] [7h]
PokerStarsMan12: checks 
color_singleton: bets 1016
PokerStarsMan12: folds 
Uncalled bet (1016) returned to color_singleton
color_singleton collected 2032 from pot
color_singleton: doesn't show hand 
*** SUMMARY ***
Total pot 2150 | Rake 118 
Board [4d 9h 5h 7h]
Seat 1: color_singleton (button) collected (2032)
Seat 2: Jackall23 (small blind) folded before Flop
Seat 4: Klemtonius (big blind) folded before Flop
Seat 5: PokerStarsMan12 folded on the Turn



PokerStars Home Game Hand #226729879325: {DaPokaStars}  Hold'em No Limit (50/100) - 2021/05/13 17:31:44 ET
Table 'again and again' 9-max (Play Money) Seat #2 is the button
Seat 1: color_singleton (26902 in chips) 
Seat 2: Jackall23 (29617 in chips) 
Seat 4: Klemtonius (11656 in chips) 
Seat 5: PokerStarsMan12 (21955 in chips) 
Seat 9: manon327 (1703 in chips) 
Klemtonius: posts small blind 50
PokerStarsMan12: posts big blind 100
*** HOLE CARDS ***
Dealt to PokerStarsMan12 [Th Qh]
manon327: calls 100
color_singleton: folds 
Jackall23: folds 
Klemtonius: calls 50
PokerStarsMan12: raises 300 to 400
manon327: calls 300
Klemtonius: folds 
*** FLOP *** [8h 3c 9d]
PokerStarsMan12: checks 
manon327: bets 100
PokerStarsMan12: calls 100
*** TURN *** [8h 3c 9d] [7d]
PokerStarsMan12: bets 200
manon327: folds 
Uncalled bet (200) returned to PokerStarsMan12
PokerStarsMan12 collected 1039 from pot
*** SUMMARY ***
Total pot 1100 | Rake 61 
Board [8h 3c 9d 7d]
Seat 1: color_singleton folded before Flop (didn't bet)
Seat 2: Jackall23 (button) folded before Flop (didn't bet)
Seat 4: Klemtonius (small blind) folded before Flop
Seat 5: PokerStarsMan12 (big blind) collected (1039)
Seat 9: manon327 folded on the Turn



PokerStars Home Game Hand #226729918143: {DaPokaStars}  Hold'em No Limit (50/100) - 2021/05/13 17:32:59 ET
Table 'again and again' 9-max (Play Money) Seat #4 is the button
Seat 1: color_singleton (26902 in chips) 
Seat 2: Jackall23 (29617 in chips) 
Seat 4: Klemtonius (11556 in chips) 
Seat 5: PokerStarsMan12 (22494 in chips) 
Seat 9: manon327 (1203 in chips) 
PokerStarsMan12: posts small blind 50
manon327: posts big blind 100
*** HOLE CARDS ***
Dealt to PokerStarsMan12 [9h 3c]
color_singleton: raises 200 to 300
Jackall23: folds 
Klemtonius: folds 
PokerStarsMan12: folds 
manon327: calls 200
*** FLOP *** [5c Kc 4c]
manon327: checks 
color_singleton: bets 614
manon327: folds 
Uncalled bet (614) returned to color_singleton
color_singleton collected 614 from pot
color_singleton: doesn't show hand 
*** SUMMARY ***
Total pot 650 | Rake 36 
Board [5c Kc 4c]
Seat 1: color_singleton collected (614)
Seat 2: Jackall23 folded before Flop (didn't bet)
Seat 4: Klemtonius (button) folded before Flop (didn't bet)
Seat 5: PokerStarsMan12 (small blind) folded before Flop
Seat 9: manon327 (big blind) folded on the Flop



PokerStars Home Game Hand #226729931518: {DaPokaStars}  Hold'em No Limit (50/100) - 2021/05/13 17:33:25 ET
Table 'again and again' 9-max (Play Money) Seat #5 is the button
Seat 1: color_singleton (27216 in chips) 
Seat 2: Jackall23 (29617 in chips) 
Seat 4: Klemtonius (11556 in chips) 
Seat 5: PokerStarsMan12 (22444 in chips) 
Seat 9: manon327 (903 in chips) 
manon327: posts small blind 50
color_singleton: posts big blind 100
*** HOLE CARDS ***
Dealt to PokerStarsMan12 [Th 4c]
Jackall23: calls 100
Klemtonius: raises 100 to 200
PokerStarsMan12: folds 
manon327: raises 100 to 300
color_singleton: folds 
Jackall23: calls 200
Klemtonius: calls 100
*** FLOP *** [Td 4s Qc]
manon327: bets 472
Jackall23: folds 
Klemtonius: folds 
Uncalled bet (472) returned to manon327
manon327 collected 945 from pot
*** SUMMARY ***
Total pot 1000 | Rake 55 
Board [Td 4s Qc]
Seat 1: color_singleton (big blind) folded before Flop
Seat 2: Jackall23 folded on the Flop
Seat 4: Klemtonius folded on the Flop
Seat 5: PokerStarsMan12 (button) folded before Flop (didn't bet)
Seat 9: manon327 (small blind) collected (945)



PokerStars Home Game Hand #226729960089: {DaPokaStars}  Hold'em No Limit (50/100) - 2021/05/13 17:34:21 ET
Table 'again and again' 9-max (Play Money) Seat #9 is the button
Seat 1: color_singleton (27116 in chips) 
Seat 2: Jackall23 (29317 in chips) 
Seat 4: Klemtonius (11256 in chips) 
Seat 5: PokerStarsMan12 (22444 in chips) 
Seat 8: MaFak2019 (33747 in chips) 
Seat 9: manon327 (1548 in chips) 
color_singleton: posts small blind 50
Jackall23: posts big blind 100
MaFak2019: posts small & big blinds 150
*** HOLE CARDS ***
Dealt to PokerStarsMan12 [4d Kh]
Klemtonius: raises 400 to 500
PokerStarsMan12: folds 
MaFak2019: calls 400
manon327: folds 
color_singleton: calls 450
Jackall23: folds 
*** FLOP *** [Ts Js 5h]
color_singleton: bets 1559
Klemtonius: raises 1559 to 3118
MaFak2019: folds 
color_singleton: raises 1559 to 4677
Klemtonius: raises 6079 to 10756 and is all-in
color_singleton: calls 6079
*** TURN *** [Ts Js 5h] [Ac]
*** RIVER *** [Ts Js 5h Ac] [6d]
*** SHOW DOWN ***
color_singleton: shows [Kd Ks] (a pair of Kings)
Klemtonius: shows [5s As] (two pair, Aces and Fives)
Klemtonius collected 21888 from pot
*** SUMMARY ***
Total pot 23162 | Rake 1274 
Board [Ts Js 5h Ac 6d]
Seat 1: color_singleton (small blind) showed [Kd Ks] and lost with a pair of Kings
Seat 2: Jackall23 (big blind) folded before Flop
Seat 4: Klemtonius showed [5s As] and won (21888) with two pair, Aces and Fives
Seat 5: PokerStarsMan12 folded before Flop (didn't bet)
Seat 8: MaFak2019 folded on the Flop
Seat 9: manon327 (button) folded before Flop (didn't bet)



PokerStars Home Game Hand #226729981585: {DaPokaStars}  Hold'em No Limit (50/100) - 2021/05/13 17:35:02 ET
Table 'again and again' 9-max (Play Money) Seat #1 is the button
Seat 1: color_singleton (15860 in chips) 
Seat 2: Jackall23 (29217 in chips) 
Seat 4: Klemtonius (21888 in chips) 
Seat 5: PokerStarsMan12 (22444 in chips) 
Seat 8: MaFak2019 (33197 in chips) 
Seat 9: manon327 (1548 in chips) 
Jackall23: posts small blind 50
Klemtonius: posts big blind 100
*** HOLE CARDS ***
Dealt to PokerStarsMan12 [8h Ah]
PokerStarsMan12: raises 300 to 400
MaFak2019: folds 
manon327: calls 400
color_singleton: calls 400
Jackall23: raises 300 to 700
Klemtonius: calls 600
PokerStarsMan12: calls 300
manon327: calls 300
color_singleton: calls 300
*** FLOP *** [8d 3h 8c]
Jackall23: checks 
Klemtonius: checks 
PokerStarsMan12: checks 
manon327: checks 
color_singleton: checks 
*** TURN *** [8d 3h 8c] [Ad]
Jackall23: checks 
Klemtonius: checks 
PokerStarsMan12: bets 1000
manon327: folds 
color_singleton: raises 1000 to 2000
Jackall23: folds 
Klemtonius: folds 
PokerStarsMan12: raises 2000 to 4000
color_singleton: calls 2000
*** RIVER *** [8d 3h 8c Ad] [Ks]
PokerStarsMan12: bets 4900
color_singleton: folds 
Uncalled bet (4900) returned to PokerStarsMan12
PokerStarsMan12 collected 10867 from pot
*** SUMMARY ***
Total pot 11500 | Rake 633 
Board [8d 3h 8c Ad Ks]
Seat 1: color_singleton (button) folded on the River
Seat 2: Jackall23 (small blind) folded on the Turn
Seat 4: Klemtonius (big blind) folded on the Turn
Seat 5: PokerStarsMan12 collected (10867)
Seat 8: MaFak2019 folded before Flop (didn't bet)
Seat 9: manon327 folded on the Turn



PokerStars Home Game Hand #226730034177: {DaPokaStars}  Hold'em No Limit (50/100) - 2021/05/13 17:36:46 ET
Table 'again and again' 9-max (Play Money) Seat #2 is the button
Seat 1: color_singleton (11160 in chips) 
Seat 2: Jackall23 (28517 in chips) 
Seat 4: Klemtonius (21188 in chips) 
Seat 5: PokerStarsMan12 (28611 in chips) 
Seat 8: MaFak2019 (33197 in chips) 
Seat 9: manon327 (848 in chips) 
Klemtonius: posts small blind 50
PokerStarsMan12: posts big blind 100
*** HOLE CARDS ***
Dealt to PokerStarsMan12 [Ts 9s]
MaFak2019: calls 100
manon327: raises 748 to 848 and is all-in
color_singleton: calls 848
Jackall23: folds 
Klemtonius: folds 
PokerStarsMan12: folds 
MaFak2019: calls 748
*** FLOP *** [6s Kc Jh]
MaFak2019: checks 
color_singleton: bets 1273
MaFak2019: folds 
Uncalled bet (1273) returned to color_singleton
*** TURN *** [6s Kc Jh] [7c]
*** RIVER *** [6s Kc Jh 7c] [7s]
*** SHOW DOWN ***
manon327: shows [6d 6h] (a full house, Sixes full of Sevens)
color_singleton: shows [Ks Js] (two pair, Kings and Jacks)
manon327 collected 2546 from pot
*** SUMMARY ***
Total pot 2694 | Rake 148 
Board [6s Kc Jh 7c 7s]
Seat 1: color_singleton showed [Ks Js] and lost with two pair, Kings and Jacks
Seat 2: Jackall23 (button) folded before Flop (didn't bet)
Seat 4: Klemtonius (small blind) folded before Flop
Seat 5: PokerStarsMan12 (big blind) folded before Flop
Seat 8: MaFak2019 folded on the Flop
Seat 9: manon327 showed [6d 6h] and won (2546) with a full house, Sixes full of Sevens



PokerStars Home Game Hand #226730050655: {DaPokaStars}  Hold'em No Limit (50/100) - 2021/05/13 17:37:18 ET
Table 'again and again' 9-max (Play Money) Seat #4 is the button
Seat 1: color_singleton (10312 in chips) 
Seat 2: Jackall23 (28517 in chips) 
Seat 4: Klemtonius (21138 in chips) 
Seat 5: PokerStarsMan12 (28511 in chips) 
Seat 8: MaFak2019 (32349 in chips) 
Seat 9: manon327 (2546 in chips) 
PokerStarsMan12: posts small blind 50
MaFak2019: posts big blind 100
*** HOLE CARDS ***
Dealt to PokerStarsMan12 [Th Kd]
manon327: calls 100
color_singleton: folds 
Jackall23: folds 
Klemtonius: folds 
PokerStarsMan12: raises 200 to 300
MaFak2019: calls 200
manon327: calls 200
*** FLOP *** [Kh Tc 9h]
PokerStarsMan12: bets 700
MaFak2019: calls 700
manon327: calls 700
*** TURN *** [Kh Tc 9h] [Ah]
PokerStarsMan12: checks 
MaFak2019: checks 
manon327: checks 
*** RIVER *** [Kh Tc 9h Ah] [Jh]
PokerStarsMan12: bets 1900
MaFak2019: folds 
manon327: calls 1546 and is all-in
Uncalled bet (354) returned to PokerStarsMan12
*** SHOW DOWN ***
PokerStarsMan12: shows [Th Kd] (a flush, Ace high)
manon327: shows [Qd 4s] (a straight, Ten to Ace)
PokerStarsMan12 collected 5757 from pot
*** SUMMARY ***
Total pot 6092 | Rake 335 
Board [Kh Tc 9h Ah Jh]
Seat 1: color_singleton folded before Flop (didn't bet)
Seat 2: Jackall23 folded before Flop (didn't bet)
Seat 4: Klemtonius (button) folded before Flop (didn't bet)
Seat 5: PokerStarsMan12 (small blind) showed [Th Kd] and won (5757) with a flush, Ace high
Seat 8: MaFak2019 (big blind) folded on the River
Seat 9: manon327 showed [Qd 4s] and lost with a straight, Ten to Ace



PokerStars Home Game Hand #226730089893: {DaPokaStars}  Hold'em No Limit (50/100) - 2021/05/13 17:38:37 ET
Table 'again and again' 9-max (Play Money) Seat #5 is the button
Seat 1: color_singleton (10312 in chips) 
Seat 2: Jackall23 (28517 in chips) 
Seat 4: Klemtonius (21138 in chips) 
Seat 5: PokerStarsMan12 (31722 in chips) 
Seat 8: MaFak2019 (31349 in chips) 
MaFak2019: posts small blind 50
color_singleton: posts big blind 100
*** HOLE CARDS ***
Dealt to PokerStarsMan12 [6h Ad]
Jackall23: folds 
Klemtonius: calls 100
PokerStarsMan12: calls 100
MaFak2019: calls 50
color_singleton: raises 400 to 500
Klemtonius: calls 400
PokerStarsMan12: folds 
MaFak2019: calls 400
*** FLOP *** [Jh 3c Kh]
MaFak2019: checks 
color_singleton: bets 756
Klemtonius: calls 756
MaFak2019: calls 756
*** TURN *** [Jh 3c Kh] [6d]
MaFak2019: checks 
color_singleton: checks 
Klemtonius: bets 3655
MaFak2019: calls 3655
color_singleton: folds 
*** RIVER *** [Jh 3c Kh 6d] [9h]
MaFak2019: checks 
Klemtonius: checks 
*** SHOW DOWN ***
MaFak2019: shows [Kd 7h] (a pair of Kings)
Klemtonius: mucks hand 
MaFak2019 collected 10563 from pot
*** SUMMARY ***
Total pot 11178 | Rake 615 
Board [Jh 3c Kh 6d 9h]
Seat 1: color_singleton (big blind) folded on the Turn
Seat 2: Jackall23 folded before Flop (didn't bet)
Seat 4: Klemtonius mucked [Kc 5h]
Seat 5: PokerStarsMan12 (button) folded before Flop
Seat 8: MaFak2019 (small blind) showed [Kd 7h] and won (10563) with a pair of Kings



PokerStars Home Game Hand #226730126098: {DaPokaStars}  Hold'em No Limit (50/100) - 2021/05/13 17:39:50 ET
Table 'again and again' 9-max (Play Money) Seat #8 is the button
Seat 1: color_singleton (9056 in chips) 
Seat 4: Klemtonius (16227 in chips) 
Seat 5: PokerStarsMan12 (31622 in chips) 
Seat 8: MaFak2019 (37001 in chips) 
color_singleton: posts small blind 50
Klemtonius: posts big blind 100
*** HOLE CARDS ***
Dealt to PokerStarsMan12 [8s Ah]
PokerStarsMan12: raises 300 to 400
MaFak2019: calls 400
color_singleton: calls 350
Klemtonius: calls 300
*** FLOP *** [2h 7h Qd]
color_singleton: checks 
Klemtonius: checks 
PokerStarsMan12: checks 
MaFak2019: checks 
*** TURN *** [2h 7h Qd] [Ts]
color_singleton: bets 756
Klemtonius: folds 
PokerStarsMan12: folds 
MaFak2019: calls 756
*** RIVER *** [2h 7h Qd Ts] [2c]
color_singleton: checks 
MaFak2019: checks 
*** SHOW DOWN ***
color_singleton: shows [Ks Td] (two pair, Tens and Deuces)
MaFak2019: mucks hand 
color_singleton collected 2941 from pot
*** SUMMARY ***
Total pot 3112 | Rake 171 
Board [2h 7h Qd Ts 2c]
Seat 1: color_singleton (small blind) showed [Ks Td] and won (2941) with two pair, Tens and Deuces
Seat 4: Klemtonius (big blind) folded on the Turn
Seat 5: PokerStarsMan12 folded on the Turn
Seat 8: MaFak2019 (button) mucked [Js 9d]



PokerStars Home Game Hand #226730143512: {DaPokaStars}  Hold'em No Limit (50/100) - 2021/05/13 17:40:25 ET
Table 'again and again' 9-max (Play Money) Seat #1 is the button
Seat 1: color_singleton (10841 in chips) 
Seat 4: Klemtonius (15827 in chips) 
Seat 5: PokerStarsMan12 (31222 in chips) 
Seat 8: MaFak2019 (35845 in chips) 
Seat 9: manon327 (10000 in chips) 
Klemtonius: posts small blind 50
PokerStarsMan12: posts big blind 100
manon327: posts small & big blinds 150
*** HOLE CARDS ***
Dealt to PokerStarsMan12 [Qh 5c]
MaFak2019: calls 100
manon327: checks 
color_singleton: calls 100
Klemtonius: calls 50
PokerStarsMan12: checks 
*** FLOP *** [4s 3c Ks]
Klemtonius: checks 
PokerStarsMan12: checks 
MaFak2019: bets 600
manon327: folds 
color_singleton: calls 600
Klemtonius: folds 
PokerStarsMan12: folds 
*** TURN *** [4s 3c Ks] [3d]
MaFak2019: checks 
color_singleton: checks 
*** RIVER *** [4s 3c Ks 3d] [5h]
MaFak2019: bets 2600
color_singleton: folds 
Uncalled bet (2600) returned to MaFak2019
MaFak2019 collected 1654 from pot
MaFak2019: doesn't show hand 
*** SUMMARY ***
Total pot 1750 | Rake 96 
Board [4s 3c Ks 3d 5h]
Seat 1: color_singleton (button) folded on the River
Seat 4: Klemtonius (small blind) folded on the Flop
Seat 5: PokerStarsMan12 (big blind) folded on the Flop
Seat 8: MaFak2019 collected (1654)
Seat 9: manon327 folded on the Flop (didn't bet)



PokerStars Home Game Hand #226730177455: {DaPokaStars}  Hold'em No Limit (50/100) - 2021/05/13 17:41:23 ET
Table 'again and again' 9-max (Play Money) Seat #4 is the button
Seat 1: color_singleton (10141 in chips) 
Seat 4: Klemtonius (15727 in chips) 
Seat 5: PokerStarsMan12 (31122 in chips) 
Seat 8: MaFak2019 (36799 in chips) 
Seat 9: manon327 (9850 in chips) 
PokerStarsMan12: posts small blind 50
MaFak2019: posts big blind 100
*** HOLE CARDS ***
Dealt to PokerStarsMan12 [6d 7s]
manon327: folds 
color_singleton: folds 
Klemtonius: folds 
PokerStarsMan12: calls 50
MaFak2019: checks 
*** FLOP *** [Th Ts 3h]
PokerStarsMan12: checks 
MaFak2019: checks 
*** TURN *** [Th Ts 3h] [Ac]
PokerStarsMan12: checks 
MaFak2019: checks 
*** RIVER *** [Th Ts 3h Ac] [Ah]
PokerStarsMan12: checks 
MaFak2019: checks 
*** SHOW DOWN ***
PokerStarsMan12: shows [6d 7s] (two pair, Aces and Tens)
MaFak2019: shows [Qh Kc] (two pair, Aces and Tens - King kicker)
MaFak2019 collected 189 from pot
*** SUMMARY ***
Total pot 200 | Rake 11 
Board [Th Ts 3h Ac Ah]
Seat 1: color_singleton folded before Flop (didn't bet)
Seat 4: Klemtonius (button) folded before Flop (didn't bet)
Seat 5: PokerStarsMan12 (small blind) showed [6d 7s] and lost with two pair, Aces and Tens
Seat 8: MaFak2019 (big blind) showed [Qh Kc] and won (189) with two pair, Aces and Tens
Seat 9: manon327 folded before Flop (didn't bet)



PokerStars Home Game Hand #226730200726: {DaPokaStars}  Hold'em No Limit (50/100) - 2021/05/13 17:42:11 ET
Table 'again and again' 9-max (Play Money) Seat #5 is the button
Seat 1: color_singleton (10141 in chips) 
Seat 2: Jackall23 (28517 in chips) 
Seat 4: Klemtonius (15727 in chips) 
Seat 5: PokerStarsMan12 (31022 in chips) 
Seat 8: MaFak2019 (36888 in chips) 
Seat 9: manon327 (9850 in chips) 
MaFak2019: posts small blind 50
manon327: posts big blind 100
Jackall23: posts small & big blinds 150
*** HOLE CARDS ***
Dealt to PokerStarsMan12 [2c 3d]
color_singleton: folds 
Jackall23: checks 
Klemtonius: calls 100
PokerStarsMan12: folds 
MaFak2019: calls 50
manon327: checks 
*** FLOP *** [6d 7h 8h]
MaFak2019: checks 
manon327: checks 
Jackall23: bets 100
Klemtonius: calls 100
MaFak2019: calls 100
manon327: calls 100
*** TURN *** [6d 7h 8h] [Qc]
MaFak2019: checks 
manon327: checks 
Jackall23: bets 100
Klemtonius: raises 1003 to 1103
MaFak2019: calls 1103
manon327: folds 
Jackall23: folds 
*** RIVER *** [6d 7h 8h Qc] [2s]
MaFak2019: checks 
Klemtonius: bets 2982
MaFak2019: folds 
Uncalled bet (2982) returned to Klemtonius
Klemtonius collected 2982 from pot
Klemtonius: doesn't show hand 
*** SUMMARY ***
Total pot 3156 | Rake 174 
Board [6d 7h 8h Qc 2s]
Seat 1: color_singleton folded before Flop (didn't bet)
Seat 2: Jackall23 folded on the Turn
Seat 4: Klemtonius collected (2982)
Seat 5: PokerStarsMan12 (button) folded before Flop (didn't bet)
Seat 8: MaFak2019 (small blind) folded on the River
Seat 9: manon327 (big blind) folded on the Turn



PokerStars Home Game Hand #226730233097: {DaPokaStars}  Hold'em No Limit (50/100) - 2021/05/13 17:43:18 ET
Table 'again and again' 9-max (Play Money) Seat #8 is the button
Seat 1: color_singleton (10141 in chips) 
Seat 2: Jackall23 (28167 in chips) 
Seat 4: Klemtonius (17406 in chips) 
Seat 5: PokerStarsMan12 (31022 in chips) 
Seat 8: MaFak2019 (35585 in chips) 
Seat 9: manon327 (9650 in chips) 
manon327: posts small blind 50
color_singleton: posts big blind 100
*** HOLE CARDS ***
Dealt to PokerStarsMan12 [2s 3d]
Jackall23: raises 100 to 200
Klemtonius: raises 100 to 300
PokerStarsMan12: folds 
MaFak2019: calls 300
manon327: folds 
color_singleton: calls 200
Jackall23: raises 100 to 400
Klemtonius: calls 100
MaFak2019: calls 100
color_singleton: calls 100
*** FLOP *** [2c As 4d]
color_singleton: checks 
Jackall23: checks 
Klemtonius: bets 779
MaFak2019: folds 
color_singleton: folds 
Jackall23: calls 779
*** TURN *** [2c As 4d] [5c]
Jackall23: checks 
Klemtonius: bets 3032
Jackall23: folds 
Uncalled bet (3032) returned to Klemtonius
Klemtonius collected 3032 from pot
Klemtonius: doesn't show hand 
*** SUMMARY ***
Total pot 3208 | Rake 176 
Board [2c As 4d 5c]
Seat 1: color_singleton (big blind) folded on the Flop
Seat 2: Jackall23 folded on the Turn
Seat 4: Klemtonius collected (3032)
Seat 5: PokerStarsMan12 folded before Flop (didn't bet)
Seat 8: MaFak2019 (button) folded on the Flop
Seat 9: manon327 (small blind) folded before Flop



PokerStars Home Game Hand #226730260026: {DaPokaStars}  Hold'em No Limit (50/100) - 2021/05/13 17:44:08 ET
Table 'again and again' 9-max (Play Money) Seat #9 is the button
Seat 1: color_singleton (9741 in chips) 
Seat 2: Jackall23 (26988 in chips) 
Seat 4: Klemtonius (19259 in chips) 
Seat 5: PokerStarsMan12 (31022 in chips) 
Seat 8: MaFak2019 (35185 in chips) 
Seat 9: manon327 (9600 in chips) 
color_singleton: posts small blind 50
Jackall23: posts big blind 100
*** HOLE CARDS ***
Dealt to PokerStarsMan12 [Jc 3h]
Klemtonius: calls 100
PokerStarsMan12: folds 
MaFak2019: calls 100
manon327: calls 100
color_singleton: calls 50
Jackall23: checks 
*** FLOP *** [Th 4c Ad]
color_singleton: checks 
Jackall23: checks 
Klemtonius: checks 
MaFak2019: checks 
manon327: checks 
*** TURN *** [Th 4c Ad] [Td]
color_singleton: checks 
Jackall23: checks 
Klemtonius: checks 
MaFak2019: checks 
manon327: checks 
*** RIVER *** [Th 4c Ad Td] [5d]
color_singleton: checks 
Jackall23: bets 236
Klemtonius: folds 
MaFak2019: calls 236
manon327: folds 
color_singleton: folds 
*** SHOW DOWN ***
Jackall23: shows [5s Ac] (two pair, Aces and Tens)
MaFak2019: mucks hand 
Jackall23 collected 919 from pot
*** SUMMARY ***
Total pot 972 | Rake 53 
Board [Th 4c Ad Td 5d]
Seat 1: color_singleton (small blind) folded on the River
Seat 2: Jackall23 (big blind) showed [5s Ac] and won (919) with two pair, Aces and Tens
Seat 4: Klemtonius folded on the River
Seat 5: PokerStarsMan12 folded before Flop (didn't bet)
Seat 8: MaFak2019 mucked [7d 5c]
Seat 9: manon327 (button) folded on the River



PokerStars Home Game Hand #226730298136: {DaPokaStars}  Hold'em No Limit (50/100) - 2021/05/13 17:45:26 ET
Table 'again and again' 9-max (Play Money) Seat #1 is the button
Seat 1: color_singleton (9641 in chips) 
Seat 2: Jackall23 (27571 in chips) 
Seat 4: Klemtonius (19159 in chips) 
Seat 5: PokerStarsMan12 (31022 in chips) 
Seat 8: MaFak2019 (34849 in chips) 
Seat 9: manon327 (9500 in chips) 
Jackall23: posts small blind 50
Klemtonius: posts big blind 100
*** HOLE CARDS ***
Dealt to PokerStarsMan12 [Ah Kd]
PokerStarsMan12: raises 300 to 400
MaFak2019: calls 400
manon327: folds 
color_singleton: folds 
Jackall23: folds 
Klemtonius: calls 300
*** FLOP *** [3h Qd 8c]
Klemtonius: bets 1181
PokerStarsMan12: folds 
MaFak2019: folds 
Uncalled bet (1181) returned to Klemtonius
Klemtonius collected 1181 from pot
Klemtonius: doesn't show hand 
*** SUMMARY ***
Total pot 1250 | Rake 69 
Board [3h Qd 8c]
Seat 1: color_singleton (button) folded before Flop (didn't bet)
Seat 2: Jackall23 (small blind) folded before Flop
Seat 4: Klemtonius (big blind) collected (1181)
Seat 5: PokerStarsMan12 folded on the Flop
Seat 8: MaFak2019 folded on the Flop
Seat 9: manon327 folded before Flop (didn't bet)



PokerStars Home Game Hand #226730313064: {DaPokaStars}  Hold'em No Limit (50/100) - 2021/05/13 17:45:56 ET
Table 'again and again' 9-max (Play Money) Seat #2 is the button
Seat 1: color_singleton (9641 in chips) 
Seat 2: Jackall23 (27521 in chips) 
Seat 4: Klemtonius (19940 in chips) 
Seat 5: PokerStarsMan12 (30622 in chips) 
Seat 8: MaFak2019 (34449 in chips) 
Seat 9: manon327 (9500 in chips) 
Klemtonius: posts small blind 50
PokerStarsMan12: posts big blind 100
*** HOLE CARDS ***
Dealt to PokerStarsMan12 [6s Ks]
MaFak2019: calls 100
manon327: calls 100
color_singleton: raises 300 to 400
Jackall23: calls 400
Klemtonius: raises 300 to 700
PokerStarsMan12: folds 
MaFak2019: calls 600
manon327: folds 
color_singleton: calls 300
Jackall23: calls 300
*** FLOP *** [4c 8h 7d]
Klemtonius: bets 2835
MaFak2019: folds 
color_singleton: folds 
Jackall23: folds 
Uncalled bet (2835) returned to Klemtonius
Klemtonius collected 2835 from pot
Klemtonius: doesn't show hand 
*** SUMMARY ***
Total pot 3000 | Rake 165 
Board [4c 8h 7d]
Seat 1: color_singleton folded on the Flop
Seat 2: Jackall23 (button) folded on the Flop
Seat 4: Klemtonius (small blind) collected (2835)
Seat 5: PokerStarsMan12 (big blind) folded before Flop
Seat 8: MaFak2019 folded on the Flop
Seat 9: manon327 folded before Flop



PokerStars Home Game Hand #226730328999: {DaPokaStars}  Hold'em No Limit (50/100) - 2021/05/13 17:46:29 ET
Table 'again and again' 9-max (Play Money) Seat #4 is the button
Seat 1: color_singleton (8941 in chips) 
Seat 2: Jackall23 (26821 in chips) 
Seat 4: Klemtonius (22075 in chips) 
Seat 5: PokerStarsMan12 (30522 in chips) 
Seat 8: MaFak2019 (33749 in chips) 
Seat 9: manon327 (9400 in chips) 
PokerStarsMan12: posts small blind 50
MaFak2019: posts big blind 100
*** HOLE CARDS ***
Dealt to PokerStarsMan12 [Jd 4s]
manon327: folds 
color_singleton: folds 
Jackall23: folds 
Klemtonius: raises 250 to 350
PokerStarsMan12: folds 
MaFak2019: calls 250
*** FLOP *** [9s Td 6d]
MaFak2019: checks 
Klemtonius: checks 
*** TURN *** [9s Td 6d] [Kd]
MaFak2019: bets 400
Klemtonius: calls 400
*** RIVER *** [9s Td 6d Kd] [6s]
MaFak2019: bets 32999 and is all-in
Klemtonius: folds 
Uncalled bet (32999) returned to MaFak2019
MaFak2019 collected 1465 from pot
MaFak2019: doesn't show hand 
*** SUMMARY ***
Total pot 1550 | Rake 85 
Board [9s Td 6d Kd 6s]
Seat 1: color_singleton folded before Flop (didn't bet)
Seat 2: Jackall23 folded before Flop (didn't bet)
Seat 4: Klemtonius (button) folded on the River
Seat 5: PokerStarsMan12 (small blind) folded before Flop
Seat 8: MaFak2019 (big blind) collected (1465)
Seat 9: manon327 folded before Flop (didn't bet)



PokerStars Home Game Hand #226730356659: {DaPokaStars}  Hold'em No Limit (50/100) - 2021/05/13 17:47:26 ET
Table 'again and again' 9-max (Play Money) Seat #5 is the button
Seat 1: color_singleton (8941 in chips) 
Seat 2: Jackall23 (26821 in chips) 
Seat 4: Klemtonius (21325 in chips) 
Seat 5: PokerStarsMan12 (30472 in chips) 
Seat 8: MaFak2019 (34464 in chips) 
Seat 9: manon327 (9400 in chips) 
MaFak2019: posts small blind 50
manon327: posts big blind 100
*** HOLE CARDS ***
Dealt to PokerStarsMan12 [Qd 4c]
color_singleton: raises 100 to 200
Jackall23: folds 
Klemtonius: raises 100 to 300
PokerStarsMan12: folds 
MaFak2019: calls 250
manon327: folds 
color_singleton: calls 100
*** FLOP *** [8h 7c 6d]
MaFak2019: checks 
color_singleton: checks 
Klemtonius: bets 472
MaFak2019: calls 472
color_singleton: calls 472
*** TURN *** [8h 7c 6d] [6h]
MaFak2019: checks 
color_singleton: checks 
Klemtonius: bets 1141
MaFak2019: calls 1141
color_singleton: raises 1859 to 3000
Klemtonius: calls 1859
MaFak2019: folds 
*** RIVER *** [8h 7c 6d 6h] [Kd]
color_singleton: bets 5169 and is all-in
Klemtonius has timed out
Klemtonius: folds 
Uncalled bet (5169) returned to color_singleton
color_singleton collected 9031 from pot
color_singleton: doesn't show hand 
*** SUMMARY ***
Total pot 9557 | Rake 526 
Board [8h 7c 6d 6h Kd]
Seat 1: color_singleton collected (9031)
Seat 2: Jackall23 folded before Flop (didn't bet)
Seat 4: Klemtonius folded on the River
Seat 5: PokerStarsMan12 (button) folded before Flop (didn't bet)
Seat 8: MaFak2019 (small blind) folded on the Turn
Seat 9: manon327 (big blind) folded before Flop



PokerStars Home Game Hand #226730399856: {DaPokaStars}  Hold'em No Limit (50/100) - 2021/05/13 17:48:55 ET
Table 'again and again' 9-max (Play Money) Seat #8 is the button
Seat 1: color_singleton (14200 in chips) 
Seat 2: Jackall23 (26821 in chips) 
Seat 5: PokerStarsMan12 (30472 in chips) 
Seat 8: MaFak2019 (32551 in chips) 
Seat 9: manon327 (9300 in chips) 
manon327: posts small blind 50
color_singleton: posts big blind 100
*** HOLE CARDS ***
Dealt to PokerStarsMan12 [Qc 7c]
Jackall23: folds 
PokerStarsMan12: calls 100
MaFak2019: calls 100
manon327: folds 
color_singleton: checks 
*** FLOP *** [Kc 8d Tc]
color_singleton: checks 
PokerStarsMan12: bets 300
MaFak2019: calls 300
color_singleton: folds 
*** TURN *** [Kc 8d Tc] [Qh]
PokerStarsMan12: bets 600
MaFak2019: folds 
Uncalled bet (600) returned to PokerStarsMan12
PokerStarsMan12 collected 898 from pot
*** SUMMARY ***
Total pot 950 | Rake 52 
Board [Kc 8d Tc Qh]
Seat 1: color_singleton (big blind) folded on the Flop
Seat 2: Jackall23 folded before Flop (didn't bet)
Seat 5: PokerStarsMan12 collected (898)
Seat 8: MaFak2019 (button) folded on the Turn
Seat 9: manon327 (small blind) folded before Flop



PokerStars Home Game Hand #226730417398: {DaPokaStars}  Hold'em No Limit (50/100) - 2021/05/13 17:49:31 ET
Table 'again and again' 9-max (Play Money) Seat #9 is the button
Seat 1: color_singleton (14100 in chips) 
Seat 2: Jackall23 (26821 in chips) 
Seat 4: Klemtonius (17553 in chips) 
Seat 5: PokerStarsMan12 (30970 in chips) 
Seat 8: MaFak2019 (32151 in chips) 
Seat 9: manon327 (9250 in chips) 
color_singleton: posts small blind 50
Jackall23: posts big blind 100
*** HOLE CARDS ***
Dealt to PokerStarsMan12 [7c 2d]
Klemtonius: folds 
PokerStarsMan12: folds 
MaFak2019: folds 
manon327: folds 
color_singleton: raises 200 to 300
Jackall23: folds 
Uncalled bet (200) returned to color_singleton
color_singleton collected 200 from pot
color_singleton: doesn't show hand 
*** SUMMARY ***
Total pot 200 | Rake 0 
Seat 1: color_singleton (small blind) collected (200)
Seat 2: Jackall23 (big blind) folded before Flop
Seat 4: Klemtonius folded before Flop (didn't bet)
Seat 5: PokerStarsMan12 folded before Flop (didn't bet)
Seat 8: MaFak2019 folded before Flop (didn't bet)
Seat 9: manon327 (button) folded before Flop (didn't bet)



PokerStars Home Game Hand #226730424997: {DaPokaStars}  Hold'em No Limit (50/100) - 2021/05/13 17:49:47 ET
Table 'again and again' 9-max (Play Money) Seat #1 is the button
Seat 1: color_singleton (14200 in chips) 
Seat 2: Jackall23 (26721 in chips) 
Seat 4: Klemtonius (17553 in chips) 
Seat 5: PokerStarsMan12 (30970 in chips) 
Seat 8: MaFak2019 (32151 in chips) 
Seat 9: manon327 (9250 in chips) 
Jackall23: posts small blind 50
Klemtonius: posts big blind 100
*** HOLE CARDS ***
Dealt to PokerStarsMan12 [6h Th]
PokerStarsMan12: folds 
MaFak2019: calls 100
manon327: calls 100
color_singleton: calls 100
Jackall23: calls 50
Klemtonius: checks 
*** FLOP *** [Td 4h 9c]
Jackall23: checks 
Klemtonius: bets 236
MaFak2019: calls 236
manon327: calls 236
color_singleton: folds 
Jackall23: calls 236
*** TURN *** [Td 4h 9c] [4d]
Jackall23: checks 
Klemtonius: checks 
MaFak2019: checks 
manon327: checks 
*** RIVER *** [Td 4h 9c 4d] [Jh]
Jackall23: bets 682
Klemtonius: calls 682
MaFak2019: folds 
manon327: calls 682
*** SHOW DOWN ***
Jackall23: shows [7s Qs] (a pair of Fours)
Klemtonius: shows [Kc Js] (two pair, Jacks and Fours)
manon327: shows [Ks Jd] (two pair, Jacks and Fours)
Klemtonius collected 1649 from pot
manon327 collected 1649 from pot
*** SUMMARY ***
Total pot 3490 | Rake 192 
Board [Td 4h 9c 4d Jh]
Seat 1: color_singleton (button) folded on the Flop
Seat 2: Jackall23 (small blind) showed [7s Qs] and lost with a pair of Fours
Seat 4: Klemtonius (big blind) showed [Kc Js] and won (1649) with two pair, Jacks and Fours
Seat 5: PokerStarsMan12 folded before Flop (didn't bet)
Seat 8: MaFak2019 folded on the River
Seat 9: manon327 showed [Ks Jd] and won (1649) with two pair, Jacks and Fours



PokerStars Home Game Hand #226730454020: {DaPokaStars}  Hold'em No Limit (50/100) - 2021/05/13 17:50:47 ET
Table 'again and again' 9-max (Play Money) Seat #2 is the button
Seat 1: color_singleton (14100 in chips) 
Seat 2: Jackall23 (25703 in chips) 
Seat 4: Klemtonius (18184 in chips) 
Seat 5: PokerStarsMan12 (30970 in chips) 
Seat 8: MaFak2019 (31815 in chips) 
Seat 9: manon327 (9881 in chips) 
Klemtonius: posts small blind 50
PokerStarsMan12: posts big blind 100
*** HOLE CARDS ***
Dealt to PokerStarsMan12 [Kc 9h]
MaFak2019: calls 100
manon327: calls 100
color_singleton: folds 
Jackall23: calls 100
Klemtonius: calls 50
PokerStarsMan12: checks 
*** FLOP *** [9s 3s 5d]
Klemtonius: bets 100
PokerStarsMan12: raises 100 to 200
MaFak2019: raises 700 to 900
manon327: calls 900
Jackall23: folds 
Klemtonius: folds 
PokerStarsMan12: folds 
*** TURN *** [9s 3s 5d] [4d]
MaFak2019: bets 1700
manon327: folds 
Uncalled bet (1700) returned to MaFak2019
MaFak2019 collected 2457 from pot
MaFak2019: doesn't show hand 
*** SUMMARY ***
Total pot 2600 | Rake 143 
Board [9s 3s 5d 4d]
Seat 1: color_singleton folded before Flop (didn't bet)
Seat 2: Jackall23 (button) folded on the Flop
Seat 4: Klemtonius (small blind) folded on the Flop
Seat 5: PokerStarsMan12 (big blind) folded on the Flop
Seat 8: MaFak2019 collected (2457)
Seat 9: manon327 folded on the Turn



PokerStars Home Game Hand #226730485070: {DaPokaStars}  Hold'em No Limit (50/100) - 2021/05/13 17:51:52 ET
Table 'again and again' 9-max (Play Money) Seat #4 is the button
Seat 1: color_singleton (14100 in chips) 
Seat 2: Jackall23 (25603 in chips) 
Seat 4: Klemtonius (17984 in chips) 
Seat 5: PokerStarsMan12 (30670 in chips) 
Seat 8: MaFak2019 (33272 in chips) 
Seat 9: manon327 (8881 in chips) 
PokerStarsMan12: posts small blind 50
MaFak2019: posts big blind 100
*** HOLE CARDS ***
Dealt to PokerStarsMan12 [Tc 9c]
manon327: folds 
color_singleton: raises 200 to 300
Jackall23: folds 
Klemtonius: folds 
PokerStarsMan12: calls 250
MaFak2019: calls 200
*** FLOP *** [8d Jc Kh]
PokerStarsMan12: checks 
MaFak2019: checks 
color_singleton: checks 
*** TURN *** [8d Jc Kh] [6s]
PokerStarsMan12: checks 
MaFak2019: bets 600
color_singleton: folds 
PokerStarsMan12: calls 600
*** RIVER *** [8d Jc Kh 6s] [Kc]
PokerStarsMan12: checks 
MaFak2019: bets 800
PokerStarsMan12: folds 
Uncalled bet (800) returned to MaFak2019
MaFak2019 collected 1984 from pot
MaFak2019: doesn't show hand 
*** SUMMARY ***
Total pot 2100 | Rake 116 
Board [8d Jc Kh 6s Kc]
Seat 1: color_singleton folded on the Turn
Seat 2: Jackall23 folded before Flop (didn't bet)
Seat 4: Klemtonius (button) folded before Flop (didn't bet)
Seat 5: PokerStarsMan12 (small blind) folded on the River
Seat 8: MaFak2019 (big blind) collected (1984)
Seat 9: manon327 folded before Flop (didn't bet)



PokerStars Home Game Hand #226730516165: {DaPokaStars}  Hold'em No Limit (50/100) - 2021/05/13 17:52:57 ET
Table 'again and again' 9-max (Play Money) Seat #5 is the button
Seat 1: color_singleton (13800 in chips) 
Seat 2: Jackall23 (25603 in chips) 
Seat 4: Klemtonius (17984 in chips) 
Seat 5: PokerStarsMan12 (29770 in chips) 
Seat 8: MaFak2019 (34356 in chips) 
Seat 9: manon327 (8881 in chips) 
MaFak2019: posts small blind 50
manon327: posts big blind 100
*** HOLE CARDS ***
Dealt to PokerStarsMan12 [9c Jc]
color_singleton: folds 
Jackall23: folds 
Klemtonius: raises 200 to 300
PokerStarsMan12: calls 300
MaFak2019: calls 250
manon327: folds 
*** FLOP *** [4s 2c Kh]
MaFak2019: bets 600
Klemtonius: folds 
PokerStarsMan12: folds 
Uncalled bet (600) returned to MaFak2019
MaFak2019 collected 945 from pot
MaFak2019: doesn't show hand 
*** SUMMARY ***
Total pot 1000 | Rake 55 
Board [4s 2c Kh]
Seat 1: color_singleton folded before Flop (didn't bet)
Seat 2: Jackall23 folded before Flop (didn't bet)
Seat 4: Klemtonius folded on the Flop
Seat 5: PokerStarsMan12 (button) folded on the Flop
Seat 8: MaFak2019 (small blind) collected (945)
Seat 9: manon327 (big blind) folded before Flop



PokerStars Home Game Hand #226730533743: {DaPokaStars}  Hold'em No Limit (50/100) - 2021/05/13 17:53:34 ET
Table 'again and again' 9-max (Play Money) Seat #8 is the button
Seat 1: color_singleton (13800 in chips) 
Seat 2: Jackall23 (25603 in chips) 
Seat 4: Klemtonius (17684 in chips) 
Seat 5: PokerStarsMan12 (29470 in chips) 
Seat 8: MaFak2019 (35001 in chips) 
Seat 9: manon327 (8781 in chips) 
manon327: posts small blind 50
color_singleton: posts big blind 100
*** HOLE CARDS ***
Dealt to PokerStarsMan12 [6h Ks]
Jackall23: folds 
Klemtonius: calls 100
PokerStarsMan12: folds 
MaFak2019: calls 100
manon327: calls 50
color_singleton: raises 400 to 500
Klemtonius: calls 400
MaFak2019: folds 
manon327: folds 
*** FLOP *** [5h Td Jc]
color_singleton: bets 1134
Klemtonius: calls 1134
*** TURN *** [5h Td Jc] [9h]
color_singleton: bets 3277
Klemtonius: calls 3277
*** RIVER *** [5h Td Jc 9h] [Tc]
color_singleton: checks 
Klemtonius: checks 
*** SHOW DOWN ***
color_singleton: shows [Js Ah] (two pair, Jacks and Tens)
Klemtonius: mucks hand 
color_singleton collected 9471 from pot
*** SUMMARY ***
Total pot 10022 | Rake 551 
Board [5h Td Jc 9h Tc]
Seat 1: color_singleton (big blind) showed [Js Ah] and won (9471) with two pair, Jacks and Tens
Seat 2: Jackall23 folded before Flop (didn't bet)
Seat 4: Klemtonius mucked [Jd 9c]
Seat 5: PokerStarsMan12 folded before Flop (didn't bet)
Seat 8: MaFak2019 (button) folded before Flop
Seat 9: manon327 (small blind) folded before Flop



PokerStars Home Game Hand #226730562086: {DaPokaStars}  Hold'em No Limit (50/100) - 2021/05/13 17:54:34 ET
Table 'again and again' 9-max (Play Money) Seat #9 is the button
Seat 1: color_singleton (18360 in chips) 
Seat 2: Jackall23 (25603 in chips) 
Seat 4: Klemtonius (12773 in chips) 
Seat 5: PokerStarsMan12 (29470 in chips) 
Seat 8: MaFak2019 (34901 in chips) 
Seat 9: manon327 (8681 in chips) 
color_singleton: posts small blind 50
Jackall23: posts big blind 100
*** HOLE CARDS ***
Dealt to PokerStarsMan12 [Th 8d]
Klemtonius: folds 
PokerStarsMan12: folds 
MaFak2019: raises 300 to 400
manon327: calls 400
color_singleton: folds 
Jackall23: calls 300
*** FLOP *** [7c 7s 3h]
Jackall23: checks 
MaFak2019: checks 
manon327: bets 1181
Jackall23: folds 
MaFak2019: folds 
Uncalled bet (1181) returned to manon327
manon327 collected 1181 from pot
*** SUMMARY ***
Total pot 1250 | Rake 69 
Board [7c 7s 3h]
Seat 1: color_singleton (small blind) folded before Flop
Seat 2: Jackall23 (big blind) folded on the Flop
Seat 4: Klemtonius folded before Flop (didn't bet)
Seat 5: PokerStarsMan12 folded before Flop (didn't bet)
Seat 8: MaFak2019 folded on the Flop
Seat 9: manon327 (button) collected (1181)



PokerStars Home Game Hand #226730587086: {DaPokaStars}  Hold'em No Limit (50/100) - 2021/05/13 17:55:15 ET
Table 'again and again' 9-max (Play Money) Seat #1 is the button
Seat 1: color_singleton (18310 in chips) 
Seat 2: Jackall23 (25203 in chips) 
Seat 4: Klemtonius (12773 in chips) 
Seat 5: PokerStarsMan12 (29470 in chips) 
Seat 8: MaFak2019 (34501 in chips) 
Seat 9: manon327 (9462 in chips) 
Jackall23: posts small blind 50
Klemtonius: posts big blind 100
*** HOLE CARDS ***
Dealt to PokerStarsMan12 [5s 8h]
PokerStarsMan12: folds 
MaFak2019: calls 100
manon327: calls 100
color_singleton: raises 100 to 200
Jackall23: folds 
Klemtonius: folds 
MaFak2019: calls 100
manon327: calls 100
*** FLOP *** [Kc 5h Ts]
MaFak2019: checks 
manon327: checks 
color_singleton: checks 
*** TURN *** [Kc 5h Ts] [Ks]
MaFak2019: checks 
manon327: checks 
color_singleton: bets 709
MaFak2019: calls 709
manon327: folds 
*** RIVER *** [Kc 5h Ts Ks] [2s]
MaFak2019: checks 
color_singleton: checks 
*** SHOW DOWN ***
MaFak2019: shows [Td 9h] (two pair, Kings and Tens)
color_singleton: mucks hand 
MaFak2019 collected 2049 from pot
*** SUMMARY ***
Total pot 2168 | Rake 119 
Board [Kc 5h Ts Ks 2s]
Seat 1: color_singleton (button) mucked [Js 7h]
Seat 2: Jackall23 (small blind) folded before Flop
Seat 4: Klemtonius (big blind) folded before Flop
Seat 5: PokerStarsMan12 folded before Flop (didn't bet)
Seat 8: MaFak2019 showed [Td 9h] and won (2049) with two pair, Kings and Tens
Seat 9: manon327 folded on the Turn



PokerStars Home Game Hand #226730600252: {DaPokaStars}  Hold'em No Limit (50/100) - 2021/05/13 17:55:51 ET
Table 'again and again' 9-max (Play Money) Seat #2 is the button
Seat 1: color_singleton (17401 in chips) 
Seat 2: Jackall23 (25153 in chips) 
Seat 4: Klemtonius (12673 in chips) 
Seat 5: PokerStarsMan12 (29470 in chips) 
Seat 8: MaFak2019 (35641 in chips) 
Klemtonius: posts small blind 50
PokerStarsMan12: posts big blind 100
*** HOLE CARDS ***
Dealt to PokerStarsMan12 [Qc Ah]
MaFak2019: calls 100
color_singleton: folds 
Jackall23: folds 
Klemtonius: calls 50
PokerStarsMan12: raises 300 to 400
MaFak2019: calls 300
Klemtonius: calls 300
*** FLOP *** [2d Ac 6c]
Klemtonius: checks 
PokerStarsMan12: bets 800
MaFak2019: folds 
Klemtonius: folds 
Uncalled bet (800) returned to PokerStarsMan12
PokerStarsMan12 collected 1134 from pot
*** SUMMARY ***
Total pot 1200 | Rake 66 
Board [2d Ac 6c]
Seat 1: color_singleton folded before Flop (didn't bet)
Seat 2: Jackall23 (button) folded before Flop (didn't bet)
Seat 4: Klemtonius (small blind) folded on the Flop
Seat 5: PokerStarsMan12 (big blind) collected (1134)
Seat 8: MaFak2019 folded on the Flop



PokerStars Home Game Hand #226730614498: {DaPokaStars}  Hold'em No Limit (50/100) - 2021/05/13 17:56:30 ET
Table 'again and again' 9-max (Play Money) Seat #4 is the button
Seat 1: color_singleton (17401 in chips) 
Seat 2: Jackall23 (25153 in chips) 
Seat 4: Klemtonius (12273 in chips) 
Seat 5: PokerStarsMan12 (30204 in chips) 
Seat 8: MaFak2019 (35241 in chips) 
PokerStarsMan12: posts small blind 50
MaFak2019: posts big blind 100
*** HOLE CARDS ***
Dealt to PokerStarsMan12 [Th 4c]
color_singleton: folds 
Jackall23: calls 100
Klemtonius: folds 
PokerStarsMan12: calls 50
MaFak2019: checks 
*** FLOP *** [Jc 3h Ah]
PokerStarsMan12: checks 
MaFak2019: bets 283
Jackall23: calls 283
PokerStarsMan12: folds 
*** TURN *** [Jc 3h Ah] [3d]
MaFak2019: bets 818
Jackall23: calls 818
*** RIVER *** [Jc 3h Ah 3d] [Qd]
MaFak2019: bets 2364
Jackall23: calls 2364
*** SHOW DOWN ***
MaFak2019: shows [8h Ac] (two pair, Aces and Threes)
Jackall23: mucks hand 
MaFak2019 collected 6832 from pot
*** SUMMARY ***
Total pot 7230 | Rake 398 
Board [Jc 3h Ah 3d Qd]
Seat 1: color_singleton folded before Flop (didn't bet)
Seat 2: Jackall23 mucked [Kd Kc]
Seat 4: Klemtonius (button) folded before Flop (didn't bet)
Seat 5: PokerStarsMan12 (small blind) folded on the Flop
Seat 8: MaFak2019 (big blind) showed [8h Ac] and won (6832) with two pair, Aces and Threes



PokerStars Home Game Hand #226730631798: {DaPokaStars}  Hold'em No Limit (50/100) - 2021/05/13 17:57:17 ET
Table 'again and again' 9-max (Play Money) Seat #5 is the button
Seat 1: color_singleton (17401 in chips) 
Seat 2: Jackall23 (21588 in chips) 
Seat 4: Klemtonius (12273 in chips) 
Seat 5: PokerStarsMan12 (30104 in chips) 
Seat 8: MaFak2019 (38508 in chips) 
MaFak2019: posts small blind 50
color_singleton: posts big blind 100
*** HOLE CARDS ***
Dealt to PokerStarsMan12 [Js 4s]
Jackall23: folds 
Klemtonius: calls 100
PokerStarsMan12: folds 
MaFak2019: calls 50
color_singleton: checks 
*** FLOP *** [Ah Ks Th]
MaFak2019: checks 
color_singleton: bets 141
Klemtonius: calls 141
MaFak2019: calls 141
*** TURN *** [Ah Ks Th] [4h]
MaFak2019: bets 683
color_singleton: calls 683
Klemtonius: calls 683
*** RIVER *** [Ah Ks Th 4h] [6d]
MaFak2019: checks 
color_singleton: bets 1310
Klemtonius: folds 
MaFak2019: folds 
Uncalled bet (1310) returned to color_singleton
color_singleton collected 2620 from pot
color_singleton: doesn't show hand 
*** SUMMARY ***
Total pot 2772 | Rake 152 
Board [Ah Ks Th 4h 6d]
Seat 1: color_singleton (big blind) collected (2620)
Seat 2: Jackall23 folded before Flop (didn't bet)
Seat 4: Klemtonius folded on the River
Seat 5: PokerStarsMan12 (button) folded before Flop (didn't bet)
Seat 8: MaFak2019 (small blind) folded on the River



PokerStars Home Game Hand #226730656993: {DaPokaStars}  Hold'em No Limit (50/100) - 2021/05/13 17:58:04 ET
Table 'again and again' 9-max (Play Money) Seat #8 is the button
Seat 1: color_singleton (19097 in chips) 
Seat 2: Jackall23 (21588 in chips) 
Seat 4: Klemtonius (11349 in chips) 
Seat 5: PokerStarsMan12 (30104 in chips) 
Seat 8: MaFak2019 (37584 in chips) 
color_singleton: posts small blind 50
Jackall23: posts big blind 100
*** HOLE CARDS ***
Dealt to PokerStarsMan12 [5h 2c]
Klemtonius: raises 100 to 200
PokerStarsMan12: folds 
MaFak2019: folds 
color_singleton: folds 
Jackall23: calls 100
*** FLOP *** [As 4s 6d]
Jackall23: checks 
Klemtonius: bets 212
Jackall23: calls 212
*** TURN *** [As 4s 6d] [Qh]
Jackall23: checks 
Klemtonius: checks 
*** RIVER *** [As 4s 6d Qh] [Ks]
Jackall23: bets 413
Klemtonius: calls 413
*** SHOW DOWN ***
Jackall23: shows [Kh Ad] (two pair, Aces and Kings)
Klemtonius: mucks hand 
Jackall23 collected 1606 from pot
*** SUMMARY ***
Total pot 1700 | Rake 94 
Board [As 4s 6d Qh Ks]
Seat 1: color_singleton (small blind) folded before Flop
Seat 2: Jackall23 (big blind) showed [Kh Ad] and won (1606) with two pair, Aces and Kings
Seat 4: Klemtonius mucked [2h Ac]
Seat 5: PokerStarsMan12 folded before Flop (didn't bet)
Seat 8: MaFak2019 (button) folded before Flop (didn't bet)



PokerStars Home Game Hand #226730670481: {DaPokaStars}  Hold'em No Limit (50/100) - 2021/05/13 17:58:41 ET
Table 'again and again' 9-max (Play Money) Seat #1 is the button
Seat 1: color_singleton (19047 in chips) 
Seat 2: Jackall23 (22369 in chips) 
Seat 4: Klemtonius (10524 in chips) 
Seat 5: PokerStarsMan12 (30104 in chips) 
Seat 8: MaFak2019 (37584 in chips) 
Jackall23: posts small blind 50
Klemtonius: posts big blind 100
*** HOLE CARDS ***
Dealt to PokerStarsMan12 [3s Kc]
PokerStarsMan12: folds 
MaFak2019: folds 
color_singleton: raises 200 to 300
Jackall23: calls 250
Klemtonius: calls 200
*** FLOP *** [4h 7c Qd]
Jackall23: checks 
Klemtonius: checks 
color_singleton: checks 
*** TURN *** [4h 7c Qd] [Tc]
Jackall23: checks 
Klemtonius: checks 
color_singleton: checks 
*** RIVER *** [4h 7c Qd Tc] [2c]
Jackall23: checks 
Klemtonius: checks 
color_singleton: checks 
*** SHOW DOWN ***
Jackall23: shows [7s 8s] (a pair of Sevens)
Klemtonius: mucks hand 
color_singleton: mucks hand 
Jackall23 collected 850 from pot
*** SUMMARY ***
Total pot 900 | Rake 50 
Board [4h 7c Qd Tc 2c]
Seat 1: color_singleton (button) mucked [Kd 3c]
Seat 2: Jackall23 (small blind) showed [7s 8s] and won (850) with a pair of Sevens
Seat 4: Klemtonius (big blind) mucked [8h Ks]
Seat 5: PokerStarsMan12 folded before Flop (didn't bet)
Seat 8: MaFak2019 folded before Flop (didn't bet)



PokerStars Home Game Hand #226730681272: {DaPokaStars}  Hold'em No Limit (50/100) - 2021/05/13 17:59:11 ET
Table 'again and again' 9-max (Play Money) Seat #2 is the button
Seat 1: color_singleton (18747 in chips) 
Seat 2: Jackall23 (22919 in chips) 
Seat 4: Klemtonius (10224 in chips) 
Seat 5: PokerStarsMan12 (30104 in chips) 
Seat 8: MaFak2019 (37584 in chips) 
Seat 9: manon327 (9262 in chips) 
Klemtonius: posts small blind 50
PokerStarsMan12: posts big blind 100
manon327: posts small & big blinds 150
*** HOLE CARDS ***
Dealt to PokerStarsMan12 [5h 4s]
MaFak2019: calls 100
manon327: checks 
color_singleton: calls 100
Jackall23: calls 100
Klemtonius: calls 50
PokerStarsMan12: checks 
*** FLOP *** [7s 6c Qc]
Klemtonius: checks 
PokerStarsMan12: bets 300
MaFak2019: calls 300
manon327: calls 300
color_singleton: folds 
Jackall23: calls 300
Klemtonius: folds 
*** TURN *** [7s 6c Qc] [7c]
PokerStarsMan12: checks 
MaFak2019: checks 
manon327: checks 
Jackall23: checks 
*** RIVER *** [7s 6c Qc 7c] [5s]
PokerStarsMan12: checks 
MaFak2019: checks 
manon327: bets 874
Jackall23: calls 874
PokerStarsMan12: folds 
MaFak2019: calls 874
*** SHOW DOWN ***
manon327: shows [8s 9d] (a straight, Five to Nine)
Jackall23: mucks hand 
MaFak2019: mucks hand 
manon327 collected 4226 from pot
*** SUMMARY ***
Total pot 4472 | Rake 246 
Board [7s 6c Qc 7c 5s]
Seat 1: color_singleton folded on the Flop
Seat 2: Jackall23 (button) mucked [Qs 3s]
Seat 4: Klemtonius (small blind) folded on the Flop
Seat 5: PokerStarsMan12 (big blind) folded on the River
Seat 8: MaFak2019 mucked [Td 8d]
Seat 9: manon327 showed [8s 9d] and won (4226) with a straight, Five to Nine



PokerStars Home Game Hand #226730700809: {DaPokaStars}  Hold'em No Limit (50/100) - 2021/05/13 18:00:06 ET
Table 'again and again' 9-max (Play Money) Seat #4 is the button
Seat 1: color_singleton (18647 in chips) 
Seat 2: Jackall23 (21645 in chips) 
Seat 4: Klemtonius (10124 in chips) 
Seat 5: PokerStarsMan12 (29704 in chips) 
Seat 8: MaFak2019 (36310 in chips) 
Seat 9: manon327 (12164 in chips) 
PokerStarsMan12: posts small blind 50
MaFak2019: posts big blind 100
*** HOLE CARDS ***
Dealt to PokerStarsMan12 [6h Ac]
manon327: calls 100
color_singleton: folds 
Jackall23: folds 
Klemtonius: raises 100 to 200
PokerStarsMan12: calls 150
MaFak2019: calls 100
manon327: calls 100
*** FLOP *** [6s 4h 8s]
PokerStarsMan12: bets 300
MaFak2019: folds 
manon327: calls 300
Klemtonius: folds 
*** TURN *** [6s 4h 8s] [9d]
PokerStarsMan12: checks 
manon327: checks 
*** RIVER *** [6s 4h 8s 9d] [3d]
PokerStarsMan12: bets 800
manon327: folds 
Uncalled bet (800) returned to PokerStarsMan12
PokerStarsMan12 collected 1323 from pot
*** SUMMARY ***
Total pot 1400 | Rake 77 
Board [6s 4h 8s 9d 3d]
Seat 1: color_singleton folded before Flop (didn't bet)
Seat 2: Jackall23 folded before Flop (didn't bet)
Seat 4: Klemtonius (button) folded on the Flop
Seat 5: PokerStarsMan12 (small blind) collected (1323)
Seat 8: MaFak2019 (big blind) folded on the Flop
Seat 9: manon327 folded on the River



PokerStars Home Game Hand #226730718907: {DaPokaStars}  Hold'em No Limit (50/100) - 2021/05/13 18:00:52 ET
Table 'again and again' 9-max (Play Money) Seat #5 is the button
Seat 1: color_singleton (18647 in chips) 
Seat 2: Jackall23 (21645 in chips) 
Seat 4: Klemtonius (9924 in chips) 
Seat 5: PokerStarsMan12 (30527 in chips) 
Seat 8: MaFak2019 (36110 in chips) 
Seat 9: manon327 (11664 in chips) 
MaFak2019: posts small blind 50
manon327: posts big blind 100
*** HOLE CARDS ***
Dealt to PokerStarsMan12 [8s Ac]
color_singleton: folds 
Jackall23: calls 100
Klemtonius: folds 
PokerStarsMan12: raises 300 to 400
MaFak2019: folds 
manon327: calls 300
Jackall23: folds 
*** FLOP *** [As 5c Jd]
manon327: bets 449
PokerStarsMan12: calls 449
*** TURN *** [As 5c Jd] [Ah]
manon327: bets 873
PokerStarsMan12: calls 873
*** RIVER *** [As 5c Jd Ah] [Kd]
manon327: bets 1698
PokerStarsMan12: calls 1698
*** SHOW DOWN ***
manon327: shows [9d Ad] (three of a kind, Aces)
PokerStarsMan12: shows [8s Ac] (three of a kind, Aces)
manon327 collected 3303 from pot
PokerStarsMan12 collected 3303 from pot
*** SUMMARY ***
Total pot 6990 | Rake 384 
Board [As 5c Jd Ah Kd]
Seat 1: color_singleton folded before Flop (didn't bet)
Seat 2: Jackall23 folded before Flop
Seat 4: Klemtonius folded before Flop (didn't bet)
Seat 5: PokerStarsMan12 (button) showed [8s Ac] and won (3303) with three of a kind, Aces
Seat 8: MaFak2019 (small blind) folded before Flop
Seat 9: manon327 (big blind) showed [9d Ad] and won (3303) with three of a kind, Aces



PokerStars Home Game Hand #226730740021: {DaPokaStars}  Hold'em No Limit (50/100) - 2021/05/13 18:01:40 ET
Table 'again and again' 9-max (Play Money) Seat #8 is the button
Seat 1: color_singleton (18647 in chips) 
Seat 2: Jackall23 (21545 in chips) 
Seat 4: Klemtonius (9924 in chips) 
Seat 5: PokerStarsMan12 (30410 in chips) 
Seat 8: MaFak2019 (36060 in chips) 
Seat 9: manon327 (11547 in chips) 
manon327: posts small blind 50
color_singleton: posts big blind 100
*** HOLE CARDS ***
Dealt to PokerStarsMan12 [Ac Js]
Jackall23: raises 100 to 200
Klemtonius: calls 200
PokerStarsMan12: raises 300 to 500
MaFak2019: raises 300 to 800
manon327: folds 
color_singleton: folds 
Jackall23: calls 600
Klemtonius: folds 
PokerStarsMan12: calls 300
*** FLOP *** [2d Jd Ts]
Jackall23: checks 
PokerStarsMan12: bets 1300
MaFak2019: raises 1300 to 2600
Jackall23: folds 
PokerStarsMan12: calls 1300
*** TURN *** [2d Jd Ts] [8h]
PokerStarsMan12: checks 
MaFak2019: checks 
*** RIVER *** [2d Jd Ts 8h] [8s]
PokerStarsMan12: bets 3800
MaFak2019: calls 3800
*** SHOW DOWN ***
PokerStarsMan12: shows [Ac Js] (two pair, Jacks and Eights)
MaFak2019: shows [Ah Ad] (two pair, Aces and Eights)
MaFak2019 collected 14695 from pot
*** SUMMARY ***
Total pot 15550 | Rake 855 
Board [2d Jd Ts 8h 8s]
Seat 1: color_singleton (big blind) folded before Flop
Seat 2: Jackall23 folded on the Flop
Seat 4: Klemtonius folded before Flop
Seat 5: PokerStarsMan12 showed [Ac Js] and lost with two pair, Jacks and Eights
Seat 8: MaFak2019 (button) showed [Ah Ad] and won (14695) with two pair, Aces and Eights
Seat 9: manon327 (small blind) folded before Flop



PokerStars Home Game Hand #226730759732: {DaPokaStars}  Hold'em No Limit (50/100) - 2021/05/13 18:02:23 ET
Table 'again and again' 9-max (Play Money) Seat #9 is the button
Seat 1: color_singleton (18547 in chips) 
Seat 2: Jackall23 (20745 in chips) 
Seat 4: Klemtonius (9724 in chips) 
Seat 5: PokerStarsMan12 (23210 in chips) 
Seat 8: MaFak2019 (43555 in chips) 
Seat 9: manon327 (11497 in chips) 
color_singleton: posts small blind 50
Jackall23: posts big blind 100
*** HOLE CARDS ***
Dealt to PokerStarsMan12 [9s Qh]
Klemtonius: raises 100 to 200
PokerStarsMan12: calls 200
MaFak2019: calls 200
manon327: calls 200
color_singleton: calls 150
Jackall23: folds 
*** FLOP *** [Js 2d 2c]
color_singleton: checks 
Klemtonius: checks 
PokerStarsMan12: checks 
MaFak2019: checks 
manon327: checks 
*** TURN *** [Js 2d 2c] [6d]
color_singleton: checks 
Klemtonius: checks 
PokerStarsMan12: checks 
MaFak2019: checks 
manon327: checks 
*** RIVER *** [Js 2d 2c 6d] [Qc]
color_singleton: checks 
Klemtonius: checks 
PokerStarsMan12: bets 700
MaFak2019: folds 
manon327: calls 700
color_singleton: folds 
Klemtonius: folds 
*** SHOW DOWN ***
PokerStarsMan12: shows [9s Qh] (two pair, Queens and Deuces)
manon327: shows [Qs 3c] (two pair, Queens and Deuces)
PokerStarsMan12 collected 1181 from pot
manon327 collected 1181 from pot
*** SUMMARY ***
Total pot 2500 | Rake 138 
Board [Js 2d 2c 6d Qc]
Seat 1: color_singleton (small blind) folded on the River
Seat 2: Jackall23 (big blind) folded before Flop
Seat 4: Klemtonius folded on the River
Seat 5: PokerStarsMan12 showed [9s Qh] and won (1181) with two pair, Queens and Deuces
Seat 8: MaFak2019 folded on the River
Seat 9: manon327 (button) showed [Qs 3c] and won (1181) with two pair, Queens and Deuces



PokerStars Home Game Hand #226730786216: {DaPokaStars}  Hold'em No Limit (50/100) - 2021/05/13 18:03:21 ET
Table 'again and again' 9-max (Play Money) Seat #1 is the button
Seat 1: color_singleton (18347 in chips) 
Seat 2: Jackall23 (20645 in chips) 
Seat 4: Klemtonius (9524 in chips) 
Seat 5: PokerStarsMan12 (23491 in chips) 
Seat 8: MaFak2019 (43355 in chips) 
Seat 9: manon327 (11778 in chips) 
Jackall23: posts small blind 50
Klemtonius: posts big blind 100
*** HOLE CARDS ***
Dealt to PokerStarsMan12 [2c Kd]
PokerStarsMan12: folds 
MaFak2019: calls 100
manon327: calls 100
color_singleton: calls 100
Jackall23: calls 50
Klemtonius: raises 500 to 600
MaFak2019: calls 500
manon327: calls 500
color_singleton: calls 500
Jackall23: calls 500
*** FLOP *** [Kh Qc Ah]
Jackall23: checks 
Klemtonius: bets 2835
MaFak2019: folds 
manon327: calls 2835
color_singleton: folds 
Jackall23: folds 
*** TURN *** [Kh Qc Ah] [Ac]
Klemtonius: bets 6089 and is all-in
manon327: calls 6089
*** RIVER *** [Kh Qc Ah Ac] [4s]
*** SHOW DOWN ***
Klemtonius: shows [Qs Qd] (a full house, Queens full of Aces)
manon327: shows [Ad 6d] (three of a kind, Aces)
Klemtonius collected 19701 from pot
*** SUMMARY ***
Total pot 20848 | Rake 1147 
Board [Kh Qc Ah Ac 4s]
Seat 1: color_singleton (button) folded on the Flop
Seat 2: Jackall23 (small blind) folded on the Flop
Seat 4: Klemtonius (big blind) showed [Qs Qd] and won (19701) with a full house, Queens full of Aces
Seat 5: PokerStarsMan12 folded before Flop (didn't bet)
Seat 8: MaFak2019 folded on the Flop
Seat 9: manon327 showed [Ad 6d] and lost with three of a kind, Aces



PokerStars Home Game Hand #226730816676: {DaPokaStars}  Hold'em No Limit (50/100) - 2021/05/13 18:04:26 ET
Table 'again and again' 9-max (Play Money) Seat #2 is the button
Seat 1: color_singleton (17747 in chips) 
Seat 2: Jackall23 (20045 in chips) 
Seat 4: Klemtonius (19701 in chips) 
Seat 5: PokerStarsMan12 (23491 in chips) 
Seat 8: MaFak2019 (42755 in chips) 
Seat 9: manon327 (2254 in chips) 
Klemtonius: posts small blind 50
PokerStarsMan12: posts big blind 100
*** HOLE CARDS ***
Dealt to PokerStarsMan12 [Td 4h]
MaFak2019: calls 100
manon327: folds 
color_singleton: raises 200 to 300
Jackall23: folds 
Klemtonius: calls 250
PokerStarsMan12: folds 
MaFak2019: raises 200 to 500
color_singleton: calls 200
Klemtonius: calls 200
*** FLOP *** [Ad 9c 8c]
Klemtonius: bets 1512
MaFak2019: raises 1512 to 3024
color_singleton: folds 
Klemtonius: calls 1512
*** TURN *** [Ad 9c 8c] [2d]
Klemtonius: checks 
MaFak2019: bets 3613
Klemtonius: calls 3613
*** RIVER *** [Ad 9c 8c 2d] [Kd]
Klemtonius: checks 
MaFak2019: bets 7028
Klemtonius: folds 
Uncalled bet (7028) returned to MaFak2019
MaFak2019 collected 14056 from pot
MaFak2019: doesn't show hand 
*** SUMMARY ***
Total pot 14874 | Rake 818 
Board [Ad 9c 8c 2d Kd]
Seat 1: color_singleton folded on the Flop
Seat 2: Jackall23 (button) folded before Flop (didn't bet)
Seat 4: Klemtonius (small blind) folded on the River
Seat 5: PokerStarsMan12 (big blind) folded before Flop
Seat 8: MaFak2019 collected (14056)
Seat 9: manon327 folded before Flop (didn't bet)



PokerStars Home Game Hand #226730855917: {DaPokaStars}  Hold'em No Limit (50/100) - 2021/05/13 18:05:51 ET
Table 'again and again' 9-max (Play Money) Seat #4 is the button
Seat 1: color_singleton (17247 in chips) 
Seat 2: Jackall23 (20045 in chips) 
Seat 4: Klemtonius (12564 in chips) 
Seat 5: PokerStarsMan12 (23391 in chips) 
Seat 8: MaFak2019 (49674 in chips) 
Seat 9: manon327 (2254 in chips) 
PokerStarsMan12: posts small blind 50
MaFak2019: posts big blind 100
*** HOLE CARDS ***
Dealt to PokerStarsMan12 [2d Ad]
manon327: calls 100
color_singleton: raises 200 to 300
Jackall23: folds 
Klemtonius: raises 200 to 500
PokerStarsMan12: folds 
MaFak2019: calls 400
manon327: folds 
color_singleton: calls 200
*** FLOP *** [7s 9d 4h]
MaFak2019: checks 
color_singleton: checks 
Klemtonius: checks 
*** TURN *** [7s 9d 4h] [4c]
MaFak2019: checks 
color_singleton: bets 779
Klemtonius: calls 779
MaFak2019: calls 779
*** RIVER *** [7s 9d 4h 4c] [8h]
MaFak2019: checks 
color_singleton: checks 
Klemtonius: checks 
*** SHOW DOWN ***
MaFak2019: shows [7d Jh] (two pair, Sevens and Fours)
color_singleton: mucks hand 
Klemtonius: shows [8s As] (two pair, Eights and Fours)
Klemtonius collected 3768 from pot
*** SUMMARY ***
Total pot 3987 | Rake 219 
Board [7s 9d 4h 4c 8h]
Seat 1: color_singleton mucked [3d 3h]
Seat 2: Jackall23 folded before Flop (didn't bet)
Seat 4: Klemtonius (button) showed [8s As] and won (3768) with two pair, Eights and Fours
Seat 5: PokerStarsMan12 (small blind) folded before Flop
Seat 8: MaFak2019 (big blind) showed [7d Jh] and lost with two pair, Sevens and Fours
Seat 9: manon327 folded before Flop



PokerStars Home Game Hand #226730882049: {DaPokaStars}  Hold'em No Limit (50/100) - 2021/05/13 18:06:46 ET
Table 'again and again' 9-max (Play Money) Seat #5 is the button
Seat 1: color_singleton (15968 in chips) 
Seat 2: Jackall23 (20045 in chips) 
Seat 4: Klemtonius (15053 in chips) 
Seat 5: PokerStarsMan12 (23341 in chips) 
Seat 8: MaFak2019 (48395 in chips) 
Seat 9: manon327 (2154 in chips) 
MaFak2019: posts small blind 50
manon327: posts big blind 100
*** HOLE CARDS ***
Dealt to PokerStarsMan12 [Ts Jh]
color_singleton: folds 
Jackall23: calls 100
Klemtonius: raises 100 to 200
PokerStarsMan12: calls 200
MaFak2019: calls 150
manon327: calls 100
Jackall23: calls 100
*** FLOP *** [8c 5h 7c]
MaFak2019: bets 472
manon327: calls 472
Jackall23: folds 
Klemtonius: calls 472
PokerStarsMan12: folds 
*** TURN *** [8c 5h 7c] [6c]
MaFak2019: bets 1141
manon327: calls 1141
Klemtonius: raises 1141 to 2282
MaFak2019: calls 1141
manon327: calls 341 and is all-in
*** RIVER *** [8c 5h 7c 6c] [Qs]
MaFak2019: checks 
Klemtonius: checks 
*** SHOW DOWN ***
MaFak2019: shows [6h 8d] (two pair, Eights and Sixes)
Klemtonius: mucks hand 
MaFak2019 collected 1512 from side pot
manon327: shows [5c Jc] (a flush, Jack high)
manon327 collected 6485 from main pot
*** SUMMARY ***
Total pot 8462 Main pot 6485. Side pot 1512. | Rake 465 
Board [8c 5h 7c 6c Qs]
Seat 1: color_singleton folded before Flop (didn't bet)
Seat 2: Jackall23 folded on the Flop
Seat 4: Klemtonius mucked [6d 5d]
Seat 5: PokerStarsMan12 (button) folded on the Flop
Seat 8: MaFak2019 (small blind) showed [6h 8d] and won (1512) with two pair, Eights and Sixes
Seat 9: manon327 (big blind) showed [5c Jc] and won (6485) with a flush, Jack high



PokerStars Home Game Hand #226730908524: {DaPokaStars}  Hold'em No Limit (50/100) - 2021/05/13 18:07:43 ET
Table 'again and again' 9-max (Play Money) Seat #8 is the button
Seat 1: color_singleton (15968 in chips) 
Seat 2: Jackall23 (19845 in chips) 
Seat 4: Klemtonius (12099 in chips) 
Seat 5: PokerStarsMan12 (23141 in chips) 
Seat 8: MaFak2019 (46953 in chips) 
Seat 9: manon327 (6485 in chips) 
manon327: posts small blind 50
color_singleton: posts big blind 100
*** HOLE CARDS ***
Dealt to PokerStarsMan12 [9d 6c]
Jackall23: folds 
Klemtonius: folds 
PokerStarsMan12: folds 
MaFak2019: calls 100
manon327: folds 
color_singleton: raises 200 to 300
MaFak2019: calls 200
*** FLOP *** [9s 8d Jh]
color_singleton: bets 307
MaFak2019: calls 307
*** TURN *** [9s 8d Jh] [7d]
color_singleton: checks 
MaFak2019: checks 
*** RIVER *** [9s 8d Jh 7d] [4c]
color_singleton: bets 1194
MaFak2019: folds 
Uncalled bet (1194) returned to color_singleton
color_singleton collected 1194 from pot
color_singleton: doesn't show hand 
*** SUMMARY ***
Total pot 1264 | Rake 70 
Board [9s 8d Jh 7d 4c]
Seat 1: color_singleton (big blind) collected (1194)
Seat 2: Jackall23 folded before Flop (didn't bet)
Seat 4: Klemtonius folded before Flop (didn't bet)
Seat 5: PokerStarsMan12 folded before Flop (didn't bet)
Seat 8: MaFak2019 (button) folded on the River
Seat 9: manon327 (small blind) folded before Flop



PokerStars Home Game Hand #226730925774: {DaPokaStars}  Hold'em No Limit (50/100) - 2021/05/13 18:08:21 ET
Table 'again and again' 9-max (Play Money) Seat #9 is the button
Seat 1: color_singleton (16555 in chips) 
Seat 2: Jackall23 (19845 in chips) 
Seat 4: Klemtonius (12099 in chips) 
Seat 5: PokerStarsMan12 (23141 in chips) 
Seat 8: MaFak2019 (46346 in chips) 
Seat 9: manon327 (6435 in chips) 
color_singleton: posts small blind 50
Jackall23: posts big blind 100
*** HOLE CARDS ***
Dealt to PokerStarsMan12 [3d 9d]
Klemtonius: calls 100
PokerStarsMan12: folds 
MaFak2019: calls 100
manon327: calls 100
color_singleton: raises 200 to 300
Jackall23: calls 200
Klemtonius: calls 200
MaFak2019: calls 200
manon327: calls 200
*** FLOP *** [9c As 8d]
color_singleton: bets 1417
Jackall23: folds 
Klemtonius: folds 
MaFak2019: folds 
manon327: folds 
Uncalled bet (1417) returned to color_singleton
color_singleton collected 1417 from pot
color_singleton: doesn't show hand 
*** SUMMARY ***
Total pot 1500 | Rake 83 
Board [9c As 8d]
Seat 1: color_singleton (small blind) collected (1417)
Seat 2: Jackall23 (big blind) folded on the Flop
Seat 4: Klemtonius folded on the Flop
Seat 5: PokerStarsMan12 folded before Flop (didn't bet)
Seat 8: MaFak2019 folded on the Flop
Seat 9: manon327 (button) folded on the Flop



PokerStars Home Game Hand #226730943280: {DaPokaStars}  Hold'em No Limit (50/100) - 2021/05/13 18:09:00 ET
Table 'again and again' 9-max (Play Money) Seat #1 is the button
Seat 1: color_singleton (17672 in chips) 
Seat 2: Jackall23 (19545 in chips) 
Seat 4: Klemtonius (11799 in chips) 
Seat 5: PokerStarsMan12 (23141 in chips) 
Seat 8: MaFak2019 (46046 in chips) 
Seat 9: manon327 (6135 in chips) 
Jackall23: posts small blind 50
Klemtonius: posts big blind 100
*** HOLE CARDS ***
Dealt to PokerStarsMan12 [Qc Th]
PokerStarsMan12: raises 200 to 300
MaFak2019: folds 
manon327: calls 300
color_singleton: folds 
Jackall23: folds 
Klemtonius: calls 200
*** FLOP *** [5c As 9s]
Klemtonius: checks 
PokerStarsMan12: checks 
manon327: checks 
*** TURN *** [5c As 9s] [5s]
Klemtonius: bets 449
PokerStarsMan12: folds 
manon327: calls 449
*** RIVER *** [5c As 9s 5s] [Tc]
Klemtonius: checks 
manon327: checks 
*** SHOW DOWN ***
Klemtonius: shows [Qs 9d] (two pair, Nines and Fives)
manon327: shows [Kc Ts] (two pair, Tens and Fives)
manon327 collected 1746 from pot
*** SUMMARY ***
Total pot 1848 | Rake 102 
Board [5c As 9s 5s Tc]
Seat 1: color_singleton (button) folded before Flop (didn't bet)
Seat 2: Jackall23 (small blind) folded before Flop
Seat 4: Klemtonius (big blind) showed [Qs 9d] and lost with two pair, Nines and Fives
Seat 5: PokerStarsMan12 folded on the Turn
Seat 8: MaFak2019 folded before Flop (didn't bet)
Seat 9: manon327 showed [Kc Ts] and won (1746) with two pair, Tens and Fives



PokerStars Home Game Hand #226730958512: {DaPokaStars}  Hold'em No Limit (50/100) - 2021/05/13 18:09:34 ET
Table 'again and again' 9-max (Play Money) Seat #2 is the button
Seat 1: color_singleton (17672 in chips) 
Seat 2: Jackall23 (19495 in chips) 
Seat 4: Klemtonius (11050 in chips) 
Seat 5: PokerStarsMan12 (22841 in chips) 
Seat 8: MaFak2019 (46046 in chips) 
Seat 9: manon327 (7132 in chips) 
Klemtonius: posts small blind 50
PokerStarsMan12: posts big blind 100
*** HOLE CARDS ***
Dealt to PokerStarsMan12 [Qd 6c]
MaFak2019: calls 100
manon327: folds 
color_singleton: raises 300 to 400
Jackall23: folds 
Klemtonius: folds 
PokerStarsMan12: folds 
MaFak2019: calls 300
*** FLOP *** [Js 5d 8d]
MaFak2019: checks 
color_singleton: bets 449
MaFak2019: folds 
Uncalled bet (449) returned to color_singleton
color_singleton collected 898 from pot
color_singleton: doesn't show hand 
*** SUMMARY ***
Total pot 950 | Rake 52 
Board [Js 5d 8d]
Seat 1: color_singleton collected (898)
Seat 2: Jackall23 (button) folded before Flop (didn't bet)
Seat 4: Klemtonius (small blind) folded before Flop
Seat 5: PokerStarsMan12 (big blind) folded before Flop
Seat 8: MaFak2019 folded on the Flop
Seat 9: manon327 folded before Flop (didn't bet)



PokerStars Home Game Hand #226730967936: {DaPokaStars}  Hold'em No Limit (50/100) - 2021/05/13 18:09:55 ET
Table 'again and again' 9-max (Play Money) Seat #4 is the button
Seat 1: color_singleton (18170 in chips) 
Seat 2: Jackall23 (19495 in chips) 
Seat 4: Klemtonius (11000 in chips) 
Seat 5: PokerStarsMan12 (22741 in chips) 
Seat 8: MaFak2019 (45646 in chips) 
Seat 9: manon327 (7132 in chips) 
PokerStarsMan12: posts small blind 50
MaFak2019: posts big blind 100
*** HOLE CARDS ***
Dealt to PokerStarsMan12 [Qh Kc]
manon327: folds 
color_singleton: raises 200 to 300
Jackall23: folds 
Klemtonius: calls 300
PokerStarsMan12: calls 250
MaFak2019: raises 200 to 500
color_singleton: calls 200
Klemtonius: calls 200
PokerStarsMan12: calls 200
*** FLOP *** [Ad 9s 8d]
PokerStarsMan12: checks 
MaFak2019: checks 
color_singleton: bets 1890
Klemtonius: calls 1890
PokerStarsMan12: folds 
MaFak2019: folds 
*** TURN *** [Ad 9s 8d] [3s]
color_singleton: bets 5462
Klemtonius: calls 5462
*** RIVER *** [Ad 9s 8d 3s] [Th]
color_singleton: bets 7892
Klemtonius: calls 3148 and is all-in
Uncalled bet (4744) returned to color_singleton
*** SHOW DOWN ***
color_singleton: shows [Qd Ac] (a pair of Aces)
Klemtonius: shows [Jh Qs] (a straight, Eight to Queen)
Klemtonius collected 21735 from pot
*** SUMMARY ***
Total pot 23000 | Rake 1265 
Board [Ad 9s 8d 3s Th]
Seat 1: color_singleton showed [Qd Ac] and lost with a pair of Aces
Seat 2: Jackall23 folded before Flop (didn't bet)
Seat 4: Klemtonius (button) showed [Jh Qs] and won (21735) with a straight, Eight to Queen
Seat 5: PokerStarsMan12 (small blind) folded on the Flop
Seat 8: MaFak2019 (big blind) folded on the Flop
Seat 9: manon327 folded before Flop (didn't bet)



PokerStars Home Game Hand #226730992091: {DaPokaStars}  Hold'em No Limit (50/100) - 2021/05/13 18:10:48 ET
Table 'again and again' 9-max (Play Money) Seat #5 is the button
Seat 1: color_singleton (7170 in chips) 
Seat 2: Jackall23 (19495 in chips) 
Seat 4: Klemtonius (21735 in chips) 
Seat 5: PokerStarsMan12 (22241 in chips) 
Seat 8: MaFak2019 (45146 in chips) 
Seat 9: manon327 (7132 in chips) 
MaFak2019: posts small blind 50
manon327: posts big blind 100
*** HOLE CARDS ***
Dealt to PokerStarsMan12 [As 8c]
color_singleton: raises 200 to 300
Jackall23: folds 
Klemtonius: raises 200 to 500
PokerStarsMan12: calls 500
MaFak2019: calls 450
manon327: calls 400
color_singleton: raises 700 to 1200
Klemtonius: calls 700
PokerStarsMan12: folds 
MaFak2019: calls 700
manon327: folds 
*** FLOP *** [Ks 9c Jd]
MaFak2019: bets 2173
color_singleton: calls 2173
Klemtonius: folds 
*** TURN *** [Ks 9c Jd] [7c]
MaFak2019: checks 
color_singleton: checks 
*** RIVER *** [Ks 9c Jd 7c] [4d]
MaFak2019: bets 4227
color_singleton: folds 
Uncalled bet (4227) returned to MaFak2019
MaFak2019 collected 8454 from pot
MaFak2019: doesn't show hand 
*** SUMMARY ***
Total pot 8946 | Rake 492 
Board [Ks 9c Jd 7c 4d]
Seat 1: color_singleton folded on the River
Seat 2: Jackall23 folded before Flop (didn't bet)
Seat 4: Klemtonius folded on the Flop
Seat 5: PokerStarsMan12 (button) folded before Flop
Seat 8: MaFak2019 (small blind) collected (8454)
Seat 9: manon327 (big blind) folded before Flop



PokerStars Home Game Hand #226731019350: {DaPokaStars}  Hold'em No Limit (50/100) - 2021/05/13 18:11:48 ET
Table 'again and again' 9-max (Play Money) Seat #8 is the button
Seat 1: color_singleton (3797 in chips) 
Seat 2: Jackall23 (19495 in chips) 
Seat 4: Klemtonius (20535 in chips) 
Seat 5: PokerStarsMan12 (21741 in chips) 
Seat 8: MaFak2019 (50227 in chips) 
Seat 9: manon327 (6632 in chips) 
manon327: posts small blind 50
color_singleton: posts big blind 100
*** HOLE CARDS ***
Dealt to PokerStarsMan12 [5s Kd]
Jackall23: calls 100
Klemtonius: calls 100
PokerStarsMan12: folds 
MaFak2019: calls 100
manon327: calls 50
color_singleton: raises 500 to 600
Jackall23: folds 
Klemtonius: folds 
MaFak2019: folds 
manon327: folds 
Uncalled bet (500) returned to color_singleton
color_singleton collected 500 from pot
color_singleton: doesn't show hand 
*** SUMMARY ***
Total pot 500 | Rake 0 
Seat 1: color_singleton (big blind) collected (500)
Seat 2: Jackall23 folded before Flop
Seat 4: Klemtonius folded before Flop
Seat 5: PokerStarsMan12 folded before Flop (didn't bet)
Seat 8: MaFak2019 (button) folded before Flop
Seat 9: manon327 (small blind) folded before Flop



PokerStars Home Game Hand #226731031993: {DaPokaStars}  Hold'em No Limit (50/100) - 2021/05/13 18:12:17 ET
Table 'again and again' 9-max (Play Money) Seat #9 is the button
Seat 1: color_singleton (4197 in chips) 
Seat 2: Jackall23 (19395 in chips) 
Seat 4: Klemtonius (20435 in chips) 
Seat 5: PokerStarsMan12 (21741 in chips) 
Seat 8: MaFak2019 (50127 in chips) 
Seat 9: manon327 (6532 in chips) 
color_singleton: posts small blind 50
Jackall23: posts big blind 100
*** HOLE CARDS ***
Dealt to PokerStarsMan12 [3h 3d]
Klemtonius: folds 
PokerStarsMan12: raises 200 to 300
MaFak2019: calls 300
manon327: folds 
color_singleton: calls 250
Jackall23: folds 
*** FLOP *** [Kd Qd 2c]
color_singleton: checks 
PokerStarsMan12: checks 
MaFak2019: checks 
*** TURN *** [Kd Qd 2c] [Jd]
color_singleton: bets 472
PokerStarsMan12 has timed out
PokerStarsMan12: folds 
MaFak2019: calls 472
*** RIVER *** [Kd Qd 2c Jd] [Qh]
color_singleton: checks 
MaFak2019: checks 
*** SHOW DOWN ***
color_singleton: shows [Jh 9h] (two pair, Queens and Jacks)
MaFak2019: mucks hand 
color_singleton collected 1837 from pot
*** SUMMARY ***
Total pot 1944 | Rake 107 
Board [Kd Qd 2c Jd Qh]
Seat 1: color_singleton (small blind) showed [Jh 9h] and won (1837) with two pair, Queens and Jacks
Seat 2: Jackall23 (big blind) folded before Flop
Seat 4: Klemtonius folded before Flop (didn't bet)
Seat 5: PokerStarsMan12 folded on the Turn
Seat 8: MaFak2019 mucked [5c Ah]
Seat 9: manon327 (button) folded before Flop (didn't bet)



PokerStars Home Game Hand #226731061887: {DaPokaStars}  Hold'em No Limit (50/100) - 2021/05/13 18:13:17 ET
Table 'again and again' 9-max (Play Money) Seat #1 is the button
Seat 1: color_singleton (5262 in chips) 
Seat 2: Jackall23 (19295 in chips) 
Seat 4: Klemtonius (20435 in chips) 
Seat 5: PokerStarsMan12 (21441 in chips) 
Seat 8: MaFak2019 (49355 in chips) 
Seat 9: manon327 (6532 in chips) 
Jackall23: posts small blind 50
Klemtonius: posts big blind 100
*** HOLE CARDS ***
Dealt to PokerStarsMan12 [3d 4c]
PokerStarsMan12: calls 100
MaFak2019: calls 100
manon327: calls 100
color_singleton: calls 100
Jackall23: folds 
Klemtonius: checks 
*** FLOP *** [Qc 8h 5s]
Klemtonius: checks 
PokerStarsMan12: checks 
MaFak2019: checks 
manon327: bets 260
color_singleton: folds 
Klemtonius: folds 
PokerStarsMan12: folds 
MaFak2019: calls 260
*** TURN *** [Qc 8h 5s] [8d]
MaFak2019: checks 
manon327: bets 505
MaFak2019: folds 
Uncalled bet (505) returned to manon327
manon327 collected 1011 from pot
*** SUMMARY ***
Total pot 1070 | Rake 59 
Board [Qc 8h 5s 8d]
Seat 1: color_singleton (button) folded on the Flop
Seat 2: Jackall23 (small blind) folded before Flop
Seat 4: Klemtonius (big blind) folded on the Flop
Seat 5: PokerStarsMan12 folded on the Flop
Seat 8: MaFak2019 folded on the Turn
Seat 9: manon327 collected (1011)



PokerStars Home Game Hand #226731084048: {DaPokaStars}  Hold'em No Limit (50/100) - 2021/05/13 18:14:07 ET
Table 'again and again' 9-max (Play Money) Seat #2 is the button
Seat 1: color_singleton (5162 in chips) 
Seat 2: Jackall23 (19245 in chips) 
Seat 4: Klemtonius (20335 in chips) 
Seat 5: PokerStarsMan12 (21341 in chips) 
Seat 8: MaFak2019 (48995 in chips) 
Seat 9: manon327 (7183 in chips) 
Klemtonius: posts small blind 50
PokerStarsMan12: posts big blind 100
*** HOLE CARDS ***
Dealt to PokerStarsMan12 [Qd 5d]
MaFak2019: raises 300 to 400
manon327: folds 
color_singleton: folds 
Jackall23: folds 
Klemtonius: calls 350
PokerStarsMan12: calls 300
*** FLOP *** [6c 4s 9s]
Klemtonius: bets 1134
PokerStarsMan12: folds 
MaFak2019: folds 
Uncalled bet (1134) returned to Klemtonius
Klemtonius collected 1134 from pot
Klemtonius: doesn't show hand 
*** SUMMARY ***
Total pot 1200 | Rake 66 
Board [6c 4s 9s]
Seat 1: color_singleton folded before Flop (didn't bet)
Seat 2: Jackall23 (button) folded before Flop (didn't bet)
Seat 4: Klemtonius (small blind) collected (1134)
Seat 5: PokerStarsMan12 (big blind) folded on the Flop
Seat 8: MaFak2019 folded on the Flop
Seat 9: manon327 folded before Flop (didn't bet)



PokerStars Home Game Hand #226731103412: {DaPokaStars}  Hold'em No Limit (50/100) - 2021/05/13 18:14:50 ET
Table 'again and again' 9-max (Play Money) Seat #4 is the button
Seat 1: color_singleton (5162 in chips) 
Seat 2: Jackall23 (19245 in chips) 
Seat 4: Klemtonius (21069 in chips) 
Seat 5: PokerStarsMan12 (20941 in chips) 
Seat 8: MaFak2019 (48595 in chips) 
Seat 9: manon327 (7183 in chips) 
PokerStarsMan12: posts small blind 50
MaFak2019: posts big blind 100
*** HOLE CARDS ***
Dealt to PokerStarsMan12 [Th 7d]
manon327: folds 
color_singleton: folds 
Jackall23: calls 100
Klemtonius: calls 100
PokerStarsMan12: calls 50
MaFak2019: checks 
*** FLOP *** [5d Qd Js]
PokerStarsMan12: checks 
MaFak2019: checks 
Jackall23: checks 
Klemtonius: checks 
*** TURN *** [5d Qd Js] [Ac]
PokerStarsMan12: checks 
MaFak2019: checks 
Jackall23: bets 100
Klemtonius: raises 100 to 200
PokerStarsMan12: folds 
MaFak2019: folds 
Jackall23: calls 100
*** RIVER *** [5d Qd Js Ac] [Ts]
Jackall23: checks 
Klemtonius: bets 756
Jackall23: calls 756
*** SHOW DOWN ***
Klemtonius: shows [As 3c] (a pair of Aces)
Jackall23: shows [2c Ah] (a pair of Aces)
Jackall23 collected 1093 from pot
Klemtonius collected 1092 from pot
*** SUMMARY ***
Total pot 2312 | Rake 127 
Board [5d Qd Js Ac Ts]
Seat 1: color_singleton folded before Flop (didn't bet)
Seat 2: Jackall23 showed [2c Ah] and won (1093) with a pair of Aces
Seat 4: Klemtonius (button) showed [As 3c] and won (1092) with a pair of Aces
Seat 5: PokerStarsMan12 (small blind) folded on the Turn
Seat 8: MaFak2019 (big blind) folded on the Turn
Seat 9: manon327 folded before Flop (didn't bet)



PokerStars Home Game Hand #226731126871: {DaPokaStars}  Hold'em No Limit (50/100) - 2021/05/13 18:15:43 ET
Table 'again and again' 9-max (Play Money) Seat #5 is the button
Seat 1: color_singleton (5162 in chips) 
Seat 2: Jackall23 (19282 in chips) 
Seat 4: Klemtonius (21105 in chips) 
Seat 5: PokerStarsMan12 (20841 in chips) 
Seat 8: MaFak2019 (48495 in chips) 
Seat 9: manon327 (7183 in chips) 
MaFak2019: posts small blind 50
manon327: posts big blind 100
*** HOLE CARDS ***
Dealt to PokerStarsMan12 [7s Jc]
color_singleton: raises 200 to 300
Jackall23: calls 300
Klemtonius: raises 200 to 500
PokerStarsMan12: folds 
MaFak2019: calls 450
manon327: folds 
color_singleton: calls 200
Jackall23: calls 200
*** FLOP *** [8s 4s 4c]
MaFak2019: checks 
color_singleton: checks 
Jackall23: checks 
Klemtonius: checks 
*** TURN *** [8s 4s 4c] [7c]
MaFak2019: checks 
color_singleton: checks 
Jackall23: checks 
Klemtonius is disconnected 
Klemtonius has timed out while disconnected
Klemtonius: checks 
*** RIVER *** [8s 4s 4c 7c] [Qc]
MaFak2019: checks 
color_singleton: bets 992
Jackall23: calls 992
Klemtonius is connected 
Klemtonius: folds 
MaFak2019: folds 
*** SHOW DOWN ***
color_singleton: shows [Qs Tc] (two pair, Queens and Fours)
Jackall23: shows [Qh Ac] (two pair, Queens and Fours - Ace kicker)
Jackall23 collected 3859 from pot
*** SUMMARY ***
Total pot 4084 | Rake 225 
Board [8s 4s 4c 7c Qc]
Seat 1: color_singleton showed [Qs Tc] and lost with two pair, Queens and Fours
Seat 2: Jackall23 showed [Qh Ac] and won (3859) with two pair, Queens and Fours
Seat 4: Klemtonius folded on the River
Seat 5: PokerStarsMan12 (button) folded before Flop (didn't bet)
Seat 8: MaFak2019 (small blind) folded on the River
Seat 9: manon327 (big blind) folded before Flop



PokerStars Home Game Hand #226731164871: {DaPokaStars}  Hold'em No Limit (50/100) - 2021/05/13 18:17:08 ET
Table 'again and again' 9-max (Play Money) Seat #8 is the button
Seat 1: color_singleton (3670 in chips) 
Seat 2: Jackall23 (21649 in chips) 
Seat 4: Klemtonius (20605 in chips) 
Seat 5: PokerStarsMan12 (20841 in chips) 
Seat 8: MaFak2019 (47995 in chips) 
Seat 9: manon327 (7083 in chips) 
manon327: posts small blind 50
color_singleton: posts big blind 100
*** HOLE CARDS ***
Dealt to PokerStarsMan12 [8c 6c]
Jackall23: folds 
Klemtonius: calls 100
PokerStarsMan12: calls 100
MaFak2019: calls 100
manon327: folds 
color_singleton: checks 
*** FLOP *** [4s Td 2h]
color_singleton: checks 
Klemtonius: checks 
PokerStarsMan12: checks 
MaFak2019: checks 
*** TURN *** [4s Td 2h] [Kh]
color_singleton: checks 
Klemtonius: bets 425
PokerStarsMan12: folds 
MaFak2019: calls 425
color_singleton: folds 
*** RIVER *** [4s Td 2h Kh] [3h]
Klemtonius: bets 1228
MaFak2019: calls 1228
*** SHOW DOWN ***
Klemtonius: shows [6d Ks] (a pair of Kings)
MaFak2019: shows [Jd Kc] (a pair of Kings - Jack kicker)
MaFak2019 collected 3549 from pot
*** SUMMARY ***
Total pot 3756 | Rake 207 
Board [4s Td 2h Kh 3h]
Seat 1: color_singleton (big blind) folded on the Turn
Seat 2: Jackall23 folded before Flop (didn't bet)
Seat 4: Klemtonius showed [6d Ks] and lost with a pair of Kings
Seat 5: PokerStarsMan12 folded on the Turn
Seat 8: MaFak2019 (button) showed [Jd Kc] and won (3549) with a pair of Kings
Seat 9: manon327 (small blind) folded before Flop



PokerStars Home Game Hand #226731184004: {DaPokaStars}  Hold'em No Limit (50/100) - 2021/05/13 18:17:51 ET
Table 'again and again' 9-max (Play Money) Seat #9 is the button
Seat 1: color_singleton (3570 in chips) 
Seat 2: Jackall23 (21649 in chips) 
Seat 4: Klemtonius (18852 in chips) 
Seat 5: PokerStarsMan12 (20741 in chips) 
Seat 8: MaFak2019 (49791 in chips) 
Seat 9: manon327 (7033 in chips) 
color_singleton: posts small blind 50
Jackall23: posts big blind 100
*** HOLE CARDS ***
Dealt to PokerStarsMan12 [3h Kh]
Klemtonius: raises 100 to 200
PokerStarsMan12: calls 200
MaFak2019: calls 200
manon327: calls 200
color_singleton: calls 150
Jackall23: folds 
*** FLOP *** [3d Tc 3c]
color_singleton: checks 
Klemtonius: bets 1039
PokerStarsMan12: calls 1039
MaFak2019: folds 
manon327: folds 
color_singleton: folds 
*** TURN *** [3d Tc 3c] [Qs]
Klemtonius: checks 
PokerStarsMan12: bets 2000
Klemtonius: calls 2000
*** RIVER *** [3d Tc 3c Qs] [Kd]
Klemtonius: checks 
PokerStarsMan12: bets 450
Klemtonius: raises 7683 to 8133
PokerStarsMan12: raises 9369 to 17502 and is all-in
Klemtonius: calls 7480 and is all-in
Uncalled bet (1889) returned to PokerStarsMan12
*** SHOW DOWN ***
PokerStarsMan12: shows [3h Kh] (a full house, Threes full of Kings)
Klemtonius: shows [3s Ts] (a full house, Threes full of Tens)
PokerStarsMan12 collected 36292 from pot
*** SUMMARY ***
Total pot 38404 | Rake 2112 
Board [3d Tc 3c Qs Kd]
Seat 1: color_singleton (small blind) folded on the Flop
Seat 2: Jackall23 (big blind) folded before Flop
Seat 4: Klemtonius showed [3s Ts] and lost with a full house, Threes full of Tens
Seat 5: PokerStarsMan12 showed [3h Kh] and won (36292) with a full house, Threes full of Kings
Seat 8: MaFak2019 folded on the Flop
Seat 9: manon327 (button) folded on the Flop



PokerStars Home Game Hand #226731210408: {DaPokaStars}  Hold'em No Limit (50/100) - 2021/05/13 18:18:51 ET
Table 'again and again' 9-max (Play Money) Seat #1 is the button
Seat 1: color_singleton (3370 in chips) 
Seat 2: Jackall23 (21549 in chips) 
Seat 5: PokerStarsMan12 (38181 in chips) 
Seat 8: MaFak2019 (49591 in chips) 
Seat 9: manon327 (6833 in chips) 
Jackall23: posts small blind 50
PokerStarsMan12: posts big blind 100
*** HOLE CARDS ***
Dealt to PokerStarsMan12 [4s 9d]
MaFak2019: calls 100
manon327: folds 
color_singleton: calls 100
Jackall23: calls 50
PokerStarsMan12: checks 
*** FLOP *** [6c 6s Jh]
Jackall23: checks 
PokerStarsMan12: checks 
MaFak2019: checks 
color_singleton: checks 
*** TURN *** [6c 6s Jh] [7s]
Jackall23: checks 
PokerStarsMan12: checks 
MaFak2019: checks 
color_singleton: checks 
*** RIVER *** [6c 6s Jh 7s] [4c]
Jackall23: checks 
PokerStarsMan12: checks 
MaFak2019: checks 
color_singleton: checks 
*** SHOW DOWN ***
Jackall23: shows [Kd As] (a pair of Sixes)
PokerStarsMan12: shows [4s 9d] (two pair, Sixes and Fours)
MaFak2019: mucks hand 
color_singleton: mucks hand 
PokerStarsMan12 collected 378 from pot
*** SUMMARY ***
Total pot 400 | Rake 22 
Board [6c 6s Jh 7s 4c]
Seat 1: color_singleton (button) mucked [5d Kh]
Seat 2: Jackall23 (small blind) showed [Kd As] and lost with a pair of Sixes
Seat 5: PokerStarsMan12 (big blind) showed [4s 9d] and won (378) with two pair, Sixes and Fours
Seat 8: MaFak2019 mucked [3h Ac]
Seat 9: manon327 folded before Flop (didn't bet)



PokerStars Home Game Hand #226731231394: {DaPokaStars}  Hold'em No Limit (50/100) - 2021/05/13 18:19:39 ET
Table 'again and again' 9-max (Play Money) Seat #2 is the button
Seat 1: color_singleton (3270 in chips) 
Seat 2: Jackall23 (21449 in chips) 
Seat 5: PokerStarsMan12 (38459 in chips) 
Seat 8: MaFak2019 (49491 in chips) 
Seat 9: manon327 (6833 in chips) 
PokerStarsMan12: posts small blind 50
MaFak2019: posts big blind 100
*** HOLE CARDS ***
Dealt to PokerStarsMan12 [Ah 2h]
manon327: calls 100
color_singleton: folds 
Jackall23: folds 
PokerStarsMan12: calls 50
MaFak2019: checks 
*** FLOP *** [Td Kc 9h]
PokerStarsMan12: checks 
MaFak2019: checks 
manon327: checks 
*** TURN *** [Td Kc 9h] [7h]
PokerStarsMan12: bets 141
MaFak2019: raises 565 to 706
manon327: calls 706
PokerStarsMan12: calls 565
*** RIVER *** [Td Kc 9h 7h] [8h]
PokerStarsMan12: bets 1500
MaFak2019 has timed out
MaFak2019: folds 
manon327: calls 1500
*** SHOW DOWN ***
PokerStarsMan12: shows [Ah 2h] (a flush, Ace high)
manon327: mucks hand 
PokerStarsMan12 collected 5120 from pot
*** SUMMARY ***
Total pot 5418 | Rake 298 
Board [Td Kc 9h 7h 8h]
Seat 1: color_singleton folded before Flop (didn't bet)
Seat 2: Jackall23 (button) folded before Flop (didn't bet)
Seat 5: PokerStarsMan12 (small blind) showed [Ah 2h] and won (5120) with a flush, Ace high
Seat 8: MaFak2019 (big blind) folded on the River
Seat 9: manon327 mucked [Ac Js]



PokerStars Home Game Hand #226731256475: {DaPokaStars}  Hold'em No Limit (50/100) - 2021/05/13 18:20:37 ET
Table 'again and again' 9-max (Play Money) Seat #5 is the button
Seat 1: color_singleton (3270 in chips) 
Seat 2: Jackall23 (21449 in chips) 
Seat 4: Klemtonius (10000 in chips) 
Seat 5: PokerStarsMan12 (41273 in chips) 
Seat 9: manon327 (4527 in chips) 
manon327: posts small blind 50
color_singleton: posts big blind 100
Klemtonius: posts small & big blinds 150
*** HOLE CARDS ***
Dealt to PokerStarsMan12 [7c Qd]
Jackall23: calls 100
Klemtonius: checks 
PokerStarsMan12: folds 
manon327: calls 50
color_singleton: checks 
*** FLOP *** [Th 6d 2s]
manon327 has timed out
manon327: checks 
color_singleton: bets 212
Jackall23: calls 212
Klemtonius: folds 
manon327 has timed out
manon327: folds 
*** TURN *** [Th 6d 2s] [2d]
color_singleton: bets 413
Jackall23: folds 
Uncalled bet (413) returned to color_singleton
color_singleton collected 826 from pot
color_singleton: doesn't show hand 
*** SUMMARY ***
Total pot 874 | Rake 48 
Board [Th 6d 2s 2d]
Seat 1: color_singleton (big blind) collected (826)
Seat 2: Jackall23 folded on the Turn
Seat 4: Klemtonius folded on the Flop (didn't bet)
Seat 5: PokerStarsMan12 (button) folded before Flop (didn't bet)
Seat 9: manon327 (small blind) folded on the Flop



PokerStars Home Game Hand #226731287667: {DaPokaStars}  Hold'em No Limit (50/100) - 2021/05/13 18:21:48 ET
Table 'again and again' 9-max (Play Money) Seat #9 is the button
Seat 1: color_singleton (3784 in chips) 
Seat 2: Jackall23 (21137 in chips) 
Seat 4: Klemtonius (9850 in chips) 
Seat 5: PokerStarsMan12 (41273 in chips) 
Seat 8: MaFak2019 (48685 in chips) 
Seat 9: manon327 (4427 in chips) 
color_singleton: posts small blind 50
Jackall23: posts big blind 100
MaFak2019: posts small blind 50
*** HOLE CARDS ***
Dealt to PokerStarsMan12 [4h 9s]
Klemtonius: raises 100 to 200
PokerStarsMan12: folds 
MaFak2019: folds 
manon327: folds 
color_singleton: raises 100 to 300
Jackall23: calls 200
Klemtonius: raises 950 to 1250
color_singleton: calls 950
Jackall23: calls 950
*** FLOP *** [Ad 5c 8c]
color_singleton: checks 
Jackall23: bets 1795
Klemtonius: calls 1795
color_singleton: folds 
*** TURN *** [Ad 5c 8c] [7d]
Jackall23: checks 
Klemtonius: checks 
*** RIVER *** [Ad 5c 8c 7d] [8d]
Jackall23: checks 
Klemtonius: bets 6805 and is all-in
Jackall23: folds 
Uncalled bet (6805) returned to Klemtonius
Klemtonius collected 6984 from pot
Klemtonius: doesn't show hand 
*** SUMMARY ***
Total pot 7390 | Rake 406 
Board [Ad 5c 8c 7d 8d]
Seat 1: color_singleton (small blind) folded on the Flop
Seat 2: Jackall23 (big blind) folded on the River
Seat 4: Klemtonius collected (6984)
Seat 5: PokerStarsMan12 folded before Flop (didn't bet)
Seat 8: MaFak2019 folded before Flop (didn't bet)
Seat 9: manon327 (button) folded before Flop (didn't bet)



PokerStars Home Game Hand #226731305115: {DaPokaStars}  Hold'em No Limit (50/100) - 2021/05/13 18:22:29 ET
Table 'again and again' 9-max (Play Money) Seat #1 is the button
Seat 1: color_singleton (2534 in chips) 
Seat 2: Jackall23 (18092 in chips) 
Seat 4: Klemtonius (13789 in chips) 
Seat 5: PokerStarsMan12 (41273 in chips) 
Seat 8: MaFak2019 (48635 in chips) 
Seat 9: manon327 (4427 in chips) 
Jackall23: posts small blind 50
Klemtonius: posts big blind 100
*** HOLE CARDS ***
Dealt to PokerStarsMan12 [5d 4d]
PokerStarsMan12: calls 100
MaFak2019: calls 100
manon327: calls 100
color_singleton: calls 100
Jackall23: folds 
Klemtonius: checks 
*** FLOP *** [Ac Kh 8c]
Klemtonius: checks 
PokerStarsMan12: checks 
MaFak2019: bets 520
manon327: calls 520
color_singleton: calls 520
Klemtonius: folds 
PokerStarsMan12: folds 
*** TURN *** [Ac Kh 8c] [Jh]
MaFak2019: bets 1994
manon327: folds 
color_singleton: calls 1914 and is all-in
Uncalled bet (80) returned to MaFak2019
*** RIVER *** [Ac Kh 8c Jh] [As]
*** SHOW DOWN ***
MaFak2019: shows [8s 8d] (a full house, Eights full of Aces)
color_singleton: shows [3h 8h] (two pair, Aces and Eights)
MaFak2019 collected 5611 from pot
*** SUMMARY ***
Total pot 5938 | Rake 327 
Board [Ac Kh 8c Jh As]
Seat 1: color_singleton (button) showed [3h 8h] and lost with two pair, Aces and Eights
Seat 2: Jackall23 (small blind) folded before Flop
Seat 4: Klemtonius (big blind) folded on the Flop
Seat 5: PokerStarsMan12 folded on the Flop
Seat 8: MaFak2019 showed [8s 8d] and won (5611) with a full house, Eights full of Aces
Seat 9: manon327 folded on the Turn



PokerStars Home Game Hand #226731333977: {DaPokaStars}  Hold'em No Limit (50/100) - 2021/05/13 18:23:15 ET
Table 'again and again' 9-max (Play Money) Seat #2 is the button
Seat 2: Jackall23 (18042 in chips) 
Seat 4: Klemtonius (13689 in chips) 
Seat 5: PokerStarsMan12 (41173 in chips) 
Seat 8: MaFak2019 (51712 in chips) 
Seat 9: manon327 (3807 in chips) 
Klemtonius: posts small blind 50
PokerStarsMan12: posts big blind 100
*** HOLE CARDS ***
Dealt to PokerStarsMan12 [3c 6h]
MaFak2019: calls 100
manon327 has timed out
manon327: folds 
Jackall23: folds 
Klemtonius: calls 50
PokerStarsMan12: checks 
*** FLOP *** [As Ks 2h]
Klemtonius: checks 
PokerStarsMan12: checks 
MaFak2019: checks 
*** TURN *** [As Ks 2h] [5s]
Klemtonius: bets 141
PokerStarsMan12: folds 
MaFak2019: calls 141
*** RIVER *** [As Ks 2h 5s] [6c]
Klemtonius: checks 
MaFak2019: checks 
*** SHOW DOWN ***
Klemtonius: shows [9d Ts] (high card Ace)
MaFak2019: shows [2s Jc] (a pair of Deuces)
MaFak2019 collected 550 from pot
*** SUMMARY ***
Total pot 582 | Rake 32 
Board [As Ks 2h 5s 6c]
Seat 2: Jackall23 (button) folded before Flop (didn't bet)
Seat 4: Klemtonius (small blind) showed [9d Ts] and lost with high card Ace
Seat 5: PokerStarsMan12 (big blind) folded on the Turn
Seat 8: MaFak2019 showed [2s Jc] and won (550) with a pair of Deuces
Seat 9: manon327 folded before Flop (didn't bet)



PokerStars Home Game Hand #226731362515: {DaPokaStars}  Hold'em No Limit (50/100) - 2021/05/13 18:24:02 ET
Table 'again and again' 9-max (Play Money) Seat #4 is the button
Seat 1: color_singleton (10000 in chips) 
Seat 2: Jackall23 (18042 in chips) 
Seat 4: Klemtonius (13448 in chips) 
Seat 5: PokerStarsMan12 (41073 in chips) 
Seat 8: MaFak2019 (52021 in chips) 
PokerStarsMan12: posts small blind 50
MaFak2019: posts big blind 100
*** HOLE CARDS ***
Dealt to PokerStarsMan12 [8d Kc]
color_singleton: raises 200 to 300
Jackall23: folds 
Klemtonius: calls 300
PokerStarsMan12: folds 
MaFak2019: calls 200
*** FLOP *** [4s Jc 3h]
MaFak2019: checks 
color_singleton: checks 
Klemtonius: bets 898
MaFak2019: calls 898
color_singleton: folds 
*** TURN *** [4s Jc 3h] [9c]
MaFak2019: checks 
Klemtonius: bets 2595
MaFak2019: calls 2595
*** RIVER *** [4s Jc 3h 9c] [4c]
MaFak2019: checks 
Klemtonius: checks 
*** SHOW DOWN ***
MaFak2019: shows [Ad 2d] (a pair of Fours)
Klemtonius: shows [Jh 6c] (two pair, Jacks and Fours)
Klemtonius collected 7500 from pot
*** SUMMARY ***
Total pot 7936 | Rake 436 
Board [4s Jc 3h 9c 4c]
Seat 1: color_singleton folded on the Flop
Seat 2: Jackall23 folded before Flop (didn't bet)
Seat 4: Klemtonius (button) showed [Jh 6c] and won (7500) with two pair, Jacks and Fours
Seat 5: PokerStarsMan12 (small blind) folded before Flop
Seat 8: MaFak2019 (big blind) showed [Ad 2d] and lost with a pair of Fours



PokerStars Home Game Hand #226731378144: {DaPokaStars}  Hold'em No Limit (50/100) - 2021/05/13 18:24:39 ET
Table 'again and again' 9-max (Play Money) Seat #5 is the button
Seat 1: color_singleton (9700 in chips) 
Seat 2: Jackall23 (18042 in chips) 
Seat 4: Klemtonius (17155 in chips) 
Seat 5: PokerStarsMan12 (41023 in chips) 
Seat 8: MaFak2019 (48228 in chips) 
Seat 9: manon327 (3807 in chips) 
MaFak2019: posts small blind 50
manon327: posts big blind 100
*** HOLE CARDS ***
Dealt to PokerStarsMan12 [6d 6h]
color_singleton: raises 200 to 300
Jackall23: folds 
Klemtonius: calls 300
PokerStarsMan12: calls 300
MaFak2019: calls 250
manon327: calls 200
*** FLOP *** [3s Qc 6c]
MaFak2019: checks 
manon327: checks 
color_singleton: checks 
Klemtonius: checks 
PokerStarsMan12: bets 900
MaFak2019: folds 
manon327: calls 900
color_singleton: folds 
Klemtonius: folds 
*** TURN *** [3s Qc 6c] [4s]
manon327: checks 
PokerStarsMan12: bets 1500
manon327: folds 
Uncalled bet (1500) returned to PokerStarsMan12
PokerStarsMan12 collected 3118 from pot
*** SUMMARY ***
Total pot 3300 | Rake 182 
Board [3s Qc 6c 4s]
Seat 1: color_singleton folded on the Flop
Seat 2: Jackall23 folded before Flop (didn't bet)
Seat 4: Klemtonius folded on the Flop
Seat 5: PokerStarsMan12 (button) collected (3118)
Seat 8: MaFak2019 (small blind) folded on the Flop
Seat 9: manon327 (big blind) folded on the Turn



PokerStars Home Game Hand #226731401685: {DaPokaStars}  Hold'em No Limit (50/100) - 2021/05/13 18:25:34 ET
Table 'again and again' 9-max (Play Money) Seat #8 is the button
Seat 1: color_singleton (9400 in chips) 
Seat 2: Jackall23 (18042 in chips) 
Seat 4: Klemtonius (16855 in chips) 
Seat 5: PokerStarsMan12 (42941 in chips) 
Seat 8: MaFak2019 (47928 in chips) 
Seat 9: manon327 (2607 in chips) 
manon327: posts small blind 50
color_singleton: posts big blind 100
*** HOLE CARDS ***
Dealt to PokerStarsMan12 [Qc 3d]
Jackall23: calls 100
Klemtonius: folds 
PokerStarsMan12: folds 
MaFak2019: raises 100 to 200
manon327: folds 
color_singleton: calls 100
Jackall23: calls 100
*** FLOP *** [Jh As 7h]
color_singleton: bets 307
Jackall23: calls 307
MaFak2019: raises 1535 to 1842
color_singleton: calls 1535
Jackall23: calls 1535
*** TURN *** [Jh As 7h] [Ts]
color_singleton: checks 
Jackall23: checks 
MaFak2019: checks 
*** RIVER *** [Jh As 7h Ts] [8d]
color_singleton: checks 
Jackall23: bets 5836
MaFak2019: calls 5836
color_singleton: folds 
*** SHOW DOWN ***
Jackall23: shows [Ah 9c] (a straight, Seven to Jack)
MaFak2019: mucks hand 
Jackall23 collected 16866 from pot
*** SUMMARY ***
Total pot 17848 | Rake 982 
Board [Jh As 7h Ts 8d]
Seat 1: color_singleton (big blind) folded on the River
Seat 2: Jackall23 showed [Ah 9c] and won (16866) with a straight, Seven to Jack
Seat 4: Klemtonius folded before Flop (didn't bet)
Seat 5: PokerStarsMan12 folded before Flop (didn't bet)
Seat 8: MaFak2019 (button) mucked [8c Ac]
Seat 9: manon327 (small blind) folded before Flop



PokerStars Home Game Hand #226731428206: {DaPokaStars}  Hold'em No Limit (50/100) - 2021/05/13 18:26:35 ET
Table 'again and again' 9-max (Play Money) Seat #9 is the button
Seat 1: color_singleton (7358 in chips) 
Seat 2: Jackall23 (27030 in chips) 
Seat 4: Klemtonius (16855 in chips) 
Seat 5: PokerStarsMan12 (42941 in chips) 
Seat 8: MaFak2019 (40050 in chips) 
Seat 9: manon327 (2557 in chips) 
color_singleton: posts small blind 50
Jackall23: posts big blind 100
*** HOLE CARDS ***
Dealt to PokerStarsMan12 [8s 6d]
Klemtonius: folds 
PokerStarsMan12: folds 
MaFak2019: calls 100
manon327: calls 100
color_singleton: calls 50
Jackall23: checks 
*** FLOP *** [Jc 7h Js]
color_singleton: checks 
Jackall23: checks 
MaFak2019: checks 
manon327: checks 
*** TURN *** [Jc 7h Js] [As]
color_singleton: checks 
Jackall23: checks 
MaFak2019: checks 
manon327: checks 
*** RIVER *** [Jc 7h Js As] [6h]
color_singleton: checks 
Jackall23: checks 
MaFak2019: checks 
manon327: checks 
*** SHOW DOWN ***
color_singleton: shows [Qc 6c] (two pair, Jacks and Sixes)
Jackall23: mucks hand 
MaFak2019: mucks hand 
manon327: mucks hand 
color_singleton collected 378 from pot
*** SUMMARY ***
Total pot 400 | Rake 22 
Board [Jc 7h Js As 6h]
Seat 1: color_singleton (small blind) showed [Qc 6c] and won (378) with two pair, Jacks and Sixes
Seat 2: Jackall23 (big blind) mucked [2s 5s]
Seat 4: Klemtonius folded before Flop (didn't bet)
Seat 5: PokerStarsMan12 folded before Flop (didn't bet)
Seat 8: MaFak2019 mucked [Th 2h]
Seat 9: manon327 (button) mucked [Kc Td]



PokerStars Home Game Hand #226731449995: {DaPokaStars}  Hold'em No Limit (50/100) - 2021/05/13 18:27:27 ET
Table 'again and again' 9-max (Play Money) Seat #1 is the button
Seat 1: color_singleton (7636 in chips) 
Seat 2: Jackall23 (26930 in chips) 
Seat 4: Klemtonius (16855 in chips) 
Seat 5: PokerStarsMan12 (42941 in chips) 
Seat 8: MaFak2019 (39950 in chips) 
Jackall23: posts small blind 50
Klemtonius: posts big blind 100
*** HOLE CARDS ***
Dealt to PokerStarsMan12 [Kh 7s]
PokerStarsMan12: folds 
MaFak2019: raises 200 to 300
color_singleton: calls 300
Jackall23: folds 
Klemtonius: calls 200
*** FLOP *** [Kd Ks Js]
Klemtonius: checks 
MaFak2019: checks 
color_singleton: checks 
*** TURN *** [Kd Ks Js] [Th]
Klemtonius: checks 
MaFak2019: bets 898
color_singleton: calls 898
Klemtonius: folds 
*** RIVER *** [Kd Ks Js Th] [5c]
MaFak2019: bets 2595
color_singleton: raises 2595 to 5190
MaFak2019: raises 2595 to 7785
color_singleton: calls 1248 and is all-in
Uncalled bet (1347) returned to MaFak2019
*** SHOW DOWN ***
MaFak2019: shows [Qc Ah] (a straight, Ten to Ace)
color_singleton: shows [Jd Kc] (a full house, Kings full of Jacks)
color_singleton collected 14763 from pot
*** SUMMARY ***
Total pot 15622 | Rake 859 
Board [Kd Ks Js Th 5c]
Seat 1: color_singleton (button) showed [Jd Kc] and won (14763) with a full house, Kings full of Jacks
Seat 2: Jackall23 (small blind) folded before Flop
Seat 4: Klemtonius (big blind) folded on the Turn
Seat 5: PokerStarsMan12 folded before Flop (didn't bet)
Seat 8: MaFak2019 showed [Qc Ah] and lost with a straight, Ten to Ace



PokerStars Home Game Hand #226731471882: {DaPokaStars}  Hold'em No Limit (50/100) - 2021/05/13 18:28:19 ET
Table 'again and again' 9-max (Play Money) Seat #2 is the button
Seat 1: color_singleton (14763 in chips) 
Seat 2: Jackall23 (26880 in chips) 
Seat 4: Klemtonius (16555 in chips) 
Seat 5: PokerStarsMan12 (42941 in chips) 
Seat 8: MaFak2019 (32314 in chips) 
Seat 9: manon327 (2457 in chips) 
Klemtonius: posts small blind 50
PokerStarsMan12: posts big blind 100
*** HOLE CARDS ***
Dealt to PokerStarsMan12 [Kc 9c]
MaFak2019: calls 100
manon327: calls 100
color_singleton: folds 
Jackall23: raises 100 to 200
Klemtonius: calls 150
PokerStarsMan12: calls 100
MaFak2019: calls 100
manon327: calls 100
*** FLOP *** [Ah Qh 8d]
Klemtonius: checks 
PokerStarsMan12: checks 
MaFak2019: checks 
manon327: checks 
Jackall23: bets 100
Klemtonius: folds 
PokerStarsMan12: folds 
MaFak2019: folds 
manon327: folds 
Uncalled bet (100) returned to Jackall23
Jackall23 collected 945 from pot
*** SUMMARY ***
Total pot 1000 | Rake 55 
Board [Ah Qh 8d]
Seat 1: color_singleton folded before Flop (didn't bet)
Seat 2: Jackall23 (button) collected (945)
Seat 4: Klemtonius (small blind) folded on the Flop
Seat 5: PokerStarsMan12 (big blind) folded on the Flop
Seat 8: MaFak2019 folded on the Flop
Seat 9: manon327 folded on the Flop



PokerStars Home Game Hand #226731490073: {DaPokaStars}  Hold'em No Limit (50/100) - 2021/05/13 18:29:02 ET
Table 'again and again' 9-max (Play Money) Seat #4 is the button
Seat 1: color_singleton (14763 in chips) 
Seat 2: Jackall23 (27625 in chips) 
Seat 4: Klemtonius (16355 in chips) 
Seat 5: PokerStarsMan12 (42741 in chips) 
Seat 8: MaFak2019 (32114 in chips) 
Seat 9: manon327 (2257 in chips) 
PokerStarsMan12: posts small blind 50
MaFak2019: posts big blind 100
*** HOLE CARDS ***
Dealt to PokerStarsMan12 [6h Th]
manon327: calls 100
color_singleton: raises 100 to 200
Jackall23: calls 200
Klemtonius: calls 200
PokerStarsMan12: folds 
MaFak2019: calls 100
manon327: calls 100
*** FLOP *** [6s Ac Ad]
MaFak2019: checks 
manon327: checks 
color_singleton: checks 
Jackall23: checks 
Klemtonius: checks 
*** TURN *** [6s Ac Ad] [9s]
MaFak2019: checks 
manon327: checks 
color_singleton: checks 
Jackall23: checks 
Klemtonius: checks 
*** RIVER *** [6s Ac Ad 9s] [5c]
MaFak2019: checks 
manon327: checks 
color_singleton: checks 
Jackall23: bets 496
Klemtonius: folds 
MaFak2019: folds 
manon327: folds 
color_singleton: folds 
Uncalled bet (496) returned to Jackall23
Jackall23 collected 992 from pot
*** SUMMARY ***
Total pot 1050 | Rake 58 
Board [6s Ac Ad 9s 5c]
Seat 1: color_singleton folded on the River
Seat 2: Jackall23 collected (992)
Seat 4: Klemtonius (button) folded on the River
Seat 5: PokerStarsMan12 (small blind) folded before Flop
Seat 8: MaFak2019 (big blind) folded on the River
Seat 9: manon327 folded on the River



PokerStars Home Game Hand #226731512452: {DaPokaStars}  Hold'em No Limit (50/100) - 2021/05/13 18:29:55 ET
Table 'again and again' 9-max (Play Money) Seat #5 is the button
Seat 1: color_singleton (14563 in chips) 
Seat 2: Jackall23 (28417 in chips) 
Seat 4: Klemtonius (16155 in chips) 
Seat 5: PokerStarsMan12 (42691 in chips) 
Seat 8: MaFak2019 (31914 in chips) 
Seat 9: manon327 (2057 in chips) 
MaFak2019: posts small blind 50
manon327: posts big blind 100
*** HOLE CARDS ***
Dealt to PokerStarsMan12 [2s 2h]
color_singleton: raises 200 to 300
Jackall23: calls 300
Klemtonius: folds 
PokerStarsMan12: calls 300
MaFak2019: calls 250
manon327: folds 
*** FLOP *** [5s Kh 4c]
MaFak2019: bets 1228
color_singleton: folds 
Jackall23: raises 1228 to 2456
PokerStarsMan12: folds 
MaFak2019: calls 1228
*** TURN *** [5s Kh 4c] [3h]
MaFak2019: bets 2935
Jackall23: raises 2935 to 5870
MaFak2019: calls 2935
*** RIVER *** [5s Kh 4c 3h] [8d]
MaFak2019: checks 
Jackall23: checks 
*** SHOW DOWN ***
MaFak2019: shows [Kd 4s] (two pair, Kings and Fours)
Jackall23: mucks hand 
MaFak2019 collected 16965 from pot
*** SUMMARY ***
Total pot 17952 | Rake 987 
Board [5s Kh 4c 3h 8d]
Seat 1: color_singleton folded on the Flop
Seat 2: Jackall23 mucked [As Kc]
Seat 4: Klemtonius folded before Flop (didn't bet)
Seat 5: PokerStarsMan12 (button) folded on the Flop
Seat 8: MaFak2019 (small blind) showed [Kd 4s] and won (16965) with two pair, Kings and Fours
Seat 9: manon327 (big blind) folded before Flop



PokerStars Home Game Hand #226731537860: {DaPokaStars}  Hold'em No Limit (50/100) - 2021/05/13 18:30:54 ET
Table 'again and again' 9-max (Play Money) Seat #8 is the button
Seat 1: color_singleton (14263 in chips) 
Seat 2: Jackall23 (19791 in chips) 
Seat 4: Klemtonius (16155 in chips) 
Seat 5: PokerStarsMan12 (42391 in chips) 
Seat 8: MaFak2019 (40253 in chips) 
Seat 9: manon327 (1957 in chips) 
manon327: posts small blind 50
color_singleton: posts big blind 100
*** HOLE CARDS ***
Dealt to PokerStarsMan12 [8d Jh]
Jackall23: calls 100
Klemtonius: raises 350 to 450
PokerStarsMan12: folds 
MaFak2019: calls 450
manon327: calls 400
color_singleton: calls 350
Jackall23: calls 350
*** FLOP *** [2d 4d Qh]
manon327: checks 
color_singleton: checks 
Jackall23: checks 
Klemtonius: bets 2126
MaFak2019: folds 
manon327: folds 
color_singleton: folds 
Jackall23: folds 
Uncalled bet (2126) returned to Klemtonius
Klemtonius collected 2126 from pot
Klemtonius: doesn't show hand 
*** SUMMARY ***
Total pot 2250 | Rake 124 
Board [2d 4d Qh]
Seat 1: color_singleton (big blind) folded on the Flop
Seat 2: Jackall23 folded on the Flop
Seat 4: Klemtonius collected (2126)
Seat 5: PokerStarsMan12 folded before Flop (didn't bet)
Seat 8: MaFak2019 (button) folded on the Flop
Seat 9: manon327 (small blind) folded on the Flop



PokerStars Home Game Hand #226731555536: {DaPokaStars}  Hold'em No Limit (50/100) - 2021/05/13 18:31:36 ET
Table 'again and again' 9-max (Play Money) Seat #9 is the button
Seat 1: color_singleton (13813 in chips) 
Seat 2: Jackall23 (19341 in chips) 
Seat 4: Klemtonius (17831 in chips) 
Seat 5: PokerStarsMan12 (42391 in chips) 
Seat 8: MaFak2019 (39803 in chips) 
Seat 9: manon327 (1507 in chips) 
color_singleton: posts small blind 50
Jackall23: posts big blind 100
*** HOLE CARDS ***
Dealt to PokerStarsMan12 [Ah Ad]
Klemtonius: calls 100
PokerStarsMan12: raises 300 to 400
MaFak2019: calls 400
manon327: calls 400
color_singleton: folds 
Jackall23: folds 
Klemtonius: calls 300
*** FLOP *** [4d Jh 7d]
Klemtonius: checks 
PokerStarsMan12: bets 1000
MaFak2019: calls 1000
manon327: calls 1000
Klemtonius: folds 
*** TURN *** [4d Jh 7d] [2h]
PokerStarsMan12: bets 2300
MaFak2019: folds 
manon327: calls 107 and is all-in
Uncalled bet (2193) returned to PokerStarsMan12
*** RIVER *** [4d Jh 7d 2h] [9s]
*** SHOW DOWN ***
PokerStarsMan12: shows [Ah Ad] (a pair of Aces)
manon327: shows [Jc Kc] (a pair of Jacks)
PokerStarsMan12 collected 4691 from pot
*** SUMMARY ***
Total pot 4964 | Rake 273 
Board [4d Jh 7d 2h 9s]
Seat 1: color_singleton (small blind) folded before Flop
Seat 2: Jackall23 (big blind) folded before Flop
Seat 4: Klemtonius folded on the Flop
Seat 5: PokerStarsMan12 showed [Ah Ad] and won (4691) with a pair of Aces
Seat 8: MaFak2019 folded on the Turn
Seat 9: manon327 (button) showed [Jc Kc] and lost with a pair of Jacks



PokerStars Home Game Hand #226731575553: {DaPokaStars}  Hold'em No Limit (50/100) - 2021/05/13 18:32:23 ET
Table 'again and again' 9-max (Play Money) Seat #1 is the button
Seat 1: color_singleton (13763 in chips) 
Seat 2: Jackall23 (19241 in chips) 
Seat 4: Klemtonius (17431 in chips) 
Seat 5: PokerStarsMan12 (45575 in chips) 
Seat 8: MaFak2019 (38403 in chips) 
Jackall23: posts small blind 50
Klemtonius: posts big blind 100
*** HOLE CARDS ***
Dealt to PokerStarsMan12 [Jh 7s]
PokerStarsMan12: folds 
MaFak2019: calls 100
color_singleton: raises 200 to 300
Jackall23: folds 
Klemtonius: calls 200
MaFak2019: calls 200
*** FLOP *** [6s 6d 2d]
Klemtonius: checks 
MaFak2019: checks 
color_singleton: checks 
*** TURN *** [6s 6d 2d] [Kc]
Klemtonius: checks 
MaFak2019: checks 
color_singleton: bets 449
Klemtonius: folds 
MaFak2019: raises 1796 to 2245
color_singleton: calls 1796
*** RIVER *** [6s 6d 2d Kc] [5h]
MaFak2019: bets 5141
color_singleton: folds 
Uncalled bet (5141) returned to MaFak2019
MaFak2019 collected 5141 from pot
MaFak2019: doesn't show hand 
*** SUMMARY ***
Total pot 5440 | Rake 299 
Board [6s 6d 2d Kc 5h]
Seat 1: color_singleton (button) folded on the River
Seat 2: Jackall23 (small blind) folded before Flop
Seat 4: Klemtonius (big blind) folded on the Turn
Seat 5: PokerStarsMan12 folded before Flop (didn't bet)
Seat 8: MaFak2019 collected (5141)



PokerStars Home Game Hand #226731598915: {DaPokaStars}  Hold'em No Limit (50/100) - 2021/05/13 18:33:18 ET
Table 'again and again' 9-max (Play Money) Seat #2 is the button
Seat 1: color_singleton (11218 in chips) 
Seat 2: Jackall23 (19191 in chips) 
Seat 4: Klemtonius (17131 in chips) 
Seat 5: PokerStarsMan12 (45575 in chips) 
Seat 8: MaFak2019 (40999 in chips) 
Seat 9: manon327 (5305 in chips) 
Klemtonius: posts small blind 50
PokerStarsMan12: posts big blind 100
*** HOLE CARDS ***
Dealt to PokerStarsMan12 [Jc 8c]
MaFak2019: calls 100
manon327 has timed out
manon327: folds 
color_singleton: raises 200 to 300
Jackall23: calls 300
Klemtonius: folds 
PokerStarsMan12: calls 200
MaFak2019: raises 200 to 500
color_singleton: calls 200
Jackall23: calls 200
PokerStarsMan12: calls 200
*** FLOP *** [Ts 2s Kc]
PokerStarsMan12: checks 
MaFak2019: checks 
color_singleton: checks 
Jackall23: checks 
*** TURN *** [Ts 2s Kc] [Qd]
PokerStarsMan12: checks 
MaFak2019: checks 
color_singleton: checks 
Jackall23: bets 968
PokerStarsMan12: folds 
MaFak2019: calls 968
color_singleton: folds 
*** RIVER *** [Ts 2s Kc Qd] [Qh]
MaFak2019: bets 3767
Jackall23: raises 3767 to 7534
MaFak2019: raises 3767 to 11301
Jackall23: raises 6422 to 17723 and is all-in
MaFak2019: calls 6422
*** SHOW DOWN ***
Jackall23: shows [Jd Ad] (a straight, Ten to Ace)
MaFak2019: shows [Qs Ac] (three of a kind, Queens)
Jackall23 collected 37263 from pot
*** SUMMARY ***
Total pot 39432 | Rake 2169 
Board [Ts 2s Kc Qd Qh]
Seat 1: color_singleton folded on the Turn
Seat 2: Jackall23 (button) showed [Jd Ad] and won (37263) with a straight, Ten to Ace
Seat 4: Klemtonius (small blind) folded before Flop
Seat 5: PokerStarsMan12 (big blind) folded on the Turn
Seat 8: MaFak2019 showed [Qs Ac] and lost with three of a kind, Queens
Seat 9: manon327 folded before Flop (didn't bet)



PokerStars Home Game Hand #226731632263: {DaPokaStars}  Hold'em No Limit (50/100) - 2021/05/13 18:34:36 ET
Table 'again and again' 9-max (Play Money) Seat #4 is the button
Seat 1: color_singleton (10718 in chips) 
Seat 2: Jackall23 (37263 in chips) 
Seat 4: Klemtonius (17081 in chips) 
Seat 5: PokerStarsMan12 (45075 in chips) 
Seat 8: MaFak2019 (21808 in chips) 
Seat 9: manon327 (5305 in chips) 
PokerStarsMan12: posts small blind 50
MaFak2019: posts big blind 100
*** HOLE CARDS ***
Dealt to PokerStarsMan12 [Tc Kc]
manon327: calls 100
color_singleton: folds 
Jackall23: folds 
Klemtonius: raises 350 to 450
PokerStarsMan12: calls 400
MaFak2019: calls 350
manon327: calls 350
*** FLOP *** [2d Th Ac]
PokerStarsMan12: checks 
MaFak2019: checks 
manon327: checks 
Klemtonius: bets 1701
PokerStarsMan12: folds 
MaFak2019: folds 
manon327: folds 
Uncalled bet (1701) returned to Klemtonius
Klemtonius collected 1701 from pot
Klemtonius: doesn't show hand 
*** SUMMARY ***
Total pot 1800 | Rake 99 
Board [2d Th Ac]
Seat 1: color_singleton folded before Flop (didn't bet)
Seat 2: Jackall23 folded before Flop (didn't bet)
Seat 4: Klemtonius (button) collected (1701)
Seat 5: PokerStarsMan12 (small blind) folded on the Flop
Seat 8: MaFak2019 (big blind) folded on the Flop
Seat 9: manon327 folded on the Flop



PokerStars Home Game Hand #226731652168: {DaPokaStars}  Hold'em No Limit (50/100) - 2021/05/13 18:35:23 ET
Table 'again and again' 9-max (Play Money) Seat #5 is the button
Seat 1: color_singleton (10718 in chips) 
Seat 2: Jackall23 (37263 in chips) 
Seat 4: Klemtonius (18332 in chips) 
Seat 5: PokerStarsMan12 (44625 in chips) 
Seat 8: MaFak2019 (21358 in chips) 
Seat 9: manon327 (4855 in chips) 
MaFak2019: posts small blind 50
manon327: posts big blind 100
*** HOLE CARDS ***
Dealt to PokerStarsMan12 [Qc Qd]
color_singleton: folds 
Jackall23: folds 
Klemtonius: raises 250 to 350
PokerStarsMan12: raises 450 to 800
MaFak2019: calls 750
manon327: folds 
Klemtonius: calls 450
*** FLOP *** [3s 4d Jh]
MaFak2019: checks 
Klemtonius: bets 2362
PokerStarsMan12: calls 2362
MaFak2019: folds 
*** TURN *** [3s 4d Jh] [Jc]
Klemtonius: bets 15170 and is all-in
PokerStarsMan12: calls 15170
*** RIVER *** [3s 4d Jh Jc] [Ad]
*** SHOW DOWN ***
Klemtonius: shows [Ac 8s] (two pair, Aces and Jacks)
PokerStarsMan12: shows [Qc Qd] (two pair, Queens and Jacks)
Klemtonius collected 35498 from pot
*** SUMMARY ***
Total pot 37564 | Rake 2066 
Board [3s 4d Jh Jc Ad]
Seat 1: color_singleton folded before Flop (didn't bet)
Seat 2: Jackall23 folded before Flop (didn't bet)
Seat 4: Klemtonius showed [Ac 8s] and won (35498) with two pair, Aces and Jacks
Seat 5: PokerStarsMan12 (button) showed [Qc Qd] and lost with two pair, Queens and Jacks
Seat 8: MaFak2019 (small blind) folded on the Flop
Seat 9: manon327 (big blind) folded before Flop



PokerStars Home Game Hand #226731671202: {DaPokaStars}  Hold'em No Limit (50/100) - 2021/05/13 18:36:08 ET
Table 'again and again' 9-max (Play Money) Seat #8 is the button
Seat 1: color_singleton (10718 in chips) 
Seat 2: Jackall23 (37263 in chips) 
Seat 4: Klemtonius (35498 in chips) 
Seat 5: PokerStarsMan12 (26293 in chips) 
Seat 8: MaFak2019 (20558 in chips) 
Seat 9: manon327 (4755 in chips) 
manon327: posts small blind 50
color_singleton: posts big blind 100
*** HOLE CARDS ***
Dealt to PokerStarsMan12 [5c 9s]
Jackall23: folds 
Klemtonius: calls 100
PokerStarsMan12: folds 
MaFak2019: raises 200 to 300
manon327: folds 
color_singleton: calls 200
Klemtonius: folds 
*** FLOP *** [Ad 8d 3h]
color_singleton: checks 
MaFak2019: checks 
*** TURN *** [Ad 8d 3h] [7c]
color_singleton: bets 354
MaFak2019: raises 354 to 708
color_singleton: raises 3454 to 4162
MaFak2019: folds 
Uncalled bet (3454) returned to color_singleton
color_singleton collected 2047 from pot
color_singleton: doesn't show hand 
*** SUMMARY ***
Total pot 2166 | Rake 119 
Board [Ad 8d 3h 7c]
Seat 1: color_singleton (big blind) collected (2047)
Seat 2: Jackall23 folded before Flop (didn't bet)
Seat 4: Klemtonius folded before Flop
Seat 5: PokerStarsMan12 folded before Flop (didn't bet)
Seat 8: MaFak2019 (button) folded on the Turn
Seat 9: manon327 (small blind) folded before Flop



PokerStars Home Game Hand #226731698795: {DaPokaStars}  Hold'em No Limit (50/100) - 2021/05/13 18:37:14 ET
Table 'again and again' 9-max (Play Money) Seat #9 is the button
Seat 1: color_singleton (11757 in chips) 
Seat 2: Jackall23 (37263 in chips) 
Seat 4: Klemtonius (35398 in chips) 
Seat 5: PokerStarsMan12 (26293 in chips) 
Seat 8: MaFak2019 (19550 in chips) 
Seat 9: manon327 (4705 in chips) 
color_singleton: posts small blind 50
Jackall23: posts big blind 100
*** HOLE CARDS ***
Dealt to PokerStarsMan12 [5h 6d]
Klemtonius: calls 100
PokerStarsMan12: calls 100
MaFak2019: calls 100
manon327: calls 100
color_singleton: calls 50
Jackall23: checks 
*** FLOP *** [7d 4s 2c]
color_singleton: checks 
Jackall23: bets 100
Klemtonius: calls 100
PokerStarsMan12: raises 200 to 300
MaFak2019: folds 
manon327: folds 
color_singleton: calls 300
Jackall23: folds 
Klemtonius: calls 200
*** TURN *** [7d 4s 2c] [Qh]
color_singleton: checks 
Klemtonius: checks 
PokerStarsMan12: checks 
*** RIVER *** [7d 4s 2c Qh] [Kh]
color_singleton: bets 1512
Klemtonius: folds 
PokerStarsMan12: folds 
Uncalled bet (1512) returned to color_singleton
color_singleton collected 1512 from pot
color_singleton: doesn't show hand 
*** SUMMARY ***
Total pot 1600 | Rake 88 
Board [7d 4s 2c Qh Kh]
Seat 1: color_singleton (small blind) collected (1512)
Seat 2: Jackall23 (big blind) folded on the Flop
Seat 4: Klemtonius folded on the River
Seat 5: PokerStarsMan12 folded on the River
Seat 8: MaFak2019 folded on the Flop
Seat 9: manon327 (button) folded on the Flop



PokerStars Home Game Hand #226731726692: {DaPokaStars}  Hold'em No Limit (50/100) - 2021/05/13 18:38:09 ET
Table 'again and again' 9-max (Play Money) Seat #1 is the button
Seat 1: color_singleton (12869 in chips) 
Seat 2: Jackall23 (37063 in chips) 
Seat 4: Klemtonius (34998 in chips) 
Seat 5: PokerStarsMan12 (25893 in chips) 
Seat 8: MaFak2019 (19450 in chips) 
Seat 9: manon327 (4605 in chips) 
Jackall23: posts small blind 50
Klemtonius: posts big blind 100
*** HOLE CARDS ***
Dealt to PokerStarsMan12 [Qs Ah]
PokerStarsMan12: raises 300 to 400
MaFak2019: calls 400
manon327: folds 
color_singleton: folds 
Jackall23: folds 
Klemtonius: folds 
*** FLOP *** [Js 3s 8s]
PokerStarsMan12: bets 500
MaFak2019: raises 500 to 1000
PokerStarsMan12: calls 500
*** TURN *** [Js 3s 8s] [6h]
PokerStarsMan12: checks 
MaFak2019: checks 
*** RIVER *** [Js 3s 8s 6h] [2h]
PokerStarsMan12: bets 1700
MaFak2019: folds 
Uncalled bet (1700) returned to PokerStarsMan12
PokerStarsMan12 collected 2788 from pot
*** SUMMARY ***
Total pot 2950 | Rake 162 
Board [Js 3s 8s 6h 2h]
Seat 1: color_singleton (button) folded before Flop (didn't bet)
Seat 2: Jackall23 (small blind) folded before Flop
Seat 4: Klemtonius (big blind) folded before Flop
Seat 5: PokerStarsMan12 collected (2788)
Seat 8: MaFak2019 folded on the River
Seat 9: manon327 folded before Flop (didn't bet)



PokerStars Home Game Hand #226731740757: {DaPokaStars}  Hold'em No Limit (50/100) - 2021/05/13 18:38:43 ET
Table 'again and again' 9-max (Play Money) Seat #2 is the button
Seat 1: color_singleton (12869 in chips) 
Seat 2: Jackall23 (37013 in chips) 
Seat 4: Klemtonius (34898 in chips) 
Seat 5: PokerStarsMan12 (27281 in chips) 
Seat 8: MaFak2019 (18050 in chips) 
Seat 9: manon327 (4605 in chips) 
Klemtonius: posts small blind 50
PokerStarsMan12: posts big blind 100
*** HOLE CARDS ***
Dealt to PokerStarsMan12 [4s 3c]
MaFak2019: raises 200 to 300
manon327: folds 
color_singleton: folds 
Jackall23: calls 300
Klemtonius: folds 
PokerStarsMan12: calls 200
*** FLOP *** [Ad Jd Td]
PokerStarsMan12: checks 
MaFak2019: bets 898
Jackall23: folds 
PokerStarsMan12: folds 
Uncalled bet (898) returned to MaFak2019
MaFak2019 collected 898 from pot
MaFak2019: doesn't show hand 
*** SUMMARY ***
Total pot 950 | Rake 52 
Board [Ad Jd Td]
Seat 1: color_singleton folded before Flop (didn't bet)
Seat 2: Jackall23 (button) folded on the Flop
Seat 4: Klemtonius (small blind) folded before Flop
Seat 5: PokerStarsMan12 (big blind) folded on the Flop
Seat 8: MaFak2019 collected (898)
Seat 9: manon327 folded before Flop (didn't bet)



PokerStars Home Game Hand #226731750766: {DaPokaStars}  Hold'em No Limit (50/100) - 2021/05/13 18:39:07 ET
Table 'again and again' 9-max (Play Money) Seat #4 is the button
Seat 1: color_singleton (12869 in chips) 
Seat 2: Jackall23 (36713 in chips) 
Seat 4: Klemtonius (34848 in chips) 
Seat 5: PokerStarsMan12 (26981 in chips) 
Seat 8: MaFak2019 (18648 in chips) 
Seat 9: manon327 (4605 in chips) 
PokerStarsMan12: posts small blind 50
MaFak2019: posts big blind 100
*** HOLE CARDS ***
Dealt to PokerStarsMan12 [2d 8h]
manon327: calls 100
color_singleton: raises 200 to 300
Jackall23: folds 
Klemtonius: raises 850 to 1150
PokerStarsMan12: folds 
MaFak2019: folds 
manon327: folds 
color_singleton: raises 3950 to 5100
Klemtonius: raises 11850 to 16950
color_singleton: calls 7769 and is all-in
Uncalled bet (4081) returned to Klemtonius
*** FLOP *** [Ad 3s 3h]
*** TURN *** [Ad 3s 3h] [7c]
*** RIVER *** [Ad 3s 3h 7c] [Td]
*** SHOW DOWN ***
color_singleton: shows [Qh Qd] (two pair, Queens and Threes)
Klemtonius: shows [Kc Kh] (two pair, Kings and Threes)
Klemtonius collected 24559 from pot
*** SUMMARY ***
Total pot 25988 | Rake 1429 
Board [Ad 3s 3h 7c Td]
Seat 1: color_singleton showed [Qh Qd] and lost with two pair, Queens and Threes
Seat 2: Jackall23 folded before Flop (didn't bet)
Seat 4: Klemtonius (button) showed [Kc Kh] and won (24559) with two pair, Kings and Threes
Seat 5: PokerStarsMan12 (small blind) folded before Flop
Seat 8: MaFak2019 (big blind) folded before Flop
Seat 9: manon327 folded before Flop



PokerStars Home Game Hand #226731770022: {DaPokaStars}  Hold'em No Limit (50/100) - 2021/05/13 18:39:54 ET
Table 'again and again' 9-max (Play Money) Seat #5 is the button
Seat 2: Jackall23 (36713 in chips) 
Seat 4: Klemtonius (46538 in chips) 
Seat 5: PokerStarsMan12 (26931 in chips) 
Seat 8: MaFak2019 (18548 in chips) 
Seat 9: manon327 (4505 in chips) 
MaFak2019: posts small blind 50
manon327: posts big blind 100
*** HOLE CARDS ***
Dealt to PokerStarsMan12 [6s Ks]
Jackall23: calls 100
Klemtonius: folds 
PokerStarsMan12: raises 200 to 300
MaFak2019: calls 250
manon327: folds 
Jackall23: calls 200
*** FLOP *** [3d Th 4s]
MaFak2019: checks 
Jackall23: bets 472
PokerStarsMan12: folds 
MaFak2019: folds 
Uncalled bet (472) returned to Jackall23
Jackall23 collected 945 from pot
*** SUMMARY ***
Total pot 1000 | Rake 55 
Board [3d Th 4s]
Seat 2: Jackall23 collected (945)
Seat 4: Klemtonius folded before Flop (didn't bet)
Seat 5: PokerStarsMan12 (button) folded on the Flop
Seat 8: MaFak2019 (small blind) folded on the Flop
Seat 9: manon327 (big blind) folded before Flop



PokerStars Home Game Hand #226731782594: {DaPokaStars}  Hold'em No Limit (50/100) - 2021/05/13 18:40:24 ET
Table 'again and again' 9-max (Play Money) Seat #8 is the button
Seat 1: color_singleton (10000 in chips) 
Seat 2: Jackall23 (37358 in chips) 
Seat 4: Klemtonius (46538 in chips) 
Seat 5: PokerStarsMan12 (26631 in chips) 
Seat 8: MaFak2019 (18248 in chips) 
Seat 9: manon327 (4405 in chips) 
manon327: posts small blind 50
color_singleton: posts big blind 100
*** HOLE CARDS ***
Dealt to PokerStarsMan12 [Td 6c]
Jackall23: calls 100
Klemtonius: calls 100
PokerStarsMan12: folds 
MaFak2019: calls 100
manon327: folds 
color_singleton: checks 
*** FLOP *** [8c Ad Jh]
color_singleton: bets 212
Jackall23: raises 212 to 424
Klemtonius: folds 
MaFak2019: calls 424
color_singleton: calls 212
*** TURN *** [8c Ad Jh] [Ah]
color_singleton: checks 
Jackall23: bets 813
MaFak2019: calls 813
color_singleton: calls 813
*** RIVER *** [8c Ad Jh Ah] [5c]
color_singleton: checks 
Jackall23: bets 1966
MaFak2019: folds 
color_singleton: folds 
Uncalled bet (1966) returned to Jackall23
Jackall23 collected 3932 from pot
*** SUMMARY ***
Total pot 4161 | Rake 229 
Board [8c Ad Jh Ah 5c]
Seat 1: color_singleton (big blind) folded on the River
Seat 2: Jackall23 collected (3932)
Seat 4: Klemtonius folded on the Flop
Seat 5: PokerStarsMan12 folded before Flop (didn't bet)
Seat 8: MaFak2019 (button) folded on the River
Seat 9: manon327 (small blind) folded before Flop



PokerStars Home Game Hand #226731801139: {DaPokaStars}  Hold'em No Limit (50/100) - 2021/05/13 18:41:09 ET
Table 'again and again' 9-max (Play Money) Seat #9 is the button
Seat 1: color_singleton (8663 in chips) 
Seat 2: Jackall23 (39953 in chips) 
Seat 4: Klemtonius (46438 in chips) 
Seat 5: PokerStarsMan12 (26631 in chips) 
Seat 8: MaFak2019 (16911 in chips) 
Seat 9: manon327 (4355 in chips) 
color_singleton: posts small blind 50
Jackall23: posts big blind 100
*** HOLE CARDS ***
Dealt to PokerStarsMan12 [6h 9d]
Klemtonius: folds 
PokerStarsMan12: folds 
MaFak2019: raises 200 to 300
manon327: calls 300
color_singleton: calls 250
Jackall23: calls 200
*** FLOP *** [Jc Qs 5c]
color_singleton: bets 1134
Jackall23: folds 
MaFak2019: raises 1134 to 2268
manon327: folds 
color_singleton: calls 1134
*** TURN *** [Jc Qs 5c] [9s]
color_singleton: checks 
MaFak2019: bets 5421
color_singleton: calls 5421
*** RIVER *** [Jc Qs 5c 9s] [Kh]
color_singleton: checks 
MaFak2019: bets 8922 and is all-in
color_singleton: calls 674 and is all-in
Uncalled bet (8248) returned to MaFak2019
*** SHOW DOWN ***
MaFak2019: shows [5h 5s] (three of a kind, Fives)
color_singleton: shows [4h Jh] (a pair of Jacks)
MaFak2019 collected 16940 from pot
*** SUMMARY ***
Total pot 17926 | Rake 986 
Board [Jc Qs 5c 9s Kh]
Seat 1: color_singleton (small blind) showed [4h Jh] and lost with a pair of Jacks
Seat 2: Jackall23 (big blind) folded on the Flop
Seat 4: Klemtonius folded before Flop (didn't bet)
Seat 5: PokerStarsMan12 folded before Flop (didn't bet)
Seat 8: MaFak2019 showed [5h 5s] and won (16940) with three of a kind, Fives
Seat 9: manon327 (button) folded on the Flop



PokerStars Home Game Hand #226731816938: {DaPokaStars}  Hold'em No Limit (50/100) - 2021/05/13 18:41:48 ET
Table 'again and again' 9-max (Play Money) Seat #2 is the button
Seat 2: Jackall23 (39653 in chips) 
Seat 4: Klemtonius (46438 in chips) 
Seat 5: PokerStarsMan12 (26631 in chips) 
Seat 8: MaFak2019 (25188 in chips) 
Seat 9: manon327 (4055 in chips) 
Klemtonius: posts small blind 50
PokerStarsMan12: posts big blind 100
*** HOLE CARDS ***
Dealt to PokerStarsMan12 [6h Ks]
MaFak2019: calls 100
manon327: calls 100
Jackall23: folds 
Klemtonius: calls 50
PokerStarsMan12: checks 
*** FLOP *** [7d 5h Ah]
Klemtonius: checks 
PokerStarsMan12: checks 
MaFak2019: checks 
manon327: checks 
*** TURN *** [7d 5h Ah] [9c]
Klemtonius: checks 
PokerStarsMan12: checks 
MaFak2019: checks 
manon327: checks 
*** RIVER *** [7d 5h Ah 9c] [3c]
Klemtonius: bets 189
PokerStarsMan12: folds 
MaFak2019: folds 
manon327: folds 
Uncalled bet (189) returned to Klemtonius
Klemtonius collected 378 from pot
Klemtonius: doesn't show hand 
*** SUMMARY ***
Total pot 400 | Rake 22 
Board [7d 5h Ah 9c 3c]
Seat 2: Jackall23 (button) folded before Flop (didn't bet)
Seat 4: Klemtonius (small blind) collected (378)
Seat 5: PokerStarsMan12 (big blind) folded on the River
Seat 8: MaFak2019 folded on the River
Seat 9: manon327 folded on the River



PokerStars Home Game Hand #226731838394: {DaPokaStars}  Hold'em No Limit (50/100) - 2021/05/13 18:42:40 ET
Table 'again and again' 9-max (Play Money) Seat #4 is the button
Seat 1: color_singleton (10000 in chips) 
Seat 2: Jackall23 (39653 in chips) 
Seat 4: Klemtonius (46716 in chips) 
Seat 5: PokerStarsMan12 (26531 in chips) 
Seat 8: MaFak2019 (25088 in chips) 
Seat 9: manon327 (3955 in chips) 
PokerStarsMan12: posts small blind 50
MaFak2019: posts big blind 100
*** HOLE CARDS ***
Dealt to PokerStarsMan12 [7h 7d]
manon327: calls 100
color_singleton: folds 
Jackall23: calls 100
Klemtonius: folds 
PokerStarsMan12: calls 50
MaFak2019: checks 
*** FLOP *** [Th Kd 6s]
PokerStarsMan12: checks 
MaFak2019: checks 
manon327: bets 189
Jackall23: calls 189
PokerStarsMan12: calls 189
MaFak2019: calls 189
*** TURN *** [Th Kd 6s] [Qs]
PokerStarsMan12: checks 
MaFak2019: checks 
manon327: bets 546
Jackall23: folds 
PokerStarsMan12: folds 
MaFak2019: calls 546
*** RIVER *** [Th Kd 6s Qs] [8d]
MaFak2019: checks 
manon327: bets 1062
MaFak2019: folds 
Uncalled bet (1062) returned to manon327
manon327 collected 2124 from pot
*** SUMMARY ***
Total pot 2248 | Rake 124 
Board [Th Kd 6s Qs 8d]
Seat 1: color_singleton folded before Flop (didn't bet)
Seat 2: Jackall23 folded on the Turn
Seat 4: Klemtonius (button) folded before Flop (didn't bet)
Seat 5: PokerStarsMan12 (small blind) folded on the Turn
Seat 8: MaFak2019 (big blind) folded on the River
Seat 9: manon327 collected (2124)



PokerStars Home Game Hand #226731861269: {DaPokaStars}  Hold'em No Limit (50/100) - 2021/05/13 18:43:36 ET
Table 'again and again' 9-max (Play Money) Seat #5 is the button
Seat 1: color_singleton (10000 in chips) 
Seat 2: Jackall23 (39364 in chips) 
Seat 4: Klemtonius (46716 in chips) 
Seat 5: PokerStarsMan12 (26242 in chips) 
Seat 8: MaFak2019 (24253 in chips) 
Seat 9: manon327 (5244 in chips) 
MaFak2019: posts small blind 50
manon327: posts big blind 100
*** HOLE CARDS ***
Dealt to PokerStarsMan12 [Th Ac]
color_singleton: folds 
Jackall23: raises 100 to 200
Klemtonius: calls 200
PokerStarsMan12: calls 200
MaFak2019: folds 
manon327: calls 100
*** FLOP *** [Ah 8d 5d]
manon327: bets 401
Jackall23: raises 401 to 802
Klemtonius: folds 
PokerStarsMan12: calls 802
manon327: calls 401
*** TURN *** [Ah 8d 5d] [9h]
manon327: checks 
Jackall23: bets 1538
PokerStarsMan12: calls 1538
manon327: calls 1538
*** RIVER *** [Ah 8d 5d 9h] [3c]
manon327: checks 
Jackall23: bets 3718
PokerStarsMan12: folds 
manon327: folds 
Uncalled bet (3718) returned to Jackall23
Jackall23 collected 7437 from pot
*** SUMMARY ***
Total pot 7870 | Rake 433 
Board [Ah 8d 5d 9h 3c]
Seat 1: color_singleton folded before Flop (didn't bet)
Seat 2: Jackall23 collected (7437)
Seat 4: Klemtonius folded on the Flop
Seat 5: PokerStarsMan12 (button) folded on the River
Seat 8: MaFak2019 (small blind) folded before Flop
Seat 9: manon327 (big blind) folded on the River



PokerStars Home Game Hand #226731887441: {DaPokaStars}  Hold'em No Limit (50/100) - 2021/05/13 18:44:41 ET
Table 'again and again' 9-max (Play Money) Seat #8 is the button
Seat 1: color_singleton (10000 in chips) 
Seat 2: Jackall23 (44261 in chips) 
Seat 4: Klemtonius (46516 in chips) 
Seat 5: PokerStarsMan12 (23702 in chips) 
Seat 8: MaFak2019 (24203 in chips) 
Seat 9: manon327 (2704 in chips) 
manon327: posts small blind 50
color_singleton: posts big blind 100
*** HOLE CARDS ***
Dealt to PokerStarsMan12 [2d 7s]
Jackall23: folds 
Klemtonius: calls 100
PokerStarsMan12: folds 
MaFak2019: calls 100
manon327: calls 50
color_singleton: checks 
*** FLOP *** [3d Th Jc]
manon327: checks 
color_singleton: checks 
Klemtonius: bets 189
MaFak2019: folds 
manon327: folds 
color_singleton: folds 
Uncalled bet (189) returned to Klemtonius
Klemtonius collected 378 from pot
Klemtonius: doesn't show hand 
*** SUMMARY ***
Total pot 400 | Rake 22 
Board [3d Th Jc]
Seat 1: color_singleton (big blind) folded on the Flop
Seat 2: Jackall23 folded before Flop (didn't bet)
Seat 4: Klemtonius collected (378)
Seat 5: PokerStarsMan12 folded before Flop (didn't bet)
Seat 8: MaFak2019 (button) folded on the Flop
Seat 9: manon327 (small blind) folded on the Flop



PokerStars Home Game Hand #226731899288: {DaPokaStars}  Hold'em No Limit (50/100) - 2021/05/13 18:45:10 ET
Table 'again and again' 9-max (Play Money) Seat #9 is the button
Seat 1: color_singleton (9900 in chips) 
Seat 2: Jackall23 (44261 in chips) 
Seat 4: Klemtonius (46794 in chips) 
Seat 5: PokerStarsMan12 (23702 in chips) 
Seat 8: MaFak2019 (24103 in chips) 
Seat 9: manon327 (2604 in chips) 
color_singleton: posts small blind 50
Jackall23: posts big blind 100
*** HOLE CARDS ***
Dealt to PokerStarsMan12 [Ah Js]
Klemtonius: folds 
PokerStarsMan12: raises 200 to 300
MaFak2019: calls 300
manon327 has timed out
manon327: folds 
color_singleton: folds 
Jackall23: calls 200
*** FLOP *** [2d Td Ac]
Jackall23: checks 
PokerStarsMan12: bets 500
MaFak2019: folds 
Jackall23: folds 
Uncalled bet (500) returned to PokerStarsMan12
PokerStarsMan12 collected 898 from pot
*** SUMMARY ***
Total pot 950 | Rake 52 
Board [2d Td Ac]
Seat 1: color_singleton (small blind) folded before Flop
Seat 2: Jackall23 (big blind) folded on the Flop
Seat 4: Klemtonius folded before Flop (didn't bet)
Seat 5: PokerStarsMan12 collected (898)
Seat 8: MaFak2019 folded on the Flop
Seat 9: manon327 (button) folded before Flop (didn't bet)



PokerStars Home Game Hand #226731913775: {DaPokaStars}  Hold'em No Limit (50/100) - 2021/05/13 18:45:46 ET
Table 'again and again' 9-max (Play Money) Seat #1 is the button
Seat 1: color_singleton (9850 in chips) 
Seat 2: Jackall23 (43961 in chips) 
Seat 4: Klemtonius (46794 in chips) 
Seat 5: PokerStarsMan12 (24300 in chips) 
Seat 8: MaFak2019 (23803 in chips) 
Jackall23: posts small blind 50
Klemtonius: posts big blind 100
*** HOLE CARDS ***
Dealt to PokerStarsMan12 [9c 9d]
PokerStarsMan12: raises 300 to 400
MaFak2019: raises 300 to 700
color_singleton: folds 
Jackall23: folds 
Klemtonius: calls 600
PokerStarsMan12: calls 300
*** FLOP *** [Ac 3h Kd]
Klemtonius: checks 
PokerStarsMan12: checks 
MaFak2019: bets 1016
Klemtonius: folds 
PokerStarsMan12: folds 
Uncalled bet (1016) returned to MaFak2019
MaFak2019 collected 2032 from pot
MaFak2019: doesn't show hand 
*** SUMMARY ***
Total pot 2150 | Rake 118 
Board [Ac 3h Kd]
Seat 1: color_singleton (button) folded before Flop (didn't bet)
Seat 2: Jackall23 (small blind) folded before Flop
Seat 4: Klemtonius (big blind) folded on the Flop
Seat 5: PokerStarsMan12 folded on the Flop
Seat 8: MaFak2019 collected (2032)



PokerStars Home Game Hand #226731930755: {DaPokaStars}  Hold'em No Limit (50/100) - 2021/05/13 18:46:27 ET
Table 'again and again' 9-max (Play Money) Seat #4 is the button
Seat 1: color_singleton (9850 in chips) 
Seat 4: Klemtonius (46094 in chips) 
Seat 5: PokerStarsMan12 (23600 in chips) 
Seat 8: MaFak2019 (25135 in chips) 
Seat 9: manon327 (2604 in chips) 
PokerStarsMan12: posts small blind 50
MaFak2019: posts big blind 100
*** HOLE CARDS ***
Dealt to PokerStarsMan12 [Ts 8h]
Jackall23 leaves the table
manon327: folds 
color_singleton: raises 100 to 200
Klemtonius: calls 200
PokerStarsMan12: folds 
MaFak2019: raises 650 to 850
color_singleton: calls 650
Klemtonius: folds 
*** FLOP *** [4s 9d 3c]
MaFak2019: checks 
color_singleton: checks 
*** TURN *** [4s 9d 3c] [Jh]
MaFak2019: checks 
color_singleton: checks 
*** RIVER *** [4s 9d 3c Jh] [Kd]
MaFak2019: checks 
color_singleton: checks 
*** SHOW DOWN ***
MaFak2019: shows [Td Ad] (high card Ace)
color_singleton: mucks hand 
MaFak2019 collected 1843 from pot
*** SUMMARY ***
Total pot 1950 | Rake 107 
Board [4s 9d 3c Jh Kd]
Seat 1: color_singleton mucked [5d Qd]
Seat 4: Klemtonius (button) folded before Flop
Seat 5: PokerStarsMan12 (small blind) folded before Flop
Seat 8: MaFak2019 (big blind) showed [Td Ad] and won (1843) with high card Ace
Seat 9: manon327 folded before Flop (didn't bet)



PokerStars Home Game Hand #226731944398: {DaPokaStars}  Hold'em No Limit (50/100) - 2021/05/13 18:47:01 ET
Table 'again and again' 9-max (Play Money) Seat #5 is the button
Seat 1: color_singleton (9000 in chips) 
Seat 4: Klemtonius (45894 in chips) 
Seat 5: PokerStarsMan12 (23550 in chips) 
Seat 8: MaFak2019 (26128 in chips) 
Seat 9: manon327 (2604 in chips) 
MaFak2019: posts small blind 50
manon327: posts big blind 100
*** HOLE CARDS ***
Dealt to PokerStarsMan12 [Js 7s]
color_singleton: raises 200 to 300
Klemtonius: folds 
PokerStarsMan12: calls 300
MaFak2019: folds 
manon327: calls 200
*** FLOP *** [Jc Ac 4h]
manon327: checks 
color_singleton: checks 
PokerStarsMan12: checks 
*** TURN *** [Jc Ac 4h] [Tc]
manon327: bets 449
color_singleton: calls 449
PokerStarsMan12: calls 449
*** RIVER *** [Jc Ac 4h Tc] [4c]
manon327: bets 1085
color_singleton: calls 1085
PokerStarsMan12: folds 
*** SHOW DOWN ***
manon327: shows [Jh 9s] (two pair, Jacks and Fours)
color_singleton: shows [Qh 9c] (a flush, Ace high)
color_singleton collected 4221 from pot
*** SUMMARY ***
Total pot 4467 | Rake 246 
Board [Jc Ac 4h Tc 4c]
Seat 1: color_singleton showed [Qh 9c] and won (4221) with a flush, Ace high
Seat 4: Klemtonius folded before Flop (didn't bet)
Seat 5: PokerStarsMan12 (button) folded on the River
Seat 8: MaFak2019 (small blind) folded before Flop
Seat 9: manon327 (big blind) showed [Jh 9s] and lost with two pair, Jacks and Fours



PokerStars Home Game Hand #226731964361: {DaPokaStars}  Hold'em No Limit (50/100) - 2021/05/13 18:47:51 ET
Table 'again and again' 9-max (Play Money) Seat #8 is the button
Seat 1: color_singleton (11387 in chips) 
Seat 4: Klemtonius (45894 in chips) 
Seat 5: PokerStarsMan12 (22801 in chips) 
Seat 8: MaFak2019 (26078 in chips) 
Seat 9: manon327 (770 in chips) 
manon327: posts small blind 50
color_singleton: posts big blind 100
*** HOLE CARDS ***
Dealt to PokerStarsMan12 [8c 6h]
Klemtonius: raises 250 to 350
PokerStarsMan12: folds 
MaFak2019: folds 
manon327: raises 420 to 770 and is all-in
color_singleton: folds 
Klemtonius: calls 420
*** FLOP *** [4c Qd 5d]
*** TURN *** [4c Qd 5d] [9h]
*** RIVER *** [4c Qd 5d 9h] [Jd]
*** SHOW DOWN ***
manon327: shows [2c Kd] (high card King)
Klemtonius: shows [Ah Tc] (high card Ace)
Klemtonius collected 1550 from pot
*** SUMMARY ***
Total pot 1640 | Rake 90 
Board [4c Qd 5d 9h Jd]
Seat 1: color_singleton (big blind) folded before Flop
Seat 4: Klemtonius showed [Ah Tc] and won (1550) with high card Ace
Seat 5: PokerStarsMan12 folded before Flop (didn't bet)
Seat 8: MaFak2019 (button) folded before Flop (didn't bet)
Seat 9: manon327 (small blind) showed [2c Kd] and lost with high card King



PokerStars Home Game Hand #226731974754: {DaPokaStars}  Hold'em No Limit (50/100) - 2021/05/13 18:48:16 ET
Table 'again and again' 9-max (Play Money) Seat #1 is the button
Seat 1: color_singleton (11287 in chips) 
Seat 4: Klemtonius (46674 in chips) 
Seat 5: PokerStarsMan12 (22801 in chips) 
Seat 8: MaFak2019 (26078 in chips) 
Klemtonius: posts small blind 50
PokerStarsMan12: posts big blind 100
*** HOLE CARDS ***
Dealt to PokerStarsMan12 [Qs 4h]
MaFak2019: calls 100
color_singleton: folds 
Klemtonius: calls 50
PokerStarsMan12: checks 
*** FLOP *** [Td Kh 7d]
Klemtonius: checks 
PokerStarsMan12: checks 
MaFak2019: bets 283
Klemtonius: folds 
PokerStarsMan12: folds 
Uncalled bet (283) returned to MaFak2019
MaFak2019 collected 283 from pot
MaFak2019: doesn't show hand 
*** SUMMARY ***
Total pot 300 | Rake 17 
Board [Td Kh 7d]
Seat 1: color_singleton (button) folded before Flop (didn't bet)
Seat 4: Klemtonius (small blind) folded on the Flop
Seat 5: PokerStarsMan12 (big blind) folded on the Flop
Seat 8: MaFak2019 collected (283)



PokerStars Home Game Hand #226731987667: {DaPokaStars}  Hold'em No Limit (50/100) - 2021/05/13 18:48:48 ET
Table 'again and again' 9-max (Play Money) Seat #4 is the button
Seat 1: color_singleton (11287 in chips) 
Seat 4: Klemtonius (46574 in chips) 
Seat 5: PokerStarsMan12 (22701 in chips) 
Seat 8: MaFak2019 (26261 in chips) 
PokerStarsMan12: posts small blind 50
MaFak2019: posts big blind 100
*** HOLE CARDS ***
Dealt to PokerStarsMan12 [Ah Js]
color_singleton: folds 
Klemtonius: calls 100
manon327 leaves the table
PokerStarsMan12: raises 300 to 400
MaFak2019: raises 300 to 700
Klemtonius: calls 600
PokerStarsMan12: calls 300
*** FLOP *** [6s Kh 4h]
PokerStarsMan12: checks 
MaFak2019: checks 
Klemtonius: bets 1984
PokerStarsMan12: folds 
MaFak2019: folds 
Uncalled bet (1984) returned to Klemtonius
Klemtonius collected 1984 from pot
Klemtonius: doesn't show hand 
*** SUMMARY ***
Total pot 2100 | Rake 116 
Board [6s Kh 4h]
Seat 1: color_singleton folded before Flop (didn't bet)
Seat 4: Klemtonius (button) collected (1984)
Seat 5: PokerStarsMan12 (small blind) folded on the Flop
Seat 8: MaFak2019 (big blind) folded on the Flop



PokerStars Home Game Hand #226732000394: {DaPokaStars}  Hold'em No Limit (50/100) - 2021/05/13 18:49:20 ET
Table 'again and again' 9-max (Play Money) Seat #5 is the button
Seat 1: color_singleton (11287 in chips) 
Seat 4: Klemtonius (47858 in chips) 
Seat 5: PokerStarsMan12 (22001 in chips) 
Seat 8: MaFak2019 (25561 in chips) 
MaFak2019: posts small blind 50
color_singleton: posts big blind 100
*** HOLE CARDS ***
Dealt to PokerStarsMan12 [3s 7h]
Klemtonius: raises 250 to 350
PokerStarsMan12: folds 
MaFak2019: calls 300
color_singleton: raises 250 to 600
Klemtonius: calls 250
MaFak2019: calls 250
*** FLOP *** [6d 8s Kd]
MaFak2019: checks 
color_singleton: bets 850
Klemtonius: folds 
MaFak2019: calls 850
*** TURN *** [6d 8s Kd] [Ah]
MaFak2019: checks 
color_singleton: checks 
*** RIVER *** [6d 8s Kd Ah] [Th]
MaFak2019: checks 
color_singleton: checks 
*** SHOW DOWN ***
MaFak2019: shows [4c 5h] (high card Ace)
color_singleton: shows [Kc Qd] (a pair of Kings)
color_singleton collected 3307 from pot
*** SUMMARY ***
Total pot 3500 | Rake 193 
Board [6d 8s Kd Ah Th]
Seat 1: color_singleton (big blind) showed [Kc Qd] and won (3307) with a pair of Kings
Seat 4: Klemtonius folded on the Flop
Seat 5: PokerStarsMan12 (button) folded before Flop (didn't bet)
Seat 8: MaFak2019 (small blind) showed [4c 5h] and lost with high card Ace



PokerStars Home Game Hand #226732014722: {DaPokaStars}  Hold'em No Limit (50/100) - 2021/05/13 18:49:55 ET
Table 'again and again' 9-max (Play Money) Seat #8 is the button
Seat 1: color_singleton (13144 in chips) 
Seat 4: Klemtonius (47258 in chips) 
Seat 5: PokerStarsMan12 (22001 in chips) 
Seat 8: MaFak2019 (24111 in chips) 
color_singleton: posts small blind 50
Klemtonius: posts big blind 100
*** HOLE CARDS ***
Dealt to PokerStarsMan12 [7d Ad]
PokerStarsMan12: raises 300 to 400
MaFak2019: folds 
color_singleton: calls 350
Klemtonius: calls 300
*** FLOP *** [Kh Tc 9h]
color_singleton: bets 567
Klemtonius: raises 567 to 1134
PokerStarsMan12: folds 
color_singleton: calls 567
*** TURN *** [Kh Tc 9h] [7h]
color_singleton: checks 
Klemtonius: bets 1638
color_singleton: folds 
Uncalled bet (1638) returned to Klemtonius
Klemtonius collected 3277 from pot
Klemtonius: doesn't show hand 
*** SUMMARY ***
Total pot 3468 | Rake 191 
Board [Kh Tc 9h 7h]
Seat 1: color_singleton (small blind) folded on the Turn
Seat 4: Klemtonius (big blind) collected (3277)
Seat 5: PokerStarsMan12 folded on the Flop
Seat 8: MaFak2019 (button) folded before Flop (didn't bet)



PokerStars Home Game Hand #226732025318: {DaPokaStars}  Hold'em No Limit (50/100) - 2021/05/13 18:50:22 ET
Table 'again and again' 9-max (Play Money) Seat #1 is the button
Seat 1: color_singleton (11610 in chips) 
Seat 4: Klemtonius (49001 in chips) 
Seat 5: PokerStarsMan12 (21601 in chips) 
Seat 8: MaFak2019 (24111 in chips) 
Klemtonius: posts small blind 50
PokerStarsMan12: posts big blind 100
*** HOLE CARDS ***
Dealt to PokerStarsMan12 [9c 6h]
MaFak2019 has timed out
MaFak2019: folds 
color_singleton: folds 
Klemtonius: calls 50
PokerStarsMan12: checks 
*** FLOP *** [2s 8s 3c]
Klemtonius: checks 
PokerStarsMan12: checks 
*** TURN *** [2s 8s 3c] [2d]
Klemtonius: checks 
PokerStarsMan12: checks 
*** RIVER *** [2s 8s 3c 2d] [4h]
Klemtonius: checks 
PokerStarsMan12: checks 
*** SHOW DOWN ***
Klemtonius: shows [9s 7h] (a pair of Deuces)
PokerStarsMan12: mucks hand 
Klemtonius collected 189 from pot
*** SUMMARY ***
Total pot 200 | Rake 11 
Board [2s 8s 3c 2d 4h]
Seat 1: color_singleton (button) folded before Flop (didn't bet)
Seat 4: Klemtonius (small blind) showed [9s 7h] and won (189) with a pair of Deuces
Seat 5: PokerStarsMan12 (big blind) mucked [9c 6h]
Seat 8: MaFak2019 folded before Flop (didn't bet)



PokerStars Home Game Hand #226732041799: {DaPokaStars}  Hold'em No Limit (50/100) - 2021/05/13 18:51:00 ET
Table 'again and again' 9-max (Play Money) Seat #4 is the button
Seat 1: color_singleton (11610 in chips) 
Seat 4: Klemtonius (49090 in chips) 
Seat 5: PokerStarsMan12 (21501 in chips) 
PokerStarsMan12: posts small blind 50
color_singleton: posts big blind 100
*** HOLE CARDS ***
Dealt to PokerStarsMan12 [7d 4h]
Klemtonius: raises 100 to 200
PokerStarsMan12: folds 
color_singleton: calls 100
*** FLOP *** [7h 6c 4c]
color_singleton: bets 212
Klemtonius: raises 849 to 1061
color_singleton: calls 849
*** TURN *** [7h 6c 4c] [Qc]
color_singleton: checks 
Klemtonius: checks 
*** RIVER *** [7h 6c 4c Qc] [Ac]
color_singleton: checks 
Klemtonius: checks 
*** SHOW DOWN ***
color_singleton: shows [3s 3d] (a pair of Threes)
Klemtonius: shows [5h 6h] (a pair of Sixes)
Klemtonius collected 2431 from pot
*** SUMMARY ***
Total pot 2572 | Rake 141 
Board [7h 6c 4c Qc Ac]
Seat 1: color_singleton (big blind) showed [3s 3d] and lost with a pair of Threes
Seat 4: Klemtonius (button) showed [5h 6h] and won (2431) with a pair of Sixes
Seat 5: PokerStarsMan12 (small blind) folded before Flop



PokerStars Home Game Hand #226732055108: {DaPokaStars}  Hold'em No Limit (50/100) - 2021/05/13 18:51:34 ET
Table 'again and again' 9-max (Play Money) Seat #5 is the button
Seat 1: color_singleton (10349 in chips) 
Seat 4: Klemtonius (50260 in chips) 
Seat 5: PokerStarsMan12 (21451 in chips) 
color_singleton: posts small blind 50
Klemtonius: posts big blind 100
*** HOLE CARDS ***
Dealt to PokerStarsMan12 [4c 9c]
PokerStarsMan12: calls 100
color_singleton: folds 
Klemtonius: checks 
*** FLOP *** [Jh Qd As]
Klemtonius: bets 236
PokerStarsMan12: folds 
Uncalled bet (236) returned to Klemtonius
Klemtonius collected 236 from pot
Klemtonius: doesn't show hand 
*** SUMMARY ***
Total pot 250 | Rake 14 
Board [Jh Qd As]
Seat 1: color_singleton (small blind) folded before Flop
Seat 4: Klemtonius (big blind) collected (236)
Seat 5: PokerStarsMan12 (button) folded on the Flop



PokerStars Home Game Hand #226732060608: {DaPokaStars}  Hold'em No Limit (50/100) - 2021/05/13 18:51:48 ET
Table 'again and again' 9-max (Play Money) Seat #1 is the button
Seat 1: color_singleton (10299 in chips) 
Seat 4: Klemtonius (50396 in chips) 
Seat 5: PokerStarsMan12 (21351 in chips) 
Seat 8: MaFak2019 (24111 in chips) 
Klemtonius: posts small blind 50
PokerStarsMan12: posts big blind 100
MaFak2019: posts small & big blinds 150
*** HOLE CARDS ***
Dealt to PokerStarsMan12 [8c 6c]
MaFak2019: checks 
color_singleton: raises 200 to 300
Klemtonius: raises 200 to 500
PokerStarsMan12: folds 
MaFak2019: folds 
color_singleton: calls 200
*** FLOP *** [Kc 5c Qd]
Klemtonius: bets 1181
color_singleton: folds 
Uncalled bet (1181) returned to Klemtonius
Klemtonius collected 1181 from pot
Klemtonius: doesn't show hand 
*** SUMMARY ***
Total pot 1250 | Rake 69 
Board [Kc 5c Qd]
Seat 1: color_singleton (button) folded on the Flop
Seat 4: Klemtonius (small blind) collected (1181)
Seat 5: PokerStarsMan12 (big blind) folded before Flop
Seat 8: MaFak2019 folded before Flop (didn't bet)



PokerStars Home Game Hand #226732068467: {DaPokaStars}  Hold'em No Limit (50/100) - 2021/05/13 18:52:08 ET
Table 'again and again' 9-max (Play Money) Seat #4 is the button
Seat 1: color_singleton (9799 in chips) 
Seat 4: Klemtonius (51077 in chips) 
Seat 5: PokerStarsMan12 (21251 in chips) 
Seat 8: MaFak2019 (23961 in chips) 
PokerStarsMan12: posts small blind 50
MaFak2019: posts big blind 100
*** HOLE CARDS ***
Dealt to PokerStarsMan12 [3s Kh]
color_singleton: folds 
Klemtonius: folds 
PokerStarsMan12: calls 50
MaFak2019: checks 
*** FLOP *** [4d 9d 2s]
PokerStarsMan12: checks 
MaFak2019: bets 500
PokerStarsMan12: folds 
Uncalled bet (500) returned to MaFak2019
MaFak2019 collected 189 from pot
MaFak2019: doesn't show hand 
*** SUMMARY ***
Total pot 200 | Rake 11 
Board [4d 9d 2s]
Seat 1: color_singleton folded before Flop (didn't bet)
Seat 4: Klemtonius (button) folded before Flop (didn't bet)
Seat 5: PokerStarsMan12 (small blind) folded on the Flop
Seat 8: MaFak2019 (big blind) collected (189)



PokerStars Home Game Hand #226732076868: {DaPokaStars}  Hold'em No Limit (50/100) - 2021/05/13 18:52:29 ET
Table 'again and again' 9-max (Play Money) Seat #5 is the button
Seat 1: color_singleton (9799 in chips) 
Seat 4: Klemtonius (51077 in chips) 
Seat 5: PokerStarsMan12 (21151 in chips) 
Seat 8: MaFak2019 (24050 in chips) 
MaFak2019: posts small blind 50
color_singleton: posts big blind 100
*** HOLE CARDS ***
Dealt to PokerStarsMan12 [As Jd]
Klemtonius: calls 100
PokerStarsMan12: raises 300 to 400
MaFak2019: folds 
color_singleton: calls 300
Klemtonius: calls 300
*** FLOP *** [5c Js Kc]
color_singleton: checks 
Klemtonius: checks 
PokerStarsMan12: bets 750
color_singleton: folds 
Klemtonius: folds 
Uncalled bet (750) returned to PokerStarsMan12
PokerStarsMan12 collected 1181 from pot
*** SUMMARY ***
Total pot 1250 | Rake 69 
Board [5c Js Kc]
Seat 1: color_singleton (big blind) folded on the Flop
Seat 4: Klemtonius folded on the Flop
Seat 5: PokerStarsMan12 (button) collected (1181)
Seat 8: MaFak2019 (small blind) folded before Flop



PokerStars Home Game Hand #226732087200: {DaPokaStars}  Hold'em No Limit (50/100) - 2021/05/13 18:52:55 ET
Table 'again and again' 9-max (Play Money) Seat #8 is the button
Seat 1: color_singleton (9399 in chips) 
Seat 4: Klemtonius (50677 in chips) 
Seat 5: PokerStarsMan12 (21932 in chips) 
Seat 8: MaFak2019 (24000 in chips) 
color_singleton: posts small blind 50
Klemtonius: posts big blind 100
*** HOLE CARDS ***
Dealt to PokerStarsMan12 [Qs 2s]
PokerStarsMan12: folds 
MaFak2019: raises 200 to 300
color_singleton: calls 250
Klemtonius: calls 200
*** FLOP *** [8d Kd 7d]
color_singleton: checks 
Klemtonius: bets 850
MaFak2019: folds 
color_singleton: folds 
Uncalled bet (850) returned to Klemtonius
Klemtonius collected 850 from pot
Klemtonius: doesn't show hand 
*** SUMMARY ***
Total pot 900 | Rake 50 
Board [8d Kd 7d]
Seat 1: color_singleton (small blind) folded on the Flop
Seat 4: Klemtonius (big blind) collected (850)
Seat 5: PokerStarsMan12 folded before Flop (didn't bet)
Seat 8: MaFak2019 (button) folded on the Flop



PokerStars Home Game Hand #226732103350: {DaPokaStars}  Hold'em No Limit (50/100) - 2021/05/13 18:53:16 ET
Table 'again and again' 9-max (Play Money) Seat #1 is the button
Seat 1: color_singleton (9099 in chips) 
Seat 4: Klemtonius (51227 in chips) 
Seat 5: PokerStarsMan12 (21932 in chips) 
Seat 8: MaFak2019 (23700 in chips) 
Klemtonius: posts small blind 50
PokerStarsMan12: posts big blind 100
*** HOLE CARDS ***
Dealt to PokerStarsMan12 [4d 3c]
MaFak2019: calls 100
color_singleton: raises 200 to 300
Klemtonius: calls 250
PokerStarsMan12: calls 200
MaFak2019: calls 200
*** FLOP *** [Qh Ad 3s]
Klemtonius: checks 
PokerStarsMan12: checks 
MaFak2019: checks 
color_singleton: checks 
*** TURN *** [Qh Ad 3s] [8h]
Klemtonius: bets 1134
PokerStarsMan12: folds 
MaFak2019: folds 
color_singleton: folds 
Uncalled bet (1134) returned to Klemtonius
Klemtonius collected 1134 from pot
Klemtonius: doesn't show hand 
*** SUMMARY ***
Total pot 1200 | Rake 66 
Board [Qh Ad 3s 8h]
Seat 1: color_singleton (button) folded on the Turn
Seat 4: Klemtonius (small blind) collected (1134)
Seat 5: PokerStarsMan12 (big blind) folded on the Turn
Seat 8: MaFak2019 folded on the Turn



PokerStars Home Game Hand #226732117189: {DaPokaStars}  Hold'em No Limit (50/100) - 2021/05/13 18:53:50 ET
Table 'again and again' 9-max (Play Money) Seat #4 is the button
Seat 1: color_singleton (8799 in chips) 
Seat 4: Klemtonius (52061 in chips) 
Seat 5: PokerStarsMan12 (21632 in chips) 
Seat 8: MaFak2019 (23400 in chips) 
PokerStarsMan12: posts small blind 50
MaFak2019: posts big blind 100
*** HOLE CARDS ***
Dealt to PokerStarsMan12 [Ks 9d]
color_singleton: folds 
Klemtonius: raises 250 to 350
PokerStarsMan12: calls 300
MaFak2019: folds 
*** FLOP *** [8s 4h 9s]
PokerStarsMan12: bets 400
Klemtonius: raises 400 to 800
PokerStarsMan12: calls 400
*** TURN *** [8s 4h 9s] [Qs]
PokerStarsMan12: checks 
Klemtonius: bets 1134
PokerStarsMan12: calls 1134
*** RIVER *** [8s 4h 9s Qs] [6h]
PokerStarsMan12: checks 
Klemtonius: checks 
*** SHOW DOWN ***
PokerStarsMan12: shows [Ks 9d] (a pair of Nines)
Klemtonius: mucks hand 
PokerStarsMan12 collected 4411 from pot
*** SUMMARY ***
Total pot 4668 | Rake 257 
Board [8s 4h 9s Qs 6h]
Seat 1: color_singleton folded before Flop (didn't bet)
Seat 4: Klemtonius (button) mucked [Ah 8c]
Seat 5: PokerStarsMan12 (small blind) showed [Ks 9d] and won (4411) with a pair of Nines
Seat 8: MaFak2019 (big blind) folded before Flop



PokerStars Home Game Hand #226732129302: {DaPokaStars}  Hold'em No Limit (50/100) - 2021/05/13 18:54:22 ET
Table 'again and again' 9-max (Play Money) Seat #5 is the button
Seat 1: color_singleton (8799 in chips) 
Seat 4: Klemtonius (49777 in chips) 
Seat 5: PokerStarsMan12 (23759 in chips) 
Seat 8: MaFak2019 (23300 in chips) 
MaFak2019: posts small blind 50
color_singleton: posts big blind 100
*** HOLE CARDS ***
Dealt to PokerStarsMan12 [Qs Qd]
Klemtonius: folds 
PokerStarsMan12: raises 300 to 400
MaFak2019: folds 
color_singleton: raises 300 to 700
PokerStarsMan12: calls 300
*** FLOP *** [9h 3s 5c]
color_singleton: bets 1370
PokerStarsMan12: calls 1370
*** TURN *** [9h 3s 5c] [2s]
color_singleton: bets 1980
PokerStarsMan12: raises 2620 to 4600
color_singleton: folds 
Uncalled bet (2620) returned to PokerStarsMan12
PokerStarsMan12 collected 7702 from pot
*** SUMMARY ***
Total pot 8150 | Rake 448 
Board [9h 3s 5c 2s]
Seat 1: color_singleton (big blind) folded on the Turn
Seat 4: Klemtonius folded before Flop (didn't bet)
Seat 5: PokerStarsMan12 (button) collected (7702)
Seat 8: MaFak2019 (small blind) folded before Flop



PokerStars Home Game Hand #226732165596: {DaPokaStars}  Hold'em No Limit (50/100) - 2021/05/13 18:55:45 ET
Table 'again and again' 9-max (Play Money) Seat #8 is the button
Seat 1: color_singleton (4749 in chips) 
Seat 4: Klemtonius (49777 in chips) 
Seat 5: PokerStarsMan12 (27411 in chips) 
Seat 8: MaFak2019 (23250 in chips) 
color_singleton: posts small blind 50
Klemtonius: posts big blind 100
*** HOLE CARDS ***
Dealt to PokerStarsMan12 [As Kd]
PokerStarsMan12: raises 300 to 400
MaFak2019: calls 400
color_singleton: folds 
Klemtonius: calls 300
*** FLOP *** [Jh 2d Td]
Klemtonius: bets 1181
PokerStarsMan12: folds 
MaFak2019: folds 
Uncalled bet (1181) returned to Klemtonius
Klemtonius collected 1181 from pot
Klemtonius: doesn't show hand 
*** SUMMARY ***
Total pot 1250 | Rake 69 
Board [Jh 2d Td]
Seat 1: color_singleton (small blind) folded before Flop
Seat 4: Klemtonius (big blind) collected (1181)
Seat 5: PokerStarsMan12 folded on the Flop
Seat 8: MaFak2019 (button) folded on the Flop



PokerStars Home Game Hand #226732174698: {DaPokaStars}  Hold'em No Limit (50/100) - 2021/05/13 18:56:15 ET
Table 'again and again' 9-max (Play Money) Seat #1 is the button
Seat 1: color_singleton (4699 in chips) 
Seat 4: Klemtonius (50558 in chips) 
Seat 5: PokerStarsMan12 (27011 in chips) 
Seat 8: MaFak2019 (22850 in chips) 
Klemtonius: posts small blind 50
PokerStarsMan12: posts big blind 100
*** HOLE CARDS ***
Dealt to PokerStarsMan12 [5c Ts]
MaFak2019: raises 250 to 350
color_singleton: calls 350
Klemtonius: folds 
PokerStarsMan12: folds 
*** FLOP *** [9h 9d 5s]
MaFak2019: checks 
color_singleton: checks 
*** TURN *** [9h 9d 5s] [8s]
MaFak2019: checks 
color_singleton: checks 
*** RIVER *** [9h 9d 5s 8s] [2d]
MaFak2019: checks 
color_singleton: checks 
*** SHOW DOWN ***
MaFak2019: shows [Qs Js] (a pair of Nines)
color_singleton: shows [4d Ah] (a pair of Nines - Ace kicker)
color_singleton collected 803 from pot
*** SUMMARY ***
Total pot 850 | Rake 47 
Board [9h 9d 5s 8s 2d]
Seat 1: color_singleton (button) showed [4d Ah] and won (803) with a pair of Nines
Seat 4: Klemtonius (small blind) folded before Flop
Seat 5: PokerStarsMan12 (big blind) folded before Flop
Seat 8: MaFak2019 showed [Qs Js] and lost with a pair of Nines



PokerStars Home Game Hand #226732184847: {DaPokaStars}  Hold'em No Limit (50/100) - 2021/05/13 18:56:48 ET
Table 'again and again' 9-max (Play Money) Seat #4 is the button
Seat 1: color_singleton (5152 in chips) 
Seat 4: Klemtonius (50508 in chips) 
Seat 5: PokerStarsMan12 (26911 in chips) 
Seat 8: MaFak2019 (22500 in chips) 
PokerStarsMan12: posts small blind 50
MaFak2019: posts big blind 100
*** HOLE CARDS ***
Dealt to PokerStarsMan12 [8c 8h]
color_singleton: raises 200 to 300
Klemtonius: raises 200 to 500
PokerStarsMan12: calls 450
MaFak2019: folds 
color_singleton: calls 200
*** FLOP *** [7s 2s Qc]
PokerStarsMan12: bets 800
color_singleton: raises 1100 to 1900
Klemtonius: folds 
PokerStarsMan12: folds 
Uncalled bet (1100) returned to color_singleton
color_singleton collected 3024 from pot
color_singleton: doesn't show hand 
*** SUMMARY ***
Total pot 3200 | Rake 176 
Board [7s 2s Qc]
Seat 1: color_singleton collected (3024)
Seat 4: Klemtonius (button) folded on the Flop
Seat 5: PokerStarsMan12 (small blind) folded on the Flop
Seat 8: MaFak2019 (big blind) folded before Flop



PokerStars Home Game Hand #226732194520: {DaPokaStars}  Hold'em No Limit (50/100) - 2021/05/13 18:57:20 ET
Table 'again and again' 9-max (Play Money) Seat #5 is the button
Seat 1: color_singleton (6876 in chips) 
Seat 4: Klemtonius (50008 in chips) 
Seat 5: PokerStarsMan12 (25611 in chips) 
Seat 8: MaFak2019 (22400 in chips) 
MaFak2019: posts small blind 50
color_singleton: posts big blind 100
*** HOLE CARDS ***
Dealt to PokerStarsMan12 [Qh 6d]
Klemtonius: calls 100
MrOB1reader joins the table at seat #2 
PokerStarsMan12: folds 
MaFak2019: raises 100 to 200
color_singleton: calls 100
Klemtonius: calls 100
*** FLOP *** [Jd 8c 3s]
MaFak2019: checks 
color_singleton: checks 
Klemtonius: checks 
*** TURN *** [Jd 8c 3s] [9c]
MaFak2019: checks 
color_singleton: checks 
Klemtonius: bets 283
MaFak2019: folds 
color_singleton: folds 
Uncalled bet (283) returned to Klemtonius
Klemtonius collected 567 from pot
Klemtonius: doesn't show hand 
*** SUMMARY ***
Total pot 600 | Rake 33 
Board [Jd 8c 3s 9c]
Seat 1: color_singleton (big blind) folded on the Turn
Seat 4: Klemtonius collected (567)
Seat 5: PokerStarsMan12 (button) folded before Flop (didn't bet)
Seat 8: MaFak2019 (small blind) folded on the Turn



PokerStars Home Game Hand #226732203252: {DaPokaStars}  Hold'em No Limit (50/100) - 2021/05/13 18:57:48 ET
Table 'again and again' 9-max (Play Money) Seat #8 is the button
Seat 1: color_singleton (6676 in chips) 
Seat 2: MrOB1reader (10000 in chips) 
Seat 4: Klemtonius (50375 in chips) 
Seat 5: PokerStarsMan12 (25611 in chips) 
Seat 8: MaFak2019 (22200 in chips) 
color_singleton: posts small blind 50
MrOB1reader: posts big blind 100
*** HOLE CARDS ***
Dealt to PokerStarsMan12 [4c 5c]
Klemtonius: calls 100
PokerStarsMan12: raises 200 to 300
MaFak2019: raises 200 to 500
color_singleton: folds 
MrOB1reader: folds 
Klemtonius: calls 400
PokerStarsMan12: calls 200
*** FLOP *** [5d 9h 4d]
Klemtonius: checks 
PokerStarsMan12: bets 900
MaFak2019: calls 900
Klemtonius: folds 
*** TURN *** [5d 9h 4d] [Ad]
PokerStarsMan12: checks 
MaFak2019: checks 
*** RIVER *** [5d 9h 4d Ad] [9d]
PokerStarsMan12: bets 1900
MaFak2019: calls 1900
*** SHOW DOWN ***
PokerStarsMan12: shows [4c 5c] (two pair, Nines and Fives)
MaFak2019: shows [Ts 9s] (three of a kind, Nines)
MaFak2019 collected 6851 from pot
*** SUMMARY ***
Total pot 7250 | Rake 399 
Board [5d 9h 4d Ad 9d]
Seat 1: color_singleton (small blind) folded before Flop
Seat 2: MrOB1reader (big blind) folded before Flop
Seat 4: Klemtonius folded on the Flop
Seat 5: PokerStarsMan12 showed [4c 5c] and lost with two pair, Nines and Fives
Seat 8: MaFak2019 (button) showed [Ts 9s] and won (6851) with three of a kind, Nines



PokerStars Home Game Hand #226732216007: {DaPokaStars}  Hold'em No Limit (50/100) - 2021/05/13 18:58:30 ET
Table 'again and again' 9-max (Play Money) Seat #1 is the button
Seat 1: color_singleton (6626 in chips) 
Seat 2: MrOB1reader (9900 in chips) 
Seat 4: Klemtonius (49875 in chips) 
Seat 5: PokerStarsMan12 (22311 in chips) 
Seat 8: MaFak2019 (25751 in chips) 
MrOB1reader: posts small blind 50
Klemtonius: posts big blind 100
*** HOLE CARDS ***
Dealt to PokerStarsMan12 [6h 9d]
PokerStarsMan12: raises 200 to 300
MaFak2019: calls 300
color_singleton: calls 300
MrOB1reader: folds 
Klemtonius: raises 1250 to 1550
PokerStarsMan12: folds 
MaFak2019: calls 1250
color_singleton: calls 1250
*** FLOP *** [Kd Kc 5c]
Klemtonius: checks 
MaFak2019: checks 
color_singleton: checks 
*** TURN *** [Kd Kc 5c] [5d]
Klemtonius: checks 
MaFak2019: checks 
color_singleton: bets 4725
Klemtonius: calls 4725
MaFak2019: folds 
*** RIVER *** [Kd Kc 5c 5d] [Jh]
Klemtonius: bets 400
color_singleton: calls 351 and is all-in
Uncalled bet (49) returned to Klemtonius
*** SHOW DOWN ***
Klemtonius: shows [Ks Kh] (four of a kind, Kings)
color_singleton: shows [Ac Th] (two pair, Kings and Fives)
Klemtonius collected 14319 from pot
*** SUMMARY ***
Total pot 15152 | Rake 833 
Board [Kd Kc 5c 5d Jh]
Seat 1: color_singleton (button) showed [Ac Th] and lost with two pair, Kings and Fives
Seat 2: MrOB1reader (small blind) folded before Flop
Seat 4: Klemtonius (big blind) showed [Ks Kh] and won (14319) with four of a kind, Kings
Seat 5: PokerStarsMan12 folded before Flop
Seat 8: MaFak2019 folded on the Turn



PokerStars Home Game Hand #226732236810: {DaPokaStars}  Hold'em No Limit (50/100) - 2021/05/13 18:59:37 ET
Table 'again and again' 9-max (Play Money) Seat #2 is the button
Seat 2: MrOB1reader (9850 in chips) 
Seat 4: Klemtonius (57568 in chips) 
Seat 5: PokerStarsMan12 (22011 in chips) 
Seat 8: MaFak2019 (24201 in chips) 
Klemtonius: posts small blind 50
PokerStarsMan12: posts big blind 100
*** HOLE CARDS ***
Dealt to PokerStarsMan12 [Ks 4c]
MaFak2019: calls 100
MrOB1reader: calls 100
Klemtonius: calls 50
PokerStarsMan12: checks 
*** FLOP *** [3d Ah 5h]
Klemtonius: checks 
PokerStarsMan12: checks 
MaFak2019: checks 
MrOB1reader: checks 
*** TURN *** [3d Ah 5h] [3h]
Klemtonius: checks 
PokerStarsMan12: checks 
MaFak2019: checks 
MrOB1reader: checks 
*** RIVER *** [3d Ah 5h 3h] [Jd]
Klemtonius: bets 189
PokerStarsMan12: folds 
MaFak2019: calls 189
MrOB1reader: folds 
*** SHOW DOWN ***
Klemtonius: shows [Qh 4d] (a pair of Threes)
MaFak2019: shows [Qs 6s] (a pair of Threes)
Klemtonius collected 368 from pot
MaFak2019 collected 367 from pot
*** SUMMARY ***
Total pot 778 | Rake 43 
Board [3d Ah 5h 3h Jd]
Seat 2: MrOB1reader (button) folded on the River
Seat 4: Klemtonius (small blind) showed [Qh 4d] and won (368) with a pair of Threes
Seat 5: PokerStarsMan12 (big blind) folded on the River
Seat 8: MaFak2019 showed [Qs 6s] and won (367) with a pair of Threes



PokerStars Home Game Hand #226732255146: {DaPokaStars}  Hold'em No Limit (50/100) - 2021/05/13 19:00:35 ET
Table 'again and again' 9-max (Play Money) Seat #4 is the button
Seat 1: color_singleton (10000 in chips) 
Seat 2: MrOB1reader (9750 in chips) 
Seat 4: Klemtonius (57647 in chips) 
Seat 5: PokerStarsMan12 (21911 in chips) 
Seat 8: MaFak2019 (24279 in chips) 
PokerStarsMan12: posts small blind 50
MaFak2019: posts big blind 100
*** HOLE CARDS ***
Dealt to PokerStarsMan12 [4s Jc]
color_singleton: raises 100 to 200
MrOB1reader: folds 
Klemtonius: calls 200
PokerStarsMan12: folds 
MaFak2019: calls 100
*** FLOP *** [As 9s 9h]
MaFak2019: checks 
color_singleton: bets 200
Klemtonius: raises 200 to 400
MaFak2019: folds 
color_singleton: calls 200
*** TURN *** [As 9s 9h] [2d]
color_singleton: checks 
Klemtonius: bets 685
color_singleton: folds 
Uncalled bet (685) returned to Klemtonius
Klemtonius collected 1370 from pot
Klemtonius: doesn't show hand 
*** SUMMARY ***
Total pot 1450 | Rake 80 
Board [As 9s 9h 2d]
Seat 1: color_singleton folded on the Turn
Seat 2: MrOB1reader folded before Flop (didn't bet)
Seat 4: Klemtonius (button) collected (1370)
Seat 5: PokerStarsMan12 (small blind) folded before Flop
Seat 8: MaFak2019 (big blind) folded on the Flop



PokerStars Home Game Hand #226732272814: {DaPokaStars}  Hold'em No Limit (50/100) - 2021/05/13 19:01:25 ET
Table 'again and again' 9-max (Play Money) Seat #5 is the button
Seat 1: color_singleton (9400 in chips) 
Seat 2: MrOB1reader (9750 in chips) 
Seat 4: Klemtonius (58417 in chips) 
Seat 5: PokerStarsMan12 (21861 in chips) 
Seat 8: MaFak2019 (24079 in chips) 
MaFak2019: posts small blind 50
color_singleton: posts big blind 100
*** HOLE CARDS ***
Dealt to PokerStarsMan12 [Jh Qh]
MrOB1reader: folds 
Klemtonius: folds 
PokerStarsMan12: raises 200 to 300
MaFak2019: raises 200 to 500
color_singleton: folds 
PokerStarsMan12: calls 200
*** FLOP *** [7h Qd 3c]
MaFak2019: checks 
PokerStarsMan12: bets 700
MaFak2019: calls 700
*** TURN *** [7h Qd 3c] [2d]
MaFak2019: checks 
PokerStarsMan12: bets 1300
MaFak2019: folds 
Uncalled bet (1300) returned to PokerStarsMan12
PokerStarsMan12 collected 2362 from pot
*** SUMMARY ***
Total pot 2500 | Rake 138 
Board [7h Qd 3c 2d]
Seat 1: color_singleton (big blind) folded before Flop
Seat 2: MrOB1reader folded before Flop (didn't bet)
Seat 4: Klemtonius folded before Flop (didn't bet)
Seat 5: PokerStarsMan12 (button) collected (2362)
Seat 8: MaFak2019 (small blind) folded on the Turn



PokerStars Home Game Hand #226732289884: {DaPokaStars}  Hold'em No Limit (50/100) - 2021/05/13 19:02:10 ET
Table 'again and again' 9-max (Play Money) Seat #8 is the button
Seat 1: color_singleton (9300 in chips) 
Seat 2: MrOB1reader (9750 in chips) 
Seat 4: Klemtonius (58417 in chips) 
Seat 5: PokerStarsMan12 (23023 in chips) 
Seat 8: MaFak2019 (22879 in chips) 
color_singleton: posts small blind 50
MrOB1reader: posts big blind 100
*** HOLE CARDS ***
Dealt to PokerStarsMan12 [9c 7h]
Klemtonius: folds 
PokerStarsMan12: folds 
MaFak2019: calls 100
color_singleton: raises 200 to 300
MrOB1reader: folds 
MaFak2019: calls 200
*** FLOP *** [4h Qh 9d]
color_singleton: checks 
MaFak2019: checks 
*** TURN *** [4h Qh 9d] [7s]
color_singleton: bets 661
MaFak2019: folds 
Uncalled bet (661) returned to color_singleton
color_singleton collected 661 from pot
color_singleton: doesn't show hand 
*** SUMMARY ***
Total pot 700 | Rake 39 
Board [4h Qh 9d 7s]
Seat 1: color_singleton (small blind) collected (661)
Seat 2: MrOB1reader (big blind) folded before Flop
Seat 4: Klemtonius folded before Flop (didn't bet)
Seat 5: PokerStarsMan12 folded before Flop (didn't bet)
Seat 8: MaFak2019 (button) folded on the Turn



PokerStars Home Game Hand #226732299691: {DaPokaStars}  Hold'em No Limit (50/100) - 2021/05/13 19:02:37 ET
Table 'again and again' 9-max (Play Money) Seat #1 is the button
Seat 1: color_singleton (9661 in chips) 
Seat 2: MrOB1reader (9650 in chips) 
Seat 4: Klemtonius (58417 in chips) 
Seat 5: PokerStarsMan12 (23023 in chips) 
Seat 8: MaFak2019 (22579 in chips) 
MrOB1reader: posts small blind 50
Klemtonius: posts big blind 100
*** HOLE CARDS ***
Dealt to PokerStarsMan12 [8s 6s]
PokerStarsMan12: calls 100
MaFak2019: raises 350 to 450
color_singleton: folds 
MrOB1reader: folds 
Klemtonius: calls 350
PokerStarsMan12: folds 
*** FLOP *** [8h 3h Qc]
Klemtonius: checks 
MaFak2019: bets 992
Klemtonius: folds 
Uncalled bet (992) returned to MaFak2019
MaFak2019 collected 992 from pot
MaFak2019: doesn't show hand 
*** SUMMARY ***
Total pot 1050 | Rake 58 
Board [8h 3h Qc]
Seat 1: color_singleton (button) folded before Flop (didn't bet)
Seat 2: MrOB1reader (small blind) folded before Flop
Seat 4: Klemtonius (big blind) folded on the Flop
Seat 5: PokerStarsMan12 folded before Flop
Seat 8: MaFak2019 collected (992)



PokerStars Home Game Hand #226732310902: {DaPokaStars}  Hold'em No Limit (50/100) - 2021/05/13 19:03:06 ET
Table 'again and again' 9-max (Play Money) Seat #2 is the button
Seat 1: color_singleton (9661 in chips) 
Seat 2: MrOB1reader (9600 in chips) 
Seat 4: Klemtonius (57967 in chips) 
Seat 5: PokerStarsMan12 (22923 in chips) 
Seat 8: MaFak2019 (23121 in chips) 
Klemtonius: posts small blind 50
PokerStarsMan12: posts big blind 100
*** HOLE CARDS ***
Dealt to PokerStarsMan12 [Qs 5d]
MaFak2019: folds 
color_singleton: raises 100 to 200
MrOB1reader: calls 200
Klemtonius: calls 150
PokerStarsMan12: calls 100
*** FLOP *** [Ad 7d 6d]
Klemtonius: bets 756
PokerStarsMan12: folds 
color_singleton: calls 756
MrOB1reader: calls 756
*** TURN *** [Ad 7d 6d] [7c]
Klemtonius: checks 
color_singleton: checks 
MrOB1reader: bets 1449
Klemtonius: calls 1449
color_singleton: folds 
*** RIVER *** [Ad 7d 6d 7c] [6c]
Klemtonius: checks 
MrOB1reader: bets 2819
Klemtonius: folds 
Uncalled bet (2819) returned to MrOB1reader
MrOB1reader collected 5638 from pot
*** SUMMARY ***
Total pot 5966 | Rake 328 
Board [Ad 7d 6d 7c 6c]
Seat 1: color_singleton folded on the Turn
Seat 2: MrOB1reader (button) collected (5638)
Seat 4: Klemtonius (small blind) folded on the River
Seat 5: PokerStarsMan12 (big blind) folded on the Flop
Seat 8: MaFak2019 folded before Flop (didn't bet)



PokerStars Home Game Hand #226732331714: {DaPokaStars}  Hold'em No Limit (50/100) - 2021/05/13 19:04:01 ET
Table 'again and again' 9-max (Play Money) Seat #4 is the button
Seat 1: color_singleton (8705 in chips) 
Seat 2: MrOB1reader (12833 in chips) 
Seat 4: Klemtonius (55562 in chips) 
Seat 5: PokerStarsMan12 (22723 in chips) 
Seat 8: MaFak2019 (23121 in chips) 
PokerStarsMan12: posts small blind 50
MaFak2019: posts big blind 100
*** HOLE CARDS ***
Dealt to PokerStarsMan12 [3c 2s]
color_singleton: folds 
MrOB1reader: folds 
Klemtonius: raises 250 to 350
PokerStarsMan12: folds 
MaFak2019: calls 250
*** FLOP *** [Ah 7c 6c]
MaFak2019: checks 
Klemtonius: checks 
*** TURN *** [Ah 7c 6c] [9s]
MaFak2019: checks 
Klemtonius: checks 
*** RIVER *** [Ah 7c 6c 9s] [3h]
MaFak2019: checks 
Klemtonius: checks 
*** SHOW DOWN ***
MaFak2019: shows [Qs Td] (high card Ace)
Klemtonius: mucks hand 
MaFak2019 collected 709 from pot
*** SUMMARY ***
Total pot 750 | Rake 41 
Board [Ah 7c 6c 9s 3h]
Seat 1: color_singleton folded before Flop (didn't bet)
Seat 2: MrOB1reader folded before Flop (didn't bet)
Seat 4: Klemtonius (button) mucked [4h 2h]
Seat 5: PokerStarsMan12 (small blind) folded before Flop
Seat 8: MaFak2019 (big blind) showed [Qs Td] and won (709) with high card Ace



PokerStars Home Game Hand #226732342854: {DaPokaStars}  Hold'em No Limit (50/100) - 2021/05/13 19:04:31 ET
Table 'again and again' 9-max (Play Money) Seat #5 is the button
Seat 1: color_singleton (8705 in chips) 
Seat 2: MrOB1reader (12833 in chips) 
Seat 4: Klemtonius (55212 in chips) 
Seat 5: PokerStarsMan12 (22673 in chips) 
Seat 8: MaFak2019 (23480 in chips) 
MaFak2019: posts small blind 50
color_singleton: posts big blind 100
*** HOLE CARDS ***
Dealt to PokerStarsMan12 [Kh 9h]
MrOB1reader: calls 100
Klemtonius: raises 350 to 450
PokerStarsMan12: calls 450
MaFak2019: folds 
color_singleton: calls 350
MrOB1reader: calls 350
*** FLOP *** [Tc 7s 8h]
color_singleton: checks 
MrOB1reader: checks 
Klemtonius: bets 1748
PokerStarsMan12: calls 1748
color_singleton: calls 1748
MrOB1reader: folds 
*** TURN *** [Tc 7s 8h] [Ac]
color_singleton: bets 6507 and is all-in
Klemtonius: folds 
PokerStarsMan12: folds 
Uncalled bet (6507) returned to color_singleton
color_singleton collected 6704 from pot
color_singleton: doesn't show hand 
*** SUMMARY ***
Total pot 7094 | Rake 390 
Board [Tc 7s 8h Ac]
Seat 1: color_singleton (big blind) collected (6704)
Seat 2: MrOB1reader folded on the Flop
Seat 4: Klemtonius folded on the Turn
Seat 5: PokerStarsMan12 (button) folded on the Turn
Seat 8: MaFak2019 (small blind) folded before Flop



PokerStars Home Game Hand #226732361333: {DaPokaStars}  Hold'em No Limit (50/100) - 2021/05/13 19:05:19 ET
Table 'again and again' 9-max (Play Money) Seat #8 is the button
Seat 1: color_singleton (13211 in chips) 
Seat 2: MrOB1reader (12383 in chips) 
Seat 4: Klemtonius (53014 in chips) 
Seat 5: PokerStarsMan12 (20475 in chips) 
Seat 8: MaFak2019 (23430 in chips) 
color_singleton: posts small blind 50
MrOB1reader: posts big blind 100
*** HOLE CARDS ***
Dealt to PokerStarsMan12 [Qc Tc]
Klemtonius: folds 
PokerStarsMan12: raises 200 to 300
MaFak2019: calls 300
color_singleton: calls 250
MrOB1reader: folds 
*** FLOP *** [9c Jc 6h]
color_singleton: bets 945
PokerStarsMan12: calls 945
MaFak2019: calls 945
*** TURN *** [9c Jc 6h] [Ad]
color_singleton: checks 
PokerStarsMan12: bets 2000
MaFak2019: folds 
color_singleton: folds 
Uncalled bet (2000) returned to PokerStarsMan12
PokerStarsMan12 collected 3624 from pot
*** SUMMARY ***
Total pot 3835 | Rake 211 
Board [9c Jc 6h Ad]
Seat 1: color_singleton (small blind) folded on the Turn
Seat 2: MrOB1reader (big blind) folded before Flop
Seat 4: Klemtonius folded before Flop (didn't bet)
Seat 5: PokerStarsMan12 collected (3624)
Seat 8: MaFak2019 (button) folded on the Turn



PokerStars Home Game Hand #226732372518: {DaPokaStars}  Hold'em No Limit (50/100) - 2021/05/13 19:05:49 ET
Table 'again and again' 9-max (Play Money) Seat #1 is the button
Seat 1: color_singleton (11966 in chips) 
Seat 2: MrOB1reader (12283 in chips) 
Seat 4: Klemtonius (53014 in chips) 
Seat 5: PokerStarsMan12 (22854 in chips) 
Seat 8: MaFak2019 (22185 in chips) 
MrOB1reader: posts small blind 50
Klemtonius: posts big blind 100
*** HOLE CARDS ***
Dealt to PokerStarsMan12 [4s 9s]
PokerStarsMan12: folds 
MaFak2019: folds 
color_singleton: raises 200 to 300
MrOB1reader: folds 
Klemtonius: folds 
Uncalled bet (200) returned to color_singleton
color_singleton collected 250 from pot
color_singleton: doesn't show hand 
*** SUMMARY ***
Total pot 250 | Rake 0 
Seat 1: color_singleton (button) collected (250)
Seat 2: MrOB1reader (small blind) folded before Flop
Seat 4: Klemtonius (big blind) folded before Flop
Seat 5: PokerStarsMan12 folded before Flop (didn't bet)
Seat 8: MaFak2019 folded before Flop (didn't bet)



PokerStars Home Game Hand #226732377436: {DaPokaStars}  Hold'em No Limit (50/100) - 2021/05/13 19:06:02 ET
Table 'again and again' 9-max (Play Money) Seat #2 is the button
Seat 1: color_singleton (12116 in chips) 
Seat 2: MrOB1reader (12233 in chips) 
Seat 4: Klemtonius (52914 in chips) 
Seat 5: PokerStarsMan12 (22854 in chips) 
Seat 8: MaFak2019 (22185 in chips) 
Klemtonius: posts small blind 50
PokerStarsMan12: posts big blind 100
*** HOLE CARDS ***
Dealt to PokerStarsMan12 [Qd 7c]
MaFak2019: folds 
color_singleton: raises 200 to 300
MrOB1reader: calls 300
Klemtonius: calls 250
PokerStarsMan12: folds 
*** FLOP *** [9s 8s Kc]
Klemtonius: checks 
color_singleton: bets 945
MrOB1reader: folds 
Klemtonius: folds 
Uncalled bet (945) returned to color_singleton
color_singleton collected 945 from pot
color_singleton: doesn't show hand 
*** SUMMARY ***
Total pot 1000 | Rake 55 
Board [9s 8s Kc]
Seat 1: color_singleton collected (945)
Seat 2: MrOB1reader (button) folded on the Flop
Seat 4: Klemtonius (small blind) folded on the Flop
Seat 5: PokerStarsMan12 (big blind) folded before Flop
Seat 8: MaFak2019 folded before Flop (didn't bet)



PokerStars Home Game Hand #226732385146: {DaPokaStars}  Hold'em No Limit (50/100) - 2021/05/13 19:06:22 ET
Table 'again and again' 9-max (Play Money) Seat #4 is the button
Seat 1: color_singleton (12761 in chips) 
Seat 2: MrOB1reader (11933 in chips) 
Seat 4: Klemtonius (52614 in chips) 
Seat 5: PokerStarsMan12 (22754 in chips) 
Seat 8: MaFak2019 (22185 in chips) 
PokerStarsMan12: posts small blind 50
MaFak2019: posts big blind 100
*** HOLE CARDS ***
Dealt to PokerStarsMan12 [2s Qc]
color_singleton: folds 
MrOB1reader: calls 100
Klemtonius: calls 100
PokerStarsMan12: calls 50
MaFak2019: raises 400 to 500
MrOB1reader: folds 
Klemtonius: calls 400
PokerStarsMan12: folds 
*** FLOP *** [Ah 3d 7h]
MaFak2019: bets 1134
Klemtonius: folds 
Uncalled bet (1134) returned to MaFak2019
MaFak2019 collected 1134 from pot
MaFak2019: doesn't show hand 
*** SUMMARY ***
Total pot 1200 | Rake 66 
Board [Ah 3d 7h]
Seat 1: color_singleton folded before Flop (didn't bet)
Seat 2: MrOB1reader folded before Flop
Seat 4: Klemtonius (button) folded on the Flop
Seat 5: PokerStarsMan12 (small blind) folded before Flop
Seat 8: MaFak2019 (big blind) collected (1134)



PokerStars Home Game Hand #226732393770: {DaPokaStars}  Hold'em No Limit (50/100) - 2021/05/13 19:06:45 ET
Table 'again and again' 9-max (Play Money) Seat #5 is the button
Seat 1: color_singleton (12761 in chips) 
Seat 2: MrOB1reader (11833 in chips) 
Seat 4: Klemtonius (52114 in chips) 
Seat 5: PokerStarsMan12 (22654 in chips) 
Seat 8: MaFak2019 (22819 in chips) 
MaFak2019: posts small blind 50
color_singleton: posts big blind 100
*** HOLE CARDS ***
Dealt to PokerStarsMan12 [6d Qd]
MrOB1reader: folds 
Klemtonius: calls 100
PokerStarsMan12: calls 100
MaFak2019: raises 400 to 500
color_singleton: folds 
Klemtonius: raises 400 to 900
PokerStarsMan12: folds 
MaFak2019: calls 400
*** FLOP *** [Qh 5s 7d]
MaFak2019: bets 1890
Klemtonius: calls 1890
*** TURN *** [Qh 5s 7d] [5d]
MaFak2019: bets 2731
Klemtonius: folds 
Uncalled bet (2731) returned to MaFak2019
MaFak2019 collected 5462 from pot
MaFak2019: doesn't show hand 
*** SUMMARY ***
Total pot 5780 | Rake 318 
Board [Qh 5s 7d 5d]
Seat 1: color_singleton (big blind) folded before Flop
Seat 2: MrOB1reader folded before Flop (didn't bet)
Seat 4: Klemtonius folded on the Turn
Seat 5: PokerStarsMan12 (button) folded before Flop
Seat 8: MaFak2019 (small blind) collected (5462)



PokerStars Home Game Hand #226732407396: {DaPokaStars}  Hold'em No Limit (50/100) - 2021/05/13 19:07:22 ET
Table 'again and again' 9-max (Play Money) Seat #8 is the button
Seat 1: color_singleton (12661 in chips) 
Seat 2: MrOB1reader (11833 in chips) 
Seat 4: Klemtonius (49324 in chips) 
Seat 5: PokerStarsMan12 (22554 in chips) 
Seat 8: MaFak2019 (25491 in chips) 
color_singleton: posts small blind 50
MrOB1reader: posts big blind 100
*** HOLE CARDS ***
Dealt to PokerStarsMan12 [7h Ts]
Klemtonius: calls 100
PokerStarsMan12: folds 
MaFak2019: raises 350 to 450
color_singleton: folds 
MrOB1reader: folds 
Klemtonius: calls 350
*** FLOP *** [8s 7c 3s]
Klemtonius: checks 
MaFak2019: checks 
*** TURN *** [8s 7c 3s] [5s]
Klemtonius: bets 992
MaFak2019: folds 
Uncalled bet (992) returned to Klemtonius
Klemtonius collected 992 from pot
Klemtonius: doesn't show hand 
*** SUMMARY ***
Total pot 1050 | Rake 58 
Board [8s 7c 3s 5s]
Seat 1: color_singleton (small blind) folded before Flop
Seat 2: MrOB1reader (big blind) folded before Flop
Seat 4: Klemtonius collected (992)
Seat 5: PokerStarsMan12 folded before Flop (didn't bet)
Seat 8: MaFak2019 (button) folded on the Turn



PokerStars Home Game Hand #226732418008: {DaPokaStars}  Hold'em No Limit (50/100) - 2021/05/13 19:07:50 ET
Table 'again and again' 9-max (Play Money) Seat #1 is the button
Seat 1: color_singleton (12611 in chips) 
Seat 2: MrOB1reader (11733 in chips) 
Seat 4: Klemtonius (49866 in chips) 
Seat 5: PokerStarsMan12 (22554 in chips) 
Seat 8: MaFak2019 (25041 in chips) 
MrOB1reader: posts small blind 50
Klemtonius: posts big blind 100
*** HOLE CARDS ***
Dealt to PokerStarsMan12 [7h Ts]
PokerStarsMan12: folds 
MaFak2019: calls 100
color_singleton: raises 200 to 300
MrOB1reader: calls 250
Klemtonius: calls 200
MaFak2019: calls 200
*** FLOP *** [2h Ks 4h]
MrOB1reader: checks 
Klemtonius: bets 1134
MaFak2019: folds 
color_singleton: raises 3402 to 4536
MrOB1reader: folds 
Klemtonius: folds 
Uncalled bet (3402) returned to color_singleton
color_singleton collected 3277 from pot
color_singleton: doesn't show hand 
*** SUMMARY ***
Total pot 3468 | Rake 191 
Board [2h Ks 4h]
Seat 1: color_singleton (button) collected (3277)
Seat 2: MrOB1reader (small blind) folded on the Flop
Seat 4: Klemtonius (big blind) folded on the Flop
Seat 5: PokerStarsMan12 folded before Flop (didn't bet)
Seat 8: MaFak2019 folded on the Flop



PokerStars Home Game Hand #226732430745: {DaPokaStars}  Hold'em No Limit (50/100) - 2021/05/13 19:08:24 ET
Table 'again and again' 9-max (Play Money) Seat #2 is the button
Seat 1: color_singleton (14454 in chips) 
Seat 2: MrOB1reader (11433 in chips) 
Seat 4: Klemtonius (48432 in chips) 
Seat 5: PokerStarsMan12 (22554 in chips) 
Seat 8: MaFak2019 (24741 in chips) 
Klemtonius: posts small blind 50
PokerStarsMan12: posts big blind 100
*** HOLE CARDS ***
Dealt to PokerStarsMan12 [9c Jc]
MaFak2019: raises 250 to 350
color_singleton: calls 350
MrOB1reader: folds 
Klemtonius: folds 
PokerStarsMan12: calls 250
*** FLOP *** [Js 8h 3s]
PokerStarsMan12 has timed out
PokerStarsMan12: checks 
MaFak2019: bets 1039
color_singleton: folds 
PokerStarsMan12: calls 1039
*** TURN *** [Js 8h 3s] [Qs]
PokerStarsMan12: checks 
MaFak2019: bets 3003
PokerStarsMan12: folds 
Uncalled bet (3003) returned to MaFak2019
MaFak2019 collected 3003 from pot
MaFak2019: doesn't show hand 
*** SUMMARY ***
Total pot 3178 | Rake 175 
Board [Js 8h 3s Qs]
Seat 1: color_singleton folded on the Flop
Seat 2: MrOB1reader (button) folded before Flop (didn't bet)
Seat 4: Klemtonius (small blind) folded before Flop
Seat 5: PokerStarsMan12 (big blind) folded on the Turn
Seat 8: MaFak2019 collected (3003)



PokerStars Home Game Hand #226732454391: {DaPokaStars}  Hold'em No Limit (50/100) - 2021/05/13 19:09:28 ET
Table 'again and again' 9-max (Play Money) Seat #4 is the button
Seat 1: color_singleton (14104 in chips) 
Seat 2: MrOB1reader (11433 in chips) 
Seat 4: Klemtonius (48382 in chips) 
Seat 5: PokerStarsMan12 (21165 in chips) 
Seat 8: MaFak2019 (26355 in chips) 
PokerStarsMan12: posts small blind 50
MaFak2019: posts big blind 100
*** HOLE CARDS ***
Dealt to PokerStarsMan12 [Jc Ts]
color_singleton: raises 300 to 400
MrOB1reader: folds 
Klemtonius: folds 
PokerStarsMan12: calls 350
MaFak2019: folds 
*** FLOP *** [8s Jh 2h]
PokerStarsMan12: bets 500
color_singleton: calls 500
*** TURN *** [8s Jh 2h] [5d]
PokerStarsMan12: bets 900
color_singleton: folds 
Uncalled bet (900) returned to PokerStarsMan12
PokerStarsMan12 collected 1795 from pot
*** SUMMARY ***
Total pot 1900 | Rake 105 
Board [8s Jh 2h 5d]
Seat 1: color_singleton folded on the Turn
Seat 2: MrOB1reader folded before Flop (didn't bet)
Seat 4: Klemtonius (button) folded before Flop (didn't bet)
Seat 5: PokerStarsMan12 (small blind) collected (1795)
Seat 8: MaFak2019 (big blind) folded before Flop



PokerStars Home Game Hand #226732464411: {DaPokaStars}  Hold'em No Limit (50/100) - 2021/05/13 19:09:55 ET
Table 'again and again' 9-max (Play Money) Seat #5 is the button
Seat 1: color_singleton (13204 in chips) 
Seat 2: MrOB1reader (11433 in chips) 
Seat 4: Klemtonius (48382 in chips) 
Seat 5: PokerStarsMan12 (22060 in chips) 
Seat 8: MaFak2019 (26255 in chips) 
MaFak2019: posts small blind 50
color_singleton: posts big blind 100
*** HOLE CARDS ***
Dealt to PokerStarsMan12 [9d 7c]
MrOB1reader: calls 100
Klemtonius: folds 
PokerStarsMan12: folds 
MaFak2019: folds 
color_singleton: raises 200 to 300
MrOB1reader: calls 200
*** FLOP *** [Qh Ac 2d]
color_singleton: checks 
MrOB1reader: bets 307
color_singleton: raises 307 to 614
MrOB1reader: calls 307
*** TURN *** [Qh Ac 2d] [As]
color_singleton: bets 887
MrOB1reader: calls 887
*** RIVER *** [Qh Ac 2d As] [8d]
color_singleton: bets 3451
MrOB1reader: calls 3451
*** SHOW DOWN ***
color_singleton: shows [Kd Ad] (three of a kind, Aces)
MrOB1reader: mucks hand 
color_singleton collected 9974 from pot
*** SUMMARY ***
Total pot 10554 | Rake 580 
Board [Qh Ac 2d As 8d]
Seat 1: color_singleton (big blind) showed [Kd Ad] and won (9974) with three of a kind, Aces
Seat 2: MrOB1reader mucked [5s Ah]
Seat 4: Klemtonius folded before Flop (didn't bet)
Seat 5: PokerStarsMan12 (button) folded before Flop (didn't bet)
Seat 8: MaFak2019 (small blind) folded before Flop



PokerStars Home Game Hand #226732482008: {DaPokaStars}  Hold'em No Limit (50/100) - 2021/05/13 19:10:43 ET
Table 'again and again' 9-max (Play Money) Seat #8 is the button
Seat 1: color_singleton (17926 in chips) 
Seat 2: MrOB1reader (6181 in chips) 
Seat 4: Klemtonius (48382 in chips) 
Seat 5: PokerStarsMan12 (22060 in chips) 
Seat 8: MaFak2019 (26205 in chips) 
color_singleton: posts small blind 50
MrOB1reader: posts big blind 100
*** HOLE CARDS ***
Dealt to PokerStarsMan12 [Kh Jc]
Klemtonius: raises 100 to 200
PokerStarsMan12: calls 200
MaFak2019: calls 200
color_singleton: folds 
MrOB1reader: folds 
*** FLOP *** [7h 6d 9s]
Klemtonius: bets 354
PokerStarsMan12: calls 354
MaFak2019: calls 354
*** TURN *** [7h 6d 9s] [4h]
Klemtonius: bets 1712
PokerStarsMan12: folds 
MaFak2019: calls 1712
*** RIVER *** [7h 6d 9s 4h] [6s]
Klemtonius: bets 4948
MaFak2019: folds 
Uncalled bet (4948) returned to Klemtonius
Klemtonius collected 4948 from pot
Klemtonius: doesn't show hand 
*** SUMMARY ***
Total pot 5236 | Rake 288 
Board [7h 6d 9s 4h 6s]
Seat 1: color_singleton (small blind) folded before Flop
Seat 2: MrOB1reader (big blind) folded before Flop
Seat 4: Klemtonius collected (4948)
Seat 5: PokerStarsMan12 folded on the Turn
Seat 8: MaFak2019 (button) folded on the River



PokerStars Home Game Hand #226732501064: {DaPokaStars}  Hold'em No Limit (50/100) - 2021/05/13 19:11:34 ET
Table 'again and again' 9-max (Play Money) Seat #1 is the button
Seat 1: color_singleton (17876 in chips) 
Seat 2: MrOB1reader (6081 in chips) 
Seat 4: Klemtonius (51064 in chips) 
Seat 5: PokerStarsMan12 (21506 in chips) 
Seat 8: MaFak2019 (23939 in chips) 
MrOB1reader: posts small blind 50
Klemtonius: posts big blind 100
*** HOLE CARDS ***
Dealt to PokerStarsMan12 [7h Kh]
PokerStarsMan12: raises 200 to 300
MaFak2019: raises 200 to 500
color_singleton: calls 500
MrOB1reader: calls 450
Klemtonius: raises 200 to 700
PokerStarsMan12: calls 400
MaFak2019: raises 200 to 900
color_singleton: calls 400
MrOB1reader: calls 400
Klemtonius: calls 200
PokerStarsMan12: calls 200
*** FLOP *** [Kd 9c 5s]
MrOB1reader: checks 
Klemtonius: bets 2126
PokerStarsMan12: calls 2126
MaFak2019: raises 2126 to 4252
color_singleton: folds 
MrOB1reader: folds 
Klemtonius: calls 2126
PokerStarsMan12: calls 2126
*** TURN *** [Kd 9c 5s] [2c]
Klemtonius: checks 
PokerStarsMan12: bets 3600
MaFak2019: calls 3600
Klemtonius: calls 3600
*** RIVER *** [Kd 9c 5s 2c] [2d]
Klemtonius: checks 
PokerStarsMan12: checks 
MaFak2019: bets 5187
Klemtonius: folds 
PokerStarsMan12: calls 5187
*** SHOW DOWN ***
MaFak2019: shows [Qs Kc] (two pair, Kings and Deuces)
PokerStarsMan12: mucks hand 
MaFak2019 collected 36316 from pot
*** SUMMARY ***
Total pot 38430 | Rake 2114 
Board [Kd 9c 5s 2c 2d]
Seat 1: color_singleton (button) folded on the Flop
Seat 2: MrOB1reader (small blind) folded on the Flop
Seat 4: Klemtonius (big blind) folded on the River
Seat 5: PokerStarsMan12 mucked [7h Kh]
Seat 8: MaFak2019 showed [Qs Kc] and won (36316) with two pair, Kings and Deuces



PokerStars Home Game Hand #226732536490: {DaPokaStars}  Hold'em No Limit (50/100) - 2021/05/13 19:13:11 ET
Table 'again and again' 9-max (Play Money) Seat #2 is the button
Seat 1: color_singleton (16976 in chips) 
Seat 2: MrOB1reader (5181 in chips) 
Seat 4: Klemtonius (42312 in chips) 
Seat 5: PokerStarsMan12 (7567 in chips) 
Seat 8: MaFak2019 (46316 in chips) 
Klemtonius: posts small blind 50
PokerStarsMan12: posts big blind 100
*** HOLE CARDS ***
Dealt to PokerStarsMan12 [Ts Kd]
MaFak2019: calls 100
color_singleton: raises 100 to 200
MrOB1reader: folds 
Klemtonius: calls 150
PokerStarsMan12: calls 100
MaFak2019: calls 100
*** FLOP *** [5s Js 5d]
Klemtonius: checks 
PokerStarsMan12: checks 
MaFak2019: bets 756
color_singleton: folds 
Klemtonius: folds 
PokerStarsMan12: folds 
Uncalled bet (756) returned to MaFak2019
MaFak2019 collected 756 from pot
MaFak2019: doesn't show hand 
*** SUMMARY ***
Total pot 800 | Rake 44 
Board [5s Js 5d]
Seat 1: color_singleton folded on the Flop
Seat 2: MrOB1reader (button) folded before Flop (didn't bet)
Seat 4: Klemtonius (small blind) folded on the Flop
Seat 5: PokerStarsMan12 (big blind) folded on the Flop
Seat 8: MaFak2019 collected (756)



PokerStars Home Game Hand #226732548595: {DaPokaStars}  Hold'em No Limit (50/100) - 2021/05/13 19:13:44 ET
Table 'again and again' 9-max (Play Money) Seat #4 is the button
Seat 1: color_singleton (16776 in chips) 
Seat 2: MrOB1reader (5181 in chips) 
Seat 4: Klemtonius (42112 in chips) 
Seat 5: PokerStarsMan12 (7367 in chips) 
Seat 8: MaFak2019 (46872 in chips) 
PokerStarsMan12: posts small blind 50
MaFak2019: posts big blind 100
*** HOLE CARDS ***
Dealt to PokerStarsMan12 [3h Td]
color_singleton: folds 
MrOB1reader: folds 
Klemtonius: raises 250 to 350
PokerStarsMan12: folds 
MaFak2019: calls 250
*** FLOP *** [Kc 7s Ah]
MaFak2019: checks 
Klemtonius: checks 
*** TURN *** [Kc 7s Ah] [2c]
MaFak2019: checks 
Klemtonius: bets 709
MaFak2019: folds 
Uncalled bet (709) returned to Klemtonius
Klemtonius collected 709 from pot
Klemtonius: doesn't show hand 
*** SUMMARY ***
Total pot 750 | Rake 41 
Board [Kc 7s Ah 2c]
Seat 1: color_singleton folded before Flop (didn't bet)
Seat 2: MrOB1reader folded before Flop (didn't bet)
Seat 4: Klemtonius (button) collected (709)
Seat 5: PokerStarsMan12 (small blind) folded before Flop
Seat 8: MaFak2019 (big blind) folded on the Turn



PokerStars Home Game Hand #226732555776: {DaPokaStars}  Hold'em No Limit (50/100) - 2021/05/13 19:14:03 ET
Table 'again and again' 9-max (Play Money) Seat #5 is the button
Seat 1: color_singleton (16776 in chips) 
Seat 2: MrOB1reader (5181 in chips) 
Seat 4: Klemtonius (42471 in chips) 
Seat 5: PokerStarsMan12 (7317 in chips) 
Seat 8: MaFak2019 (46522 in chips) 
MaFak2019: posts small blind 50
color_singleton: posts big blind 100
*** HOLE CARDS ***
Dealt to PokerStarsMan12 [3s 6h]
MrOB1reader: folds 
Klemtonius: raises 250 to 350
PokerStarsMan12: folds 
MaFak2019: raises 250 to 600
color_singleton: folds 
Klemtonius: calls 250
*** FLOP *** [Jc Td 3h]
MaFak2019: checks 
Klemtonius: bets 1228
MaFak2019: calls 1228
*** TURN *** [Jc Td 3h] [8s]
MaFak2019: checks 
Klemtonius: checks 
*** RIVER *** [Jc Td 3h 8s] [Kh]
MaFak2019: checks 
Klemtonius: bets 3549
MaFak2019: calls 3549
*** SHOW DOWN ***
Klemtonius: shows [6c Kc] (a pair of Kings)
MaFak2019: shows [Kd Qs] (a pair of Kings - Queen kicker)
MaFak2019 collected 10257 from pot
*** SUMMARY ***
Total pot 10854 | Rake 597 
Board [Jc Td 3h 8s Kh]
Seat 1: color_singleton (big blind) folded before Flop
Seat 2: MrOB1reader folded before Flop (didn't bet)
Seat 4: Klemtonius showed [6c Kc] and lost with a pair of Kings
Seat 5: PokerStarsMan12 (button) folded before Flop (didn't bet)
Seat 8: MaFak2019 (small blind) showed [Kd Qs] and won (10257) with a pair of Kings



PokerStars Home Game Hand #226732568092: {DaPokaStars}  Hold'em No Limit (50/100) - 2021/05/13 19:14:38 ET
Table 'again and again' 9-max (Play Money) Seat #8 is the button
Seat 1: color_singleton (16676 in chips) 
Seat 4: Klemtonius (37094 in chips) 
Seat 5: PokerStarsMan12 (7317 in chips) 
Seat 8: MaFak2019 (51402 in chips) 
color_singleton: posts small blind 50
Klemtonius: posts big blind 100
*** HOLE CARDS ***
Dealt to PokerStarsMan12 [Ah 8c]
PokerStarsMan12: raises 200 to 300
MaFak2019: calls 300
color_singleton: calls 250
Klemtonius: calls 200
*** FLOP *** [9c 8s 3h]
color_singleton: checks 
Klemtonius: bets 1134
PokerStarsMan12: folds 
MaFak2019: folds 
color_singleton: folds 
Uncalled bet (1134) returned to Klemtonius
Klemtonius collected 1134 from pot
Klemtonius: doesn't show hand 
*** SUMMARY ***
Total pot 1200 | Rake 66 
Board [9c 8s 3h]
Seat 1: color_singleton (small blind) folded on the Flop
Seat 4: Klemtonius (big blind) collected (1134)
Seat 5: PokerStarsMan12 folded on the Flop
Seat 8: MaFak2019 (button) folded on the Flop



PokerStars Home Game Hand #226732575936: {DaPokaStars}  Hold'em No Limit (50/100) - 2021/05/13 19:14:59 ET
Table 'again and again' 9-max (Play Money) Seat #1 is the button
Seat 1: color_singleton (16376 in chips) 
Seat 4: Klemtonius (37928 in chips) 
Seat 5: PokerStarsMan12 (7017 in chips) 
Seat 8: MaFak2019 (51102 in chips) 
Klemtonius: posts small blind 50
PokerStarsMan12: posts big blind 100
*** HOLE CARDS ***
Dealt to PokerStarsMan12 [Jc 3h]
MaFak2019: calls 100
color_singleton: folds 
Klemtonius: folds 
PokerStarsMan12: checks 
*** FLOP *** [9h 3d Ts]
PokerStarsMan12: checks 
MaFak2019: bets 236
PokerStarsMan12: folds 
Uncalled bet (236) returned to MaFak2019
MaFak2019 collected 236 from pot
MaFak2019: doesn't show hand 
*** SUMMARY ***
Total pot 250 | Rake 14 
Board [9h 3d Ts]
Seat 1: color_singleton (button) folded before Flop (didn't bet)
Seat 4: Klemtonius (small blind) folded before Flop
Seat 5: PokerStarsMan12 (big blind) folded on the Flop
Seat 8: MaFak2019 collected (236)



PokerStars Home Game Hand #226732592080: {DaPokaStars}  Hold'em No Limit (50/100) - 2021/05/13 19:15:24 ET
Table 'again and again' 9-max (Play Money) Seat #4 is the button
Seat 1: color_singleton (16376 in chips) 
Seat 4: Klemtonius (37878 in chips) 
Seat 5: PokerStarsMan12 (6917 in chips) 
Seat 8: MaFak2019 (51238 in chips) 
PokerStarsMan12: posts small blind 50
MaFak2019: posts big blind 100
*** HOLE CARDS ***
Dealt to PokerStarsMan12 [Kd 5s]
color_singleton: folds 
Klemtonius: raises 250 to 350
PokerStarsMan12: folds 
MaFak2019: folds 
Uncalled bet (250) returned to Klemtonius
Klemtonius collected 250 from pot
Klemtonius: doesn't show hand 
*** SUMMARY ***
Total pot 250 | Rake 0 
Seat 1: color_singleton folded before Flop (didn't bet)
Seat 4: Klemtonius (button) collected (250)
Seat 5: PokerStarsMan12 (small blind) folded before Flop
Seat 8: MaFak2019 (big blind) folded before Flop



PokerStars Home Game Hand #226732595656: {DaPokaStars}  Hold'em No Limit (50/100) - 2021/05/13 19:15:34 ET
Table 'again and again' 9-max (Play Money) Seat #5 is the button
Seat 1: color_singleton (16376 in chips) 
Seat 4: Klemtonius (38028 in chips) 
Seat 5: PokerStarsMan12 (6867 in chips) 
Seat 8: MaFak2019 (51138 in chips) 
MaFak2019: posts small blind 50
color_singleton: posts big blind 100
*** HOLE CARDS ***
Dealt to PokerStarsMan12 [4s 7c]
Klemtonius: calls 100
PokerStarsMan12: folds 
MaFak2019: calls 50
color_singleton: checks 
*** FLOP *** [4h Jc 7h]
MaFak2019: checks 
color_singleton: bets 141
Klemtonius: calls 141
MaFak2019: calls 141
*** TURN *** [4h Jc 7h] [5d]
MaFak2019: checks 
color_singleton: checks 
Klemtonius: checks 
*** RIVER *** [4h Jc 7h 5d] [Ah]
MaFak2019: checks 
color_singleton: bets 683
Klemtonius: folds 
MaFak2019: folds 
Uncalled bet (683) returned to color_singleton
color_singleton collected 683 from pot
color_singleton: doesn't show hand 
*** SUMMARY ***
Total pot 723 | Rake 40 
Board [4h Jc 7h 5d Ah]
Seat 1: color_singleton (big blind) collected (683)
Seat 4: Klemtonius folded on the River
Seat 5: PokerStarsMan12 (button) folded before Flop (didn't bet)
Seat 8: MaFak2019 (small blind) folded on the River



PokerStars Home Game Hand #226732610851: {DaPokaStars}  Hold'em No Limit (50/100) - 2021/05/13 19:16:16 ET
Table 'again and again' 9-max (Play Money) Seat #8 is the button
Seat 1: color_singleton (16818 in chips) 
Seat 2: MrOB1reader (5181 in chips) 
Seat 4: Klemtonius (37787 in chips) 
Seat 5: PokerStarsMan12 (6867 in chips) 
Seat 8: MaFak2019 (50897 in chips) 
color_singleton: posts small blind 50
MrOB1reader: posts big blind 100
*** HOLE CARDS ***
Dealt to PokerStarsMan12 [5h Qh]
Klemtonius: folds 
PokerStarsMan12: calls 100
MaFak2019: calls 100
color_singleton: raises 200 to 300
MrOB1reader: calls 200
PokerStarsMan12 has timed out
PokerStarsMan12: folds 
MaFak2019: calls 200
*** FLOP *** [6d 2s 7s]
color_singleton: checks 
MrOB1reader: bets 472
MaFak2019: calls 472
color_singleton: calls 472
*** TURN *** [6d 2s 7s] [7d]
color_singleton: checks 
MrOB1reader: bets 1141
MaFak2019: calls 1141
color_singleton: folds 
*** RIVER *** [6d 2s 7s 7d] [6c]
MrOB1reader: checks 
MaFak2019: bets 4440
MrOB1reader: folds 
Uncalled bet (4440) returned to MaFak2019
MaFak2019 collected 4440 from pot
MaFak2019: doesn't show hand 
*** SUMMARY ***
Total pot 4698 | Rake 258 
Board [6d 2s 7s 7d 6c]
Seat 1: color_singleton (small blind) folded on the Turn
Seat 2: MrOB1reader (big blind) folded on the River
Seat 4: Klemtonius folded before Flop (didn't bet)
Seat 5: PokerStarsMan12 folded before Flop
Seat 8: MaFak2019 (button) collected (4440)



PokerStars Home Game Hand #226732642287: {DaPokaStars}  Hold'em No Limit (50/100) - 2021/05/13 19:17:42 ET
Table 'again and again' 9-max (Play Money) Seat #1 is the button
Seat 1: color_singleton (16046 in chips) 
Seat 2: MrOB1reader (3268 in chips) 
Seat 4: Klemtonius (37787 in chips) 
Seat 5: PokerStarsMan12 (6767 in chips) 
Seat 8: MaFak2019 (53424 in chips) 
MrOB1reader: posts small blind 50
Klemtonius: posts big blind 100
*** HOLE CARDS ***
Dealt to PokerStarsMan12 [Ad 2h]
PokerStarsMan12: calls 100
MaFak2019: raises 350 to 450
color_singleton: calls 450
MrOB1reader: calls 400
Klemtonius: calls 350
PokerStarsMan12: folds 
*** FLOP *** [Jd Qs 4s]
MrOB1reader: bets 897
Klemtonius: folds 
MaFak2019: calls 897
color_singleton: folds 
*** TURN *** [Jd Qs 4s] [6d]
MrOB1reader: bets 1745
MaFak2019: folds 
Uncalled bet (1745) returned to MrOB1reader
MrOB1reader collected 3491 from pot
*** SUMMARY ***
Total pot 3694 | Rake 203 
Board [Jd Qs 4s 6d]
Seat 1: color_singleton (button) folded on the Flop
Seat 2: MrOB1reader (small blind) collected (3491)
Seat 4: Klemtonius (big blind) folded on the Flop
Seat 5: PokerStarsMan12 folded before Flop
Seat 8: MaFak2019 folded on the Turn



PokerStars Home Game Hand #226732658589: {DaPokaStars}  Hold'em No Limit (50/100) - 2021/05/13 19:18:17 ET
Table 'again and again' 9-max (Play Money) Seat #2 is the button
Seat 1: color_singleton (15596 in chips) 
Seat 2: MrOB1reader (5412 in chips) 
Seat 4: Klemtonius (37337 in chips) 
Seat 5: PokerStarsMan12 (6667 in chips) 
Seat 8: MaFak2019 (52077 in chips) 
Klemtonius: posts small blind 50
PokerStarsMan12: posts big blind 100
*** HOLE CARDS ***
Dealt to PokerStarsMan12 [As 8s]
MaFak2019: calls 100
color_singleton: raises 200 to 300
MrOB1reader: folds 
Klemtonius: folds 
PokerStarsMan12: calls 200
MaFak2019: calls 200
*** FLOP *** [Td Qs Qd]
PokerStarsMan12: checks 
MaFak2019: checks 
color_singleton: bets 898
PokerStarsMan12: folds 
MaFak2019: raises 898 to 1796
color_singleton: calls 898
*** TURN *** [Td Qs Qd] [Ks]
MaFak2019: checks 
color_singleton: checks 
*** RIVER *** [Td Qs Qd Ks] [9s]
MaFak2019: checks 
color_singleton: checks 
*** SHOW DOWN ***
MaFak2019: shows [8d 6d] (a pair of Queens)
color_singleton: shows [9d Th] (two pair, Queens and Tens)
color_singleton collected 4292 from pot
*** SUMMARY ***
Total pot 4542 | Rake 250 
Board [Td Qs Qd Ks 9s]
Seat 1: color_singleton showed [9d Th] and won (4292) with two pair, Queens and Tens
Seat 2: MrOB1reader (button) folded before Flop (didn't bet)
Seat 4: Klemtonius (small blind) folded before Flop
Seat 5: PokerStarsMan12 (big blind) folded on the Flop
Seat 8: MaFak2019 showed [8d 6d] and lost with a pair of Queens



PokerStars Home Game Hand #226732669138: {DaPokaStars}  Hold'em No Limit (50/100) - 2021/05/13 19:18:46 ET
Table 'again and again' 9-max (Play Money) Seat #4 is the button
Seat 1: color_singleton (17792 in chips) 
Seat 2: MrOB1reader (5412 in chips) 
Seat 4: Klemtonius (37287 in chips) 
Seat 5: PokerStarsMan12 (6367 in chips) 
Seat 8: MaFak2019 (49981 in chips) 
PokerStarsMan12: posts small blind 50
MaFak2019: posts big blind 100
*** HOLE CARDS ***
Dealt to PokerStarsMan12 [8c 8h]
color_singleton: folds 
MrOB1reader: calls 100
Klemtonius: calls 100
PokerStarsMan12: raises 400 to 500
MaFak2019: folds 
MrOB1reader: folds 
Klemtonius: folds 
Uncalled bet (400) returned to PokerStarsMan12
PokerStarsMan12 collected 400 from pot
*** SUMMARY ***
Total pot 400 | Rake 0 
Seat 1: color_singleton folded before Flop (didn't bet)
Seat 2: MrOB1reader folded before Flop
Seat 4: Klemtonius (button) folded before Flop
Seat 5: PokerStarsMan12 (small blind) collected (400)
Seat 8: MaFak2019 (big blind) folded before Flop



PokerStars Home Game Hand #226732677210: {DaPokaStars}  Hold'em No Limit (50/100) - 2021/05/13 19:19:08 ET
Table 'again and again' 9-max (Play Money) Seat #5 is the button
Seat 1: color_singleton (17792 in chips) 
Seat 2: MrOB1reader (5312 in chips) 
Seat 4: Klemtonius (37187 in chips) 
Seat 5: PokerStarsMan12 (6667 in chips) 
Seat 8: MaFak2019 (49881 in chips) 
MaFak2019: posts small blind 50
color_singleton: posts big blind 100
*** HOLE CARDS ***
Dealt to PokerStarsMan12 [4d 8s]
MrOB1reader: calls 100
Klemtonius: raises 350 to 450
PokerStarsMan12: folds 
MaFak2019: calls 400
color_singleton: folds 
MrOB1reader: calls 350
*** FLOP *** [8d Th Tc]
MaFak2019: checks 
MrOB1reader: bets 685
Klemtonius: folds 
MaFak2019: folds 
Uncalled bet (685) returned to MrOB1reader
MrOB1reader collected 1370 from pot
*** SUMMARY ***
Total pot 1450 | Rake 80 
Board [8d Th Tc]
Seat 1: color_singleton (big blind) folded before Flop
Seat 2: MrOB1reader collected (1370)
Seat 4: Klemtonius folded on the Flop
Seat 5: PokerStarsMan12 (button) folded before Flop (didn't bet)
Seat 8: MaFak2019 (small blind) folded on the Flop



PokerStars Home Game Hand #226732687427: {DaPokaStars}  Hold'em No Limit (50/100) - 2021/05/13 19:19:37 ET
Table 'again and again' 9-max (Play Money) Seat #8 is the button
Seat 1: color_singleton (17692 in chips) 
Seat 2: MrOB1reader (6232 in chips) 
Seat 4: Klemtonius (36737 in chips) 
Seat 5: PokerStarsMan12 (6667 in chips) 
Seat 8: MaFak2019 (49431 in chips) 
color_singleton: posts small blind 50
MrOB1reader: posts big blind 100
*** HOLE CARDS ***
Dealt to PokerStarsMan12 [4d 2c]
Klemtonius: raises 250 to 350
PokerStarsMan12: folds 
MaFak2019: calls 350
color_singleton: calls 300
MrOB1reader: folds 
*** FLOP *** [2d 9c 5c]
color_singleton: bets 1087
Klemtonius: calls 1087
MaFak2019: calls 1087
*** TURN *** [2d 9c 5c] [5h]
color_singleton: bets 4168
Klemtonius: folds 
MaFak2019: folds 
Uncalled bet (4168) returned to color_singleton
color_singleton collected 4168 from pot
color_singleton: doesn't show hand 
*** SUMMARY ***
Total pot 4411 | Rake 243 
Board [2d 9c 5c 5h]
Seat 1: color_singleton (small blind) collected (4168)
Seat 2: MrOB1reader (big blind) folded before Flop
Seat 4: Klemtonius folded on the Turn
Seat 5: PokerStarsMan12 folded before Flop (didn't bet)
Seat 8: MaFak2019 (button) folded on the Turn



PokerStars Home Game Hand #226732700536: {DaPokaStars}  Hold'em No Limit (50/100) - 2021/05/13 19:20:13 ET
Table 'again and again' 9-max (Play Money) Seat #1 is the button
Seat 1: color_singleton (20423 in chips) 
Seat 2: MrOB1reader (6132 in chips) 
Seat 4: Klemtonius (35300 in chips) 
Seat 5: PokerStarsMan12 (6667 in chips) 
Seat 8: MaFak2019 (47994 in chips) 
MrOB1reader: posts small blind 50
Klemtonius: posts big blind 100
*** HOLE CARDS ***
Dealt to PokerStarsMan12 [7d 9h]
PokerStarsMan12: folds 
MaFak2019: folds 
color_singleton: folds 
MrOB1reader: folds 
Uncalled bet (50) returned to Klemtonius
Klemtonius collected 100 from pot
Klemtonius: doesn't show hand 
*** SUMMARY ***
Total pot 100 | Rake 0 
Seat 1: color_singleton (button) folded before Flop (didn't bet)
Seat 2: MrOB1reader (small blind) folded before Flop
Seat 4: Klemtonius (big blind) collected (100)
Seat 5: PokerStarsMan12 folded before Flop (didn't bet)
Seat 8: MaFak2019 folded before Flop (didn't bet)



PokerStars Home Game Hand #226732703355: {DaPokaStars}  Hold'em No Limit (50/100) - 2021/05/13 19:20:21 ET
Table 'again and again' 9-max (Play Money) Seat #2 is the button
Seat 1: color_singleton (20423 in chips) 
Seat 2: MrOB1reader (6082 in chips) 
Seat 4: Klemtonius (35350 in chips) 
Seat 5: PokerStarsMan12 (6667 in chips) 
Seat 8: MaFak2019 (47994 in chips) 
Klemtonius: posts small blind 50
PokerStarsMan12: posts big blind 100
*** HOLE CARDS ***
Dealt to PokerStarsMan12 [9d 5c]
MaFak2019: calls 100
color_singleton: calls 100
MrOB1reader: folds 
Klemtonius: raises 400 to 500
PokerStarsMan12: folds 
MaFak2019: calls 400
color_singleton: calls 400
*** FLOP *** [8s Js 9h]
Klemtonius: checks 
MaFak2019: checks 
color_singleton: bets 756
Klemtonius: folds 
MaFak2019: folds 
Uncalled bet (756) returned to color_singleton
color_singleton collected 1512 from pot
color_singleton: doesn't show hand 
*** SUMMARY ***
Total pot 1600 | Rake 88 
Board [8s Js 9h]
Seat 1: color_singleton collected (1512)
Seat 2: MrOB1reader (button) folded before Flop (didn't bet)
Seat 4: Klemtonius (small blind) folded on the Flop
Seat 5: PokerStarsMan12 (big blind) folded before Flop
Seat 8: MaFak2019 folded on the Flop



PokerStars Home Game Hand #226732714031: {DaPokaStars}  Hold'em No Limit (50/100) - 2021/05/13 19:20:51 ET
Table 'again and again' 9-max (Play Money) Seat #4 is the button
Seat 1: color_singleton (21435 in chips) 
Seat 2: MrOB1reader (6082 in chips) 
Seat 4: Klemtonius (34850 in chips) 
Seat 5: PokerStarsMan12 (6567 in chips) 
Seat 8: MaFak2019 (47494 in chips) 
PokerStarsMan12: posts small blind 50
MaFak2019: posts big blind 100
*** HOLE CARDS ***
Dealt to PokerStarsMan12 [8s Kd]
color_singleton: raises 200 to 300
MrOB1reader: folds 
Klemtonius: folds 
PokerStarsMan12: folds 
MaFak2019: calls 200
*** FLOP *** [Ts Qs Qd]
MaFak2019: checks 
color_singleton: bets 614
MaFak2019: calls 614
*** TURN *** [Ts Qs Qd] [9d]
MaFak2019: checks 
color_singleton: checks 
*** RIVER *** [Ts Qs Qd 9d] [3s]
MaFak2019: checks 
color_singleton: checks 
*** SHOW DOWN ***
MaFak2019: shows [8d Kh] (a pair of Queens)
color_singleton: shows [Ac 6h] (a pair of Queens - Ace kicker)
color_singleton collected 1775 from pot
*** SUMMARY ***
Total pot 1878 | Rake 103 
Board [Ts Qs Qd 9d 3s]
Seat 1: color_singleton showed [Ac 6h] and won (1775) with a pair of Queens
Seat 2: MrOB1reader folded before Flop (didn't bet)
Seat 4: Klemtonius (button) folded before Flop (didn't bet)
Seat 5: PokerStarsMan12 (small blind) folded before Flop
Seat 8: MaFak2019 (big blind) showed [8d Kh] and lost with a pair of Queens



PokerStars Home Game Hand #226732723160: {DaPokaStars}  Hold'em No Limit (50/100) - 2021/05/13 19:21:17 ET
Table 'again and again' 9-max (Play Money) Seat #5 is the button
Seat 1: color_singleton (22296 in chips) 
Seat 2: MrOB1reader (6082 in chips) 
Seat 4: Klemtonius (34850 in chips) 
Seat 5: PokerStarsMan12 (6517 in chips) 
Seat 8: MaFak2019 (46580 in chips) 
MaFak2019: posts small blind 50
color_singleton: posts big blind 100
*** HOLE CARDS ***
Dealt to PokerStarsMan12 [8h 4s]
MrOB1reader: calls 100
Klemtonius: calls 100
PokerStarsMan12: folds 
MaFak2019: calls 50
color_singleton: raises 200 to 300
MrOB1reader: calls 200
Klemtonius: calls 200
MaFak2019: raises 200 to 500
color_singleton: calls 200
MrOB1reader: calls 200
Klemtonius: calls 200
*** FLOP *** [Ad Kh 9h]
MaFak2019: checks 
color_singleton: bets 1890
MrOB1reader: calls 1890
Klemtonius: folds 
MaFak2019: folds 
*** TURN *** [Ad Kh 9h] [3c]
color_singleton: bets 2731
MrOB1reader: calls 2731
*** RIVER *** [Ad Kh 9h 3c] [Jd]
color_singleton: checks 
MrOB1reader: checks 
*** SHOW DOWN ***
color_singleton: shows [As 8d] (a pair of Aces)
MrOB1reader: shows [Ks 9s] (two pair, Kings and Nines)
MrOB1reader collected 10624 from pot
*** SUMMARY ***
Total pot 11242 | Rake 618 
Board [Ad Kh 9h 3c Jd]
Seat 1: color_singleton (big blind) showed [As 8d] and lost with a pair of Aces
Seat 2: MrOB1reader showed [Ks 9s] and won (10624) with two pair, Kings and Nines
Seat 4: Klemtonius folded on the Flop
Seat 5: PokerStarsMan12 (button) folded before Flop (didn't bet)
Seat 8: MaFak2019 (small blind) folded on the Flop



PokerStars Home Game Hand #226732745270: {DaPokaStars}  Hold'em No Limit (50/100) - 2021/05/13 19:22:07 ET
Table 'again and again' 9-max (Play Money) Seat #8 is the button
Seat 1: color_singleton (17175 in chips) 
Seat 2: MrOB1reader (11585 in chips) 
Seat 4: Klemtonius (34350 in chips) 
Seat 5: PokerStarsMan12 (6517 in chips) 
Seat 8: MaFak2019 (46080 in chips) 
color_singleton: posts small blind 50
MrOB1reader: posts big blind 100
*** HOLE CARDS ***
Dealt to PokerStarsMan12 [Td 9c]
Klemtonius: folds 
PokerStarsMan12: raises 200 to 300
MaFak2019: calls 300
color_singleton: calls 250
MrOB1reader: calls 200
*** FLOP *** [3d Qd 9s]
color_singleton: bets 1134
MrOB1reader: folds 
PokerStarsMan12: folds 
MaFak2019: folds 
Uncalled bet (1134) returned to color_singleton
color_singleton collected 1134 from pot
color_singleton: doesn't show hand 
*** SUMMARY ***
Total pot 1200 | Rake 66 
Board [3d Qd 9s]
Seat 1: color_singleton (small blind) collected (1134)
Seat 2: MrOB1reader (big blind) folded on the Flop
Seat 4: Klemtonius folded before Flop (didn't bet)
Seat 5: PokerStarsMan12 folded on the Flop
Seat 8: MaFak2019 (button) folded on the Flop



PokerStars Home Game Hand #226732755152: {DaPokaStars}  Hold'em No Limit (50/100) - 2021/05/13 19:22:35 ET
Table 'again and again' 9-max (Play Money) Seat #1 is the button
Seat 1: color_singleton (18009 in chips) 
Seat 2: MrOB1reader (11285 in chips) 
Seat 4: Klemtonius (34350 in chips) 
Seat 5: PokerStarsMan12 (6217 in chips) 
Seat 8: MaFak2019 (45780 in chips) 
MrOB1reader: posts small blind 50
Klemtonius: posts big blind 100
*** HOLE CARDS ***
Dealt to PokerStarsMan12 [Kh 7d]
PokerStarsMan12: raises 200 to 300
MaFak2019: calls 300
color_singleton: folds 
MrOB1reader: folds 
Klemtonius: calls 200
*** FLOP *** [Ac 8h 6h]
Klemtonius: checks 
PokerStarsMan12: checks 
MaFak2019: bets 898
Klemtonius: folds 
PokerStarsMan12: folds 
Uncalled bet (898) returned to MaFak2019
MaFak2019 collected 898 from pot
MaFak2019: doesn't show hand 
*** SUMMARY ***
Total pot 950 | Rake 52 
Board [Ac 8h 6h]
Seat 1: color_singleton (button) folded before Flop (didn't bet)
Seat 2: MrOB1reader (small blind) folded before Flop
Seat 4: Klemtonius (big blind) folded on the Flop
Seat 5: PokerStarsMan12 folded on the Flop
Seat 8: MaFak2019 collected (898)



PokerStars Home Game Hand #226732762569: {DaPokaStars}  Hold'em No Limit (50/100) - 2021/05/13 19:22:56 ET
Table 'again and again' 9-max (Play Money) Seat #2 is the button
Seat 1: color_singleton (18009 in chips) 
Seat 2: MrOB1reader (11235 in chips) 
Seat 4: Klemtonius (34050 in chips) 
Seat 5: PokerStarsMan12 (5917 in chips) 
Seat 8: MaFak2019 (46378 in chips) 
Klemtonius: posts small blind 50
PokerStarsMan12: posts big blind 100
*** HOLE CARDS ***
Dealt to PokerStarsMan12 [4s Tc]
MaFak2019: calls 100
color_singleton: raises 300 to 400
MrOB1reader: folds 
Klemtonius: calls 350
PokerStarsMan12: folds 
MaFak2019: calls 300
*** FLOP *** [5d Th 6h]
Klemtonius: bets 1228
MaFak2019: folds 
color_singleton: calls 1228
*** TURN *** [5d Th 6h] [4d]
Klemtonius: bets 3549
color_singleton: folds 
Uncalled bet (3549) returned to Klemtonius
Klemtonius collected 3549 from pot
Klemtonius: doesn't show hand 
*** SUMMARY ***
Total pot 3756 | Rake 207 
Board [5d Th 6h 4d]
Seat 1: color_singleton folded on the Turn
Seat 2: MrOB1reader (button) folded before Flop (didn't bet)
Seat 4: Klemtonius (small blind) collected (3549)
Seat 5: PokerStarsMan12 (big blind) folded before Flop
Seat 8: MaFak2019 folded on the Flop



PokerStars Home Game Hand #226732772675: {DaPokaStars}  Hold'em No Limit (50/100) - 2021/05/13 19:23:24 ET
Table 'again and again' 9-max (Play Money) Seat #4 is the button
Seat 1: color_singleton (16381 in chips) 
Seat 2: MrOB1reader (11235 in chips) 
Seat 4: Klemtonius (35971 in chips) 
Seat 5: PokerStarsMan12 (5817 in chips) 
Seat 8: MaFak2019 (45978 in chips) 
PokerStarsMan12: posts small blind 50
MaFak2019: posts big blind 100
*** HOLE CARDS ***
Dealt to PokerStarsMan12 [3s 6d]
color_singleton: folds 
MrOB1reader: calls 100
Klemtonius: calls 100
PokerStarsMan12: calls 50
MaFak2019: checks 
*** FLOP *** [5h 9h Qd]
PokerStarsMan12: checks 
MaFak2019: checks 
MrOB1reader: checks 
Klemtonius: bets 378
PokerStarsMan12: folds 
MaFak2019: folds 
MrOB1reader: calls 378
*** TURN *** [5h 9h Qd] [Th]
MrOB1reader: checks 
Klemtonius: checks 
*** RIVER *** [5h 9h Qd Th] [4s]
MrOB1reader: bets 546
Klemtonius: folds 
Uncalled bet (546) returned to MrOB1reader
MrOB1reader collected 1092 from pot
*** SUMMARY ***
Total pot 1156 | Rake 64 
Board [5h 9h Qd Th 4s]
Seat 1: color_singleton folded before Flop (didn't bet)
Seat 2: MrOB1reader collected (1092)
Seat 4: Klemtonius (button) folded on the River
Seat 5: PokerStarsMan12 (small blind) folded on the Flop
Seat 8: MaFak2019 (big blind) folded on the Flop



PokerStars Home Game Hand #226732789509: {DaPokaStars}  Hold'em No Limit (50/100) - 2021/05/13 19:24:13 ET
Table 'again and again' 9-max (Play Money) Seat #5 is the button
Seat 1: color_singleton (16381 in chips) 
Seat 2: MrOB1reader (11849 in chips) 
Seat 4: Klemtonius (35493 in chips) 
Seat 5: PokerStarsMan12 (5717 in chips) 
Seat 8: MaFak2019 (45878 in chips) 
MaFak2019: posts small blind 50
color_singleton: posts big blind 100
*** HOLE CARDS ***
Dealt to PokerStarsMan12 [9s 5h]
MrOB1reader: calls 100
Klemtonius: folds 
PokerStarsMan12: calls 100
MaFak2019: folds 
color_singleton: checks 
*** FLOP *** [9d Qh Ac]
color_singleton: checks 
MrOB1reader: checks 
PokerStarsMan12: bets 300
color_singleton: folds 
MrOB1reader: folds 
Uncalled bet (300) returned to PokerStarsMan12
PokerStarsMan12 collected 331 from pot
*** SUMMARY ***
Total pot 350 | Rake 19 
Board [9d Qh Ac]
Seat 1: color_singleton (big blind) folded on the Flop
Seat 2: MrOB1reader folded on the Flop
Seat 4: Klemtonius folded before Flop (didn't bet)
Seat 5: PokerStarsMan12 (button) collected (331)
Seat 8: MaFak2019 (small blind) folded before Flop



PokerStars Home Game Hand #226732797804: {DaPokaStars}  Hold'em No Limit (50/100) - 2021/05/13 19:24:36 ET
Table 'again and again' 9-max (Play Money) Seat #8 is the button
Seat 1: color_singleton (16281 in chips) 
Seat 2: MrOB1reader (11749 in chips) 
Seat 4: Klemtonius (35493 in chips) 
Seat 5: PokerStarsMan12 (5948 in chips) 
Seat 8: MaFak2019 (45828 in chips) 
color_singleton: posts small blind 50
MrOB1reader: posts big blind 100
*** HOLE CARDS ***
Dealt to PokerStarsMan12 [4s 9c]
Klemtonius: folds 
PokerStarsMan12: folds 
MaFak2019: folds 
color_singleton: raises 300 to 400
MrOB1reader: folds 
Uncalled bet (300) returned to color_singleton
color_singleton collected 200 from pot
color_singleton: doesn't show hand 
*** SUMMARY ***
Total pot 200 | Rake 0 
Seat 1: color_singleton (small blind) collected (200)
Seat 2: MrOB1reader (big blind) folded before Flop
Seat 4: Klemtonius folded before Flop (didn't bet)
Seat 5: PokerStarsMan12 folded before Flop (didn't bet)
Seat 8: MaFak2019 (button) folded before Flop (didn't bet)



PokerStars Home Game Hand #226732801063: {DaPokaStars}  Hold'em No Limit (50/100) - 2021/05/13 19:24:45 ET
Table 'again and again' 9-max (Play Money) Seat #1 is the button
Seat 1: color_singleton (16381 in chips) 
Seat 2: MrOB1reader (11649 in chips) 
Seat 4: Klemtonius (35493 in chips) 
Seat 5: PokerStarsMan12 (5948 in chips) 
Seat 8: MaFak2019 (45828 in chips) 
MrOB1reader: posts small blind 50
Klemtonius: posts big blind 100
*** HOLE CARDS ***
Dealt to PokerStarsMan12 [Qd 5h]
PokerStarsMan12: calls 100
MaFak2019: calls 100
color_singleton: raises 300 to 400
MrOB1reader: calls 350
Klemtonius: raises 1400 to 1800
PokerStarsMan12: folds 
MaFak2019: folds 
color_singleton: calls 1400
MrOB1reader: calls 1400
*** FLOP *** [3d 4h 8d]
MrOB1reader: checks 
Klemtonius: bets 5292
color_singleton: folds 
MrOB1reader: folds 
Uncalled bet (5292) returned to Klemtonius
Klemtonius collected 5292 from pot
Klemtonius: doesn't show hand 
*** SUMMARY ***
Total pot 5600 | Rake 308 
Board [3d 4h 8d]
Seat 1: color_singleton (button) folded on the Flop
Seat 2: MrOB1reader (small blind) folded on the Flop
Seat 4: Klemtonius (big blind) collected (5292)
Seat 5: PokerStarsMan12 folded before Flop
Seat 8: MaFak2019 folded before Flop



