PokerStars Home Game Hand #227982321448: {DaPokaStars}  Hold'em No Limit (50/100) - 2021/07/01 15:16:58 ET
Table 'JULY 1' 9-max (Play Money) Seat #2 is the button
Seat 1: color_singleton (10000 in chips) 
Seat 2: HighCardJasper (10628 in chips) 
Seat 3: appositive (9072 in chips) 
Seat 4: PokerStarsMan12 (10000 in chips) 
Seat 5: Klemtonius (10601 in chips) 
Seat 9: mnnm585 (9450 in chips) 
appositive: posts small blind 50
PokerStarsMan12: posts big blind 100
*** HOLE CARDS ***
Dealt to PokerStarsMan12 [Js Ac]
Klemtonius: calls 100
mnnm585: calls 100
color_singleton: calls 100
HighCardJasper: calls 100
appositive: calls 50
PokerStarsMan12: raises 300 to 400
Klemtonius: calls 300
mnnm585: folds 
color_singleton: calls 300
HighCardJasper: calls 300
appositive: folds 
*** FLOP *** [Jh 6h 3s]
PokerStarsMan12: bets 900
Klemtonius: calls 900
color_singleton: calls 900
HighCardJasper: folds 
*** TURN *** [Jh 6h 3s] [Jd]
PokerStarsMan12: bets 2200
Klemtonius: folds 
color_singleton: calls 2200
*** RIVER *** [Jh 6h 3s Jd] [9d]
PokerStarsMan12: bets 6500 and is all-in
color_singleton: calls 6500 and is all-in
*** SHOW DOWN ***
PokerStarsMan12: shows [Js Ac] (three of a kind, Jacks)
color_singleton: shows [Jc Tc] (three of a kind, Jacks - lower kicker)
PokerStarsMan12 collected 20695 from pot
*** SUMMARY ***
Total pot 21900 | Rake 1205 
Board [Jh 6h 3s Jd 9d]
Seat 1: color_singleton showed [Jc Tc] and lost with three of a kind, Jacks
Seat 2: HighCardJasper (button) folded on the Flop
Seat 3: appositive (small blind) folded before Flop
Seat 4: PokerStarsMan12 (big blind) showed [Js Ac] and won (20695) with three of a kind, Jacks
Seat 5: Klemtonius folded on the Turn
Seat 9: mnnm585 folded before Flop



PokerStars Home Game Hand #227982365449: {DaPokaStars}  Hold'em No Limit (50/100) - 2021/07/01 15:18:33 ET
Table 'JULY 1' 9-max (Play Money) Seat #3 is the button
Seat 2: HighCardJasper (10228 in chips) 
Seat 3: appositive (8972 in chips) 
Seat 4: PokerStarsMan12 (20695 in chips) 
Seat 5: Klemtonius (9301 in chips) 
Seat 9: mnnm585 (9350 in chips) 
PokerStarsMan12: posts small blind 50
Klemtonius: posts big blind 100
*** HOLE CARDS ***
Dealt to PokerStarsMan12 [3h 3s]
mnnm585: calls 100
HighCardJasper: calls 100
appositive: folds 
PokerStarsMan12: calls 50
Klemtonius: checks 
*** FLOP *** [9d 5c Qh]
PokerStarsMan12: checks 
Klemtonius: checks 
mnnm585: checks 
HighCardJasper: bets 189
PokerStarsMan12: calls 189
Klemtonius: folds 
mnnm585: calls 189
*** TURN *** [9d 5c Qh] [Th]
PokerStarsMan12: checks 
mnnm585: checks 
HighCardJasper: checks 
*** RIVER *** [9d 5c Qh Th] [Ah]
PokerStarsMan12: checks 
mnnm585: checks 
HighCardJasper: checks 
*** SHOW DOWN ***
PokerStarsMan12: shows [3h 3s] (a pair of Threes)
mnnm585: shows [5s Kc] (a pair of Fives)
HighCardJasper: shows [Kd 9s] (a pair of Nines)
HighCardJasper collected 914 from pot
*** SUMMARY ***
Total pot 967 | Rake 53 
Board [9d 5c Qh Th Ah]
Seat 2: HighCardJasper showed [Kd 9s] and won (914) with a pair of Nines
Seat 3: appositive (button) folded before Flop (didn't bet)
Seat 4: PokerStarsMan12 (small blind) showed [3h 3s] and lost with a pair of Threes
Seat 5: Klemtonius (big blind) folded on the Flop
Seat 9: mnnm585 showed [5s Kc] and lost with a pair of Fives



PokerStars Home Game Hand #227982394953: {DaPokaStars}  Hold'em No Limit (50/100) - 2021/07/01 15:19:36 ET
Table 'JULY 1' 9-max (Play Money) Seat #4 is the button
Seat 1: color_singleton (10000 in chips) 
Seat 2: HighCardJasper (10853 in chips) 
Seat 3: appositive (8972 in chips) 
Seat 4: PokerStarsMan12 (20406 in chips) 
Seat 5: Klemtonius (9201 in chips) 
Seat 9: mnnm585 (9061 in chips) 
Klemtonius: posts small blind 50
mnnm585: posts big blind 100
*** HOLE CARDS ***
Dealt to PokerStarsMan12 [Kh As]
color_singleton: folds 
HighCardJasper: raises 100 to 200
appositive: folds 
PokerStarsMan12: raises 200 to 400
Klemtonius: calls 350
mnnm585: folds 
HighCardJasper: calls 200
*** FLOP *** [4d 8h 7d]
Klemtonius: checks 
HighCardJasper: checks 
PokerStarsMan12: checks 
*** TURN *** [4d 8h 7d] [4c]
Klemtonius: bets 1228
HighCardJasper: folds 
PokerStarsMan12: folds 
Uncalled bet (1228) returned to Klemtonius
Klemtonius collected 1228 from pot
Klemtonius: doesn't show hand 
*** SUMMARY ***
Total pot 1300 | Rake 72 
Board [4d 8h 7d 4c]
Seat 1: color_singleton folded before Flop (didn't bet)
Seat 2: HighCardJasper folded on the Turn
Seat 3: appositive folded before Flop (didn't bet)
Seat 4: PokerStarsMan12 (button) folded on the Turn
Seat 5: Klemtonius (small blind) collected (1228)
Seat 9: mnnm585 (big blind) folded before Flop



PokerStars Home Game Hand #227982416794: {DaPokaStars}  Hold'em No Limit (50/100) - 2021/07/01 15:20:23 ET
Table 'JULY 1' 9-max (Play Money) Seat #5 is the button
Seat 1: color_singleton (10000 in chips) 
Seat 2: HighCardJasper (10453 in chips) 
Seat 3: appositive (8972 in chips) 
Seat 4: PokerStarsMan12 (20006 in chips) 
Seat 5: Klemtonius (10029 in chips) 
Seat 9: mnnm585 (8961 in chips) 
mnnm585: posts small blind 50
color_singleton: posts big blind 100
*** HOLE CARDS ***
Dealt to PokerStarsMan12 [4c 5h]
HighCardJasper: calls 100
appositive: folds 
PokerStarsMan12: calls 100
Klemtonius: calls 100
mnnm585: folds 
color_singleton: raises 500 to 600
HighCardJasper: folds 
PokerStarsMan12: folds 
Klemtonius: calls 500
*** FLOP *** [5d As Qs]
color_singleton: bets 685
Klemtonius: folds 
Uncalled bet (685) returned to color_singleton
color_singleton collected 1370 from pot
color_singleton: doesn't show hand 
*** SUMMARY ***
Total pot 1450 | Rake 80 
Board [5d As Qs]
Seat 1: color_singleton (big blind) collected (1370)
Seat 2: HighCardJasper folded before Flop
Seat 3: appositive folded before Flop (didn't bet)
Seat 4: PokerStarsMan12 folded before Flop
Seat 5: Klemtonius (button) folded on the Flop
Seat 9: mnnm585 (small blind) folded before Flop



PokerStars Home Game Hand #227982436737: {DaPokaStars}  Hold'em No Limit (50/100) - 2021/07/01 15:21:06 ET
Table 'JULY 1' 9-max (Play Money) Seat #9 is the button
Seat 1: color_singleton (10770 in chips) 
Seat 2: HighCardJasper (10353 in chips) 
Seat 3: appositive (8972 in chips) 
Seat 4: PokerStarsMan12 (19906 in chips) 
Seat 5: Klemtonius (9429 in chips) 
Seat 9: mnnm585 (8911 in chips) 
color_singleton: posts small blind 50
HighCardJasper: posts big blind 100
*** HOLE CARDS ***
Dealt to PokerStarsMan12 [8c 3d]
appositive: folds 
PokerStarsMan12: calls 100
Klemtonius: calls 100
mnnm585: folds 
color_singleton: calls 50
HighCardJasper: checks 
*** FLOP *** [6h 6s 3h]
color_singleton: checks 
HighCardJasper: checks 
PokerStarsMan12: bets 200
Klemtonius: folds 
color_singleton: calls 200
HighCardJasper: folds 
*** TURN *** [6h 6s 3h] [5h]
color_singleton: checks 
PokerStarsMan12: checks 
*** RIVER *** [6h 6s 3h 5h] [6c]
color_singleton: bets 756
PokerStarsMan12: calls 756
*** SHOW DOWN ***
color_singleton: shows [2d 4d] (a straight, Deuce to Six)
PokerStarsMan12: shows [8c 3d] (a full house, Sixes full of Threes)
PokerStarsMan12 collected 2185 from pot
*** SUMMARY ***
Total pot 2312 | Rake 127 
Board [6h 6s 3h 5h 6c]
Seat 1: color_singleton (small blind) showed [2d 4d] and lost with a straight, Deuce to Six
Seat 2: HighCardJasper (big blind) folded on the Flop
Seat 3: appositive folded before Flop (didn't bet)
Seat 4: PokerStarsMan12 showed [8c 3d] and won (2185) with a full house, Sixes full of Threes
Seat 5: Klemtonius folded on the Flop
Seat 9: mnnm585 (button) folded before Flop (didn't bet)



PokerStars Home Game Hand #227982462808: {DaPokaStars}  Hold'em No Limit (50/100) - 2021/07/01 15:22:02 ET
Table 'JULY 1' 9-max (Play Money) Seat #1 is the button
Seat 1: color_singleton (9714 in chips) 
Seat 2: HighCardJasper (10253 in chips) 
Seat 3: appositive (8972 in chips) 
Seat 4: PokerStarsMan12 (21035 in chips) 
Seat 5: Klemtonius (9329 in chips) 
Seat 9: mnnm585 (8911 in chips) 
HighCardJasper: posts small blind 50
appositive: posts big blind 100
*** HOLE CARDS ***
Dealt to PokerStarsMan12 [Jc 4h]
PokerStarsMan12: folds 
Klemtonius: calls 100
mnnm585: calls 100
color_singleton: calls 100
HighCardJasper: calls 50
appositive: checks 
*** FLOP *** [Td 4c Ad]
HighCardJasper: checks 
appositive: checks 
Klemtonius: checks 
mnnm585: bets 236
color_singleton: folds 
HighCardJasper: calls 236
appositive: calls 236
Klemtonius: folds 
*** TURN *** [Td 4c Ad] [6c]
HighCardJasper: checks 
appositive: checks 
mnnm585: bets 571
HighCardJasper: folds 
appositive: folds 
Uncalled bet (571) returned to mnnm585
mnnm585 collected 1142 from pot
*** SUMMARY ***
Total pot 1208 | Rake 66 
Board [Td 4c Ad 6c]
Seat 1: color_singleton (button) folded on the Flop
Seat 2: HighCardJasper (small blind) folded on the Turn
Seat 3: appositive (big blind) folded on the Turn
Seat 4: PokerStarsMan12 folded before Flop (didn't bet)
Seat 5: Klemtonius folded on the Flop
Seat 9: mnnm585 collected (1142)



PokerStars Home Game Hand #227982495073: {DaPokaStars}  Hold'em No Limit (50/100) - 2021/07/01 15:23:11 ET
Table 'JULY 1' 9-max (Play Money) Seat #2 is the button
Seat 1: color_singleton (9614 in chips) 
Seat 2: HighCardJasper (9917 in chips) 
Seat 3: appositive (8636 in chips) 
Seat 4: PokerStarsMan12 (21035 in chips) 
Seat 5: Klemtonius (9229 in chips) 
Seat 9: mnnm585 (9717 in chips) 
appositive: posts small blind 50
PokerStarsMan12: posts big blind 100
*** HOLE CARDS ***
Dealt to PokerStarsMan12 [3c Td]
Klemtonius: calls 100
mnnm585: calls 100
color_singleton: folds 
HighCardJasper: folds 
appositive: calls 50
PokerStarsMan12: checks 
*** FLOP *** [Qd Ad 5s]
appositive: checks 
PokerStarsMan12: checks 
Klemtonius: checks 
mnnm585: checks 
*** TURN *** [Qd Ad 5s] [Jh]
appositive: checks 
PokerStarsMan12: checks 
Klemtonius: checks 
mnnm585: checks 
*** RIVER *** [Qd Ad 5s Jh] [Ts]
appositive: checks 
PokerStarsMan12: checks 
Klemtonius: checks 
mnnm585: checks 
*** SHOW DOWN ***
appositive: shows [4s 5d] (a pair of Fives)
PokerStarsMan12: shows [3c Td] (a pair of Tens)
Klemtonius: mucks hand 
mnnm585: mucks hand 
PokerStarsMan12 collected 378 from pot
*** SUMMARY ***
Total pot 400 | Rake 22 
Board [Qd Ad 5s Jh Ts]
Seat 1: color_singleton folded before Flop (didn't bet)
Seat 2: HighCardJasper (button) folded before Flop (didn't bet)
Seat 3: appositive (small blind) showed [4s 5d] and lost with a pair of Fives
Seat 4: PokerStarsMan12 (big blind) showed [3c Td] and won (378) with a pair of Tens
Seat 5: Klemtonius mucked [7c 4h]
Seat 9: mnnm585 mucked [6c 4c]



PokerStars Home Game Hand #227982524736: {DaPokaStars}  Hold'em No Limit (50/100) - 2021/07/01 15:24:16 ET
Table 'JULY 1' 9-max (Play Money) Seat #3 is the button
Seat 1: color_singleton (9614 in chips) 
Seat 2: HighCardJasper (9917 in chips) 
Seat 3: appositive (8536 in chips) 
Seat 4: PokerStarsMan12 (21313 in chips) 
Seat 5: Klemtonius (9129 in chips) 
Seat 9: mnnm585 (9617 in chips) 
PokerStarsMan12: posts small blind 50
Klemtonius: posts big blind 100
*** HOLE CARDS ***
Dealt to PokerStarsMan12 [3s 9h]
mnnm585 has timed out
mnnm585: folds 
color_singleton: folds 
HighCardJasper: calls 100
appositive: calls 100
PokerStarsMan12: calls 50
Klemtonius: raises 400 to 500
HighCardJasper: folds 
appositive: folds 
PokerStarsMan12: folds 
Uncalled bet (400) returned to Klemtonius
Klemtonius collected 400 from pot
Klemtonius: doesn't show hand 
*** SUMMARY ***
Total pot 400 | Rake 0 
Seat 1: color_singleton folded before Flop (didn't bet)
Seat 2: HighCardJasper folded before Flop
Seat 3: appositive (button) folded before Flop
Seat 4: PokerStarsMan12 (small blind) folded before Flop
Seat 5: Klemtonius (big blind) collected (400)
Seat 9: mnnm585 folded before Flop (didn't bet)



PokerStars Home Game Hand #227982542950: {DaPokaStars}  Hold'em No Limit (50/100) - 2021/07/01 15:24:55 ET
Table 'JULY 1' 9-max (Play Money) Seat #4 is the button
Seat 1: color_singleton (9614 in chips) 
Seat 2: HighCardJasper (9817 in chips) 
Seat 3: appositive (8436 in chips) 
Seat 4: PokerStarsMan12 (21213 in chips) 
Seat 5: Klemtonius (9429 in chips) 
Seat 9: mnnm585 (9617 in chips) 
Klemtonius: posts small blind 50
mnnm585: posts big blind 100
*** HOLE CARDS ***
Dealt to PokerStarsMan12 [6c Th]
color_singleton: folds 
HighCardJasper: raises 100 to 200
appositive: folds 
PokerStarsMan12: folds 
Klemtonius: raises 500 to 700
mnnm585: calls 600
HighCardJasper: calls 500
*** FLOP *** [Qd 5d Ah]
Klemtonius: checks 
mnnm585: bets 400
HighCardJasper: folds 
Klemtonius: raises 400 to 800
mnnm585: calls 400
*** TURN *** [Qd 5d Ah] [Tc]
Klemtonius: bets 1748
mnnm585: raises 1748 to 3496
Klemtonius: calls 1748
*** RIVER *** [Qd 5d Ah Tc] [9s]
Klemtonius: bets 4433 and is all-in
mnnm585: calls 4433
*** SHOW DOWN ***
Klemtonius: shows [As Ks] (a pair of Aces)
mnnm585: shows [Td Ts] (three of a kind, Tens)
mnnm585 collected 18482 from pot
*** SUMMARY ***
Total pot 19558 | Rake 1076 
Board [Qd 5d Ah Tc 9s]
Seat 1: color_singleton folded before Flop (didn't bet)
Seat 2: HighCardJasper folded on the Flop
Seat 3: appositive folded before Flop (didn't bet)
Seat 4: PokerStarsMan12 (button) folded before Flop (didn't bet)
Seat 5: Klemtonius (small blind) showed [As Ks] and lost with a pair of Aces
Seat 9: mnnm585 (big blind) showed [Td Ts] and won (18482) with three of a kind, Tens



PokerStars Home Game Hand #227982581941: {DaPokaStars}  Hold'em No Limit (50/100) - 2021/07/01 15:26:20 ET
Table 'JULY 1' 9-max (Play Money) Seat #9 is the button
Seat 1: color_singleton (9614 in chips) 
Seat 2: HighCardJasper (9117 in chips) 
Seat 3: appositive (8436 in chips) 
Seat 4: PokerStarsMan12 (21213 in chips) 
Seat 9: mnnm585 (18670 in chips) 
color_singleton: posts small blind 50
HighCardJasper: posts big blind 100
*** HOLE CARDS ***
Dealt to PokerStarsMan12 [7c 4s]
appositive: calls 100
PokerStarsMan12: folds 
mnnm585: folds 
color_singleton: raises 200 to 300
HighCardJasper: folds 
appositive: calls 200
*** FLOP *** [9c Qc Jd]
color_singleton: bets 200
appositive: raises 200 to 400
color_singleton: calls 200
*** TURN *** [9c Qc Jd] [7h]
color_singleton: checks 
appositive: bets 708
color_singleton: raises 708 to 1416
appositive: raises 708 to 2124
color_singleton: raises 6476 to 8600
appositive: calls 5612 and is all-in
Uncalled bet (864) returned to color_singleton
*** RIVER *** [9c Qc Jd 7h] [4h]
*** SHOW DOWN ***
color_singleton: shows [Kc Td] (a straight, Nine to King)
appositive: shows [Js Jc] (three of a kind, Jacks)
color_singleton collected 16039 from pot
*** SUMMARY ***
Total pot 16972 | Rake 933 
Board [9c Qc Jd 7h 4h]
Seat 1: color_singleton (small blind) showed [Kc Td] and won (16039) with a straight, Nine to King
Seat 2: HighCardJasper (big blind) folded before Flop
Seat 3: appositive showed [Js Jc] and lost with three of a kind, Jacks
Seat 4: PokerStarsMan12 folded before Flop (didn't bet)
Seat 9: mnnm585 (button) folded before Flop (didn't bet)



PokerStars Home Game Hand #227982607794: {DaPokaStars}  Hold'em No Limit (50/100) - 2021/07/01 15:27:16 ET
Table 'JULY 1' 9-max (Play Money) Seat #1 is the button
Seat 1: color_singleton (17217 in chips) 
Seat 2: HighCardJasper (9017 in chips) 
Seat 4: PokerStarsMan12 (21213 in chips) 
Seat 9: mnnm585 (18670 in chips) 
HighCardJasper: posts small blind 50
PokerStarsMan12: posts big blind 100
*** HOLE CARDS ***
Dealt to PokerStarsMan12 [Ks 5h]
mnnm585: calls 100
color_singleton: folds 
HighCardJasper: calls 50
PokerStarsMan12: checks 
*** FLOP *** [6h 8c Ts]
HighCardJasper: checks 
PokerStarsMan12: checks 
mnnm585: checks 
*** TURN *** [6h 8c Ts] [4h]
HighCardJasper: checks 
PokerStarsMan12: checks 
mnnm585: checks 
*** RIVER *** [6h 8c Ts 4h] [9h]
HighCardJasper: bets 141
PokerStarsMan12: folds 
mnnm585: folds 
Uncalled bet (141) returned to HighCardJasper
HighCardJasper collected 283 from pot
HighCardJasper: doesn't show hand 
*** SUMMARY ***
Total pot 300 | Rake 17 
Board [6h 8c Ts 4h 9h]
Seat 1: color_singleton (button) folded before Flop (didn't bet)
Seat 2: HighCardJasper (small blind) collected (283)
Seat 4: PokerStarsMan12 (big blind) folded on the River
Seat 9: mnnm585 folded on the River



PokerStars Home Game Hand #227982634899: {DaPokaStars}  Hold'em No Limit (50/100) - 2021/07/01 15:28:14 ET
Table 'JULY 1' 9-max (Play Money) Seat #2 is the button
Seat 1: color_singleton (17217 in chips) 
Seat 2: HighCardJasper (9200 in chips) 
Seat 4: PokerStarsMan12 (21113 in chips) 
Seat 5: Klemtonius (10000 in chips) 
Seat 9: mnnm585 (18570 in chips) 
PokerStarsMan12: posts small blind 50
Klemtonius: posts big blind 100
*** HOLE CARDS ***
Dealt to PokerStarsMan12 [8c 6d]
mnnm585: folds 
color_singleton: raises 100 to 200
HighCardJasper: calls 200
PokerStarsMan12: calls 150
Klemtonius: raises 100 to 300
color_singleton: calls 100
HighCardJasper: calls 100
PokerStarsMan12: calls 100
*** FLOP *** [5s Kc 3s]
PokerStarsMan12: checks 
Klemtonius: checks 
color_singleton: checks 
HighCardJasper: checks 
*** TURN *** [5s Kc 3s] [9d]
PokerStarsMan12: checks 
Klemtonius: checks 
color_singleton: checks 
HighCardJasper: checks 
*** RIVER *** [5s Kc 3s 9d] [8s]
PokerStarsMan12: bets 567
Klemtonius: folds 
color_singleton: folds 
HighCardJasper: folds 
Uncalled bet (567) returned to PokerStarsMan12
PokerStarsMan12 collected 1134 from pot
*** SUMMARY ***
Total pot 1200 | Rake 66 
Board [5s Kc 3s 9d 8s]
Seat 1: color_singleton folded on the River
Seat 2: HighCardJasper (button) folded on the River
Seat 4: PokerStarsMan12 (small blind) collected (1134)
Seat 5: Klemtonius (big blind) folded on the River
Seat 9: mnnm585 folded before Flop (didn't bet)



PokerStars Home Game Hand #227982678840: {DaPokaStars}  Hold'em No Limit (50/100) - 2021/07/01 15:29:50 ET
Table 'JULY 1' 9-max (Play Money) Seat #4 is the button
Seat 1: color_singleton (16917 in chips) 
Seat 2: HighCardJasper (8900 in chips) 
Seat 4: PokerStarsMan12 (21947 in chips) 
Seat 5: Klemtonius (9700 in chips) 
Seat 9: mnnm585 (18570 in chips) 
Klemtonius: posts small blind 50
mnnm585: posts big blind 100
*** HOLE CARDS ***
Dealt to PokerStarsMan12 [9h 7s]
color_singleton: folds 
HighCardJasper: raises 100 to 200
PokerStarsMan12: folds 
Klemtonius: calls 150
mnnm585: calls 100
*** FLOP *** [Ks Qc Kh]
Klemtonius: checks 
mnnm585: bets 283
HighCardJasper: folds 
Klemtonius: folds 
Uncalled bet (283) returned to mnnm585
mnnm585 collected 567 from pot
*** SUMMARY ***
Total pot 600 | Rake 33 
Board [Ks Qc Kh]
Seat 1: color_singleton folded before Flop (didn't bet)
Seat 2: HighCardJasper folded on the Flop
Seat 4: PokerStarsMan12 (button) folded before Flop (didn't bet)
Seat 5: Klemtonius (small blind) folded on the Flop
Seat 9: mnnm585 (big blind) collected (567)



PokerStars Home Game Hand #227982697016: {DaPokaStars}  Hold'em No Limit (50/100) - 2021/07/01 15:30:29 ET
Table 'JULY 1' 9-max (Play Money) Seat #5 is the button
Seat 1: color_singleton (16917 in chips) 
Seat 2: HighCardJasper (8700 in chips) 
Seat 4: PokerStarsMan12 (21947 in chips) 
Seat 5: Klemtonius (9500 in chips) 
Seat 9: mnnm585 (18937 in chips) 
mnnm585: posts small blind 50
color_singleton: posts big blind 100
*** HOLE CARDS ***
Dealt to PokerStarsMan12 [3h 5h]
HighCardJasper: folds 
PokerStarsMan12: calls 100
Klemtonius: calls 100
mnnm585: calls 50
color_singleton: checks 
*** FLOP *** [Qs As 6d]
mnnm585: checks 
color_singleton: bets 189
PokerStarsMan12: folds 
Klemtonius: folds 
mnnm585: folds 
Uncalled bet (189) returned to color_singleton
color_singleton collected 378 from pot
color_singleton: doesn't show hand 
*** SUMMARY ***
Total pot 400 | Rake 22 
Board [Qs As 6d]
Seat 1: color_singleton (big blind) collected (378)
Seat 2: HighCardJasper folded before Flop (didn't bet)
Seat 4: PokerStarsMan12 folded on the Flop
Seat 5: Klemtonius (button) folded on the Flop
Seat 9: mnnm585 (small blind) folded on the Flop



PokerStars Home Game Hand #227982712605: {DaPokaStars}  Hold'em No Limit (50/100) - 2021/07/01 15:31:03 ET
Table 'JULY 1' 9-max (Play Money) Seat #9 is the button
Seat 1: color_singleton (17195 in chips) 
Seat 2: HighCardJasper (8700 in chips) 
Seat 4: PokerStarsMan12 (21847 in chips) 
Seat 5: Klemtonius (9400 in chips) 
Seat 9: mnnm585 (18837 in chips) 
color_singleton: posts small blind 50
HighCardJasper: posts big blind 100
*** HOLE CARDS ***
Dealt to PokerStarsMan12 [8c 2h]
PokerStarsMan12: folds 
Klemtonius: calls 100
mnnm585: folds 
color_singleton: calls 50
HighCardJasper: checks 
*** FLOP *** [3h Tc Ks]
color_singleton: checks 
HighCardJasper: checks 
Klemtonius: bets 100
color_singleton: calls 100
HighCardJasper: calls 100
*** TURN *** [3h Tc Ks] [9c]
color_singleton: checks 
HighCardJasper: checks 
Klemtonius: bets 567
color_singleton: calls 567
HighCardJasper: folds 
*** RIVER *** [3h Tc Ks 9c] [Jc]
color_singleton: checks 
Klemtonius: checks 
*** SHOW DOWN ***
color_singleton: shows [7s Kd] (a pair of Kings)
Klemtonius: shows [Kh 4h] (a pair of Kings)
color_singleton collected 820 from pot
Klemtonius collected 819 from pot
*** SUMMARY ***
Total pot 1734 | Rake 95 
Board [3h Tc Ks 9c Jc]
Seat 1: color_singleton (small blind) showed [7s Kd] and won (820) with a pair of Kings
Seat 2: HighCardJasper (big blind) folded on the Turn
Seat 4: PokerStarsMan12 folded before Flop (didn't bet)
Seat 5: Klemtonius showed [Kh 4h] and won (819) with a pair of Kings
Seat 9: mnnm585 (button) folded before Flop (didn't bet)



PokerStars Home Game Hand #227982739291: {DaPokaStars}  Hold'em No Limit (50/100) - 2021/07/01 15:32:00 ET
Table 'JULY 1' 9-max (Play Money) Seat #1 is the button
Seat 1: color_singleton (17248 in chips) 
Seat 2: HighCardJasper (8500 in chips) 
Seat 4: PokerStarsMan12 (21847 in chips) 
Seat 5: Klemtonius (9452 in chips) 
Seat 9: mnnm585 (18837 in chips) 
HighCardJasper: posts small blind 50
PokerStarsMan12: posts big blind 100
*** HOLE CARDS ***
Dealt to PokerStarsMan12 [5h 4h]
Klemtonius: calls 100
mnnm585: calls 100
color_singleton: calls 100
HighCardJasper: calls 50
PokerStarsMan12: checks 
*** FLOP *** [Js Ad Ts]
HighCardJasper: checks 
PokerStarsMan12: checks 
Klemtonius: checks 
mnnm585: checks 
color_singleton: checks 
*** TURN *** [Js Ad Ts] [Ks]
HighCardJasper: checks 
PokerStarsMan12: checks 
Klemtonius: bets 472
mnnm585: folds 
color_singleton: folds 
HighCardJasper: folds 
PokerStarsMan12: folds 
Uncalled bet (472) returned to Klemtonius
Klemtonius collected 472 from pot
Klemtonius: doesn't show hand 
*** SUMMARY ***
Total pot 500 | Rake 28 
Board [Js Ad Ts Ks]
Seat 1: color_singleton (button) folded on the Turn
Seat 2: HighCardJasper (small blind) folded on the Turn
Seat 4: PokerStarsMan12 (big blind) folded on the Turn
Seat 5: Klemtonius collected (472)
Seat 9: mnnm585 folded on the Turn



PokerStars Home Game Hand #227982767057: {DaPokaStars}  Hold'em No Limit (50/100) - 2021/07/01 15:33:00 ET
Table 'JULY 1' 9-max (Play Money) Seat #2 is the button
Seat 1: color_singleton (17148 in chips) 
Seat 2: HighCardJasper (8400 in chips) 
Seat 4: PokerStarsMan12 (21747 in chips) 
Seat 5: Klemtonius (9824 in chips) 
Seat 9: mnnm585 (18737 in chips) 
PokerStarsMan12: posts small blind 50
Klemtonius: posts big blind 100
*** HOLE CARDS ***
Dealt to PokerStarsMan12 [8h 7h]
mnnm585: folds 
color_singleton: folds 
HighCardJasper: calls 100
PokerStarsMan12: calls 50
Klemtonius: checks 
*** FLOP *** [Th 8s 3c]
PokerStarsMan12: bets 200
Klemtonius: folds 
HighCardJasper: folds 
Uncalled bet (200) returned to PokerStarsMan12
PokerStarsMan12 collected 283 from pot
*** SUMMARY ***
Total pot 300 | Rake 17 
Board [Th 8s 3c]
Seat 1: color_singleton folded before Flop (didn't bet)
Seat 2: HighCardJasper (button) folded on the Flop
Seat 4: PokerStarsMan12 (small blind) collected (283)
Seat 5: Klemtonius (big blind) folded on the Flop
Seat 9: mnnm585 folded before Flop (didn't bet)



PokerStars Home Game Hand #227982779931: {DaPokaStars}  Hold'em No Limit (50/100) - 2021/07/01 15:33:27 ET
Table 'JULY 1' 9-max (Play Money) Seat #4 is the button
Seat 1: color_singleton (17148 in chips) 
Seat 2: HighCardJasper (8300 in chips) 
Seat 4: PokerStarsMan12 (21930 in chips) 
Seat 5: Klemtonius (9724 in chips) 
Seat 9: mnnm585 (18737 in chips) 
Klemtonius: posts small blind 50
mnnm585: posts big blind 100
*** HOLE CARDS ***
Dealt to PokerStarsMan12 [9s 5d]
color_singleton: raises 100 to 200
HighCardJasper: calls 200
PokerStarsMan12: folds 
Klemtonius: calls 150
mnnm585: calls 100
*** FLOP *** [4c As 6h]
Klemtonius: checks 
mnnm585: bets 100
color_singleton: calls 100
HighCardJasper: calls 100
Klemtonius: folds 
*** TURN *** [4c As 6h] [5h]
mnnm585: bets 100
color_singleton: raises 500 to 600
HighCardJasper: folds 
mnnm585: calls 500
*** RIVER *** [4c As 6h 5h] [8d]
mnnm585: checks 
color_singleton: checks 
*** SHOW DOWN ***
mnnm585: shows [Qs Qc] (a pair of Queens)
color_singleton: shows [Kd Ad] (a pair of Aces)
color_singleton collected 2173 from pot
*** SUMMARY ***
Total pot 2300 | Rake 127 
Board [4c As 6h 5h 8d]
Seat 1: color_singleton showed [Kd Ad] and won (2173) with a pair of Aces
Seat 2: HighCardJasper folded on the Turn
Seat 4: PokerStarsMan12 (button) folded before Flop (didn't bet)
Seat 5: Klemtonius (small blind) folded on the Flop
Seat 9: mnnm585 (big blind) showed [Qs Qc] and lost with a pair of Queens



PokerStars Home Game Hand #227982806845: {DaPokaStars}  Hold'em No Limit (50/100) - 2021/07/01 15:34:25 ET
Table 'JULY 1' 9-max (Play Money) Seat #5 is the button
Seat 1: color_singleton (18421 in chips) 
Seat 2: HighCardJasper (8000 in chips) 
Seat 4: PokerStarsMan12 (21930 in chips) 
Seat 5: Klemtonius (9524 in chips) 
Seat 9: mnnm585 (17837 in chips) 
mnnm585: posts small blind 50
color_singleton: posts big blind 100
*** HOLE CARDS ***
Dealt to PokerStarsMan12 [7s Th]
HighCardJasper: calls 100
PokerStarsMan12: folds 
Klemtonius: raises 350 to 450
mnnm585: calls 400
color_singleton: calls 350
HighCardJasper: folds 
*** FLOP *** [9c Jh 8c]
mnnm585: bets 100
color_singleton: calls 100
Klemtonius: raises 835 to 935
mnnm585: folds 
color_singleton: folds 
Uncalled bet (835) returned to Klemtonius
Klemtonius collected 1654 from pot
Klemtonius: doesn't show hand 
*** SUMMARY ***
Total pot 1750 | Rake 96 
Board [9c Jh 8c]
Seat 1: color_singleton (big blind) folded on the Flop
Seat 2: HighCardJasper folded before Flop
Seat 4: PokerStarsMan12 folded before Flop (didn't bet)
Seat 5: Klemtonius (button) collected (1654)
Seat 9: mnnm585 (small blind) folded on the Flop



PokerStars Home Game Hand #227982828627: {DaPokaStars}  Hold'em No Limit (50/100) - 2021/07/01 15:35:12 ET
Table 'JULY 1' 9-max (Play Money) Seat #9 is the button
Seat 1: color_singleton (17871 in chips) 
Seat 2: HighCardJasper (7900 in chips) 
Seat 4: PokerStarsMan12 (21930 in chips) 
Seat 5: Klemtonius (10628 in chips) 
Seat 9: mnnm585 (17287 in chips) 
color_singleton: posts small blind 50
HighCardJasper: posts big blind 100
*** HOLE CARDS ***
Dealt to PokerStarsMan12 [8c Td]
PokerStarsMan12: folds 
Klemtonius: calls 100
mnnm585: folds 
color_singleton: calls 50
HighCardJasper: checks 
*** FLOP *** [3c 2h Ts]
color_singleton: checks 
HighCardJasper: checks 
Klemtonius: bets 283
color_singleton: folds 
HighCardJasper: calls 283
*** TURN *** [3c 2h Ts] [Kc]
HighCardJasper: checks 
Klemtonius: checks 
*** RIVER *** [3c 2h Ts Kc] [2c]
HighCardJasper: checks 
Klemtonius: checks 
*** SHOW DOWN ***
HighCardJasper: shows [9c As] (a pair of Deuces)
Klemtonius: mucks hand 
HighCardJasper collected 818 from pot
*** SUMMARY ***
Total pot 866 | Rake 48 
Board [3c 2h Ts Kc 2c]
Seat 1: color_singleton (small blind) folded on the Flop
Seat 2: HighCardJasper (big blind) showed [9c As] and won (818) with a pair of Deuces
Seat 4: PokerStarsMan12 folded before Flop (didn't bet)
Seat 5: Klemtonius mucked [Qs 6d]
Seat 9: mnnm585 (button) folded before Flop (didn't bet)



PokerStars Home Game Hand #227982856603: {DaPokaStars}  Hold'em No Limit (50/100) - 2021/07/01 15:36:13 ET
Table 'JULY 1' 9-max (Play Money) Seat #1 is the button
Seat 1: color_singleton (17771 in chips) 
Seat 2: HighCardJasper (8335 in chips) 
Seat 4: PokerStarsMan12 (21930 in chips) 
Seat 5: Klemtonius (10245 in chips) 
HighCardJasper: posts small blind 50
PokerStarsMan12: posts big blind 100
*** HOLE CARDS ***
Dealt to PokerStarsMan12 [3c 3s]
Klemtonius: raises 250 to 350
color_singleton: calls 350
HighCardJasper: folds 
PokerStarsMan12: calls 250
*** FLOP *** [8s Th 4h]
PokerStarsMan12: checks 
Klemtonius: bets 1039
color_singleton: calls 1039
PokerStarsMan12: folds 
*** TURN *** [8s Th 4h] [Ac]
Klemtonius: bets 3003
color_singleton: folds 
Uncalled bet (3003) returned to Klemtonius
Klemtonius collected 3003 from pot
Klemtonius: doesn't show hand 
*** SUMMARY ***
Total pot 3178 | Rake 175 
Board [8s Th 4h Ac]
Seat 1: color_singleton (button) folded on the Turn
Seat 2: HighCardJasper (small blind) folded before Flop
Seat 4: PokerStarsMan12 (big blind) folded on the Flop
Seat 5: Klemtonius collected (3003)



PokerStars Home Game Hand #227982880033: {DaPokaStars}  Hold'em No Limit (50/100) - 2021/07/01 15:36:53 ET
Table 'JULY 1' 9-max (Play Money) Seat #2 is the button
Seat 1: color_singleton (16382 in chips) 
Seat 2: HighCardJasper (8285 in chips) 
Seat 4: PokerStarsMan12 (21580 in chips) 
Seat 5: Klemtonius (11859 in chips) 
PokerStarsMan12: posts small blind 50
Klemtonius: posts big blind 100
*** HOLE CARDS ***
Dealt to PokerStarsMan12 [8h Jh]
color_singleton: folds 
HighCardJasper: calls 100
PokerStarsMan12: calls 50
Klemtonius: raises 200 to 300
HighCardJasper: calls 200
PokerStarsMan12: calls 200
*** FLOP *** [9s 4c 3d]
PokerStarsMan12: checks 
Klemtonius: checks 
HighCardJasper: bets 425
PokerStarsMan12: folds 
Klemtonius: calls 425
*** TURN *** [9s 4c 3d] [8s]
Klemtonius: checks 
HighCardJasper: checks 
*** RIVER *** [9s 4c 3d 8s] [Kd]
Klemtonius: checks 
HighCardJasper: bets 827
Klemtonius: folds 
Uncalled bet (827) returned to HighCardJasper
HighCardJasper collected 1654 from pot
HighCardJasper: doesn't show hand 
*** SUMMARY ***
Total pot 1750 | Rake 96 
Board [9s 4c 3d 8s Kd]
Seat 1: color_singleton folded before Flop (didn't bet)
Seat 2: HighCardJasper (button) collected (1654)
Seat 4: PokerStarsMan12 (small blind) folded on the Flop
Seat 5: Klemtonius (big blind) folded on the River



PokerStars Home Game Hand #227982904588: {DaPokaStars}  Hold'em No Limit (50/100) - 2021/07/01 15:37:46 ET
Table 'JULY 1' 9-max (Play Money) Seat #4 is the button
Seat 1: color_singleton (16382 in chips) 
Seat 2: HighCardJasper (9214 in chips) 
Seat 4: PokerStarsMan12 (21280 in chips) 
Seat 5: Klemtonius (11134 in chips) 
Klemtonius: posts small blind 50
color_singleton: posts big blind 100
*** HOLE CARDS ***
Dealt to PokerStarsMan12 [8s 2h]
HighCardJasper: folds 
PokerStarsMan12: folds 
Klemtonius: calls 50
color_singleton: checks 
*** FLOP *** [4d Th 3c]
Klemtonius: checks 
color_singleton: checks 
*** TURN *** [4d Th 3c] [6c]
Klemtonius: checks 
color_singleton: checks 
*** RIVER *** [4d Th 3c 6c] [4c]
Klemtonius: checks 
color_singleton: checks 
*** SHOW DOWN ***
Klemtonius: shows [2d Qs] (a pair of Fours)
color_singleton: shows [Qd 2s] (a pair of Fours)
Klemtonius collected 95 from pot
color_singleton collected 94 from pot
*** SUMMARY ***
Total pot 200 | Rake 11 
Board [4d Th 3c 6c 4c]
Seat 1: color_singleton (big blind) showed [Qd 2s] and won (94) with a pair of Fours
Seat 2: HighCardJasper folded before Flop (didn't bet)
Seat 4: PokerStarsMan12 (button) folded before Flop (didn't bet)
Seat 5: Klemtonius (small blind) showed [2d Qs] and won (95) with a pair of Fours



PokerStars Home Game Hand #227982921128: {DaPokaStars}  Hold'em No Limit (50/100) - 2021/07/01 15:38:21 ET
Table 'JULY 1' 9-max (Play Money) Seat #5 is the button
Seat 1: color_singleton (16376 in chips) 
Seat 2: HighCardJasper (9214 in chips) 
Seat 4: PokerStarsMan12 (21280 in chips) 
Seat 5: Klemtonius (11129 in chips) 
color_singleton: posts small blind 50
HighCardJasper: posts big blind 100
*** HOLE CARDS ***
Dealt to PokerStarsMan12 [4c Kc]
PokerStarsMan12: calls 100
Klemtonius: raises 300 to 400
color_singleton: folds 
HighCardJasper: folds 
PokerStarsMan12: folds 
Uncalled bet (300) returned to Klemtonius
Klemtonius collected 350 from pot
Klemtonius: doesn't show hand 
*** SUMMARY ***
Total pot 350 | Rake 0 
Seat 1: color_singleton (small blind) folded before Flop
Seat 2: HighCardJasper (big blind) folded before Flop
Seat 4: PokerStarsMan12 folded before Flop
Seat 5: Klemtonius (button) collected (350)



PokerStars Home Game Hand #227982934677: {DaPokaStars}  Hold'em No Limit (50/100) - 2021/07/01 15:38:50 ET
Table 'JULY 1' 9-max (Play Money) Seat #1 is the button
Seat 1: color_singleton (16326 in chips) 
Seat 2: HighCardJasper (9114 in chips) 
Seat 4: PokerStarsMan12 (21180 in chips) 
Seat 5: Klemtonius (11379 in chips) 
Seat 9: mnnm585 (17287 in chips) 
HighCardJasper: posts small blind 50
PokerStarsMan12: posts big blind 100
mnnm585: posts small & big blinds 150
*** HOLE CARDS ***
Dealt to PokerStarsMan12 [Qd 8c]
Klemtonius: calls 100
mnnm585: raises 100 to 200
color_singleton: calls 200
HighCardJasper: folds 
PokerStarsMan12: calls 100
Klemtonius: calls 100
*** FLOP *** [Ts 3h 7h]
PokerStarsMan12: checks 
Klemtonius: checks 
mnnm585: bets 100
color_singleton: calls 100
PokerStarsMan12: folds 
Klemtonius: calls 100
*** TURN *** [Ts 3h 7h] [6c]
Klemtonius: checks 
mnnm585: checks 
color_singleton: checks 
*** RIVER *** [Ts 3h 7h 6c] [4h]
Klemtonius: checks 
mnnm585: bets 100
color_singleton: calls 100
Klemtonius: folds 
*** SHOW DOWN ***
mnnm585: shows [7d Jd] (a pair of Sevens)
color_singleton: mucks hand 
mnnm585 collected 1323 from pot
*** SUMMARY ***
Total pot 1400 | Rake 77 
Board [Ts 3h 7h 6c 4h]
Seat 1: color_singleton (button) mucked [2d Ad]
Seat 2: HighCardJasper (small blind) folded before Flop
Seat 4: PokerStarsMan12 (big blind) folded on the Flop
Seat 5: Klemtonius folded on the River
Seat 9: mnnm585 showed [7d Jd] and won (1323) with a pair of Sevens



PokerStars Home Game Hand #227982970644: {DaPokaStars}  Hold'em No Limit (50/100) - 2021/07/01 15:40:07 ET
Table 'JULY 1' 9-max (Play Money) Seat #2 is the button
Seat 1: color_singleton (15926 in chips) 
Seat 2: HighCardJasper (9064 in chips) 
Seat 4: PokerStarsMan12 (20980 in chips) 
Seat 5: Klemtonius (11079 in chips) 
Seat 9: mnnm585 (18160 in chips) 
PokerStarsMan12: posts small blind 50
Klemtonius: posts big blind 100
*** HOLE CARDS ***
Dealt to PokerStarsMan12 [Td Kh]
mnnm585: folds 
color_singleton: folds 
HighCardJasper: folds 
PokerStarsMan12: raises 300 to 400
Klemtonius: calls 300
*** FLOP *** [3d 2c 5s]
PokerStarsMan12: checks 
Klemtonius: checks 
*** TURN *** [3d 2c 5s] [6s]
PokerStarsMan12: checks 
Klemtonius: bets 378
PokerStarsMan12: calls 378
*** RIVER *** [3d 2c 5s 6s] [4d]
PokerStarsMan12: checks 
Klemtonius: checks 
*** SHOW DOWN ***
PokerStarsMan12: shows [Td Kh] (a straight, Deuce to Six)
Klemtonius: shows [Th 4h] (a straight, Deuce to Six)
PokerStarsMan12 collected 735 from pot
Klemtonius collected 735 from pot
*** SUMMARY ***
Total pot 1556 | Rake 86 
Board [3d 2c 5s 6s 4d]
Seat 1: color_singleton folded before Flop (didn't bet)
Seat 2: HighCardJasper (button) folded before Flop (didn't bet)
Seat 4: PokerStarsMan12 (small blind) showed [Td Kh] and won (735) with a straight, Deuce to Six
Seat 5: Klemtonius (big blind) showed [Th 4h] and won (735) with a straight, Deuce to Six
Seat 9: mnnm585 folded before Flop (didn't bet)



PokerStars Home Game Hand #227982986047: {DaPokaStars}  Hold'em No Limit (50/100) - 2021/07/01 15:40:40 ET
Table 'JULY 1' 9-max (Play Money) Seat #4 is the button
Seat 1: color_singleton (15926 in chips) 
Seat 2: HighCardJasper (9064 in chips) 
Seat 4: PokerStarsMan12 (20937 in chips) 
Seat 5: Klemtonius (11036 in chips) 
Seat 9: mnnm585 (18160 in chips) 
Klemtonius: posts small blind 50
mnnm585: posts big blind 100
*** HOLE CARDS ***
Dealt to PokerStarsMan12 [9h 7h]
color_singleton: raises 100 to 200
HighCardJasper: calls 200
PokerStarsMan12: folds 
Klemtonius: calls 150
mnnm585: folds 
*** FLOP *** [Js 6h Tc]
Klemtonius: checks 
color_singleton: checks 
HighCardJasper: checks 
*** TURN *** [Js 6h Tc] [4s]
Klemtonius: checks 
color_singleton: checks 
HighCardJasper: checks 
*** RIVER *** [Js 6h Tc 4s] [2d]
Klemtonius: checks 
color_singleton: checks 
HighCardJasper: checks 
*** SHOW DOWN ***
Klemtonius: shows [Ah Qd] (high card Ace)
color_singleton: mucks hand 
HighCardJasper: mucks hand 
Klemtonius collected 661 from pot
*** SUMMARY ***
Total pot 700 | Rake 39 
Board [Js 6h Tc 4s 2d]
Seat 1: color_singleton mucked [Ad 3s]
Seat 2: HighCardJasper mucked [Ks 5c]
Seat 4: PokerStarsMan12 (button) folded before Flop (didn't bet)
Seat 5: Klemtonius (small blind) showed [Ah Qd] and won (661) with high card Ace
Seat 9: mnnm585 (big blind) folded before Flop



PokerStars Home Game Hand #227983009757: {DaPokaStars}  Hold'em No Limit (50/100) - 2021/07/01 15:41:31 ET
Table 'JULY 1' 9-max (Play Money) Seat #5 is the button
Seat 1: color_singleton (15726 in chips) 
Seat 2: HighCardJasper (8864 in chips) 
Seat 4: PokerStarsMan12 (20937 in chips) 
Seat 5: Klemtonius (11497 in chips) 
Seat 9: mnnm585 (18060 in chips) 
mnnm585: posts small blind 50
color_singleton: posts big blind 100
*** HOLE CARDS ***
Dealt to PokerStarsMan12 [8s 9c]
HighCardJasper: raises 100 to 200
PokerStarsMan12: calls 200
Klemtonius: calls 200
mnnm585: folds 
color_singleton: calls 100
*** FLOP *** [4d 6h 8d]
color_singleton: checks 
HighCardJasper: checks 
PokerStarsMan12: bets 400
Klemtonius: folds 
color_singleton: folds 
HighCardJasper: folds 
Uncalled bet (400) returned to PokerStarsMan12
PokerStarsMan12 collected 803 from pot
*** SUMMARY ***
Total pot 850 | Rake 47 
Board [4d 6h 8d]
Seat 1: color_singleton (big blind) folded on the Flop
Seat 2: HighCardJasper folded on the Flop
Seat 4: PokerStarsMan12 collected (803)
Seat 5: Klemtonius (button) folded on the Flop
Seat 9: mnnm585 (small blind) folded before Flop



PokerStars Home Game Hand #227983028224: {DaPokaStars}  Hold'em No Limit (50/100) - 2021/07/01 15:42:10 ET
Table 'JULY 1' 9-max (Play Money) Seat #9 is the button
Seat 1: color_singleton (15526 in chips) 
Seat 2: HighCardJasper (8664 in chips) 
Seat 4: PokerStarsMan12 (21540 in chips) 
Seat 5: Klemtonius (11297 in chips) 
Seat 9: mnnm585 (18010 in chips) 
color_singleton: posts small blind 50
HighCardJasper: posts big blind 100
*** HOLE CARDS ***
Dealt to PokerStarsMan12 [6d 2c]
PokerStarsMan12: folds 
Klemtonius: raises 100 to 200
mnnm585: folds 
color_singleton: folds 
HighCardJasper: calls 100
*** FLOP *** [8h 6c 2d]
HighCardJasper: checks 
Klemtonius: checks 
*** TURN *** [8h 6c 2d] [Ts]
HighCardJasper: bets 212
Klemtonius: calls 212
*** RIVER *** [8h 6c 2d Ts] [9c]
HighCardJasper: checks 
Klemtonius: checks 
*** SHOW DOWN ***
HighCardJasper: shows [3c Qd] (high card Queen)
Klemtonius: shows [9d Jd] (a pair of Nines)
Klemtonius collected 826 from pot
*** SUMMARY ***
Total pot 874 | Rake 48 
Board [8h 6c 2d Ts 9c]
Seat 1: color_singleton (small blind) folded before Flop
Seat 2: HighCardJasper (big blind) showed [3c Qd] and lost with high card Queen
Seat 4: PokerStarsMan12 folded before Flop (didn't bet)
Seat 5: Klemtonius showed [9d Jd] and won (826) with a pair of Nines
Seat 9: mnnm585 (button) folded before Flop (didn't bet)



PokerStars Home Game Hand #227983061108: {DaPokaStars}  Hold'em No Limit (50/100) - 2021/07/01 15:43:04 ET
Table 'JULY 1' 9-max (Play Money) Seat #1 is the button
Seat 1: color_singleton (15476 in chips) 
Seat 2: HighCardJasper (8252 in chips) 
Seat 4: PokerStarsMan12 (21540 in chips) 
Seat 5: Klemtonius (11711 in chips) 
Seat 9: mnnm585 (18010 in chips) 
HighCardJasper: posts small blind 50
PokerStarsMan12: posts big blind 100
*** HOLE CARDS ***
Dealt to PokerStarsMan12 [2c 6d]
Klemtonius: calls 100
mnnm585: raises 100 to 200
color_singleton: calls 200
HighCardJasper: calls 150
PokerStarsMan12: folds 
Klemtonius: calls 100
*** FLOP *** [Ac Th 3s]
HighCardJasper: checks 
Klemtonius: checks 
mnnm585: bets 100
color_singleton: calls 100
HighCardJasper: folds 
Klemtonius: calls 100
*** TURN *** [Ac Th 3s] [6c]
Klemtonius: checks 
mnnm585: bets 100
color_singleton: raises 400 to 500
Klemtonius: folds 
mnnm585: folds 
Uncalled bet (400) returned to color_singleton
color_singleton collected 1323 from pot
color_singleton: doesn't show hand 
*** SUMMARY ***
Total pot 1400 | Rake 77 
Board [Ac Th 3s 6c]
Seat 1: color_singleton (button) collected (1323)
Seat 2: HighCardJasper (small blind) folded on the Flop
Seat 4: PokerStarsMan12 (big blind) folded before Flop
Seat 5: Klemtonius folded on the Turn
Seat 9: mnnm585 folded on the Turn



PokerStars Home Game Hand #227983095859: {DaPokaStars}  Hold'em No Limit (50/100) - 2021/07/01 15:44:19 ET
Table 'JULY 1' 9-max (Play Money) Seat #2 is the button
Seat 1: color_singleton (16399 in chips) 
Seat 2: HighCardJasper (8052 in chips) 
Seat 4: PokerStarsMan12 (21440 in chips) 
Seat 5: Klemtonius (11411 in chips) 
Seat 9: mnnm585 (17610 in chips) 
PokerStarsMan12: posts small blind 50
Klemtonius: posts big blind 100
*** HOLE CARDS ***
Dealt to PokerStarsMan12 [Qs Ah]
mnnm585: calls 100
color_singleton: calls 100
HighCardJasper: folds 
PokerStarsMan12: raises 300 to 400
Klemtonius: calls 300
mnnm585: calls 300
color_singleton: calls 300
*** FLOP *** [7h 6c Kd]
PokerStarsMan12: checks 
Klemtonius: checks 
mnnm585: checks 
color_singleton: checks 
*** TURN *** [7h 6c Kd] [3h]
PokerStarsMan12: checks 
Klemtonius: checks 
mnnm585: checks 
color_singleton: bets 756
PokerStarsMan12: folds 
Klemtonius: folds 
mnnm585: folds 
Uncalled bet (756) returned to color_singleton
color_singleton collected 1512 from pot
color_singleton: doesn't show hand 
*** SUMMARY ***
Total pot 1600 | Rake 88 
Board [7h 6c Kd 3h]
Seat 1: color_singleton collected (1512)
Seat 2: HighCardJasper (button) folded before Flop (didn't bet)
Seat 4: PokerStarsMan12 (small blind) folded on the Turn
Seat 5: Klemtonius (big blind) folded on the Turn
Seat 9: mnnm585 folded on the Turn



PokerStars Home Game Hand #227983135370: {DaPokaStars}  Hold'em No Limit (50/100) - 2021/07/01 15:45:43 ET
Table 'JULY 1' 9-max (Play Money) Seat #4 is the button
Seat 1: color_singleton (17511 in chips) 
Seat 2: HighCardJasper (8052 in chips) 
Seat 3: appositive (5622 in chips) 
Seat 4: PokerStarsMan12 (21040 in chips) 
Seat 5: Klemtonius (11011 in chips) 
Seat 9: mnnm585 (17210 in chips) 
Klemtonius: posts small blind 50
mnnm585: posts big blind 100
appositive: posts small & big blinds 150
*** HOLE CARDS ***
Dealt to PokerStarsMan12 [6c 8h]
color_singleton: folds 
HighCardJasper: calls 100
appositive: checks 
PokerStarsMan12: folds 
Klemtonius: calls 50
mnnm585: raises 100 to 200
HighCardJasper: calls 100
appositive: calls 100
Klemtonius: calls 100
*** FLOP *** [8s 6s 7h]
Klemtonius: checks 
mnnm585: checks 
HighCardJasper: checks 
appositive: bets 401
Klemtonius: folds 
mnnm585: calls 401
HighCardJasper: folds 
*** TURN *** [8s 6s 7h] [6h]
mnnm585: bets 780
appositive: raises 780 to 1560
mnnm585: calls 780
*** RIVER *** [8s 6s 7h 6h] [4c]
mnnm585: checks 
appositive: bets 3411 and is all-in
mnnm585: folds 
Uncalled bet (3411) returned to appositive
appositive collected 4510 from pot
appositive: doesn't show hand 
*** SUMMARY ***
Total pot 4772 | Rake 262 
Board [8s 6s 7h 6h 4c]
Seat 1: color_singleton folded before Flop (didn't bet)
Seat 2: HighCardJasper folded on the Flop
Seat 3: appositive collected (4510)
Seat 4: PokerStarsMan12 (button) folded before Flop (didn't bet)
Seat 5: Klemtonius (small blind) folded on the Flop
Seat 9: mnnm585 (big blind) folded on the River



PokerStars Home Game Hand #227983175629: {DaPokaStars}  Hold'em No Limit (50/100) - 2021/07/01 15:47:08 ET
Table 'JULY 1' 9-max (Play Money) Seat #5 is the button
Seat 1: color_singleton (17511 in chips) 
Seat 2: HighCardJasper (7852 in chips) 
Seat 3: appositive (7921 in chips) 
Seat 4: PokerStarsMan12 (21040 in chips) 
Seat 5: Klemtonius (10811 in chips) 
Seat 9: mnnm585 (15049 in chips) 
mnnm585: posts small blind 50
color_singleton: posts big blind 100
*** HOLE CARDS ***
Dealt to PokerStarsMan12 [4c 7d]
HighCardJasper: raises 100 to 200
appositive: calls 200
PokerStarsMan12: folds 
Klemtonius: raises 750 to 950
mnnm585: folds 
color_singleton: calls 850
HighCardJasper: folds 
appositive: calls 750
*** FLOP *** [Ts 9d Ks]
color_singleton: bets 1464
appositive: folds 
Klemtonius: calls 1464
*** TURN *** [Ts 9d Ks] [4d]
color_singleton: checks 
Klemtonius: bets 2848
color_singleton: folds 
Uncalled bet (2848) returned to Klemtonius
Klemtonius collected 5696 from pot
Klemtonius: doesn't show hand 
*** SUMMARY ***
Total pot 6028 | Rake 332 
Board [Ts 9d Ks 4d]
Seat 1: color_singleton (big blind) folded on the Turn
Seat 2: HighCardJasper folded before Flop
Seat 3: appositive folded on the Flop
Seat 4: PokerStarsMan12 folded before Flop (didn't bet)
Seat 5: Klemtonius (button) collected (5696)
Seat 9: mnnm585 (small blind) folded before Flop



PokerStars Home Game Hand #227983219876: {DaPokaStars}  Hold'em No Limit (50/100) - 2021/07/01 15:48:43 ET
Table 'JULY 1' 9-max (Play Money) Seat #9 is the button
Seat 1: color_singleton (15097 in chips) 
Seat 2: HighCardJasper (7652 in chips) 
Seat 3: appositive (6971 in chips) 
Seat 4: PokerStarsMan12 (21040 in chips) 
Seat 5: Klemtonius (14093 in chips) 
Seat 9: mnnm585 (14999 in chips) 
color_singleton: posts small blind 50
HighCardJasper: posts big blind 100
*** HOLE CARDS ***
Dealt to PokerStarsMan12 [4s 7d]
appositive: folds 
PokerStarsMan12: folds 
Klemtonius: raises 100 to 200
mnnm585: raises 100 to 300
color_singleton: folds 
HighCardJasper: calls 200
Klemtonius: calls 100
*** FLOP *** [2c 5s Ah]
HighCardJasper: checks 
Klemtonius: bets 898
mnnm585: raises 898 to 1796
HighCardJasper: folds 
Klemtonius: calls 898
*** TURN *** [2c 5s Ah] [Qc]
Klemtonius: checks 
mnnm585: bets 4292
Klemtonius: folds 
Uncalled bet (4292) returned to mnnm585
mnnm585 collected 4292 from pot
*** SUMMARY ***
Total pot 4542 | Rake 250 
Board [2c 5s Ah Qc]
Seat 1: color_singleton (small blind) folded before Flop
Seat 2: HighCardJasper (big blind) folded on the Flop
Seat 3: appositive folded before Flop (didn't bet)
Seat 4: PokerStarsMan12 folded before Flop (didn't bet)
Seat 5: Klemtonius folded on the Turn
Seat 9: mnnm585 (button) collected (4292)



PokerStars Home Game Hand #227983242874: {DaPokaStars}  Hold'em No Limit (50/100) - 2021/07/01 15:49:33 ET
Table 'JULY 1' 9-max (Play Money) Seat #1 is the button
Seat 1: color_singleton (15047 in chips) 
Seat 2: HighCardJasper (7352 in chips) 
Seat 3: appositive (6971 in chips) 
Seat 4: PokerStarsMan12 (21040 in chips) 
Seat 5: Klemtonius (11997 in chips) 
Seat 9: mnnm585 (17195 in chips) 
HighCardJasper: posts small blind 50
appositive: posts big blind 100
*** HOLE CARDS ***
Dealt to PokerStarsMan12 [8d 7c]
PokerStarsMan12: calls 100
Klemtonius: folds 
mnnm585: calls 100
color_singleton: folds 
HighCardJasper: folds 
appositive: checks 
*** FLOP *** [4c Ac 6s]
appositive: checks 
PokerStarsMan12: checks 
mnnm585: bets 165
appositive: calls 165
PokerStarsMan12: calls 165
*** TURN *** [4c Ac 6s] [2s]
appositive: bets 399
PokerStarsMan12: folds 
mnnm585: calls 399
*** RIVER *** [4c Ac 6s 2s] [Jc]
appositive: bets 776
mnnm585: folds 
Uncalled bet (776) returned to appositive
appositive collected 1553 from pot
appositive: doesn't show hand 
*** SUMMARY ***
Total pot 1643 | Rake 90 
Board [4c Ac 6s 2s Jc]
Seat 1: color_singleton (button) folded before Flop (didn't bet)
Seat 2: HighCardJasper (small blind) folded before Flop
Seat 3: appositive (big blind) collected (1553)
Seat 4: PokerStarsMan12 folded on the Turn
Seat 5: Klemtonius folded before Flop (didn't bet)
Seat 9: mnnm585 folded on the River



PokerStars Home Game Hand #227983272004: {DaPokaStars}  Hold'em No Limit (50/100) - 2021/07/01 15:50:36 ET
Table 'JULY 1' 9-max (Play Money) Seat #2 is the button
Seat 1: color_singleton (15047 in chips) 
Seat 2: HighCardJasper (7302 in chips) 
Seat 3: appositive (7860 in chips) 
Seat 4: PokerStarsMan12 (20775 in chips) 
Seat 5: Klemtonius (11997 in chips) 
Seat 9: mnnm585 (16531 in chips) 
appositive: posts small blind 50
PokerStarsMan12: posts big blind 100
*** HOLE CARDS ***
Dealt to PokerStarsMan12 [8c 7d]
Klemtonius: calls 100
mnnm585: calls 100
color_singleton: folds 
HighCardJasper has timed out
HighCardJasper: folds 
appositive: calls 50
PokerStarsMan12: checks 
*** FLOP *** [5c 5h Jd]
appositive: checks 
PokerStarsMan12: checks 
Klemtonius: checks 
mnnm585: checks 
*** TURN *** [5c 5h Jd] [7c]
appositive: checks 
PokerStarsMan12: bets 200
Klemtonius: folds 
mnnm585: folds 
appositive: calls 200
*** RIVER *** [5c 5h Jd 7c] [3d]
appositive: checks 
PokerStarsMan12: bets 500
appositive: folds 
Uncalled bet (500) returned to PokerStarsMan12
PokerStarsMan12 collected 756 from pot
*** SUMMARY ***
Total pot 800 | Rake 44 
Board [5c 5h Jd 7c 3d]
Seat 1: color_singleton folded before Flop (didn't bet)
Seat 2: HighCardJasper (button) folded before Flop (didn't bet)
Seat 3: appositive (small blind) folded on the River
Seat 4: PokerStarsMan12 (big blind) collected (756)
Seat 5: Klemtonius folded on the Turn
Seat 9: mnnm585 folded on the Turn



PokerStars Home Game Hand #227983313569: {DaPokaStars}  Hold'em No Limit (50/100) - 2021/07/01 15:52:07 ET
Table 'JULY 1' 9-max (Play Money) Seat #3 is the button
Seat 1: color_singleton (15047 in chips) 
Seat 2: HighCardJasper (7302 in chips) 
Seat 3: appositive (7560 in chips) 
Seat 4: PokerStarsMan12 (21231 in chips) 
Seat 5: Klemtonius (11897 in chips) 
Seat 9: mnnm585 (16431 in chips) 
PokerStarsMan12: posts small blind 50
Klemtonius: posts big blind 100
*** HOLE CARDS ***
Dealt to PokerStarsMan12 [Th 5d]
mnnm585: folds 
color_singleton: folds 
HighCardJasper: folds 
appositive: calls 100
PokerStarsMan12: calls 50
Klemtonius: checks 
*** FLOP *** [2c Jc 8c]
PokerStarsMan12: checks 
Klemtonius: bets 141
appositive: calls 141
PokerStarsMan12: folds 
*** TURN *** [2c Jc 8c] [Ts]
Klemtonius: bets 275
appositive: folds 
Uncalled bet (275) returned to Klemtonius
Klemtonius collected 550 from pot
Klemtonius: doesn't show hand 
*** SUMMARY ***
Total pot 582 | Rake 32 
Board [2c Jc 8c Ts]
Seat 1: color_singleton folded before Flop (didn't bet)
Seat 2: HighCardJasper folded before Flop (didn't bet)
Seat 3: appositive (button) folded on the Turn
Seat 4: PokerStarsMan12 (small blind) folded on the Flop
Seat 5: Klemtonius (big blind) collected (550)
Seat 9: mnnm585 folded before Flop (didn't bet)



PokerStars Home Game Hand #227983332753: {DaPokaStars}  Hold'em No Limit (50/100) - 2021/07/01 15:52:49 ET
Table 'JULY 1' 9-max (Play Money) Seat #4 is the button
Seat 1: color_singleton (15047 in chips) 
Seat 2: HighCardJasper (7302 in chips) 
Seat 3: appositive (7319 in chips) 
Seat 4: PokerStarsMan12 (21131 in chips) 
Seat 5: Klemtonius (12206 in chips) 
Seat 9: mnnm585 (16431 in chips) 
Klemtonius: posts small blind 50
mnnm585: posts big blind 100
*** HOLE CARDS ***
Dealt to PokerStarsMan12 [Kc Qh]
color_singleton: folds 
HighCardJasper: calls 100
appositive: calls 100
PokerStarsMan12: raises 400 to 500
Klemtonius: calls 450
mnnm585: folds 
HighCardJasper: folds 
appositive: calls 400
*** FLOP *** [2d Jc Qc]
Klemtonius: bets 803
appositive: folds 
PokerStarsMan12: calls 803
*** TURN *** [2d Jc Qc] [8c]
Klemtonius: bets 3124
PokerStarsMan12: calls 3124
*** RIVER *** [2d Jc Qc 8c] [Js]
Klemtonius: bets 7779 and is all-in
PokerStarsMan12: folds 
Uncalled bet (7779) returned to Klemtonius
Klemtonius collected 9029 from pot
Klemtonius: doesn't show hand 
*** SUMMARY ***
Total pot 9554 | Rake 525 
Board [2d Jc Qc 8c Js]
Seat 1: color_singleton folded before Flop (didn't bet)
Seat 2: HighCardJasper folded before Flop
Seat 3: appositive folded on the Flop
Seat 4: PokerStarsMan12 (button) folded on the River
Seat 5: Klemtonius (small blind) collected (9029)
Seat 9: mnnm585 (big blind) folded before Flop



PokerStars Home Game Hand #227983375393: {DaPokaStars}  Hold'em No Limit (50/100) - 2021/07/01 15:54:12 ET
Table 'JULY 1' 9-max (Play Money) Seat #5 is the button
Seat 1: color_singleton (15047 in chips) 
Seat 2: HighCardJasper (7202 in chips) 
Seat 3: appositive (6819 in chips) 
Seat 4: PokerStarsMan12 (16704 in chips) 
Seat 5: Klemtonius (16808 in chips) 
Seat 9: mnnm585 (16331 in chips) 
mnnm585: posts small blind 50
color_singleton: posts big blind 100
*** HOLE CARDS ***
Dealt to PokerStarsMan12 [4s 5c]
HighCardJasper: folds 
appositive: calls 100
PokerStarsMan12: folds 
Klemtonius: folds 
mnnm585: raises 100 to 200
color_singleton: calls 100
appositive: calls 100
*** FLOP *** [8s 9s 6c]
mnnm585: checks 
color_singleton: bets 283
appositive: calls 283
mnnm585: calls 283
*** TURN *** [8s 9s 6c] [Th]
mnnm585: checks 
color_singleton: bets 684
appositive: calls 684
mnnm585: calls 684
*** RIVER *** [8s 9s 6c Th] [Js]
mnnm585: bets 1654
color_singleton: calls 1654
appositive: folds 
*** SHOW DOWN ***
mnnm585: shows [Jc Jd] (three of a kind, Jacks)
color_singleton: shows [7s Kh] (a straight, Seven to Jack)
color_singleton collected 6434 from pot
*** SUMMARY ***
Total pot 6809 | Rake 375 
Board [8s 9s 6c Th Js]
Seat 1: color_singleton (big blind) showed [7s Kh] and won (6434) with a straight, Seven to Jack
Seat 2: HighCardJasper folded before Flop (didn't bet)
Seat 3: appositive folded on the River
Seat 4: PokerStarsMan12 folded before Flop (didn't bet)
Seat 5: Klemtonius (button) folded before Flop (didn't bet)
Seat 9: mnnm585 (small blind) showed [Jc Jd] and lost with three of a kind, Jacks



PokerStars Home Game Hand #227983409801: {DaPokaStars}  Hold'em No Limit (50/100) - 2021/07/01 15:55:35 ET
Table 'JULY 1' 9-max (Play Money) Seat #9 is the button
Seat 1: color_singleton (18660 in chips) 
Seat 2: HighCardJasper (7202 in chips) 
Seat 3: appositive (5652 in chips) 
Seat 4: PokerStarsMan12 (16704 in chips) 
Seat 5: Klemtonius (16808 in chips) 
Seat 9: mnnm585 (13510 in chips) 
color_singleton: posts small blind 50
HighCardJasper: posts big blind 100
*** HOLE CARDS ***
Dealt to PokerStarsMan12 [7s Ad]
appositive: calls 100
PokerStarsMan12: calls 100
Klemtonius: calls 100
mnnm585: calls 100
color_singleton: calls 50
HighCardJasper: checks 
*** FLOP *** [3s Jh 8d]
color_singleton: checks 
HighCardJasper: checks 
appositive: checks 
PokerStarsMan12: checks 
Klemtonius: checks 
mnnm585: checks 
*** TURN *** [3s Jh 8d] [Kh]
color_singleton: bets 283
HighCardJasper: folds 
appositive: folds 
PokerStarsMan12: folds 
Klemtonius: folds 
mnnm585: folds 
Uncalled bet (283) returned to color_singleton
color_singleton collected 567 from pot
color_singleton: doesn't show hand 
*** SUMMARY ***
Total pot 600 | Rake 33 
Board [3s Jh 8d Kh]
Seat 1: color_singleton (small blind) collected (567)
Seat 2: HighCardJasper (big blind) folded on the Turn
Seat 3: appositive folded on the Turn
Seat 4: PokerStarsMan12 folded on the Turn
Seat 5: Klemtonius folded on the Turn
Seat 9: mnnm585 (button) folded on the Turn



PokerStars Home Game Hand #227983436503: {DaPokaStars}  Hold'em No Limit (50/100) - 2021/07/01 15:56:57 ET
Table 'JULY 1' 9-max (Play Money) Seat #1 is the button
Seat 1: color_singleton (19127 in chips) 
Seat 2: HighCardJasper (7102 in chips) 
Seat 3: appositive (5552 in chips) 
Seat 4: PokerStarsMan12 (16604 in chips) 
Seat 5: Klemtonius (16708 in chips) 
Seat 9: mnnm585 (13410 in chips) 
HighCardJasper: posts small blind 50
appositive: posts big blind 100
*** HOLE CARDS ***
Dealt to PokerStarsMan12 [Jd Td]
PokerStarsMan12: raises 300 to 400
Klemtonius: calls 400
mnnm585: folds 
color_singleton: folds 
HighCardJasper: folds 
appositive: folds 
*** FLOP *** [7c 3c 4s]
PokerStarsMan12: checks 
Klemtonius: checks 
*** TURN *** [7c 3c 4s] [9h]
PokerStarsMan12: checks 
Klemtonius: bets 898
PokerStarsMan12: folds 
Uncalled bet (898) returned to Klemtonius
Klemtonius collected 898 from pot
Klemtonius: doesn't show hand 
*** SUMMARY ***
Total pot 950 | Rake 52 
Board [7c 3c 4s 9h]
Seat 1: color_singleton (button) folded before Flop (didn't bet)
Seat 2: HighCardJasper (small blind) folded before Flop
Seat 3: appositive (big blind) folded before Flop
Seat 4: PokerStarsMan12 folded on the Turn
Seat 5: Klemtonius collected (898)
Seat 9: mnnm585 folded before Flop (didn't bet)



PokerStars Home Game Hand #227983452411: {DaPokaStars}  Hold'em No Limit (50/100) - 2021/07/01 15:57:45 ET
Table 'JULY 1' 9-max (Play Money) Seat #2 is the button
Seat 1: color_singleton (19127 in chips) 
Seat 2: HighCardJasper (7052 in chips) 
Seat 3: appositive (5452 in chips) 
Seat 4: PokerStarsMan12 (16204 in chips) 
Seat 5: Klemtonius (17206 in chips) 
Seat 9: mnnm585 (13410 in chips) 
appositive: posts small blind 50
PokerStarsMan12: posts big blind 100
*** HOLE CARDS ***
Dealt to PokerStarsMan12 [Ts Kc]
Klemtonius: raises 100 to 200
mnnm585: folds 
color_singleton: folds 
HighCardJasper: calls 200
appositive: folds 
PokerStarsMan12: calls 100
*** FLOP *** [2d 2h Ad]
PokerStarsMan12: checks 
Klemtonius: bets 307
HighCardJasper: calls 307
PokerStarsMan12: folds 
*** TURN *** [2d 2h Ad] [7d]
Klemtonius: checks 
HighCardJasper: checks 
*** RIVER *** [2d 2h Ad 7d] [8h]
Klemtonius: bets 597
HighCardJasper: raises 597 to 1194
Klemtonius: folds 
Uncalled bet (597) returned to HighCardJasper
HighCardJasper collected 2323 from pot
HighCardJasper: doesn't show hand 
*** SUMMARY ***
Total pot 2458 | Rake 135 
Board [2d 2h Ad 7d 8h]
Seat 1: color_singleton folded before Flop (didn't bet)
Seat 2: HighCardJasper (button) collected (2323)
Seat 3: appositive (small blind) folded before Flop
Seat 4: PokerStarsMan12 (big blind) folded on the Flop
Seat 5: Klemtonius folded on the River
Seat 9: mnnm585 folded before Flop (didn't bet)



PokerStars Home Game Hand #227983471000: {DaPokaStars}  Hold'em No Limit (50/100) - 2021/07/01 15:58:41 ET
Table 'JULY 1' 9-max (Play Money) Seat #3 is the button
Seat 1: color_singleton (19127 in chips) 
Seat 2: HighCardJasper (8271 in chips) 
Seat 3: appositive (5402 in chips) 
Seat 4: PokerStarsMan12 (16004 in chips) 
Seat 5: Klemtonius (16102 in chips) 
Seat 9: mnnm585 (13410 in chips) 
PokerStarsMan12: posts small blind 50
Klemtonius: posts big blind 100
*** HOLE CARDS ***
Dealt to PokerStarsMan12 [Ks 6d]
mnnm585: calls 100
color_singleton: calls 100
HighCardJasper: calls 100
appositive: folds 
PokerStarsMan12: calls 50
Klemtonius: checks 
*** FLOP *** [2h As 4d]
PokerStarsMan12: checks 
Klemtonius: bets 236
mnnm585: calls 236
color_singleton: folds 
HighCardJasper: calls 236
PokerStarsMan12: folds 
*** TURN *** [2h As 4d] [3c]
Klemtonius: bets 1142
mnnm585: folds 
HighCardJasper: calls 1142
*** RIVER *** [2h As 4d 3c] [5c]
Klemtonius: bets 3300
HighCardJasper: calls 3300
*** SHOW DOWN ***
Klemtonius: shows [3h Th] (a straight, Ace to Five)
HighCardJasper: shows [5s 6s] (a straight, Deuce to Six)
HighCardJasper collected 9537 from pot
*** SUMMARY ***
Total pot 10092 | Rake 555 
Board [2h As 4d 3c 5c]
Seat 1: color_singleton folded on the Flop
Seat 2: HighCardJasper showed [5s 6s] and won (9537) with a straight, Deuce to Six
Seat 3: appositive (button) folded before Flop (didn't bet)
Seat 4: PokerStarsMan12 (small blind) folded on the Flop
Seat 5: Klemtonius (big blind) showed [3h Th] and lost with a straight, Ace to Five
Seat 9: mnnm585 folded on the Turn



PokerStars Home Game Hand #227983489623: {DaPokaStars}  Hold'em No Limit (50/100) - 2021/07/01 15:59:36 ET
Table 'JULY 1' 9-max (Play Money) Seat #4 is the button
Seat 1: color_singleton (19027 in chips) 
Seat 2: HighCardJasper (13030 in chips) 
Seat 3: appositive (5402 in chips) 
Seat 4: PokerStarsMan12 (15904 in chips) 
Seat 5: Klemtonius (11324 in chips) 
Seat 9: mnnm585 (13074 in chips) 
Klemtonius: posts small blind 50
mnnm585: posts big blind 100
*** HOLE CARDS ***
Dealt to PokerStarsMan12 [2c 5s]
color_singleton: folds 
HighCardJasper: folds 
appositive: calls 100
PokerStarsMan12: folds 
Klemtonius: calls 50
mnnm585: checks 
*** FLOP *** [9c 7d Tc]
Klemtonius: bets 283
mnnm585: calls 283
appositive: folds 
*** TURN *** [9c 7d Tc] [As]
Klemtonius: bets 409
mnnm585: folds 
Uncalled bet (409) returned to Klemtonius
Klemtonius collected 818 from pot
Klemtonius: doesn't show hand 
*** SUMMARY ***
Total pot 866 | Rake 48 
Board [9c 7d Tc As]
Seat 1: color_singleton folded before Flop (didn't bet)
Seat 2: HighCardJasper folded before Flop (didn't bet)
Seat 3: appositive folded on the Flop
Seat 4: PokerStarsMan12 (button) folded before Flop (didn't bet)
Seat 5: Klemtonius (small blind) collected (818)
Seat 9: mnnm585 (big blind) folded on the Turn



PokerStars Home Game Hand #227983514982: {DaPokaStars}  Hold'em No Limit (50/100) - 2021/07/01 16:00:49 ET
Table 'JULY 1' 9-max (Play Money) Seat #9 is the button
Seat 1: color_singleton (19027 in chips) 
Seat 2: HighCardJasper (13030 in chips) 
Seat 3: appositive (5302 in chips) 
Seat 4: PokerStarsMan12 (15904 in chips) 
Seat 9: mnnm585 (12691 in chips) 
color_singleton: posts small blind 50
HighCardJasper: posts big blind 100
*** HOLE CARDS ***
Dealt to PokerStarsMan12 [Kd Ts]
appositive: folds 
PokerStarsMan12: raises 300 to 400
mnnm585: calls 400
color_singleton: folds 
HighCardJasper: folds 
*** FLOP *** [6s Th As]
PokerStarsMan12: checks 
mnnm585: checks 
*** TURN *** [6s Th As] [5d]
PokerStarsMan12: checks 
mnnm585: checks 
*** RIVER *** [6s Th As 5d] [4c]
PokerStarsMan12: checks 
mnnm585: checks 
*** SHOW DOWN ***
PokerStarsMan12: shows [Kd Ts] (a pair of Tens)
mnnm585: mucks hand 
PokerStarsMan12 collected 898 from pot
*** SUMMARY ***
Total pot 950 | Rake 52 
Board [6s Th As 5d 4c]
Seat 1: color_singleton (small blind) folded before Flop
Seat 2: HighCardJasper (big blind) folded before Flop
Seat 3: appositive folded before Flop (didn't bet)
Seat 4: PokerStarsMan12 showed [Kd Ts] and won (898) with a pair of Tens
Seat 9: mnnm585 (button) mucked [3c Tc]



PokerStars Home Game Hand #227983529812: {DaPokaStars}  Hold'em No Limit (50/100) - 2021/07/01 16:01:26 ET
Table 'JULY 1' 9-max (Play Money) Seat #1 is the button
Seat 1: color_singleton (18977 in chips) 
Seat 2: HighCardJasper (12930 in chips) 
Seat 3: appositive (5302 in chips) 
Seat 4: PokerStarsMan12 (16402 in chips) 
Seat 5: Klemtonius (11759 in chips) 
Seat 9: mnnm585 (12291 in chips) 
HighCardJasper: posts small blind 50
appositive: posts big blind 100
*** HOLE CARDS ***
Dealt to PokerStarsMan12 [5s Ah]
PokerStarsMan12: raises 300 to 400
Klemtonius: calls 400
mnnm585: calls 400
color_singleton: folds 
HighCardJasper: folds 
appositive: calls 300
*** FLOP *** [8h 9c 4c]
appositive: checks 
PokerStarsMan12: checks 
Klemtonius: checks 
mnnm585: checks 
*** TURN *** [8h 9c 4c] [5c]
appositive: bets 779
PokerStarsMan12: folds 
Klemtonius: calls 779
mnnm585: folds 
*** RIVER *** [8h 9c 4c 5c] [Th]
appositive: checks 
Klemtonius: checks 
*** SHOW DOWN ***
appositive: shows [6h 9d] (a pair of Nines)
Klemtonius: mucks hand 
appositive collected 3032 from pot
*** SUMMARY ***
Total pot 3208 | Rake 176 
Board [8h 9c 4c 5c Th]
Seat 1: color_singleton (button) folded before Flop (didn't bet)
Seat 2: HighCardJasper (small blind) folded before Flop
Seat 3: appositive (big blind) showed [6h 9d] and won (3032) with a pair of Nines
Seat 4: PokerStarsMan12 folded on the Turn
Seat 5: Klemtonius mucked [As 2c]
Seat 9: mnnm585 folded on the Turn



PokerStars Home Game Hand #227983570385: {DaPokaStars}  Hold'em No Limit (50/100) - 2021/07/01 16:02:57 ET
Table 'JULY 1' 9-max (Play Money) Seat #2 is the button
Seat 1: color_singleton (18977 in chips) 
Seat 2: HighCardJasper (12880 in chips) 
Seat 3: appositive (7155 in chips) 
Seat 4: PokerStarsMan12 (16002 in chips) 
Seat 5: Klemtonius (10580 in chips) 
Seat 9: mnnm585 (11891 in chips) 
appositive: posts small blind 50
PokerStarsMan12: posts big blind 100
*** HOLE CARDS ***
Dealt to PokerStarsMan12 [Ac As]
Klemtonius: raises 100 to 200
mnnm585: folds 
color_singleton: folds 
HighCardJasper: calls 200
appositive: calls 150
PokerStarsMan12: raises 500 to 700
Klemtonius: calls 500
HighCardJasper: folds 
appositive: folds 
*** FLOP *** [Kh Ah 2c]
PokerStarsMan12: bets 900
Klemtonius: folds 
Uncalled bet (900) returned to PokerStarsMan12
PokerStarsMan12 collected 1701 from pot
*** SUMMARY ***
Total pot 1800 | Rake 99 
Board [Kh Ah 2c]
Seat 1: color_singleton folded before Flop (didn't bet)
Seat 2: HighCardJasper (button) folded before Flop
Seat 3: appositive (small blind) folded before Flop
Seat 4: PokerStarsMan12 (big blind) collected (1701)
Seat 5: Klemtonius folded on the Flop
Seat 9: mnnm585 folded before Flop (didn't bet)



PokerStars Home Game Hand #227983597704: {DaPokaStars}  Hold'em No Limit (50/100) - 2021/07/01 16:03:55 ET
Table 'JULY 1' 9-max (Play Money) Seat #3 is the button
Seat 1: color_singleton (18977 in chips) 
Seat 2: HighCardJasper (12680 in chips) 
Seat 3: appositive (6955 in chips) 
Seat 4: PokerStarsMan12 (17003 in chips) 
Seat 5: Klemtonius (9880 in chips) 
Seat 9: mnnm585 (11891 in chips) 
PokerStarsMan12: posts small blind 50
Klemtonius: posts big blind 100
*** HOLE CARDS ***
Dealt to PokerStarsMan12 [7s Th]
mnnm585: calls 100
color_singleton: raises 200 to 300
HighCardJasper: calls 300
appositive: folds 
PokerStarsMan12: folds 
Klemtonius: calls 200
mnnm585: folds 
*** FLOP *** [Ks 4c 8s]
Klemtonius: checks 
color_singleton: checks 
HighCardJasper: checks 
*** TURN *** [Ks 4c 8s] [Td]
Klemtonius: checks 
color_singleton: checks 
HighCardJasper: checks 
*** RIVER *** [Ks 4c 8s Td] [5c]
Klemtonius: checks 
color_singleton: checks 
HighCardJasper: bets 100
Klemtonius: calls 100
color_singleton: folds 
*** SHOW DOWN ***
HighCardJasper: shows [3c 9c] (high card King)
Klemtonius: shows [Ac 2s] (high card Ace)
Klemtonius collected 1181 from pot
*** SUMMARY ***
Total pot 1250 | Rake 69 
Board [Ks 4c 8s Td 5c]
Seat 1: color_singleton folded on the River
Seat 2: HighCardJasper showed [3c 9c] and lost with high card King
Seat 3: appositive (button) folded before Flop (didn't bet)
Seat 4: PokerStarsMan12 (small blind) folded before Flop
Seat 5: Klemtonius (big blind) showed [Ac 2s] and won (1181) with high card Ace
Seat 9: mnnm585 folded before Flop



PokerStars Home Game Hand #227983637262: {DaPokaStars}  Hold'em No Limit (50/100) - 2021/07/01 16:05:19 ET
Table 'JULY 1' 9-max (Play Money) Seat #4 is the button
Seat 1: color_singleton (18677 in chips) 
Seat 2: HighCardJasper (12280 in chips) 
Seat 3: appositive (6955 in chips) 
Seat 4: PokerStarsMan12 (16953 in chips) 
Seat 5: Klemtonius (10661 in chips) 
Seat 9: mnnm585 (11791 in chips) 
Klemtonius: posts small blind 50
mnnm585: posts big blind 100
*** HOLE CARDS ***
Dealt to PokerStarsMan12 [3h Jc]
color_singleton: raises 200 to 300
HighCardJasper has timed out
HighCardJasper: folds 
appositive: folds 
PokerStarsMan12: folds 
Klemtonius: calls 250
mnnm585: calls 200
*** FLOP *** [Kd Ts Jd]
Klemtonius: checks 
mnnm585: bets 425
color_singleton: calls 425
Klemtonius: folds 
*** TURN *** [Kd Ts Jd] [5d]
mnnm585: bets 827
color_singleton: calls 827
*** RIVER *** [Kd Ts Jd 5d] [5s]
mnnm585: bets 3217
color_singleton: calls 3217
*** SHOW DOWN ***
mnnm585: shows [8d Qd] (a flush, King high)
color_singleton: mucks hand 
mnnm585 collected 9297 from pot
*** SUMMARY ***
Total pot 9838 | Rake 541 
Board [Kd Ts Jd 5d 5s]
Seat 1: color_singleton mucked [Qc Ah]
Seat 2: HighCardJasper folded before Flop (didn't bet)
Seat 3: appositive folded before Flop (didn't bet)
Seat 4: PokerStarsMan12 (button) folded before Flop (didn't bet)
Seat 5: Klemtonius (small blind) folded on the Flop
Seat 9: mnnm585 (big blind) showed [8d Qd] and won (9297) with a flush, King high



PokerStars Home Game Hand #227983671810: {DaPokaStars}  Hold'em No Limit (50/100) - 2021/07/01 16:06:27 ET
Table 'JULY 1' 9-max (Play Money) Seat #5 is the button
Seat 1: color_singleton (13908 in chips) 
Seat 2: HighCardJasper (12280 in chips) 
Seat 3: appositive (6955 in chips) 
Seat 4: PokerStarsMan12 (16953 in chips) 
Seat 5: Klemtonius (10361 in chips) 
Seat 9: mnnm585 (16319 in chips) 
mnnm585: posts small blind 50
color_singleton: posts big blind 100
*** HOLE CARDS ***
Dealt to PokerStarsMan12 [Kc 3s]
HighCardJasper: calls 100
appositive: folds 
PokerStarsMan12: folds 
Klemtonius: calls 100
mnnm585: calls 50
color_singleton: checks 
*** FLOP *** [3h Ad 5d]
mnnm585: checks 
color_singleton: checks 
HighCardJasper: checks 
Klemtonius: checks 
*** TURN *** [3h Ad 5d] [6c]
mnnm585: checks 
color_singleton: checks 
HighCardJasper: checks 
Klemtonius: checks 
*** RIVER *** [3h Ad 5d 6c] [5c]
mnnm585: checks 
color_singleton: checks 
HighCardJasper: bets 189
Klemtonius: folds 
mnnm585: folds 
color_singleton: calls 189
*** SHOW DOWN ***
HighCardJasper: shows [Ts Kh] (a pair of Fives)
color_singleton: shows [3c Ks] (two pair, Fives and Threes)
color_singleton collected 735 from pot
*** SUMMARY ***
Total pot 778 | Rake 43 
Board [3h Ad 5d 6c 5c]
Seat 1: color_singleton (big blind) showed [3c Ks] and won (735) with two pair, Fives and Threes
Seat 2: HighCardJasper showed [Ts Kh] and lost with a pair of Fives
Seat 3: appositive folded before Flop (didn't bet)
Seat 4: PokerStarsMan12 folded before Flop (didn't bet)
Seat 5: Klemtonius (button) folded on the River
Seat 9: mnnm585 (small blind) folded on the River



PokerStars Home Game Hand #227983713533: {DaPokaStars}  Hold'em No Limit (50/100) - 2021/07/01 16:07:56 ET
Table 'JULY 1' 9-max (Play Money) Seat #9 is the button
Seat 1: color_singleton (14354 in chips) 
Seat 2: HighCardJasper (11991 in chips) 
Seat 3: appositive (6955 in chips) 
Seat 4: PokerStarsMan12 (16953 in chips) 
Seat 5: Klemtonius (10261 in chips) 
Seat 9: mnnm585 (16219 in chips) 
color_singleton: posts small blind 50
HighCardJasper: posts big blind 100
*** HOLE CARDS ***
Dealt to PokerStarsMan12 [Ts 8c]
appositive: folds 
PokerStarsMan12: folds 
Klemtonius: folds 
mnnm585: calls 100
color_singleton: calls 50
HighCardJasper: checks 
*** FLOP *** [9c 7h Kd]
color_singleton: checks 
HighCardJasper: checks 
mnnm585: checks 
*** TURN *** [9c 7h Kd] [2d]
color_singleton: checks 
HighCardJasper: bets 141
mnnm585: folds 
color_singleton: folds 
Uncalled bet (141) returned to HighCardJasper
HighCardJasper collected 283 from pot
HighCardJasper: doesn't show hand 
*** SUMMARY ***
Total pot 300 | Rake 17 
Board [9c 7h Kd 2d]
Seat 1: color_singleton (small blind) folded on the Turn
Seat 2: HighCardJasper (big blind) collected (283)
Seat 3: appositive folded before Flop (didn't bet)
Seat 4: PokerStarsMan12 folded before Flop (didn't bet)
Seat 5: Klemtonius folded before Flop (didn't bet)
Seat 9: mnnm585 (button) folded on the Turn



PokerStars Home Game Hand #227983728374: {DaPokaStars}  Hold'em No Limit (50/100) - 2021/07/01 16:08:27 ET
Table 'JULY 1' 9-max (Play Money) Seat #1 is the button
Seat 1: color_singleton (14254 in chips) 
Seat 2: HighCardJasper (12174 in chips) 
Seat 3: appositive (6955 in chips) 
Seat 4: PokerStarsMan12 (16953 in chips) 
Seat 5: Klemtonius (10261 in chips) 
Seat 9: mnnm585 (16119 in chips) 
HighCardJasper: posts small blind 50
appositive: posts big blind 100
*** HOLE CARDS ***
Dealt to PokerStarsMan12 [Th 7c]
PokerStarsMan12: folds 
Klemtonius: calls 100
mnnm585: calls 100
color_singleton: folds 
HighCardJasper: calls 50
appositive: checks 
*** FLOP *** [6s 5h 3h]
HighCardJasper: checks 
appositive: checks 
Klemtonius: bets 100
mnnm585: calls 100
HighCardJasper: calls 100
appositive: calls 100
*** TURN *** [6s 5h 3h] [Js]
HighCardJasper: bets 378
appositive: folds 
Klemtonius: calls 378
mnnm585: calls 378
*** RIVER *** [6s 5h 3h Js] [As]
HighCardJasper: checks 
Klemtonius: bets 914
mnnm585: folds 
HighCardJasper: calls 914
*** SHOW DOWN ***
Klemtonius: shows [7h 4h] (a straight, Three to Seven)
HighCardJasper: mucks hand 
Klemtonius collected 3555 from pot
*** SUMMARY ***
Total pot 3762 | Rake 207 
Board [6s 5h 3h Js As]
Seat 1: color_singleton (button) folded before Flop (didn't bet)
Seat 2: HighCardJasper (small blind) mucked [Ts Jc]
Seat 3: appositive (big blind) folded on the Turn
Seat 4: PokerStarsMan12 folded before Flop (didn't bet)
Seat 5: Klemtonius showed [7h 4h] and won (3555) with a straight, Three to Seven
Seat 9: mnnm585 folded on the River



PokerStars Home Game Hand #227983764763: {DaPokaStars}  Hold'em No Limit (50/100) - 2021/07/01 16:09:45 ET
Table 'JULY 1' 9-max (Play Money) Seat #2 is the button
Seat 1: color_singleton (14254 in chips) 
Seat 2: HighCardJasper (10682 in chips) 
Seat 3: appositive (6755 in chips) 
Seat 4: PokerStarsMan12 (16953 in chips) 
Seat 5: Klemtonius (12324 in chips) 
Seat 9: mnnm585 (15541 in chips) 
appositive: posts small blind 50
PokerStarsMan12: posts big blind 100
*** HOLE CARDS ***
Dealt to PokerStarsMan12 [3h 5c]
Klemtonius: folds 
mnnm585: calls 100
color_singleton: calls 100
HighCardJasper: calls 100
appositive: calls 50
PokerStarsMan12: checks 
*** FLOP *** [8d 9c Jd]
appositive: checks 
PokerStarsMan12: checks 
mnnm585: checks 
color_singleton: bets 236
HighCardJasper: folds 
appositive: calls 236
PokerStarsMan12: folds 
mnnm585: folds 
*** TURN *** [8d 9c Jd] [Js]
appositive: checks 
color_singleton: checks 
*** RIVER *** [8d 9c Jd Js] [7s]
appositive: checks 
color_singleton: checks 
*** SHOW DOWN ***
appositive: shows [9d 4d] (two pair, Jacks and Nines)
color_singleton: mucks hand 
appositive collected 919 from pot
*** SUMMARY ***
Total pot 972 | Rake 53 
Board [8d 9c Jd Js 7s]
Seat 1: color_singleton mucked [As 8h]
Seat 2: HighCardJasper (button) folded on the Flop
Seat 3: appositive (small blind) showed [9d 4d] and won (919) with two pair, Jacks and Nines
Seat 4: PokerStarsMan12 (big blind) folded on the Flop
Seat 5: Klemtonius folded before Flop (didn't bet)
Seat 9: mnnm585 folded on the Flop



PokerStars Home Game Hand #227983794282: {DaPokaStars}  Hold'em No Limit (50/100) - 2021/07/01 16:10:48 ET
Table 'JULY 1' 9-max (Play Money) Seat #3 is the button
Seat 1: color_singleton (13918 in chips) 
Seat 2: HighCardJasper (10582 in chips) 
Seat 3: appositive (7338 in chips) 
Seat 4: PokerStarsMan12 (16853 in chips) 
Seat 5: Klemtonius (12324 in chips) 
Seat 9: mnnm585 (15441 in chips) 
PokerStarsMan12: posts small blind 50
Klemtonius: posts big blind 100
*** HOLE CARDS ***
Dealt to PokerStarsMan12 [Qh 6d]
mnnm585: calls 100
color_singleton: calls 100
HighCardJasper: calls 100
appositive: folds 
PokerStarsMan12: calls 50
Klemtonius: raises 100 to 200
mnnm585: calls 100
color_singleton: calls 100
HighCardJasper: calls 100
PokerStarsMan12: calls 100
*** FLOP *** [3c Qc Ad]
PokerStarsMan12: checks 
Klemtonius: bets 945
mnnm585: folds 
color_singleton: folds 
HighCardJasper: folds 
PokerStarsMan12: folds 
Uncalled bet (945) returned to Klemtonius
Klemtonius collected 945 from pot
Klemtonius: doesn't show hand 
*** SUMMARY ***
Total pot 1000 | Rake 55 
Board [3c Qc Ad]
Seat 1: color_singleton folded on the Flop
Seat 2: HighCardJasper folded on the Flop
Seat 3: appositive (button) folded before Flop (didn't bet)
Seat 4: PokerStarsMan12 (small blind) folded on the Flop
Seat 5: Klemtonius (big blind) collected (945)
Seat 9: mnnm585 folded on the Flop



PokerStars Home Game Hand #227983817089: {DaPokaStars}  Hold'em No Limit (50/100) - 2021/07/01 16:11:37 ET
Table 'JULY 1' 9-max (Play Money) Seat #4 is the button
Seat 1: color_singleton (13718 in chips) 
Seat 2: HighCardJasper (10382 in chips) 
Seat 3: appositive (7338 in chips) 
Seat 4: PokerStarsMan12 (16653 in chips) 
Seat 5: Klemtonius (13069 in chips) 
Seat 9: mnnm585 (15241 in chips) 
Klemtonius: posts small blind 50
mnnm585: posts big blind 100
*** HOLE CARDS ***
Dealt to PokerStarsMan12 [Qh Ts]
color_singleton has timed out
color_singleton: folds 
HighCardJasper: calls 100
appositive: calls 100
PokerStarsMan12: calls 100
Klemtonius: raises 100 to 200
mnnm585: folds 
HighCardJasper: calls 100
appositive: calls 100
PokerStarsMan12: calls 100
*** FLOP *** [9h 5d 2h]
Klemtonius: bets 850
HighCardJasper: calls 850
appositive: folds 
PokerStarsMan12: folds 
*** TURN *** [9h 5d 2h] [3s]
Klemtonius: bets 2457
HighCardJasper: folds 
Uncalled bet (2457) returned to Klemtonius
Klemtonius collected 2457 from pot
Klemtonius: doesn't show hand 
*** SUMMARY ***
Total pot 2600 | Rake 143 
Board [9h 5d 2h 3s]
Seat 1: color_singleton folded before Flop (didn't bet)
Seat 2: HighCardJasper folded on the Turn
Seat 3: appositive folded on the Flop
Seat 4: PokerStarsMan12 (button) folded on the Flop
Seat 5: Klemtonius (small blind) collected (2457)
Seat 9: mnnm585 (big blind) folded before Flop



PokerStars Home Game Hand #227983853152: {DaPokaStars}  Hold'em No Limit (50/100) - 2021/07/01 16:12:56 ET
Table 'JULY 1' 9-max (Play Money) Seat #5 is the button
Seat 2: HighCardJasper (9332 in chips) 
Seat 3: appositive (7138 in chips) 
Seat 4: PokerStarsMan12 (16453 in chips) 
Seat 5: Klemtonius (14476 in chips) 
Seat 9: mnnm585 (15141 in chips) 
mnnm585: posts small blind 50
HighCardJasper: posts big blind 100
*** HOLE CARDS ***
Dealt to PokerStarsMan12 [3s 7h]
appositive: folds 
PokerStarsMan12: folds 
Klemtonius: calls 100
mnnm585: calls 50
HighCardJasper: raises 200 to 300
Klemtonius: calls 200
mnnm585: calls 200
*** FLOP *** [Kd 9h Ah]
mnnm585: checks 
HighCardJasper: bets 425
Klemtonius: folds 
mnnm585: folds 
Uncalled bet (425) returned to HighCardJasper
HighCardJasper collected 850 from pot
HighCardJasper: doesn't show hand 
*** SUMMARY ***
Total pot 900 | Rake 50 
Board [Kd 9h Ah]
Seat 2: HighCardJasper (big blind) collected (850)
Seat 3: appositive folded before Flop (didn't bet)
Seat 4: PokerStarsMan12 folded before Flop (didn't bet)
Seat 5: Klemtonius (button) folded on the Flop
Seat 9: mnnm585 (small blind) folded on the Flop



PokerStars Home Game Hand #227983870449: {DaPokaStars}  Hold'em No Limit (50/100) - 2021/07/01 16:13:33 ET
Table 'JULY 1' 9-max (Play Money) Seat #9 is the button
Seat 2: HighCardJasper (9882 in chips) 
Seat 3: appositive (7138 in chips) 
Seat 4: PokerStarsMan12 (16453 in chips) 
Seat 5: Klemtonius (14176 in chips) 
Seat 9: mnnm585 (14841 in chips) 
HighCardJasper: posts small blind 50
appositive: posts big blind 100
*** HOLE CARDS ***
Dealt to PokerStarsMan12 [Tc 8s]
PokerStarsMan12: calls 100
Klemtonius: calls 100
mnnm585: calls 100
HighCardJasper: calls 50
appositive: checks 
*** FLOP *** [Kh 7d 6s]
HighCardJasper: checks 
appositive: bets 236
PokerStarsMan12: folds 
Klemtonius: folds 
mnnm585: calls 236
HighCardJasper: folds 
*** TURN *** [Kh 7d 6s] [As]
appositive: bets 459
mnnm585: calls 459
*** RIVER *** [Kh 7d 6s As] [Ts]
appositive: bets 893
mnnm585: folds 
Uncalled bet (893) returned to appositive
appositive collected 1786 from pot
appositive: doesn't show hand 
*** SUMMARY ***
Total pot 1890 | Rake 104 
Board [Kh 7d 6s As Ts]
Seat 2: HighCardJasper (small blind) folded on the Flop
Seat 3: appositive (big blind) collected (1786)
Seat 4: PokerStarsMan12 folded on the Flop
Seat 5: Klemtonius folded on the Flop
Seat 9: mnnm585 (button) folded on the River



PokerStars Home Game Hand #227983909756: {DaPokaStars}  Hold'em No Limit (50/100) - 2021/07/01 16:14:58 ET
Table 'JULY 1' 9-max (Play Money) Seat #2 is the button
Seat 1: color_singleton (13718 in chips) 
Seat 2: HighCardJasper (9782 in chips) 
Seat 3: appositive (8129 in chips) 
Seat 4: PokerStarsMan12 (16353 in chips) 
Seat 5: Klemtonius (14076 in chips) 
Seat 9: mnnm585 (14046 in chips) 
appositive: posts small blind 50
PokerStarsMan12: posts big blind 100
color_singleton: posts small & big blinds 150
*** HOLE CARDS ***
Dealt to PokerStarsMan12 [2s 6d]
Klemtonius: folds 
mnnm585: calls 100
color_singleton: checks 
HighCardJasper: calls 100
appositive: calls 50
PokerStarsMan12: checks 
*** FLOP *** [7h 5h 3d]
MaFak2019 joins the table at seat #8 
appositive: checks 
PokerStarsMan12: checks 
mnnm585: checks 
color_singleton: bets 260
HighCardJasper: folds 
appositive: folds 
PokerStarsMan12: folds 
mnnm585: calls 260
*** TURN *** [7h 5h 3d] [2h]
mnnm585: bets 505
color_singleton: folds 
Uncalled bet (505) returned to mnnm585
mnnm585 collected 1011 from pot
*** SUMMARY ***
Total pot 1070 | Rake 59 
Board [7h 5h 3d 2h]
Seat 1: color_singleton folded on the Turn
Seat 2: HighCardJasper (button) folded on the Flop
Seat 3: appositive (small blind) folded on the Flop
Seat 4: PokerStarsMan12 (big blind) folded on the Flop
Seat 5: Klemtonius folded before Flop (didn't bet)
Seat 9: mnnm585 collected (1011)



PokerStars Home Game Hand #227983950711: {DaPokaStars}  Hold'em No Limit (50/100) - 2021/07/01 16:16:03 ET
Table 'JULY 1' 9-max (Play Money) Seat #3 is the button
Seat 1: color_singleton (13308 in chips) 
Seat 2: HighCardJasper (9682 in chips) 
Seat 3: appositive (8029 in chips) 
Seat 4: PokerStarsMan12 (16253 in chips) 
Seat 8: MaFak2019 (10000 in chips) 
Seat 9: mnnm585 (14697 in chips) 
PokerStarsMan12: posts small blind 50
MaFak2019: posts big blind 100
*** HOLE CARDS ***
Dealt to PokerStarsMan12 [Kh Qh]
mnnm585: folds 
color_singleton: raises 100 to 200
HighCardJasper: folds 
appositive: calls 200
PokerStarsMan12: raises 300 to 500
MaFak2019: calls 400
color_singleton: calls 300
appositive: calls 300
*** FLOP *** [Ts 2c Js]
PokerStarsMan12: checks 
MaFak2019: checks 
color_singleton: checks 
appositive: checks 
*** TURN *** [Ts 2c Js] [3s]
PokerStarsMan12: checks 
MaFak2019: checks 
color_singleton: checks 
appositive: checks 
*** RIVER *** [Ts 2c Js 3s] [9s]
PokerStarsMan12: checks 
MaFak2019: checks 
color_singleton: checks 
appositive: checks 
*** SHOW DOWN ***
PokerStarsMan12: shows [Kh Qh] (a straight, Nine to King)
MaFak2019: shows [Qd 6s] (a flush, Jack high)
color_singleton: mucks hand 
appositive: mucks hand 
MaFak2019 collected 1890 from pot
*** SUMMARY ***
Total pot 2000 | Rake 110 
Board [Ts 2c Js 3s 9s]
Seat 1: color_singleton mucked [6h 8h]
Seat 2: HighCardJasper folded before Flop (didn't bet)
Seat 3: appositive (button) mucked [Ah 2d]
Seat 4: PokerStarsMan12 (small blind) showed [Kh Qh] and lost with a straight, Nine to King
Seat 8: MaFak2019 (big blind) showed [Qd 6s] and won (1890) with a flush, Jack high
Seat 9: mnnm585 folded before Flop (didn't bet)



PokerStars Home Game Hand #227983996846: {DaPokaStars}  Hold'em No Limit (50/100) - 2021/07/01 16:17:39 ET
Table 'JULY 1' 9-max (Play Money) Seat #4 is the button
Seat 1: color_singleton (12808 in chips) 
Seat 2: HighCardJasper (9682 in chips) 
Seat 3: appositive (7529 in chips) 
Seat 4: PokerStarsMan12 (15753 in chips) 
Seat 8: MaFak2019 (11390 in chips) 
Seat 9: mnnm585 (14697 in chips) 
MaFak2019: posts small blind 50
mnnm585: posts big blind 100
*** HOLE CARDS ***
Dealt to PokerStarsMan12 [9c 7h]
color_singleton: raises 200 to 300
HighCardJasper: folds 
appositive: calls 300
PokerStarsMan12: folds 
MaFak2019: calls 250
mnnm585: calls 200
*** FLOP *** [4d 3h As]
MaFak2019: bets 1000
mnnm585: folds 
color_singleton: raises 1567 to 2567
appositive: folds 
MaFak2019: raises 1567 to 4134
color_singleton: raises 7766 to 11900
MaFak2019: calls 6956 and is all-in
Uncalled bet (810) returned to color_singleton
*** TURN *** [4d 3h As] [Td]
*** RIVER *** [4d 3h As Td] [Kc]
*** SHOW DOWN ***
MaFak2019: shows [Ad 2d] (a pair of Aces)
color_singleton: shows [Ac 4s] (two pair, Aces and Fours)
color_singleton collected 22094 from pot
*** SUMMARY ***
Total pot 23380 | Rake 1286 
Board [4d 3h As Td Kc]
Seat 1: color_singleton showed [Ac 4s] and won (22094) with two pair, Aces and Fours
Seat 2: HighCardJasper folded before Flop (didn't bet)
Seat 3: appositive folded on the Flop
Seat 4: PokerStarsMan12 (button) folded before Flop (didn't bet)
Seat 8: MaFak2019 (small blind) showed [Ad 2d] and lost with a pair of Aces
Seat 9: mnnm585 (big blind) folded on the Flop



PokerStars Home Game Hand #227984030454: {DaPokaStars}  Hold'em No Limit (50/100) - 2021/07/01 16:18:49 ET
Table 'JULY 1' 9-max (Play Money) Seat #9 is the button
Seat 1: color_singleton (23512 in chips) 
Seat 2: HighCardJasper (9682 in chips) 
Seat 3: appositive (7229 in chips) 
Seat 4: PokerStarsMan12 (15753 in chips) 
Seat 5: Klemtonius (14076 in chips) 
Seat 9: mnnm585 (14397 in chips) 
color_singleton: posts small blind 50
HighCardJasper: posts big blind 100
Klemtonius: posts small & big blinds 150
*** HOLE CARDS ***
Dealt to PokerStarsMan12 [Td Ks]
appositive: calls 100
PokerStarsMan12: calls 100
Klemtonius: checks 
mnnm585: folds 
color_singleton: raises 300 to 400
HighCardJasper: calls 300
appositive: calls 300
PokerStarsMan12: calls 300
Klemtonius: calls 300
*** FLOP *** [Th Ts Qh]
color_singleton: bets 968
HighCardJasper: folds 
appositive: folds 
PokerStarsMan12: raises 1032 to 2000
Klemtonius: calls 2000
color_singleton: folds 
*** TURN *** [Th Ts Qh] [5c]
PokerStarsMan12: bets 13353 and is all-in
Klemtonius: calls 11626 and is all-in
Uncalled bet (1727) returned to PokerStarsMan12
*** RIVER *** [Th Ts Qh 5c] [4c]
*** SHOW DOWN ***
PokerStarsMan12: shows [Td Ks] (three of a kind, Tens)
Klemtonius: shows [Tc 7c] (three of a kind, Tens - lower kicker)
PokerStarsMan12 collected 28605 from pot
*** SUMMARY ***
Total pot 30270 | Rake 1665 
Board [Th Ts Qh 5c 4c]
Seat 1: color_singleton (small blind) folded on the Flop
Seat 2: HighCardJasper (big blind) folded on the Flop
Seat 3: appositive folded on the Flop
Seat 4: PokerStarsMan12 showed [Td Ks] and won (28605) with three of a kind, Tens
Seat 5: Klemtonius showed [Tc 7c] and lost with three of a kind, Tens
Seat 9: mnnm585 (button) folded before Flop (didn't bet)



PokerStars Home Game Hand #227984078858: {DaPokaStars}  Hold'em No Limit (50/100) - 2021/07/01 16:20:30 ET
Table 'JULY 1' 9-max (Play Money) Seat #1 is the button
Seat 1: color_singleton (22144 in chips) 
Seat 2: HighCardJasper (9282 in chips) 
Seat 3: appositive (6829 in chips) 
Seat 4: PokerStarsMan12 (30332 in chips) 
Seat 8: MaFak2019 (10000 in chips) 
Seat 9: mnnm585 (14397 in chips) 
HighCardJasper: posts small blind 50
appositive: posts big blind 100
*** HOLE CARDS ***
Dealt to PokerStarsMan12 [7c 4d]
PokerStarsMan12: folds 
MaFak2019: raises 200 to 300
mnnm585: calls 300
color_singleton: folds 
HighCardJasper: calls 250
appositive: folds 
*** FLOP *** [9c 3d 6d]
HighCardJasper: checks 
MaFak2019: checks 
mnnm585: checks 
*** TURN *** [9c 3d 6d] [Jh]
HighCardJasper: checks 
MaFak2019: bets 945
mnnm585: folds 
HighCardJasper: folds 
Uncalled bet (945) returned to MaFak2019
MaFak2019 collected 945 from pot
MaFak2019: doesn't show hand 
*** SUMMARY ***
Total pot 1000 | Rake 55 
Board [9c 3d 6d Jh]
Seat 1: color_singleton (button) folded before Flop (didn't bet)
Seat 2: HighCardJasper (small blind) folded on the Turn
Seat 3: appositive (big blind) folded before Flop
Seat 4: PokerStarsMan12 folded before Flop (didn't bet)
Seat 8: MaFak2019 collected (945)
Seat 9: mnnm585 folded on the Turn



PokerStars Home Game Hand #227984107369: {DaPokaStars}  Hold'em No Limit (50/100) - 2021/07/01 16:21:30 ET
Table 'JULY 1' 9-max (Play Money) Seat #2 is the button
Seat 1: color_singleton (22144 in chips) 
Seat 2: HighCardJasper (8982 in chips) 
Seat 3: appositive (6729 in chips) 
Seat 4: PokerStarsMan12 (30332 in chips) 
Seat 5: Klemtonius (10000 in chips) 
Seat 8: MaFak2019 (10645 in chips) 
Seat 9: mnnm585 (14097 in chips) 
appositive: posts small blind 50
PokerStarsMan12: posts big blind 100
*** HOLE CARDS ***
Dealt to PokerStarsMan12 [Ah 2h]
Klemtonius: calls 100
MaFak2019: calls 100
mnnm585: raises 100 to 200
color_singleton: folds 
HighCardJasper: raises 100 to 300
appositive: folds 
PokerStarsMan12: calls 200
Klemtonius: calls 200
MaFak2019: calls 200
mnnm585: calls 100
*** FLOP *** [6c 8h 7c]
PokerStarsMan12: checks 
Klemtonius: checks 
MaFak2019: checks 
mnnm585: checks 
HighCardJasper: checks 
*** TURN *** [6c 8h 7c] [Kc]
PokerStarsMan12: checks 
Klemtonius: checks 
MaFak2019: checks 
mnnm585: checks 
HighCardJasper: checks 
*** RIVER *** [6c 8h 7c Kc] [3d]
PokerStarsMan12: checks 
Klemtonius: checks 
MaFak2019: checks 
mnnm585: checks 
HighCardJasper: checks 
*** SHOW DOWN ***
PokerStarsMan12: shows [Ah 2h] (high card Ace)
Klemtonius: shows [Qd As] (high card Ace - King+Queen kicker)
MaFak2019: shows [6s 2s] (a pair of Sixes)
mnnm585: shows [Jd Jh] (a pair of Jacks)
HighCardJasper: mucks hand 
mnnm585 collected 1465 from pot
*** SUMMARY ***
Total pot 1550 | Rake 85 
Board [6c 8h 7c Kc 3d]
Seat 1: color_singleton folded before Flop (didn't bet)
Seat 2: HighCardJasper (button) mucked [Ad 2d]
Seat 3: appositive (small blind) folded before Flop
Seat 4: PokerStarsMan12 (big blind) showed [Ah 2h] and lost with high card Ace
Seat 5: Klemtonius showed [Qd As] and lost with high card Ace
Seat 8: MaFak2019 showed [6s 2s] and lost with a pair of Sixes
Seat 9: mnnm585 showed [Jd Jh] and won (1465) with a pair of Jacks



PokerStars Home Game Hand #227984151261: {DaPokaStars}  Hold'em No Limit (50/100) - 2021/07/01 16:23:02 ET
Table 'JULY 1' 9-max (Play Money) Seat #3 is the button
Seat 1: color_singleton (22144 in chips) 
Seat 2: HighCardJasper (8682 in chips) 
Seat 3: appositive (6679 in chips) 
Seat 4: PokerStarsMan12 (30032 in chips) 
Seat 5: Klemtonius (9700 in chips) 
Seat 8: MaFak2019 (10345 in chips) 
Seat 9: mnnm585 (15262 in chips) 
PokerStarsMan12: posts small blind 50
Klemtonius: posts big blind 100
*** HOLE CARDS ***
Dealt to PokerStarsMan12 [Jd Ts]
MaFak2019: calls 100
mnnm585: calls 100
color_singleton: calls 100
HighCardJasper: folds 
appositive: folds 
PokerStarsMan12: calls 50
Klemtonius: checks 
*** FLOP *** [6c 5h 6h]
PokerStarsMan12: checks 
Klemtonius: bets 236
MaFak2019: calls 236
mnnm585: calls 236
color_singleton: folds 
PokerStarsMan12: folds 
*** TURN *** [6c 5h 6h] [7d]
Klemtonius: checks 
MaFak2019: checks 
mnnm585: checks 
*** RIVER *** [6c 5h 6h 7d] [Kc]
Klemtonius: checks 
MaFak2019: checks 
mnnm585: checks 
*** SHOW DOWN ***
Klemtonius: shows [Kh 3h] (two pair, Kings and Sixes)
MaFak2019: mucks hand 
mnnm585: mucks hand 
Klemtonius collected 1142 from pot
*** SUMMARY ***
Total pot 1208 | Rake 66 
Board [6c 5h 6h 7d Kc]
Seat 1: color_singleton folded on the Flop
Seat 2: HighCardJasper folded before Flop (didn't bet)
Seat 3: appositive (button) folded before Flop (didn't bet)
Seat 4: PokerStarsMan12 (small blind) folded on the Flop
Seat 5: Klemtonius (big blind) showed [Kh 3h] and won (1142) with two pair, Kings and Sixes
Seat 8: MaFak2019 mucked [Ah 9d]
Seat 9: mnnm585 mucked [Jc 5c]



PokerStars Home Game Hand #227984177213: {DaPokaStars}  Hold'em No Limit (50/100) - 2021/07/01 16:23:56 ET
Table 'JULY 1' 9-max (Play Money) Seat #4 is the button
Seat 1: color_singleton (22044 in chips) 
Seat 2: HighCardJasper (8682 in chips) 
Seat 3: appositive (6679 in chips) 
Seat 4: PokerStarsMan12 (29932 in chips) 
Seat 5: Klemtonius (10506 in chips) 
Seat 8: MaFak2019 (10009 in chips) 
Seat 9: mnnm585 (14926 in chips) 
Klemtonius: posts small blind 50
MaFak2019: posts big blind 100
*** HOLE CARDS ***
Dealt to PokerStarsMan12 [Ah 4c]
mnnm585: folds 
color_singleton: raises 200 to 300
HighCardJasper: folds 
appositive: calls 300
PokerStarsMan12: folds 
Klemtonius: calls 250
MaFak2019: calls 200
*** FLOP *** [7h 3d 9c]
Klemtonius: checks 
MaFak2019: checks 
color_singleton: checks 
appositive: checks 
*** TURN *** [7h 3d 9c] [Kc]
Klemtonius: bets 1134
MaFak2019: folds 
color_singleton: folds 
appositive: calls 1134
*** RIVER *** [7h 3d 9c Kc] [Kd]
Klemtonius: bets 1638
appositive: raises 1638 to 3276
Klemtonius: calls 1638
*** SHOW DOWN ***
appositive: shows [Ks Jd] (three of a kind, Kings)
Klemtonius: mucks hand 
appositive collected 9469 from pot
*** SUMMARY ***
Total pot 10020 | Rake 551 
Board [7h 3d 9c Kc Kd]
Seat 1: color_singleton folded on the Turn
Seat 2: HighCardJasper folded before Flop (didn't bet)
Seat 3: appositive showed [Ks Jd] and won (9469) with three of a kind, Kings
Seat 4: PokerStarsMan12 (button) folded before Flop (didn't bet)
Seat 5: Klemtonius (small blind) mucked [5d Kh]
Seat 8: MaFak2019 (big blind) folded on the Turn
Seat 9: mnnm585 folded before Flop (didn't bet)



PokerStars Home Game Hand #227984225672: {DaPokaStars}  Hold'em No Limit (50/100) - 2021/07/01 16:25:10 ET
Table 'JULY 1' 9-max (Play Money) Seat #5 is the button
Seat 1: color_singleton (21744 in chips) 
Seat 2: HighCardJasper (8682 in chips) 
Seat 3: appositive (11438 in chips) 
Seat 4: PokerStarsMan12 (29932 in chips) 
Seat 5: Klemtonius (5796 in chips) 
Seat 8: MaFak2019 (9709 in chips) 
Seat 9: mnnm585 (14926 in chips) 
MaFak2019: posts small blind 50
mnnm585: posts big blind 100
*** HOLE CARDS ***
Dealt to PokerStarsMan12 [5d 2s]
color_singleton: raises 100 to 200
HighCardJasper: calls 200
appositive: calls 200
PokerStarsMan12: folds 
Klemtonius: calls 200
MaFak2019: calls 150
mnnm585: folds 
*** FLOP *** [3h Ah 3d]
MaFak2019: checks 
color_singleton: checks 
HighCardJasper: bets 519
appositive: calls 519
Klemtonius: folds 
MaFak2019: folds 
color_singleton: folds 
*** TURN *** [3h Ah 3d] [Tc]
HighCardJasper: checks 
appositive: checks 
*** RIVER *** [3h Ah 3d Tc] [Ad]
HighCardJasper: bets 1010
appositive: folds 
Uncalled bet (1010) returned to HighCardJasper
HighCardJasper collected 2020 from pot
HighCardJasper: doesn't show hand 
*** SUMMARY ***
Total pot 2138 | Rake 118 
Board [3h Ah 3d Tc Ad]
Seat 1: color_singleton folded on the Flop
Seat 2: HighCardJasper collected (2020)
Seat 3: appositive folded on the River
Seat 4: PokerStarsMan12 folded before Flop (didn't bet)
Seat 5: Klemtonius (button) folded on the Flop
Seat 8: MaFak2019 (small blind) folded on the Flop
Seat 9: mnnm585 (big blind) folded before Flop



PokerStars Home Game Hand #227984274970: {DaPokaStars}  Hold'em No Limit (50/100) - 2021/07/01 16:26:54 ET
Table 'JULY 1' 9-max (Play Money) Seat #8 is the button
Seat 1: color_singleton (21544 in chips) 
Seat 2: HighCardJasper (9983 in chips) 
Seat 3: appositive (10719 in chips) 
Seat 4: PokerStarsMan12 (29932 in chips) 
Seat 5: Klemtonius (5596 in chips) 
Seat 8: MaFak2019 (9509 in chips) 
Seat 9: mnnm585 (14826 in chips) 
mnnm585: posts small blind 50
color_singleton: posts big blind 100
*** HOLE CARDS ***
Dealt to PokerStarsMan12 [Qs 7h]
HighCardJasper: calls 100
appositive: folds 
PokerStarsMan12: folds 
Klemtonius: calls 100
MaFak2019: calls 100
mnnm585: folds 
color_singleton: checks 
*** FLOP *** [Qc 9c Ts]
color_singleton: bets 212
HighCardJasper: folds 
Klemtonius: calls 212
MaFak2019: raises 1061 to 1273
color_singleton: folds 
Klemtonius: calls 1061
*** TURN *** [Qc 9c Ts] [2c]
Klemtonius: checks 
MaFak2019: checks 
*** RIVER *** [Qc 9c Ts 2c] [5c]
Klemtonius: checks 
MaFak2019: bets 1516
Klemtonius: folds 
Uncalled bet (1516) returned to MaFak2019
MaFak2019 collected 3032 from pot
MaFak2019: doesn't show hand 
*** SUMMARY ***
Total pot 3208 | Rake 176 
Board [Qc 9c Ts 2c 5c]
Seat 1: color_singleton (big blind) folded on the Flop
Seat 2: HighCardJasper folded on the Flop
Seat 3: appositive folded before Flop (didn't bet)
Seat 4: PokerStarsMan12 folded before Flop (didn't bet)
Seat 5: Klemtonius folded on the River
Seat 8: MaFak2019 (button) collected (3032)
Seat 9: mnnm585 (small blind) folded before Flop



PokerStars Home Game Hand #227984321512: {DaPokaStars}  Hold'em No Limit (50/100) - 2021/07/01 16:28:31 ET
Table 'JULY 1' 9-max (Play Money) Seat #9 is the button
Seat 1: color_singleton (21232 in chips) 
Seat 2: HighCardJasper (9883 in chips) 
Seat 3: appositive (10719 in chips) 
Seat 4: PokerStarsMan12 (29932 in chips) 
Seat 5: Klemtonius (4223 in chips) 
Seat 8: MaFak2019 (11168 in chips) 
Seat 9: mnnm585 (14776 in chips) 
color_singleton: posts small blind 50
HighCardJasper: posts big blind 100
*** HOLE CARDS ***
Dealt to PokerStarsMan12 [Qc 5c]
appositive: folds 
PokerStarsMan12: folds 
Klemtonius: raises 100 to 200
MaFak2019: calls 200
mnnm585: calls 200
color_singleton: folds 
HighCardJasper: calls 100
*** FLOP *** [8d 4s Kh]
HighCardJasper: checks 
Klemtonius: checks 
MaFak2019: checks 
mnnm585: checks 
*** TURN *** [8d 4s Kh] [2h]
HighCardJasper: checks 
Klemtonius: bets 803
MaFak2019: folds 
mnnm585: folds 
HighCardJasper: folds 
Uncalled bet (803) returned to Klemtonius
Klemtonius collected 803 from pot
Klemtonius: doesn't show hand 
*** SUMMARY ***
Total pot 850 | Rake 47 
Board [8d 4s Kh 2h]
Seat 1: color_singleton (small blind) folded before Flop
Seat 2: HighCardJasper (big blind) folded on the Turn
Seat 3: appositive folded before Flop (didn't bet)
Seat 4: PokerStarsMan12 folded before Flop (didn't bet)
Seat 5: Klemtonius collected (803)
Seat 8: MaFak2019 folded on the Turn
Seat 9: mnnm585 (button) folded on the Turn



PokerStars Home Game Hand #227984357216: {DaPokaStars}  Hold'em No Limit (50/100) - 2021/07/01 16:29:45 ET
Table 'JULY 1' 9-max (Play Money) Seat #1 is the button
Seat 1: color_singleton (21182 in chips) 
Seat 2: HighCardJasper (9683 in chips) 
Seat 3: appositive (10719 in chips) 
Seat 4: PokerStarsMan12 (29932 in chips) 
Seat 5: Klemtonius (4826 in chips) 
Seat 8: MaFak2019 (10968 in chips) 
Seat 9: mnnm585 (14576 in chips) 
HighCardJasper: posts small blind 50
appositive: posts big blind 100
*** HOLE CARDS ***
Dealt to PokerStarsMan12 [3d 7d]
PokerStarsMan12: folds 
Klemtonius: raises 250 to 350
MaFak2019 has timed out
MaFak2019: folds 
mnnm585: calls 350
color_singleton: calls 350
HighCardJasper: folds 
appositive: calls 250
*** FLOP *** [As 8c Js]
appositive: checks 
Klemtonius: bets 100
mnnm585: calls 100
color_singleton: calls 100
appositive: calls 100
*** TURN *** [As 8c Js] [4h]
appositive: checks 
Klemtonius: checks 
mnnm585: checks 
color_singleton: checks 
*** RIVER *** [As 8c Js 4h] [5c]
appositive: checks 
Klemtonius: bets 874
mnnm585: folds 
color_singleton: calls 874
appositive: folds 
*** SHOW DOWN ***
Klemtonius: shows [Jh 7h] (a pair of Jacks)
color_singleton: shows [Jd Qh] (a pair of Jacks - Ace+Queen kicker)
color_singleton collected 3400 from pot
*** SUMMARY ***
Total pot 3598 | Rake 198 
Board [As 8c Js 4h 5c]
Seat 1: color_singleton (button) showed [Jd Qh] and won (3400) with a pair of Jacks
Seat 2: HighCardJasper (small blind) folded before Flop
Seat 3: appositive (big blind) folded on the River
Seat 4: PokerStarsMan12 folded before Flop (didn't bet)
Seat 5: Klemtonius showed [Jh 7h] and lost with a pair of Jacks
Seat 8: MaFak2019 folded before Flop (didn't bet)
Seat 9: mnnm585 folded on the River



PokerStars Home Game Hand #227984409247: {DaPokaStars}  Hold'em No Limit (50/100) - 2021/07/01 16:31:33 ET
Table 'JULY 1' 9-max (Play Money) Seat #2 is the button
Seat 1: color_singleton (23258 in chips) 
Seat 2: HighCardJasper (9633 in chips) 
Seat 3: appositive (10269 in chips) 
Seat 4: PokerStarsMan12 (29932 in chips) 
Seat 5: Klemtonius (3502 in chips) 
Seat 8: MaFak2019 (10968 in chips) 
Seat 9: mnnm585 (14126 in chips) 
appositive: posts small blind 50
PokerStarsMan12: posts big blind 100
*** HOLE CARDS ***
Dealt to PokerStarsMan12 [9d 5d]
Klemtonius: folds 
MaFak2019: calls 100
mnnm585: calls 100
color_singleton: calls 100
HighCardJasper: calls 100
appositive: calls 50
PokerStarsMan12: checks 
*** FLOP *** [Ac 7s 2s]
appositive: checks 
PokerStarsMan12: checks 
MaFak2019: checks 
mnnm585: checks 
color_singleton: checks 
HighCardJasper: checks 
*** TURN *** [Ac 7s 2s] [7h]
Klemtonius is disconnected 
appositive: checks 
PokerStarsMan12 has timed out
PokerStarsMan12: checks 
MaFak2019: checks 
mnnm585: checks 
color_singleton: checks 
HighCardJasper: bets 283
appositive: calls 283
PokerStarsMan12: folds 
MaFak2019 has timed out
MaFak2019: folds 
mnnm585: folds 
color_singleton: folds 
*** RIVER *** [Ac 7s 2s 7h] [6h]
appositive: checks 
HighCardJasper: bets 551
appositive: calls 551
*** SHOW DOWN ***
HighCardJasper: shows [4c 4d] (two pair, Sevens and Fours)
appositive: shows [Jc Ad] (two pair, Aces and Sevens)
appositive collected 2143 from pot
*** SUMMARY ***
Total pot 2268 | Rake 125 
Board [Ac 7s 2s 7h 6h]
Seat 1: color_singleton folded on the Turn
Seat 2: HighCardJasper (button) showed [4c 4d] and lost with two pair, Sevens and Fours
Seat 3: appositive (small blind) showed [Jc Ad] and won (2143) with two pair, Aces and Sevens
Seat 4: PokerStarsMan12 (big blind) folded on the Turn
Seat 5: Klemtonius folded before Flop (didn't bet)
Seat 8: MaFak2019 folded on the Turn
Seat 9: mnnm585 folded on the Turn



PokerStars Home Game Hand #227984471833: {DaPokaStars}  Hold'em No Limit (50/100) - 2021/07/01 16:33:44 ET
Table 'JULY 1' 9-max (Play Money) Seat #3 is the button
Seat 1: color_singleton (23158 in chips) 
Seat 2: HighCardJasper (8699 in chips) 
Seat 3: appositive (11478 in chips) 
Seat 4: PokerStarsMan12 (29832 in chips) 
Seat 5: Klemtonius (3502 in chips) 
Seat 8: MaFak2019 (10868 in chips) 
Seat 9: mnnm585 (14026 in chips) 
PokerStarsMan12: posts small blind 50
Klemtonius: posts big blind 100
*** HOLE CARDS ***
Dealt to PokerStarsMan12 [5s Jc]
MaFak2019: calls 100
mnnm585: calls 100
color_singleton: calls 100
HighCardJasper: calls 100
appositive: raises 100 to 200
PokerStarsMan12: folds 
Klemtonius: calls 100
MaFak2019: calls 100
mnnm585: calls 100
color_singleton: calls 100
HighCardJasper: calls 100
*** FLOP *** [Td 6s Jh]
Klemtonius: checks 
MaFak2019: checks 
mnnm585: checks 
color_singleton: checks 
HighCardJasper: bets 590
appositive: calls 590
Klemtonius: folds 
MaFak2019: calls 590
mnnm585: folds 
color_singleton: folds 
*** TURN *** [Td 6s Jh] [Kh]
MaFak2019: checks 
HighCardJasper: checks 
appositive: checks 
*** RIVER *** [Td 6s Jh Kh] [5h]
MaFak2019: checks 
HighCardJasper: checks 
appositive: bets 500
MaFak2019: calls 500
HighCardJasper: calls 500
*** SHOW DOWN ***
appositive: shows [Ad Kc] (a pair of Kings)
MaFak2019: mucks hand 
HighCardJasper: mucks hand 
appositive collected 4271 from pot
*** SUMMARY ***
Total pot 4520 | Rake 249 
Board [Td 6s Jh Kh 5h]
Seat 1: color_singleton folded on the Flop
Seat 2: HighCardJasper mucked [Js 9s]
Seat 3: appositive (button) showed [Ad Kc] and won (4271) with a pair of Kings
Seat 4: PokerStarsMan12 (small blind) folded before Flop
Seat 5: Klemtonius (big blind) folded on the Flop
Seat 8: MaFak2019 mucked [9h Jd]
Seat 9: mnnm585 folded on the Flop



PokerStars Home Game Hand #227984518700: {DaPokaStars}  Hold'em No Limit (50/100) - 2021/07/01 16:35:22 ET
Table 'JULY 1' 9-max (Play Money) Seat #4 is the button
Seat 1: color_singleton (22958 in chips) 
Seat 2: HighCardJasper (7409 in chips) 
Seat 3: appositive (14459 in chips) 
Seat 4: PokerStarsMan12 (29782 in chips) 
Seat 5: Klemtonius (3302 in chips) 
Seat 8: MaFak2019 (9578 in chips) 
Seat 9: mnnm585 (13826 in chips) 
Klemtonius: posts small blind 50
MaFak2019: posts big blind 100
*** HOLE CARDS ***
Dealt to PokerStarsMan12 [6d Js]
mnnm585: calls 100
color_singleton: calls 100
HighCardJasper: calls 100
appositive: calls 100
PokerStarsMan12: calls 100
Klemtonius: calls 50
MaFak2019: checks 
*** FLOP *** [7d 9c Tc]
Klemtonius: bets 661
MaFak2019: folds 
mnnm585: folds 
color_singleton: folds 
HighCardJasper: folds 
appositive: calls 661
PokerStarsMan12: folds 
*** TURN *** [7d 9c Tc] [4s]
Klemtonius: checks 
appositive: bets 500
Klemtonius: calls 500
*** RIVER *** [7d 9c Tc 4s] [9d]
Klemtonius: bets 2041 and is all-in
appositive: folds 
Uncalled bet (2041) returned to Klemtonius
Klemtonius collected 2856 from pot
Klemtonius: doesn't show hand 
*** SUMMARY ***
Total pot 3022 | Rake 166 
Board [7d 9c Tc 4s 9d]
Seat 1: color_singleton folded on the Flop
Seat 2: HighCardJasper folded on the Flop
Seat 3: appositive folded on the River
Seat 4: PokerStarsMan12 (button) folded on the Flop
Seat 5: Klemtonius (small blind) collected (2856)
Seat 8: MaFak2019 (big blind) folded on the Flop
Seat 9: mnnm585 folded on the Flop



PokerStars Home Game Hand #227984560713: {DaPokaStars}  Hold'em No Limit (50/100) - 2021/07/01 16:36:51 ET
Table 'JULY 1' 9-max (Play Money) Seat #5 is the button
Seat 1: color_singleton (22858 in chips) 
Seat 2: HighCardJasper (7309 in chips) 
Seat 3: appositive (13198 in chips) 
Seat 4: PokerStarsMan12 (29682 in chips) 
Seat 5: Klemtonius (4897 in chips) 
Seat 8: MaFak2019 (9478 in chips) 
Seat 9: mnnm585 (13726 in chips) 
MaFak2019: posts small blind 50
mnnm585: posts big blind 100
*** HOLE CARDS ***
Dealt to PokerStarsMan12 [Kc 3h]
color_singleton: folds 
HighCardJasper: folds 
appositive: calls 100
PokerStarsMan12: folds 
Klemtonius: calls 100
MaFak2019: calls 50
mnnm585: checks 
*** FLOP *** [9s 4c Qs]
MaFak2019: checks 
mnnm585: checks 
appositive: checks 
Klemtonius: bets 189
MaFak2019: calls 189
mnnm585: folds 
appositive: calls 189
*** TURN *** [9s 4c Qs] [As]
MaFak2019: checks 
appositive: checks 
Klemtonius: checks 
*** RIVER *** [9s 4c Qs As] [Ac]
MaFak2019: checks 
appositive: checks 
Klemtonius: bets 914
MaFak2019: folds 
appositive: folds 
Uncalled bet (914) returned to Klemtonius
Klemtonius collected 914 from pot
Klemtonius: doesn't show hand 
*** SUMMARY ***
Total pot 967 | Rake 53 
Board [9s 4c Qs As Ac]
Seat 1: color_singleton folded before Flop (didn't bet)
Seat 2: HighCardJasper folded before Flop (didn't bet)
Seat 3: appositive folded on the River
Seat 4: PokerStarsMan12 folded before Flop (didn't bet)
Seat 5: Klemtonius (button) collected (914)
Seat 8: MaFak2019 (small blind) folded on the River
Seat 9: mnnm585 (big blind) folded on the Flop



PokerStars Home Game Hand #227984611224: {DaPokaStars}  Hold'em No Limit (50/100) - 2021/07/01 16:38:38 ET
Table 'JULY 1' 9-max (Play Money) Seat #8 is the button
Seat 1: color_singleton (22858 in chips) 
Seat 2: HighCardJasper (7309 in chips) 
Seat 3: appositive (12909 in chips) 
Seat 4: PokerStarsMan12 (29682 in chips) 
Seat 5: Klemtonius (5522 in chips) 
Seat 8: MaFak2019 (9189 in chips) 
Seat 9: mnnm585 (13626 in chips) 
mnnm585: posts small blind 50
color_singleton: posts big blind 100
*** HOLE CARDS ***
Dealt to PokerStarsMan12 [Kh 6h]
HighCardJasper: calls 100
appositive: calls 100
PokerStarsMan12: calls 100
Klemtonius: calls 100
MaFak2019: calls 100
mnnm585: calls 50
color_singleton: checks 
*** FLOP *** [7s Ac 9c]
mnnm585: bets 330
color_singleton: folds 
HighCardJasper: folds 
appositive: calls 330
PokerStarsMan12: folds 
Klemtonius: folds 
MaFak2019: calls 330
*** TURN *** [7s Ac 9c] [Qs]
mnnm585: bets 798
appositive: folds 
MaFak2019: calls 798
*** RIVER *** [7s Ac 9c Qs] [5s]
mnnm585: checks 
MaFak2019: checks 
*** SHOW DOWN ***
mnnm585: shows [4d Ad] (a pair of Aces)
MaFak2019: mucks hand 
mnnm585 collected 3105 from pot
*** SUMMARY ***
Total pot 3286 | Rake 181 
Board [7s Ac 9c Qs 5s]
Seat 1: color_singleton (big blind) folded on the Flop
Seat 2: HighCardJasper folded on the Flop
Seat 3: appositive folded on the Turn
Seat 4: PokerStarsMan12 folded on the Flop
Seat 5: Klemtonius folded on the Flop
Seat 8: MaFak2019 (button) mucked [Tc Jd]
Seat 9: mnnm585 (small blind) showed [4d Ad] and won (3105) with a pair of Aces



PokerStars Home Game Hand #227984649011: {DaPokaStars}  Hold'em No Limit (50/100) - 2021/07/01 16:39:58 ET
Table 'JULY 1' 9-max (Play Money) Seat #9 is the button
Seat 1: color_singleton (22758 in chips) 
Seat 2: HighCardJasper (7209 in chips) 
Seat 3: appositive (12479 in chips) 
Seat 4: PokerStarsMan12 (29582 in chips) 
Seat 5: Klemtonius (5422 in chips) 
Seat 8: MaFak2019 (7961 in chips) 
Seat 9: mnnm585 (15503 in chips) 
color_singleton: posts small blind 50
HighCardJasper: posts big blind 100
*** HOLE CARDS ***
Dealt to PokerStarsMan12 [5c 9h]
appositive: calls 100
PokerStarsMan12: folds 
Klemtonius: calls 100
MaFak2019: calls 100
mnnm585: calls 100
color_singleton: calls 50
HighCardJasper: checks 
*** FLOP *** [Qd Ah 6h]
color_singleton: checks 
HighCardJasper: checks 
appositive: checks 
Klemtonius: checks 
MaFak2019: checks 
mnnm585: checks 
*** TURN *** [Qd Ah 6h] [Ad]
color_singleton: checks 
HighCardJasper: checks 
appositive: checks 
Klemtonius: checks 
MaFak2019: checks 
mnnm585: bets 567
color_singleton: folds 
HighCardJasper: folds 
appositive: calls 567
Klemtonius: folds 
MaFak2019: folds 
*** RIVER *** [Qd Ah 6h Ad] [6d]
appositive: bets 819
mnnm585: calls 819
*** SHOW DOWN ***
appositive: shows [Kc 6c] (a full house, Sixes full of Aces)
mnnm585: mucks hand 
appositive collected 3187 from pot
*** SUMMARY ***
Total pot 3372 | Rake 185 
Board [Qd Ah 6h Ad 6d]
Seat 1: color_singleton (small blind) folded on the Turn
Seat 2: HighCardJasper (big blind) folded on the Turn
Seat 3: appositive showed [Kc 6c] and won (3187) with a full house, Sixes full of Aces
Seat 4: PokerStarsMan12 folded before Flop (didn't bet)
Seat 5: Klemtonius folded on the Turn
Seat 8: MaFak2019 folded on the Turn
Seat 9: mnnm585 (button) mucked [3d Qc]



PokerStars Home Game Hand #227984687318: {DaPokaStars}  Hold'em No Limit (50/100) - 2021/07/01 16:41:21 ET
Table 'JULY 1' 9-max (Play Money) Seat #1 is the button
Seat 1: color_singleton (22658 in chips) 
Seat 2: HighCardJasper (7109 in chips) 
Seat 3: appositive (14180 in chips) 
Seat 4: PokerStarsMan12 (29582 in chips) 
Seat 5: Klemtonius (5322 in chips) 
Seat 8: MaFak2019 (7861 in chips) 
Seat 9: mnnm585 (14017 in chips) 
HighCardJasper: posts small blind 50
appositive: posts big blind 100
*** HOLE CARDS ***
Dealt to PokerStarsMan12 [4s 9d]
PokerStarsMan12: folds 
Klemtonius: raises 100 to 200
MaFak2019: folds 
mnnm585: folds 
color_singleton: calls 200
HighCardJasper: calls 150
appositive: calls 100
*** FLOP *** [2s 9c 4c]
HighCardJasper: checks 
appositive: checks 
Klemtonius: bets 756
color_singleton: calls 756
HighCardJasper: folds 
appositive: folds 
*** TURN *** [2s 9c 4c] [6s]
Klemtonius: checks 
color_singleton: bets 1092
Klemtonius: folds 
Uncalled bet (1092) returned to color_singleton
color_singleton collected 2185 from pot
color_singleton: doesn't show hand 
*** SUMMARY ***
Total pot 2312 | Rake 127 
Board [2s 9c 4c 6s]
Seat 1: color_singleton (button) collected (2185)
Seat 2: HighCardJasper (small blind) folded on the Flop
Seat 3: appositive (big blind) folded on the Flop
Seat 4: PokerStarsMan12 folded before Flop (didn't bet)
Seat 5: Klemtonius folded on the Turn
Seat 8: MaFak2019 folded before Flop (didn't bet)
Seat 9: mnnm585 folded before Flop (didn't bet)



PokerStars Home Game Hand #227984710397: {DaPokaStars}  Hold'em No Limit (50/100) - 2021/07/01 16:42:10 ET
Table 'JULY 1' 9-max (Play Money) Seat #2 is the button
Seat 1: color_singleton (23887 in chips) 
Seat 2: HighCardJasper (6909 in chips) 
Seat 3: appositive (13980 in chips) 
Seat 4: PokerStarsMan12 (29582 in chips) 
Seat 5: Klemtonius (4366 in chips) 
Seat 8: MaFak2019 (7861 in chips) 
Seat 9: mnnm585 (14017 in chips) 
appositive: posts small blind 50
PokerStarsMan12: posts big blind 100
*** HOLE CARDS ***
Dealt to PokerStarsMan12 [8d 6d]
Klemtonius: calls 100
MaFak2019: calls 100
mnnm585: folds 
color_singleton: calls 100
HighCardJasper has timed out
HighCardJasper: folds 
appositive: calls 50
PokerStarsMan12: checks 
*** FLOP *** [5s Jd 6h]
appositive: checks 
PokerStarsMan12: checks 
Klemtonius: checks 
MaFak2019: bets 472
color_singleton: calls 472
appositive: folds 
PokerStarsMan12: folds 
Klemtonius: folds 
*** TURN *** [5s Jd 6h] [Td]
MaFak2019: bets 1365
color_singleton: folds 
Uncalled bet (1365) returned to MaFak2019
MaFak2019 collected 1365 from pot
MaFak2019: doesn't show hand 
*** SUMMARY ***
Total pot 1444 | Rake 79 
Board [5s Jd 6h Td]
Seat 1: color_singleton folded on the Turn
Seat 2: HighCardJasper (button) folded before Flop (didn't bet)
Seat 3: appositive (small blind) folded on the Flop
Seat 4: PokerStarsMan12 (big blind) folded on the Flop
Seat 5: Klemtonius folded on the Flop
Seat 8: MaFak2019 collected (1365)
Seat 9: mnnm585 folded before Flop (didn't bet)



PokerStars Home Game Hand #227984736013: {DaPokaStars}  Hold'em No Limit (50/100) - 2021/07/01 16:43:06 ET
Table 'JULY 1' 9-max (Play Money) Seat #3 is the button
Seat 1: color_singleton (23315 in chips) 
Seat 3: appositive (13880 in chips) 
Seat 4: PokerStarsMan12 (29482 in chips) 
Seat 5: Klemtonius (4266 in chips) 
Seat 8: MaFak2019 (8654 in chips) 
Seat 9: mnnm585 (14017 in chips) 
PokerStarsMan12: posts small blind 50
Klemtonius: posts big blind 100
*** HOLE CARDS ***
Dealt to PokerStarsMan12 [9c Qd]
MaFak2019: folds 
mnnm585: folds 
color_singleton: raises 200 to 300
appositive: folds 
PokerStarsMan12: calls 250
Klemtonius: folds 
*** FLOP *** [8s 6c 9s]
PokerStarsMan12: bets 400
color_singleton: calls 400
*** TURN *** [8s 6c 9s] [Jc]
PokerStarsMan12: checks 
color_singleton: bets 708
PokerStarsMan12: calls 708
*** RIVER *** [8s 6c 9s Jc] [6s]
PokerStarsMan12: checks 
color_singleton: bets 1378
PokerStarsMan12: folds 
Uncalled bet (1378) returned to color_singleton
color_singleton collected 2756 from pot
color_singleton: doesn't show hand 
*** SUMMARY ***
Total pot 2916 | Rake 160 
Board [8s 6c 9s Jc 6s]
Seat 1: color_singleton collected (2756)
Seat 3: appositive (button) folded before Flop (didn't bet)
Seat 4: PokerStarsMan12 (small blind) folded on the River
Seat 5: Klemtonius (big blind) folded before Flop
Seat 8: MaFak2019 folded before Flop (didn't bet)
Seat 9: mnnm585 folded before Flop (didn't bet)



PokerStars Home Game Hand #227984760112: {DaPokaStars}  Hold'em No Limit (50/100) - 2021/07/01 16:43:59 ET
Table 'JULY 1' 9-max (Play Money) Seat #4 is the button
Seat 1: color_singleton (24663 in chips) 
Seat 2: HighCardJasper (6909 in chips) 
Seat 4: PokerStarsMan12 (28074 in chips) 
Seat 5: Klemtonius (4166 in chips) 
Seat 8: MaFak2019 (8654 in chips) 
Seat 9: mnnm585 (14017 in chips) 
Klemtonius: posts small blind 50
MaFak2019: posts big blind 100
*** HOLE CARDS ***
Dealt to PokerStarsMan12 [3s 5d]
mnnm585: raises 100 to 200
color_singleton: folds 
HighCardJasper: calls 200
PokerStarsMan12: folds 
Klemtonius: calls 150
MaFak2019: calls 100
*** FLOP *** [6d Qc Ts]
Klemtonius: bets 756
MaFak2019: raises 756 to 1512
mnnm585: calls 1512
HighCardJasper: folds 
Klemtonius: calls 756
*** TURN *** [6d Qc Ts] [2h]
Klemtonius: checks 
MaFak2019: bets 5043
mnnm585: calls 5043
Klemtonius: folds 
*** RIVER *** [6d Qc Ts 2h] [6s]
MaFak2019: checks 
mnnm585: checks 
*** SHOW DOWN ***
MaFak2019: shows [Qh Td] (two pair, Queens and Tens)
mnnm585: shows [Ac As] (two pair, Aces and Sixes)
mnnm585 collected 14574 from pot
*** SUMMARY ***
Total pot 15422 | Rake 848 
Board [6d Qc Ts 2h 6s]
Seat 1: color_singleton folded before Flop (didn't bet)
Seat 2: HighCardJasper folded on the Flop
Seat 4: PokerStarsMan12 (button) folded before Flop (didn't bet)
Seat 5: Klemtonius (small blind) folded on the Turn
Seat 8: MaFak2019 (big blind) showed [Qh Td] and lost with two pair, Queens and Tens
Seat 9: mnnm585 showed [Ac As] and won (14574) with two pair, Aces and Sixes



PokerStars Home Game Hand #227984784507: {DaPokaStars}  Hold'em No Limit (50/100) - 2021/07/01 16:44:52 ET
Table 'JULY 1' 9-max (Play Money) Seat #5 is the button
Seat 1: color_singleton (24663 in chips) 
Seat 2: HighCardJasper (6709 in chips) 
Seat 3: appositive (13880 in chips) 
Seat 4: PokerStarsMan12 (28074 in chips) 
Seat 5: Klemtonius (2454 in chips) 
Seat 8: MaFak2019 (1899 in chips) 
Seat 9: mnnm585 (21836 in chips) 
MaFak2019: posts small blind 50
mnnm585: posts big blind 100
*** HOLE CARDS ***
Dealt to PokerStarsMan12 [2c Tc]
color_singleton: raises 200 to 300
HighCardJasper: folds 
appositive: folds 
PokerStarsMan12: folds 
Klemtonius: raises 200 to 500
MaFak2019: calls 450
mnnm585: folds 
color_singleton: calls 200
*** FLOP *** [4c 2h 8s]
MaFak2019: checks 
color_singleton: checks 
Klemtonius: bets 1512
MaFak2019: calls 1399 and is all-in
color_singleton: folds 
Uncalled bet (113) returned to Klemtonius
*** TURN *** [4c 2h 8s] [Kd]
*** RIVER *** [4c 2h 8s Kd] [Kh]
*** SHOW DOWN ***
MaFak2019: shows [6h 8d] (two pair, Kings and Eights)
Klemtonius: shows [As 6s] (a pair of Kings)
MaFak2019 collected 4156 from pot
*** SUMMARY ***
Total pot 4398 | Rake 242 
Board [4c 2h 8s Kd Kh]
Seat 1: color_singleton folded on the Flop
Seat 2: HighCardJasper folded before Flop (didn't bet)
Seat 3: appositive folded before Flop (didn't bet)
Seat 4: PokerStarsMan12 folded before Flop (didn't bet)
Seat 5: Klemtonius (button) showed [As 6s] and lost with a pair of Kings
Seat 8: MaFak2019 (small blind) showed [6h 8d] and won (4156) with two pair, Kings and Eights
Seat 9: mnnm585 (big blind) folded before Flop



PokerStars Home Game Hand #227984805649: {DaPokaStars}  Hold'em No Limit (50/100) - 2021/07/01 16:45:37 ET
Table 'JULY 1' 9-max (Play Money) Seat #8 is the button
Seat 1: color_singleton (24163 in chips) 
Seat 2: HighCardJasper (6709 in chips) 
Seat 3: appositive (13880 in chips) 
Seat 4: PokerStarsMan12 (28074 in chips) 
Seat 5: Klemtonius (555 in chips) 
Seat 8: MaFak2019 (4156 in chips) 
Seat 9: mnnm585 (21736 in chips) 
mnnm585: posts small blind 50
color_singleton: posts big blind 100
*** HOLE CARDS ***
Dealt to PokerStarsMan12 [8d 9d]
HighCardJasper: folds 
appositive: folds 
PokerStarsMan12: calls 100
Klemtonius: calls 100
MaFak2019: raises 100 to 200
mnnm585: calls 150
color_singleton: calls 100
PokerStarsMan12: calls 100
Klemtonius: calls 100
*** FLOP *** [7h 7c 6c]
mnnm585: checks 
color_singleton: bets 472
PokerStarsMan12: calls 472
Klemtonius: folds 
MaFak2019: raises 2361 to 2833
mnnm585: folds 
color_singleton: folds 
PokerStarsMan12: raises 2361 to 5194
MaFak2019: calls 1123 and is all-in
Uncalled bet (1238) returned to PokerStarsMan12
*** TURN *** [7h 7c 6c] [Js]
*** RIVER *** [7h 7c 6c Js] [Jc]
*** SHOW DOWN ***
PokerStarsMan12: shows [8d 9d] (two pair, Jacks and Sevens)
MaFak2019: shows [5c 3c] (a flush, Jack high)
MaFak2019 collected 8868 from pot
*** SUMMARY ***
Total pot 9384 | Rake 516 
Board [7h 7c 6c Js Jc]
Seat 1: color_singleton (big blind) folded on the Flop
Seat 2: HighCardJasper folded before Flop (didn't bet)
Seat 3: appositive folded before Flop (didn't bet)
Seat 4: PokerStarsMan12 showed [8d 9d] and lost with two pair, Jacks and Sevens
Seat 5: Klemtonius folded on the Flop
Seat 8: MaFak2019 (button) showed [5c 3c] and won (8868) with a flush, Jack high
Seat 9: mnnm585 (small blind) folded on the Flop



PokerStars Home Game Hand #227984839466: {DaPokaStars}  Hold'em No Limit (50/100) - 2021/07/01 16:46:47 ET
Table 'JULY 1' 9-max (Play Money) Seat #9 is the button
Seat 1: color_singleton (23491 in chips) 
Seat 2: HighCardJasper (6709 in chips) 
Seat 3: appositive (13880 in chips) 
Seat 4: PokerStarsMan12 (23918 in chips) 
Seat 5: Klemtonius (355 in chips) 
Seat 8: MaFak2019 (8868 in chips) 
Seat 9: mnnm585 (21536 in chips) 
color_singleton: posts small blind 50
HighCardJasper: posts big blind 100
*** HOLE CARDS ***
Dealt to PokerStarsMan12 [7d 6s]
appositive: folds 
PokerStarsMan12: calls 100
Klemtonius: raises 255 to 355 and is all-in
MaFak2019: calls 355
mnnm585: folds 
color_singleton: calls 305
HighCardJasper: folds 
PokerStarsMan12: calls 255
*** FLOP *** [7h Tc 9h]
color_singleton: checks 
PokerStarsMan12: checks 
MaFak2019: checks 
*** TURN *** [7h Tc 9h] [2c]
color_singleton: checks 
PokerStarsMan12: checks 
MaFak2019: checks 
*** RIVER *** [7h Tc 9h 2c] [Kh]
color_singleton: checks 
PokerStarsMan12: checks 
MaFak2019: checks 
*** SHOW DOWN ***
color_singleton: shows [Ac 3d] (high card Ace)
PokerStarsMan12: shows [7d 6s] (a pair of Sevens)
Klemtonius: shows [6d Kc] (a pair of Kings)
MaFak2019: mucks hand 
Klemtonius collected 1436 from pot
*** SUMMARY ***
Total pot 1520 | Rake 84 
Board [7h Tc 9h 2c Kh]
Seat 1: color_singleton (small blind) showed [Ac 3d] and lost with high card Ace
Seat 2: HighCardJasper (big blind) folded before Flop
Seat 3: appositive folded before Flop (didn't bet)
Seat 4: PokerStarsMan12 showed [7d 6s] and lost with a pair of Sevens
Seat 5: Klemtonius showed [6d Kc] and won (1436) with a pair of Kings
Seat 8: MaFak2019 mucked [4h 6c]
Seat 9: mnnm585 (button) folded before Flop (didn't bet)



PokerStars Home Game Hand #227984865447: {DaPokaStars}  Hold'em No Limit (50/100) - 2021/07/01 16:47:42 ET
Table 'JULY 1' 9-max (Play Money) Seat #1 is the button
Seat 1: color_singleton (23136 in chips) 
Seat 2: HighCardJasper (6609 in chips) 
Seat 3: appositive (13880 in chips) 
Seat 4: PokerStarsMan12 (23563 in chips) 
Seat 5: Klemtonius (1436 in chips) 
Seat 8: MaFak2019 (8513 in chips) 
Seat 9: mnnm585 (21536 in chips) 
HighCardJasper: posts small blind 50
appositive: posts big blind 100
*** HOLE CARDS ***
Dealt to PokerStarsMan12 [8d Qh]
PokerStarsMan12: calls 100
Klemtonius: raises 700 to 800
MaFak2019: calls 800
mnnm585: folds 
color_singleton: folds 
HighCardJasper: folds 
appositive: calls 700
PokerStarsMan12: folds 
*** FLOP *** [8h Ks 2d]
appositive: checks 
Klemtonius: bets 636 and is all-in
MaFak2019: folds 
appositive: calls 636
*** TURN *** [8h Ks 2d] [6h]
*** RIVER *** [8h Ks 2d 6h] [Qc]
*** SHOW DOWN ***
appositive: shows [4s 5d] (high card King)
Klemtonius: shows [4d Kd] (a pair of Kings)
Klemtonius collected 3612 from pot
*** SUMMARY ***
Total pot 3822 | Rake 210 
Board [8h Ks 2d 6h Qc]
Seat 1: color_singleton (button) folded before Flop (didn't bet)
Seat 2: HighCardJasper (small blind) folded before Flop
Seat 3: appositive (big blind) showed [4s 5d] and lost with high card King
Seat 4: PokerStarsMan12 folded before Flop
Seat 5: Klemtonius showed [4d Kd] and won (3612) with a pair of Kings
Seat 8: MaFak2019 folded on the Flop
Seat 9: mnnm585 folded before Flop (didn't bet)



PokerStars Home Game Hand #227984895377: {DaPokaStars}  Hold'em No Limit (50/100) - 2021/07/01 16:48:40 ET
Table 'JULY 1' 9-max (Play Money) Seat #2 is the button
Seat 1: color_singleton (23136 in chips) 
Seat 2: HighCardJasper (6559 in chips) 
Seat 3: appositive (12444 in chips) 
Seat 4: PokerStarsMan12 (23463 in chips) 
Seat 5: Klemtonius (3612 in chips) 
Seat 8: MaFak2019 (7713 in chips) 
Seat 9: mnnm585 (21536 in chips) 
appositive: posts small blind 50
PokerStarsMan12: posts big blind 100
*** HOLE CARDS ***
Dealt to PokerStarsMan12 [Jh 7h]
Klemtonius: raises 600 to 700
MaFak2019: raises 600 to 1300
mnnm585: folds 
color_singleton: folds 
HighCardJasper: calls 1300
appositive: folds 
PokerStarsMan12: folds 
Klemtonius: calls 600
*** FLOP *** [3h Kh 6s]
Klemtonius: checks 
MaFak2019: checks 
HighCardJasper: bets 3827
Klemtonius: folds 
MaFak2019: folds 
Uncalled bet (3827) returned to HighCardJasper
HighCardJasper collected 3827 from pot
HighCardJasper: doesn't show hand 
*** SUMMARY ***
Total pot 4050 | Rake 223 
Board [3h Kh 6s]
Seat 1: color_singleton folded before Flop (didn't bet)
Seat 2: HighCardJasper (button) collected (3827)
Seat 3: appositive (small blind) folded before Flop
Seat 4: PokerStarsMan12 (big blind) folded before Flop
Seat 5: Klemtonius folded on the Flop
Seat 8: MaFak2019 folded on the Flop
Seat 9: mnnm585 folded before Flop (didn't bet)



PokerStars Home Game Hand #227984921137: {DaPokaStars}  Hold'em No Limit (50/100) - 2021/07/01 16:49:35 ET
Table 'JULY 1' 9-max (Play Money) Seat #3 is the button
Seat 1: color_singleton (23136 in chips) 
Seat 2: HighCardJasper (9086 in chips) 
Seat 3: appositive (12394 in chips) 
Seat 4: PokerStarsMan12 (23363 in chips) 
Seat 5: Klemtonius (2312 in chips) 
Seat 8: MaFak2019 (6413 in chips) 
Seat 9: mnnm585 (21536 in chips) 
PokerStarsMan12: posts small blind 50
Klemtonius: posts big blind 100
*** HOLE CARDS ***
Dealt to PokerStarsMan12 [Kc Qc]
MaFak2019: calls 100
mnnm585: calls 100
color_singleton: calls 100
HighCardJasper: raises 400 to 500
appositive: calls 500
PokerStarsMan12: calls 450
Klemtonius: folds 
MaFak2019: folds 
mnnm585: calls 400
color_singleton: calls 400
*** FLOP *** [5d Kd 2c]
PokerStarsMan12: bets 1300
mnnm585: folds 
color_singleton: folds 
HighCardJasper: folds 
appositive: raises 1300 to 2600
PokerStarsMan12: calls 1300
*** TURN *** [5d Kd 2c] [4h]
PokerStarsMan12: checks 
appositive: bets 7465
PokerStarsMan12: raises 7465 to 14930
appositive: calls 1829 and is all-in
Uncalled bet (5636) returned to PokerStarsMan12
*** RIVER *** [5d Kd 2c 4h] [Ad]
*** SHOW DOWN ***
PokerStarsMan12: shows [Kc Qc] (a pair of Kings)
appositive: shows [Kh Ks] (three of a kind, Kings)
appositive collected 25031 from pot
*** SUMMARY ***
Total pot 26488 | Rake 1457 
Board [5d Kd 2c 4h Ad]
Seat 1: color_singleton folded on the Flop
Seat 2: HighCardJasper folded on the Flop
Seat 3: appositive (button) showed [Kh Ks] and won (25031) with three of a kind, Kings
Seat 4: PokerStarsMan12 (small blind) showed [Kc Qc] and lost with a pair of Kings
Seat 5: Klemtonius (big blind) folded before Flop
Seat 8: MaFak2019 folded before Flop
Seat 9: mnnm585 folded on the Flop



PokerStars Home Game Hand #227984967155: {DaPokaStars}  Hold'em No Limit (50/100) - 2021/07/01 16:51:15 ET
Table 'JULY 1' 9-max (Play Money) Seat #4 is the button
Seat 1: color_singleton (22636 in chips) 
Seat 2: HighCardJasper (8586 in chips) 
Seat 3: appositive (25031 in chips) 
Seat 4: PokerStarsMan12 (10969 in chips) 
Seat 5: Klemtonius (2212 in chips) 
Seat 8: MaFak2019 (6313 in chips) 
Seat 9: mnnm585 (21036 in chips) 
Klemtonius: posts small blind 50
MaFak2019: posts big blind 100
*** HOLE CARDS ***
Dealt to PokerStarsMan12 [6h 4d]
mnnm585: calls 100
color_singleton: folds 
HighCardJasper: raises 100 to 200
appositive: folds 
PokerStarsMan12: folds 
Klemtonius: raises 400 to 600
MaFak2019: calls 500
mnnm585: folds 
HighCardJasper: calls 400
*** FLOP *** [8s Qd 9s]
Klemtonius: bets 1612 and is all-in
MaFak2019: calls 1612
HighCardJasper: calls 1612
*** TURN *** [8s Qd 9s] [Ts]
MaFak2019: checks 
HighCardJasper: checks 
*** RIVER *** [8s Qd 9s Ts] [6c]
MaFak2019: bets 4101 and is all-in
HighCardJasper: folds 
Uncalled bet (4101) returned to MaFak2019
*** SHOW DOWN ***
MaFak2019: shows [2s 6s] (a flush, Ten high)
Klemtonius: shows [Qc Ad] (a pair of Queens)
MaFak2019 collected 6366 from pot
*** SUMMARY ***
Total pot 6736 | Rake 370 
Board [8s Qd 9s Ts 6c]
Seat 1: color_singleton folded before Flop (didn't bet)
Seat 2: HighCardJasper folded on the River
Seat 3: appositive folded before Flop (didn't bet)
Seat 4: PokerStarsMan12 (button) folded before Flop (didn't bet)
Seat 5: Klemtonius (small blind) showed [Qc Ad] and lost with a pair of Queens
Seat 8: MaFak2019 (big blind) showed [2s 6s] and won (6366) with a flush, Ten high
Seat 9: mnnm585 folded before Flop



PokerStars Home Game Hand #227985001692: {DaPokaStars}  Hold'em No Limit (50/100) - 2021/07/01 16:52:29 ET
Table 'JULY 1' 9-max (Play Money) Seat #8 is the button
Seat 1: color_singleton (22636 in chips) 
Seat 2: HighCardJasper (6374 in chips) 
Seat 3: appositive (25031 in chips) 
Seat 4: PokerStarsMan12 (10969 in chips) 
Seat 8: MaFak2019 (10467 in chips) 
Seat 9: mnnm585 (20936 in chips) 
mnnm585: posts small blind 50
color_singleton: posts big blind 100
*** HOLE CARDS ***
Dealt to PokerStarsMan12 [8h Ad]
HighCardJasper: calls 100
appositive: folds 
PokerStarsMan12: calls 100
MaFak2019: calls 100
mnnm585: calls 50
color_singleton: checks 
*** FLOP *** [6d As 6s]
mnnm585: checks 
color_singleton: bets 236
HighCardJasper: folds 
PokerStarsMan12: calls 236
MaFak2019: folds 
mnnm585: folds 
*** TURN *** [6d As 6s] [6h]
color_singleton: bets 459
PokerStarsMan12: calls 459
*** RIVER *** [6d As 6s 6h] [2c]
color_singleton: checks 
PokerStarsMan12: bets 1000
color_singleton: folds 
Uncalled bet (1000) returned to PokerStarsMan12
PokerStarsMan12 collected 1786 from pot
*** SUMMARY ***
Total pot 1890 | Rake 104 
Board [6d As 6s 6h 2c]
Seat 1: color_singleton (big blind) folded on the River
Seat 2: HighCardJasper folded on the Flop
Seat 3: appositive folded before Flop (didn't bet)
Seat 4: PokerStarsMan12 collected (1786)
Seat 8: MaFak2019 (button) folded on the Flop
Seat 9: mnnm585 (small blind) folded on the Flop



PokerStars Home Game Hand #227985029049: {DaPokaStars}  Hold'em No Limit (50/100) - 2021/07/01 16:53:28 ET
Table 'JULY 1' 9-max (Play Money) Seat #9 is the button
Seat 1: color_singleton (21841 in chips) 
Seat 2: HighCardJasper (6274 in chips) 
Seat 3: appositive (25031 in chips) 
Seat 4: PokerStarsMan12 (11960 in chips) 
Seat 8: MaFak2019 (10367 in chips) 
Seat 9: mnnm585 (20836 in chips) 
color_singleton: posts small blind 50
HighCardJasper: posts big blind 100
*** HOLE CARDS ***
Dealt to PokerStarsMan12 [5s 7c]
appositive: calls 100
PokerStarsMan12: folds 
MaFak2019: raises 350 to 450
mnnm585: calls 450
color_singleton: folds 
HighCardJasper: folds 
appositive: calls 350
*** FLOP *** [3d 3c 8c]
appositive: checks 
MaFak2019: checks 
mnnm585: checks 
*** TURN *** [3d 3c 8c] [9d]
appositive: checks 
MaFak2019: checks 
mnnm585: checks 
*** RIVER *** [3d 3c 8c 9d] [As]
appositive: checks 
MaFak2019: bets 1417
mnnm585: folds 
appositive: folds 
Uncalled bet (1417) returned to MaFak2019
MaFak2019 collected 1417 from pot
MaFak2019: doesn't show hand 
*** SUMMARY ***
Total pot 1500 | Rake 83 
Board [3d 3c 8c 9d As]
Seat 1: color_singleton (small blind) folded before Flop
Seat 2: HighCardJasper (big blind) folded before Flop
Seat 3: appositive folded on the River
Seat 4: PokerStarsMan12 folded before Flop (didn't bet)
Seat 8: MaFak2019 collected (1417)
Seat 9: mnnm585 (button) folded on the River



PokerStars Home Game Hand #227985045333: {DaPokaStars}  Hold'em No Limit (50/100) - 2021/07/01 16:54:03 ET
Table 'JULY 1' 9-max (Play Money) Seat #1 is the button
Seat 1: color_singleton (21791 in chips) 
Seat 2: HighCardJasper (6174 in chips) 
Seat 3: appositive (24581 in chips) 
Seat 4: PokerStarsMan12 (11960 in chips) 
Seat 8: MaFak2019 (11334 in chips) 
Seat 9: mnnm585 (20386 in chips) 
HighCardJasper: posts small blind 50
appositive: posts big blind 100
*** HOLE CARDS ***
Dealt to PokerStarsMan12 [2h Ad]
PokerStarsMan12: calls 100
MaFak2019: raises 350 to 450
mnnm585: folds 
color_singleton: folds 
HighCardJasper: folds 
appositive: folds 
PokerStarsMan12: calls 350
*** FLOP *** [Qc Qh 4c]
PokerStarsMan12: checks 
MaFak2019: checks 
*** TURN *** [Qc Qh 4c] [5d]
PokerStarsMan12: checks 
MaFak2019: bets 992
PokerStarsMan12: folds 
Uncalled bet (992) returned to MaFak2019
MaFak2019 collected 992 from pot
MaFak2019: doesn't show hand 
*** SUMMARY ***
Total pot 1050 | Rake 58 
Board [Qc Qh 4c 5d]
Seat 1: color_singleton (button) folded before Flop (didn't bet)
Seat 2: HighCardJasper (small blind) folded before Flop
Seat 3: appositive (big blind) folded before Flop
Seat 4: PokerStarsMan12 folded on the Turn
Seat 8: MaFak2019 collected (992)
Seat 9: mnnm585 folded before Flop (didn't bet)



PokerStars Home Game Hand #227985061224: {DaPokaStars}  Hold'em No Limit (50/100) - 2021/07/01 16:54:38 ET
Table 'JULY 1' 9-max (Play Money) Seat #2 is the button
Seat 1: color_singleton (21791 in chips) 
Seat 2: HighCardJasper (6124 in chips) 
Seat 3: appositive (24481 in chips) 
Seat 4: PokerStarsMan12 (11510 in chips) 
Seat 8: MaFak2019 (11876 in chips) 
Seat 9: mnnm585 (20386 in chips) 
appositive: posts small blind 50
PokerStarsMan12: posts big blind 100
*** HOLE CARDS ***
Dealt to PokerStarsMan12 [Qh Ad]
MaFak2019: calls 100
mnnm585: calls 100
color_singleton has timed out
color_singleton: folds 
HighCardJasper: calls 100
appositive: calls 50
PokerStarsMan12: raises 400 to 500
MaFak2019: calls 400
mnnm585: calls 400
HighCardJasper: folds 
appositive: calls 400
*** FLOP *** [5c 3c Kc]
appositive: bets 992
PokerStarsMan12: folds 
MaFak2019: folds 
mnnm585: calls 992
*** TURN *** [5c 3c Kc] [7s]
appositive: bets 1929
mnnm585: calls 1929
*** RIVER *** [5c 3c Kc 7s] [Tc]
appositive: bets 7505
mnnm585: folds 
Uncalled bet (7505) returned to appositive
appositive collected 7505 from pot
appositive: doesn't show hand 
*** SUMMARY ***
Total pot 7942 | Rake 437 
Board [5c 3c Kc 7s Tc]
Seat 1: color_singleton folded before Flop (didn't bet)
Seat 2: HighCardJasper (button) folded before Flop
Seat 3: appositive (small blind) collected (7505)
Seat 4: PokerStarsMan12 (big blind) folded on the Flop
Seat 8: MaFak2019 folded on the Flop
Seat 9: mnnm585 folded on the River



PokerStars Home Game Hand #227985099300: {DaPokaStars}  Hold'em No Limit (50/100) - 2021/07/01 16:56:07 ET
Table 'JULY 1' 9-max (Play Money) Seat #3 is the button
Seat 1: color_singleton (21791 in chips) 
Seat 2: HighCardJasper (6024 in chips) 
Seat 3: appositive (28565 in chips) 
Seat 4: PokerStarsMan12 (11010 in chips) 
Seat 8: MaFak2019 (11376 in chips) 
Seat 9: mnnm585 (16965 in chips) 
PokerStarsMan12: posts small blind 50
MaFak2019: posts big blind 100
*** HOLE CARDS ***
Dealt to PokerStarsMan12 [9s 3h]
mnnm585: calls 100
color_singleton: folds 
HighCardJasper: calls 100
appositive: calls 100
PokerStarsMan12: folds 
MaFak2019: checks 
*** FLOP *** [Kc Jc 9d]
MaFak2019: checks 
mnnm585: checks 
HighCardJasper: checks 
appositive: checks 
*** TURN *** [Kc Jc 9d] [2s]
MaFak2019: checks 
mnnm585: checks 
HighCardJasper: bets 212
appositive: calls 212
MaFak2019: calls 212
mnnm585: calls 212
*** RIVER *** [Kc Jc 9d 2s] [4h]
MaFak2019: checks 
mnnm585: checks 
HighCardJasper: checks 
appositive: checks 
*** SHOW DOWN ***
MaFak2019: shows [Qh 2d] (a pair of Deuces)
mnnm585: mucks hand 
HighCardJasper: shows [Qd 9c] (a pair of Nines)
appositive: mucks hand 
HighCardJasper collected 1227 from pot
*** SUMMARY ***
Total pot 1298 | Rake 71 
Board [Kc Jc 9d 2s 4h]
Seat 1: color_singleton folded before Flop (didn't bet)
Seat 2: HighCardJasper showed [Qd 9c] and won (1227) with a pair of Nines
Seat 3: appositive (button) mucked [9h 8d]
Seat 4: PokerStarsMan12 (small blind) folded before Flop
Seat 8: MaFak2019 (big blind) showed [Qh 2d] and lost with a pair of Deuces
Seat 9: mnnm585 mucked [7d Ad]



PokerStars Home Game Hand #227985121701: {DaPokaStars}  Hold'em No Limit (50/100) - 2021/07/01 16:57:14 ET
Table 'JULY 1' 9-max (Play Money) Seat #4 is the button
Seat 1: color_singleton (21791 in chips) 
Seat 2: HighCardJasper (6939 in chips) 
Seat 3: appositive (28253 in chips) 
Seat 4: PokerStarsMan12 (10960 in chips) 
Seat 8: MaFak2019 (11064 in chips) 
Seat 9: mnnm585 (16653 in chips) 
MaFak2019: posts small blind 50
mnnm585: posts big blind 100
*** HOLE CARDS ***
Dealt to PokerStarsMan12 [8c 5h]
color_singleton: folds 
HighCardJasper: calls 100
appositive: calls 100
PokerStarsMan12: folds 
MaFak2019: raises 400 to 500
mnnm585: calls 400
HighCardJasper: folds 
appositive: calls 400
*** FLOP *** [Td 8s 3c]
MaFak2019: checks 
mnnm585: checks 
appositive: checks 
*** TURN *** [Td 8s 3c] [9c]
MaFak2019: checks 
mnnm585: checks 
appositive: checks 
*** RIVER *** [Td 8s 3c 9c] [9d]
MaFak2019: checks 
mnnm585: checks 
appositive: checks 
*** SHOW DOWN ***
MaFak2019: shows [2c 2s] (two pair, Nines and Deuces)
mnnm585: mucks hand 
appositive: mucks hand 
MaFak2019 collected 1512 from pot
*** SUMMARY ***
Total pot 1600 | Rake 88 
Board [Td 8s 3c 9c 9d]
Seat 1: color_singleton folded before Flop (didn't bet)
Seat 2: HighCardJasper folded before Flop
Seat 3: appositive mucked [Js As]
Seat 4: PokerStarsMan12 (button) folded before Flop (didn't bet)
Seat 8: MaFak2019 (small blind) showed [2c 2s] and won (1512) with two pair, Nines and Deuces
Seat 9: mnnm585 (big blind) mucked [Kd Qd]



PokerStars Home Game Hand #227985143850: {DaPokaStars}  Hold'em No Limit (50/100) - 2021/07/01 16:58:19 ET
Table 'JULY 1' 9-max (Play Money) Seat #8 is the button
Seat 1: color_singleton (21791 in chips) 
Seat 2: HighCardJasper (6839 in chips) 
Seat 3: appositive (27753 in chips) 
Seat 4: PokerStarsMan12 (10960 in chips) 
Seat 8: MaFak2019 (12076 in chips) 
Seat 9: mnnm585 (16153 in chips) 
mnnm585: posts small blind 50
color_singleton: posts big blind 100
*** HOLE CARDS ***
Dealt to PokerStarsMan12 [Qc 3d]
HighCardJasper: raises 200 to 300
appositive: folds 
PokerStarsMan12: folds 
MaFak2019: folds 
mnnm585: calls 250
color_singleton: calls 200
*** FLOP *** [Jh 7d 6c]
mnnm585: checks 
color_singleton: checks 
HighCardJasper: checks 
*** TURN *** [Jh 7d 6c] [6h]
mnnm585: checks 
color_singleton: checks 
HighCardJasper: checks 
*** RIVER *** [Jh 7d 6c 6h] [7s]
mnnm585: checks 
color_singleton: checks 
HighCardJasper: bets 425
mnnm585: folds 
color_singleton: folds 
Uncalled bet (425) returned to HighCardJasper
HighCardJasper collected 850 from pot
HighCardJasper: doesn't show hand 
*** SUMMARY ***
Total pot 900 | Rake 50 
Board [Jh 7d 6c 6h 7s]
Seat 1: color_singleton (big blind) folded on the River
Seat 2: HighCardJasper collected (850)
Seat 3: appositive folded before Flop (didn't bet)
Seat 4: PokerStarsMan12 folded before Flop (didn't bet)
Seat 8: MaFak2019 (button) folded before Flop (didn't bet)
Seat 9: mnnm585 (small blind) folded on the River



PokerStars Home Game Hand #227985159698: {DaPokaStars}  Hold'em No Limit (50/100) - 2021/07/01 16:59:06 ET
Table 'JULY 1' 9-max (Play Money) Seat #9 is the button
Seat 1: color_singleton (21491 in chips) 
Seat 2: HighCardJasper (7389 in chips) 
Seat 3: appositive (27753 in chips) 
Seat 4: PokerStarsMan12 (10960 in chips) 
Seat 8: MaFak2019 (12076 in chips) 
Seat 9: mnnm585 (15853 in chips) 
color_singleton: posts small blind 50
HighCardJasper: posts big blind 100
*** HOLE CARDS ***
Dealt to PokerStarsMan12 [Jd 6d]
appositive: calls 100
PokerStarsMan12: folds 
MaFak2019: raises 350 to 450
mnnm585: folds 
color_singleton: calls 400
HighCardJasper: calls 350
appositive: calls 350
*** FLOP *** [8d Qd Td]
color_singleton: checks 
HighCardJasper: checks 
appositive: checks 
MaFak2019: checks 
*** TURN *** [8d Qd Td] [4c]
color_singleton: bets 850
HighCardJasper: folds 
appositive: folds 
MaFak2019: folds 
Uncalled bet (850) returned to color_singleton
color_singleton collected 1701 from pot
color_singleton: doesn't show hand 
*** SUMMARY ***
Total pot 1800 | Rake 99 
Board [8d Qd Td 4c]
Seat 1: color_singleton (small blind) collected (1701)
Seat 2: HighCardJasper (big blind) folded on the Turn
Seat 3: appositive folded on the Turn
Seat 4: PokerStarsMan12 folded before Flop (didn't bet)
Seat 8: MaFak2019 folded on the Turn
Seat 9: mnnm585 (button) folded before Flop (didn't bet)



PokerStars Home Game Hand #227985176974: {DaPokaStars}  Hold'em No Limit (50/100) - 2021/07/01 16:59:58 ET
Table 'JULY 1' 9-max (Play Money) Seat #1 is the button
Seat 1: color_singleton (22742 in chips) 
Seat 2: HighCardJasper (6939 in chips) 
Seat 3: appositive (27303 in chips) 
Seat 4: PokerStarsMan12 (10960 in chips) 
Seat 8: MaFak2019 (11626 in chips) 
Seat 9: mnnm585 (15853 in chips) 
HighCardJasper: posts small blind 50
appositive: posts big blind 100
*** HOLE CARDS ***
Dealt to PokerStarsMan12 [4h 3c]
PokerStarsMan12: folds 
MaFak2019: calls 100
mnnm585: calls 100
color_singleton: calls 100
HighCardJasper: calls 50
appositive: checks 
*** FLOP *** [Th 3s 4s]
HighCardJasper: checks 
appositive: checks 
MaFak2019: bets 472
mnnm585: calls 472
color_singleton: folds 
HighCardJasper: folds 
appositive: calls 472
*** TURN *** [Th 3s 4s] [Kc]
appositive: checks 
MaFak2019: checks 
mnnm585: bets 905
appositive: folds 
MaFak2019: calls 905
*** RIVER *** [Th 3s 4s Kc] [Qh]
MaFak2019: checks 
mnnm585: checks 
*** SHOW DOWN ***
MaFak2019: shows [5d Ts] (a pair of Tens)
mnnm585: shows [Ks 5s] (a pair of Kings)
mnnm585 collected 3521 from pot
*** SUMMARY ***
Total pot 3726 | Rake 205 
Board [Th 3s 4s Kc Qh]
Seat 1: color_singleton (button) folded on the Flop
Seat 2: HighCardJasper (small blind) folded on the Flop
Seat 3: appositive (big blind) folded on the Turn
Seat 4: PokerStarsMan12 folded before Flop (didn't bet)
Seat 8: MaFak2019 showed [5d Ts] and lost with a pair of Tens
Seat 9: mnnm585 showed [Ks 5s] and won (3521) with a pair of Kings



PokerStars Home Game Hand #227985200811: {DaPokaStars}  Hold'em No Limit (50/100) - 2021/07/01 17:01:03 ET
Table 'JULY 1' 9-max (Play Money) Seat #2 is the button
Seat 1: color_singleton (22642 in chips) 
Seat 2: HighCardJasper (6839 in chips) 
Seat 3: appositive (26731 in chips) 
Seat 4: PokerStarsMan12 (10960 in chips) 
Seat 8: MaFak2019 (10149 in chips) 
Seat 9: mnnm585 (17897 in chips) 
appositive: posts small blind 50
PokerStarsMan12: posts big blind 100
*** HOLE CARDS ***
Dealt to PokerStarsMan12 [7d 2d]
MaFak2019: calls 100
mnnm585: calls 100
color_singleton: calls 100
HighCardJasper: calls 100
appositive: calls 50
PokerStarsMan12: checks 
*** FLOP *** [Jh 6c Th]
appositive: checks 
PokerStarsMan12: checks 
MaFak2019: checks 
mnnm585: checks 
color_singleton: checks 
HighCardJasper: checks 
*** TURN *** [Jh 6c Th] [Qc]
appositive: checks 
PokerStarsMan12: checks 
MaFak2019: checks 
mnnm585: checks 
color_singleton: checks 
HighCardJasper: bets 283
appositive: folds 
PokerStarsMan12: folds 
MaFak2019: folds 
mnnm585: calls 283
color_singleton: calls 283
*** RIVER *** [Jh 6c Th Qc] [Kd]
mnnm585: checks 
color_singleton: checks 
HighCardJasper: checks 
*** SHOW DOWN ***
mnnm585: shows [Js 3s] (a pair of Jacks)
color_singleton: shows [Kh 4d] (a pair of Kings)
HighCardJasper: mucks hand 
color_singleton collected 1369 from pot
*** SUMMARY ***
Total pot 1449 | Rake 80 
Board [Jh 6c Th Qc Kd]
Seat 1: color_singleton showed [Kh 4d] and won (1369) with a pair of Kings
Seat 2: HighCardJasper (button) mucked [Ts 2h]
Seat 3: appositive (small blind) folded on the Turn
Seat 4: PokerStarsMan12 (big blind) folded on the Turn
Seat 8: MaFak2019 folded on the Turn
Seat 9: mnnm585 showed [Js 3s] and lost with a pair of Jacks



PokerStars Home Game Hand #227985235712: {DaPokaStars}  Hold'em No Limit (50/100) - 2021/07/01 17:02:22 ET
Table 'JULY 1' 9-max (Play Money) Seat #3 is the button
Seat 1: color_singleton (23628 in chips) 
Seat 2: HighCardJasper (6456 in chips) 
Seat 3: appositive (26631 in chips) 
Seat 4: PokerStarsMan12 (10860 in chips) 
Seat 8: MaFak2019 (10049 in chips) 
Seat 9: mnnm585 (17514 in chips) 
PokerStarsMan12: posts small blind 50
MaFak2019: posts big blind 100
*** HOLE CARDS ***
Dealt to PokerStarsMan12 [9c 5d]
mnnm585: calls 100
color_singleton: calls 100
HighCardJasper: calls 100
appositive: calls 100
PokerStarsMan12: calls 50
MaFak2019: checks 
*** FLOP *** [Th Td 7d]
PokerStarsMan12: checks 
MaFak2019: checks 
mnnm585: checks 
color_singleton: checks 
HighCardJasper: checks 
appositive: checks 
*** TURN *** [Th Td 7d] [Ks]
PokerStarsMan12: checks 
MaFak2019: checks 
mnnm585: bets 283
color_singleton: folds 
HighCardJasper: folds 
appositive: calls 283
PokerStarsMan12: folds 
MaFak2019: folds 
*** RIVER *** [Th Td 7d Ks] [8c]
mnnm585: bets 551
appositive: calls 551
*** SHOW DOWN ***
mnnm585: shows [Kh 9h] (two pair, Kings and Tens)
appositive: mucks hand 
mnnm585 collected 2143 from pot
*** SUMMARY ***
Total pot 2268 | Rake 125 
Board [Th Td 7d Ks 8c]
Seat 1: color_singleton folded on the Turn
Seat 2: HighCardJasper folded on the Turn
Seat 3: appositive (button) mucked [5h 5s]
Seat 4: PokerStarsMan12 (small blind) folded on the Turn
Seat 8: MaFak2019 (big blind) folded on the Turn
Seat 9: mnnm585 showed [Kh 9h] and won (2143) with two pair, Kings and Tens



PokerStars Home Game Hand #227985261178: {DaPokaStars}  Hold'em No Limit (50/100) - 2021/07/01 17:03:19 ET
Table 'JULY 1' 9-max (Play Money) Seat #4 is the button
Seat 1: color_singleton (23528 in chips) 
Seat 2: HighCardJasper (6356 in chips) 
Seat 3: appositive (25697 in chips) 
Seat 4: PokerStarsMan12 (10760 in chips) 
Seat 8: MaFak2019 (9949 in chips) 
Seat 9: mnnm585 (18723 in chips) 
MaFak2019: posts small blind 50
mnnm585: posts big blind 100
*** HOLE CARDS ***
Dealt to PokerStarsMan12 [8d 2c]
color_singleton: raises 200 to 300
HighCardJasper: folds 
appositive: calls 300
PokerStarsMan12: folds 
MaFak2019: calls 250
mnnm585: calls 200
*** FLOP *** [Th 7d 8c]
MaFak2019 has timed out
MaFak2019: checks 
mnnm585: checks 
color_singleton: bets 600
appositive: calls 600
MaFak2019: calls 600
mnnm585: folds 
*** TURN *** [Th 7d 8c] [Jc]
MaFak2019: checks 
color_singleton: checks 
appositive: bets 1417
MaFak2019: folds 
color_singleton: folds 
Uncalled bet (1417) returned to appositive
appositive collected 2835 from pot
appositive: doesn't show hand 
*** SUMMARY ***
Total pot 3000 | Rake 165 
Board [Th 7d 8c Jc]
Seat 1: color_singleton folded on the Turn
Seat 2: HighCardJasper folded before Flop (didn't bet)
Seat 3: appositive collected (2835)
Seat 4: PokerStarsMan12 (button) folded before Flop (didn't bet)
Seat 8: MaFak2019 (small blind) folded on the Turn
Seat 9: mnnm585 (big blind) folded on the Flop



PokerStars Home Game Hand #227985296381: {DaPokaStars}  Hold'em No Limit (50/100) - 2021/07/01 17:04:36 ET
Table 'JULY 1' 9-max (Play Money) Seat #8 is the button
Seat 1: color_singleton (22628 in chips) 
Seat 2: HighCardJasper (6356 in chips) 
Seat 3: appositive (27632 in chips) 
Seat 4: PokerStarsMan12 (10760 in chips) 
Seat 8: MaFak2019 (9049 in chips) 
Seat 9: mnnm585 (18423 in chips) 
mnnm585: posts small blind 50
color_singleton: posts big blind 100
*** HOLE CARDS ***
Dealt to PokerStarsMan12 [Ad Jd]
HighCardJasper: calls 100
appositive: folds 
PokerStarsMan12: raises 400 to 500
MaFak2019: folds 
mnnm585: folds 
color_singleton: folds 
HighCardJasper: folds 
Uncalled bet (400) returned to PokerStarsMan12
PokerStarsMan12 collected 350 from pot
*** SUMMARY ***
Total pot 350 | Rake 0 
Seat 1: color_singleton (big blind) folded before Flop
Seat 2: HighCardJasper folded before Flop
Seat 3: appositive folded before Flop (didn't bet)
Seat 4: PokerStarsMan12 collected (350)
Seat 8: MaFak2019 (button) folded before Flop (didn't bet)
Seat 9: mnnm585 (small blind) folded before Flop



PokerStars Home Game Hand #227985311578: {DaPokaStars}  Hold'em No Limit (50/100) - 2021/07/01 17:05:09 ET
Table 'JULY 1' 9-max (Play Money) Seat #9 is the button
Seat 1: color_singleton (22528 in chips) 
Seat 2: HighCardJasper (6256 in chips) 
Seat 3: appositive (27632 in chips) 
Seat 4: PokerStarsMan12 (11010 in chips) 
Seat 8: MaFak2019 (9049 in chips) 
Seat 9: mnnm585 (18373 in chips) 
color_singleton: posts small blind 50
HighCardJasper: posts big blind 100
*** HOLE CARDS ***
Dealt to PokerStarsMan12 [9h 5c]
appositive: folds 
PokerStarsMan12: folds 
MaFak2019: folds 
mnnm585: folds 
color_singleton: calls 50
HighCardJasper: checks 
*** FLOP *** [Ad Td 8h]
color_singleton: checks 
HighCardJasper: bets 189
color_singleton: folds 
Uncalled bet (189) returned to HighCardJasper
HighCardJasper collected 189 from pot
HighCardJasper: doesn't show hand 
*** SUMMARY ***
Total pot 200 | Rake 11 
Board [Ad Td 8h]
Seat 1: color_singleton (small blind) folded on the Flop
Seat 2: HighCardJasper (big blind) collected (189)
Seat 3: appositive folded before Flop (didn't bet)
Seat 4: PokerStarsMan12 folded before Flop (didn't bet)
Seat 8: MaFak2019 folded before Flop (didn't bet)
Seat 9: mnnm585 (button) folded before Flop (didn't bet)



PokerStars Home Game Hand #227985325165: {DaPokaStars}  Hold'em No Limit (50/100) - 2021/07/01 17:05:38 ET
Table 'JULY 1' 9-max (Play Money) Seat #1 is the button
Seat 1: color_singleton (22428 in chips) 
Seat 2: HighCardJasper (6345 in chips) 
Seat 3: appositive (27632 in chips) 
Seat 4: PokerStarsMan12 (11010 in chips) 
Seat 8: MaFak2019 (9049 in chips) 
Seat 9: mnnm585 (18373 in chips) 
HighCardJasper: posts small blind 50
appositive: posts big blind 100
*** HOLE CARDS ***
Dealt to PokerStarsMan12 [5c 3c]
PokerStarsMan12: calls 100
MaFak2019: calls 100
mnnm585: calls 100
color_singleton: calls 100
HighCardJasper: raises 200 to 300
appositive: calls 200
PokerStarsMan12: calls 200
MaFak2019: folds 
mnnm585: calls 200
color_singleton: calls 200
*** FLOP *** [8s 4s Jd]
HighCardJasper: checks 
appositive: checks 
PokerStarsMan12: checks 
mnnm585: checks 
color_singleton: bets 800
HighCardJasper: folds 
appositive: folds 
PokerStarsMan12: folds 
mnnm585: folds 
Uncalled bet (800) returned to color_singleton
color_singleton collected 1512 from pot
color_singleton: doesn't show hand 
*** SUMMARY ***
Total pot 1600 | Rake 88 
Board [8s 4s Jd]
Seat 1: color_singleton (button) collected (1512)
Seat 2: HighCardJasper (small blind) folded on the Flop
Seat 3: appositive (big blind) folded on the Flop
Seat 4: PokerStarsMan12 folded on the Flop
Seat 8: MaFak2019 folded before Flop
Seat 9: mnnm585 folded on the Flop



PokerStars Home Game Hand #227985364116: {DaPokaStars}  Hold'em No Limit (50/100) - 2021/07/01 17:06:49 ET
Table 'JULY 1' 9-max (Play Money) Seat #2 is the button
Seat 1: color_singleton (23640 in chips) 
Seat 2: HighCardJasper (6045 in chips) 
Seat 3: appositive (27332 in chips) 
Seat 4: PokerStarsMan12 (10710 in chips) 
Seat 8: MaFak2019 (8949 in chips) 
Seat 9: mnnm585 (18073 in chips) 
appositive: posts small blind 50
PokerStarsMan12: posts big blind 100
*** HOLE CARDS ***
Dealt to PokerStarsMan12 [Ah 6h]
MaFak2019: raises 250 to 350
mnnm585: calls 350
color_singleton: folds 
HighCardJasper: folds 
appositive: calls 300
PokerStarsMan12: calls 250
*** FLOP *** [5h Ad 6c]
appositive: checks 
PokerStarsMan12: bets 700
MaFak2019: calls 700
mnnm585: folds 
appositive: calls 700
*** TURN *** [5h Ad 6c] [2s]
appositive: checks 
PokerStarsMan12: bets 2000
MaFak2019: folds 
appositive: folds 
Uncalled bet (2000) returned to PokerStarsMan12
PokerStarsMan12 collected 3307 from pot
*** SUMMARY ***
Total pot 3500 | Rake 193 
Board [5h Ad 6c 2s]
Seat 1: color_singleton folded before Flop (didn't bet)
Seat 2: HighCardJasper (button) folded before Flop (didn't bet)
Seat 3: appositive (small blind) folded on the Turn
Seat 4: PokerStarsMan12 (big blind) collected (3307)
Seat 8: MaFak2019 folded on the Turn
Seat 9: mnnm585 folded on the Flop



PokerStars Home Game Hand #227985385393: {DaPokaStars}  Hold'em No Limit (50/100) - 2021/07/01 17:07:35 ET
Table 'JULY 1' 9-max (Play Money) Seat #3 is the button
Seat 1: color_singleton (23640 in chips) 
Seat 2: HighCardJasper (6045 in chips) 
Seat 3: appositive (26282 in chips) 
Seat 4: PokerStarsMan12 (12967 in chips) 
Seat 8: MaFak2019 (7899 in chips) 
Seat 9: mnnm585 (17723 in chips) 
PokerStarsMan12: posts small blind 50
MaFak2019: posts big blind 100
*** HOLE CARDS ***
Dealt to PokerStarsMan12 [5d 4s]
mnnm585: calls 100
color_singleton: folds 
HighCardJasper: calls 100
appositive: calls 100
PokerStarsMan12: calls 50
MaFak2019: checks 
*** FLOP *** [Qh 3h 8c]
PokerStarsMan12: checks 
MaFak2019: checks 
mnnm585: bets 100
HighCardJasper: folds 
appositive: folds 
PokerStarsMan12: folds 
MaFak2019: calls 100
*** TURN *** [Qh 3h 8c] [Ac]
MaFak2019: checks 
mnnm585: bets 330
MaFak2019: folds 
Uncalled bet (330) returned to mnnm585
mnnm585 collected 661 from pot
*** SUMMARY ***
Total pot 700 | Rake 39 
Board [Qh 3h 8c Ac]
Seat 1: color_singleton folded before Flop (didn't bet)
Seat 2: HighCardJasper folded on the Flop
Seat 3: appositive (button) folded on the Flop
Seat 4: PokerStarsMan12 (small blind) folded on the Flop
Seat 8: MaFak2019 (big blind) folded on the Turn
Seat 9: mnnm585 collected (661)



PokerStars Home Game Hand #227985410802: {DaPokaStars}  Hold'em No Limit (50/100) - 2021/07/01 17:08:30 ET
Table 'JULY 1' 9-max (Play Money) Seat #4 is the button
Seat 1: color_singleton (23640 in chips) 
Seat 2: HighCardJasper (5945 in chips) 
Seat 3: appositive (26182 in chips) 
Seat 4: PokerStarsMan12 (12867 in chips) 
Seat 8: MaFak2019 (7699 in chips) 
Seat 9: mnnm585 (18184 in chips) 
MaFak2019: posts small blind 50
mnnm585: posts big blind 100
*** HOLE CARDS ***
Dealt to PokerStarsMan12 [Ah 6h]
color_singleton: calls 100
HighCardJasper: folds 
appositive: calls 100
PokerStarsMan12: calls 100
MaFak2019: folds 
mnnm585: checks 
*** FLOP *** [As Qd 7d]
mnnm585: checks 
color_singleton: checks 
appositive: checks 
PokerStarsMan12: bets 300
mnnm585: folds 
color_singleton: folds 
appositive: calls 300
*** TURN *** [As Qd 7d] [Kd]
appositive: checks 
PokerStarsMan12: checks 
*** RIVER *** [As Qd 7d Kd] [2c]
appositive: checks 
PokerStarsMan12: checks 
*** SHOW DOWN ***
appositive: shows [7h Jd] (a pair of Sevens)
PokerStarsMan12: shows [Ah 6h] (a pair of Aces)
PokerStarsMan12 collected 992 from pot
*** SUMMARY ***
Total pot 1050 | Rake 58 
Board [As Qd 7d Kd 2c]
Seat 1: color_singleton folded on the Flop
Seat 2: HighCardJasper folded before Flop (didn't bet)
Seat 3: appositive showed [7h Jd] and lost with a pair of Sevens
Seat 4: PokerStarsMan12 (button) showed [Ah 6h] and won (992) with a pair of Aces
Seat 8: MaFak2019 (small blind) folded before Flop
Seat 9: mnnm585 (big blind) folded on the Flop



PokerStars Home Game Hand #227985450466: {DaPokaStars}  Hold'em No Limit (50/100) - 2021/07/01 17:09:45 ET
Table 'JULY 1' 9-max (Play Money) Seat #8 is the button
Seat 1: color_singleton (23540 in chips) 
Seat 2: HighCardJasper (5945 in chips) 
Seat 3: appositive (25782 in chips) 
Seat 4: PokerStarsMan12 (13459 in chips) 
Seat 8: MaFak2019 (7649 in chips) 
Seat 9: mnnm585 (18084 in chips) 
mnnm585: posts small blind 50
color_singleton: posts big blind 100
*** HOLE CARDS ***
Dealt to PokerStarsMan12 [Tc Th]
HighCardJasper: folds 
appositive: folds 
PokerStarsMan12: raises 300 to 400
MaFak2019: folds 
mnnm585: folds 
color_singleton: calls 300
*** FLOP *** [9s Ts Jc]
color_singleton: bets 401
PokerStarsMan12: calls 401
*** TURN *** [9s Ts Jc] [As]
color_singleton: checks 
PokerStarsMan12: bets 800
color_singleton: folds 
Uncalled bet (800) returned to PokerStarsMan12
PokerStarsMan12 collected 1561 from pot
*** SUMMARY ***
Total pot 1652 | Rake 91 
Board [9s Ts Jc As]
Seat 1: color_singleton (big blind) folded on the Turn
Seat 2: HighCardJasper folded before Flop (didn't bet)
Seat 3: appositive folded before Flop (didn't bet)
Seat 4: PokerStarsMan12 collected (1561)
Seat 8: MaFak2019 (button) folded before Flop (didn't bet)
Seat 9: mnnm585 (small blind) folded before Flop



PokerStars Home Game Hand #227985467271: {DaPokaStars}  Hold'em No Limit (50/100) - 2021/07/01 17:10:22 ET
Table 'JULY 1' 9-max (Play Money) Seat #9 is the button
Seat 1: color_singleton (22739 in chips) 
Seat 2: HighCardJasper (5945 in chips) 
Seat 3: appositive (25782 in chips) 
Seat 4: PokerStarsMan12 (14219 in chips) 
Seat 8: MaFak2019 (7649 in chips) 
Seat 9: mnnm585 (18034 in chips) 
color_singleton: posts small blind 50
HighCardJasper: posts big blind 100
*** HOLE CARDS ***
Dealt to PokerStarsMan12 [Kc Jd]
appositive: folds 
PokerStarsMan12: raises 200 to 300
MaFak2019: calls 300
mnnm585: calls 300
color_singleton: folds 
HighCardJasper: folds 
*** FLOP *** [8h 3s Qd]
PokerStarsMan12: checks 
MaFak2019: bets 992
mnnm585: folds 
PokerStarsMan12: folds 
Uncalled bet (992) returned to MaFak2019
MaFak2019 collected 992 from pot
MaFak2019: doesn't show hand 
*** SUMMARY ***
Total pot 1050 | Rake 58 
Board [8h 3s Qd]
Seat 1: color_singleton (small blind) folded before Flop
Seat 2: HighCardJasper (big blind) folded before Flop
Seat 3: appositive folded before Flop (didn't bet)
Seat 4: PokerStarsMan12 folded on the Flop
Seat 8: MaFak2019 collected (992)
Seat 9: mnnm585 (button) folded on the Flop



PokerStars Home Game Hand #227985477880: {DaPokaStars}  Hold'em No Limit (50/100) - 2021/07/01 17:10:45 ET
Table 'JULY 1' 9-max (Play Money) Seat #1 is the button
Seat 1: color_singleton (22689 in chips) 
Seat 2: HighCardJasper (5845 in chips) 
Seat 3: appositive (25782 in chips) 
Seat 4: PokerStarsMan12 (13919 in chips) 
Seat 8: MaFak2019 (8341 in chips) 
Seat 9: mnnm585 (17734 in chips) 
HighCardJasper: posts small blind 50
appositive: posts big blind 100
*** HOLE CARDS ***
Dealt to PokerStarsMan12 [3s Kc]
PokerStarsMan12: folds 
MaFak2019: raises 250 to 350
mnnm585: folds 
color_singleton: folds 
HighCardJasper: calls 300
appositive: folds 
*** FLOP *** [Ks 8h 2h]
HighCardJasper: checks 
MaFak2019: bets 756
HighCardJasper: folds 
Uncalled bet (756) returned to MaFak2019
MaFak2019 collected 756 from pot
MaFak2019: doesn't show hand 
*** SUMMARY ***
Total pot 800 | Rake 44 
Board [Ks 8h 2h]
Seat 1: color_singleton (button) folded before Flop (didn't bet)
Seat 2: HighCardJasper (small blind) folded on the Flop
Seat 3: appositive (big blind) folded before Flop
Seat 4: PokerStarsMan12 folded before Flop (didn't bet)
Seat 8: MaFak2019 collected (756)
Seat 9: mnnm585 folded before Flop (didn't bet)



PokerStars Home Game Hand #227985495038: {DaPokaStars}  Hold'em No Limit (50/100) - 2021/07/01 17:11:23 ET
Table 'JULY 1' 9-max (Play Money) Seat #2 is the button
Seat 1: color_singleton (22689 in chips) 
Seat 2: HighCardJasper (5495 in chips) 
Seat 3: appositive (25682 in chips) 
Seat 4: PokerStarsMan12 (13919 in chips) 
Seat 8: MaFak2019 (8747 in chips) 
Seat 9: mnnm585 (17734 in chips) 
appositive: posts small blind 50
PokerStarsMan12: posts big blind 100
*** HOLE CARDS ***
Dealt to PokerStarsMan12 [2h 5c]
MaFak2019: raises 250 to 350
mnnm585: calls 350
color_singleton: calls 350
HighCardJasper: folds 
appositive: folds 
PokerStarsMan12: folds 
*** FLOP *** [8h Ad 7h]
MaFak2019: checks 
mnnm585: checks 
color_singleton: checks 
*** TURN *** [8h Ad 7h] [9d]
MaFak2019: checks 
mnnm585: checks 
color_singleton: bets 567
MaFak2019: calls 567
mnnm585: folds 
*** RIVER *** [8h Ad 7h 9d] [7s]
MaFak2019: checks 
color_singleton: bets 1200
MaFak2019: folds 
Uncalled bet (1200) returned to color_singleton
color_singleton collected 2206 from pot
color_singleton: doesn't show hand 
*** SUMMARY ***
Total pot 2334 | Rake 128 
Board [8h Ad 7h 9d 7s]
Seat 1: color_singleton collected (2206)
Seat 2: HighCardJasper (button) folded before Flop (didn't bet)
Seat 3: appositive (small blind) folded before Flop
Seat 4: PokerStarsMan12 (big blind) folded before Flop
Seat 8: MaFak2019 folded on the River
Seat 9: mnnm585 folded on the Turn



PokerStars Home Game Hand #227985526371: {DaPokaStars}  Hold'em No Limit (50/100) - 2021/07/01 17:12:32 ET
Table 'JULY 1' 9-max (Play Money) Seat #3 is the button
Seat 1: color_singleton (23978 in chips) 
Seat 2: HighCardJasper (5495 in chips) 
Seat 3: appositive (25632 in chips) 
Seat 4: PokerStarsMan12 (13819 in chips) 
Seat 8: MaFak2019 (7830 in chips) 
Seat 9: mnnm585 (17384 in chips) 
PokerStarsMan12: posts small blind 50
MaFak2019: posts big blind 100
*** HOLE CARDS ***
Dealt to PokerStarsMan12 [Ah Qc]
mnnm585: folds 
color_singleton: raises 200 to 300
HighCardJasper: calls 300
appositive: calls 300
PokerStarsMan12: calls 250
MaFak2019: folds 
*** FLOP *** [8h 8s 2c]
PokerStarsMan12: checks 
color_singleton: bets 614
HighCardJasper: folds 
appositive: raises 614 to 1228
PokerStarsMan12: folds 
color_singleton: folds 
Uncalled bet (614) returned to appositive
appositive collected 2389 from pot
appositive: doesn't show hand 
*** SUMMARY ***
Total pot 2528 | Rake 139 
Board [8h 8s 2c]
Seat 1: color_singleton folded on the Flop
Seat 2: HighCardJasper folded on the Flop
Seat 3: appositive (button) collected (2389)
Seat 4: PokerStarsMan12 (small blind) folded on the Flop
Seat 8: MaFak2019 (big blind) folded before Flop
Seat 9: mnnm585 folded before Flop (didn't bet)



PokerStars Home Game Hand #227985546251: {DaPokaStars}  Hold'em No Limit (50/100) - 2021/07/01 17:13:15 ET
Table 'JULY 1' 9-max (Play Money) Seat #4 is the button
Seat 1: color_singleton (23064 in chips) 
Seat 2: HighCardJasper (5195 in chips) 
Seat 3: appositive (27107 in chips) 
Seat 4: PokerStarsMan12 (13519 in chips) 
Seat 8: MaFak2019 (7730 in chips) 
Seat 9: mnnm585 (17384 in chips) 
MaFak2019: posts small blind 50
mnnm585: posts big blind 100
*** HOLE CARDS ***
Dealt to PokerStarsMan12 [4d 9h]
color_singleton: folds 
HighCardJasper: calls 100
appositive: folds 
PokerStarsMan12: folds 
MaFak2019: raises 300 to 400
mnnm585: calls 300
HighCardJasper: calls 300
*** FLOP *** [4s 6s 3d]
MaFak2019: checks 
mnnm585: checks 
HighCardJasper: checks 
*** TURN *** [4s 6s 3d] [2c]
MaFak2019: checks 
mnnm585: checks 
HighCardJasper: checks 
*** RIVER *** [4s 6s 3d 2c] [Kh]
MaFak2019: checks 
mnnm585: checks 
HighCardJasper: checks 
*** SHOW DOWN ***
MaFak2019: shows [7c 7s] (a pair of Sevens)
mnnm585: mucks hand 
HighCardJasper: mucks hand 
MaFak2019 collected 1134 from pot
*** SUMMARY ***
Total pot 1200 | Rake 66 
Board [4s 6s 3d 2c Kh]
Seat 1: color_singleton folded before Flop (didn't bet)
Seat 2: HighCardJasper mucked [Qh 9s]
Seat 3: appositive folded before Flop (didn't bet)
Seat 4: PokerStarsMan12 (button) folded before Flop (didn't bet)
Seat 8: MaFak2019 (small blind) showed [7c 7s] and won (1134) with a pair of Sevens
Seat 9: mnnm585 (big blind) mucked [8d Ad]



PokerStars Home Game Hand #227985564008: {DaPokaStars}  Hold'em No Limit (50/100) - 2021/07/01 17:13:54 ET
Table 'JULY 1' 9-max (Play Money) Seat #8 is the button
Seat 1: color_singleton (23064 in chips) 
Seat 2: HighCardJasper (4795 in chips) 
Seat 3: appositive (27107 in chips) 
Seat 4: PokerStarsMan12 (13519 in chips) 
Seat 8: MaFak2019 (8464 in chips) 
Seat 9: mnnm585 (16984 in chips) 
mnnm585: posts small blind 50
color_singleton: posts big blind 100
*** HOLE CARDS ***
Dealt to PokerStarsMan12 [Jh Ah]
HighCardJasper: calls 100
appositive: calls 100
PokerStarsMan12: raises 400 to 500
MaFak2019: calls 500
mnnm585: calls 450
color_singleton: folds 
HighCardJasper: folds 
appositive: calls 400
*** FLOP *** [2h 2d Th]
mnnm585: checks 
appositive: checks 
PokerStarsMan12: bets 1000
MaFak2019: raises 4079 to 5079
mnnm585: folds 
appositive: folds 
PokerStarsMan12: calls 4079
*** TURN *** [2h 2d Th] [As]
PokerStarsMan12: bets 7940 and is all-in
MaFak2019: calls 2885 and is all-in
Uncalled bet (5055) returned to PokerStarsMan12
*** RIVER *** [2h 2d Th As] [9h]
*** SHOW DOWN ***
PokerStarsMan12: shows [Jh Ah] (a flush, Ace high)
MaFak2019: shows [5h 6h] (a flush, Ten high)
PokerStarsMan12 collected 17131 from pot
*** SUMMARY ***
Total pot 18128 | Rake 997 
Board [2h 2d Th As 9h]
Seat 1: color_singleton (big blind) folded before Flop
Seat 2: HighCardJasper folded before Flop
Seat 3: appositive folded on the Flop
Seat 4: PokerStarsMan12 showed [Jh Ah] and won (17131) with a flush, Ace high
Seat 8: MaFak2019 (button) showed [5h 6h] and lost with a flush, Ten high
Seat 9: mnnm585 (small blind) folded on the Flop



PokerStars Home Game Hand #227985602291: {DaPokaStars}  Hold'em No Limit (50/100) - 2021/07/01 17:15:18 ET
Table 'JULY 1' 9-max (Play Money) Seat #9 is the button
Seat 1: color_singleton (22964 in chips) 
Seat 2: HighCardJasper (4695 in chips) 
Seat 3: appositive (26607 in chips) 
Seat 4: PokerStarsMan12 (22186 in chips) 
Seat 9: mnnm585 (16484 in chips) 
color_singleton: posts small blind 50
HighCardJasper: posts big blind 100
*** HOLE CARDS ***
Dealt to PokerStarsMan12 [9c 5d]
appositive: folds 
PokerStarsMan12: folds 
mnnm585: folds 
color_singleton: calls 50
HighCardJasper: checks 
*** FLOP *** [Js 2h 6c]
color_singleton: checks 
HighCardJasper: bets 189
color_singleton: calls 189
*** TURN *** [Js 2h 6c] [Kc]
color_singleton: checks 
HighCardJasper: bets 273
color_singleton: folds 
Uncalled bet (273) returned to HighCardJasper
HighCardJasper collected 546 from pot
HighCardJasper: doesn't show hand 
*** SUMMARY ***
Total pot 578 | Rake 32 
Board [Js 2h 6c Kc]
Seat 1: color_singleton (small blind) folded on the Turn
Seat 2: HighCardJasper (big blind) collected (546)
Seat 3: appositive folded before Flop (didn't bet)
Seat 4: PokerStarsMan12 folded before Flop (didn't bet)
Seat 9: mnnm585 (button) folded before Flop (didn't bet)



PokerStars Home Game Hand #227985627603: {DaPokaStars}  Hold'em No Limit (50/100) - 2021/07/01 17:16:13 ET
Table 'JULY 1' 9-max (Play Money) Seat #1 is the button
Seat 1: color_singleton (22675 in chips) 
Seat 2: HighCardJasper (4952 in chips) 
Seat 3: appositive (26607 in chips) 
Seat 4: PokerStarsMan12 (22186 in chips) 
Seat 8: MaFak2019 (10000 in chips) 
Seat 9: mnnm585 (16484 in chips) 
HighCardJasper: posts small blind 50
appositive: posts big blind 100
*** HOLE CARDS ***
Dealt to PokerStarsMan12 [2d 8d]
PokerStarsMan12: folds 
MaFak2019: calls 100
mnnm585: calls 100
color_singleton: raises 300 to 400
HighCardJasper: calls 350
appositive: calls 300
MaFak2019: calls 300
mnnm585: calls 300
*** FLOP *** [Jd 8s Jc]
HighCardJasper: checks 
appositive: checks 
MaFak2019: checks 
mnnm585: checks 
color_singleton: bets 1100
HighCardJasper: folds 
appositive: folds 
MaFak2019: folds 
mnnm585: folds 
Uncalled bet (1100) returned to color_singleton
color_singleton collected 1890 from pot
color_singleton: doesn't show hand 
*** SUMMARY ***
Total pot 2000 | Rake 110 
Board [Jd 8s Jc]
Seat 1: color_singleton (button) collected (1890)
Seat 2: HighCardJasper (small blind) folded on the Flop
Seat 3: appositive (big blind) folded on the Flop
Seat 4: PokerStarsMan12 folded before Flop (didn't bet)
Seat 8: MaFak2019 folded on the Flop
Seat 9: mnnm585 folded on the Flop



PokerStars Home Game Hand #227985650416: {DaPokaStars}  Hold'em No Limit (50/100) - 2021/07/01 17:17:04 ET
Table 'JULY 1' 9-max (Play Money) Seat #2 is the button
Seat 1: color_singleton (24165 in chips) 
Seat 2: HighCardJasper (4552 in chips) 
Seat 3: appositive (26207 in chips) 
Seat 4: PokerStarsMan12 (22186 in chips) 
Seat 8: MaFak2019 (9600 in chips) 
Seat 9: mnnm585 (16084 in chips) 
appositive: posts small blind 50
PokerStarsMan12: posts big blind 100
*** HOLE CARDS ***
Dealt to PokerStarsMan12 [As 2s]
MaFak2019: folds 
mnnm585: folds 
color_singleton: raises 200 to 300
HighCardJasper: calls 300
appositive: calls 250
PokerStarsMan12: calls 200
*** FLOP *** [5d 8d 3c]
appositive: checks 
PokerStarsMan12: checks 
color_singleton: checks 
HighCardJasper: bets 567
appositive: folds 
PokerStarsMan12: folds 
color_singleton: folds 
Uncalled bet (567) returned to HighCardJasper
HighCardJasper collected 1134 from pot
HighCardJasper: doesn't show hand 
*** SUMMARY ***
Total pot 1200 | Rake 66 
Board [5d 8d 3c]
Seat 1: color_singleton folded on the Flop
Seat 2: HighCardJasper (button) collected (1134)
Seat 3: appositive (small blind) folded on the Flop
Seat 4: PokerStarsMan12 (big blind) folded on the Flop
Seat 8: MaFak2019 folded before Flop (didn't bet)
Seat 9: mnnm585 folded before Flop (didn't bet)



PokerStars Home Game Hand #227985672379: {DaPokaStars}  Hold'em No Limit (50/100) - 2021/07/01 17:17:52 ET
Table 'JULY 1' 9-max (Play Money) Seat #3 is the button
Seat 1: color_singleton (23865 in chips) 
Seat 2: HighCardJasper (5386 in chips) 
Seat 3: appositive (25907 in chips) 
Seat 4: PokerStarsMan12 (21886 in chips) 
Seat 8: MaFak2019 (9600 in chips) 
PokerStarsMan12: posts small blind 50
MaFak2019: posts big blind 100
*** HOLE CARDS ***
Dealt to PokerStarsMan12 [7h 2d]
color_singleton: folds 
HighCardJasper: calls 100
appositive: calls 100
PokerStarsMan12: calls 50
MaFak2019: raises 400 to 500
HighCardJasper: folds 
appositive: calls 400
PokerStarsMan12: folds 
*** FLOP *** [3c Js Ad]
MaFak2019: checks 
appositive: checks 
*** TURN *** [3c Js Ad] [Jd]
MaFak2019: checks 
appositive: checks 
*** RIVER *** [3c Js Ad Jd] [6c]
MaFak2019: checks 
appositive: checks 
*** SHOW DOWN ***
MaFak2019: shows [4d 3d] (two pair, Jacks and Threes)
appositive: mucks hand 
MaFak2019 collected 1134 from pot
*** SUMMARY ***
Total pot 1200 | Rake 66 
Board [3c Js Ad Jd 6c]
Seat 1: color_singleton folded before Flop (didn't bet)
Seat 2: HighCardJasper folded before Flop
Seat 3: appositive (button) mucked [5s Qs]
Seat 4: PokerStarsMan12 (small blind) folded before Flop
Seat 8: MaFak2019 (big blind) showed [4d 3d] and won (1134) with two pair, Jacks and Threes



PokerStars Home Game Hand #227985697001: {DaPokaStars}  Hold'em No Limit (50/100) - 2021/07/01 17:18:47 ET
Table 'JULY 1' 9-max (Play Money) Seat #4 is the button
Seat 1: color_singleton (23865 in chips) 
Seat 2: HighCardJasper (5286 in chips) 
Seat 3: appositive (25407 in chips) 
Seat 4: PokerStarsMan12 (21786 in chips) 
Seat 8: MaFak2019 (10234 in chips) 
MaFak2019: posts small blind 50
color_singleton: posts big blind 100
*** HOLE CARDS ***
Dealt to PokerStarsMan12 [7d Ad]
HighCardJasper: calls 100
appositive: calls 100
PokerStarsMan12: calls 100
MaFak2019: folds 
color_singleton: checks 
*** FLOP *** [7c Ac 2d]
color_singleton: bets 212
HighCardJasper: calls 212
appositive: calls 212
PokerStarsMan12: raises 488 to 700
color_singleton: folds 
HighCardJasper: folds 
appositive: calls 488
*** TURN *** [7c Ac 2d] [5d]
appositive: checks 
PokerStarsMan12: bets 1100
appositive: raises 1100 to 2200
PokerStarsMan12: calls 1100
*** RIVER *** [7c Ac 2d 5d] [9d]
appositive: checks 
PokerStarsMan12: bets 8000
appositive: folds 
Uncalled bet (8000) returned to PokerStarsMan12
PokerStarsMan12 collected 6307 from pot
*** SUMMARY ***
Total pot 6674 | Rake 367 
Board [7c Ac 2d 5d 9d]
Seat 1: color_singleton (big blind) folded on the Flop
Seat 2: HighCardJasper folded on the Flop
Seat 3: appositive folded on the River
Seat 4: PokerStarsMan12 (button) collected (6307)
Seat 8: MaFak2019 (small blind) folded before Flop



PokerStars Home Game Hand #227985729334: {DaPokaStars}  Hold'em No Limit (50/100) - 2021/07/01 17:19:58 ET
Table 'JULY 1' 9-max (Play Money) Seat #8 is the button
Seat 1: color_singleton (23553 in chips) 
Seat 2: HighCardJasper (4974 in chips) 
Seat 3: appositive (22407 in chips) 
Seat 4: PokerStarsMan12 (25093 in chips) 
Seat 8: MaFak2019 (10184 in chips) 
color_singleton: posts small blind 50
HighCardJasper: posts big blind 100
*** HOLE CARDS ***
Dealt to PokerStarsMan12 [3c Kd]
appositive: calls 100
PokerStarsMan12: folds 
MaFak2019: calls 100
color_singleton: calls 50
HighCardJasper: checks 
*** FLOP *** [4h 6d Jd]
color_singleton: bets 189
HighCardJasper: folds 
appositive: calls 189
MaFak2019: calls 189
*** TURN *** [4h 6d Jd] [Td]
color_singleton: bets 457
appositive: calls 457
MaFak2019: folds 
*** RIVER *** [4h 6d Jd Td] [9c]
color_singleton: bets 889
appositive: folds 
Uncalled bet (889) returned to color_singleton
color_singleton collected 1778 from pot
color_singleton: doesn't show hand 
*** SUMMARY ***
Total pot 1881 | Rake 103 
Board [4h 6d Jd Td 9c]
Seat 1: color_singleton (small blind) collected (1778)
Seat 2: HighCardJasper (big blind) folded on the Flop
Seat 3: appositive folded on the River
Seat 4: PokerStarsMan12 folded before Flop (didn't bet)
Seat 8: MaFak2019 (button) folded on the Turn



PokerStars Home Game Hand #227985763524: {DaPokaStars}  Hold'em No Limit (50/100) - 2021/07/01 17:21:14 ET
Table 'JULY 1' 9-max (Play Money) Seat #1 is the button
Seat 1: color_singleton (24585 in chips) 
Seat 2: HighCardJasper (4874 in chips) 
Seat 3: appositive (21661 in chips) 
Seat 4: PokerStarsMan12 (25093 in chips) 
Seat 8: MaFak2019 (9895 in chips) 
Seat 9: mnnm585 (16084 in chips) 
HighCardJasper: posts small blind 50
appositive: posts big blind 100
mnnm585: posts small & big blinds 150
*** HOLE CARDS ***
Dealt to PokerStarsMan12 [7h 8s]
PokerStarsMan12: calls 100
MaFak2019: raises 500 to 600
mnnm585: folds 
color_singleton: folds 
HighCardJasper: folds 
appositive: folds 
PokerStarsMan12: folds 
Uncalled bet (500) returned to MaFak2019
MaFak2019 collected 500 from pot
MaFak2019: doesn't show hand 
*** SUMMARY ***
Total pot 500 | Rake 0 
Seat 1: color_singleton (button) folded before Flop (didn't bet)
Seat 2: HighCardJasper (small blind) folded before Flop
Seat 3: appositive (big blind) folded before Flop
Seat 4: PokerStarsMan12 folded before Flop
Seat 8: MaFak2019 collected (500)
Seat 9: mnnm585 folded before Flop (didn't bet)



PokerStars Home Game Hand #227985777328: {DaPokaStars}  Hold'em No Limit (50/100) - 2021/07/01 17:21:31 ET
Table 'JULY 1' 9-max (Play Money) Seat #2 is the button
Seat 1: color_singleton (24585 in chips) 
Seat 2: HighCardJasper (4824 in chips) 
Seat 3: appositive (21561 in chips) 
Seat 4: PokerStarsMan12 (24993 in chips) 
Seat 8: MaFak2019 (10295 in chips) 
Seat 9: mnnm585 (15934 in chips) 
appositive: posts small blind 50
PokerStarsMan12: posts big blind 100
*** HOLE CARDS ***
Dealt to PokerStarsMan12 [9d Kd]
MaFak2019: calls 100
mnnm585: folds 
color_singleton: raises 100 to 200
HighCardJasper: folds 
appositive: calls 150
PokerStarsMan12: calls 100
MaFak2019: calls 100
*** FLOP *** [Ts 4s Js]
appositive: checks 
PokerStarsMan12: checks 
MaFak2019: checks 
color_singleton: checks 
*** TURN *** [Ts 4s Js] [9c]
appositive: checks 
PokerStarsMan12: checks 
MaFak2019: checks 
color_singleton: checks 
*** RIVER *** [Ts 4s Js 9c] [2c]
appositive: checks 
PokerStarsMan12: checks 
Klemtonius is disconnected 
MaFak2019: checks 
color_singleton: checks 
*** SHOW DOWN ***
appositive: shows [6h Ad] (high card Ace)
PokerStarsMan12: shows [9d Kd] (a pair of Nines)
MaFak2019: mucks hand 
color_singleton: mucks hand 
PokerStarsMan12 collected 756 from pot
*** SUMMARY ***
Total pot 800 | Rake 44 
Board [Ts 4s Js 9c 2c]
Seat 1: color_singleton mucked [5h Qh]
Seat 2: HighCardJasper (button) folded before Flop (didn't bet)
Seat 3: appositive (small blind) showed [6h Ad] and lost with high card Ace
Seat 4: PokerStarsMan12 (big blind) showed [9d Kd] and won (756) with a pair of Nines
Seat 8: MaFak2019 mucked [7d 5c]
Seat 9: mnnm585 folded before Flop (didn't bet)



PokerStars Home Game Hand #227985810612: {DaPokaStars}  Hold'em No Limit (50/100) - 2021/07/01 17:22:46 ET
Table 'JULY 1' 9-max (Play Money) Seat #3 is the button
Seat 1: color_singleton (24385 in chips) 
Seat 2: HighCardJasper (4824 in chips) 
Seat 3: appositive (21361 in chips) 
Seat 4: PokerStarsMan12 (25549 in chips) 
Seat 8: MaFak2019 (10095 in chips) 
Seat 9: mnnm585 (15934 in chips) 
PokerStarsMan12: posts small blind 50
MaFak2019: posts big blind 100
*** HOLE CARDS ***
Dealt to PokerStarsMan12 [7c Jc]
mnnm585: raises 100 to 200
color_singleton: folds 
HighCardJasper: folds 
appositive: calls 200
PokerStarsMan12: calls 150
MaFak2019: calls 100
*** FLOP *** [9s 4h 4s]
PokerStarsMan12: checks 
MaFak2019: bets 756
mnnm585: calls 756
appositive: calls 756
PokerStarsMan12: folds 
*** TURN *** [9s 4h 4s] [8c]
MaFak2019: bets 2899
mnnm585: calls 2899
appositive: folds 
*** RIVER *** [9s 4h 4s 8c] [2d]
MaFak2019: bets 6240 and is all-in
mnnm585: folds 
Uncalled bet (6240) returned to MaFak2019
MaFak2019 collected 8378 from pot
MaFak2019: doesn't show hand 
*** SUMMARY ***
Total pot 8866 | Rake 488 
Board [9s 4h 4s 8c 2d]
Seat 1: color_singleton folded before Flop (didn't bet)
Seat 2: HighCardJasper folded before Flop (didn't bet)
Seat 3: appositive (button) folded on the Turn
Seat 4: PokerStarsMan12 (small blind) folded on the Flop
Seat 8: MaFak2019 (big blind) collected (8378)
Seat 9: mnnm585 folded on the River



PokerStars Home Game Hand #227985837812: {DaPokaStars}  Hold'em No Limit (50/100) - 2021/07/01 17:23:47 ET
Table 'JULY 1' 9-max (Play Money) Seat #4 is the button
Seat 1: color_singleton (24385 in chips) 
Seat 2: HighCardJasper (4824 in chips) 
Seat 3: appositive (20405 in chips) 
Seat 4: PokerStarsMan12 (25349 in chips) 
Seat 8: MaFak2019 (14618 in chips) 
Seat 9: mnnm585 (12079 in chips) 
MaFak2019: posts small blind 50
mnnm585: posts big blind 100
*** HOLE CARDS ***
Dealt to PokerStarsMan12 [3c 7c]
color_singleton: folds 
HighCardJasper: folds 
appositive: calls 100
PokerStarsMan12: calls 100
MaFak2019: calls 50
mnnm585: checks 
*** FLOP *** [Qd 2h 8c]
MaFak2019: checks 
mnnm585: checks 
appositive: checks 
PokerStarsMan12: checks 
*** TURN *** [Qd 2h 8c] [8s]
MaFak2019: checks 
mnnm585: bets 189
appositive: raises 189 to 378
PokerStarsMan12: folds 
MaFak2019: folds 
mnnm585: raises 189 to 567
appositive: raises 189 to 756
mnnm585: calls 189
*** RIVER *** [Qd 2h 8c 8s] [2d]
mnnm585: bets 1807
appositive: raises 1807 to 3614
mnnm585: calls 1807
*** SHOW DOWN ***
appositive: shows [8h Qh] (a full house, Eights full of Queens)
mnnm585: mucks hand 
appositive collected 8637 from pot
*** SUMMARY ***
Total pot 9140 | Rake 503 
Board [Qd 2h 8c 8s 2d]
Seat 1: color_singleton folded before Flop (didn't bet)
Seat 2: HighCardJasper folded before Flop (didn't bet)
Seat 3: appositive showed [8h Qh] and won (8637) with a full house, Eights full of Queens
Seat 4: PokerStarsMan12 (button) folded on the Turn
Seat 8: MaFak2019 (small blind) folded on the Turn
Seat 9: mnnm585 (big blind) mucked [8d Jh]



PokerStars Home Game Hand #227985870371: {DaPokaStars}  Hold'em No Limit (50/100) - 2021/07/01 17:24:45 ET
Table 'JULY 1' 9-max (Play Money) Seat #8 is the button
Seat 1: color_singleton (24385 in chips) 
Seat 2: HighCardJasper (4824 in chips) 
Seat 3: appositive (24572 in chips) 
Seat 4: PokerStarsMan12 (25249 in chips) 
Seat 8: MaFak2019 (14518 in chips) 
Seat 9: mnnm585 (7609 in chips) 
mnnm585: posts small blind 50
color_singleton: posts big blind 100
*** HOLE CARDS ***
Dealt to PokerStarsMan12 [9h Qc]
HighCardJasper: calls 100
appositive: calls 100
PokerStarsMan12: calls 100
MaFak2019: calls 100
mnnm585: calls 50
color_singleton: checks 
*** FLOP *** [9c Jc Kd]
mnnm585: checks 
color_singleton: checks 
HighCardJasper: checks 
appositive: bets 300
PokerStarsMan12: folds 
MaFak2019: calls 300
mnnm585: folds 
color_singleton: folds 
HighCardJasper: folds 
*** TURN *** [9c Jc Kd] [4s]
appositive: bets 567
MaFak2019: calls 567
*** RIVER *** [9c Jc Kd 4s] [6c]
appositive: bets 1103
MaFak2019: folds 
Uncalled bet (1103) returned to appositive
appositive collected 2206 from pot
appositive: doesn't show hand 
*** SUMMARY ***
Total pot 2334 | Rake 128 
Board [9c Jc Kd 4s 6c]
Seat 1: color_singleton (big blind) folded on the Flop
Seat 2: HighCardJasper folded on the Flop
Seat 3: appositive collected (2206)
Seat 4: PokerStarsMan12 folded on the Flop
Seat 8: MaFak2019 (button) folded on the River
Seat 9: mnnm585 (small blind) folded on the Flop



PokerStars Home Game Hand #227985907410: {DaPokaStars}  Hold'em No Limit (50/100) - 2021/07/01 17:26:09 ET
Table 'JULY 1' 9-max (Play Money) Seat #9 is the button
Seat 1: color_singleton (24285 in chips) 
Seat 2: HighCardJasper (4724 in chips) 
Seat 3: appositive (25811 in chips) 
Seat 4: PokerStarsMan12 (25149 in chips) 
Seat 8: MaFak2019 (13551 in chips) 
Seat 9: mnnm585 (7509 in chips) 
color_singleton: posts small blind 50
HighCardJasper: posts big blind 100
*** HOLE CARDS ***
Dealt to PokerStarsMan12 [5d Tc]
appositive: calls 100
PokerStarsMan12: folds 
MaFak2019: folds 
mnnm585: calls 100
color_singleton: calls 50
HighCardJasper: checks 
*** FLOP *** [6c Kd Qd]
color_singleton: bets 189
HighCardJasper: calls 189
appositive: calls 189
mnnm585: calls 189
*** TURN *** [6c Kd Qd] [Qc]
color_singleton: checks 
HighCardJasper: checks 
appositive: checks 
mnnm585: bets 1092
color_singleton: calls 1092
HighCardJasper: calls 1092
appositive: folds 
*** RIVER *** [6c Kd Qd Qc] [Ts]
color_singleton: checks 
HighCardJasper: bets 3343 and is all-in
mnnm585: folds 
color_singleton: calls 3343
*** SHOW DOWN ***
HighCardJasper: shows [Js Qh] (three of a kind, Queens)
color_singleton: shows [Qs 5c] (three of a kind, Queens - lower kicker)
HighCardJasper collected 10507 from pot
*** SUMMARY ***
Total pot 11118 | Rake 611 
Board [6c Kd Qd Qc Ts]
Seat 1: color_singleton (small blind) showed [Qs 5c] and lost with three of a kind, Queens
Seat 2: HighCardJasper (big blind) showed [Js Qh] and won (10507) with three of a kind, Queens
Seat 3: appositive folded on the Turn
Seat 4: PokerStarsMan12 folded before Flop (didn't bet)
Seat 8: MaFak2019 folded before Flop (didn't bet)
Seat 9: mnnm585 (button) folded on the River



PokerStars Home Game Hand #227985941370: {DaPokaStars}  Hold'em No Limit (50/100) - 2021/07/01 17:27:26 ET
Table 'JULY 1' 9-max (Play Money) Seat #1 is the button
Seat 1: color_singleton (19561 in chips) 
Seat 2: HighCardJasper (10507 in chips) 
Seat 3: appositive (25522 in chips) 
Seat 4: PokerStarsMan12 (25149 in chips) 
Seat 8: MaFak2019 (13551 in chips) 
Seat 9: mnnm585 (6128 in chips) 
HighCardJasper: posts small blind 50
appositive: posts big blind 100
*** HOLE CARDS ***
Dealt to PokerStarsMan12 [8s Jh]
PokerStarsMan12: folds 
MaFak2019: calls 100
mnnm585: calls 100
color_singleton: calls 100
HighCardJasper: calls 50
appositive: checks 
*** FLOP *** [Th 4s 5d]
HighCardJasper: bets 236
appositive: calls 236
MaFak2019: raises 590 to 826
mnnm585: calls 826
color_singleton: folds 
HighCardJasper: folds 
appositive: folds 
*** TURN *** [Th 4s 5d] [3d]
MaFak2019: checks 
mnnm585: bets 2480
MaFak2019: folds 
Uncalled bet (2480) returned to mnnm585
mnnm585 collected 2480 from pot
*** SUMMARY ***
Total pot 2624 | Rake 144 
Board [Th 4s 5d 3d]
Seat 1: color_singleton (button) folded on the Flop
Seat 2: HighCardJasper (small blind) folded on the Flop
Seat 3: appositive (big blind) folded on the Flop
Seat 4: PokerStarsMan12 folded before Flop (didn't bet)
Seat 8: MaFak2019 folded on the Turn
Seat 9: mnnm585 collected (2480)



PokerStars Home Game Hand #227985977845: {DaPokaStars}  Hold'em No Limit (50/100) - 2021/07/01 17:28:49 ET
Table 'JULY 1' 9-max (Play Money) Seat #2 is the button
Seat 1: color_singleton (19461 in chips) 
Seat 2: HighCardJasper (10171 in chips) 
Seat 3: appositive (25186 in chips) 
Seat 4: PokerStarsMan12 (25149 in chips) 
Seat 8: MaFak2019 (12625 in chips) 
Seat 9: mnnm585 (7682 in chips) 
appositive: posts small blind 50
PokerStarsMan12: posts big blind 100
*** HOLE CARDS ***
Dealt to PokerStarsMan12 [Td Ts]
MaFak2019: calls 100
mnnm585: calls 100
color_singleton: folds 
HighCardJasper: calls 100
appositive: calls 50
PokerStarsMan12: raises 300 to 400
MaFak2019: calls 300
mnnm585: calls 300
HighCardJasper: folds 
appositive: folds 
*** FLOP *** [2c 2s 4d]
PokerStarsMan12: bets 800
MaFak2019: folds 
mnnm585: folds 
Uncalled bet (800) returned to PokerStarsMan12
PokerStarsMan12 collected 1323 from pot
*** SUMMARY ***
Total pot 1400 | Rake 77 
Board [2c 2s 4d]
Seat 1: color_singleton folded before Flop (didn't bet)
Seat 2: HighCardJasper (button) folded before Flop
Seat 3: appositive (small blind) folded before Flop
Seat 4: PokerStarsMan12 (big blind) collected (1323)
Seat 8: MaFak2019 folded on the Flop
Seat 9: mnnm585 folded on the Flop



PokerStars Home Game Hand #227985996078: {DaPokaStars}  Hold'em No Limit (50/100) - 2021/07/01 17:29:31 ET
Table 'JULY 1' 9-max (Play Money) Seat #3 is the button
Seat 1: color_singleton (19461 in chips) 
Seat 2: HighCardJasper (10071 in chips) 
Seat 3: appositive (25086 in chips) 
Seat 4: PokerStarsMan12 (26072 in chips) 
Seat 8: MaFak2019 (12225 in chips) 
Seat 9: mnnm585 (7282 in chips) 
PokerStarsMan12: posts small blind 50
MaFak2019: posts big blind 100
*** HOLE CARDS ***
Dealt to PokerStarsMan12 [2s 5h]
mnnm585: calls 100
color_singleton: raises 300 to 400
HighCardJasper: folds 
appositive: folds 
PokerStarsMan12: folds 
MaFak2019: calls 300
mnnm585: folds 
*** FLOP *** [6s 2h As]
MaFak2019: checks 
color_singleton: bets 449
MaFak2019: calls 449
*** TURN *** [6s 2h As] [6d]
MaFak2019: checks 
color_singleton: bets 873
MaFak2019: folds 
Uncalled bet (873) returned to color_singleton
color_singleton collected 1746 from pot
color_singleton: doesn't show hand 
*** SUMMARY ***
Total pot 1848 | Rake 102 
Board [6s 2h As 6d]
Seat 1: color_singleton collected (1746)
Seat 2: HighCardJasper folded before Flop (didn't bet)
Seat 3: appositive (button) folded before Flop (didn't bet)
Seat 4: PokerStarsMan12 (small blind) folded before Flop
Seat 8: MaFak2019 (big blind) folded on the Turn
Seat 9: mnnm585 folded before Flop



PokerStars Home Game Hand #227986012301: {DaPokaStars}  Hold'em No Limit (50/100) - 2021/07/01 17:30:08 ET
Table 'JULY 1' 9-max (Play Money) Seat #4 is the button
Seat 1: color_singleton (20358 in chips) 
Seat 2: HighCardJasper (10071 in chips) 
Seat 3: appositive (25086 in chips) 
Seat 4: PokerStarsMan12 (26022 in chips) 
Seat 8: MaFak2019 (11376 in chips) 
Seat 9: mnnm585 (7182 in chips) 
MaFak2019: posts small blind 50
mnnm585: posts big blind 100
*** HOLE CARDS ***
Dealt to PokerStarsMan12 [Qd 5h]
color_singleton: raises 100 to 200
HighCardJasper: calls 200
appositive: calls 200
PokerStarsMan12: folds 
MaFak2019: calls 150
mnnm585: calls 100
*** FLOP *** [7h 7c 5s]
MaFak2019: checks 
mnnm585: bets 472
color_singleton: calls 472
HighCardJasper: folds 
appositive: calls 472
MaFak2019: folds 
*** TURN *** [7h 7c 5s] [Jh]
mnnm585: bets 1141
color_singleton: calls 1141
appositive: folds 
*** RIVER *** [7h 7c 5s Jh] [4s]
mnnm585: checks 
color_singleton: checks 
*** SHOW DOWN ***
mnnm585: shows [9d 7d] (three of a kind, Sevens)
color_singleton: mucks hand 
mnnm585 collected 4440 from pot
*** SUMMARY ***
Total pot 4698 | Rake 258 
Board [7h 7c 5s Jh 4s]
Seat 1: color_singleton mucked [Ah Kh]
Seat 2: HighCardJasper folded on the Flop
Seat 3: appositive folded on the Turn
Seat 4: PokerStarsMan12 (button) folded before Flop (didn't bet)
Seat 8: MaFak2019 (small blind) folded on the Flop
Seat 9: mnnm585 (big blind) showed [9d 7d] and won (4440) with three of a kind, Sevens



PokerStars Home Game Hand #227986038343: {DaPokaStars}  Hold'em No Limit (50/100) - 2021/07/01 17:31:08 ET
Table 'JULY 1' 9-max (Play Money) Seat #8 is the button
Seat 1: color_singleton (18545 in chips) 
Seat 2: HighCardJasper (9871 in chips) 
Seat 3: appositive (24414 in chips) 
Seat 4: PokerStarsMan12 (26022 in chips) 
Seat 8: MaFak2019 (11176 in chips) 
Seat 9: mnnm585 (9809 in chips) 
mnnm585: posts small blind 50
color_singleton: posts big blind 100
*** HOLE CARDS ***
Dealt to PokerStarsMan12 [5h 9h]
HighCardJasper: calls 100
appositive: calls 100
PokerStarsMan12: folds 
MaFak2019: calls 100
mnnm585: folds 
color_singleton: checks 
*** FLOP *** [Ac 3s Kd]
color_singleton: checks 
HighCardJasper: checks 
appositive: bets 212
MaFak2019: calls 212
color_singleton: calls 212
HighCardJasper: calls 212
*** TURN *** [Ac 3s Kd] [6s]
color_singleton: checks 
HighCardJasper: checks 
appositive: checks 
MaFak2019: checks 
*** RIVER *** [Ac 3s Kd 6s] [8d]
color_singleton: checks 
HighCardJasper: checks 
appositive: bets 613
MaFak2019: calls 613
color_singleton: folds 
HighCardJasper: folds 
*** SHOW DOWN ***
appositive: shows [6c As] (two pair, Aces and Sixes)
MaFak2019: mucks hand 
appositive collected 2385 from pot
*** SUMMARY ***
Total pot 2524 | Rake 139 
Board [Ac 3s Kd 6s 8d]
Seat 1: color_singleton (big blind) folded on the River
Seat 2: HighCardJasper folded on the River
Seat 3: appositive showed [6c As] and won (2385) with two pair, Aces and Sixes
Seat 4: PokerStarsMan12 folded before Flop (didn't bet)
Seat 8: MaFak2019 (button) mucked [5s 5c]
Seat 9: mnnm585 (small blind) folded before Flop



PokerStars Home Game Hand #227986069728: {DaPokaStars}  Hold'em No Limit (50/100) - 2021/07/01 17:32:21 ET
Table 'JULY 1' 9-max (Play Money) Seat #9 is the button
Seat 1: color_singleton (18233 in chips) 
Seat 2: HighCardJasper (9559 in chips) 
Seat 3: appositive (25874 in chips) 
Seat 4: PokerStarsMan12 (26022 in chips) 
Seat 8: MaFak2019 (10251 in chips) 
Seat 9: mnnm585 (9759 in chips) 
color_singleton: posts small blind 50
HighCardJasper: posts big blind 100
*** HOLE CARDS ***
Dealt to PokerStarsMan12 [8c 2s]
appositive: folds 
PokerStarsMan12: folds 
MaFak2019: calls 100
mnnm585: folds 
color_singleton: raises 100 to 200
Klemtonius leaves the table
HighCardJasper: calls 100
MaFak2019: raises 600 to 800
color_singleton: calls 600
HighCardJasper: folds 
*** FLOP *** [4s Th 3c]
color_singleton: bets 850
MaFak2019: folds 
Uncalled bet (850) returned to color_singleton
color_singleton collected 1701 from pot
color_singleton: doesn't show hand 
*** SUMMARY ***
Total pot 1800 | Rake 99 
Board [4s Th 3c]
Seat 1: color_singleton (small blind) collected (1701)
Seat 2: HighCardJasper (big blind) folded before Flop
Seat 3: appositive folded before Flop (didn't bet)
Seat 4: PokerStarsMan12 folded before Flop (didn't bet)
Seat 8: MaFak2019 folded on the Flop
Seat 9: mnnm585 (button) folded before Flop (didn't bet)



PokerStars Home Game Hand #227986084981: {DaPokaStars}  Hold'em No Limit (50/100) - 2021/07/01 17:32:57 ET
Table 'JULY 1' 9-max (Play Money) Seat #1 is the button
Seat 1: color_singleton (19134 in chips) 
Seat 2: HighCardJasper (9359 in chips) 
Seat 3: appositive (25874 in chips) 
Seat 4: PokerStarsMan12 (26022 in chips) 
Seat 8: MaFak2019 (9451 in chips) 
Seat 9: mnnm585 (9759 in chips) 
HighCardJasper: posts small blind 50
appositive: posts big blind 100
*** HOLE CARDS ***
Dealt to PokerStarsMan12 [Ts 8h]
PokerStarsMan12: folds 
MaFak2019: calls 100
mnnm585: raises 100 to 200
color_singleton: calls 200
HighCardJasper: folds 
appositive: calls 100
MaFak2019: calls 100
*** FLOP *** [8s 5h 2s]
appositive: checks 
MaFak2019: bets 803
mnnm585: folds 
color_singleton: calls 803
appositive: calls 803
*** TURN *** [8s 5h 2s] [4c]
appositive: checks 
MaFak2019: bets 3080
color_singleton: folds 
appositive: folds 
Uncalled bet (3080) returned to MaFak2019
MaFak2019 collected 3080 from pot
MaFak2019: doesn't show hand 
*** SUMMARY ***
Total pot 3259 | Rake 179 
Board [8s 5h 2s 4c]
Seat 1: color_singleton (button) folded on the Turn
Seat 2: HighCardJasper (small blind) folded before Flop
Seat 3: appositive (big blind) folded on the Turn
Seat 4: PokerStarsMan12 folded before Flop (didn't bet)
Seat 8: MaFak2019 collected (3080)
Seat 9: mnnm585 folded on the Flop



PokerStars Home Game Hand #227986107403: {DaPokaStars}  Hold'em No Limit (50/100) - 2021/07/01 17:33:49 ET
Table 'JULY 1' 9-max (Play Money) Seat #2 is the button
Seat 1: color_singleton (18131 in chips) 
Seat 2: HighCardJasper (9309 in chips) 
Seat 3: appositive (24871 in chips) 
Seat 4: PokerStarsMan12 (26022 in chips) 
Seat 8: MaFak2019 (11528 in chips) 
Seat 9: mnnm585 (9559 in chips) 
appositive: posts small blind 50
PokerStarsMan12: posts big blind 100
*** HOLE CARDS ***
Dealt to PokerStarsMan12 [Kc Jc]
MaFak2019: calls 100
mnnm585: calls 100
color_singleton: calls 100
HighCardJasper: raises 100 to 200
appositive: folds 
PokerStarsMan12: calls 100
MaFak2019: raises 100 to 300
mnnm585: calls 200
color_singleton: calls 200
HighCardJasper: calls 100
PokerStarsMan12 is disconnected 
PokerStarsMan12 has timed out while being disconnected
PokerStarsMan12: folds 
*** FLOP *** [7h 3c 6h]
MaFak2019: bets 1370
mnnm585: folds 
color_singleton: folds 
HighCardJasper: folds 
Uncalled bet (1370) returned to MaFak2019
MaFak2019 collected 1370 from pot
MaFak2019: doesn't show hand 
*** SUMMARY ***
Total pot 1450 | Rake 80 
Board [7h 3c 6h]
Seat 1: color_singleton folded on the Flop
Seat 2: HighCardJasper (button) folded on the Flop
Seat 3: appositive (small blind) folded before Flop
Seat 4: PokerStarsMan12 (big blind) folded before Flop
Seat 8: MaFak2019 collected (1370)
Seat 9: mnnm585 folded on the Flop



PokerStars Home Game Hand #227986137121: {DaPokaStars}  Hold'em No Limit (50/100) - 2021/07/01 17:34:59 ET
Table 'JULY 1' 9-max (Play Money) Seat #3 is the button
Seat 1: color_singleton (17831 in chips) 
Seat 2: HighCardJasper (9009 in chips) 
Seat 3: appositive (24821 in chips) 
Seat 4: PokerStarsMan12 (25822 in chips) 
Seat 8: MaFak2019 (12598 in chips) 
Seat 9: mnnm585 (9259 in chips) 
PokerStarsMan12: posts small blind 50
MaFak2019: posts big blind 100
*** HOLE CARDS ***
Dealt to PokerStarsMan12 [6c Ah]
mnnm585: folds 
color_singleton: raises 200 to 300
HighCardJasper: calls 300
appositive: folds 
PokerStarsMan12: folds 
MaFak2019: calls 200
*** FLOP *** [3d 4c Kh]
MaFak2019: checks 
color_singleton: bets 449
HighCardJasper: folds 
MaFak2019: folds 
Uncalled bet (449) returned to color_singleton
color_singleton collected 898 from pot
color_singleton: doesn't show hand 
*** SUMMARY ***
Total pot 950 | Rake 52 
Board [3d 4c Kh]
Seat 1: color_singleton collected (898)
Seat 2: HighCardJasper folded on the Flop
Seat 3: appositive (button) folded before Flop (didn't bet)
Seat 4: PokerStarsMan12 (small blind) folded before Flop
Seat 8: MaFak2019 (big blind) folded on the Flop
Seat 9: mnnm585 folded before Flop (didn't bet)



PokerStars Home Game Hand #227986157726: {DaPokaStars}  Hold'em No Limit (50/100) - 2021/07/01 17:35:47 ET
Table 'JULY 1' 9-max (Play Money) Seat #4 is the button
Seat 1: color_singleton (18429 in chips) 
Seat 2: HighCardJasper (8709 in chips) 
Seat 3: appositive (24821 in chips) 
Seat 4: PokerStarsMan12 (25772 in chips) 
Seat 8: MaFak2019 (12298 in chips) 
Seat 9: mnnm585 (9259 in chips) 
MaFak2019: posts small blind 50
mnnm585: posts big blind 100
*** HOLE CARDS ***
Dealt to PokerStarsMan12 [Ad 8s]
color_singleton: raises 200 to 300
HighCardJasper: folds 
appositive: calls 300
PokerStarsMan12: calls 300
MaFak2019: calls 250
mnnm585: folds 
*** FLOP *** [Ts 8c 5s]
MaFak2019: checks 
color_singleton: bets 614
appositive: calls 614
PokerStarsMan12: folds 
MaFak2019: folds 
*** TURN *** [Ts 8c 5s] [Kh]
color_singleton: bets 1194
appositive: folds 
Uncalled bet (1194) returned to color_singleton
color_singleton collected 2389 from pot
color_singleton: doesn't show hand 
*** SUMMARY ***
Total pot 2528 | Rake 139 
Board [Ts 8c 5s Kh]
Seat 1: color_singleton collected (2389)
Seat 2: HighCardJasper folded before Flop (didn't bet)
Seat 3: appositive folded on the Turn
Seat 4: PokerStarsMan12 (button) folded on the Flop
Seat 8: MaFak2019 (small blind) folded on the Flop
Seat 9: mnnm585 (big blind) folded before Flop



PokerStars Home Game Hand #227986178053: {DaPokaStars}  Hold'em No Limit (50/100) - 2021/07/01 17:36:35 ET
Table 'JULY 1' 9-max (Play Money) Seat #8 is the button
Seat 1: color_singleton (19904 in chips) 
Seat 2: HighCardJasper (8709 in chips) 
Seat 3: appositive (23907 in chips) 
Seat 4: PokerStarsMan12 (25472 in chips) 
Seat 8: MaFak2019 (11998 in chips) 
Seat 9: mnnm585 (9159 in chips) 
mnnm585: posts small blind 50
color_singleton: posts big blind 100
*** HOLE CARDS ***
Dealt to PokerStarsMan12 [Qs 4h]
HighCardJasper: raises 200 to 300
appositive: folds 
PokerStarsMan12: folds 
MaFak2019: folds 
mnnm585: folds 
color_singleton: calls 200
*** FLOP *** [8h 8c Td]
color_singleton: bets 307
HighCardJasper: calls 307
*** TURN *** [8h 8c Td] [9d]
color_singleton: bets 597
HighCardJasper: folds 
Uncalled bet (597) returned to color_singleton
color_singleton collected 1194 from pot
color_singleton: doesn't show hand 
*** SUMMARY ***
Total pot 1264 | Rake 70 
Board [8h 8c Td 9d]
Seat 1: color_singleton (big blind) collected (1194)
Seat 2: HighCardJasper folded on the Turn
Seat 3: appositive folded before Flop (didn't bet)
Seat 4: PokerStarsMan12 folded before Flop (didn't bet)
Seat 8: MaFak2019 (button) folded before Flop (didn't bet)
Seat 9: mnnm585 (small blind) folded before Flop



PokerStars Home Game Hand #227986196847: {DaPokaStars}  Hold'em No Limit (50/100) - 2021/07/01 17:37:19 ET
Table 'JULY 1' 9-max (Play Money) Seat #9 is the button
Seat 1: color_singleton (20491 in chips) 
Seat 2: HighCardJasper (8102 in chips) 
Seat 3: appositive (23907 in chips) 
Seat 4: PokerStarsMan12 (25472 in chips) 
Seat 8: MaFak2019 (11998 in chips) 
Seat 9: mnnm585 (9109 in chips) 
color_singleton: posts small blind 50
HighCardJasper: posts big blind 100
*** HOLE CARDS ***
Dealt to PokerStarsMan12 [Kd Qd]
appositive: calls 100
PokerStarsMan12: raises 300 to 400
MaFak2019: calls 400
mnnm585: folds 
color_singleton: folds 
HighCardJasper: folds 
appositive: calls 300
*** FLOP *** [Ac 7s 2d]
appositive: bets 638
PokerStarsMan12: folds 
MaFak2019: raises 638 to 1276
appositive: calls 638
*** TURN *** [Ac 7s 2d] [Kh]
appositive: checks 
MaFak2019: bets 3687
appositive: folds 
Uncalled bet (3687) returned to MaFak2019
MaFak2019 collected 3687 from pot
MaFak2019: doesn't show hand 
*** SUMMARY ***
Total pot 3902 | Rake 215 
Board [Ac 7s 2d Kh]
Seat 1: color_singleton (small blind) folded before Flop
Seat 2: HighCardJasper (big blind) folded before Flop
Seat 3: appositive folded on the Turn
Seat 4: PokerStarsMan12 folded on the Flop
Seat 8: MaFak2019 collected (3687)
Seat 9: mnnm585 (button) folded before Flop (didn't bet)



PokerStars Home Game Hand #227986225237: {DaPokaStars}  Hold'em No Limit (50/100) - 2021/07/01 17:38:26 ET
Table 'JULY 1' 9-max (Play Money) Seat #1 is the button
Seat 1: color_singleton (20441 in chips) 
Seat 2: HighCardJasper (8002 in chips) 
Seat 3: appositive (22231 in chips) 
Seat 4: PokerStarsMan12 (25072 in chips) 
Seat 8: MaFak2019 (14009 in chips) 
Seat 9: mnnm585 (9109 in chips) 
HighCardJasper: posts small blind 50
appositive: posts big blind 100
*** HOLE CARDS ***
Dealt to PokerStarsMan12 [4c 2d]
PokerStarsMan12: folds 
MaFak2019: calls 100
mnnm585: calls 100
color_singleton has timed out
color_singleton: folds 
HighCardJasper: calls 50
appositive: checks 
*** FLOP *** [Ac 4h 5s]
HighCardJasper: checks 
appositive: checks 
MaFak2019: checks 
mnnm585: checks 
*** TURN *** [Ac 4h 5s] [2c]
HighCardJasper: checks 
appositive: checks 
MaFak2019: checks 
mnnm585: checks 
*** RIVER *** [Ac 4h 5s 2c] [8h]
HighCardJasper: bets 100
appositive: folds 
MaFak2019: raises 578 to 678
mnnm585: folds 
HighCardJasper: calls 578
*** SHOW DOWN ***
MaFak2019: shows [6d 8s] (a pair of Eights)
HighCardJasper: shows [2h 8c] (two pair, Eights and Deuces)
HighCardJasper collected 1659 from pot
*** SUMMARY ***
Total pot 1756 | Rake 97 
Board [Ac 4h 5s 2c 8h]
Seat 1: color_singleton (button) folded before Flop (didn't bet)
Seat 2: HighCardJasper (small blind) showed [2h 8c] and won (1659) with two pair, Eights and Deuces
Seat 3: appositive (big blind) folded on the River
Seat 4: PokerStarsMan12 folded before Flop (didn't bet)
Seat 8: MaFak2019 showed [6d 8s] and lost with a pair of Eights
Seat 9: mnnm585 folded on the River



PokerStars Home Game Hand #227986258008: {DaPokaStars}  Hold'em No Limit (50/100) - 2021/07/01 17:39:43 ET
Table 'JULY 1' 9-max (Play Money) Seat #2 is the button
Seat 2: HighCardJasper (8883 in chips) 
Seat 3: appositive (22131 in chips) 
Seat 4: PokerStarsMan12 (25072 in chips) 
Seat 8: MaFak2019 (13231 in chips) 
Seat 9: mnnm585 (9009 in chips) 
appositive: posts small blind 50
PokerStarsMan12: posts big blind 100
*** HOLE CARDS ***
Dealt to PokerStarsMan12 [7c Td]
MaFak2019: raises 250 to 350
mnnm585: folds 
HighCardJasper: calls 350
appositive: folds 
PokerStarsMan12: folds 
*** FLOP *** [Qs 9s Kh]
MaFak2019: checks 
HighCardJasper: bets 401
MaFak2019: calls 401
*** TURN *** [Qs 9s Kh] [As]
MaFak2019: checks 
HighCardJasper: bets 780
MaFak2019: calls 780
*** RIVER *** [Qs 9s Kh As] [Tc]
MaFak2019: checks 
HighCardJasper: checks 
*** SHOW DOWN ***
MaFak2019: shows [Ah 5h] (a pair of Aces)
HighCardJasper: shows [4h Ad] (a pair of Aces)
MaFak2019 collected 1518 from pot
HighCardJasper collected 1517 from pot
*** SUMMARY ***
Total pot 3212 | Rake 177 
Board [Qs 9s Kh As Tc]
Seat 2: HighCardJasper (button) showed [4h Ad] and won (1517) with a pair of Aces
Seat 3: appositive (small blind) folded before Flop
Seat 4: PokerStarsMan12 (big blind) folded before Flop
Seat 8: MaFak2019 showed [Ah 5h] and won (1518) with a pair of Aces
Seat 9: mnnm585 folded before Flop (didn't bet)



PokerStars Home Game Hand #227986278481: {DaPokaStars}  Hold'em No Limit (50/100) - 2021/07/01 17:40:31 ET
Table 'JULY 1' 9-max (Play Money) Seat #3 is the button
Seat 1: color_singleton (20441 in chips) 
Seat 2: HighCardJasper (8869 in chips) 
Seat 3: appositive (22081 in chips) 
Seat 4: PokerStarsMan12 (24972 in chips) 
Seat 8: MaFak2019 (13218 in chips) 
Seat 9: mnnm585 (9009 in chips) 
PokerStarsMan12: posts small blind 50
MaFak2019: posts big blind 100
*** HOLE CARDS ***
Dealt to PokerStarsMan12 [3s Js]
mnnm585: raises 100 to 200
color_singleton: folds 
HighCardJasper: folds 
appositive: calls 200
PokerStarsMan12: calls 150
MaFak2019: raises 100 to 300
mnnm585: calls 100
appositive: calls 100
PokerStarsMan12: calls 100
*** FLOP *** [4h 9c 4c]
PokerStarsMan12: checks 
MaFak2019: checks 
mnnm585: bets 567
appositive: calls 567
PokerStarsMan12: folds 
MaFak2019: folds 
*** TURN *** [4h 9c 4c] [3c]
mnnm585: bets 1103
appositive: raises 1103 to 2206
mnnm585: calls 1103
*** RIVER *** [4h 9c 4c 3c] [5d]
mnnm585: checks 
appositive: checks 
*** SHOW DOWN ***
mnnm585: shows [Jc Jh] (two pair, Jacks and Fours)
appositive: mucks hand 
mnnm585 collected 6375 from pot
*** SUMMARY ***
Total pot 6746 | Rake 371 
Board [4h 9c 4c 3c 5d]
Seat 1: color_singleton folded before Flop (didn't bet)
Seat 2: HighCardJasper folded before Flop (didn't bet)
Seat 3: appositive (button) mucked [9s Ah]
Seat 4: PokerStarsMan12 (small blind) folded on the Flop
Seat 8: MaFak2019 (big blind) folded on the Flop
Seat 9: mnnm585 showed [Jc Jh] and won (6375) with two pair, Jacks and Fours



PokerStars Home Game Hand #227986308111: {DaPokaStars}  Hold'em No Limit (50/100) - 2021/07/01 17:41:40 ET
Table 'JULY 1' 9-max (Play Money) Seat #4 is the button
Seat 1: color_singleton (20441 in chips) 
Seat 2: HighCardJasper (8869 in chips) 
Seat 3: appositive (19008 in chips) 
Seat 4: PokerStarsMan12 (24672 in chips) 
Seat 9: mnnm585 (12311 in chips) 
mnnm585: posts small blind 50
color_singleton: posts big blind 100
*** HOLE CARDS ***
Dealt to PokerStarsMan12 [9h 7s]
HighCardJasper: raises 200 to 300
appositive: folds 
PokerStarsMan12: folds 
mnnm585: calls 250
color_singleton: calls 200
*** FLOP *** [6h 9s Qc]
mnnm585: checks 
color_singleton: bets 425
HighCardJasper: folds 
mnnm585: folds 
Uncalled bet (425) returned to color_singleton
color_singleton collected 850 from pot
color_singleton: doesn't show hand 
*** SUMMARY ***
Total pot 900 | Rake 50 
Board [6h 9s Qc]
Seat 1: color_singleton (big blind) collected (850)
Seat 2: HighCardJasper folded on the Flop
Seat 3: appositive folded before Flop (didn't bet)
Seat 4: PokerStarsMan12 (button) folded before Flop (didn't bet)
Seat 9: mnnm585 (small blind) folded on the Flop



PokerStars Home Game Hand #227986323888: {DaPokaStars}  Hold'em No Limit (50/100) - 2021/07/01 17:42:17 ET
Table 'JULY 1' 9-max (Play Money) Seat #9 is the button
Seat 1: color_singleton (20991 in chips) 
Seat 2: HighCardJasper (8569 in chips) 
Seat 3: appositive (19008 in chips) 
Seat 4: PokerStarsMan12 (24672 in chips) 
Seat 8: MaFak2019 (12918 in chips) 
Seat 9: mnnm585 (12011 in chips) 
color_singleton: posts small blind 50
HighCardJasper: posts big blind 100
MaFak2019: posts small blind 50
*** HOLE CARDS ***
Dealt to PokerStarsMan12 [5c Ac]
appositive: calls 100
PokerStarsMan12: calls 100
MaFak2019: calls 100
mnnm585: calls 100
color_singleton: calls 50
HighCardJasper: checks 
*** FLOP *** [Kh 9d Qd]
color_singleton: bets 307
HighCardJasper: folds 
appositive: calls 307
PokerStarsMan12: folds 
MaFak2019: calls 307
mnnm585: raises 307 to 614
color_singleton: folds 
appositive: calls 307
MaFak2019: calls 307
*** TURN *** [Kh 9d Qd] [9h]
appositive: bets 900
MaFak2019: calls 900
mnnm585: calls 900
*** RIVER *** [Kh 9d Qd 9h] [As]
appositive: checks 
MaFak2019: checks 
mnnm585: bets 5197
appositive: folds 
MaFak2019: folds 
Uncalled bet (5197) returned to mnnm585
mnnm585 collected 5197 from pot
*** SUMMARY ***
Total pot 5499 | Rake 302 
Board [Kh 9d Qd 9h As]
Seat 1: color_singleton (small blind) folded on the Flop
Seat 2: HighCardJasper (big blind) folded on the Flop
Seat 3: appositive folded on the River
Seat 4: PokerStarsMan12 folded on the Flop
Seat 8: MaFak2019 folded on the River
Seat 9: mnnm585 (button) collected (5197)



PokerStars Home Game Hand #227986375774: {DaPokaStars}  Hold'em No Limit (50/100) - 2021/07/01 17:43:57 ET
Table 'JULY 1' 9-max (Play Money) Seat #1 is the button
Seat 1: color_singleton (20584 in chips) 
Seat 2: HighCardJasper (8469 in chips) 
Seat 3: appositive (17394 in chips) 
Seat 4: PokerStarsMan12 (24572 in chips) 
Seat 8: MaFak2019 (11254 in chips) 
Seat 9: mnnm585 (15594 in chips) 
HighCardJasper: posts small blind 50
appositive: posts big blind 100
*** HOLE CARDS ***
Dealt to PokerStarsMan12 [Ac 7s]
PokerStarsMan12: raises 200 to 300
MaFak2019: calls 300
mnnm585: calls 300
color_singleton: folds 
HighCardJasper: calls 250
appositive: folds 
*** FLOP *** [3s 3h 2h]
HighCardJasper: checks 
PokerStarsMan12: checks 
MaFak2019: bets 1228
mnnm585: folds 
HighCardJasper: folds 
PokerStarsMan12: folds 
Uncalled bet (1228) returned to MaFak2019
MaFak2019 collected 1228 from pot
MaFak2019: doesn't show hand 
*** SUMMARY ***
Total pot 1300 | Rake 72 
Board [3s 3h 2h]
Seat 1: color_singleton (button) folded before Flop (didn't bet)
Seat 2: HighCardJasper (small blind) folded on the Flop
Seat 3: appositive (big blind) folded before Flop
Seat 4: PokerStarsMan12 folded on the Flop
Seat 8: MaFak2019 collected (1228)
Seat 9: mnnm585 folded on the Flop



PokerStars Home Game Hand #227986390281: {DaPokaStars}  Hold'em No Limit (50/100) - 2021/07/01 17:44:32 ET
Table 'JULY 1' 9-max (Play Money) Seat #2 is the button
Seat 1: color_singleton (20584 in chips) 
Seat 2: HighCardJasper (8169 in chips) 
Seat 3: appositive (17294 in chips) 
Seat 4: PokerStarsMan12 (24272 in chips) 
Seat 8: MaFak2019 (12182 in chips) 
Seat 9: mnnm585 (15294 in chips) 
appositive: posts small blind 50
PokerStarsMan12: posts big blind 100
*** HOLE CARDS ***
Dealt to PokerStarsMan12 [2d 2c]
MaFak2019: calls 100
mnnm585: folds 
color_singleton: folds 
HighCardJasper: calls 100
appositive: calls 50
PokerStarsMan12: checks 
*** FLOP *** [Jh 5h As]
appositive: checks 
PokerStarsMan12: checks 
MaFak2019: checks 
HighCardJasper: checks 
*** TURN *** [Jh 5h As] [5d]
appositive: checks 
PokerStarsMan12: bets 200
MaFak2019: calls 200
HighCardJasper: folds 
appositive: folds 
*** RIVER *** [Jh 5h As 5d] [9d]
PokerStarsMan12: bets 500
MaFak2019: folds 
Uncalled bet (500) returned to PokerStarsMan12
PokerStarsMan12 collected 756 from pot
*** SUMMARY ***
Total pot 800 | Rake 44 
Board [Jh 5h As 5d 9d]
Seat 1: color_singleton folded before Flop (didn't bet)
Seat 2: HighCardJasper (button) folded on the Turn
Seat 3: appositive (small blind) folded on the Turn
Seat 4: PokerStarsMan12 (big blind) collected (756)
Seat 8: MaFak2019 folded on the River
Seat 9: mnnm585 folded before Flop (didn't bet)



PokerStars Home Game Hand #227986411037: {DaPokaStars}  Hold'em No Limit (50/100) - 2021/07/01 17:45:22 ET
Table 'JULY 1' 9-max (Play Money) Seat #3 is the button
Seat 1: color_singleton (20584 in chips) 
Seat 2: HighCardJasper (8069 in chips) 
Seat 3: appositive (17194 in chips) 
Seat 4: PokerStarsMan12 (24728 in chips) 
Seat 8: MaFak2019 (11882 in chips) 
Seat 9: mnnm585 (15294 in chips) 
PokerStarsMan12: posts small blind 50
MaFak2019: posts big blind 100
*** HOLE CARDS ***
Dealt to PokerStarsMan12 [Ac Th]
mnnm585: calls 100
color_singleton: raises 100 to 200
HighCardJasper: raises 100 to 300
appositive: calls 300
PokerStarsMan12: calls 250
MaFak2019: folds 
mnnm585: calls 200
color_singleton: calls 100
*** FLOP *** [4c 9s 3c]
PokerStarsMan12: checks 
mnnm585: checks 
color_singleton: checks 
HighCardJasper: bets 1512
appositive: folds 
PokerStarsMan12: folds 
mnnm585: folds 
color_singleton: folds 
Uncalled bet (1512) returned to HighCardJasper
HighCardJasper collected 1512 from pot
HighCardJasper: doesn't show hand 
*** SUMMARY ***
Total pot 1600 | Rake 88 
Board [4c 9s 3c]
Seat 1: color_singleton folded on the Flop
Seat 2: HighCardJasper collected (1512)
Seat 3: appositive (button) folded on the Flop
Seat 4: PokerStarsMan12 (small blind) folded on the Flop
Seat 8: MaFak2019 (big blind) folded before Flop
Seat 9: mnnm585 folded on the Flop



PokerStars Home Game Hand #227986430998: {DaPokaStars}  Hold'em No Limit (50/100) - 2021/07/01 17:46:10 ET
Table 'JULY 1' 9-max (Play Money) Seat #4 is the button
Seat 1: color_singleton (20284 in chips) 
Seat 2: HighCardJasper (9281 in chips) 
Seat 3: appositive (16894 in chips) 
Seat 4: PokerStarsMan12 (24428 in chips) 
Seat 8: MaFak2019 (11782 in chips) 
Seat 9: mnnm585 (14994 in chips) 
MaFak2019: posts small blind 50
mnnm585: posts big blind 100
*** HOLE CARDS ***
Dealt to PokerStarsMan12 [Jh Qc]
color_singleton: calls 100
HighCardJasper: calls 100
appositive: calls 100
PokerStarsMan12: raises 200 to 300
MaFak2019: raises 1000 to 1300
mnnm585: folds 
color_singleton: folds 
HighCardJasper: folds 
appositive: folds 
PokerStarsMan12: folds 
Uncalled bet (1000) returned to MaFak2019
MaFak2019 collected 1000 from pot
MaFak2019: doesn't show hand 
*** SUMMARY ***
Total pot 1000 | Rake 0 
Seat 1: color_singleton folded before Flop
Seat 2: HighCardJasper folded before Flop
Seat 3: appositive folded before Flop
Seat 4: PokerStarsMan12 (button) folded before Flop
Seat 8: MaFak2019 (small blind) collected (1000)
Seat 9: mnnm585 (big blind) folded before Flop



PokerStars Home Game Hand #227986442443: {DaPokaStars}  Hold'em No Limit (50/100) - 2021/07/01 17:46:38 ET
Table 'JULY 1' 9-max (Play Money) Seat #8 is the button
Seat 1: color_singleton (20184 in chips) 
Seat 2: HighCardJasper (9181 in chips) 
Seat 3: appositive (16794 in chips) 
Seat 4: PokerStarsMan12 (24128 in chips) 
Seat 8: MaFak2019 (12482 in chips) 
Seat 9: mnnm585 (14894 in chips) 
mnnm585: posts small blind 50
color_singleton: posts big blind 100
*** HOLE CARDS ***
Dealt to PokerStarsMan12 [Tc 3c]
HighCardJasper: calls 100
appositive: calls 100
PokerStarsMan12: folds 
MaFak2019: calls 100
mnnm585: calls 50
color_singleton: checks 
*** FLOP *** [9d Ad Qh]
mnnm585: checks 
color_singleton: checks 
HighCardJasper: checks 
appositive: checks 
MaFak2019: checks 
*** TURN *** [9d Ad Qh] [Ks]
mnnm585: checks 
color_singleton: bets 236
HighCardJasper: calls 236
appositive: calls 236
MaFak2019: raises 1416 to 1652
mnnm585: folds 
color_singleton: folds 
HighCardJasper: folds 
appositive: folds 
Uncalled bet (1416) returned to MaFak2019
MaFak2019 collected 1365 from pot
MaFak2019: doesn't show hand 
*** SUMMARY ***
Total pot 1444 | Rake 79 
Board [9d Ad Qh Ks]
Seat 1: color_singleton (big blind) folded on the Turn
Seat 2: HighCardJasper folded on the Turn
Seat 3: appositive folded on the Turn
Seat 4: PokerStarsMan12 folded before Flop (didn't bet)
Seat 8: MaFak2019 (button) collected (1365)
Seat 9: mnnm585 (small blind) folded on the Turn



PokerStars Home Game Hand #227986460761: {DaPokaStars}  Hold'em No Limit (50/100) - 2021/07/01 17:47:22 ET
Table 'JULY 1' 9-max (Play Money) Seat #9 is the button
Seat 1: color_singleton (19848 in chips) 
Seat 2: HighCardJasper (8845 in chips) 
Seat 3: appositive (16458 in chips) 
Seat 4: PokerStarsMan12 (24128 in chips) 
Seat 8: MaFak2019 (13511 in chips) 
Seat 9: mnnm585 (14794 in chips) 
color_singleton: posts small blind 50
HighCardJasper: posts big blind 100
*** HOLE CARDS ***
Dealt to PokerStarsMan12 [9s 8c]
appositive: calls 100
PokerStarsMan12: calls 100
MaFak2019: calls 100
mnnm585: calls 100
color_singleton: calls 50
HighCardJasper: checks 
*** FLOP *** [Kd Qh 8h]
color_singleton: checks 
HighCardJasper: checks 
appositive: bets 283
PokerStarsMan12: folds 
MaFak2019: folds 
mnnm585: folds 
color_singleton: folds 
HighCardJasper: calls 283
*** TURN *** [Kd Qh 8h] [5d]
HighCardJasper: checks 
appositive: bets 551
HighCardJasper: calls 551
*** RIVER *** [Kd Qh 8h 5d] [5c]
HighCardJasper: checks 
appositive: bets 1071
HighCardJasper: raises 1071 to 2142
appositive: calls 1071
*** SHOW DOWN ***
HighCardJasper: shows [8s Kh] (two pair, Kings and Eights)
appositive: mucks hand 
HighCardJasper collected 6192 from pot
*** SUMMARY ***
Total pot 6552 | Rake 360 
Board [Kd Qh 8h 5d 5c]
Seat 1: color_singleton (small blind) folded on the Flop
Seat 2: HighCardJasper (big blind) showed [8s Kh] and won (6192) with two pair, Kings and Eights
Seat 3: appositive mucked [Jd Kc]
Seat 4: PokerStarsMan12 folded on the Flop
Seat 8: MaFak2019 folded on the Flop
Seat 9: mnnm585 (button) folded on the Flop



PokerStars Home Game Hand #227986491920: {DaPokaStars}  Hold'em No Limit (50/100) - 2021/07/01 17:48:37 ET
Table 'JULY 1' 9-max (Play Money) Seat #1 is the button
Seat 1: color_singleton (19748 in chips) 
Seat 2: HighCardJasper (11961 in chips) 
Seat 3: appositive (13382 in chips) 
Seat 4: PokerStarsMan12 (24028 in chips) 
Seat 8: MaFak2019 (13411 in chips) 
Seat 9: mnnm585 (14694 in chips) 
HighCardJasper: posts small blind 50
appositive: posts big blind 100
*** HOLE CARDS ***
Dealt to PokerStarsMan12 [4s 2d]
PokerStarsMan12: folds 
MaFak2019: raises 250 to 350
mnnm585: calls 350
color_singleton: folds 
HighCardJasper: folds 
appositive: folds 
*** FLOP *** [Ks Tc 2c]
MaFak2019: checks 
mnnm585: checks 
*** TURN *** [Ks Tc 2c] [2h]
MaFak2019: checks 
mnnm585: checks 
*** RIVER *** [Ks Tc 2c 2h] [Ts]
MaFak2019: checks 
mnnm585: bets 401
MaFak2019: folds 
Uncalled bet (401) returned to mnnm585
mnnm585 collected 803 from pot
*** SUMMARY ***
Total pot 850 | Rake 47 
Board [Ks Tc 2c 2h Ts]
Seat 1: color_singleton (button) folded before Flop (didn't bet)
Seat 2: HighCardJasper (small blind) folded before Flop
Seat 3: appositive (big blind) folded before Flop
Seat 4: PokerStarsMan12 folded before Flop (didn't bet)
Seat 8: MaFak2019 folded on the River
Seat 9: mnnm585 collected (803)



PokerStars Home Game Hand #227986505960: {DaPokaStars}  Hold'em No Limit (50/100) - 2021/07/01 17:49:10 ET
Table 'JULY 1' 9-max (Play Money) Seat #2 is the button
Seat 1: color_singleton (19748 in chips) 
Seat 2: HighCardJasper (11911 in chips) 
Seat 3: appositive (13282 in chips) 
Seat 4: PokerStarsMan12 (24028 in chips) 
Seat 8: MaFak2019 (13061 in chips) 
Seat 9: mnnm585 (15147 in chips) 
appositive: posts small blind 50
PokerStarsMan12: posts big blind 100
*** HOLE CARDS ***
Dealt to PokerStarsMan12 [5d 9h]
MaFak2019: folds 
mnnm585: calls 100
color_singleton: raises 200 to 300
HighCardJasper: folds 
appositive: folds 
PokerStarsMan12: calls 200
mnnm585: folds 
*** FLOP *** [7d Kd Ah]
PokerStarsMan12: checks 
color_singleton: bets 354
PokerStarsMan12: folds 
Uncalled bet (354) returned to color_singleton
color_singleton collected 709 from pot
color_singleton: doesn't show hand 
*** SUMMARY ***
Total pot 750 | Rake 41 
Board [7d Kd Ah]
Seat 1: color_singleton collected (709)
Seat 2: HighCardJasper (button) folded before Flop (didn't bet)
Seat 3: appositive (small blind) folded before Flop
Seat 4: PokerStarsMan12 (big blind) folded on the Flop
Seat 8: MaFak2019 folded before Flop (didn't bet)
Seat 9: mnnm585 folded before Flop



PokerStars Home Game Hand #227986517635: {DaPokaStars}  Hold'em No Limit (50/100) - 2021/07/01 17:49:39 ET
Table 'JULY 1' 9-max (Play Money) Seat #3 is the button
Seat 1: color_singleton (20157 in chips) 
Seat 2: HighCardJasper (11911 in chips) 
Seat 3: appositive (13232 in chips) 
Seat 4: PokerStarsMan12 (23728 in chips) 
Seat 8: MaFak2019 (13061 in chips) 
Seat 9: mnnm585 (15047 in chips) 
PokerStarsMan12: posts small blind 50
MaFak2019: posts big blind 100
*** HOLE CARDS ***
Dealt to PokerStarsMan12 [3s Kh]
mnnm585: folds 
color_singleton: raises 200 to 300
HighCardJasper: calls 300
appositive: calls 300
PokerStarsMan12: folds 
MaFak2019: folds 
*** FLOP *** [Kc 7c 5s]
color_singleton: checks 
HighCardJasper: checks 
appositive: checks 
*** TURN *** [Kc 7c 5s] [6d]
color_singleton: bets 496
HighCardJasper: calls 496
appositive: folds 
*** RIVER *** [Kc 7c 5s 6d] [Kd]
color_singleton: checks 
HighCardJasper: checks 
*** SHOW DOWN ***
color_singleton: shows [Qh Qc] (two pair, Kings and Queens)
HighCardJasper: mucks hand 
color_singleton collected 1930 from pot
*** SUMMARY ***
Total pot 2042 | Rake 112 
Board [Kc 7c 5s 6d Kd]
Seat 1: color_singleton showed [Qh Qc] and won (1930) with two pair, Kings and Queens
Seat 2: HighCardJasper mucked [Ts 8s]
Seat 3: appositive (button) folded on the Turn
Seat 4: PokerStarsMan12 (small blind) folded before Flop
Seat 8: MaFak2019 (big blind) folded before Flop
Seat 9: mnnm585 folded before Flop (didn't bet)



PokerStars Home Game Hand #227986537304: {DaPokaStars}  Hold'em No Limit (50/100) - 2021/07/01 17:50:26 ET
Table 'JULY 1' 9-max (Play Money) Seat #4 is the button
Seat 1: color_singleton (21291 in chips) 
Seat 2: HighCardJasper (11115 in chips) 
Seat 3: appositive (12932 in chips) 
Seat 4: PokerStarsMan12 (23678 in chips) 
Seat 8: MaFak2019 (12961 in chips) 
Seat 9: mnnm585 (15047 in chips) 
MaFak2019: posts small blind 50
mnnm585: posts big blind 100
*** HOLE CARDS ***
Dealt to PokerStarsMan12 [7d 2c]
color_singleton: raises 100 to 200
HighCardJasper: folds 
appositive: calls 200
PokerStarsMan12: folds 
MaFak2019: raises 700 to 900
mnnm585: folds 
color_singleton: folds 
appositive: folds 
Uncalled bet (700) returned to MaFak2019
MaFak2019 collected 700 from pot
MaFak2019: doesn't show hand 
*** SUMMARY ***
Total pot 700 | Rake 0 
Seat 1: color_singleton folded before Flop
Seat 2: HighCardJasper folded before Flop (didn't bet)
Seat 3: appositive folded before Flop
Seat 4: PokerStarsMan12 (button) folded before Flop (didn't bet)
Seat 8: MaFak2019 (small blind) collected (700)
Seat 9: mnnm585 (big blind) folded before Flop



PokerStars Home Game Hand #227986548093: {DaPokaStars}  Hold'em No Limit (50/100) - 2021/07/01 17:50:52 ET
Table 'JULY 1' 9-max (Play Money) Seat #8 is the button
Seat 1: color_singleton (21091 in chips) 
Seat 2: HighCardJasper (11115 in chips) 
Seat 3: appositive (12732 in chips) 
Seat 4: PokerStarsMan12 (23678 in chips) 
Seat 8: MaFak2019 (13461 in chips) 
Seat 9: mnnm585 (14947 in chips) 
mnnm585: posts small blind 50
color_singleton: posts big blind 100
*** HOLE CARDS ***
Dealt to PokerStarsMan12 [Ad As]
HighCardJasper: calls 100
appositive: folds 
PokerStarsMan12: raises 300 to 400
MaFak2019: calls 400
mnnm585: calls 350
color_singleton: folds 
HighCardJasper: folds 
*** FLOP *** [Kh Qc 4s]
mnnm585: checks 
PokerStarsMan12: bets 700
MaFak2019: raises 12361 to 13061 and is all-in
mnnm585: folds 
PokerStarsMan12: calls 12361
*** TURN *** [Kh Qc 4s] [2h]
*** RIVER *** [Kh Qc 4s 2h] [6s]
*** SHOW DOWN ***
PokerStarsMan12: shows [Ad As] (a pair of Aces)
MaFak2019: shows [Qh Kc] (two pair, Kings and Queens)
MaFak2019 collected 26008 from pot
*** SUMMARY ***
Total pot 27522 | Rake 1514 
Board [Kh Qc 4s 2h 6s]
Seat 1: color_singleton (big blind) folded before Flop
Seat 2: HighCardJasper folded before Flop
Seat 3: appositive folded before Flop (didn't bet)
Seat 4: PokerStarsMan12 showed [Ad As] and lost with a pair of Aces
Seat 8: MaFak2019 (button) showed [Qh Kc] and won (26008) with two pair, Kings and Queens
Seat 9: mnnm585 (small blind) folded on the Flop



PokerStars Home Game Hand #227986566255: {DaPokaStars}  Hold'em No Limit (50/100) - 2021/07/01 17:51:36 ET
Table 'JULY 1' 9-max (Play Money) Seat #9 is the button
Seat 1: color_singleton (20991 in chips) 
Seat 2: HighCardJasper (11015 in chips) 
Seat 3: appositive (12732 in chips) 
Seat 4: PokerStarsMan12 (10217 in chips) 
Seat 8: MaFak2019 (26008 in chips) 
Seat 9: mnnm585 (14547 in chips) 
color_singleton: posts small blind 50
HighCardJasper: posts big blind 100
*** HOLE CARDS ***
Dealt to PokerStarsMan12 [Qd Js]
appositive: calls 100
PokerStarsMan12: calls 100
MaFak2019: calls 100
mnnm585: folds 
color_singleton: raises 200 to 300
HighCardJasper: calls 200
appositive: calls 200
PokerStarsMan12: calls 200
MaFak2019: calls 200
*** FLOP *** [6c Kd 4h]
color_singleton: checks 
HighCardJasper: checks 
appositive: checks 
PokerStarsMan12: checks 
MaFak2019: checks 
*** TURN *** [6c Kd 4h] [Kc]
color_singleton: checks 
HighCardJasper: checks 
appositive: checks 
PokerStarsMan12: checks 
MaFak2019: checks 
*** RIVER *** [6c Kd 4h Kc] [4s]
color_singleton: checks 
HighCardJasper: checks 
appositive: checks 
PokerStarsMan12: checks 
MaFak2019: checks 
*** SHOW DOWN ***
color_singleton: shows [Ac Th] (two pair, Kings and Fours)
HighCardJasper: mucks hand 
appositive: mucks hand 
PokerStarsMan12: mucks hand 
MaFak2019: mucks hand 
color_singleton collected 1417 from pot
*** SUMMARY ***
Total pot 1500 | Rake 83 
Board [6c Kd 4h Kc 4s]
Seat 1: color_singleton (small blind) showed [Ac Th] and won (1417) with two pair, Kings and Fours
Seat 2: HighCardJasper (big blind) mucked [8d 5d]
Seat 3: appositive mucked [7s 8s]
Seat 4: PokerStarsMan12 mucked [Qd Js]
Seat 8: MaFak2019 mucked [5s 3h]
Seat 9: mnnm585 (button) folded before Flop (didn't bet)



PokerStars Home Game Hand #227986596671: {DaPokaStars}  Hold'em No Limit (50/100) - 2021/07/01 17:52:51 ET
Table 'JULY 1' 9-max (Play Money) Seat #1 is the button
Seat 1: color_singleton (22108 in chips) 
Seat 2: HighCardJasper (10715 in chips) 
Seat 3: appositive (12432 in chips) 
Seat 4: PokerStarsMan12 (9917 in chips) 
Seat 8: MaFak2019 (25708 in chips) 
Seat 9: mnnm585 (14547 in chips) 
HighCardJasper: posts small blind 50
appositive: posts big blind 100
*** HOLE CARDS ***
Dealt to PokerStarsMan12 [8s 8d]
PokerStarsMan12: raises 200 to 300
MaFak2019: calls 300
mnnm585: folds 
color_singleton: folds 
HighCardJasper: folds 
appositive: folds 
*** FLOP *** [Jd 3s 6s]
PokerStarsMan12: bets 400
MaFak2019: folds 
Uncalled bet (400) returned to PokerStarsMan12
PokerStarsMan12 collected 709 from pot
*** SUMMARY ***
Total pot 750 | Rake 41 
Board [Jd 3s 6s]
Seat 1: color_singleton (button) folded before Flop (didn't bet)
Seat 2: HighCardJasper (small blind) folded before Flop
Seat 3: appositive (big blind) folded before Flop
Seat 4: PokerStarsMan12 collected (709)
Seat 8: MaFak2019 folded on the Flop
Seat 9: mnnm585 folded before Flop (didn't bet)



PokerStars Home Game Hand #227986614031: {DaPokaStars}  Hold'em No Limit (50/100) - 2021/07/01 17:53:34 ET
Table 'JULY 1' 9-max (Play Money) Seat #2 is the button
Seat 1: color_singleton (22108 in chips) 
Seat 2: HighCardJasper (10665 in chips) 
Seat 3: appositive (12332 in chips) 
Seat 4: PokerStarsMan12 (10326 in chips) 
Seat 8: MaFak2019 (25408 in chips) 
Seat 9: mnnm585 (14547 in chips) 
appositive: posts small blind 50
PokerStarsMan12: posts big blind 100
*** HOLE CARDS ***
Dealt to PokerStarsMan12 [Th As]
MaFak2019: folds 
mnnm585: folds 
color_singleton: folds 
HighCardJasper: raises 100 to 200
appositive: calls 150
PokerStarsMan12: calls 100
*** FLOP *** [Tc 9s 8h]
appositive: checks 
PokerStarsMan12: bets 300
HighCardJasper: folds 
appositive: calls 300
*** TURN *** [Tc 9s 8h] [6s]
appositive: checks 
PokerStarsMan12: bets 700
appositive: calls 700
*** RIVER *** [Tc 9s 8h 6s] [Jc]
appositive: bets 1228
PokerStarsMan12: folds 
Uncalled bet (1228) returned to appositive
appositive collected 2457 from pot
appositive: doesn't show hand 
*** SUMMARY ***
Total pot 2600 | Rake 143 
Board [Tc 9s 8h 6s Jc]
Seat 1: color_singleton folded before Flop (didn't bet)
Seat 2: HighCardJasper (button) folded on the Flop
Seat 3: appositive (small blind) collected (2457)
Seat 4: PokerStarsMan12 (big blind) folded on the River
Seat 8: MaFak2019 folded before Flop (didn't bet)
Seat 9: mnnm585 folded before Flop (didn't bet)



PokerStars Home Game Hand #227986637059: {DaPokaStars}  Hold'em No Limit (50/100) - 2021/07/01 17:54:30 ET
Table 'JULY 1' 9-max (Play Money) Seat #3 is the button
Seat 1: color_singleton (22108 in chips) 
Seat 2: HighCardJasper (10465 in chips) 
Seat 3: appositive (13589 in chips) 
Seat 4: PokerStarsMan12 (9126 in chips) 
Seat 8: MaFak2019 (25408 in chips) 
Seat 9: mnnm585 (14547 in chips) 
PokerStarsMan12: posts small blind 50
MaFak2019: posts big blind 100
*** HOLE CARDS ***
Dealt to PokerStarsMan12 [Qc Jc]
mnnm585: folds 
color_singleton: calls 100
HighCardJasper: calls 100
appositive: calls 100
PokerStarsMan12: raises 300 to 400
MaFak2019: calls 300
color_singleton: calls 300
HighCardJasper: folds 
appositive: calls 300
*** FLOP *** [4d 9d Ks]
PokerStarsMan12: checks 
MaFak2019: bets 1606
color_singleton: folds 
appositive: folds 
PokerStarsMan12: folds 
Uncalled bet (1606) returned to MaFak2019
MaFak2019 collected 1606 from pot
MaFak2019: doesn't show hand 
*** SUMMARY ***
Total pot 1700 | Rake 94 
Board [4d 9d Ks]
Seat 1: color_singleton folded on the Flop
Seat 2: HighCardJasper folded before Flop
Seat 3: appositive (button) folded on the Flop
Seat 4: PokerStarsMan12 (small blind) folded on the Flop
Seat 8: MaFak2019 (big blind) collected (1606)
Seat 9: mnnm585 folded before Flop (didn't bet)



PokerStars Home Game Hand #227986660002: {DaPokaStars}  Hold'em No Limit (50/100) - 2021/07/01 17:55:20 ET
Table 'JULY 1' 9-max (Play Money) Seat #4 is the button
Seat 1: color_singleton (21708 in chips) 
Seat 2: HighCardJasper (10365 in chips) 
Seat 3: appositive (13189 in chips) 
Seat 4: PokerStarsMan12 (8726 in chips) 
Seat 8: MaFak2019 (26614 in chips) 
Seat 9: mnnm585 (14547 in chips) 
MaFak2019: posts small blind 50
mnnm585: posts big blind 100
*** HOLE CARDS ***
Dealt to PokerStarsMan12 [3h 5c]
color_singleton: raises 200 to 300
HighCardJasper: folds 
appositive: folds 
PokerStarsMan12: folds 
MaFak2019: calls 250
mnnm585: folds 
*** FLOP *** [Jc 8s 5h]
MaFak2019: checks 
color_singleton: bets 330
MaFak2019: calls 330
*** TURN *** [Jc 8s 5h] [8d]
MaFak2019: checks 
color_singleton: bets 642
MaFak2019: calls 642
*** RIVER *** [Jc 8s 5h 8d] [Kd]
MaFak2019: checks 
color_singleton: checks 
*** SHOW DOWN ***
MaFak2019: shows [3s 5d] (two pair, Eights and Fives)
color_singleton: shows [Jd Ac] (two pair, Jacks and Eights)
color_singleton collected 2499 from pot
*** SUMMARY ***
Total pot 2644 | Rake 145 
Board [Jc 8s 5h 8d Kd]
Seat 1: color_singleton showed [Jd Ac] and won (2499) with two pair, Jacks and Eights
Seat 2: HighCardJasper folded before Flop (didn't bet)
Seat 3: appositive folded before Flop (didn't bet)
Seat 4: PokerStarsMan12 (button) folded before Flop (didn't bet)
Seat 8: MaFak2019 (small blind) showed [3s 5d] and lost with two pair, Eights and Fives
Seat 9: mnnm585 (big blind) folded before Flop



PokerStars Home Game Hand #227986669245: {DaPokaStars}  Hold'em No Limit (50/100) - 2021/07/01 17:55:50 ET
Table 'JULY 1' 9-max (Play Money) Seat #8 is the button
Seat 1: color_singleton (22935 in chips) 
Seat 2: HighCardJasper (10365 in chips) 
Seat 3: appositive (13189 in chips) 
Seat 4: PokerStarsMan12 (8726 in chips) 
Seat 8: MaFak2019 (25342 in chips) 
Seat 9: mnnm585 (14447 in chips) 
mnnm585: posts small blind 50
color_singleton: posts big blind 100
*** HOLE CARDS ***
Dealt to PokerStarsMan12 [3d 3h]
HighCardJasper: calls 100
appositive: calls 100
PokerStarsMan12: calls 100
MaFak2019: raises 550 to 650
mnnm585: calls 600
color_singleton: calls 550
HighCardJasper: folds 
appositive: folds 
PokerStarsMan12: calls 550
*** FLOP *** [2h Td 5h]
mnnm585: checks 
color_singleton: checks 
PokerStarsMan12: bets 1000
MaFak2019: calls 1000
mnnm585: folds 
color_singleton: folds 
*** TURN *** [2h Td 5h] [Qh]
PokerStarsMan12: checks 
MaFak2019: checks 
*** RIVER *** [2h Td 5h Qh] [7d]
PokerStarsMan12: bets 2300
MaFak2019: folds 
Uncalled bet (2300) returned to PokerStarsMan12
PokerStarsMan12 collected 4536 from pot
*** SUMMARY ***
Total pot 4800 | Rake 264 
Board [2h Td 5h Qh 7d]
Seat 1: color_singleton (big blind) folded on the Flop
Seat 2: HighCardJasper folded before Flop
Seat 3: appositive folded before Flop
Seat 4: PokerStarsMan12 collected (4536)
Seat 8: MaFak2019 (button) folded on the River
Seat 9: mnnm585 (small blind) folded on the Flop



PokerStars Home Game Hand #227986687868: {DaPokaStars}  Hold'em No Limit (50/100) - 2021/07/01 17:56:51 ET
Table 'JULY 1' 9-max (Play Money) Seat #9 is the button
Seat 1: color_singleton (22285 in chips) 
Seat 2: HighCardJasper (10265 in chips) 
Seat 3: appositive (13089 in chips) 
Seat 4: PokerStarsMan12 (11612 in chips) 
Seat 8: MaFak2019 (23692 in chips) 
Seat 9: mnnm585 (13797 in chips) 
color_singleton: posts small blind 50
HighCardJasper: posts big blind 100
*** HOLE CARDS ***
Dealt to PokerStarsMan12 [7c 7h]
appositive: calls 100
PokerStarsMan12: calls 100
MaFak2019: raises 450 to 550
mnnm585: folds 
color_singleton: calls 500
HighCardJasper: folds 
appositive: calls 450
PokerStarsMan12: calls 450
*** FLOP *** [4s 2s Th]
color_singleton: checks 
appositive: checks 
PokerStarsMan12: bets 1000
MaFak2019: folds 
color_singleton: calls 1000
appositive: calls 1000
*** TURN *** [4s 2s Th] [8s]
color_singleton: checks 
appositive: checks 
PokerStarsMan12: checks 
*** RIVER *** [4s 2s Th 8s] [4c]
color_singleton: checks 
appositive: bets 2504
PokerStarsMan12: folds 
color_singleton: folds 
Uncalled bet (2504) returned to appositive
appositive collected 5008 from pot
appositive: doesn't show hand 
*** SUMMARY ***
Total pot 5300 | Rake 292 
Board [4s 2s Th 8s 4c]
Seat 1: color_singleton (small blind) folded on the River
Seat 2: HighCardJasper (big blind) folded before Flop
Seat 3: appositive collected (5008)
Seat 4: PokerStarsMan12 folded on the River
Seat 8: MaFak2019 folded on the Flop
Seat 9: mnnm585 (button) folded before Flop (didn't bet)



PokerStars Home Game Hand #227986707432: {DaPokaStars}  Hold'em No Limit (50/100) - 2021/07/01 17:57:54 ET
Table 'JULY 1' 9-max (Play Money) Seat #1 is the button
Seat 1: color_singleton (20735 in chips) 
Seat 2: HighCardJasper (10165 in chips) 
Seat 3: appositive (16547 in chips) 
Seat 4: PokerStarsMan12 (10062 in chips) 
Seat 8: MaFak2019 (23142 in chips) 
Seat 9: mnnm585 (13797 in chips) 
HighCardJasper: posts small blind 50
appositive: posts big blind 100
*** HOLE CARDS ***
Dealt to PokerStarsMan12 [4s As]
PokerStarsMan12: raises 200 to 300
MaFak2019: folds 
mnnm585: folds 
color_singleton: folds 
HighCardJasper: calls 250
appositive: folds 
*** FLOP *** [Jc 2d Js]
HighCardJasper: checks 
PokerStarsMan12: checks 
*** TURN *** [Jc 2d Js] [Kc]
HighCardJasper: checks 
PokerStarsMan12: checks 
*** RIVER *** [Jc 2d Js Kc] [Qs]
HighCardJasper: bets 330
PokerStarsMan12: calls 330
*** SHOW DOWN ***
HighCardJasper: shows [6s Th] (a pair of Jacks)
PokerStarsMan12: shows [4s As] (a pair of Jacks - Ace kicker)
PokerStarsMan12 collected 1285 from pot
*** SUMMARY ***
Total pot 1360 | Rake 75 
Board [Jc 2d Js Kc Qs]
Seat 1: color_singleton (button) folded before Flop (didn't bet)
Seat 2: HighCardJasper (small blind) showed [6s Th] and lost with a pair of Jacks
Seat 3: appositive (big blind) folded before Flop
Seat 4: PokerStarsMan12 showed [4s As] and won (1285) with a pair of Jacks
Seat 8: MaFak2019 folded before Flop (didn't bet)
Seat 9: mnnm585 folded before Flop (didn't bet)



PokerStars Home Game Hand #227986715603: {DaPokaStars}  Hold'em No Limit (50/100) - 2021/07/01 17:58:21 ET
Table 'JULY 1' 9-max (Play Money) Seat #2 is the button
Seat 1: color_singleton (20735 in chips) 
Seat 2: HighCardJasper (9535 in chips) 
Seat 3: appositive (16447 in chips) 
Seat 4: PokerStarsMan12 (10717 in chips) 
Seat 8: MaFak2019 (23142 in chips) 
Seat 9: mnnm585 (13797 in chips) 
appositive: posts small blind 50
PokerStarsMan12: posts big blind 100
*** HOLE CARDS ***
Dealt to PokerStarsMan12 [9d 3s]
MaFak2019: folds 
mnnm585: calls 100
color_singleton: folds 
HighCardJasper: raises 100 to 200
appositive: calls 150
PokerStarsMan12: calls 100
mnnm585: calls 100
*** FLOP *** [6c Ks 9h]
appositive: checks 
PokerStarsMan12: checks 
mnnm585: checks 
HighCardJasper: bets 378
appositive: folds 
PokerStarsMan12: calls 378
mnnm585: calls 378
*** TURN *** [6c Ks 9h] [8c]
PokerStarsMan12: checks 
mnnm585: checks 
HighCardJasper: bets 914
PokerStarsMan12: folds 
mnnm585: calls 914
*** RIVER *** [6c Ks 9h 8c] [Td]
mnnm585: checks 
HighCardJasper: checks 
*** SHOW DOWN ***
mnnm585: shows [Ad Qh] (high card Ace)
HighCardJasper: shows [Kc Jd] (a pair of Kings)
HighCardJasper collected 3555 from pot
*** SUMMARY ***
Total pot 3762 | Rake 207 
Board [6c Ks 9h 8c Td]
Seat 1: color_singleton folded before Flop (didn't bet)
Seat 2: HighCardJasper (button) showed [Kc Jd] and won (3555) with a pair of Kings
Seat 3: appositive (small blind) folded on the Flop
Seat 4: PokerStarsMan12 (big blind) folded on the Turn
Seat 8: MaFak2019 folded before Flop (didn't bet)
Seat 9: mnnm585 showed [Ad Qh] and lost with high card Ace



PokerStars Home Game Hand #227986735037: {DaPokaStars}  Hold'em No Limit (50/100) - 2021/07/01 17:59:23 ET
Table 'JULY 1' 9-max (Play Money) Seat #4 is the button
Seat 1: color_singleton (20735 in chips) 
Seat 2: HighCardJasper (11598 in chips) 
Seat 4: PokerStarsMan12 (10139 in chips) 
Seat 8: MaFak2019 (23142 in chips) 
Seat 9: mnnm585 (12305 in chips) 
MaFak2019: posts small blind 50
mnnm585: posts big blind 100
*** HOLE CARDS ***
Dealt to PokerStarsMan12 [Ac 6d]
color_singleton: raises 200 to 300
HighCardJasper: calls 300
PokerStarsMan12: calls 300
MaFak2019: folds 
mnnm585: calls 200
*** FLOP *** [4c 2s 4h]
mnnm585: checks 
color_singleton: checks 
HighCardJasper: checks 
PokerStarsMan12: checks 
*** TURN *** [4c 2s 4h] [7d]
mnnm585: bets 590
color_singleton: folds 
HighCardJasper: folds 
PokerStarsMan12: folds 
Uncalled bet (590) returned to mnnm585
mnnm585 collected 1181 from pot
*** SUMMARY ***
Total pot 1250 | Rake 69 
Board [4c 2s 4h 7d]
Seat 1: color_singleton folded on the Turn
Seat 2: HighCardJasper folded on the Turn
Seat 4: PokerStarsMan12 (button) folded on the Turn
Seat 8: MaFak2019 (small blind) folded before Flop
Seat 9: mnnm585 (big blind) collected (1181)



PokerStars Home Game Hand #227986751959: {DaPokaStars}  Hold'em No Limit (50/100) - 2021/07/01 18:00:17 ET
Table 'JULY 1' 9-max (Play Money) Seat #8 is the button
Seat 1: color_singleton (20435 in chips) 
Seat 2: HighCardJasper (11298 in chips) 
Seat 4: PokerStarsMan12 (9839 in chips) 
Seat 8: MaFak2019 (23092 in chips) 
Seat 9: mnnm585 (13186 in chips) 
mnnm585: posts small blind 50
color_singleton: posts big blind 100
*** HOLE CARDS ***
Dealt to PokerStarsMan12 [3d Js]
HighCardJasper: calls 100
PokerStarsMan12: folds 
MaFak2019: raises 350 to 450
mnnm585: calls 400
color_singleton: folds 
HighCardJasper: folds 
*** FLOP *** [Kd 7h 4s]
mnnm585: checks 
MaFak2019: checks 
*** TURN *** [Kd 7h 4s] [Qs]
mnnm585: bets 519
MaFak2019: folds 
Uncalled bet (519) returned to mnnm585
mnnm585 collected 1039 from pot
*** SUMMARY ***
Total pot 1100 | Rake 61 
Board [Kd 7h 4s Qs]
Seat 1: color_singleton (big blind) folded before Flop
Seat 2: HighCardJasper folded before Flop
Seat 4: PokerStarsMan12 folded before Flop (didn't bet)
Seat 8: MaFak2019 (button) folded on the Turn
Seat 9: mnnm585 (small blind) collected (1039)



PokerStars Home Game Hand #227986761794: {DaPokaStars}  Hold'em No Limit (50/100) - 2021/07/01 18:00:47 ET
Table 'JULY 1' 9-max (Play Money) Seat #9 is the button
Seat 1: color_singleton (20335 in chips) 
Seat 2: HighCardJasper (11198 in chips) 
Seat 4: PokerStarsMan12 (9839 in chips) 
Seat 8: MaFak2019 (22642 in chips) 
Seat 9: mnnm585 (13775 in chips) 
color_singleton: posts small blind 50
HighCardJasper: posts big blind 100
*** HOLE CARDS ***
Dealt to PokerStarsMan12 [Th 4s]
PokerStarsMan12: folds 
MaFak2019: raises 250 to 350
mnnm585: calls 350
color_singleton: calls 300
HighCardJasper: calls 250
*** FLOP *** [Td 6d 4h]
color_singleton: bets 661
HighCardJasper: folds 
MaFak2019: folds 
mnnm585: folds 
Uncalled bet (661) returned to color_singleton
color_singleton collected 1323 from pot
color_singleton: doesn't show hand 
*** SUMMARY ***
Total pot 1400 | Rake 77 
Board [Td 6d 4h]
Seat 1: color_singleton (small blind) collected (1323)
Seat 2: HighCardJasper (big blind) folded on the Flop
Seat 4: PokerStarsMan12 folded before Flop (didn't bet)
Seat 8: MaFak2019 folded on the Flop
Seat 9: mnnm585 (button) folded on the Flop



PokerStars Home Game Hand #227986771360: {DaPokaStars}  Hold'em No Limit (50/100) - 2021/07/01 18:01:15 ET
Table 'JULY 1' 9-max (Play Money) Seat #1 is the button
Seat 1: color_singleton (21308 in chips) 
Seat 2: HighCardJasper (10848 in chips) 
Seat 4: PokerStarsMan12 (9839 in chips) 
Seat 8: MaFak2019 (22292 in chips) 
Seat 9: mnnm585 (13425 in chips) 
HighCardJasper: posts small blind 50
PokerStarsMan12: posts big blind 100
*** HOLE CARDS ***
Dealt to PokerStarsMan12 [Jd 3c]
MaFak2019: folds 
mnnm585: folds 
color_singleton: raises 200 to 300
HighCardJasper: folds 
PokerStarsMan12: calls 200
*** FLOP *** [8h 4c Js]
PokerStarsMan12: bets 400
color_singleton: folds 
Uncalled bet (400) returned to PokerStarsMan12
PokerStarsMan12 collected 614 from pot
*** SUMMARY ***
Total pot 650 | Rake 36 
Board [8h 4c Js]
Seat 1: color_singleton (button) folded on the Flop
Seat 2: HighCardJasper (small blind) folded before Flop
Seat 4: PokerStarsMan12 (big blind) collected (614)
Seat 8: MaFak2019 folded before Flop (didn't bet)
Seat 9: mnnm585 folded before Flop (didn't bet)



PokerStars Home Game Hand #227986779975: {DaPokaStars}  Hold'em No Limit (50/100) - 2021/07/01 18:01:38 ET
Table 'JULY 1' 9-max (Play Money) Seat #2 is the button
Seat 1: color_singleton (21008 in chips) 
Seat 2: HighCardJasper (10798 in chips) 
Seat 4: PokerStarsMan12 (10153 in chips) 
Seat 8: MaFak2019 (22292 in chips) 
Seat 9: mnnm585 (13425 in chips) 
PokerStarsMan12: posts small blind 50
MaFak2019: posts big blind 100
*** HOLE CARDS ***
Dealt to PokerStarsMan12 [7d Jh]
mnnm585: folds 
color_singleton: folds 
HighCardJasper: raises 100 to 200
PokerStarsMan12: calls 150
MaFak2019: calls 100
*** FLOP *** [Ac Ts Kh]
PokerStarsMan12: checks 
MaFak2019: checks 
HighCardJasper: bets 283
PokerStarsMan12: folds 
MaFak2019: folds 
Uncalled bet (283) returned to HighCardJasper
HighCardJasper collected 567 from pot
HighCardJasper: doesn't show hand 
*** SUMMARY ***
Total pot 600 | Rake 33 
Board [Ac Ts Kh]
Seat 1: color_singleton folded before Flop (didn't bet)
Seat 2: HighCardJasper (button) collected (567)
Seat 4: PokerStarsMan12 (small blind) folded on the Flop
Seat 8: MaFak2019 (big blind) folded on the Flop
Seat 9: mnnm585 folded before Flop (didn't bet)



PokerStars Home Game Hand #227986789324: {DaPokaStars}  Hold'em No Limit (50/100) - 2021/07/01 18:02:03 ET
Table 'JULY 1' 9-max (Play Money) Seat #4 is the button
Seat 1: color_singleton (21008 in chips) 
Seat 2: HighCardJasper (11165 in chips) 
Seat 4: PokerStarsMan12 (9953 in chips) 
Seat 8: MaFak2019 (22092 in chips) 
Seat 9: mnnm585 (13425 in chips) 
MaFak2019: posts small blind 50
mnnm585: posts big blind 100
*** HOLE CARDS ***
Dealt to PokerStarsMan12 [9s 7c]
color_singleton: folds 
HighCardJasper: calls 100
PokerStarsMan12: calls 100
MaFak2019: folds 
mnnm585: checks 
*** FLOP *** [5c Ah 7s]
mnnm585: checks 
HighCardJasper: checks 
PokerStarsMan12: checks 
*** TURN *** [5c Ah 7s] [8s]
mnnm585: checks 
HighCardJasper: bets 165
PokerStarsMan12: calls 165
mnnm585: calls 165
*** RIVER *** [5c Ah 7s 8s] [Jc]
mnnm585: checks 
HighCardJasper: bets 399
PokerStarsMan12: folds 
mnnm585: folds 
Uncalled bet (399) returned to HighCardJasper
HighCardJasper collected 799 from pot
HighCardJasper: doesn't show hand 
*** SUMMARY ***
Total pot 845 | Rake 46 
Board [5c Ah 7s 8s Jc]
Seat 1: color_singleton folded before Flop (didn't bet)
Seat 2: HighCardJasper collected (799)
Seat 4: PokerStarsMan12 (button) folded on the River
Seat 8: MaFak2019 (small blind) folded before Flop
Seat 9: mnnm585 (big blind) folded on the River



PokerStars Home Game Hand #227986810274: {DaPokaStars}  Hold'em No Limit (50/100) - 2021/07/01 18:02:57 ET
Table 'JULY 1' 9-max (Play Money) Seat #8 is the button
Seat 1: color_singleton (21008 in chips) 
Seat 2: HighCardJasper (11699 in chips) 
Seat 3: appositive (16247 in chips) 
Seat 4: PokerStarsMan12 (9688 in chips) 
Seat 8: MaFak2019 (22042 in chips) 
Seat 9: mnnm585 (13160 in chips) 
mnnm585: posts small blind 50
color_singleton: posts big blind 100
appositive: posts small & big blinds 150
*** HOLE CARDS ***
Dealt to PokerStarsMan12 [9s Qh]
HighCardJasper: calls 100
appositive: checks 
PokerStarsMan12: calls 100
MaFak2019: calls 100
mnnm585: calls 50
color_singleton: checks 
*** FLOP *** [Qs 2h 4h]
mnnm585: checks 
color_singleton: checks 
HighCardJasper: checks 
appositive: checks 
PokerStarsMan12: bets 500
MaFak2019: folds 
mnnm585: calls 500
color_singleton: folds 
HighCardJasper: folds 
appositive: folds 
*** TURN *** [Qs 2h 4h] [5h]
mnnm585: bets 779
PokerStarsMan12: calls 779
*** RIVER *** [Qs 2h 4h 5h] [Ad]
mnnm585: checks 
PokerStarsMan12: bets 1700
mnnm585: folds 
Uncalled bet (1700) returned to PokerStarsMan12
PokerStarsMan12 collected 3032 from pot
*** SUMMARY ***
Total pot 3208 | Rake 176 
Board [Qs 2h 4h 5h Ad]
Seat 1: color_singleton (big blind) folded on the Flop
Seat 2: HighCardJasper folded on the Flop
Seat 3: appositive folded on the Flop (didn't bet)
Seat 4: PokerStarsMan12 collected (3032)
Seat 8: MaFak2019 (button) folded on the Flop
Seat 9: mnnm585 (small blind) folded on the River



PokerStars Home Game Hand #227986846351: {DaPokaStars}  Hold'em No Limit (50/100) - 2021/07/01 18:04:26 ET
Table 'JULY 1' 9-max (Play Money) Seat #9 is the button
Seat 1: color_singleton (20908 in chips) 
Seat 2: HighCardJasper (11599 in chips) 
Seat 3: appositive (16097 in chips) 
Seat 4: PokerStarsMan12 (11341 in chips) 
Seat 8: MaFak2019 (21942 in chips) 
Seat 9: mnnm585 (11781 in chips) 
color_singleton: posts small blind 50
HighCardJasper: posts big blind 100
*** HOLE CARDS ***
Dealt to PokerStarsMan12 [6h Ks]
appositive: folds 
PokerStarsMan12: calls 100
MaFak2019: calls 100
mnnm585: calls 100
color_singleton: calls 50
HighCardJasper: checks 
*** FLOP *** [6c 3d Qh]
color_singleton: bets 236
HighCardJasper: calls 236
PokerStarsMan12: calls 236
MaFak2019: folds 
mnnm585: folds 
*** TURN *** [6c 3d Qh] [5c]
color_singleton: bets 571
HighCardJasper: folds 
PokerStarsMan12: calls 571
*** RIVER *** [6c 3d Qh 5c] [4c]
color_singleton: bets 1110
PokerStarsMan12: folds 
Uncalled bet (1110) returned to color_singleton
color_singleton collected 2221 from pot
color_singleton: doesn't show hand 
*** SUMMARY ***
Total pot 2350 | Rake 129 
Board [6c 3d Qh 5c 4c]
Seat 1: color_singleton (small blind) collected (2221)
Seat 2: HighCardJasper (big blind) folded on the Turn
Seat 3: appositive folded before Flop (didn't bet)
Seat 4: PokerStarsMan12 folded on the River
Seat 8: MaFak2019 folded on the Flop
Seat 9: mnnm585 (button) folded on the Flop



PokerStars Home Game Hand #227986864263: {DaPokaStars}  Hold'em No Limit (50/100) - 2021/07/01 18:05:12 ET
Table 'JULY 1' 9-max (Play Money) Seat #1 is the button
Seat 1: color_singleton (22222 in chips) 
Seat 2: HighCardJasper (11263 in chips) 
Seat 3: appositive (16097 in chips) 
Seat 4: PokerStarsMan12 (10434 in chips) 
Seat 8: MaFak2019 (21842 in chips) 
Seat 9: mnnm585 (11681 in chips) 
HighCardJasper: posts small blind 50
appositive: posts big blind 100
*** HOLE CARDS ***
Dealt to PokerStarsMan12 [Js Ks]
PokerStarsMan12: raises 300 to 400
MaFak2019: folds 
mnnm585: folds 
color_singleton: folds 
HighCardJasper: calls 350
appositive: calls 300
*** FLOP *** [Th Qh Qc]
HighCardJasper: checks 
appositive: checks 
PokerStarsMan12: bets 700
HighCardJasper: calls 700
appositive: calls 700
*** TURN *** [Th Qh Qc] [Kc]
HighCardJasper: checks 
appositive: checks 
PokerStarsMan12: checks 
*** RIVER *** [Th Qh Qc Kc] [7s]
HighCardJasper: bets 1559
appositive: folds 
PokerStarsMan12: calls 1559
*** SHOW DOWN ***
HighCardJasper: shows [As Ad] (two pair, Aces and Queens)
PokerStarsMan12: mucks hand 
HighCardJasper collected 6065 from pot
*** SUMMARY ***
Total pot 6418 | Rake 353 
Board [Th Qh Qc Kc 7s]
Seat 1: color_singleton (button) folded before Flop (didn't bet)
Seat 2: HighCardJasper (small blind) showed [As Ad] and won (6065) with two pair, Aces and Queens
Seat 3: appositive (big blind) folded on the River
Seat 4: PokerStarsMan12 mucked [Js Ks]
Seat 8: MaFak2019 folded before Flop (didn't bet)
Seat 9: mnnm585 folded before Flop (didn't bet)



