PokerStars Home Game Hand #228488338982: {DaPokaStars}  Hold'em No Limit (50/100) - 2021/07/22 15:29:25 ET
Table 'Halleria II' 9-max (Play Money) Seat #1 is the button
Seat 1: color_singleton (10000 in chips) 
Seat 2: JeBoyDirk (10000 in chips) 
Seat 9: PokerStarsMan12 (10000 in chips) 
JeBoyDirk: posts small blind 50
PokerStarsMan12: posts big blind 100
*** HOLE CARDS ***
Dealt to PokerStarsMan12 [6h Ac]
color_singleton: raises 200 to 300
JeBoyDirk: calls 250
PokerStarsMan12: calls 200
*** FLOP *** [2s 7h Ks]
JeBoyDirk: checks 
PokerStarsMan12: checks 
color_singleton: bets 425
JeBoyDirk: folds 
PokerStarsMan12: folds 
Uncalled bet (425) returned to color_singleton
color_singleton collected 850 from pot
color_singleton: doesn't show hand 
*** SUMMARY ***
Total pot 900 | Rake 50 
Board [2s 7h Ks]
Seat 1: color_singleton (button) collected (850)
Seat 2: JeBoyDirk (small blind) folded on the Flop
Seat 9: PokerStarsMan12 (big blind) folded on the Flop



PokerStars Home Game Hand #228488353141: {DaPokaStars}  Hold'em No Limit (50/100) - 2021/07/22 15:29:55 ET
Table 'Halleria II' 9-max (Play Money) Seat #2 is the button
Seat 1: color_singleton (10550 in chips) 
Seat 2: JeBoyDirk (9700 in chips) 
Seat 9: PokerStarsMan12 (9700 in chips) 
PokerStarsMan12: posts small blind 50
color_singleton: posts big blind 100
*** HOLE CARDS ***
Dealt to PokerStarsMan12 [Qc 3d]
JeBoyDirk: calls 100
PokerStarsMan12: calls 50
color_singleton: checks 
*** FLOP *** [Tc 7d 8d]
PokerStarsMan12: checks 
color_singleton: bets 141
JeBoyDirk: raises 141 to 282
PokerStarsMan12: folds 
color_singleton: calls 141
*** TURN *** [Tc 7d 8d] [4s]
color_singleton: checks 
JeBoyDirk: bets 400
color_singleton: folds 
Uncalled bet (400) returned to JeBoyDirk
JeBoyDirk collected 816 from pot
*** SUMMARY ***
Total pot 864 | Rake 48 
Board [Tc 7d 8d 4s]
Seat 1: color_singleton (big blind) folded on the Turn
Seat 2: JeBoyDirk (button) collected (816)
Seat 9: PokerStarsMan12 (small blind) folded on the Flop



PokerStars Home Game Hand #228488374663: {DaPokaStars}  Hold'em No Limit (50/100) - 2021/07/22 15:30:29 ET
Table 'Halleria II' 9-max (Play Money) Seat #9 is the button
Seat 1: color_singleton (10168 in chips) 
Seat 2: JeBoyDirk (10134 in chips) 
Seat 9: PokerStarsMan12 (9600 in chips) 
color_singleton: posts small blind 50
JeBoyDirk: posts big blind 100
*** HOLE CARDS ***
Dealt to PokerStarsMan12 [Jd Th]
PokerStarsMan12: raises 200 to 300
color_singleton: calls 250
JeBoyDirk: folds 
*** FLOP *** [4h 5s 2c]
color_singleton: bets 661
PokerStarsMan12: folds 
Uncalled bet (661) returned to color_singleton
color_singleton collected 661 from pot
color_singleton: doesn't show hand 
*** SUMMARY ***
Total pot 700 | Rake 39 
Board [4h 5s 2c]
Seat 1: color_singleton (small blind) collected (661)
Seat 2: JeBoyDirk (big blind) folded before Flop
Seat 9: PokerStarsMan12 (button) folded on the Flop



PokerStars Home Game Hand #228488380822: {DaPokaStars}  Hold'em No Limit (50/100) - 2021/07/22 15:30:42 ET
Table 'Halleria II' 9-max (Play Money) Seat #1 is the button
Seat 1: color_singleton (10529 in chips) 
Seat 2: JeBoyDirk (10034 in chips) 
Seat 9: PokerStarsMan12 (9300 in chips) 
JeBoyDirk: posts small blind 50
PokerStarsMan12: posts big blind 100
*** HOLE CARDS ***
Dealt to PokerStarsMan12 [2d 4s]
color_singleton: folds 
JeBoyDirk: folds 
Uncalled bet (50) returned to PokerStarsMan12
PokerStarsMan12 collected 100 from pot
*** SUMMARY ***
Total pot 100 | Rake 0 
Seat 1: color_singleton (button) folded before Flop (didn't bet)
Seat 2: JeBoyDirk (small blind) folded before Flop
Seat 9: PokerStarsMan12 (big blind) collected (100)



PokerStars Home Game Hand #228488383523: {DaPokaStars}  Hold'em No Limit (50/100) - 2021/07/22 15:30:47 ET
Table 'Halleria II' 9-max (Play Money) Seat #2 is the button
Seat 1: color_singleton (10529 in chips) 
Seat 2: JeBoyDirk (9984 in chips) 
Seat 9: PokerStarsMan12 (9350 in chips) 
PokerStarsMan12: posts small blind 50
color_singleton: posts big blind 100
*** HOLE CARDS ***
Dealt to PokerStarsMan12 [Th 6s]
JeBoyDirk: folds 
PokerStarsMan12: calls 50
color_singleton: checks 
*** FLOP *** [4d 4h 6c]
PokerStarsMan12: bets 200
color_singleton: folds 
Uncalled bet (200) returned to PokerStarsMan12
PokerStarsMan12 collected 189 from pot
*** SUMMARY ***
Total pot 200 | Rake 11 
Board [4d 4h 6c]
Seat 1: color_singleton (big blind) folded on the Flop
Seat 2: JeBoyDirk (button) folded before Flop (didn't bet)
Seat 9: PokerStarsMan12 (small blind) collected (189)



PokerStars Home Game Hand #228488392996: {DaPokaStars}  Hold'em No Limit (50/100) - 2021/07/22 15:31:07 ET
Table 'Halleria II' 9-max (Play Money) Seat #9 is the button
Seat 1: color_singleton (10429 in chips) 
Seat 2: JeBoyDirk (9984 in chips) 
Seat 9: PokerStarsMan12 (9439 in chips) 
color_singleton: posts small blind 50
JeBoyDirk: posts big blind 100
*** HOLE CARDS ***
Dealt to PokerStarsMan12 [5d 8c]
PokerStarsMan12: raises 200 to 300
color_singleton: folds 
JeBoyDirk: raises 200 to 500
PokerStarsMan12: calls 200
*** FLOP *** [Kc 4c 8h]
JeBoyDirk: checks 
PokerStarsMan12: bets 500
JeBoyDirk: raises 500 to 1000
PokerStarsMan12: calls 500
*** TURN *** [Kc 4c 8h] [2d]
JeBoyDirk: bets 1800
PokerStarsMan12: folds 
Uncalled bet (1800) returned to JeBoyDirk
JeBoyDirk collected 2882 from pot
*** SUMMARY ***
Total pot 3050 | Rake 168 
Board [Kc 4c 8h 2d]
Seat 1: color_singleton (small blind) folded before Flop
Seat 2: JeBoyDirk (big blind) collected (2882)
Seat 9: PokerStarsMan12 (button) folded on the Turn



PokerStars Home Game Hand #228488413228: {DaPokaStars}  Hold'em No Limit (50/100) - 2021/07/22 15:31:50 ET
Table 'Halleria II' 9-max (Play Money) Seat #1 is the button
Seat 1: color_singleton (10379 in chips) 
Seat 2: JeBoyDirk (11366 in chips) 
Seat 9: PokerStarsMan12 (7939 in chips) 
JeBoyDirk: posts small blind 50
PokerStarsMan12: posts big blind 100
*** HOLE CARDS ***
Dealt to PokerStarsMan12 [Qc Qd]
color_singleton: folds 
JeBoyDirk: folds 
Uncalled bet (50) returned to PokerStarsMan12
PokerStarsMan12 collected 100 from pot
*** SUMMARY ***
Total pot 100 | Rake 0 
Seat 1: color_singleton (button) folded before Flop (didn't bet)
Seat 2: JeBoyDirk (small blind) folded before Flop
Seat 9: PokerStarsMan12 (big blind) collected (100)



PokerStars Home Game Hand #228488418201: {DaPokaStars}  Hold'em No Limit (50/100) - 2021/07/22 15:32:00 ET
Table 'Halleria II' 9-max (Play Money) Seat #2 is the button
Seat 1: color_singleton (10379 in chips) 
Seat 2: JeBoyDirk (11316 in chips) 
Seat 9: PokerStarsMan12 (7989 in chips) 
PokerStarsMan12: posts small blind 50
color_singleton: posts big blind 100
*** HOLE CARDS ***
Dealt to PokerStarsMan12 [6s 4h]
JeBoyDirk: folds 
PokerStarsMan12: calls 50
color_singleton: raises 200 to 300
PokerStarsMan12: calls 200
*** FLOP *** [2h 8h As]
PokerStarsMan12: checks 
color_singleton: checks 
*** TURN *** [2h 8h As] [Ks]
PokerStarsMan12: checks 
color_singleton: bets 283
PokerStarsMan12: folds 
Uncalled bet (283) returned to color_singleton
color_singleton collected 567 from pot
color_singleton: doesn't show hand 
*** SUMMARY ***
Total pot 600 | Rake 33 
Board [2h 8h As Ks]
Seat 1: color_singleton (big blind) collected (567)
Seat 2: JeBoyDirk (button) folded before Flop (didn't bet)
Seat 9: PokerStarsMan12 (small blind) folded on the Turn



PokerStars Home Game Hand #228488431908: {DaPokaStars}  Hold'em No Limit (50/100) - 2021/07/22 15:32:22 ET
Table 'Halleria II' 9-max (Play Money) Seat #9 is the button
Seat 1: color_singleton (10646 in chips) 
Seat 2: JeBoyDirk (11316 in chips) 
Seat 9: PokerStarsMan12 (7689 in chips) 
color_singleton: posts small blind 50
JeBoyDirk: posts big blind 100
*** HOLE CARDS ***
Dealt to PokerStarsMan12 [3c 9s]
PokerStarsMan12: folds 
color_singleton: folds 
Uncalled bet (50) returned to JeBoyDirk
JeBoyDirk collected 100 from pot
*** SUMMARY ***
Total pot 100 | Rake 0 
Seat 1: color_singleton (small blind) folded before Flop
Seat 2: JeBoyDirk (big blind) collected (100)
Seat 9: PokerStarsMan12 (button) folded before Flop (didn't bet)



PokerStars Home Game Hand #228488434162: {DaPokaStars}  Hold'em No Limit (50/100) - 2021/07/22 15:32:27 ET
Table 'Halleria II' 9-max (Play Money) Seat #1 is the button
Seat 1: color_singleton (10596 in chips) 
Seat 2: JeBoyDirk (11366 in chips) 
Seat 9: PokerStarsMan12 (7689 in chips) 
JeBoyDirk: posts small blind 50
PokerStarsMan12: posts big blind 100
*** HOLE CARDS ***
Dealt to PokerStarsMan12 [6h Qc]
color_singleton: folds 
JeBoyDirk: calls 50
PokerStarsMan12: checks 
*** FLOP *** [Jd 3d 8s]
JeBoyDirk: checks 
PokerStarsMan12: checks 
*** TURN *** [Jd 3d 8s] [Qh]
JeBoyDirk: checks 
PokerStarsMan12: bets 300
JeBoyDirk: folds 
Uncalled bet (300) returned to PokerStarsMan12
PokerStarsMan12 collected 189 from pot
*** SUMMARY ***
Total pot 200 | Rake 11 
Board [Jd 3d 8s Qh]
Seat 1: color_singleton (button) folded before Flop (didn't bet)
Seat 2: JeBoyDirk (small blind) folded on the Turn
Seat 9: PokerStarsMan12 (big blind) collected (189)



PokerStars Home Game Hand #228488443680: {DaPokaStars}  Hold'em No Limit (50/100) - 2021/07/22 15:32:47 ET
Table 'Halleria II' 9-max (Play Money) Seat #2 is the button
Seat 1: color_singleton (10596 in chips) 
Seat 2: JeBoyDirk (11266 in chips) 
Seat 9: PokerStarsMan12 (7778 in chips) 
PokerStarsMan12: posts small blind 50
color_singleton: posts big blind 100
*** HOLE CARDS ***
Dealt to PokerStarsMan12 [5h 2s]
JeBoyDirk: folds 
PokerStarsMan12: calls 50
color_singleton: checks 
*** FLOP *** [6h Ac Qs]
PokerStarsMan12: checks 
color_singleton: checks 
*** TURN *** [6h Ac Qs] [7h]
PokerStarsMan12: checks 
color_singleton: checks 
*** RIVER *** [6h Ac Qs 7h] [3h]
PokerStarsMan12: checks 
color_singleton: checks 
*** SHOW DOWN ***
PokerStarsMan12: shows [5h 2s] (high card Ace)
color_singleton: shows [Jd 7s] (a pair of Sevens)
color_singleton collected 189 from pot
*** SUMMARY ***
Total pot 200 | Rake 11 
Board [6h Ac Qs 7h 3h]
Seat 1: color_singleton (big blind) showed [Jd 7s] and won (189) with a pair of Sevens
Seat 2: JeBoyDirk (button) folded before Flop (didn't bet)
Seat 9: PokerStarsMan12 (small blind) showed [5h 2s] and lost with high card Ace



PokerStars Home Game Hand #228488454090: {DaPokaStars}  Hold'em No Limit (50/100) - 2021/07/22 15:33:09 ET
Table 'Halleria II' 9-max (Play Money) Seat #9 is the button
Seat 1: color_singleton (10685 in chips) 
Seat 2: JeBoyDirk (11266 in chips) 
Seat 9: PokerStarsMan12 (7678 in chips) 
color_singleton: posts small blind 50
JeBoyDirk: posts big blind 100
*** HOLE CARDS ***
Dealt to PokerStarsMan12 [Qs 6s]
PokerStarsMan12: calls 100
color_singleton: raises 200 to 300
JeBoyDirk: folds 
PokerStarsMan12: calls 200
*** FLOP *** [5d 9s 3h]
color_singleton: checks 
PokerStarsMan12: checks 
*** TURN *** [5d 9s 3h] [Ks]
color_singleton: bets 330
PokerStarsMan12: raises 470 to 800
color_singleton: raises 470 to 1270
PokerStarsMan12: calls 470
*** RIVER *** [5d 9s 3h Ks] [Qh]
color_singleton: bets 3062
PokerStarsMan12: folds 
Uncalled bet (3062) returned to color_singleton
color_singleton collected 3062 from pot
color_singleton: doesn't show hand 
*** SUMMARY ***
Total pot 3240 | Rake 178 
Board [5d 9s 3h Ks Qh]
Seat 1: color_singleton (small blind) collected (3062)
Seat 2: JeBoyDirk (big blind) folded before Flop
Seat 9: PokerStarsMan12 (button) folded on the River



PokerStars Home Game Hand #228488472314: {DaPokaStars}  Hold'em No Limit (50/100) - 2021/07/22 15:33:48 ET
Table 'Halleria II' 9-max (Play Money) Seat #1 is the button
Seat 1: color_singleton (12177 in chips) 
Seat 2: JeBoyDirk (11166 in chips) 
Seat 9: PokerStarsMan12 (6108 in chips) 
JeBoyDirk: posts small blind 50
PokerStarsMan12: posts big blind 100
*** HOLE CARDS ***
Dealt to PokerStarsMan12 [Qh 6d]
color_singleton: folds 
JeBoyDirk: folds 
Uncalled bet (50) returned to PokerStarsMan12
PokerStarsMan12 collected 100 from pot
*** SUMMARY ***
Total pot 100 | Rake 0 
Seat 1: color_singleton (button) folded before Flop (didn't bet)
Seat 2: JeBoyDirk (small blind) folded before Flop
Seat 9: PokerStarsMan12 (big blind) collected (100)



PokerStars Home Game Hand #228488476197: {DaPokaStars}  Hold'em No Limit (50/100) - 2021/07/22 15:33:56 ET
Table 'Halleria II' 9-max (Play Money) Seat #2 is the button
Seat 1: color_singleton (12177 in chips) 
Seat 2: JeBoyDirk (11116 in chips) 
Seat 9: PokerStarsMan12 (6158 in chips) 
PokerStarsMan12: posts small blind 50
color_singleton: posts big blind 100
*** HOLE CARDS ***
Dealt to PokerStarsMan12 [2d 5h]
GillesdeH joins the table at seat #8 
JeBoyDirk: folds 
PokerStarsMan12: calls 50
color_singleton: checks 
*** FLOP *** [Ks Qd 6s]
PokerStarsMan12: checks 
color_singleton: bets 189
PokerStarsMan12: folds 
Uncalled bet (189) returned to color_singleton
color_singleton collected 189 from pot
color_singleton: doesn't show hand 
*** SUMMARY ***
Total pot 200 | Rake 11 
Board [Ks Qd 6s]
Seat 1: color_singleton (big blind) collected (189)
Seat 2: JeBoyDirk (button) folded before Flop (didn't bet)
Seat 9: PokerStarsMan12 (small blind) folded on the Flop



PokerStars Home Game Hand #228488485745: {DaPokaStars}  Hold'em No Limit (50/100) - 2021/07/22 15:34:16 ET
Table 'Halleria II' 9-max (Play Money) Seat #9 is the button
Seat 1: color_singleton (12266 in chips) 
Seat 2: JeBoyDirk (11116 in chips) 
Seat 8: GillesdeH (10000 in chips) 
Seat 9: PokerStarsMan12 (6058 in chips) 
color_singleton: posts small blind 50
JeBoyDirk: posts big blind 100
GillesdeH: posts big blind 100
*** HOLE CARDS ***
Dealt to PokerStarsMan12 [3h 4c]
GillesdeH: checks 
PokerStarsMan12: calls 100
color_singleton: folds 
JeBoyDirk: checks 
*** FLOP *** [2c 3s Ah]
JeBoyDirk: checks 
GillesdeH: checks 
PokerStarsMan12: bets 300
JeBoyDirk: folds 
GillesdeH: folds 
Uncalled bet (300) returned to PokerStarsMan12
PokerStarsMan12 collected 331 from pot
*** SUMMARY ***
Total pot 350 | Rake 19 
Board [2c 3s Ah]
Seat 1: color_singleton (small blind) folded before Flop
Seat 2: JeBoyDirk (big blind) folded on the Flop
Seat 8: GillesdeH folded on the Flop (didn't bet)
Seat 9: PokerStarsMan12 (button) collected (331)



PokerStars Home Game Hand #228488500146: {DaPokaStars}  Hold'em No Limit (50/100) - 2021/07/22 15:34:46 ET
Table 'Halleria II' 9-max (Play Money) Seat #1 is the button
Seat 1: color_singleton (12216 in chips) 
Seat 2: JeBoyDirk (11016 in chips) 
Seat 8: GillesdeH (9900 in chips) 
Seat 9: PokerStarsMan12 (6289 in chips) 
JeBoyDirk: posts small blind 50
GillesdeH: posts big blind 100
*** HOLE CARDS ***
Dealt to PokerStarsMan12 [Kd 9h]
PokerStarsMan12: raises 300 to 400
color_singleton: folds 
JeBoyDirk: folds 
GillesdeH: calls 300
*** FLOP *** [Td 3d Tc]
GillesdeH: checks 
PokerStarsMan12: checks 
*** TURN *** [Td 3d Tc] [Jc]
GillesdeH: checks 
PokerStarsMan12: bets 400
GillesdeH: folds 
Uncalled bet (400) returned to PokerStarsMan12
PokerStarsMan12 collected 803 from pot
*** SUMMARY ***
Total pot 850 | Rake 47 
Board [Td 3d Tc Jc]
Seat 1: color_singleton (button) folded before Flop (didn't bet)
Seat 2: JeBoyDirk (small blind) folded before Flop
Seat 8: GillesdeH (big blind) folded on the Turn
Seat 9: PokerStarsMan12 collected (803)



PokerStars Home Game Hand #228488512008: {DaPokaStars}  Hold'em No Limit (50/100) - 2021/07/22 15:35:12 ET
Table 'Halleria II' 9-max (Play Money) Seat #2 is the button
Seat 1: color_singleton (12216 in chips) 
Seat 2: JeBoyDirk (10966 in chips) 
Seat 8: GillesdeH (9500 in chips) 
Seat 9: PokerStarsMan12 (6692 in chips) 
GillesdeH: posts small blind 50
PokerStarsMan12: posts big blind 100
*** HOLE CARDS ***
Dealt to PokerStarsMan12 [4d 3d]
color_singleton: raises 200 to 300
JeBoyDirk: folds 
GillesdeH: folds 
PokerStarsMan12: calls 200
*** FLOP *** [2d 8d Qs]
PokerStarsMan12: bets 400
color_singleton: folds 
Uncalled bet (400) returned to PokerStarsMan12
PokerStarsMan12 collected 614 from pot
*** SUMMARY ***
Total pot 650 | Rake 36 
Board [2d 8d Qs]
Seat 1: color_singleton folded on the Flop
Seat 2: JeBoyDirk (button) folded before Flop (didn't bet)
Seat 8: GillesdeH (small blind) folded before Flop
Seat 9: PokerStarsMan12 (big blind) collected (614)



PokerStars Home Game Hand #228488519862: {DaPokaStars}  Hold'em No Limit (50/100) - 2021/07/22 15:35:28 ET
Table 'Halleria II' 9-max (Play Money) Seat #8 is the button
Seat 1: color_singleton (11916 in chips) 
Seat 2: JeBoyDirk (10966 in chips) 
Seat 8: GillesdeH (9450 in chips) 
Seat 9: PokerStarsMan12 (7006 in chips) 
PokerStarsMan12: posts small blind 50
color_singleton: posts big blind 100
*** HOLE CARDS ***
Dealt to PokerStarsMan12 [Jc 6s]
JeBoyDirk: folds 
GillesdeH: calls 100
PokerStarsMan12: calls 50
color_singleton: checks 
*** FLOP *** [Kh Ad 7h]
PokerStarsMan12: checks 
color_singleton: checks 
GillesdeH: checks 
*** TURN *** [Kh Ad 7h] [Ks]
PokerStarsMan12: checks 
color_singleton: checks 
GillesdeH: checks 
*** RIVER *** [Kh Ad 7h Ks] [6h]
PokerStarsMan12: bets 100
color_singleton: folds 
GillesdeH: folds 
Uncalled bet (100) returned to PokerStarsMan12
PokerStarsMan12 collected 283 from pot
*** SUMMARY ***
Total pot 300 | Rake 17 
Board [Kh Ad 7h Ks 6h]
Seat 1: color_singleton (big blind) folded on the River
Seat 2: JeBoyDirk folded before Flop (didn't bet)
Seat 8: GillesdeH (button) folded on the River
Seat 9: PokerStarsMan12 (small blind) collected (283)



PokerStars Home Game Hand #228488538301: {DaPokaStars}  Hold'em No Limit (50/100) - 2021/07/22 15:36:07 ET
Table 'Halleria II' 9-max (Play Money) Seat #9 is the button
Seat 1: color_singleton (11816 in chips) 
Seat 2: JeBoyDirk (10966 in chips) 
Seat 8: GillesdeH (9350 in chips) 
Seat 9: PokerStarsMan12 (7189 in chips) 
color_singleton: posts small blind 50
JeBoyDirk: posts big blind 100
*** HOLE CARDS ***
Dealt to PokerStarsMan12 [2d Td]
GillesdeH: folds 
PokerStarsMan12: calls 100
color_singleton: calls 50
JeBoyDirk: checks 
*** FLOP *** [Kc 2c Qd]
color_singleton: bets 141
JeBoyDirk: folds 
PokerStarsMan12: folds 
Uncalled bet (141) returned to color_singleton
color_singleton collected 283 from pot
color_singleton: doesn't show hand 
*** SUMMARY ***
Total pot 300 | Rake 17 
Board [Kc 2c Qd]
Seat 1: color_singleton (small blind) collected (283)
Seat 2: JeBoyDirk (big blind) folded on the Flop
Seat 8: GillesdeH folded before Flop (didn't bet)
Seat 9: PokerStarsMan12 (button) folded on the Flop



PokerStars Home Game Hand #228488551407: {DaPokaStars}  Hold'em No Limit (50/100) - 2021/07/22 15:36:35 ET
Table 'Halleria II' 9-max (Play Money) Seat #1 is the button
Seat 1: color_singleton (11999 in chips) 
Seat 2: JeBoyDirk (10866 in chips) 
Seat 8: GillesdeH (9350 in chips) 
Seat 9: PokerStarsMan12 (7089 in chips) 
JeBoyDirk: posts small blind 50
GillesdeH: posts big blind 100
*** HOLE CARDS ***
Dealt to PokerStarsMan12 [Td 9s]
PokerStarsMan12: raises 200 to 300
color_singleton: calls 300
JeBoyDirk: folds 
GillesdeH: folds 
*** FLOP *** [6s Ks 8c]
PokerStarsMan12: bets 400
color_singleton: calls 400
*** TURN *** [6s Ks 8c] [7h]
PokerStarsMan12: bets 900
color_singleton: folds 
Uncalled bet (900) returned to PokerStarsMan12
PokerStarsMan12 collected 1465 from pot
*** SUMMARY ***
Total pot 1550 | Rake 85 
Board [6s Ks 8c 7h]
Seat 1: color_singleton (button) folded on the Turn
Seat 2: JeBoyDirk (small blind) folded before Flop
Seat 8: GillesdeH (big blind) folded before Flop
Seat 9: PokerStarsMan12 collected (1465)



PokerStars Home Game Hand #228488567627: {DaPokaStars}  Hold'em No Limit (50/100) - 2021/07/22 15:37:09 ET
Table 'Halleria II' 9-max (Play Money) Seat #2 is the button
Seat 1: color_singleton (11299 in chips) 
Seat 2: JeBoyDirk (10816 in chips) 
Seat 8: GillesdeH (9250 in chips) 
Seat 9: PokerStarsMan12 (7854 in chips) 
GillesdeH: posts small blind 50
PokerStarsMan12: posts big blind 100
*** HOLE CARDS ***
Dealt to PokerStarsMan12 [7d Qh]
color_singleton: raises 200 to 300
JeBoyDirk: folds 
GillesdeH: calls 250
PokerStarsMan12: calls 200
*** FLOP *** [4s Jh 5d]
GillesdeH: checks 
PokerStarsMan12: checks 
color_singleton: bets 425
GillesdeH: folds 
PokerStarsMan12: folds 
Uncalled bet (425) returned to color_singleton
color_singleton collected 850 from pot
color_singleton: doesn't show hand 
*** SUMMARY ***
Total pot 900 | Rake 50 
Board [4s Jh 5d]
Seat 1: color_singleton collected (850)
Seat 2: JeBoyDirk (button) folded before Flop (didn't bet)
Seat 8: GillesdeH (small blind) folded on the Flop
Seat 9: PokerStarsMan12 (big blind) folded on the Flop



PokerStars Home Game Hand #228488581385: {DaPokaStars}  Hold'em No Limit (50/100) - 2021/07/22 15:37:38 ET
Table 'Halleria II' 9-max (Play Money) Seat #8 is the button
Seat 1: color_singleton (11849 in chips) 
Seat 2: JeBoyDirk (10816 in chips) 
Seat 8: GillesdeH (8950 in chips) 
Seat 9: PokerStarsMan12 (7554 in chips) 
PokerStarsMan12: posts small blind 50
color_singleton: posts big blind 100
*** HOLE CARDS ***
Dealt to PokerStarsMan12 [8c Td]
JeBoyDirk: folds 
GillesdeH: calls 100
PokerStarsMan12: calls 50
color_singleton: checks 
*** FLOP *** [5d Ts 7s]
PokerStarsMan12: bets 200
color_singleton: calls 200
GillesdeH: calls 200
*** TURN *** [5d Ts 7s] [5s]
PokerStarsMan12: bets 700
color_singleton: calls 700
GillesdeH: calls 700
*** RIVER *** [5d Ts 7s 5s] [4s]
PokerStarsMan12: checks 
color_singleton: checks 
GillesdeH: bets 1417
PokerStarsMan12: folds 
color_singleton: folds 
Uncalled bet (1417) returned to GillesdeH
GillesdeH collected 2835 from pot
*** SUMMARY ***
Total pot 3000 | Rake 165 
Board [5d Ts 7s 5s 4s]
Seat 1: color_singleton (big blind) folded on the River
Seat 2: JeBoyDirk folded before Flop (didn't bet)
Seat 8: GillesdeH (button) collected (2835)
Seat 9: PokerStarsMan12 (small blind) folded on the River



PokerStars Home Game Hand #228488613810: {DaPokaStars}  Hold'em No Limit (50/100) - 2021/07/22 15:38:46 ET
Table 'Halleria II' 9-max (Play Money) Seat #9 is the button
Seat 1: color_singleton (10849 in chips) 
Seat 2: JeBoyDirk (10816 in chips) 
Seat 8: GillesdeH (10785 in chips) 
Seat 9: PokerStarsMan12 (6554 in chips) 
color_singleton: posts small blind 50
JeBoyDirk: posts big blind 100
*** HOLE CARDS ***
Dealt to PokerStarsMan12 [Td 8d]
GillesdeH: calls 100
PokerStarsMan12: raises 200 to 300
color_singleton: calls 250
JeBoyDirk: folds 
GillesdeH: calls 200
*** FLOP *** [7s Jc 9d]
color_singleton: bets 472
GillesdeH: calls 472
PokerStarsMan12: raises 1028 to 1500
color_singleton: folds 
GillesdeH: folds 
Uncalled bet (1028) returned to PokerStarsMan12
PokerStarsMan12 collected 2283 from pot
*** SUMMARY ***
Total pot 2416 | Rake 133 
Board [7s Jc 9d]
Seat 1: color_singleton (small blind) folded on the Flop
Seat 2: JeBoyDirk (big blind) folded before Flop
Seat 8: GillesdeH folded on the Flop
Seat 9: PokerStarsMan12 (button) collected (2283)



PokerStars Home Game Hand #228488643001: {DaPokaStars}  Hold'em No Limit (50/100) - 2021/07/22 15:39:48 ET
Table 'Halleria II' 9-max (Play Money) Seat #1 is the button
Seat 1: color_singleton (10077 in chips) 
Seat 2: JeBoyDirk (10716 in chips) 
Seat 8: GillesdeH (10013 in chips) 
Seat 9: PokerStarsMan12 (8065 in chips) 
JeBoyDirk: posts small blind 50
GillesdeH: posts big blind 100
*** HOLE CARDS ***
Dealt to PokerStarsMan12 [7s Ac]
PokerStarsMan12: raises 200 to 300
color_singleton: folds 
JeBoyDirk: folds 
GillesdeH: calls 200
*** FLOP *** [Jh 6h 9s]
GillesdeH: bets 307
PokerStarsMan12: calls 307
*** TURN *** [Jh 6h 9s] [3s]
GillesdeH: checks 
PokerStarsMan12: checks 
*** RIVER *** [Jh 6h 9s 3s] [4d]
GillesdeH: checks 
PokerStarsMan12: checks 
*** SHOW DOWN ***
GillesdeH: shows [Qh Jc] (a pair of Jacks)
PokerStarsMan12: mucks hand 
GillesdeH collected 1194 from pot
*** SUMMARY ***
Total pot 1264 | Rake 70 
Board [Jh 6h 9s 3s 4d]
Seat 1: color_singleton (button) folded before Flop (didn't bet)
Seat 2: JeBoyDirk (small blind) folded before Flop
Seat 8: GillesdeH (big blind) showed [Qh Jc] and won (1194) with a pair of Jacks
Seat 9: PokerStarsMan12 mucked [7s Ac]



PokerStars Home Game Hand #228488661446: {DaPokaStars}  Hold'em No Limit (50/100) - 2021/07/22 15:40:27 ET
Table 'Halleria II' 9-max (Play Money) Seat #2 is the button
Seat 1: color_singleton (10077 in chips) 
Seat 2: JeBoyDirk (10666 in chips) 
Seat 8: GillesdeH (10600 in chips) 
Seat 9: PokerStarsMan12 (7458 in chips) 
GillesdeH: posts small blind 50
PokerStarsMan12: posts big blind 100
*** HOLE CARDS ***
Dealt to PokerStarsMan12 [Jh Ks]
color_singleton: raises 200 to 300
JeBoyDirk: folds 
GillesdeH: calls 250
PokerStarsMan12: calls 200
*** FLOP *** [4c 7h 7s]
GillesdeH: checks 
PokerStarsMan12: bets 500
color_singleton: folds 
GillesdeH: folds 
Uncalled bet (500) returned to PokerStarsMan12
PokerStarsMan12 collected 850 from pot
*** SUMMARY ***
Total pot 900 | Rake 50 
Board [4c 7h 7s]
Seat 1: color_singleton folded on the Flop
Seat 2: JeBoyDirk (button) folded before Flop (didn't bet)
Seat 8: GillesdeH (small blind) folded on the Flop
Seat 9: PokerStarsMan12 (big blind) collected (850)



PokerStars Home Game Hand #228488671697: {DaPokaStars}  Hold'em No Limit (50/100) - 2021/07/22 15:40:49 ET
Table 'Halleria II' 9-max (Play Money) Seat #8 is the button
Seat 1: color_singleton (9777 in chips) 
Seat 2: JeBoyDirk (10666 in chips) 
Seat 8: GillesdeH (10300 in chips) 
Seat 9: PokerStarsMan12 (8008 in chips) 
PokerStarsMan12: posts small blind 50
color_singleton: posts big blind 100
*** HOLE CARDS ***
Dealt to PokerStarsMan12 [2h 4d]
JeBoyDirk: folds 
GillesdeH: calls 100
PokerStarsMan12: calls 50
color_singleton: raises 200 to 300
GillesdeH: calls 200
PokerStarsMan12: calls 200
*** FLOP *** [Qc 4h Td]
PokerStarsMan12: checks 
color_singleton: checks 
GillesdeH: checks 
*** TURN *** [Qc 4h Td] [Qh]
PokerStarsMan12: checks 
color_singleton: checks 
GillesdeH: checks 
*** RIVER *** [Qc 4h Td Qh] [Jh]
PokerStarsMan12: bets 400
color_singleton: folds 
GillesdeH: folds 
Uncalled bet (400) returned to PokerStarsMan12
PokerStarsMan12 collected 850 from pot
*** SUMMARY ***
Total pot 900 | Rake 50 
Board [Qc 4h Td Qh Jh]
Seat 1: color_singleton (big blind) folded on the River
Seat 2: JeBoyDirk folded before Flop (didn't bet)
Seat 8: GillesdeH (button) folded on the River
Seat 9: PokerStarsMan12 (small blind) collected (850)



PokerStars Home Game Hand #228488699286: {DaPokaStars}  Hold'em No Limit (50/100) - 2021/07/22 15:41:47 ET
Table 'Halleria II' 9-max (Play Money) Seat #9 is the button
Seat 1: color_singleton (9477 in chips) 
Seat 2: JeBoyDirk (10666 in chips) 
Seat 8: GillesdeH (10000 in chips) 
Seat 9: PokerStarsMan12 (8558 in chips) 
color_singleton: posts small blind 50
JeBoyDirk: posts big blind 100
*** HOLE CARDS ***
Dealt to PokerStarsMan12 [Kh Th]
GillesdeH: calls 100
PokerStarsMan12: raises 300 to 400
color_singleton: folds 
JeBoyDirk: calls 300
GillesdeH: calls 300
*** FLOP *** [3c 4s 8d]
JeBoyDirk: checks 
GillesdeH: checks 
PokerStarsMan12: checks 
*** TURN *** [3c 4s 8d] [4d]
JeBoyDirk: checks 
GillesdeH: checks 
PokerStarsMan12: checks 
*** RIVER *** [3c 4s 8d 4d] [6h]
JeBoyDirk: checks 
GillesdeH: checks 
PokerStarsMan12: checks 
*** SHOW DOWN ***
JeBoyDirk: shows [Ad 9d] (a pair of Fours)
GillesdeH: shows [Qh As] (a pair of Fours - Ace+Queen kicker)
PokerStarsMan12: mucks hand 
GillesdeH collected 1181 from pot
*** SUMMARY ***
Total pot 1250 | Rake 69 
Board [3c 4s 8d 4d 6h]
Seat 1: color_singleton (small blind) folded before Flop
Seat 2: JeBoyDirk (big blind) showed [Ad 9d] and lost with a pair of Fours
Seat 8: GillesdeH showed [Qh As] and won (1181) with a pair of Fours
Seat 9: PokerStarsMan12 (button) mucked [Kh Th]



PokerStars Home Game Hand #228488726872: {DaPokaStars}  Hold'em No Limit (50/100) - 2021/07/22 15:42:45 ET
Table 'Halleria II' 9-max (Play Money) Seat #1 is the button
Seat 1: color_singleton (9427 in chips) 
Seat 2: JeBoyDirk (10266 in chips) 
Seat 8: GillesdeH (10781 in chips) 
Seat 9: PokerStarsMan12 (8158 in chips) 
JeBoyDirk: posts small blind 50
GillesdeH: posts big blind 100
*** HOLE CARDS ***
Dealt to PokerStarsMan12 [7c 6s]
PokerStarsMan12: raises 300 to 400
color_singleton: folds 
JeBoyDirk: folds 
GillesdeH: calls 300
*** FLOP *** [4s Tc 9c]
GillesdeH: checks 
PokerStarsMan12: checks 
*** TURN *** [4s Tc 9c] [Ts]
GillesdeH: checks 
PokerStarsMan12: checks 
*** RIVER *** [4s Tc 9c Ts] [5h]
GillesdeH: bets 803
PokerStarsMan12: folds 
Uncalled bet (803) returned to GillesdeH
GillesdeH collected 803 from pot
*** SUMMARY ***
Total pot 850 | Rake 47 
Board [4s Tc 9c Ts 5h]
Seat 1: color_singleton (button) folded before Flop (didn't bet)
Seat 2: JeBoyDirk (small blind) folded before Flop
Seat 8: GillesdeH (big blind) collected (803)
Seat 9: PokerStarsMan12 folded on the River



PokerStars Home Game Hand #228488744671: {DaPokaStars}  Hold'em No Limit (50/100) - 2021/07/22 15:43:23 ET
Table 'Halleria II' 9-max (Play Money) Seat #2 is the button
Seat 1: color_singleton (9427 in chips) 
Seat 2: JeBoyDirk (10216 in chips) 
Seat 8: GillesdeH (11184 in chips) 
Seat 9: PokerStarsMan12 (7758 in chips) 
GillesdeH: posts small blind 50
PokerStarsMan12: posts big blind 100
*** HOLE CARDS ***
Dealt to PokerStarsMan12 [3h 5h]
color_singleton: folds 
JeBoyDirk: calls 100
GillesdeH: calls 50
PokerStarsMan12: checks 
*** FLOP *** [4d 8s Ad]
GillesdeH: checks 
PokerStarsMan12: checks 
JeBoyDirk: checks 
*** TURN *** [4d 8s Ad] [2h]
GillesdeH: checks 
PokerStarsMan12: bets 300
JeBoyDirk: folds 
GillesdeH: calls 300
*** RIVER *** [4d 8s Ad 2h] [Ac]
GillesdeH: checks 
PokerStarsMan12: bets 1000
GillesdeH: folds 
Uncalled bet (1000) returned to PokerStarsMan12
PokerStarsMan12 collected 850 from pot
*** SUMMARY ***
Total pot 900 | Rake 50 
Board [4d 8s Ad 2h Ac]
Seat 1: color_singleton folded before Flop (didn't bet)
Seat 2: JeBoyDirk (button) folded on the Turn
Seat 8: GillesdeH (small blind) folded on the River
Seat 9: PokerStarsMan12 (big blind) collected (850)



PokerStars Home Game Hand #228488771944: {DaPokaStars}  Hold'em No Limit (50/100) - 2021/07/22 15:44:20 ET
Table 'Halleria II' 9-max (Play Money) Seat #8 is the button
Seat 1: color_singleton (9427 in chips) 
Seat 2: JeBoyDirk (10116 in chips) 
Seat 8: GillesdeH (10784 in chips) 
Seat 9: PokerStarsMan12 (8208 in chips) 
PokerStarsMan12: posts small blind 50
color_singleton: posts big blind 100
*** HOLE CARDS ***
Dealt to PokerStarsMan12 [Ks Jh]
JeBoyDirk: folds 
GillesdeH: calls 100
PokerStarsMan12: raises 400 to 500
color_singleton: folds 
GillesdeH: calls 400
*** FLOP *** [3h 8s 4d]
PokerStarsMan12: checks 
GillesdeH: checks 
*** TURN *** [3h 8s 4d] [Tc]
PokerStarsMan12: checks 
GillesdeH: checks 
*** RIVER *** [3h 8s 4d Tc] [Ad]
PokerStarsMan12: checks 
GillesdeH: bets 1039
PokerStarsMan12: folds 
Uncalled bet (1039) returned to GillesdeH
GillesdeH collected 1039 from pot
*** SUMMARY ***
Total pot 1100 | Rake 61 
Board [3h 8s 4d Tc Ad]
Seat 1: color_singleton (big blind) folded before Flop
Seat 2: JeBoyDirk folded before Flop (didn't bet)
Seat 8: GillesdeH (button) collected (1039)
Seat 9: PokerStarsMan12 (small blind) folded on the River



PokerStars Home Game Hand #228488789216: {DaPokaStars}  Hold'em No Limit (50/100) - 2021/07/22 15:44:57 ET
Table 'Halleria II' 9-max (Play Money) Seat #9 is the button
Seat 1: color_singleton (9327 in chips) 
Seat 2: JeBoyDirk (10116 in chips) 
Seat 8: GillesdeH (11323 in chips) 
Seat 9: PokerStarsMan12 (7708 in chips) 
color_singleton: posts small blind 50
JeBoyDirk: posts big blind 100
*** HOLE CARDS ***
Dealt to PokerStarsMan12 [5c Kc]
GillesdeH: calls 100
PokerStarsMan12: calls 100
color_singleton: raises 200 to 300
JeBoyDirk: calls 200
GillesdeH: calls 200
PokerStarsMan12: calls 200
*** FLOP *** [8d 4h 6s]
color_singleton: bets 567
JeBoyDirk: folds 
GillesdeH: calls 567
PokerStarsMan12: folds 
*** TURN *** [8d 4h 6s] [4s]
color_singleton: checks 
GillesdeH: checks 
*** RIVER *** [8d 4h 6s 4s] [8h]
color_singleton: checks 
GillesdeH: bets 2206
color_singleton: folds 
Uncalled bet (2206) returned to GillesdeH
GillesdeH collected 2206 from pot
*** SUMMARY ***
Total pot 2334 | Rake 128 
Board [8d 4h 6s 4s 8h]
Seat 1: color_singleton (small blind) folded on the River
Seat 2: JeBoyDirk (big blind) folded on the Flop
Seat 8: GillesdeH collected (2206)
Seat 9: PokerStarsMan12 (button) folded on the Flop



PokerStars Home Game Hand #228488811244: {DaPokaStars}  Hold'em No Limit (50/100) - 2021/07/22 15:45:40 ET
Table 'Halleria II' 9-max (Play Money) Seat #1 is the button
Seat 1: color_singleton (8460 in chips) 
Seat 2: JeBoyDirk (9816 in chips) 
Seat 8: GillesdeH (12662 in chips) 
Seat 9: PokerStarsMan12 (7408 in chips) 
JeBoyDirk: posts small blind 50
GillesdeH: posts big blind 100
*** HOLE CARDS ***
Dealt to PokerStarsMan12 [Qc 7c]
PokerStarsMan12: calls 100
color_singleton: calls 100
JeBoyDirk: folds 
GillesdeH: raises 100 to 200
PokerStarsMan12: calls 100
color_singleton: calls 100
*** FLOP *** [Qd As 7d]
GillesdeH: checks 
PokerStarsMan12: checks 
color_singleton: checks 
*** TURN *** [Qd As 7d] [9s]
GillesdeH: checks 
PokerStarsMan12: checks 
color_singleton: checks 
*** RIVER *** [Qd As 7d 9s] [2s]
GillesdeH: checks 
PokerStarsMan12: checks 
color_singleton: checks 
*** SHOW DOWN ***
GillesdeH: shows [Tc Kc] (high card Ace)
PokerStarsMan12: shows [Qc 7c] (two pair, Queens and Sevens)
color_singleton: mucks hand 
PokerStarsMan12 collected 614 from pot
*** SUMMARY ***
Total pot 650 | Rake 36 
Board [Qd As 7d 9s 2s]
Seat 1: color_singleton (button) mucked [7s 6h]
Seat 2: JeBoyDirk (small blind) folded before Flop
Seat 8: GillesdeH (big blind) showed [Tc Kc] and lost with high card Ace
Seat 9: PokerStarsMan12 showed [Qc 7c] and won (614) with two pair, Queens and Sevens



PokerStars Home Game Hand #228488829846: {DaPokaStars}  Hold'em No Limit (50/100) - 2021/07/22 15:46:19 ET
Table 'Halleria II' 9-max (Play Money) Seat #2 is the button
Seat 1: color_singleton (8260 in chips) 
Seat 2: JeBoyDirk (9766 in chips) 
Seat 8: GillesdeH (12462 in chips) 
Seat 9: PokerStarsMan12 (7822 in chips) 
GillesdeH: posts small blind 50
PokerStarsMan12: posts big blind 100
*** HOLE CARDS ***
Dealt to PokerStarsMan12 [9d 4s]
color_singleton: folds 
JeBoyDirk: folds 
GillesdeH: calls 50
PokerStarsMan12: checks 
*** FLOP *** [Ks Qh Kh]
GillesdeH: bets 500
PokerStarsMan12: folds 
Uncalled bet (500) returned to GillesdeH
GillesdeH collected 189 from pot
*** SUMMARY ***
Total pot 200 | Rake 11 
Board [Ks Qh Kh]
Seat 1: color_singleton folded before Flop (didn't bet)
Seat 2: JeBoyDirk (button) folded before Flop (didn't bet)
Seat 8: GillesdeH (small blind) collected (189)
Seat 9: PokerStarsMan12 (big blind) folded on the Flop



PokerStars Home Game Hand #228488842236: {DaPokaStars}  Hold'em No Limit (50/100) - 2021/07/22 15:46:45 ET
Table 'Halleria II' 9-max (Play Money) Seat #8 is the button
Seat 1: color_singleton (8260 in chips) 
Seat 2: JeBoyDirk (9766 in chips) 
Seat 8: GillesdeH (12551 in chips) 
Seat 9: PokerStarsMan12 (7722 in chips) 
PokerStarsMan12: posts small blind 50
color_singleton: posts big blind 100
*** HOLE CARDS ***
Dealt to PokerStarsMan12 [5s 7s]
JeBoyDirk: raises 100 to 200
GillesdeH: calls 200
PokerStarsMan12: calls 150
color_singleton: calls 100
*** FLOP *** [Tc 8c 9s]
PokerStarsMan12: checks 
color_singleton: checks 
JeBoyDirk: checks 
GillesdeH: checks 
*** TURN *** [Tc 8c 9s] [3s]
PokerStarsMan12: bets 400
color_singleton: calls 400
JeBoyDirk: calls 400
GillesdeH: folds 
*** RIVER *** [Tc 8c 9s 3s] [4h]
PokerStarsMan12: checks 
color_singleton: bets 1000
JeBoyDirk: folds 
PokerStarsMan12: folds 
Uncalled bet (1000) returned to color_singleton
color_singleton collected 1890 from pot
color_singleton: doesn't show hand 
*** SUMMARY ***
Total pot 2000 | Rake 110 
Board [Tc 8c 9s 3s 4h]
Seat 1: color_singleton (big blind) collected (1890)
Seat 2: JeBoyDirk folded on the River
Seat 8: GillesdeH (button) folded on the Turn
Seat 9: PokerStarsMan12 (small blind) folded on the River



PokerStars Home Game Hand #228488869825: {DaPokaStars}  Hold'em No Limit (50/100) - 2021/07/22 15:47:44 ET
Table 'Halleria II' 9-max (Play Money) Seat #9 is the button
Seat 1: color_singleton (9550 in chips) 
Seat 2: JeBoyDirk (9166 in chips) 
Seat 8: GillesdeH (12351 in chips) 
Seat 9: PokerStarsMan12 (7122 in chips) 
color_singleton: posts small blind 50
JeBoyDirk: posts big blind 100
*** HOLE CARDS ***
Dealt to PokerStarsMan12 [9s Th]
GillesdeH: calls 100
PokerStarsMan12: raises 300 to 400
color_singleton: calls 350
JeBoyDirk: folds 
GillesdeH: calls 300
*** FLOP *** [As 8d Qc]
color_singleton: checks 
GillesdeH: checks 
PokerStarsMan12: checks 
*** TURN *** [As 8d Qc] [8s]
color_singleton: bets 614
GillesdeH: calls 614
PokerStarsMan12: folds 
*** RIVER *** [As 8d Qc 8s] [Jd]
color_singleton: bets 2389
GillesdeH: calls 2389
*** SHOW DOWN ***
color_singleton: shows [9h Ad] (two pair, Aces and Eights)
GillesdeH: shows [5c 8c] (three of a kind, Eights)
GillesdeH collected 6904 from pot
*** SUMMARY ***
Total pot 7306 | Rake 402 
Board [As 8d Qc 8s Jd]
Seat 1: color_singleton (small blind) showed [9h Ad] and lost with two pair, Aces and Eights
Seat 2: JeBoyDirk (big blind) folded before Flop
Seat 8: GillesdeH showed [5c 8c] and won (6904) with three of a kind, Eights
Seat 9: PokerStarsMan12 (button) folded on the Turn



PokerStars Home Game Hand #228488888405: {DaPokaStars}  Hold'em No Limit (50/100) - 2021/07/22 15:48:23 ET
Table 'Halleria II' 9-max (Play Money) Seat #1 is the button
Seat 1: color_singleton (6147 in chips) 
Seat 2: JeBoyDirk (9066 in chips) 
Seat 8: GillesdeH (15852 in chips) 
Seat 9: PokerStarsMan12 (6722 in chips) 
JeBoyDirk: posts small blind 50
GillesdeH: posts big blind 100
*** HOLE CARDS ***
Dealt to PokerStarsMan12 [Th As]
PokerStarsMan12: raises 300 to 400
color_singleton: folds 
JeBoyDirk: calls 350
GillesdeH: calls 300
*** FLOP *** [Kd 6s Qd]
JeBoyDirk: checks 
GillesdeH: checks 
PokerStarsMan12: checks 
*** TURN *** [Kd 6s Qd] [2d]
JeBoyDirk: checks 
GillesdeH: checks 
PokerStarsMan12: checks 
*** RIVER *** [Kd 6s Qd 2d] [4c]
JeBoyDirk: bets 500
GillesdeH: folds 
PokerStarsMan12: folds 
Uncalled bet (500) returned to JeBoyDirk
JeBoyDirk collected 1134 from pot
*** SUMMARY ***
Total pot 1200 | Rake 66 
Board [Kd 6s Qd 2d 4c]
Seat 1: color_singleton (button) folded before Flop (didn't bet)
Seat 2: JeBoyDirk (small blind) collected (1134)
Seat 8: GillesdeH (big blind) folded on the River
Seat 9: PokerStarsMan12 folded on the River



PokerStars Home Game Hand #228488908977: {DaPokaStars}  Hold'em No Limit (50/100) - 2021/07/22 15:49:06 ET
Table 'Halleria II' 9-max (Play Money) Seat #2 is the button
Seat 1: color_singleton (6147 in chips) 
Seat 2: JeBoyDirk (9800 in chips) 
Seat 8: GillesdeH (15452 in chips) 
Seat 9: PokerStarsMan12 (6322 in chips) 
GillesdeH: posts small blind 50
PokerStarsMan12: posts big blind 100
*** HOLE CARDS ***
Dealt to PokerStarsMan12 [Ks Kc]
color_singleton: raises 200 to 300
JeBoyDirk: calls 300
GillesdeH: calls 250
PokerStarsMan12: raises 600 to 900
color_singleton: raises 1100 to 2000
JeBoyDirk: folds 
GillesdeH: folds 
PokerStarsMan12: calls 1100
*** FLOP *** [9c Td Ah]
PokerStarsMan12: checks 
color_singleton: bets 4147 and is all-in
PokerStarsMan12: folds 
Uncalled bet (4147) returned to color_singleton
color_singleton collected 4347 from pot
color_singleton: doesn't show hand 
*** SUMMARY ***
Total pot 4600 | Rake 253 
Board [9c Td Ah]
Seat 1: color_singleton collected (4347)
Seat 2: JeBoyDirk (button) folded before Flop
Seat 8: GillesdeH (small blind) folded before Flop
Seat 9: PokerStarsMan12 (big blind) folded on the Flop



PokerStars Home Game Hand #228488927978: {DaPokaStars}  Hold'em No Limit (50/100) - 2021/07/22 15:49:47 ET
Table 'Halleria II' 9-max (Play Money) Seat #8 is the button
Seat 1: color_singleton (8494 in chips) 
Seat 2: JeBoyDirk (9500 in chips) 
Seat 8: GillesdeH (15152 in chips) 
Seat 9: PokerStarsMan12 (4322 in chips) 
PokerStarsMan12: posts small blind 50
color_singleton: posts big blind 100
*** HOLE CARDS ***
Dealt to PokerStarsMan12 [5s Kh]
JeBoyDirk: folds 
GillesdeH: calls 100
PokerStarsMan12: calls 50
color_singleton: checks 
*** FLOP *** [2d As 5d]
PokerStarsMan12: checks 
color_singleton: bets 141
GillesdeH: calls 141
PokerStarsMan12: calls 141
*** TURN *** [2d As 5d] [7s]
PokerStarsMan12: checks 
color_singleton: checks 
GillesdeH: checks 
*** RIVER *** [2d As 5d 7s] [Ah]
PokerStarsMan12: bets 300
color_singleton: calls 300
GillesdeH: folds 
*** SHOW DOWN ***
PokerStarsMan12: shows [5s Kh] (two pair, Aces and Fives)
color_singleton: mucks hand 
PokerStarsMan12 collected 1250 from pot
*** SUMMARY ***
Total pot 1323 | Rake 73 
Board [2d As 5d 7s Ah]
Seat 1: color_singleton (big blind) mucked [5c Qc]
Seat 2: JeBoyDirk folded before Flop (didn't bet)
Seat 8: GillesdeH (button) folded on the River
Seat 9: PokerStarsMan12 (small blind) showed [5s Kh] and won (1250) with two pair, Aces and Fives



PokerStars Home Game Hand #228488947697: {DaPokaStars}  Hold'em No Limit (50/100) - 2021/07/22 15:50:29 ET
Table 'Halleria II' 9-max (Play Money) Seat #9 is the button
Seat 1: color_singleton (7953 in chips) 
Seat 2: JeBoyDirk (9500 in chips) 
Seat 8: GillesdeH (14911 in chips) 
Seat 9: PokerStarsMan12 (5031 in chips) 
color_singleton: posts small blind 50
JeBoyDirk: posts big blind 100
*** HOLE CARDS ***
Dealt to PokerStarsMan12 [2h 8d]
GillesdeH: calls 100
PokerStarsMan12: folds 
color_singleton: raises 400 to 500
JeBoyDirk: folds 
GillesdeH: folds 
Uncalled bet (400) returned to color_singleton
color_singleton collected 300 from pot
color_singleton: doesn't show hand 
*** SUMMARY ***
Total pot 300 | Rake 0 
Seat 1: color_singleton (small blind) collected (300)
Seat 2: JeBoyDirk (big blind) folded before Flop
Seat 8: GillesdeH folded before Flop
Seat 9: PokerStarsMan12 (button) folded before Flop (didn't bet)



PokerStars Home Game Hand #228488957052: {DaPokaStars}  Hold'em No Limit (50/100) - 2021/07/22 15:50:49 ET
Table 'Halleria II' 9-max (Play Money) Seat #1 is the button
Seat 1: color_singleton (8153 in chips) 
Seat 2: JeBoyDirk (9400 in chips) 
Seat 8: GillesdeH (14811 in chips) 
Seat 9: PokerStarsMan12 (5031 in chips) 
JeBoyDirk: posts small blind 50
GillesdeH: posts big blind 100
*** HOLE CARDS ***
Dealt to PokerStarsMan12 [Kh 4s]
PokerStarsMan12: folds 
color_singleton: folds 
JeBoyDirk: calls 50
GillesdeH: checks 
*** FLOP *** [6s Qd 3s]
JeBoyDirk: bets 200
GillesdeH: calls 200
*** TURN *** [6s Qd 3s] [3d]
JeBoyDirk: bets 300
GillesdeH: calls 300
*** RIVER *** [6s Qd 3s 3d] [Kc]
JeBoyDirk: bets 500
GillesdeH: folds 
Uncalled bet (500) returned to JeBoyDirk
JeBoyDirk collected 1134 from pot
*** SUMMARY ***
Total pot 1200 | Rake 66 
Board [6s Qd 3s 3d Kc]
Seat 1: color_singleton (button) folded before Flop (didn't bet)
Seat 2: JeBoyDirk (small blind) collected (1134)
Seat 8: GillesdeH (big blind) folded on the River
Seat 9: PokerStarsMan12 folded before Flop (didn't bet)



PokerStars Home Game Hand #228488974055: {DaPokaStars}  Hold'em No Limit (50/100) - 2021/07/22 15:51:25 ET
Table 'Halleria II' 9-max (Play Money) Seat #2 is the button
Seat 1: color_singleton (8153 in chips) 
Seat 2: JeBoyDirk (9934 in chips) 
Seat 8: GillesdeH (14211 in chips) 
Seat 9: PokerStarsMan12 (5031 in chips) 
GillesdeH: posts small blind 50
PokerStarsMan12: posts big blind 100
*** HOLE CARDS ***
Dealt to PokerStarsMan12 [Ah Qs]
color_singleton: folds 
JeBoyDirk: folds 
GillesdeH: calls 50
PokerStarsMan12: raises 300 to 400
GillesdeH: calls 300
*** FLOP *** [9s Ac 6s]
GillesdeH: checks 
PokerStarsMan12: bets 400
GillesdeH: calls 400
*** TURN *** [9s Ac 6s] [2c]
GillesdeH: checks 
PokerStarsMan12: bets 900
GillesdeH: folds 
Uncalled bet (900) returned to PokerStarsMan12
PokerStarsMan12 collected 1512 from pot
*** SUMMARY ***
Total pot 1600 | Rake 88 
Board [9s Ac 6s 2c]
Seat 1: color_singleton folded before Flop (didn't bet)
Seat 2: JeBoyDirk (button) folded before Flop (didn't bet)
Seat 8: GillesdeH (small blind) folded on the Turn
Seat 9: PokerStarsMan12 (big blind) collected (1512)



PokerStars Home Game Hand #228488995195: {DaPokaStars}  Hold'em No Limit (50/100) - 2021/07/22 15:52:10 ET
Table 'Halleria II' 9-max (Play Money) Seat #8 is the button
Seat 1: color_singleton (8153 in chips) 
Seat 2: JeBoyDirk (9934 in chips) 
Seat 8: GillesdeH (13411 in chips) 
Seat 9: PokerStarsMan12 (5743 in chips) 
PokerStarsMan12: posts small blind 50
color_singleton: posts big blind 100
*** HOLE CARDS ***
Dealt to PokerStarsMan12 [Jh 3s]
JeBoyDirk: calls 100
GillesdeH: calls 100
PokerStarsMan12: calls 50
color_singleton: checks 
*** FLOP *** [Th Kd 7s]
PokerStarsMan12: checks 
color_singleton: checks 
JeBoyDirk: bets 200
GillesdeH: folds 
PokerStarsMan12: folds 
color_singleton: calls 200
*** TURN *** [Th Kd 7s] [Jc]
color_singleton: checks 
JeBoyDirk: checks 
*** RIVER *** [Th Kd 7s Jc] [Ah]
color_singleton: checks 
JeBoyDirk: bets 400
color_singleton: folds 
Uncalled bet (400) returned to JeBoyDirk
JeBoyDirk collected 756 from pot
*** SUMMARY ***
Total pot 800 | Rake 44 
Board [Th Kd 7s Jc Ah]
Seat 1: color_singleton (big blind) folded on the River
Seat 2: JeBoyDirk collected (756)
Seat 8: GillesdeH (button) folded on the Flop
Seat 9: PokerStarsMan12 (small blind) folded on the Flop



PokerStars Home Game Hand #228489020915: {DaPokaStars}  Hold'em No Limit (50/100) - 2021/07/22 15:53:04 ET
Table 'Halleria II' 9-max (Play Money) Seat #9 is the button
Seat 1: color_singleton (7853 in chips) 
Seat 2: JeBoyDirk (10390 in chips) 
Seat 8: GillesdeH (13311 in chips) 
Seat 9: PokerStarsMan12 (5643 in chips) 
color_singleton: posts small blind 50
JeBoyDirk: posts big blind 100
*** HOLE CARDS ***
Dealt to PokerStarsMan12 [6s Qh]
GillesdeH: calls 100
PokerStarsMan12: folds 
color_singleton: folds 
JeBoyDirk: raises 300 to 400
GillesdeH: calls 300
*** FLOP *** [Jc 2d Ts]
JeBoyDirk: bets 500
GillesdeH: folds 
Uncalled bet (500) returned to JeBoyDirk
JeBoyDirk collected 803 from pot
*** SUMMARY ***
Total pot 850 | Rake 47 
Board [Jc 2d Ts]
Seat 1: color_singleton (small blind) folded before Flop
Seat 2: JeBoyDirk (big blind) collected (803)
Seat 8: GillesdeH folded on the Flop
Seat 9: PokerStarsMan12 (button) folded before Flop (didn't bet)



PokerStars Home Game Hand #228489043329: {DaPokaStars}  Hold'em No Limit (50/100) - 2021/07/22 15:53:46 ET
Table 'Halleria II' 9-max (Play Money) Seat #1 is the button
Seat 1: color_singleton (7803 in chips) 
Seat 2: JeBoyDirk (10793 in chips) 
Seat 8: GillesdeH (12911 in chips) 
Seat 9: PokerStarsMan12 (5643 in chips) 
JeBoyDirk: posts small blind 50
GillesdeH: posts big blind 100
*** HOLE CARDS ***
Dealt to PokerStarsMan12 [Ad 2h]
PokerStarsMan12: raises 200 to 300
color_singleton: folds 
JeBoyDirk: calls 250
GillesdeH: folds 
*** FLOP *** [Jd 5d 3h]
JeBoyDirk: checks 
PokerStarsMan12: bets 300
JeBoyDirk: calls 300
*** TURN *** [Jd 5d 3h] [9h]
JeBoyDirk: checks 
PokerStarsMan12: checks 
*** RIVER *** [Jd 5d 3h 9h] [4c]
JeBoyDirk: bets 800
PokerStarsMan12: raises 1100 to 1900
JeBoyDirk: calls 1100
*** SHOW DOWN ***
PokerStarsMan12: shows [Ad 2h] (a straight, Ace to Five)
JeBoyDirk: mucks hand 
PokerStarsMan12 collected 4819 from pot
*** SUMMARY ***
Total pot 5100 | Rake 281 
Board [Jd 5d 3h 9h 4c]
Seat 1: color_singleton (button) folded before Flop (didn't bet)
Seat 2: JeBoyDirk (small blind) mucked [Ah Jh]
Seat 8: GillesdeH (big blind) folded before Flop
Seat 9: PokerStarsMan12 showed [Ad 2h] and won (4819) with a straight, Ace to Five



PokerStars Home Game Hand #228489068943: {DaPokaStars}  Hold'em No Limit (50/100) - 2021/07/22 15:54:42 ET
Table 'Halleria II' 9-max (Play Money) Seat #2 is the button
Seat 1: color_singleton (7803 in chips) 
Seat 2: JeBoyDirk (8293 in chips) 
Seat 8: GillesdeH (12811 in chips) 
Seat 9: PokerStarsMan12 (7962 in chips) 
GillesdeH: posts small blind 50
PokerStarsMan12: posts big blind 100
*** HOLE CARDS ***
Dealt to PokerStarsMan12 [8d Kh]
color_singleton: folds 
JeBoyDirk: folds 
GillesdeH: calls 50
PokerStarsMan12: checks 
*** FLOP *** [5h 8s 6s]
GillesdeH: checks 
PokerStarsMan12: bets 200
GillesdeH: calls 200
*** TURN *** [5h 8s 6s] [9h]
GillesdeH: checks 
PokerStarsMan12: bets 300
GillesdeH: folds 
Uncalled bet (300) returned to PokerStarsMan12
PokerStarsMan12 collected 567 from pot
*** SUMMARY ***
Total pot 600 | Rake 33 
Board [5h 8s 6s 9h]
Seat 1: color_singleton folded before Flop (didn't bet)
Seat 2: JeBoyDirk (button) folded before Flop (didn't bet)
Seat 8: GillesdeH (small blind) folded on the Turn
Seat 9: PokerStarsMan12 (big blind) collected (567)



PokerStars Home Game Hand #228489090009: {DaPokaStars}  Hold'em No Limit (50/100) - 2021/07/22 15:55:34 ET
Table 'Halleria II' 9-max (Play Money) Seat #8 is the button
Seat 1: color_singleton (7803 in chips) 
Seat 2: JeBoyDirk (8293 in chips) 
Seat 8: GillesdeH (12511 in chips) 
Seat 9: PokerStarsMan12 (8229 in chips) 
PokerStarsMan12: posts small blind 50
color_singleton: posts big blind 100
*** HOLE CARDS ***
Dealt to PokerStarsMan12 [Jc 2d]
JeBoyDirk: calls 100
GillesdeH: calls 100
PokerStarsMan12: calls 50
color_singleton: raises 300 to 400
JeBoyDirk: calls 300
GillesdeH: calls 300
PokerStarsMan12: folds 
*** FLOP *** [6c 7c Kc]
color_singleton: checks 
JeBoyDirk: bets 800
GillesdeH: folds 
color_singleton: folds 
Uncalled bet (800) returned to JeBoyDirk
JeBoyDirk collected 1228 from pot
*** SUMMARY ***
Total pot 1300 | Rake 72 
Board [6c 7c Kc]
Seat 1: color_singleton (big blind) folded on the Flop
Seat 2: JeBoyDirk collected (1228)
Seat 8: GillesdeH (button) folded on the Flop
Seat 9: PokerStarsMan12 (small blind) folded before Flop



PokerStars Home Game Hand #228489101435: {DaPokaStars}  Hold'em No Limit (50/100) - 2021/07/22 15:56:09 ET
Table 'Halleria II' 9-max (Play Money) Seat #9 is the button
Seat 1: color_singleton (7403 in chips) 
Seat 2: JeBoyDirk (9121 in chips) 
Seat 8: GillesdeH (12111 in chips) 
Seat 9: PokerStarsMan12 (8129 in chips) 
color_singleton: posts small blind 50
JeBoyDirk: posts big blind 100
*** HOLE CARDS ***
Dealt to PokerStarsMan12 [6s Js]
GillesdeH: calls 100
PokerStarsMan12 has timed out
PokerStarsMan12: folds 
color_singleton: raises 200 to 300
JeBoyDirk: calls 200
GillesdeH: calls 200
*** FLOP *** [Ac 8c Qd]
color_singleton: bets 425
JeBoyDirk: folds 
GillesdeH: folds 
Uncalled bet (425) returned to color_singleton
color_singleton collected 850 from pot
color_singleton: doesn't show hand 
*** SUMMARY ***
Total pot 900 | Rake 50 
Board [Ac 8c Qd]
Seat 1: color_singleton (small blind) collected (850)
Seat 2: JeBoyDirk (big blind) folded on the Flop
Seat 8: GillesdeH folded on the Flop
Seat 9: PokerStarsMan12 (button) folded before Flop (didn't bet)



PokerStars Home Game Hand #228489117781: {DaPokaStars}  Hold'em No Limit (50/100) - 2021/07/22 15:56:58 ET
Table 'Halleria II' 9-max (Play Money) Seat #1 is the button
Seat 1: color_singleton (7953 in chips) 
Seat 2: JeBoyDirk (8821 in chips) 
Seat 8: GillesdeH (11811 in chips) 
Seat 9: PokerStarsMan12 (8129 in chips) 
JeBoyDirk: posts small blind 50
GillesdeH: posts big blind 100
*** HOLE CARDS ***
Dealt to PokerStarsMan12 [6h 4s]
PokerStarsMan12: folds 
color_singleton: raises 200 to 300
JeBoyDirk: folds 
GillesdeH: calls 200
*** FLOP *** [8d Jc 6d]
GillesdeH: checks 
color_singleton: bets 307
GillesdeH: calls 307
*** TURN *** [8d Jc 6d] [9s]
GillesdeH: checks 
color_singleton: checks 
*** RIVER *** [8d Jc 6d 9s] [Qh]
GillesdeH: checks 
color_singleton: checks 
*** SHOW DOWN ***
GillesdeH: shows [6s 2c] (a pair of Sixes)
color_singleton: shows [Ks 8s] (a pair of Eights)
color_singleton collected 1194 from pot
*** SUMMARY ***
Total pot 1264 | Rake 70 
Board [8d Jc 6d 9s Qh]
Seat 1: color_singleton (button) showed [Ks 8s] and won (1194) with a pair of Eights
Seat 2: JeBoyDirk (small blind) folded before Flop
Seat 8: GillesdeH (big blind) showed [6s 2c] and lost with a pair of Sixes
Seat 9: PokerStarsMan12 folded before Flop (didn't bet)



PokerStars Home Game Hand #228489131510: {DaPokaStars}  Hold'em No Limit (50/100) - 2021/07/22 15:57:39 ET
Table 'Halleria II' 9-max (Play Money) Seat #2 is the button
Seat 1: color_singleton (8540 in chips) 
Seat 2: JeBoyDirk (8771 in chips) 
Seat 8: GillesdeH (11204 in chips) 
Seat 9: PokerStarsMan12 (8129 in chips) 
GillesdeH: posts small blind 50
PokerStarsMan12: posts big blind 100
*** HOLE CARDS ***
Dealt to PokerStarsMan12 [Kc Jc]
color_singleton: raises 200 to 300
JeBoyDirk: folds 
GillesdeH: calls 250
PokerStarsMan12: calls 200
*** FLOP *** [5h Js 3d]
GillesdeH: checks 
PokerStarsMan12: bets 425
color_singleton: calls 425
GillesdeH: calls 425
*** TURN *** [5h Js 3d] [5d]
GillesdeH: checks 
PokerStarsMan12: bets 600
color_singleton: folds 
GillesdeH: folds 
Uncalled bet (600) returned to PokerStarsMan12
PokerStarsMan12 collected 2055 from pot
*** SUMMARY ***
Total pot 2175 | Rake 120 
Board [5h Js 3d 5d]
Seat 1: color_singleton folded on the Turn
Seat 2: JeBoyDirk (button) folded before Flop (didn't bet)
Seat 8: GillesdeH (small blind) folded on the Turn
Seat 9: PokerStarsMan12 (big blind) collected (2055)



PokerStars Home Game Hand #228489155454: {DaPokaStars}  Hold'em No Limit (50/100) - 2021/07/22 15:58:37 ET
Table 'Halleria II' 9-max (Play Money) Seat #8 is the button
Seat 1: color_singleton (7815 in chips) 
Seat 2: JeBoyDirk (8771 in chips) 
Seat 8: GillesdeH (10479 in chips) 
Seat 9: PokerStarsMan12 (9459 in chips) 
PokerStarsMan12: posts small blind 50
color_singleton: posts big blind 100
*** HOLE CARDS ***
Dealt to PokerStarsMan12 [6c 7c]
JeBoyDirk: calls 100
GillesdeH: calls 100
PokerStarsMan12: calls 50
color_singleton: checks 
*** FLOP *** [Jd 3s 2d]
PokerStarsMan12: checks 
color_singleton: checks 
JeBoyDirk: checks 
GillesdeH: checks 
*** TURN *** [Jd 3s 2d] [9c]
PokerStarsMan12: checks 
color_singleton: checks 
JeBoyDirk: checks 
GillesdeH: checks 
*** RIVER *** [Jd 3s 2d 9c] [Kh]
PokerStarsMan12: checks 
color_singleton: checks 
JeBoyDirk: checks 
GillesdeH: checks 
*** SHOW DOWN ***
PokerStarsMan12: shows [6c 7c] (high card King)
color_singleton: shows [Qc 5h] (high card King - Queen kicker)
JeBoyDirk: shows [Ac 5s] (high card Ace)
Klemtonius joins the table at seat #5 
GillesdeH: mucks hand 
JeBoyDirk collected 378 from pot
*** SUMMARY ***
Total pot 400 | Rake 22 
Board [Jd 3s 2d 9c Kh]
Seat 1: color_singleton (big blind) showed [Qc 5h] and lost with high card King
Seat 2: JeBoyDirk showed [Ac 5s] and won (378) with high card Ace
Seat 8: GillesdeH (button) mucked [4c 7d]
Seat 9: PokerStarsMan12 (small blind) showed [6c 7c] and lost with high card King



PokerStars Home Game Hand #228489166221: {DaPokaStars}  Hold'em No Limit (50/100) - 2021/07/22 15:59:09 ET
Table 'Halleria II' 9-max (Play Money) Seat #9 is the button
Seat 1: color_singleton (7715 in chips) 
Seat 2: JeBoyDirk (9049 in chips) 
Seat 5: Klemtonius (10000 in chips) 
Seat 8: GillesdeH (10379 in chips) 
Seat 9: PokerStarsMan12 (9359 in chips) 
color_singleton: posts small blind 50
JeBoyDirk: posts big blind 100
Klemtonius: posts big blind 100
*** HOLE CARDS ***
Dealt to PokerStarsMan12 [6h 3s]
Klemtonius: raises 100 to 200
GillesdeH: calls 200
PokerStarsMan12: folds 
color_singleton: folds 
JeBoyDirk: folds 
*** FLOP *** [6c Js Td]
Klemtonius: checks 
GillesdeH: checks 
*** TURN *** [6c Js Td] [3h]
Klemtonius: bets 260
GillesdeH: folds 
Uncalled bet (260) returned to Klemtonius
Klemtonius collected 520 from pot
Klemtonius: doesn't show hand 
*** SUMMARY ***
Total pot 550 | Rake 30 
Board [6c Js Td 3h]
Seat 1: color_singleton (small blind) folded before Flop
Seat 2: JeBoyDirk (big blind) folded before Flop
Seat 5: Klemtonius collected (520)
Seat 8: GillesdeH folded on the Turn
Seat 9: PokerStarsMan12 (button) folded before Flop (didn't bet)



PokerStars Home Game Hand #228489174092: {DaPokaStars}  Hold'em No Limit (50/100) - 2021/07/22 15:59:33 ET
Table 'Halleria II' 9-max (Play Money) Seat #1 is the button
Seat 1: color_singleton (7665 in chips) 
Seat 2: JeBoyDirk (8949 in chips) 
Seat 5: Klemtonius (10320 in chips) 
Seat 8: GillesdeH (10179 in chips) 
Seat 9: PokerStarsMan12 (9359 in chips) 
JeBoyDirk: posts small blind 50
Klemtonius: posts big blind 100
*** HOLE CARDS ***
Dealt to PokerStarsMan12 [6c 4h]
GillesdeH: calls 100
PokerStarsMan12: folds 
color_singleton has timed out
color_singleton: folds 
JeBoyDirk: calls 50
Klemtonius: checks 
*** FLOP *** [8c 3h 7c]
JeBoyDirk: checks 
Klemtonius: checks 
GillesdeH: checks 
*** TURN *** [8c 3h 7c] [4d]
JeBoyDirk: checks 
Klemtonius: checks 
GillesdeH: checks 
*** RIVER *** [8c 3h 7c 4d] [3c]
JeBoyDirk: checks 
Klemtonius: checks 
GillesdeH: checks 
*** SHOW DOWN ***
JeBoyDirk: shows [5d As] (a pair of Threes)
Klemtonius: mucks hand 
GillesdeH: shows [2d Ah] (a pair of Threes)
JeBoyDirk collected 142 from pot
GillesdeH collected 141 from pot
*** SUMMARY ***
Total pot 300 | Rake 17 
Board [8c 3h 7c 4d 3c]
Seat 1: color_singleton (button) folded before Flop (didn't bet)
Seat 2: JeBoyDirk (small blind) showed [5d As] and won (142) with a pair of Threes
Seat 5: Klemtonius (big blind) mucked [6d 9c]
Seat 8: GillesdeH showed [2d Ah] and won (141) with a pair of Threes
Seat 9: PokerStarsMan12 folded before Flop (didn't bet)



PokerStars Home Game Hand #228489194764: {DaPokaStars}  Hold'em No Limit (50/100) - 2021/07/22 16:00:32 ET
Table 'Halleria II' 9-max (Play Money) Seat #2 is the button
Seat 2: JeBoyDirk (8991 in chips) 
Seat 5: Klemtonius (10220 in chips) 
Seat 8: GillesdeH (10220 in chips) 
Seat 9: PokerStarsMan12 (9359 in chips) 
Klemtonius: posts small blind 50
GillesdeH: posts big blind 100
*** HOLE CARDS ***
Dealt to PokerStarsMan12 [8h 4d]
PokerStarsMan12 has timed out
PokerStarsMan12: folds 
JeBoyDirk: raises 200 to 300
Klemtonius: raises 200 to 500
GillesdeH: folds 
JeBoyDirk: calls 200
*** FLOP *** [9d 7h Qs]
Klemtonius: bets 1039
JeBoyDirk: folds 
Uncalled bet (1039) returned to Klemtonius
Klemtonius collected 1039 from pot
Klemtonius: doesn't show hand 
*** SUMMARY ***
Total pot 1100 | Rake 61 
Board [9d 7h Qs]
Seat 2: JeBoyDirk (button) folded on the Flop
Seat 5: Klemtonius (small blind) collected (1039)
Seat 8: GillesdeH (big blind) folded before Flop
Seat 9: PokerStarsMan12 folded before Flop (didn't bet)



PokerStars Home Game Hand #228489293201: {DaPokaStars}  Hold'em No Limit (50/100) - 2021/07/22 16:04:17 ET
Table 'Halleria II' 9-max (Play Money) Seat #5 is the button
Seat 1: color_singleton (7315 in chips) 
Seat 2: JeBoyDirk (9903 in chips) 
Seat 5: Klemtonius (10484 in chips) 
Seat 8: GillesdeH (9053 in chips) 
Seat 9: PokerStarsMan12 (9359 in chips) 
GillesdeH: posts small blind 50
PokerStarsMan12: posts big blind 100
*** HOLE CARDS ***
Dealt to PokerStarsMan12 [4c Ac]
color_singleton: raises 200 to 300
JeBoyDirk: folds 
Klemtonius: folds 
GillesdeH: calls 250
PokerStarsMan12: calls 200
*** FLOP *** [Qd Ts 9d]
GillesdeH: checks 
PokerStarsMan12: checks 
color_singleton: bets 425
GillesdeH: folds 
PokerStarsMan12: calls 425
*** TURN *** [Qd Ts 9d] [Ah]
PokerStarsMan12: bets 900
color_singleton: calls 900
*** RIVER *** [Qd Ts 9d Ah] [7s]
PokerStarsMan12: checks 
color_singleton: checks 
*** SHOW DOWN ***
PokerStarsMan12: shows [4c Ac] (a pair of Aces)
color_singleton: shows [Ad 9s] (two pair, Aces and Nines)
color_singleton collected 3355 from pot
*** SUMMARY ***
Total pot 3550 | Rake 195 
Board [Qd Ts 9d Ah 7s]
Seat 1: color_singleton showed [Ad 9s] and won (3355) with two pair, Aces and Nines
Seat 2: JeBoyDirk folded before Flop (didn't bet)
Seat 5: Klemtonius (button) folded before Flop (didn't bet)
Seat 8: GillesdeH (small blind) folded on the Flop
Seat 9: PokerStarsMan12 (big blind) showed [4c Ac] and lost with a pair of Aces



PokerStars Home Game Hand #228489325467: {DaPokaStars}  Hold'em No Limit (50/100) - 2021/07/22 16:05:14 ET
Table 'Halleria II' 9-max (Play Money) Seat #8 is the button
Seat 1: color_singleton (9045 in chips) 
Seat 2: JeBoyDirk (9903 in chips) 
Seat 5: Klemtonius (10484 in chips) 
Seat 8: GillesdeH (8753 in chips) 
Seat 9: PokerStarsMan12 (7734 in chips) 
PokerStarsMan12: posts small blind 50
color_singleton: posts big blind 100
*** HOLE CARDS ***
Dealt to PokerStarsMan12 [4c 6h]
JeBoyDirk: folds 
Klemtonius: calls 100
GillesdeH: calls 100
PokerStarsMan12: calls 50
color_singleton: raises 200 to 300
Klemtonius: folds 
GillesdeH: folds 
PokerStarsMan12: calls 200
*** FLOP *** [Kh 2c Tc]
PokerStarsMan12: checks 
color_singleton: bets 378
PokerStarsMan12: folds 
Uncalled bet (378) returned to color_singleton
color_singleton collected 756 from pot
color_singleton: doesn't show hand 
*** SUMMARY ***
Total pot 800 | Rake 44 
Board [Kh 2c Tc]
Seat 1: color_singleton (big blind) collected (756)
Seat 2: JeBoyDirk folded before Flop (didn't bet)
Seat 5: Klemtonius folded before Flop
Seat 8: GillesdeH (button) folded before Flop
Seat 9: PokerStarsMan12 (small blind) folded on the Flop



PokerStars Home Game Hand #228489342114: {DaPokaStars}  Hold'em No Limit (50/100) - 2021/07/22 16:05:49 ET
Table 'Halleria II' 9-max (Play Money) Seat #9 is the button
Seat 1: color_singleton (9501 in chips) 
Seat 2: JeBoyDirk (9903 in chips) 
Seat 5: Klemtonius (10384 in chips) 
Seat 8: GillesdeH (8653 in chips) 
Seat 9: PokerStarsMan12 (7434 in chips) 
color_singleton: posts small blind 50
JeBoyDirk: posts big blind 100
*** HOLE CARDS ***
Dealt to PokerStarsMan12 [Js Jh]
Klemtonius: calls 100
GillesdeH: folds 
PokerStarsMan12: raises 300 to 400
color_singleton: folds 
JeBoyDirk has timed out
JeBoyDirk: folds 
Klemtonius: calls 300
*** FLOP *** [Ts Tc Kh]
Klemtonius: checks 
PokerStarsMan12: bets 600
Klemtonius: folds 
Uncalled bet (600) returned to PokerStarsMan12
PokerStarsMan12 collected 898 from pot
*** SUMMARY ***
Total pot 950 | Rake 52 
Board [Ts Tc Kh]
Seat 1: color_singleton (small blind) folded before Flop
Seat 2: JeBoyDirk (big blind) folded before Flop
Seat 5: Klemtonius folded on the Flop
Seat 8: GillesdeH folded before Flop (didn't bet)
Seat 9: PokerStarsMan12 (button) collected (898)



PokerStars Home Game Hand #228489373845: {DaPokaStars}  Hold'em No Limit (50/100) - 2021/07/22 16:06:46 ET
Table 'Halleria II' 9-max (Play Money) Seat #1 is the button
Seat 1: color_singleton (9451 in chips) 
Seat 2: JeBoyDirk (9803 in chips) 
Seat 5: Klemtonius (9984 in chips) 
Seat 8: GillesdeH (8653 in chips) 
Seat 9: PokerStarsMan12 (7932 in chips) 
JeBoyDirk: posts small blind 50
Klemtonius: posts big blind 100
*** HOLE CARDS ***
Dealt to PokerStarsMan12 [3s Jc]
GillesdeH: folds 
PokerStarsMan12: folds 
color_singleton: raises 200 to 300
JeBoyDirk: calls 250
Klemtonius: folds 
*** FLOP *** [4c Jh 6d]
JeBoyDirk: checks 
color_singleton: checks 
*** TURN *** [4c Jh 6d] [Th]
JeBoyDirk: checks 
color_singleton: checks 
*** RIVER *** [4c Jh 6d Th] [Js]
JeBoyDirk: bets 300
color_singleton: calls 300
*** SHOW DOWN ***
JeBoyDirk: shows [9s Td] (two pair, Jacks and Tens)
color_singleton: mucks hand 
JeBoyDirk collected 1228 from pot
*** SUMMARY ***
Total pot 1300 | Rake 72 
Board [4c Jh 6d Th Js]
Seat 1: color_singleton (button) mucked [2d Ad]
Seat 2: JeBoyDirk (small blind) showed [9s Td] and won (1228) with two pair, Jacks and Tens
Seat 5: Klemtonius (big blind) folded before Flop
Seat 8: GillesdeH folded before Flop (didn't bet)
Seat 9: PokerStarsMan12 folded before Flop (didn't bet)



PokerStars Home Game Hand #228489399980: {DaPokaStars}  Hold'em No Limit (50/100) - 2021/07/22 16:07:42 ET
Table 'Halleria II' 9-max (Play Money) Seat #2 is the button
Seat 1: color_singleton (8851 in chips) 
Seat 2: JeBoyDirk (10431 in chips) 
Seat 5: Klemtonius (9884 in chips) 
Seat 8: GillesdeH (8653 in chips) 
Seat 9: PokerStarsMan12 (7932 in chips) 
Klemtonius: posts small blind 50
GillesdeH: posts big blind 100
*** HOLE CARDS ***
Dealt to PokerStarsMan12 [Jc 5h]
PokerStarsMan12: folds 
color_singleton: folds 
JeBoyDirk: folds 
Klemtonius: calls 50
GillesdeH: checks 
*** FLOP *** [Td 6c Kh]
Klemtonius: bets 100
GillesdeH: folds 
Uncalled bet (100) returned to Klemtonius
Klemtonius collected 189 from pot
Klemtonius: doesn't show hand 
*** SUMMARY ***
Total pot 200 | Rake 11 
Board [Td 6c Kh]
Seat 1: color_singleton folded before Flop (didn't bet)
Seat 2: JeBoyDirk (button) folded before Flop (didn't bet)
Seat 5: Klemtonius (small blind) collected (189)
Seat 8: GillesdeH (big blind) folded on the Flop
Seat 9: PokerStarsMan12 folded before Flop (didn't bet)



PokerStars Home Game Hand #228489407405: {DaPokaStars}  Hold'em No Limit (50/100) - 2021/07/22 16:07:58 ET
Table 'Halleria II' 9-max (Play Money) Seat #5 is the button
Seat 1: color_singleton (8851 in chips) 
Seat 2: JeBoyDirk (10431 in chips) 
Seat 5: Klemtonius (9973 in chips) 
Seat 8: GillesdeH (8553 in chips) 
Seat 9: PokerStarsMan12 (7932 in chips) 
GillesdeH: posts small blind 50
PokerStarsMan12: posts big blind 100
*** HOLE CARDS ***
Dealt to PokerStarsMan12 [2c 2s]
color_singleton: folds 
JeBoyDirk: folds 
Klemtonius: raises 100 to 200
GillesdeH: folds 
PokerStarsMan12: calls 100
*** FLOP *** [6s 7s 5s]
PokerStarsMan12: bets 212
Klemtonius: folds 
Uncalled bet (212) returned to PokerStarsMan12
PokerStarsMan12 collected 425 from pot
*** SUMMARY ***
Total pot 450 | Rake 25 
Board [6s 7s 5s]
Seat 1: color_singleton folded before Flop (didn't bet)
Seat 2: JeBoyDirk folded before Flop (didn't bet)
Seat 5: Klemtonius (button) folded on the Flop
Seat 8: GillesdeH (small blind) folded before Flop
Seat 9: PokerStarsMan12 (big blind) collected (425)



PokerStars Home Game Hand #228489421841: {DaPokaStars}  Hold'em No Limit (50/100) - 2021/07/22 16:08:28 ET
Table 'Halleria II' 9-max (Play Money) Seat #8 is the button
Seat 1: color_singleton (8851 in chips) 
Seat 2: JeBoyDirk (10431 in chips) 
Seat 5: Klemtonius (9773 in chips) 
Seat 8: GillesdeH (8503 in chips) 
Seat 9: PokerStarsMan12 (8157 in chips) 
PokerStarsMan12: posts small blind 50
color_singleton: posts big blind 100
*** HOLE CARDS ***
Dealt to PokerStarsMan12 [Qs 5h]
JeBoyDirk: folds 
Klemtonius: raises 250 to 350
GillesdeH: calls 350
PokerStarsMan12: folds 
color_singleton: calls 250
*** FLOP *** [2c 2h Td]
color_singleton: checks 
Klemtonius: checks 
GillesdeH: checks 
*** TURN *** [2c 2h Td] [2d]
color_singleton: checks 
Klemtonius: checks 
GillesdeH: checks 
*** RIVER *** [2c 2h Td 2d] [8c]
color_singleton: bets 519
Klemtonius: raises 519 to 1038
GillesdeH: folds 
color_singleton: calls 519
*** SHOW DOWN ***
Klemtonius: shows [As 2s] (four of a kind, Deuces)
color_singleton: mucks hand 
Klemtonius collected 3001 from pot
*** SUMMARY ***
Total pot 3176 | Rake 175 
Board [2c 2h Td 2d 8c]
Seat 1: color_singleton (big blind) mucked [8s 7c]
Seat 2: JeBoyDirk folded before Flop (didn't bet)
Seat 5: Klemtonius showed [As 2s] and won (3001) with four of a kind, Deuces
Seat 8: GillesdeH (button) folded on the River
Seat 9: PokerStarsMan12 (small blind) folded before Flop



PokerStars Home Game Hand #228489450873: {DaPokaStars}  Hold'em No Limit (50/100) - 2021/07/22 16:09:30 ET
Table 'Halleria II' 9-max (Play Money) Seat #9 is the button
Seat 1: color_singleton (7463 in chips) 
Seat 2: JeBoyDirk (10431 in chips) 
Seat 5: Klemtonius (11386 in chips) 
Seat 8: GillesdeH (8153 in chips) 
Seat 9: PokerStarsMan12 (8107 in chips) 
color_singleton: posts small blind 50
JeBoyDirk: posts big blind 100
*** HOLE CARDS ***
Dealt to PokerStarsMan12 [9s 4c]
Klemtonius: calls 100
GillesdeH: calls 100
PokerStarsMan12: folds 
color_singleton: calls 50
JeBoyDirk: checks 
*** FLOP *** [Jc 8s 5c]
color_singleton: checks 
JeBoyDirk: checks 
Klemtonius: checks 
GillesdeH: bets 500
color_singleton: folds 
JeBoyDirk: folds 
Klemtonius: calls 500
*** TURN *** [Jc 8s 5c] [7d]
Klemtonius: checks 
GillesdeH: bets 1323
Klemtonius: folds 
Uncalled bet (1323) returned to GillesdeH
GillesdeH collected 1323 from pot
*** SUMMARY ***
Total pot 1400 | Rake 77 
Board [Jc 8s 5c 7d]
Seat 1: color_singleton (small blind) folded on the Flop
Seat 2: JeBoyDirk (big blind) folded on the Flop
Seat 5: Klemtonius folded on the Turn
Seat 8: GillesdeH collected (1323)
Seat 9: PokerStarsMan12 (button) folded before Flop (didn't bet)



PokerStars Home Game Hand #228489485397: {DaPokaStars}  Hold'em No Limit (50/100) - 2021/07/22 16:10:44 ET
Table 'Halleria II' 9-max (Play Money) Seat #1 is the button
Seat 1: color_singleton (7363 in chips) 
Seat 2: JeBoyDirk (10331 in chips) 
Seat 5: Klemtonius (10786 in chips) 
Seat 8: GillesdeH (8876 in chips) 
Seat 9: PokerStarsMan12 (8107 in chips) 
JeBoyDirk: posts small blind 50
Klemtonius: posts big blind 100
*** HOLE CARDS ***
Dealt to PokerStarsMan12 [Kc 7h]
GillesdeH: calls 100
PokerStarsMan12: folds 
color_singleton: raises 400 to 500
JeBoyDirk: folds 
Klemtonius is connected 
Klemtonius: folds 
GillesdeH: folds 
Uncalled bet (400) returned to color_singleton
color_singleton collected 350 from pot
color_singleton: doesn't show hand 
*** SUMMARY ***
Total pot 350 | Rake 0 
Seat 1: color_singleton (button) collected (350)
Seat 2: JeBoyDirk (small blind) folded before Flop
Seat 5: Klemtonius (big blind) folded before Flop
Seat 8: GillesdeH folded before Flop
Seat 9: PokerStarsMan12 folded before Flop (didn't bet)



PokerStars Home Game Hand #228489497938: {DaPokaStars}  Hold'em No Limit (50/100) - 2021/07/22 16:11:11 ET
Table 'Halleria II' 9-max (Play Money) Seat #2 is the button
Seat 1: color_singleton (7613 in chips) 
Seat 2: JeBoyDirk (10281 in chips) 
Seat 5: Klemtonius (10686 in chips) 
Seat 8: GillesdeH (8776 in chips) 
Seat 9: PokerStarsMan12 (8107 in chips) 
Klemtonius: posts small blind 50
GillesdeH: posts big blind 100
*** HOLE CARDS ***
Dealt to PokerStarsMan12 [Td 4s]
PokerStarsMan12: folds 
color_singleton: raises 200 to 300
JeBoyDirk: folds 
Klemtonius: calls 250
GillesdeH: folds 
*** FLOP *** [Jh Ks Kd]
Klemtonius: bets 100
color_singleton: calls 100
*** TURN *** [Jh Ks Kd] [6h]
Klemtonius: bets 100
color_singleton: calls 100
*** RIVER *** [Jh Ks Kd 6h] [8s]
Klemtonius: bets 100
color_singleton: folds 
Uncalled bet (100) returned to Klemtonius
Klemtonius collected 1039 from pot
Klemtonius: doesn't show hand 
*** SUMMARY ***
Total pot 1100 | Rake 61 
Board [Jh Ks Kd 6h 8s]
Seat 1: color_singleton folded on the River
Seat 2: JeBoyDirk (button) folded before Flop (didn't bet)
Seat 5: Klemtonius (small blind) collected (1039)
Seat 8: GillesdeH (big blind) folded before Flop
Seat 9: PokerStarsMan12 folded before Flop (didn't bet)



PokerStars Home Game Hand #228489526255: {DaPokaStars}  Hold'em No Limit (50/100) - 2021/07/22 16:12:11 ET
Table 'Halleria II' 9-max (Play Money) Seat #5 is the button
Seat 1: color_singleton (7113 in chips) 
Seat 2: JeBoyDirk (10281 in chips) 
Seat 5: Klemtonius (11225 in chips) 
Seat 8: GillesdeH (8676 in chips) 
Seat 9: PokerStarsMan12 (8107 in chips) 
GillesdeH: posts small blind 50
PokerStarsMan12: posts big blind 100
*** HOLE CARDS ***
Dealt to PokerStarsMan12 [Ts 3c]
color_singleton: calls 100
JeBoyDirk: folds 
Klemtonius: calls 100
GillesdeH: folds 
PokerStarsMan12: checks 
*** FLOP *** [Jc 2h Kd]
PokerStarsMan12: checks 
color_singleton: checks 
Klemtonius: checks 
*** TURN *** [Jc 2h Kd] [2c]
PokerStarsMan12: checks 
color_singleton: checks 
Klemtonius: checks 
*** RIVER *** [Jc 2h Kd 2c] [3s]
PokerStarsMan12: bets 165
color_singleton: folds 
Klemtonius: folds 
Uncalled bet (165) returned to PokerStarsMan12
PokerStarsMan12 collected 331 from pot
*** SUMMARY ***
Total pot 350 | Rake 19 
Board [Jc 2h Kd 2c 3s]
Seat 1: color_singleton folded on the River
Seat 2: JeBoyDirk folded before Flop (didn't bet)
Seat 5: Klemtonius (button) folded on the River
Seat 8: GillesdeH (small blind) folded before Flop
Seat 9: PokerStarsMan12 (big blind) collected (331)



PokerStars Home Game Hand #228489549536: {DaPokaStars}  Hold'em No Limit (50/100) - 2021/07/22 16:13:01 ET
Table 'Halleria II' 9-max (Play Money) Seat #8 is the button
Seat 1: color_singleton (7013 in chips) 
Seat 2: JeBoyDirk (10281 in chips) 
Seat 5: Klemtonius (11125 in chips) 
Seat 8: GillesdeH (8626 in chips) 
Seat 9: PokerStarsMan12 (8338 in chips) 
PokerStarsMan12: posts small blind 50
color_singleton: posts big blind 100
*** HOLE CARDS ***
Dealt to PokerStarsMan12 [Qc As]
JeBoyDirk: folds 
Klemtonius: calls 100
GillesdeH: calls 100
PokerStarsMan12: raises 300 to 400
color_singleton: folds 
Klemtonius: calls 300
GillesdeH: calls 300
*** FLOP *** [Jd 8s 3h]
PokerStarsMan12: checks 
Klemtonius: checks 
GillesdeH: checks 
*** TURN *** [Jd 8s 3h] [8d]
PokerStarsMan12: checks 
Klemtonius: checks 
GillesdeH: checks 
*** RIVER *** [Jd 8s 3h 8d] [5d]
PokerStarsMan12: checks 
Klemtonius: checks 
GillesdeH: checks 
*** SHOW DOWN ***
PokerStarsMan12: shows [Qc As] (a pair of Eights)
Klemtonius: mucks hand 
GillesdeH: mucks hand 
PokerStarsMan12 collected 1228 from pot
*** SUMMARY ***
Total pot 1300 | Rake 72 
Board [Jd 8s 3h 8d 5d]
Seat 1: color_singleton (big blind) folded before Flop
Seat 2: JeBoyDirk folded before Flop (didn't bet)
Seat 5: Klemtonius mucked [Qh 6h]
Seat 8: GillesdeH (button) mucked [Qs Td]
Seat 9: PokerStarsMan12 (small blind) showed [Qc As] and won (1228) with a pair of Eights



PokerStars Home Game Hand #228489590249: {DaPokaStars}  Hold'em No Limit (50/100) - 2021/07/22 16:14:28 ET
Table 'Halleria II' 9-max (Play Money) Seat #9 is the button
Seat 1: color_singleton (6913 in chips) 
Seat 2: JeBoyDirk (10281 in chips) 
Seat 5: Klemtonius (10725 in chips) 
Seat 8: GillesdeH (8226 in chips) 
Seat 9: PokerStarsMan12 (9166 in chips) 
color_singleton: posts small blind 50
JeBoyDirk: posts big blind 100
*** HOLE CARDS ***
Dealt to PokerStarsMan12 [Jd Ts]
Klemtonius: folds 
GillesdeH: calls 100
PokerStarsMan12: raises 300 to 400
color_singleton: folds 
JeBoyDirk: folds 
GillesdeH: calls 300
*** FLOP *** [Kd 3h Ks]
GillesdeH: bets 898
PokerStarsMan12: folds 
Uncalled bet (898) returned to GillesdeH
GillesdeH collected 898 from pot
*** SUMMARY ***
Total pot 950 | Rake 52 
Board [Kd 3h Ks]
Seat 1: color_singleton (small blind) folded before Flop
Seat 2: JeBoyDirk (big blind) folded before Flop
Seat 5: Klemtonius folded before Flop (didn't bet)
Seat 8: GillesdeH collected (898)
Seat 9: PokerStarsMan12 (button) folded on the Flop



PokerStars Home Game Hand #228489605887: {DaPokaStars}  Hold'em No Limit (50/100) - 2021/07/22 16:15:01 ET
Table 'Halleria II' 9-max (Play Money) Seat #1 is the button
Seat 1: color_singleton (6863 in chips) 
Seat 2: JeBoyDirk (10181 in chips) 
Seat 5: Klemtonius (10725 in chips) 
Seat 8: GillesdeH (8724 in chips) 
Seat 9: PokerStarsMan12 (8766 in chips) 
JeBoyDirk: posts small blind 50
Klemtonius: posts big blind 100
*** HOLE CARDS ***
Dealt to PokerStarsMan12 [9c 6c]
GillesdeH: calls 100
PokerStarsMan12: calls 100
color_singleton: calls 100
JeBoyDirk: folds 
Klemtonius: checks 
*** FLOP *** [6h 6d 4h]
Klemtonius: bets 425
GillesdeH: calls 425
PokerStarsMan12: calls 425
color_singleton: folds 
*** TURN *** [6h 6d 4h] [Js]
Klemtonius: checks 
GillesdeH: checks 
PokerStarsMan12: bets 1000
Klemtonius: calls 1000
GillesdeH: calls 1000
*** RIVER *** [6h 6d 4h Js] [3c]
Klemtonius: checks 
GillesdeH: checks 
PokerStarsMan12: bets 2000
Klemtonius: folds 
GillesdeH: folds 
Uncalled bet (2000) returned to PokerStarsMan12
PokerStarsMan12 collected 4465 from pot
*** SUMMARY ***
Total pot 4725 | Rake 260 
Board [6h 6d 4h Js 3c]
Seat 1: color_singleton (button) folded on the Flop
Seat 2: JeBoyDirk (small blind) folded before Flop
Seat 5: Klemtonius (big blind) folded on the River
Seat 8: GillesdeH folded on the River
Seat 9: PokerStarsMan12 collected (4465)



PokerStars Home Game Hand #228489630406: {DaPokaStars}  Hold'em No Limit (50/100) - 2021/07/22 16:15:52 ET
Table 'Halleria II' 9-max (Play Money) Seat #2 is the button
Seat 1: color_singleton (6763 in chips) 
Seat 2: JeBoyDirk (10131 in chips) 
Seat 5: Klemtonius (9200 in chips) 
Seat 8: GillesdeH (7199 in chips) 
Seat 9: PokerStarsMan12 (11706 in chips) 
Klemtonius: posts small blind 50
GillesdeH: posts big blind 100
*** HOLE CARDS ***
Dealt to PokerStarsMan12 [Jh Ac]
PokerStarsMan12: raises 300 to 400
color_singleton: calls 400
JeBoyDirk: folds 
Klemtonius: folds 
GillesdeH: calls 300
*** FLOP *** [5d Qc Kh]
GillesdeH: bets 590
PokerStarsMan12: folds 
color_singleton: calls 590
*** TURN *** [5d Qc Kh] [5h]
GillesdeH: checks 
color_singleton: checks 
*** RIVER *** [5d Qc Kh 5h] [9s]
GillesdeH: bets 2296
color_singleton: folds 
Uncalled bet (2296) returned to GillesdeH
GillesdeH collected 2296 from pot
*** SUMMARY ***
Total pot 2430 | Rake 134 
Board [5d Qc Kh 5h 9s]
Seat 1: color_singleton folded on the River
Seat 2: JeBoyDirk (button) folded before Flop (didn't bet)
Seat 5: Klemtonius (small blind) folded before Flop
Seat 8: GillesdeH (big blind) collected (2296)
Seat 9: PokerStarsMan12 folded on the Flop



PokerStars Home Game Hand #228489653068: {DaPokaStars}  Hold'em No Limit (50/100) - 2021/07/22 16:16:39 ET
Table 'Halleria II' 9-max (Play Money) Seat #5 is the button
Seat 1: color_singleton (5773 in chips) 
Seat 2: JeBoyDirk (10131 in chips) 
Seat 5: Klemtonius (9150 in chips) 
Seat 8: GillesdeH (8505 in chips) 
Seat 9: PokerStarsMan12 (11306 in chips) 
GillesdeH: posts small blind 50
PokerStarsMan12: posts big blind 100
*** HOLE CARDS ***
Dealt to PokerStarsMan12 [Tc 2h]
color_singleton: folds 
JeBoyDirk: folds 
Klemtonius: calls 100
GillesdeH: calls 50
PokerStarsMan12: checks 
*** FLOP *** [7c Qs 6d]
GillesdeH: checks 
PokerStarsMan12: checks 
Klemtonius: checks 
*** TURN *** [7c Qs 6d] [2s]
GillesdeH: checks 
PokerStarsMan12: bets 200
Klemtonius: calls 200
GillesdeH: folds 
*** RIVER *** [7c Qs 6d 2s] [9d]
PokerStarsMan12: checks 
Klemtonius: checks 
*** SHOW DOWN ***
PokerStarsMan12: shows [Tc 2h] (a pair of Deuces)
Klemtonius: mucks hand 
PokerStarsMan12 collected 661 from pot
*** SUMMARY ***
Total pot 700 | Rake 39 
Board [7c Qs 6d 2s 9d]
Seat 1: color_singleton folded before Flop (didn't bet)
Seat 2: JeBoyDirk folded before Flop (didn't bet)
Seat 5: Klemtonius (button) mucked [8s Kd]
Seat 8: GillesdeH (small blind) folded on the Turn
Seat 9: PokerStarsMan12 (big blind) showed [Tc 2h] and won (661) with a pair of Deuces



PokerStars Home Game Hand #228489675720: {DaPokaStars}  Hold'em No Limit (50/100) - 2021/07/22 16:17:25 ET
Table 'Halleria II' 9-max (Play Money) Seat #8 is the button
Seat 1: color_singleton (5773 in chips) 
Seat 2: JeBoyDirk (10131 in chips) 
Seat 5: Klemtonius (8850 in chips) 
Seat 8: GillesdeH (8405 in chips) 
Seat 9: PokerStarsMan12 (11667 in chips) 
PokerStarsMan12: posts small blind 50
color_singleton: posts big blind 100
*** HOLE CARDS ***
Dealt to PokerStarsMan12 [Qh 6h]
JeBoyDirk: folds 
Klemtonius: calls 100
GillesdeH: calls 100
PokerStarsMan12: calls 50
color_singleton: checks 
*** FLOP *** [4d Kh Js]
PokerStarsMan12: checks 
color_singleton: checks 
Klemtonius: checks 
GillesdeH: checks 
*** TURN *** [4d Kh Js] [3s]
PokerStarsMan12: checks 
color_singleton: bets 189
Klemtonius: folds 
GillesdeH: calls 189
PokerStarsMan12: folds 
*** RIVER *** [4d Kh Js 3s] [8h]
color_singleton: bets 735
GillesdeH: folds 
Uncalled bet (735) returned to color_singleton
color_singleton collected 735 from pot
color_singleton: doesn't show hand 
*** SUMMARY ***
Total pot 778 | Rake 43 
Board [4d Kh Js 3s 8h]
Seat 1: color_singleton (big blind) collected (735)
Seat 2: JeBoyDirk folded before Flop (didn't bet)
Seat 5: Klemtonius folded on the Turn
Seat 8: GillesdeH (button) folded on the River
Seat 9: PokerStarsMan12 (small blind) folded on the Turn



PokerStars Home Game Hand #228489719058: {DaPokaStars}  Hold'em No Limit (50/100) - 2021/07/22 16:18:54 ET
Table 'Halleria II' 9-max (Play Money) Seat #9 is the button
Seat 1: color_singleton (6219 in chips) 
Seat 2: JeBoyDirk (10131 in chips) 
Seat 5: Klemtonius (8750 in chips) 
Seat 8: GillesdeH (8116 in chips) 
Seat 9: PokerStarsMan12 (11567 in chips) 
color_singleton: posts small blind 50
JeBoyDirk: posts big blind 100
*** HOLE CARDS ***
Dealt to PokerStarsMan12 [Js 5d]
Klemtonius: calls 100
GillesdeH: calls 100
PokerStarsMan12: folds 
color_singleton: raises 300 to 400
JeBoyDirk: folds 
Klemtonius: calls 300
GillesdeH: calls 300
*** FLOP *** [Jd Tc 2d]
color_singleton: bets 614
Klemtonius: folds 
GillesdeH: folds 
Uncalled bet (614) returned to color_singleton
color_singleton collected 1228 from pot
color_singleton: doesn't show hand 
*** SUMMARY ***
Total pot 1300 | Rake 72 
Board [Jd Tc 2d]
Seat 1: color_singleton (small blind) collected (1228)
Seat 2: JeBoyDirk (big blind) folded before Flop
Seat 5: Klemtonius folded on the Flop
Seat 8: GillesdeH folded on the Flop
Seat 9: PokerStarsMan12 (button) folded before Flop (didn't bet)



PokerStars Home Game Hand #228489740375: {DaPokaStars}  Hold'em No Limit (50/100) - 2021/07/22 16:19:38 ET
Table 'Halleria II' 9-max (Play Money) Seat #1 is the button
Seat 1: color_singleton (7047 in chips) 
Seat 2: JeBoyDirk (10031 in chips) 
Seat 5: Klemtonius (8350 in chips) 
Seat 8: GillesdeH (7716 in chips) 
Seat 9: PokerStarsMan12 (11567 in chips) 
JeBoyDirk: posts small blind 50
Klemtonius: posts big blind 100
*** HOLE CARDS ***
Dealt to PokerStarsMan12 [9d 5d]
GillesdeH: calls 100
PokerStarsMan12: calls 100
color_singleton: folds 
JeBoyDirk: folds 
Klemtonius: checks 
*** FLOP *** [5c Kd Jc]
Klemtonius: checks 
GillesdeH: checks 
PokerStarsMan12: checks 
*** TURN *** [5c Kd Jc] [Td]
Klemtonius: checks 
GillesdeH: checks 
PokerStarsMan12: bets 200
Klemtonius: folds 
GillesdeH: folds 
Uncalled bet (200) returned to PokerStarsMan12
PokerStarsMan12 collected 331 from pot
*** SUMMARY ***
Total pot 350 | Rake 19 
Board [5c Kd Jc Td]
Seat 1: color_singleton (button) folded before Flop (didn't bet)
Seat 2: JeBoyDirk (small blind) folded before Flop
Seat 5: Klemtonius (big blind) folded on the Turn
Seat 8: GillesdeH folded on the Turn
Seat 9: PokerStarsMan12 collected (331)



PokerStars Home Game Hand #228489754685: {DaPokaStars}  Hold'em No Limit (50/100) - 2021/07/22 16:20:07 ET
Table 'Halleria II' 9-max (Play Money) Seat #2 is the button
Seat 1: color_singleton (7047 in chips) 
Seat 2: JeBoyDirk (9981 in chips) 
Seat 5: Klemtonius (8250 in chips) 
Seat 8: GillesdeH (7616 in chips) 
Seat 9: PokerStarsMan12 (11798 in chips) 
Klemtonius: posts small blind 50
GillesdeH: posts big blind 100
*** HOLE CARDS ***
Dealt to PokerStarsMan12 [8s 4s]
PokerStarsMan12: folds 
color_singleton: folds 
JeBoyDirk: folds 
Klemtonius: calls 50
GillesdeH: checks 
*** FLOP *** [Qs 4c Kc]
Klemtonius: checks 
GillesdeH: bets 500
dockstarr joins the table at seat #3 
Klemtonius: folds 
Uncalled bet (500) returned to GillesdeH
GillesdeH collected 189 from pot
*** SUMMARY ***
Total pot 200 | Rake 11 
Board [Qs 4c Kc]
Seat 1: color_singleton folded before Flop (didn't bet)
Seat 2: JeBoyDirk (button) folded before Flop (didn't bet)
Seat 5: Klemtonius (small blind) folded on the Flop
Seat 8: GillesdeH (big blind) collected (189)
Seat 9: PokerStarsMan12 folded before Flop (didn't bet)



PokerStars Home Game Hand #228489782677: {DaPokaStars}  Hold'em No Limit (50/100) - 2021/07/22 16:20:46 ET
Table 'Halleria II' 9-max (Play Money) Seat #5 is the button
Seat 1: color_singleton (7047 in chips) 
Seat 2: JeBoyDirk (9981 in chips) 
Seat 3: dockstarr (10000 in chips) 
Seat 5: Klemtonius (8150 in chips) 
Seat 8: GillesdeH (7705 in chips) 
Seat 9: PokerStarsMan12 (11798 in chips) 
GillesdeH: posts small blind 50
PokerStarsMan12: posts big blind 100
dockstarr: posts big blind 100
*** HOLE CARDS ***
Dealt to PokerStarsMan12 [5c 8h]
color_singleton: folds 
JeBoyDirk: calls 100
dockstarr: checks 
Klemtonius: calls 100
GillesdeH: calls 50
PokerStarsMan12: checks 
*** FLOP *** [Kc 3d 3c]
GillesdeH: checks 
PokerStarsMan12: checks 
JeBoyDirk: checks 
dockstarr: checks 
Klemtonius: checks 
*** TURN *** [Kc 3d 3c] [7s]
GillesdeH: checks 
PokerStarsMan12: checks 
JeBoyDirk: checks 
dockstarr: checks 
Klemtonius: checks 
*** RIVER *** [Kc 3d 3c 7s] [8s]
GillesdeH: checks 
PokerStarsMan12: bets 300
JeBoyDirk: folds 
dockstarr: folds 
Klemtonius: folds 
GillesdeH: calls 300
*** SHOW DOWN ***
PokerStarsMan12: shows [5c 8h] (two pair, Eights and Threes)
GillesdeH: mucks hand 
PokerStarsMan12 collected 1039 from pot
*** SUMMARY ***
Total pot 1100 | Rake 61 
Board [Kc 3d 3c 7s 8s]
Seat 1: color_singleton folded before Flop (didn't bet)
Seat 2: JeBoyDirk folded on the River
Seat 3: dockstarr folded on the River (didn't bet)
Seat 5: Klemtonius (button) folded on the River
Seat 8: GillesdeH (small blind) mucked [Qc 6d]
Seat 9: PokerStarsMan12 (big blind) showed [5c 8h] and won (1039) with two pair, Eights and Threes



PokerStars Home Game Hand #228489818535: {DaPokaStars}  Hold'em No Limit (50/100) - 2021/07/22 16:21:59 ET
Table 'Halleria II' 9-max (Play Money) Seat #8 is the button
Seat 1: color_singleton (7047 in chips) 
Seat 2: JeBoyDirk (9881 in chips) 
Seat 3: dockstarr (9900 in chips) 
Seat 5: Klemtonius (8050 in chips) 
Seat 8: GillesdeH (7305 in chips) 
Seat 9: PokerStarsMan12 (12437 in chips) 
PokerStarsMan12: posts small blind 50
color_singleton: posts big blind 100
*** HOLE CARDS ***
Dealt to PokerStarsMan12 [4c 9h]
JeBoyDirk has timed out
JeBoyDirk: folds 
dockstarr: folds 
Klemtonius: raises 250 to 350
GillesdeH: calls 350
PokerStarsMan12: folds 
color_singleton: calls 250
*** FLOP *** [Td 9d 3h]
color_singleton: checks 
Klemtonius: bets 1039
GillesdeH: folds 
color_singleton: folds 
Uncalled bet (1039) returned to Klemtonius
Klemtonius collected 1039 from pot
Klemtonius: doesn't show hand 
*** SUMMARY ***
Total pot 1100 | Rake 61 
Board [Td 9d 3h]
Seat 1: color_singleton (big blind) folded on the Flop
Seat 2: JeBoyDirk folded before Flop (didn't bet)
Seat 3: dockstarr folded before Flop (didn't bet)
Seat 5: Klemtonius collected (1039)
Seat 8: GillesdeH (button) folded on the Flop
Seat 9: PokerStarsMan12 (small blind) folded before Flop



PokerStars Home Game Hand #228489845334: {DaPokaStars}  Hold'em No Limit (50/100) - 2021/07/22 16:22:54 ET
Table 'Halleria II' 9-max (Play Money) Seat #9 is the button
Seat 1: color_singleton (6697 in chips) 
Seat 5: Klemtonius (8739 in chips) 
Seat 8: GillesdeH (6955 in chips) 
Seat 9: PokerStarsMan12 (12387 in chips) 
color_singleton: posts small blind 50
Klemtonius: posts big blind 100
*** HOLE CARDS ***
Dealt to PokerStarsMan12 [5c 4c]
GillesdeH: calls 100
PokerStarsMan12: calls 100
color_singleton: calls 50
Klemtonius: raises 100 to 200
GillesdeH: folds 
PokerStarsMan12: calls 100
color_singleton: calls 100
*** FLOP *** [Kh Jh 2h]
color_singleton: checks 
Klemtonius: bets 100
PokerStarsMan12: folds 
color_singleton: folds 
Uncalled bet (100) returned to Klemtonius
Klemtonius collected 661 from pot
Klemtonius: doesn't show hand 
*** SUMMARY ***
Total pot 700 | Rake 39 
Board [Kh Jh 2h]
Seat 1: color_singleton (small blind) folded on the Flop
Seat 5: Klemtonius (big blind) collected (661)
Seat 8: GillesdeH folded before Flop
Seat 9: PokerStarsMan12 (button) folded on the Flop



PokerStars Home Game Hand #228489865662: {DaPokaStars}  Hold'em No Limit (50/100) - 2021/07/22 16:23:36 ET
Table 'Halleria II' 9-max (Play Money) Seat #1 is the button
Seat 1: color_singleton (6497 in chips) 
Seat 5: Klemtonius (9200 in chips) 
Seat 8: GillesdeH (6855 in chips) 
Seat 9: PokerStarsMan12 (12187 in chips) 
Klemtonius: posts small blind 50
GillesdeH: posts big blind 100
*** HOLE CARDS ***
Dealt to PokerStarsMan12 [2c Th]
PokerStarsMan12: folds 
color_singleton: calls 100
Klemtonius: calls 50
GillesdeH: checks 
*** FLOP *** [Js Qc 6d]
Klemtonius: checks 
GillesdeH: checks 
color_singleton: checks 
*** TURN *** [Js Qc 6d] [2h]
Klemtonius: checks 
GillesdeH: checks 
color_singleton: checks 
*** RIVER *** [Js Qc 6d 2h] [4d]
Klemtonius: checks 
GillesdeH: bets 600
color_singleton: folds 
Klemtonius: folds 
Uncalled bet (600) returned to GillesdeH
GillesdeH collected 283 from pot
*** SUMMARY ***
Total pot 300 | Rake 17 
Board [Js Qc 6d 2h 4d]
Seat 1: color_singleton (button) folded on the River
Seat 5: Klemtonius (small blind) folded on the River
Seat 8: GillesdeH (big blind) collected (283)
Seat 9: PokerStarsMan12 folded before Flop (didn't bet)



PokerStars Home Game Hand #228489884923: {DaPokaStars}  Hold'em No Limit (50/100) - 2021/07/22 16:24:16 ET
Table 'Halleria II' 9-max (Play Money) Seat #5 is the button
Seat 1: color_singleton (6397 in chips) 
Seat 3: dockstarr (9900 in chips) 
Seat 5: Klemtonius (9100 in chips) 
Seat 8: GillesdeH (7038 in chips) 
Seat 9: PokerStarsMan12 (12187 in chips) 
GillesdeH: posts small blind 50
PokerStarsMan12: posts big blind 100
dockstarr: posts small & big blinds 150
*** HOLE CARDS ***
Dealt to PokerStarsMan12 [5c 3h]
color_singleton: raises 200 to 300
dockstarr: calls 200
Klemtonius: calls 300
GillesdeH: calls 250
PokerStarsMan12: folds 
*** FLOP *** [8h Td 8s]
GillesdeH: checks 
color_singleton: bets 1276
dockstarr: folds 
Klemtonius: calls 1276
GillesdeH: folds 
*** TURN *** [8h Td 8s] [2d]
color_singleton: bets 3687
Klemtonius: folds 
Uncalled bet (3687) returned to color_singleton
color_singleton collected 3687 from pot
color_singleton: doesn't show hand 
*** SUMMARY ***
Total pot 3902 | Rake 215 
Board [8h Td 8s 2d]
Seat 1: color_singleton collected (3687)
Seat 3: dockstarr folded on the Flop
Seat 5: Klemtonius (button) folded on the Turn
Seat 8: GillesdeH (small blind) folded on the Flop
Seat 9: PokerStarsMan12 (big blind) folded before Flop



PokerStars Home Game Hand #228489911491: {DaPokaStars}  Hold'em No Limit (50/100) - 2021/07/22 16:25:11 ET
Table 'Halleria II' 9-max (Play Money) Seat #8 is the button
Seat 1: color_singleton (8508 in chips) 
Seat 2: JeBoyDirk (9881 in chips) 
Seat 3: dockstarr (9550 in chips) 
Seat 5: Klemtonius (7524 in chips) 
Seat 8: GillesdeH (6738 in chips) 
Seat 9: PokerStarsMan12 (12087 in chips) 
PokerStarsMan12: posts small blind 50
color_singleton: posts big blind 100
JeBoyDirk: posts small & big blinds 150
*** HOLE CARDS ***
Dealt to PokerStarsMan12 [3s 6d]
JeBoyDirk: checks 
dockstarr: calls 100
Klemtonius: folds 
GillesdeH: folds 
PokerStarsMan12: calls 50
color_singleton: raises 200 to 300
JeBoyDirk: folds 
dockstarr: calls 200
PokerStarsMan12: folds 
*** FLOP *** [Js 9c Tc]
color_singleton: checks 
dockstarr: checks 
*** TURN *** [Js 9c Tc] [8c]
color_singleton: bets 401
dockstarr: calls 401
*** RIVER *** [Js 9c Tc 8c] [Kh]
color_singleton: checks 
dockstarr: checks 
*** SHOW DOWN ***
color_singleton: shows [5h 6c] (high card King)
dockstarr: shows [2s Ks] (a pair of Kings)
dockstarr collected 1561 from pot
*** SUMMARY ***
Total pot 1652 | Rake 91 
Board [Js 9c Tc 8c Kh]
Seat 1: color_singleton (big blind) showed [5h 6c] and lost with high card King
Seat 2: JeBoyDirk folded before Flop (didn't bet)
Seat 3: dockstarr showed [2s Ks] and won (1561) with a pair of Kings
Seat 5: Klemtonius folded before Flop (didn't bet)
Seat 8: GillesdeH (button) folded before Flop (didn't bet)
Seat 9: PokerStarsMan12 (small blind) folded before Flop



PokerStars Home Game Hand #228489937047: {DaPokaStars}  Hold'em No Limit (50/100) - 2021/07/22 16:26:03 ET
Table 'Halleria II' 9-max (Play Money) Seat #9 is the button
Seat 1: color_singleton (7807 in chips) 
Seat 2: JeBoyDirk (9731 in chips) 
Seat 3: dockstarr (10410 in chips) 
Seat 5: Klemtonius (7524 in chips) 
Seat 8: GillesdeH (6738 in chips) 
Seat 9: PokerStarsMan12 (11987 in chips) 
color_singleton: posts small blind 50
JeBoyDirk: posts big blind 100
*** HOLE CARDS ***
Dealt to PokerStarsMan12 [2s Jc]
dockstarr: folds 
Klemtonius: raises 100 to 200
GillesdeH: calls 200
PokerStarsMan12: folds 
color_singleton: calls 150
JeBoyDirk: folds 
*** FLOP *** [Ac Qc Jd]
color_singleton: bets 330
Klemtonius: raises 1321 to 1651
GillesdeH: calls 1651
color_singleton: folds 
*** TURN *** [Ac Qc Jd] [6h]
Klemtonius: bets 5673 and is all-in
GillesdeH: folds 
Uncalled bet (5673) returned to Klemtonius
Klemtonius collected 4094 from pot
Klemtonius: doesn't show hand 
*** SUMMARY ***
Total pot 4332 | Rake 238 
Board [Ac Qc Jd 6h]
Seat 1: color_singleton (small blind) folded on the Flop
Seat 2: JeBoyDirk (big blind) folded before Flop
Seat 3: dockstarr folded before Flop (didn't bet)
Seat 5: Klemtonius collected (4094)
Seat 8: GillesdeH folded on the Turn
Seat 9: PokerStarsMan12 (button) folded before Flop (didn't bet)



PokerStars Home Game Hand #228489968445: {DaPokaStars}  Hold'em No Limit (50/100) - 2021/07/22 16:27:02 ET
Table 'Halleria II' 9-max (Play Money) Seat #1 is the button
Seat 1: color_singleton (7277 in chips) 
Seat 2: JeBoyDirk (9631 in chips) 
Seat 3: dockstarr (10410 in chips) 
Seat 5: Klemtonius (9767 in chips) 
Seat 8: GillesdeH (4887 in chips) 
Seat 9: PokerStarsMan12 (11987 in chips) 
JeBoyDirk: posts small blind 50
dockstarr: posts big blind 100
*** HOLE CARDS ***
Dealt to PokerStarsMan12 [Th 4h]
Klemtonius: folds 
GillesdeH: folds 
PokerStarsMan12: folds 
color_singleton: raises 200 to 300
JeBoyDirk: calls 250
dockstarr: calls 200
*** FLOP *** [Jc Td 2h]
JeBoyDirk: checks 
dockstarr: bets 100
color_singleton: calls 100
JeBoyDirk: calls 100
*** TURN *** [Jc Td 2h] [8s]
JeBoyDirk: checks 
dockstarr: checks 
color_singleton: checks 
*** RIVER *** [Jc Td 2h 8s] [2c]
JeBoyDirk: checks 
dockstarr: checks 
color_singleton: checks 
*** SHOW DOWN ***
JeBoyDirk: shows [9h 6h] (a pair of Deuces)
dockstarr: shows [Kh Ac] (a pair of Deuces - Ace kicker)
color_singleton: mucks hand 
dockstarr collected 1134 from pot
*** SUMMARY ***
Total pot 1200 | Rake 66 
Board [Jc Td 2h 8s 2c]
Seat 1: color_singleton (button) mucked [Kd 5h]
Seat 2: JeBoyDirk (small blind) showed [9h 6h] and lost with a pair of Deuces
Seat 3: dockstarr (big blind) showed [Kh Ac] and won (1134) with a pair of Deuces
Seat 5: Klemtonius folded before Flop (didn't bet)
Seat 8: GillesdeH folded before Flop (didn't bet)
Seat 9: PokerStarsMan12 folded before Flop (didn't bet)



PokerStars Home Game Hand #228489991601: {DaPokaStars}  Hold'em No Limit (50/100) - 2021/07/22 16:27:50 ET
Table 'Halleria II' 9-max (Play Money) Seat #2 is the button
Seat 1: color_singleton (6877 in chips) 
Seat 2: JeBoyDirk (9231 in chips) 
Seat 3: dockstarr (11144 in chips) 
Seat 5: Klemtonius (9767 in chips) 
Seat 8: GillesdeH (4887 in chips) 
Seat 9: PokerStarsMan12 (11987 in chips) 
dockstarr: posts small blind 50
Klemtonius: posts big blind 100
*** HOLE CARDS ***
Dealt to PokerStarsMan12 [7d 7c]
GillesdeH: calls 100
PokerStarsMan12: raises 300 to 400
color_singleton: folds 
JeBoyDirk: folds 
dockstarr: folds 
Klemtonius: calls 300
GillesdeH: calls 300
*** FLOP *** [Td 6s Kh]
Klemtonius: checks 
GillesdeH: bets 1181
PokerStarsMan12: folds 
Klemtonius: folds 
Uncalled bet (1181) returned to GillesdeH
GillesdeH collected 1181 from pot
*** SUMMARY ***
Total pot 1250 | Rake 69 
Board [Td 6s Kh]
Seat 1: color_singleton folded before Flop (didn't bet)
Seat 2: JeBoyDirk (button) folded before Flop (didn't bet)
Seat 3: dockstarr (small blind) folded before Flop
Seat 5: Klemtonius (big blind) folded on the Flop
Seat 8: GillesdeH collected (1181)
Seat 9: PokerStarsMan12 folded on the Flop



PokerStars Home Game Hand #228490010778: {DaPokaStars}  Hold'em No Limit (50/100) - 2021/07/22 16:28:30 ET
Table 'Halleria II' 9-max (Play Money) Seat #3 is the button
Seat 1: color_singleton (6877 in chips) 
Seat 2: JeBoyDirk (9231 in chips) 
Seat 3: dockstarr (11094 in chips) 
Seat 5: Klemtonius (9367 in chips) 
Seat 8: GillesdeH (5668 in chips) 
Seat 9: PokerStarsMan12 (11587 in chips) 
Klemtonius: posts small blind 50
GillesdeH: posts big blind 100
*** HOLE CARDS ***
Dealt to PokerStarsMan12 [4c 7c]
PokerStarsMan12: folds 
color_singleton: folds 
JeBoyDirk: calls 100
dockstarr: folds 
Klemtonius: calls 50
GillesdeH: checks 
*** FLOP *** [7h 6c 3h]
Klemtonius: bets 283
GillesdeH: folds 
JeBoyDirk: folds 
Uncalled bet (283) returned to Klemtonius
Klemtonius collected 283 from pot
Klemtonius: doesn't show hand 
*** SUMMARY ***
Total pot 300 | Rake 17 
Board [7h 6c 3h]
Seat 1: color_singleton folded before Flop (didn't bet)
Seat 2: JeBoyDirk folded on the Flop
Seat 3: dockstarr (button) folded before Flop (didn't bet)
Seat 5: Klemtonius (small blind) collected (283)
Seat 8: GillesdeH (big blind) folded on the Flop
Seat 9: PokerStarsMan12 folded before Flop (didn't bet)



PokerStars Home Game Hand #228490023382: {DaPokaStars}  Hold'em No Limit (50/100) - 2021/07/22 16:28:55 ET
Table 'Halleria II' 9-max (Play Money) Seat #5 is the button
Seat 1: color_singleton (6877 in chips) 
Seat 2: JeBoyDirk (9131 in chips) 
Seat 3: dockstarr (11094 in chips) 
Seat 5: Klemtonius (9550 in chips) 
Seat 8: GillesdeH (5568 in chips) 
Seat 9: PokerStarsMan12 (11587 in chips) 
GillesdeH: posts small blind 50
PokerStarsMan12: posts big blind 100
*** HOLE CARDS ***
Dealt to PokerStarsMan12 [Qc Qs]
color_singleton: raises 200 to 300
JeBoyDirk: folds 
dockstarr: folds 
Klemtonius: calls 300
GillesdeH: calls 250
PokerStarsMan12: raises 700 to 1000
color_singleton: calls 700
Klemtonius: calls 700
GillesdeH: calls 700
*** FLOP *** [7c 9h 5h]
GillesdeH: checks 
PokerStarsMan12: bets 1800
color_singleton: raises 1800 to 3600
Klemtonius: calls 3600
GillesdeH: calls 3600
PokerStarsMan12: folds 
*** TURN *** [7c 9h 5h] [5c]
GillesdeH: checks 
color_singleton: checks 
Klemtonius: checks 
*** RIVER *** [7c 9h 5h 5c] [8c]
GillesdeH: bets 968 and is all-in
color_singleton: calls 968
Klemtonius: folds 
*** SHOW DOWN ***
GillesdeH: shows [Ah 6h] (a straight, Five to Nine)
color_singleton: shows [Jd 9d] (two pair, Nines and Fives)
GillesdeH collected 17517 from pot
*** SUMMARY ***
Total pot 18536 | Rake 1019 
Board [7c 9h 5h 5c 8c]
Seat 1: color_singleton showed [Jd 9d] and lost with two pair, Nines and Fives
Seat 2: JeBoyDirk folded before Flop (didn't bet)
Seat 3: dockstarr folded before Flop (didn't bet)
Seat 5: Klemtonius (button) folded on the River
Seat 8: GillesdeH (small blind) showed [Ah 6h] and won (17517) with a straight, Five to Nine
Seat 9: PokerStarsMan12 (big blind) folded on the Flop



PokerStars Home Game Hand #228490069992: {DaPokaStars}  Hold'em No Limit (50/100) - 2021/07/22 16:30:32 ET
Table 'Halleria II' 9-max (Play Money) Seat #8 is the button
Seat 1: color_singleton (1309 in chips) 
Seat 2: JeBoyDirk (9131 in chips) 
Seat 3: dockstarr (11094 in chips) 
Seat 5: Klemtonius (4950 in chips) 
Seat 8: GillesdeH (17517 in chips) 
Seat 9: PokerStarsMan12 (8787 in chips) 
PokerStarsMan12: posts small blind 50
color_singleton: posts big blind 100
*** HOLE CARDS ***
Dealt to PokerStarsMan12 [9c 7c]
JeBoyDirk: folds 
dockstarr: calls 100
Klemtonius: calls 100
GillesdeH: calls 100
PokerStarsMan12: calls 50
color_singleton: raises 500 to 600
dockstarr: calls 500
Klemtonius: folds 
GillesdeH: calls 500
PokerStarsMan12: calls 500
*** FLOP *** [7d 4s 4c]
PokerStarsMan12: bets 1181
color_singleton: calls 709 and is all-in
dockstarr: folds 
GillesdeH: folds 
Uncalled bet (472) returned to PokerStarsMan12
*** TURN *** [7d 4s 4c] [8h]
*** RIVER *** [7d 4s 4c 8h] [3d]
*** SHOW DOWN ***
PokerStarsMan12: shows [9c 7c] (two pair, Sevens and Fours)
color_singleton: shows [2h Ac] (a pair of Fours)
PokerStarsMan12 collected 3703 from pot
*** SUMMARY ***
Total pot 3918 | Rake 215 
Board [7d 4s 4c 8h 3d]
Seat 1: color_singleton (big blind) showed [2h Ac] and lost with a pair of Fours
Seat 2: JeBoyDirk folded before Flop (didn't bet)
Seat 3: dockstarr folded on the Flop
Seat 5: Klemtonius folded before Flop
Seat 8: GillesdeH (button) folded on the Flop
Seat 9: PokerStarsMan12 (small blind) showed [9c 7c] and won (3703) with two pair, Sevens and Fours



PokerStars Home Game Hand #228490099401: {DaPokaStars}  Hold'em No Limit (50/100) - 2021/07/22 16:31:33 ET
Table 'Halleria II' 9-max (Play Money) Seat #9 is the button
Seat 2: JeBoyDirk (9131 in chips) 
Seat 3: dockstarr (10494 in chips) 
Seat 5: Klemtonius (4850 in chips) 
Seat 8: GillesdeH (16917 in chips) 
Seat 9: PokerStarsMan12 (11181 in chips) 
JeBoyDirk: posts small blind 50
dockstarr: posts big blind 100
*** HOLE CARDS ***
Dealt to PokerStarsMan12 [9c 8d]
Klemtonius: calls 100
GillesdeH: calls 100
PokerStarsMan12: raises 300 to 400
JeBoyDirk: folds 
dockstarr: calls 300
Klemtonius: folds 
GillesdeH: calls 300
*** FLOP *** [4h Jd Tc]
dockstarr: bets 100
GillesdeH: calls 100
PokerStarsMan12: raises 650 to 750
dockstarr: calls 650
GillesdeH: calls 650
*** TURN *** [4h Jd Tc] [3d]
dockstarr: checks 
GillesdeH: checks 
PokerStarsMan12: checks 
*** RIVER *** [4h Jd Tc 3d] [8c]
dockstarr: checks 
GillesdeH: checks 
PokerStarsMan12: checks 
*** SHOW DOWN ***
dockstarr: shows [9s Jh] (a pair of Jacks)
GillesdeH: mucks hand 
PokerStarsMan12: mucks hand 
dockstarr collected 3402 from pot
*** SUMMARY ***
Total pot 3600 | Rake 198 
Board [4h Jd Tc 3d 8c]
Seat 2: JeBoyDirk (small blind) folded before Flop
Seat 3: dockstarr (big blind) showed [9s Jh] and won (3402) with a pair of Jacks
Seat 5: Klemtonius folded before Flop
Seat 8: GillesdeH mucked [7d Ts]
Seat 9: PokerStarsMan12 (button) mucked [9c 8d]



PokerStars Home Game Hand #228490137395: {DaPokaStars}  Hold'em No Limit (50/100) - 2021/07/22 16:32:52 ET
Table 'Halleria II' 9-max (Play Money) Seat #2 is the button
Seat 1: color_singleton (10000 in chips) 
Seat 2: JeBoyDirk (9081 in chips) 
Seat 3: dockstarr (12746 in chips) 
Seat 5: Klemtonius (4750 in chips) 
Seat 8: GillesdeH (15767 in chips) 
Seat 9: PokerStarsMan12 (10031 in chips) 
dockstarr: posts small blind 50
Klemtonius: posts big blind 100
color_singleton: posts small blind 50
*** HOLE CARDS ***
Dealt to PokerStarsMan12 [Tc 7c]
GillesdeH: calls 100
PokerStarsMan12: calls 100
color_singleton: calls 100
JeBoyDirk has timed out
JeBoyDirk: folds 
dockstarr: calls 50
Klemtonius: checks 
*** FLOP *** [Jc Jd 3h]
dockstarr: checks 
Klemtonius: checks 
GillesdeH: checks 
PokerStarsMan12: checks 
color_singleton: checks 
*** TURN *** [Jc Jd 3h] [Qc]
dockstarr: bets 100
Klemtonius: raises 100 to 200
GillesdeH: folds 
PokerStarsMan12: calls 200
color_singleton: folds 
dockstarr: calls 100
*** RIVER *** [Jc Jd 3h Qc] [Th]
dockstarr: checks 
Klemtonius: bets 543
PokerStarsMan12: calls 543
dockstarr: calls 543
*** SHOW DOWN ***
Klemtonius: shows [Ah Qd] (two pair, Queens and Jacks)
PokerStarsMan12: mucks hand 
dockstarr: mucks hand 
Klemtonius collected 2626 from pot
*** SUMMARY ***
Total pot 2779 | Rake 153 
Board [Jc Jd 3h Qc Th]
Seat 1: color_singleton folded on the Turn
Seat 2: JeBoyDirk (button) folded before Flop (didn't bet)
Seat 3: dockstarr (small blind) mucked [5d Qh]
Seat 5: Klemtonius (big blind) showed [Ah Qd] and won (2626) with two pair, Queens and Jacks
Seat 8: GillesdeH folded on the Turn
Seat 9: PokerStarsMan12 mucked [Tc 7c]



PokerStars Home Game Hand #228490175910: {DaPokaStars}  Hold'em No Limit (50/100) - 2021/07/22 16:34:12 ET
Table 'Halleria II' 9-max (Play Money) Seat #3 is the button
Seat 1: color_singleton (9850 in chips) 
Seat 3: dockstarr (11903 in chips) 
Seat 5: Klemtonius (6533 in chips) 
Seat 8: GillesdeH (15667 in chips) 
Seat 9: PokerStarsMan12 (9188 in chips) 
Klemtonius: posts small blind 50
GillesdeH: posts big blind 100
*** HOLE CARDS ***
Dealt to PokerStarsMan12 [Jd Qs]
PokerStarsMan12: raises 200 to 300
color_singleton: calls 300
dockstarr: folds 
Klemtonius: calls 250
GillesdeH: folds 
*** FLOP *** [4d 8c 7c]
Klemtonius: checks 
PokerStarsMan12: checks 
color_singleton: bets 945
Klemtonius: folds 
PokerStarsMan12: folds 
Uncalled bet (945) returned to color_singleton
color_singleton collected 945 from pot
color_singleton: doesn't show hand 
*** SUMMARY ***
Total pot 1000 | Rake 55 
Board [4d 8c 7c]
Seat 1: color_singleton collected (945)
Seat 3: dockstarr (button) folded before Flop (didn't bet)
Seat 5: Klemtonius (small blind) folded on the Flop
Seat 8: GillesdeH (big blind) folded before Flop
Seat 9: PokerStarsMan12 folded on the Flop



PokerStars Home Game Hand #228490197798: {DaPokaStars}  Hold'em No Limit (50/100) - 2021/07/22 16:34:57 ET
Table 'Halleria II' 9-max (Play Money) Seat #5 is the button
Seat 1: color_singleton (10495 in chips) 
Seat 3: dockstarr (11903 in chips) 
Seat 5: Klemtonius (6233 in chips) 
Seat 8: GillesdeH (15567 in chips) 
Seat 9: PokerStarsMan12 (8888 in chips) 
GillesdeH: posts small blind 50
PokerStarsMan12: posts big blind 100
*** HOLE CARDS ***
Dealt to PokerStarsMan12 [Qd 8c]
color_singleton: raises 200 to 300
dockstarr: calls 300
Klemtonius: calls 300
GillesdeH: folds 
PokerStarsMan12: calls 200
*** FLOP *** [5h Kc 2s]
PokerStarsMan12: checks 
color_singleton: checks 
dockstarr: checks 
Klemtonius: checks 
*** TURN *** [5h Kc 2s] [Tc]
PokerStarsMan12: checks 
color_singleton: bets 590
dockstarr: folds 
Klemtonius: calls 590
PokerStarsMan12: folds 
*** RIVER *** [5h Kc 2s Tc] [3s]
color_singleton: bets 1148
Klemtonius: folds 
Uncalled bet (1148) returned to color_singleton
color_singleton collected 2296 from pot
color_singleton: doesn't show hand 
*** SUMMARY ***
Total pot 2430 | Rake 134 
Board [5h Kc 2s Tc 3s]
Seat 1: color_singleton collected (2296)
Seat 3: dockstarr folded on the Turn
Seat 5: Klemtonius (button) folded on the River
Seat 8: GillesdeH (small blind) folded before Flop
Seat 9: PokerStarsMan12 (big blind) folded on the Turn



PokerStars Home Game Hand #228490217256: {DaPokaStars}  Hold'em No Limit (50/100) - 2021/07/22 16:35:37 ET
Table 'Halleria II' 9-max (Play Money) Seat #8 is the button
Seat 1: color_singleton (11901 in chips) 
Seat 2: JeBoyDirk (9081 in chips) 
Seat 3: dockstarr (11603 in chips) 
Seat 5: Klemtonius (5343 in chips) 
Seat 8: GillesdeH (15517 in chips) 
Seat 9: PokerStarsMan12 (8588 in chips) 
PokerStarsMan12: posts small blind 50
color_singleton: posts big blind 100
*** HOLE CARDS ***
Dealt to PokerStarsMan12 [7c 5s]
JeBoyDirk: calls 100
dockstarr: calls 100
Klemtonius: folds 
GillesdeH: calls 100
PokerStarsMan12: calls 50
color_singleton: raises 200 to 300
JeBoyDirk: calls 200
dockstarr: folds 
GillesdeH: calls 200
PokerStarsMan12: calls 200
*** FLOP *** [3d Ks Th]
PokerStarsMan12: checks 
color_singleton: bets 614
JeBoyDirk: folds 
GillesdeH: calls 614
PokerStarsMan12: folds 
*** TURN *** [3d Ks Th] [As]
color_singleton: checks 
GillesdeH: checks 
*** RIVER *** [3d Ks Th As] [2d]
color_singleton: checks 
GillesdeH: bets 2389
color_singleton: folds 
Uncalled bet (2389) returned to GillesdeH
GillesdeH collected 2389 from pot
*** SUMMARY ***
Total pot 2528 | Rake 139 
Board [3d Ks Th As 2d]
Seat 1: color_singleton (big blind) folded on the River
Seat 2: JeBoyDirk folded on the Flop
Seat 3: dockstarr folded before Flop
Seat 5: Klemtonius folded before Flop (didn't bet)
Seat 8: GillesdeH (button) collected (2389)
Seat 9: PokerStarsMan12 (small blind) folded on the Flop



PokerStars Home Game Hand #228490240380: {DaPokaStars}  Hold'em No Limit (50/100) - 2021/07/22 16:36:25 ET
Table 'Halleria II' 9-max (Play Money) Seat #9 is the button
Seat 1: color_singleton (10987 in chips) 
Seat 2: JeBoyDirk (8781 in chips) 
Seat 3: dockstarr (11503 in chips) 
Seat 5: Klemtonius (5343 in chips) 
Seat 8: GillesdeH (16992 in chips) 
Seat 9: PokerStarsMan12 (8288 in chips) 
color_singleton: posts small blind 50
JeBoyDirk: posts big blind 100
*** HOLE CARDS ***
Dealt to PokerStarsMan12 [Th Qd]
dockstarr: calls 100
Klemtonius: calls 100
GillesdeH: calls 100
PokerStarsMan12: calls 100
color_singleton: raises 200 to 300
JeBoyDirk: calls 200
dockstarr: calls 200
Klemtonius: calls 200
GillesdeH: calls 200
PokerStarsMan12: calls 200
*** FLOP *** [Ad Jc 2d]
color_singleton: bets 850
JeBoyDirk: folds 
dockstarr: folds 
Klemtonius: folds 
GillesdeH: folds 
PokerStarsMan12: folds 
Uncalled bet (850) returned to color_singleton
color_singleton collected 1701 from pot
color_singleton: doesn't show hand 
*** SUMMARY ***
Total pot 1800 | Rake 99 
Board [Ad Jc 2d]
Seat 1: color_singleton (small blind) collected (1701)
Seat 2: JeBoyDirk (big blind) folded on the Flop
Seat 3: dockstarr folded on the Flop
Seat 5: Klemtonius folded on the Flop
Seat 8: GillesdeH folded on the Flop
Seat 9: PokerStarsMan12 (button) folded on the Flop



PokerStars Home Game Hand #228490261010: {DaPokaStars}  Hold'em No Limit (50/100) - 2021/07/22 16:37:08 ET
Table 'Halleria II' 9-max (Play Money) Seat #1 is the button
Seat 1: color_singleton (12388 in chips) 
Seat 2: JeBoyDirk (8481 in chips) 
Seat 3: dockstarr (11203 in chips) 
Seat 5: Klemtonius (5043 in chips) 
Seat 8: GillesdeH (16692 in chips) 
Seat 9: PokerStarsMan12 (7988 in chips) 
JeBoyDirk: posts small blind 50
dockstarr: posts big blind 100
*** HOLE CARDS ***
Dealt to PokerStarsMan12 [8s Qs]
Klemtonius: folds 
GillesdeH: calls 100
PokerStarsMan12: calls 100
color_singleton: folds 
JeBoyDirk: folds 
dockstarr: checks 
*** FLOP *** [Qc 4h Jd]
dockstarr: checks 
GillesdeH: checks 
PokerStarsMan12: bets 300
dockstarr: calls 300
GillesdeH: calls 300
*** TURN *** [Qc 4h Jd] [Td]
dockstarr: checks 
GillesdeH: checks 
PokerStarsMan12: bets 600
dockstarr: calls 600
GillesdeH: calls 600
*** RIVER *** [Qc 4h Jd Td] [4c]
dockstarr: checks 
GillesdeH: checks 
PokerStarsMan12: bets 1000
dockstarr: raises 1000 to 2000
GillesdeH: folds 
PokerStarsMan12: folds 
Uncalled bet (1000) returned to dockstarr
dockstarr collected 4772 from pot
dockstarr: doesn't show hand 
*** SUMMARY ***
Total pot 5050 | Rake 278 
Board [Qc 4h Jd Td 4c]
Seat 1: color_singleton (button) folded before Flop (didn't bet)
Seat 2: JeBoyDirk (small blind) folded before Flop
Seat 3: dockstarr (big blind) collected (4772)
Seat 5: Klemtonius folded before Flop (didn't bet)
Seat 8: GillesdeH folded on the River
Seat 9: PokerStarsMan12 folded on the River



PokerStars Home Game Hand #228490306083: {DaPokaStars}  Hold'em No Limit (50/100) - 2021/07/22 16:38:39 ET
Table 'Halleria II' 9-max (Play Money) Seat #2 is the button
Seat 1: color_singleton (12388 in chips) 
Seat 2: JeBoyDirk (8431 in chips) 
Seat 3: dockstarr (13975 in chips) 
Seat 5: Klemtonius (5043 in chips) 
Seat 8: GillesdeH (15692 in chips) 
Seat 9: PokerStarsMan12 (5988 in chips) 
dockstarr: posts small blind 50
Klemtonius: posts big blind 100
*** HOLE CARDS ***
Dealt to PokerStarsMan12 [Jc Qs]
GillesdeH: calls 100
PokerStarsMan12: raises 300 to 400
color_singleton: folds 
JeBoyDirk: folds 
dockstarr: folds 
Klemtonius: calls 300
GillesdeH: calls 300
*** FLOP *** [6h 5c 9c]
Klemtonius: checks 
GillesdeH: checks 
PokerStarsMan12: checks 
*** TURN *** [6h 5c 9c] [Th]
Klemtonius: checks 
GillesdeH: checks 
PokerStarsMan12: checks 
*** RIVER *** [6h 5c 9c Th] [8s]
Klemtonius: checks 
GillesdeH: bets 1181
PokerStarsMan12: raises 1819 to 3000
Klemtonius: folds 
GillesdeH: folds 
Uncalled bet (1819) returned to PokerStarsMan12
PokerStarsMan12 collected 3413 from pot
*** SUMMARY ***
Total pot 3612 | Rake 199 
Board [6h 5c 9c Th 8s]
Seat 1: color_singleton folded before Flop (didn't bet)
Seat 2: JeBoyDirk (button) folded before Flop (didn't bet)
Seat 3: dockstarr (small blind) folded before Flop
Seat 5: Klemtonius (big blind) folded on the River
Seat 8: GillesdeH folded on the River
Seat 9: PokerStarsMan12 collected (3413)



PokerStars Home Game Hand #228490341099: {DaPokaStars}  Hold'em No Limit (50/100) - 2021/07/22 16:39:52 ET
Table 'Halleria II' 9-max (Play Money) Seat #3 is the button
Seat 1: color_singleton (12388 in chips) 
Seat 2: JeBoyDirk (8431 in chips) 
Seat 3: dockstarr (13925 in chips) 
Seat 5: Klemtonius (4643 in chips) 
Seat 8: GillesdeH (14111 in chips) 
Seat 9: PokerStarsMan12 (7820 in chips) 
Klemtonius: posts small blind 50
GillesdeH: posts big blind 100
*** HOLE CARDS ***
Dealt to PokerStarsMan12 [As 8c]
PokerStarsMan12: calls 100
color_singleton: raises 200 to 300
JeBoyDirk: raises 200 to 500
dockstarr: folds 
Klemtonius: calls 450
GillesdeH: calls 400
PokerStarsMan12: folds 
color_singleton: calls 200
*** FLOP *** [Qs 7d Ac]
Klemtonius: bets 100
GillesdeH: calls 100
color_singleton: calls 100
JeBoyDirk: calls 100
*** TURN *** [Qs 7d Ac] [Jh]
Klemtonius: bets 100
GillesdeH: raises 400 to 500
color_singleton: folds 
JeBoyDirk: calls 500
Klemtonius: calls 400
*** RIVER *** [Qs 7d Ac Jh] [5s]
Klemtonius: checks 
GillesdeH: checks 
JeBoyDirk: checks 
*** SHOW DOWN ***
Klemtonius: shows [5c Ah] (two pair, Aces and Fives)
GillesdeH: mucks hand 
JeBoyDirk: mucks hand 
Klemtonius collected 3780 from pot
*** SUMMARY ***
Total pot 4000 | Rake 220 
Board [Qs 7d Ac Jh 5s]
Seat 1: color_singleton folded on the Turn
Seat 2: JeBoyDirk mucked [Kd Kc]
Seat 3: dockstarr (button) folded before Flop (didn't bet)
Seat 5: Klemtonius (small blind) showed [5c Ah] and won (3780) with two pair, Aces and Fives
Seat 8: GillesdeH (big blind) mucked [Jc Td]
Seat 9: PokerStarsMan12 folded before Flop



PokerStars Home Game Hand #228490377803: {DaPokaStars}  Hold'em No Limit (50/100) - 2021/07/22 16:41:09 ET
Table 'Halleria II' 9-max (Play Money) Seat #5 is the button
Seat 1: color_singleton (11788 in chips) 
Seat 2: JeBoyDirk (7331 in chips) 
Seat 3: dockstarr (13925 in chips) 
Seat 5: Klemtonius (7323 in chips) 
Seat 8: GillesdeH (13011 in chips) 
Seat 9: PokerStarsMan12 (7720 in chips) 
GillesdeH: posts small blind 50
PokerStarsMan12: posts big blind 100
*** HOLE CARDS ***
Dealt to PokerStarsMan12 [6c 7c]
color_singleton: folds 
JeBoyDirk: folds 
dockstarr: folds 
Klemtonius: calls 100
GillesdeH: calls 50
PokerStarsMan12: checks 
*** FLOP *** [Jc 6s Jh]
GillesdeH: checks 
PokerStarsMan12: bets 100
Klemtonius: calls 100
GillesdeH: calls 100
*** TURN *** [Jc 6s Jh] [Ac]
GillesdeH: bets 567
PokerStarsMan12: calls 567
Klemtonius: folds 
*** RIVER *** [Jc 6s Jh Ac] [7s]
GillesdeH: bets 819
PokerStarsMan12: folds 
Uncalled bet (819) returned to GillesdeH
GillesdeH collected 1639 from pot
*** SUMMARY ***
Total pot 1734 | Rake 95 
Board [Jc 6s Jh Ac 7s]
Seat 1: color_singleton folded before Flop (didn't bet)
Seat 2: JeBoyDirk folded before Flop (didn't bet)
Seat 3: dockstarr folded before Flop (didn't bet)
Seat 5: Klemtonius (button) folded on the Turn
Seat 8: GillesdeH (small blind) collected (1639)
Seat 9: PokerStarsMan12 (big blind) folded on the River



PokerStars Home Game Hand #228490398436: {DaPokaStars}  Hold'em No Limit (50/100) - 2021/07/22 16:41:52 ET
Table 'Halleria II' 9-max (Play Money) Seat #8 is the button
Seat 1: color_singleton (11788 in chips) 
Seat 2: JeBoyDirk (7331 in chips) 
Seat 3: dockstarr (13925 in chips) 
Seat 5: Klemtonius (7123 in chips) 
Seat 8: GillesdeH (13883 in chips) 
Seat 9: PokerStarsMan12 (6953 in chips) 
PokerStarsMan12: posts small blind 50
color_singleton: posts big blind 100
*** HOLE CARDS ***
Dealt to PokerStarsMan12 [5d 9d]
JeBoyDirk: raises 300 to 400
dockstarr: folds 
Klemtonius: calls 400
GillesdeH: calls 400
PokerStarsMan12: folds 
color_singleton: calls 300
*** FLOP *** [6h Ac 4h]
color_singleton: checks 
JeBoyDirk: checks 
Klemtonius: checks 
GillesdeH: checks 
*** TURN *** [6h Ac 4h] [9h]
color_singleton: checks 
JeBoyDirk: checks 
Klemtonius: checks 
GillesdeH: checks 
*** RIVER *** [6h Ac 4h 9h] [2h]
color_singleton: checks 
JeBoyDirk: bets 500
Klemtonius: folds 
GillesdeH: folds 
color_singleton: folds 
Uncalled bet (500) returned to JeBoyDirk
JeBoyDirk collected 1559 from pot
*** SUMMARY ***
Total pot 1650 | Rake 91 
Board [6h Ac 4h 9h 2h]
Seat 1: color_singleton (big blind) folded on the River
Seat 2: JeBoyDirk collected (1559)
Seat 3: dockstarr folded before Flop (didn't bet)
Seat 5: Klemtonius folded on the River
Seat 8: GillesdeH (button) folded on the River
Seat 9: PokerStarsMan12 (small blind) folded before Flop



PokerStars Home Game Hand #228490424503: {DaPokaStars}  Hold'em No Limit (50/100) - 2021/07/22 16:42:47 ET
Table 'Halleria II' 9-max (Play Money) Seat #9 is the button
Seat 1: color_singleton (11388 in chips) 
Seat 2: JeBoyDirk (8490 in chips) 
Seat 3: dockstarr (13925 in chips) 
Seat 5: Klemtonius (6723 in chips) 
Seat 8: GillesdeH (13483 in chips) 
Seat 9: PokerStarsMan12 (6903 in chips) 
color_singleton: posts small blind 50
JeBoyDirk: posts big blind 100
*** HOLE CARDS ***
Dealt to PokerStarsMan12 [8d 5c]
dockstarr: folds 
Klemtonius: raises 100 to 200
GillesdeH: calls 200
PokerStarsMan12: folds 
color_singleton: raises 400 to 600
JeBoyDirk: folds 
Klemtonius: calls 400
GillesdeH: folds 
*** FLOP *** [6s 7c Kd]
color_singleton: checks 
Klemtonius: bets 1417
color_singleton: raises 1417 to 2834
Klemtonius: calls 1417
*** TURN *** [6s 7c Kd] [Ad]
color_singleton: bets 6774
Klemtonius: calls 3289 and is all-in
Uncalled bet (3485) returned to color_singleton
*** RIVER *** [6s 7c Kd Ad] [Qh]
*** SHOW DOWN ***
color_singleton: shows [Kh Ah] (two pair, Aces and Kings)
Klemtonius: shows [5d 6d] (a pair of Sixes)
color_singleton collected 12990 from pot
*** SUMMARY ***
Total pot 13746 | Rake 756 
Board [6s 7c Kd Ad Qh]
Seat 1: color_singleton (small blind) showed [Kh Ah] and won (12990) with two pair, Aces and Kings
Seat 2: JeBoyDirk (big blind) folded before Flop
Seat 3: dockstarr folded before Flop (didn't bet)
Seat 5: Klemtonius showed [5d 6d] and lost with a pair of Sixes
Seat 8: GillesdeH folded before Flop
Seat 9: PokerStarsMan12 (button) folded before Flop (didn't bet)



PokerStars Home Game Hand #228490454020: {DaPokaStars}  Hold'em No Limit (50/100) - 2021/07/22 16:43:31 ET
Table 'Halleria II' 9-max (Play Money) Seat #1 is the button
Seat 1: color_singleton (17655 in chips) 
Seat 2: JeBoyDirk (8390 in chips) 
Seat 3: dockstarr (13925 in chips) 
Seat 8: GillesdeH (13283 in chips) 
Seat 9: PokerStarsMan12 (6903 in chips) 
JeBoyDirk: posts small blind 50
dockstarr: posts big blind 100
*** HOLE CARDS ***
Dealt to PokerStarsMan12 [Jh 2h]
GillesdeH: calls 100
PokerStarsMan12: folds 
color_singleton: folds 
JeBoyDirk: folds 
dockstarr: checks 
*** FLOP *** [6d 8c 5d]
dockstarr: checks 
GillesdeH: checks 
*** TURN *** [6d 8c 5d] [3s]
dockstarr: checks 
GillesdeH: checks 
*** RIVER *** [6d 8c 5d 3s] [Qh]
dockstarr: checks 
GillesdeH: bets 500
dockstarr: calls 500
*** SHOW DOWN ***
GillesdeH: shows [5c Tc] (a pair of Fives)
dockstarr: shows [7h 8h] (a pair of Eights)
dockstarr collected 1181 from pot
*** SUMMARY ***
Total pot 1250 | Rake 69 
Board [6d 8c 5d 3s Qh]
Seat 1: color_singleton (button) folded before Flop (didn't bet)
Seat 2: JeBoyDirk (small blind) folded before Flop
Seat 3: dockstarr (big blind) showed [7h 8h] and won (1181) with a pair of Eights
Seat 8: GillesdeH showed [5c Tc] and lost with a pair of Fives
Seat 9: PokerStarsMan12 folded before Flop (didn't bet)



PokerStars Home Game Hand #228490472023: {DaPokaStars}  Hold'em No Limit (50/100) - 2021/07/22 16:44:09 ET
Table 'Halleria II' 9-max (Play Money) Seat #2 is the button
Seat 1: color_singleton (17655 in chips) 
Seat 2: JeBoyDirk (8340 in chips) 
Seat 3: dockstarr (14506 in chips) 
Seat 5: Klemtonius (10000 in chips) 
Seat 8: GillesdeH (12683 in chips) 
Seat 9: PokerStarsMan12 (6903 in chips) 
dockstarr: posts small blind 50
Klemtonius: posts big blind 100
*** HOLE CARDS ***
Dealt to PokerStarsMan12 [Qs 6h]
GillesdeH: calls 100
PokerStarsMan12: folds 
color_singleton: calls 100
JeBoyDirk: folds 
dockstarr: folds 
Klemtonius: checks 
*** FLOP *** [4c Kc As]
Klemtonius: checks 
GillesdeH: bets 331
color_singleton: calls 331
Klemtonius: folds 
*** TURN *** [4c Kc As] [9s]
GillesdeH: bets 956
color_singleton: folds 
Uncalled bet (956) returned to GillesdeH
GillesdeH collected 956 from pot
*** SUMMARY ***
Total pot 1012 | Rake 56 
Board [4c Kc As 9s]
Seat 1: color_singleton folded on the Turn
Seat 2: JeBoyDirk (button) folded before Flop (didn't bet)
Seat 3: dockstarr (small blind) folded before Flop
Seat 5: Klemtonius (big blind) folded on the Flop
Seat 8: GillesdeH collected (956)
Seat 9: PokerStarsMan12 folded before Flop (didn't bet)



PokerStars Home Game Hand #228490484460: {DaPokaStars}  Hold'em No Limit (50/100) - 2021/07/22 16:44:36 ET
Table 'Halleria II' 9-max (Play Money) Seat #3 is the button
Seat 1: color_singleton (17224 in chips) 
Seat 2: JeBoyDirk (8340 in chips) 
Seat 3: dockstarr (14456 in chips) 
Seat 8: GillesdeH (13208 in chips) 
Seat 9: PokerStarsMan12 (6903 in chips) 
GillesdeH: posts small blind 50
PokerStarsMan12: posts big blind 100
*** HOLE CARDS ***
Dealt to PokerStarsMan12 [Ad Qh]
color_singleton: folds 
JeBoyDirk: folds 
dockstarr: calls 100
GillesdeH: calls 50
PokerStarsMan12: raises 300 to 400
dockstarr: folds 
GillesdeH: calls 300
*** FLOP *** [5s 8c As]
GillesdeH: checks 
PokerStarsMan12: bets 600
GillesdeH: folds 
Uncalled bet (600) returned to PokerStarsMan12
PokerStarsMan12 collected 850 from pot
*** SUMMARY ***
Total pot 900 | Rake 50 
Board [5s 8c As]
Seat 1: color_singleton folded before Flop (didn't bet)
Seat 2: JeBoyDirk folded before Flop (didn't bet)
Seat 3: dockstarr (button) folded before Flop
Seat 8: GillesdeH (small blind) folded on the Flop
Seat 9: PokerStarsMan12 (big blind) collected (850)



PokerStars Home Game Hand #228490500416: {DaPokaStars}  Hold'em No Limit (50/100) - 2021/07/22 16:45:09 ET
Table 'Halleria II' 9-max (Play Money) Seat #8 is the button
Seat 1: color_singleton (17224 in chips) 
Seat 2: JeBoyDirk (8340 in chips) 
Seat 3: dockstarr (14356 in chips) 
Seat 8: GillesdeH (12808 in chips) 
Seat 9: PokerStarsMan12 (7353 in chips) 
PokerStarsMan12: posts small blind 50
color_singleton: posts big blind 100
*** HOLE CARDS ***
Dealt to PokerStarsMan12 [7h 2d]
JeBoyDirk: calls 100
dockstarr: folds 
GillesdeH: calls 100
PokerStarsMan12: calls 50
color_singleton: raises 400 to 500
JeBoyDirk: calls 400
GillesdeH: calls 400
PokerStarsMan12: folds 
*** FLOP *** [Qd 2s 7d]
color_singleton: bets 756
JeBoyDirk: raises 756 to 1512
GillesdeH: folds 
color_singleton: folds 
Uncalled bet (756) returned to JeBoyDirk
JeBoyDirk collected 2941 from pot
*** SUMMARY ***
Total pot 3112 | Rake 171 
Board [Qd 2s 7d]
Seat 1: color_singleton (big blind) folded on the Flop
Seat 2: JeBoyDirk collected (2941)
Seat 3: dockstarr folded before Flop (didn't bet)
Seat 8: GillesdeH (button) folded on the Flop
Seat 9: PokerStarsMan12 (small blind) folded before Flop



PokerStars Home Game Hand #228490520283: {DaPokaStars}  Hold'em No Limit (50/100) - 2021/07/22 16:45:51 ET
Table 'Halleria II' 9-max (Play Money) Seat #9 is the button
Seat 1: color_singleton (15968 in chips) 
Seat 2: JeBoyDirk (10025 in chips) 
Seat 3: dockstarr (14356 in chips) 
Seat 5: Klemtonius (9900 in chips) 
Seat 8: GillesdeH (12308 in chips) 
Seat 9: PokerStarsMan12 (7253 in chips) 
color_singleton: posts small blind 50
JeBoyDirk: posts big blind 100
Klemtonius: posts small blind 50
*** HOLE CARDS ***
Dealt to PokerStarsMan12 [2c 3d]
dockstarr: calls 100
Klemtonius: calls 100
GillesdeH: calls 100
PokerStarsMan12: folds 
color_singleton: folds 
JeBoyDirk: checks 
*** FLOP *** [9d Kc 4s]
JeBoyDirk: checks 
dockstarr: checks 
Klemtonius: checks 
GillesdeH: checks 
*** TURN *** [9d Kc 4s] [Qs]
JeBoyDirk: checks 
dockstarr: checks 
Klemtonius has timed out
Klemtonius: checks 
GillesdeH: checks 
*** RIVER *** [9d Kc 4s Qs] [Ts]
JeBoyDirk: checks 
dockstarr: checks 
Klemtonius: checks 
GillesdeH: checks 
*** SHOW DOWN ***
JeBoyDirk: shows [8d Ah] (high card Ace)
dockstarr: shows [Qc 7c] (a pair of Queens)
Klemtonius: mucks hand 
GillesdeH: mucks hand 
dockstarr collected 472 from pot
*** SUMMARY ***
Total pot 500 | Rake 28 
Board [9d Kc 4s Qs Ts]
Seat 1: color_singleton (small blind) folded before Flop
Seat 2: JeBoyDirk (big blind) showed [8d Ah] and lost with high card Ace
Seat 3: dockstarr showed [Qc 7c] and won (472) with a pair of Queens
Seat 5: Klemtonius mucked [8h 6h]
Seat 8: GillesdeH mucked [6d 5c]
Seat 9: PokerStarsMan12 (button) folded before Flop (didn't bet)



PokerStars Home Game Hand #228490550344: {DaPokaStars}  Hold'em No Limit (50/100) - 2021/07/22 16:46:53 ET
Table 'Halleria II' 9-max (Play Money) Seat #1 is the button
Seat 1: color_singleton (15918 in chips) 
Seat 2: JeBoyDirk (9925 in chips) 
Seat 3: dockstarr (14728 in chips) 
Seat 5: Klemtonius (9750 in chips) 
Seat 8: GillesdeH (12208 in chips) 
Seat 9: PokerStarsMan12 (7253 in chips) 
JeBoyDirk: posts small blind 50
dockstarr: posts big blind 100
*** HOLE CARDS ***
Dealt to PokerStarsMan12 [9c Jh]
Klemtonius: calls 100
GillesdeH: calls 100
PokerStarsMan12: calls 100
color_singleton: calls 100
JeBoyDirk: folds 
dockstarr: checks 
*** FLOP *** [Qd 5d Ks]
dockstarr: checks 
Klemtonius: bets 260
GillesdeH: calls 260
PokerStarsMan12: folds 
color_singleton: calls 260
dockstarr: folds 
*** TURN *** [Qd 5d Ks] [Js]
Klemtonius: checks 
GillesdeH: bets 628
color_singleton: calls 628
Klemtonius: calls 628
*** RIVER *** [Qd 5d Ks Js] [Qc]
Klemtonius: checks 
GillesdeH: bets 1518
color_singleton: folds 
Klemtonius: folds 
Uncalled bet (1518) returned to GillesdeH
GillesdeH collected 3037 from pot
*** SUMMARY ***
Total pot 3214 | Rake 177 
Board [Qd 5d Ks Js Qc]
Seat 1: color_singleton (button) folded on the River
Seat 2: JeBoyDirk (small blind) folded before Flop
Seat 3: dockstarr (big blind) folded on the Flop
Seat 5: Klemtonius folded on the River
Seat 8: GillesdeH collected (3037)
Seat 9: PokerStarsMan12 folded on the Flop



PokerStars Home Game Hand #228490584707: {DaPokaStars}  Hold'em No Limit (50/100) - 2021/07/22 16:47:57 ET
Table 'Halleria II' 9-max (Play Money) Seat #2 is the button
Seat 1: color_singleton (14930 in chips) 
Seat 2: JeBoyDirk (9875 in chips) 
Seat 3: dockstarr (14628 in chips) 
Seat 5: Klemtonius (8762 in chips) 
Seat 8: GillesdeH (14257 in chips) 
Seat 9: PokerStarsMan12 (7153 in chips) 
dockstarr: posts small blind 50
Klemtonius: posts big blind 100
*** HOLE CARDS ***
Dealt to PokerStarsMan12 [4c 2s]
GillesdeH: calls 100
PokerStarsMan12: folds 
color_singleton: raises 200 to 300
JeBoyDirk: folds 
dockstarr: folds 
Klemtonius: calls 200
GillesdeH: calls 200
*** FLOP *** [6c 3s Jd]
Klemtonius: checks 
GillesdeH: checks 
color_singleton: checks 
*** TURN *** [6c 3s Jd] [6h]
Klemtonius: checks 
GillesdeH: checks 
color_singleton: checks 
*** RIVER *** [6c 3s Jd 6h] [Js]
Klemtonius: checks 
GillesdeH: checks 
color_singleton: bets 449
Klemtonius: folds 
GillesdeH: folds 
Uncalled bet (449) returned to color_singleton
color_singleton collected 898 from pot
color_singleton: doesn't show hand 
*** SUMMARY ***
Total pot 950 | Rake 52 
Board [6c 3s Jd 6h Js]
Seat 1: color_singleton collected (898)
Seat 2: JeBoyDirk (button) folded before Flop (didn't bet)
Seat 3: dockstarr (small blind) folded before Flop
Seat 5: Klemtonius (big blind) folded on the River
Seat 8: GillesdeH folded on the River
Seat 9: PokerStarsMan12 folded before Flop (didn't bet)



PokerStars Home Game Hand #228490611058: {DaPokaStars}  Hold'em No Limit (50/100) - 2021/07/22 16:48:51 ET
Table 'Halleria II' 9-max (Play Money) Seat #3 is the button
Seat 1: color_singleton (15528 in chips) 
Seat 2: JeBoyDirk (9875 in chips) 
Seat 3: dockstarr (14578 in chips) 
Seat 5: Klemtonius (8462 in chips) 
Seat 8: GillesdeH (13957 in chips) 
Seat 9: PokerStarsMan12 (7153 in chips) 
Klemtonius: posts small blind 50
GillesdeH: posts big blind 100
*** HOLE CARDS ***
Dealt to PokerStarsMan12 [5d Qd]
PokerStarsMan12: calls 100
color_singleton: raises 200 to 300
JeBoyDirk: calls 300
dockstarr: calls 300
Klemtonius: raises 200 to 500
GillesdeH: folds 
PokerStarsMan12: folds 
color_singleton: calls 200
JeBoyDirk: calls 200
dockstarr: calls 200
*** FLOP *** [5h Kd 6h]
Klemtonius: checks 
color_singleton: checks 
JeBoyDirk: checks 
dockstarr: bets 100
Klemtonius: raises 1139 to 1239
color_singleton: folds 
JeBoyDirk: folds 
dockstarr: calls 1139
*** TURN *** [5h Kd 6h] [3d]
Klemtonius: bets 1100
dockstarr: calls 1100
*** RIVER *** [5h Kd 6h 3d] [9h]
Klemtonius: checks 
dockstarr: bets 11739 and is all-in
Klemtonius: folds 
Uncalled bet (11739) returned to dockstarr
dockstarr collected 6500 from pot
dockstarr: doesn't show hand 
*** SUMMARY ***
Total pot 6878 | Rake 378 
Board [5h Kd 6h 3d 9h]
Seat 1: color_singleton folded on the Flop
Seat 2: JeBoyDirk folded on the Flop
Seat 3: dockstarr (button) collected (6500)
Seat 5: Klemtonius (small blind) folded on the River
Seat 8: GillesdeH (big blind) folded before Flop
Seat 9: PokerStarsMan12 folded before Flop



PokerStars Home Game Hand #228490647331: {DaPokaStars}  Hold'em No Limit (50/100) - 2021/07/22 16:50:06 ET
Table 'Halleria II' 9-max (Play Money) Seat #5 is the button
Seat 1: color_singleton (15028 in chips) 
Seat 2: JeBoyDirk (9375 in chips) 
Seat 3: dockstarr (18239 in chips) 
Seat 5: Klemtonius (5623 in chips) 
Seat 8: GillesdeH (13857 in chips) 
Seat 9: PokerStarsMan12 (7053 in chips) 
GillesdeH: posts small blind 50
PokerStarsMan12: posts big blind 100
*** HOLE CARDS ***
Dealt to PokerStarsMan12 [Qs Jc]
color_singleton: folds 
JeBoyDirk: folds 
dockstarr: calls 100
Klemtonius: calls 100
GillesdeH: calls 50
PokerStarsMan12: raises 300 to 400
dockstarr: calls 300
Klemtonius: folds 
GillesdeH: calls 300
*** FLOP *** [8c Kd Js]
GillesdeH: checks 
PokerStarsMan12: bets 400
dockstarr: folds 
GillesdeH: folds 
Uncalled bet (400) returned to PokerStarsMan12
PokerStarsMan12 collected 1228 from pot
*** SUMMARY ***
Total pot 1300 | Rake 72 
Board [8c Kd Js]
Seat 1: color_singleton folded before Flop (didn't bet)
Seat 2: JeBoyDirk folded before Flop (didn't bet)
Seat 3: dockstarr folded on the Flop
Seat 5: Klemtonius (button) folded before Flop
Seat 8: GillesdeH (small blind) folded on the Flop
Seat 9: PokerStarsMan12 (big blind) collected (1228)



PokerStars Home Game Hand #228490676702: {DaPokaStars}  Hold'em No Limit (50/100) - 2021/07/22 16:51:08 ET
Table 'Halleria II' 9-max (Play Money) Seat #8 is the button
Seat 1: color_singleton (15028 in chips) 
Seat 2: JeBoyDirk (9375 in chips) 
Seat 3: dockstarr (17839 in chips) 
Seat 5: Klemtonius (5523 in chips) 
Seat 8: GillesdeH (13457 in chips) 
Seat 9: PokerStarsMan12 (7881 in chips) 
PokerStarsMan12: posts small blind 50
color_singleton: posts big blind 100
*** HOLE CARDS ***
Dealt to PokerStarsMan12 [6d 5s]
JeBoyDirk: folds 
dockstarr: calls 100
Klemtonius: calls 100
GillesdeH: calls 100
PokerStarsMan12: calls 50
color_singleton: raises 200 to 300
dockstarr: calls 200
Klemtonius: calls 200
GillesdeH: calls 200
PokerStarsMan12: calls 200
*** FLOP *** [7h 5h 5d]
PokerStarsMan12: bets 800
color_singleton: calls 800
dockstarr: folds 
Klemtonius: folds 
GillesdeH: folds 
*** TURN *** [7h 5h 5d] [9d]
PokerStarsMan12: bets 2000
color_singleton: folds 
Uncalled bet (2000) returned to PokerStarsMan12
PokerStarsMan12 collected 2929 from pot
*** SUMMARY ***
Total pot 3100 | Rake 171 
Board [7h 5h 5d 9d]
Seat 1: color_singleton (big blind) folded on the Turn
Seat 2: JeBoyDirk folded before Flop (didn't bet)
Seat 3: dockstarr folded on the Flop
Seat 5: Klemtonius folded on the Flop
Seat 8: GillesdeH (button) folded on the Flop
Seat 9: PokerStarsMan12 (small blind) collected (2929)



PokerStars Home Game Hand #228490696714: {DaPokaStars}  Hold'em No Limit (50/100) - 2021/07/22 16:51:49 ET
Table 'Halleria II' 9-max (Play Money) Seat #9 is the button
Seat 1: color_singleton (13928 in chips) 
Seat 2: JeBoyDirk (9375 in chips) 
Seat 3: dockstarr (17539 in chips) 
Seat 5: Klemtonius (5223 in chips) 
Seat 8: GillesdeH (13157 in chips) 
Seat 9: PokerStarsMan12 (9710 in chips) 
color_singleton: posts small blind 50
JeBoyDirk: posts big blind 100
*** HOLE CARDS ***
Dealt to PokerStarsMan12 [Kh Tc]
dockstarr: folds 
Klemtonius: raises 100 to 200
GillesdeH: calls 200
PokerStarsMan12: calls 200
color_singleton: folds 
JeBoyDirk: calls 100
*** FLOP *** [8s 2c Jh]
JeBoyDirk: checks 
Klemtonius: checks 
GillesdeH: checks 
PokerStarsMan12: checks 
*** TURN *** [8s 2c Jh] [3c]
JeBoyDirk: checks 
Klemtonius: checks 
GillesdeH: checks 
PokerStarsMan12: checks 
*** RIVER *** [8s 2c Jh 3c] [Ac]
JeBoyDirk: checks 
Klemtonius: checks 
GillesdeH: checks 
PokerStarsMan12: checks 
*** SHOW DOWN ***
JeBoyDirk: shows [Jd 5d] (a pair of Jacks)
Klemtonius: shows [As 7s] (a pair of Aces)
GillesdeH: mucks hand 
PokerStarsMan12: mucks hand 
Klemtonius collected 803 from pot
*** SUMMARY ***
Total pot 850 | Rake 47 
Board [8s 2c Jh 3c Ac]
Seat 1: color_singleton (small blind) folded before Flop
Seat 2: JeBoyDirk (big blind) showed [Jd 5d] and lost with a pair of Jacks
Seat 3: dockstarr folded before Flop (didn't bet)
Seat 5: Klemtonius showed [As 7s] and won (803) with a pair of Aces
Seat 8: GillesdeH mucked [6h 8h]
Seat 9: PokerStarsMan12 (button) mucked [Kh Tc]



PokerStars Home Game Hand #228490721002: {DaPokaStars}  Hold'em No Limit (50/100) - 2021/07/22 16:52:41 ET
Table 'Halleria II' 9-max (Play Money) Seat #1 is the button
Seat 1: color_singleton (13878 in chips) 
Seat 2: JeBoyDirk (9175 in chips) 
Seat 3: dockstarr (17539 in chips) 
Seat 5: Klemtonius (5826 in chips) 
Seat 8: GillesdeH (12957 in chips) 
Seat 9: PokerStarsMan12 (9510 in chips) 
JeBoyDirk: posts small blind 50
dockstarr: posts big blind 100
*** HOLE CARDS ***
Dealt to PokerStarsMan12 [4s Kh]
Klemtonius: raises 100 to 200
GillesdeH: calls 200
PokerStarsMan12: folds 
color_singleton: folds 
JeBoyDirk: folds 
dockstarr: folds 
*** FLOP *** [7d Td 9c]
Klemtonius: bets 520
GillesdeH: calls 520
*** TURN *** [7d Td 9c] [Ts]
Klemtonius: bets 1503
GillesdeH: calls 1503
*** RIVER *** [7d Td 9c Ts] [5d]
Klemtonius: bets 1100
GillesdeH: raises 1100 to 2200
Klemtonius: folds 
Uncalled bet (1100) returned to GillesdeH
GillesdeH collected 6422 from pot
*** SUMMARY ***
Total pot 6796 | Rake 374 
Board [7d Td 9c Ts 5d]
Seat 1: color_singleton (button) folded before Flop (didn't bet)
Seat 2: JeBoyDirk (small blind) folded before Flop
Seat 3: dockstarr (big blind) folded before Flop
Seat 5: Klemtonius folded on the River
Seat 8: GillesdeH collected (6422)
Seat 9: PokerStarsMan12 folded before Flop (didn't bet)



PokerStars Home Game Hand #228490739355: {DaPokaStars}  Hold'em No Limit (50/100) - 2021/07/22 16:53:20 ET
Table 'Halleria II' 9-max (Play Money) Seat #2 is the button
Seat 1: color_singleton (13878 in chips) 
Seat 2: JeBoyDirk (9125 in chips) 
Seat 3: dockstarr (17439 in chips) 
Seat 5: Klemtonius (2503 in chips) 
Seat 8: GillesdeH (16056 in chips) 
Seat 9: PokerStarsMan12 (9510 in chips) 
dockstarr: posts small blind 50
Klemtonius: posts big blind 100
*** HOLE CARDS ***
Dealt to PokerStarsMan12 [Td 2c]
GillesdeH: calls 100
PokerStarsMan12: folds 
color_singleton: folds 
JeBoyDirk: calls 100
dockstarr: folds 
Klemtonius: checks 
*** FLOP *** [6h Jh 3d]
Klemtonius: checks 
GillesdeH: checks 
JeBoyDirk: checks 
*** TURN *** [6h Jh 3d] [8c]
Klemtonius: checks 
GillesdeH: bets 500
JeBoyDirk: folds 
Klemtonius: folds 
Uncalled bet (500) returned to GillesdeH
GillesdeH collected 331 from pot
*** SUMMARY ***
Total pot 350 | Rake 19 
Board [6h Jh 3d 8c]
Seat 1: color_singleton folded before Flop (didn't bet)
Seat 2: JeBoyDirk (button) folded on the Turn
Seat 3: dockstarr (small blind) folded before Flop
Seat 5: Klemtonius (big blind) folded on the Turn
Seat 8: GillesdeH collected (331)
Seat 9: PokerStarsMan12 folded before Flop (didn't bet)



PokerStars Home Game Hand #228490762818: {DaPokaStars}  Hold'em No Limit (50/100) - 2021/07/22 16:54:09 ET
Table 'Halleria II' 9-max (Play Money) Seat #3 is the button
Seat 1: color_singleton (13878 in chips) 
Seat 2: JeBoyDirk (9025 in chips) 
Seat 3: dockstarr (17389 in chips) 
Seat 5: Klemtonius (2403 in chips) 
Seat 8: GillesdeH (16287 in chips) 
Seat 9: PokerStarsMan12 (9510 in chips) 
Klemtonius: posts small blind 50
GillesdeH: posts big blind 100
*** HOLE CARDS ***
Dealt to PokerStarsMan12 [3s 4s]
PokerStarsMan12: raises 200 to 300
color_singleton: folds 
JeBoyDirk: calls 300
dockstarr: calls 300
Klemtonius: calls 250
GillesdeH: calls 200
*** FLOP *** [5c Jc Ah]
Klemtonius: checks 
GillesdeH: bets 100
PokerStarsMan12: calls 100
JeBoyDirk: raises 200 to 300
dockstarr: folds 
Klemtonius: folds 
GillesdeH: calls 200
PokerStarsMan12: calls 200
*** TURN *** [5c Jc Ah] [7d]
GillesdeH: checks 
PokerStarsMan12: checks 
JeBoyDirk: bets 500
GillesdeH: calls 500
PokerStarsMan12: folds 
*** RIVER *** [5c Jc Ah 7d] [As]
GillesdeH: checks 
JeBoyDirk: bets 1500
GillesdeH: folds 
Uncalled bet (1500) returned to JeBoyDirk
JeBoyDirk collected 3213 from pot
*** SUMMARY ***
Total pot 3400 | Rake 187 
Board [5c Jc Ah 7d As]
Seat 1: color_singleton folded before Flop (didn't bet)
Seat 2: JeBoyDirk collected (3213)
Seat 3: dockstarr (button) folded on the Flop
Seat 5: Klemtonius (small blind) folded on the Flop
Seat 8: GillesdeH (big blind) folded on the River
Seat 9: PokerStarsMan12 folded on the Turn



PokerStars Home Game Hand #228490803396: {DaPokaStars}  Hold'em No Limit (50/100) - 2021/07/22 16:55:45 ET
Table 'Halleria II' 9-max (Play Money) Seat #5 is the button
Seat 1: color_singleton (13878 in chips) 
Seat 2: JeBoyDirk (11138 in chips) 
Seat 3: dockstarr (17089 in chips) 
Seat 5: Klemtonius (2103 in chips) 
Seat 8: GillesdeH (15187 in chips) 
Seat 9: PokerStarsMan12 (8910 in chips) 
GillesdeH: posts small blind 50
PokerStarsMan12: posts big blind 100
*** HOLE CARDS ***
Dealt to PokerStarsMan12 [6s 6h]
color_singleton: folds 
JeBoyDirk: folds 
dockstarr: folds 
Klemtonius: raises 250 to 350
GillesdeH: folds 
PokerStarsMan12: calls 250
*** FLOP *** [8s 6c 8d]
PokerStarsMan12: checks 
Klemtonius: bets 354
PokerStarsMan12: calls 354
*** TURN *** [8s 6c 8d] [Ks]
PokerStarsMan12: checks 
Klemtonius: checks 
*** RIVER *** [8s 6c 8d Ks] [Kh]
PokerStarsMan12: checks 
Klemtonius: bets 1378
PokerStarsMan12: calls 1378
*** SHOW DOWN ***
Klemtonius: shows [Ac 2c] (two pair, Kings and Eights)
PokerStarsMan12: shows [6s 6h] (a full house, Sixes full of Kings)
PokerStarsMan12 collected 3982 from pot
*** SUMMARY ***
Total pot 4214 | Rake 232 
Board [8s 6c 8d Ks Kh]
Seat 1: color_singleton folded before Flop (didn't bet)
Seat 2: JeBoyDirk folded before Flop (didn't bet)
Seat 3: dockstarr folded before Flop (didn't bet)
Seat 5: Klemtonius (button) showed [Ac 2c] and lost with two pair, Kings and Eights
Seat 8: GillesdeH (small blind) folded before Flop
Seat 9: PokerStarsMan12 (big blind) showed [6s 6h] and won (3982) with a full house, Sixes full of Kings



PokerStars Home Game Hand #228490825711: {DaPokaStars}  Hold'em No Limit (50/100) - 2021/07/22 16:56:51 ET
Table 'Halleria II' 9-max (Play Money) Seat #8 is the button
Seat 1: color_singleton (13878 in chips) 
Seat 2: JeBoyDirk (11138 in chips) 
Seat 3: dockstarr (17089 in chips) 
Seat 8: GillesdeH (15137 in chips) 
Seat 9: PokerStarsMan12 (10810 in chips) 
PokerStarsMan12: posts small blind 50
color_singleton: posts big blind 100
*** HOLE CARDS ***
Dealt to PokerStarsMan12 [3c 8c]
JeBoyDirk: calls 100
dockstarr: folds 
GillesdeH: folds 
GillesdeH leaves the table
PokerStarsMan12: calls 50
color_singleton: raises 200 to 300
JeBoyDirk: calls 200
PokerStarsMan12: calls 200
*** FLOP *** [6c Ks 8s]
PokerStarsMan12: checks 
color_singleton: bets 425
JeBoyDirk: calls 425
PokerStarsMan12: folds 
*** TURN *** [6c Ks 8s] [9d]
color_singleton: bets 827
JeBoyDirk: calls 827
*** RIVER *** [6c Ks 8s 9d] [Jd]
color_singleton: checks 
JeBoyDirk: bets 1500
color_singleton: calls 1500
*** SHOW DOWN ***
JeBoyDirk: shows [Kd Js] (two pair, Kings and Jacks)
color_singleton: mucks hand 
JeBoyDirk collected 6052 from pot
*** SUMMARY ***
Total pot 6404 | Rake 352 
Board [6c Ks 8s 9d Jd]
Seat 1: color_singleton (big blind) mucked [8h 7h]
Seat 2: JeBoyDirk showed [Kd Js] and won (6052) with two pair, Kings and Jacks
Seat 3: dockstarr folded before Flop (didn't bet)
Seat 8: GillesdeH (button) folded before Flop (didn't bet)
Seat 9: PokerStarsMan12 (small blind) folded on the Flop



PokerStars Home Game Hand #228490847635: {DaPokaStars}  Hold'em No Limit (50/100) - 2021/07/22 16:57:55 ET
Table 'Halleria II' 9-max (Play Money) Seat #9 is the button
Seat 1: color_singleton (10826 in chips) 
Seat 2: JeBoyDirk (14138 in chips) 
Seat 3: dockstarr (17089 in chips) 
Seat 5: Klemtonius (10000 in chips) 
Seat 9: PokerStarsMan12 (10510 in chips) 
color_singleton: posts small blind 50
JeBoyDirk: posts big blind 100
*** HOLE CARDS ***
Dealt to PokerStarsMan12 [3h Jd]
dockstarr: folds 
Klemtonius: calls 100
PokerStarsMan12: folds 
color_singleton: raises 200 to 300
JeBoyDirk: folds 
Klemtonius: calls 200
*** FLOP *** [5h Kc Jc]
color_singleton: bets 330
Klemtonius: folds 
Uncalled bet (330) returned to color_singleton
color_singleton collected 661 from pot
color_singleton: doesn't show hand 
*** SUMMARY ***
Total pot 700 | Rake 39 
Board [5h Kc Jc]
Seat 1: color_singleton (small blind) collected (661)
Seat 2: JeBoyDirk (big blind) folded before Flop
Seat 3: dockstarr folded before Flop (didn't bet)
Seat 5: Klemtonius folded on the Flop
Seat 9: PokerStarsMan12 (button) folded before Flop (didn't bet)



PokerStars Home Game Hand #228490855156: {DaPokaStars}  Hold'em No Limit (50/100) - 2021/07/22 16:58:17 ET
Table 'Halleria II' 9-max (Play Money) Seat #1 is the button
Seat 1: color_singleton (11187 in chips) 
Seat 2: JeBoyDirk (14038 in chips) 
Seat 3: dockstarr (17089 in chips) 
Seat 5: Klemtonius (9700 in chips) 
Seat 9: PokerStarsMan12 (10510 in chips) 
JeBoyDirk: posts small blind 50
dockstarr: posts big blind 100
*** HOLE CARDS ***
Dealt to PokerStarsMan12 [Jh Ks]
Klemtonius: folds 
PokerStarsMan12: raises 300 to 400
color_singleton: folds 
JeBoyDirk: folds 
dockstarr: calls 300
*** FLOP *** [Kd 2d 9d]
dockstarr: checks 
PokerStarsMan12: bets 400
dockstarr: folds 
Uncalled bet (400) returned to PokerStarsMan12
PokerStarsMan12 collected 803 from pot
*** SUMMARY ***
Total pot 850 | Rake 47 
Board [Kd 2d 9d]
Seat 1: color_singleton (button) folded before Flop (didn't bet)
Seat 2: JeBoyDirk (small blind) folded before Flop
Seat 3: dockstarr (big blind) folded on the Flop
Seat 5: Klemtonius folded before Flop (didn't bet)
Seat 9: PokerStarsMan12 collected (803)



PokerStars Home Game Hand #228490864297: {DaPokaStars}  Hold'em No Limit (50/100) - 2021/07/22 16:58:44 ET
Table 'Halleria II' 9-max (Play Money) Seat #2 is the button
Seat 1: color_singleton (11187 in chips) 
Seat 2: JeBoyDirk (13988 in chips) 
Seat 3: dockstarr (16689 in chips) 
Seat 5: Klemtonius (9700 in chips) 
Seat 9: PokerStarsMan12 (10913 in chips) 
dockstarr: posts small blind 50
Klemtonius: posts big blind 100
*** HOLE CARDS ***
Dealt to PokerStarsMan12 [3h 3s]
PokerStarsMan12: raises 200 to 300
color_singleton: folds 
JeBoyDirk: folds 
dockstarr: folds 
Klemtonius: calls 200
*** FLOP *** [5h Qh Ad]
Klemtonius: bets 307
PokerStarsMan12: folds 
Uncalled bet (307) returned to Klemtonius
Klemtonius collected 614 from pot
Klemtonius: doesn't show hand 
*** SUMMARY ***
Total pot 650 | Rake 36 
Board [5h Qh Ad]
Seat 1: color_singleton folded before Flop (didn't bet)
Seat 2: JeBoyDirk (button) folded before Flop (didn't bet)
Seat 3: dockstarr (small blind) folded before Flop
Seat 5: Klemtonius (big blind) collected (614)
Seat 9: PokerStarsMan12 folded on the Flop



PokerStars Home Game Hand #228490876523: {DaPokaStars}  Hold'em No Limit (50/100) - 2021/07/22 16:59:20 ET
Table 'Halleria II' 9-max (Play Money) Seat #3 is the button
Seat 1: color_singleton (11187 in chips) 
Seat 2: JeBoyDirk (13988 in chips) 
Seat 3: dockstarr (16639 in chips) 
Seat 5: Klemtonius (10014 in chips) 
Seat 9: PokerStarsMan12 (10613 in chips) 
Klemtonius: posts small blind 50
PokerStarsMan12: posts big blind 100
*** HOLE CARDS ***
Dealt to PokerStarsMan12 [4h 3c]
color_singleton: raises 200 to 300
JeBoyDirk: folds 
dockstarr: calls 300
Klemtonius: calls 250
PokerStarsMan12: calls 200
*** FLOP *** [3s 8h As]
Klemtonius: bets 1134
PokerStarsMan12: folds 
color_singleton: folds 
dockstarr: folds 
Uncalled bet (1134) returned to Klemtonius
Klemtonius collected 1134 from pot
Klemtonius: doesn't show hand 
*** SUMMARY ***
Total pot 1200 | Rake 66 
Board [3s 8h As]
Seat 1: color_singleton folded on the Flop
Seat 2: JeBoyDirk folded before Flop (didn't bet)
Seat 3: dockstarr (button) folded on the Flop
Seat 5: Klemtonius (small blind) collected (1134)
Seat 9: PokerStarsMan12 (big blind) folded on the Flop



PokerStars Home Game Hand #228490885563: {DaPokaStars}  Hold'em No Limit (50/100) - 2021/07/22 16:59:46 ET
Table 'Halleria II' 9-max (Play Money) Seat #5 is the button
Seat 1: color_singleton (10887 in chips) 
Seat 2: JeBoyDirk (13988 in chips) 
Seat 3: dockstarr (16339 in chips) 
Seat 5: Klemtonius (10848 in chips) 
Seat 9: PokerStarsMan12 (10313 in chips) 
PokerStarsMan12: posts small blind 50
color_singleton: posts big blind 100
*** HOLE CARDS ***
Dealt to PokerStarsMan12 [Th Kh]
JeBoyDirk: calls 100
dockstarr: folds 
Klemtonius: calls 100
PokerStarsMan12: raises 400 to 500
color_singleton: folds 
JeBoyDirk: calls 400
Klemtonius: folds 
*** FLOP *** [Qd 7d 5h]
PokerStarsMan12: checks 
JeBoyDirk: checks 
*** TURN *** [Qd 7d 5h] [8c]
PokerStarsMan12: checks 
JeBoyDirk: checks 
*** RIVER *** [Qd 7d 5h 8c] [Qh]
PokerStarsMan12: checks 
JeBoyDirk: checks 
*** SHOW DOWN ***
PokerStarsMan12: shows [Th Kh] (a pair of Queens)
JeBoyDirk: shows [7h Ah] (two pair, Queens and Sevens)
JeBoyDirk collected 1134 from pot
*** SUMMARY ***
Total pot 1200 | Rake 66 
Board [Qd 7d 5h 8c Qh]
Seat 1: color_singleton (big blind) folded before Flop
Seat 2: JeBoyDirk showed [7h Ah] and won (1134) with two pair, Queens and Sevens
Seat 3: dockstarr folded before Flop (didn't bet)
Seat 5: Klemtonius (button) folded before Flop
Seat 9: PokerStarsMan12 (small blind) showed [Th Kh] and lost with a pair of Queens



PokerStars Home Game Hand #228490902959: {DaPokaStars}  Hold'em No Limit (50/100) - 2021/07/22 17:00:35 ET
Table 'Halleria II' 9-max (Play Money) Seat #9 is the button
Seat 1: color_singleton (10787 in chips) 
Seat 2: JeBoyDirk (14622 in chips) 
Seat 3: dockstarr (16339 in chips) 
Seat 5: Klemtonius (10748 in chips) 
Seat 9: PokerStarsMan12 (9813 in chips) 
color_singleton: posts small blind 50
JeBoyDirk: posts big blind 100
*** HOLE CARDS ***
Dealt to PokerStarsMan12 [Ad 4c]
dockstarr: folds 
Klemtonius: calls 100
PokerStarsMan12: raises 200 to 300
color_singleton: folds 
JeBoyDirk: calls 200
Klemtonius: calls 200
*** FLOP *** [4s Js 6h]
JeBoyDirk: checks 
Klemtonius: checks 
PokerStarsMan12: checks 
*** TURN *** [4s Js 6h] [Qd]
JeBoyDirk: checks 
Klemtonius: checks 
PokerStarsMan12: checks 
*** RIVER *** [4s Js 6h Qd] [2d]
JeBoyDirk: checks 
Klemtonius: checks 
PokerStarsMan12: checks 
*** SHOW DOWN ***
JeBoyDirk: shows [As 8s] (high card Ace)
Klemtonius: mucks hand 
PokerStarsMan12: shows [Ad 4c] (a pair of Fours)
PokerStarsMan12 collected 898 from pot
*** SUMMARY ***
Total pot 950 | Rake 52 
Board [4s Js 6h Qd 2d]
Seat 1: color_singleton (small blind) folded before Flop
Seat 2: JeBoyDirk (big blind) showed [As 8s] and lost with high card Ace
Seat 3: dockstarr folded before Flop (didn't bet)
Seat 5: Klemtonius mucked [8h 7h]
Seat 9: PokerStarsMan12 (button) showed [Ad 4c] and won (898) with a pair of Fours



PokerStars Home Game Hand #228490919063: {DaPokaStars}  Hold'em No Limit (50/100) - 2021/07/22 17:01:16 ET
Table 'Halleria II' 9-max (Play Money) Seat #1 is the button
Seat 1: color_singleton (10737 in chips) 
Seat 2: JeBoyDirk (14322 in chips) 
Seat 3: dockstarr (16339 in chips) 
Seat 5: Klemtonius (10448 in chips) 
Seat 9: PokerStarsMan12 (10411 in chips) 
JeBoyDirk: posts small blind 50
dockstarr: posts big blind 100
*** HOLE CARDS ***
Dealt to PokerStarsMan12 [Td Ts]
Klemtonius: raises 100 to 200
PokerStarsMan12: raises 300 to 500
color_singleton: calls 500
JeBoyDirk: calls 450
dockstarr: calls 400
Klemtonius: calls 300
*** FLOP *** [5h 3h 6s]
JeBoyDirk: checks 
dockstarr: checks 
Klemtonius: bets 2362
PokerStarsMan12: calls 2362
color_singleton: folds 
JeBoyDirk: folds 
dockstarr: folds 
*** TURN *** [5h 3h 6s] [8c]
Klemtonius: bets 2700
PokerStarsMan12: calls 2700
*** RIVER *** [5h 3h 6s 8c] [Jd]
Klemtonius: bets 3300
PokerStarsMan12: calls 3300
*** SHOW DOWN ***
Klemtonius: shows [Js 5s] (two pair, Jacks and Fives)
PokerStarsMan12: mucks hand 
Klemtonius collected 18167 from pot
*** SUMMARY ***
Total pot 19224 | Rake 1057 
Board [5h 3h 6s 8c Jd]
Seat 1: color_singleton (button) folded on the Flop
Seat 2: JeBoyDirk (small blind) folded on the Flop
Seat 3: dockstarr (big blind) folded on the Flop
Seat 5: Klemtonius showed [Js 5s] and won (18167) with two pair, Jacks and Fives
Seat 9: PokerStarsMan12 mucked [Td Ts]



PokerStars Home Game Hand #228490947621: {DaPokaStars}  Hold'em No Limit (50/100) - 2021/07/22 17:02:19 ET
Table 'Halleria II' 9-max (Play Money) Seat #2 is the button
Seat 1: color_singleton (10237 in chips) 
Seat 2: JeBoyDirk (13822 in chips) 
Seat 3: dockstarr (15839 in chips) 
Seat 5: Klemtonius (19753 in chips) 
Seat 9: PokerStarsMan12 (1549 in chips) 
dockstarr: posts small blind 50
Klemtonius: posts big blind 100
*** HOLE CARDS ***
Dealt to PokerStarsMan12 [9s 5d]
PokerStarsMan12: folds 
color_singleton: folds 
JeBoyDirk: folds 
dockstarr: folds 
Uncalled bet (50) returned to Klemtonius
Klemtonius collected 100 from pot
Klemtonius: doesn't show hand 
*** SUMMARY ***
Total pot 100 | Rake 0 
Seat 1: color_singleton folded before Flop (didn't bet)
Seat 2: JeBoyDirk (button) folded before Flop (didn't bet)
Seat 3: dockstarr (small blind) folded before Flop
Seat 5: Klemtonius (big blind) collected (100)
Seat 9: PokerStarsMan12 folded before Flop (didn't bet)



PokerStars Home Game Hand #228490951535: {DaPokaStars}  Hold'em No Limit (50/100) - 2021/07/22 17:02:28 ET
Table 'Halleria II' 9-max (Play Money) Seat #3 is the button
Seat 1: color_singleton (10237 in chips) 
Seat 2: JeBoyDirk (13822 in chips) 
Seat 3: dockstarr (15789 in chips) 
Seat 5: Klemtonius (19803 in chips) 
Seat 9: PokerStarsMan12 (1549 in chips) 
Klemtonius: posts small blind 50
PokerStarsMan12: posts big blind 100
*** HOLE CARDS ***
Dealt to PokerStarsMan12 [5c 7s]
color_singleton: raises 200 to 300
JeBoyDirk: calls 300
dockstarr: folds 
Klemtonius: calls 250
PokerStarsMan12: folds 
*** FLOP *** [3h Ts 3s]
Klemtonius: checks 
color_singleton: bets 472
JeBoyDirk: folds 
Klemtonius: calls 472
*** TURN *** [3h Ts 3s] [7d]
Klemtonius: checks 
color_singleton: checks 
*** RIVER *** [3h Ts 3s 7d] [6s]
Klemtonius: checks 
color_singleton: checks 
*** SHOW DOWN ***
Klemtonius: shows [Kd Qs] (a pair of Threes)
color_singleton: shows [2c 2h] (two pair, Threes and Deuces)
color_singleton collected 1837 from pot
*** SUMMARY ***
Total pot 1944 | Rake 107 
Board [3h Ts 3s 7d 6s]
Seat 1: color_singleton showed [2c 2h] and won (1837) with two pair, Threes and Deuces
Seat 2: JeBoyDirk folded on the Flop
Seat 3: dockstarr (button) folded before Flop (didn't bet)
Seat 5: Klemtonius (small blind) showed [Kd Qs] and lost with a pair of Threes
Seat 9: PokerStarsMan12 (big blind) folded before Flop



PokerStars Home Game Hand #228490973345: {DaPokaStars}  Hold'em No Limit (50/100) - 2021/07/22 17:03:14 ET
Table 'Halleria II' 9-max (Play Money) Seat #5 is the button
Seat 1: color_singleton (11302 in chips) 
Seat 2: JeBoyDirk (13522 in chips) 
Seat 3: dockstarr (15789 in chips) 
Seat 5: Klemtonius (19031 in chips) 
Seat 9: PokerStarsMan12 (1449 in chips) 
PokerStarsMan12: posts small blind 50
color_singleton: posts big blind 100
*** HOLE CARDS ***
Dealt to PokerStarsMan12 [4s Qh]
JeBoyDirk: folds 
dockstarr: folds 
Klemtonius: calls 100
PokerStarsMan12: calls 50
color_singleton: raises 200 to 300
Klemtonius: calls 200
PokerStarsMan12: calls 200
*** FLOP *** [6c 2h 7s]
PokerStarsMan12: checks 
color_singleton: bets 425
Klemtonius: calls 425
PokerStarsMan12: folds 
*** TURN *** [6c 2h 7s] [9c]
color_singleton: checks 
Klemtonius: bets 827
color_singleton: calls 827
*** RIVER *** [6c 2h 7s 9c] [Th]
color_singleton: checks 
Klemtonius: checks 
*** SHOW DOWN ***
color_singleton: shows [2s As] (a pair of Deuces)
Klemtonius: shows [7d Jc] (a pair of Sevens)
Klemtonius collected 3217 from pot
*** SUMMARY ***
Total pot 3404 | Rake 187 
Board [6c 2h 7s 9c Th]
Seat 1: color_singleton (big blind) showed [2s As] and lost with a pair of Deuces
Seat 2: JeBoyDirk folded before Flop (didn't bet)
Seat 3: dockstarr folded before Flop (didn't bet)
Seat 5: Klemtonius (button) showed [7d Jc] and won (3217) with a pair of Sevens
Seat 9: PokerStarsMan12 (small blind) folded on the Flop



PokerStars Home Game Hand #228490995527: {DaPokaStars}  Hold'em No Limit (50/100) - 2021/07/22 17:04:01 ET
Table 'Halleria II' 9-max (Play Money) Seat #9 is the button
Seat 1: color_singleton (9750 in chips) 
Seat 2: JeBoyDirk (13522 in chips) 
Seat 3: dockstarr (15789 in chips) 
Seat 5: Klemtonius (20696 in chips) 
Seat 9: PokerStarsMan12 (1149 in chips) 
color_singleton: posts small blind 50
JeBoyDirk: posts big blind 100
*** HOLE CARDS ***
Dealt to PokerStarsMan12 [6h 7s]
dockstarr: calls 100
Klemtonius: calls 100
PokerStarsMan12: calls 100
color_singleton: calls 50
JeBoyDirk: checks 
*** FLOP *** [5s 9s Qh]
color_singleton: bets 236
JeBoyDirk: calls 236
dockstarr: calls 236
Klemtonius: folds 
PokerStarsMan12: folds 
*** TURN *** [5s 9s Qh] [2c]
color_singleton: bets 571
JeBoyDirk: folds 
dockstarr: calls 571
*** RIVER *** [5s 9s Qh 2c] [Kd]
color_singleton: checks 
dockstarr: checks 
*** SHOW DOWN ***
color_singleton: shows [6d 5d] (a pair of Fives)
dockstarr: shows [Qs 2d] (two pair, Queens and Deuces)
dockstarr collected 2221 from pot
*** SUMMARY ***
Total pot 2350 | Rake 129 
Board [5s 9s Qh 2c Kd]
Seat 1: color_singleton (small blind) showed [6d 5d] and lost with a pair of Fives
Seat 2: JeBoyDirk (big blind) folded on the Turn
Seat 3: dockstarr showed [Qs 2d] and won (2221) with two pair, Queens and Deuces
Seat 5: Klemtonius folded on the Flop
Seat 9: PokerStarsMan12 (button) folded on the Flop



PokerStars Home Game Hand #228491025152: {DaPokaStars}  Hold'em No Limit (50/100) - 2021/07/22 17:04:45 ET
Table 'Halleria II' 9-max (Play Money) Seat #1 is the button
Seat 1: color_singleton (8843 in chips) 
Seat 2: JeBoyDirk (13186 in chips) 
Seat 3: dockstarr (17103 in chips) 
Seat 5: Klemtonius (20596 in chips) 
Seat 9: PokerStarsMan12 (1049 in chips) 
JeBoyDirk: posts small blind 50
dockstarr: posts big blind 100
*** HOLE CARDS ***
Dealt to PokerStarsMan12 [Th 6d]
Klemtonius: calls 100
PokerStarsMan12: folds 
color_singleton: folds 
JeBoyDirk: calls 50
dockstarr: checks 
*** FLOP *** [7s Jc Ad]
JeBoyDirk: checks 
dockstarr: checks 
Klemtonius: bets 141
JeBoyDirk: calls 141
dockstarr: folds 
*** TURN *** [7s Jc Ad] [Jh]
JeBoyDirk: checks 
Klemtonius: checks 
*** RIVER *** [7s Jc Ad Jh] [8c]
JeBoyDirk: checks 
Klemtonius: bets 275
JeBoyDirk: folds 
Uncalled bet (275) returned to Klemtonius
Klemtonius collected 550 from pot
Klemtonius: doesn't show hand 
*** SUMMARY ***
Total pot 582 | Rake 32 
Board [7s Jc Ad Jh 8c]
Seat 1: color_singleton (button) folded before Flop (didn't bet)
Seat 2: JeBoyDirk (small blind) folded on the River
Seat 3: dockstarr (big blind) folded on the Flop
Seat 5: Klemtonius collected (550)
Seat 9: PokerStarsMan12 folded before Flop (didn't bet)



PokerStars Home Game Hand #228491046995: {DaPokaStars}  Hold'em No Limit (50/100) - 2021/07/22 17:05:31 ET
Table 'Halleria II' 9-max (Play Money) Seat #2 is the button
Seat 1: color_singleton (8843 in chips) 
Seat 2: JeBoyDirk (12945 in chips) 
Seat 3: dockstarr (17003 in chips) 
Seat 5: Klemtonius (20905 in chips) 
Seat 9: PokerStarsMan12 (1049 in chips) 
dockstarr: posts small blind 50
Klemtonius: posts big blind 100
*** HOLE CARDS ***
Dealt to PokerStarsMan12 [5c 2s]
PokerStarsMan12: folds 
color_singleton has timed out
color_singleton: folds 
JeBoyDirk: raises 300 to 400
dockstarr: folds 
Klemtonius: calls 300
*** FLOP *** [9d 7d Qc]
Klemtonius: checks 
JeBoyDirk: bets 800
Klemtonius: raises 3900 to 4700
JeBoyDirk: raises 3900 to 8600
Klemtonius: calls 3900
*** TURN *** [9d 7d Qc] [As]
Klemtonius: bets 4000
JeBoyDirk: calls 3945 and is all-in
Uncalled bet (55) returned to Klemtonius
*** RIVER *** [9d 7d Qc As] [Ts]
*** SHOW DOWN ***
Klemtonius: shows [Qd 4d] (a pair of Queens)
JeBoyDirk: shows [Kc Ks] (a pair of Kings)
JeBoyDirk collected 24513 from pot
*** SUMMARY ***
Total pot 25940 | Rake 1427 
Board [9d 7d Qc As Ts]
Seat 1: color_singleton folded before Flop (didn't bet)
Seat 2: JeBoyDirk (button) showed [Kc Ks] and won (24513) with a pair of Kings
Seat 3: dockstarr (small blind) folded before Flop
Seat 5: Klemtonius (big blind) showed [Qd 4d] and lost with a pair of Queens
Seat 9: PokerStarsMan12 folded before Flop (didn't bet)



PokerStars Home Game Hand #228491077573: {DaPokaStars}  Hold'em No Limit (50/100) - 2021/07/22 17:06:35 ET
Table 'Halleria II' 9-max (Play Money) Seat #3 is the button
Seat 2: JeBoyDirk (24513 in chips) 
Seat 3: dockstarr (16953 in chips) 
Seat 5: Klemtonius (7960 in chips) 
Seat 9: PokerStarsMan12 (1049 in chips) 
Klemtonius: posts small blind 50
PokerStarsMan12: posts big blind 100
*** HOLE CARDS ***
Dealt to PokerStarsMan12 [3d Qs]
JeBoyDirk: calls 100
dockstarr: calls 100
Klemtonius: calls 50
PokerStarsMan12: checks 
*** FLOP *** [9h 2c Js]
Klemtonius: bets 100
PokerStarsMan12: folds 
JeBoyDirk: folds 
dockstarr: folds 
Uncalled bet (100) returned to Klemtonius
Klemtonius collected 378 from pot
Klemtonius: doesn't show hand 
*** SUMMARY ***
Total pot 400 | Rake 22 
Board [9h 2c Js]
Seat 2: JeBoyDirk folded on the Flop
Seat 3: dockstarr (button) folded on the Flop
Seat 5: Klemtonius (small blind) collected (378)
Seat 9: PokerStarsMan12 (big blind) folded on the Flop



PokerStars Home Game Hand #228491092429: {DaPokaStars}  Hold'em No Limit (50/100) - 2021/07/22 17:07:06 ET
Table 'Halleria II' 9-max (Play Money) Seat #5 is the button
Seat 2: JeBoyDirk (24413 in chips) 
Seat 3: dockstarr (16853 in chips) 
Seat 5: Klemtonius (8238 in chips) 
Seat 9: PokerStarsMan12 (949 in chips) 
PokerStarsMan12: posts small blind 50
JeBoyDirk: posts big blind 100
*** HOLE CARDS ***
Dealt to PokerStarsMan12 [Ks 8c]
dockstarr: calls 100
Klemtonius: calls 100
PokerStarsMan12: calls 50
JeBoyDirk: checks 
*** FLOP *** [2h Qd 9c]
PokerStarsMan12: checks 
JeBoyDirk: checks 
dockstarr: bets 100
Klemtonius: calls 100
PokerStarsMan12: folds 
JeBoyDirk: folds 
*** TURN *** [2h Qd 9c] [Th]
dockstarr: bets 100
Klemtonius: calls 100
*** RIVER *** [2h Qd 9c Th] [3s]
dockstarr: bets 756
Klemtonius: folds 
Uncalled bet (756) returned to dockstarr
dockstarr collected 756 from pot
dockstarr: doesn't show hand 
*** SUMMARY ***
Total pot 800 | Rake 44 
Board [2h Qd 9c Th 3s]
Seat 2: JeBoyDirk (big blind) folded on the Flop
Seat 3: dockstarr collected (756)
Seat 5: Klemtonius (button) folded on the River
Seat 9: PokerStarsMan12 (small blind) folded on the Flop



PokerStars Home Game Hand #228491113623: {DaPokaStars}  Hold'em No Limit (50/100) - 2021/07/22 17:07:51 ET
Table 'Halleria II' 9-max (Play Money) Seat #9 is the button
Seat 2: JeBoyDirk (24313 in chips) 
Seat 3: dockstarr (17309 in chips) 
Seat 5: Klemtonius (7938 in chips) 
Seat 9: PokerStarsMan12 (849 in chips) 
JeBoyDirk: posts small blind 50
dockstarr: posts big blind 100
*** HOLE CARDS ***
Dealt to PokerStarsMan12 [9d Th]
Klemtonius: calls 100
PokerStarsMan12: raises 749 to 849 and is all-in
JeBoyDirk: calls 799
dockstarr: calls 749
Klemtonius: calls 749
*** FLOP *** [Qd 6d 4c]
JeBoyDirk: checks 
dockstarr: checks 
Klemtonius: checks 
*** TURN *** [Qd 6d 4c] [Jd]
JeBoyDirk: checks 
dockstarr: checks 
Klemtonius: checks 
*** RIVER *** [Qd 6d 4c Jd] [5h]
JeBoyDirk: checks 
dockstarr: checks 
Klemtonius: checks 
*** SHOW DOWN ***
JeBoyDirk: shows [Ac Kc] (high card Ace)
dockstarr: mucks hand 
Klemtonius: shows [5c Ks] (a pair of Fives)
PokerStarsMan12: mucks hand 
Klemtonius collected 3209 from pot
*** SUMMARY ***
Total pot 3396 | Rake 187 
Board [Qd 6d 4c Jd 5h]
Seat 2: JeBoyDirk (small blind) showed [Ac Kc] and lost with high card Ace
Seat 3: dockstarr (big blind) mucked [3c 8c]
Seat 5: Klemtonius showed [5c Ks] and won (3209) with a pair of Fives
Seat 9: PokerStarsMan12 (button) mucked [9d Th]



PokerStars Home Game Hand #228491152817: {DaPokaStars}  Hold'em No Limit (50/100) - 2021/07/22 17:09:14 ET
Table 'Halleria II' 9-max (Play Money) Seat #3 is the button
Seat 1: color_singleton (9448 in chips) 
Seat 2: JeBoyDirk (23464 in chips) 
Seat 3: dockstarr (16410 in chips) 
Seat 5: Klemtonius (9668 in chips) 
Seat 9: PokerStarsMan12 (10000 in chips) 
Klemtonius: posts small blind 50
PokerStarsMan12: posts big blind 100
*** HOLE CARDS ***
Dealt to PokerStarsMan12 [6d 5c]
color_singleton: raises 200 to 300
JeBoyDirk: folds 
dockstarr: folds 
Klemtonius: calls 250
PokerStarsMan12: calls 200
*** FLOP *** [3c Qd Kc]
Klemtonius: checks 
PokerStarsMan12: checks 
color_singleton: bets 425
Klemtonius: calls 425
PokerStarsMan12: folds 
*** TURN *** [3c Qd Kc] [Ks]
Klemtonius: checks 
color_singleton: bets 827
Klemtonius: folds 
Uncalled bet (827) returned to color_singleton
color_singleton collected 1654 from pot
color_singleton: doesn't show hand 
*** SUMMARY ***
Total pot 1750 | Rake 96 
Board [3c Qd Kc Ks]
Seat 1: color_singleton collected (1654)
Seat 2: JeBoyDirk folded before Flop (didn't bet)
Seat 3: dockstarr (button) folded before Flop (didn't bet)
Seat 5: Klemtonius (small blind) folded on the Turn
Seat 9: PokerStarsMan12 (big blind) folded on the Flop



PokerStars Home Game Hand #228491168187: {DaPokaStars}  Hold'em No Limit (50/100) - 2021/07/22 17:09:46 ET
Table 'Halleria II' 9-max (Play Money) Seat #5 is the button
Seat 1: color_singleton (10377 in chips) 
Seat 2: JeBoyDirk (23464 in chips) 
Seat 3: dockstarr (16410 in chips) 
Seat 5: Klemtonius (8943 in chips) 
Seat 9: PokerStarsMan12 (9700 in chips) 
PokerStarsMan12: posts small blind 50
color_singleton: posts big blind 100
*** HOLE CARDS ***
Dealt to PokerStarsMan12 [Qd 8c]
JeBoyDirk: folds 
dockstarr: folds 
Klemtonius: calls 100
PokerStarsMan12: calls 50
color_singleton: raises 200 to 300
Klemtonius: calls 200
PokerStarsMan12: calls 200
*** FLOP *** [6d 5d Ah]
PokerStarsMan12: checks 
color_singleton: checks 
Klemtonius: checks 
*** TURN *** [6d 5d Ah] [4c]
PokerStarsMan12: checks 
color_singleton: bets 425
Klemtonius: calls 425
PokerStarsMan12: folds 
*** RIVER *** [6d 5d Ah 4c] [9s]
color_singleton: bets 827
Klemtonius: folds 
Uncalled bet (827) returned to color_singleton
color_singleton collected 1654 from pot
color_singleton: doesn't show hand 
*** SUMMARY ***
Total pot 1750 | Rake 96 
Board [6d 5d Ah 4c 9s]
Seat 1: color_singleton (big blind) collected (1654)
Seat 2: JeBoyDirk folded before Flop (didn't bet)
Seat 3: dockstarr folded before Flop (didn't bet)
Seat 5: Klemtonius (button) folded on the River
Seat 9: PokerStarsMan12 (small blind) folded on the Turn



PokerStars Home Game Hand #228491192856: {DaPokaStars}  Hold'em No Limit (50/100) - 2021/07/22 17:10:39 ET
Table 'Halleria II' 9-max (Play Money) Seat #9 is the button
Seat 1: color_singleton (11306 in chips) 
Seat 2: JeBoyDirk (23464 in chips) 
Seat 3: dockstarr (16410 in chips) 
Seat 5: Klemtonius (8218 in chips) 
Seat 9: PokerStarsMan12 (9400 in chips) 
color_singleton: posts small blind 50
JeBoyDirk: posts big blind 100
*** HOLE CARDS ***
Dealt to PokerStarsMan12 [7s 9s]
dockstarr: calls 100
Klemtonius: calls 100
PokerStarsMan12: calls 100
color_singleton: raises 100 to 200
JeBoyDirk: folds 
dockstarr: calls 100
Klemtonius: calls 100
PokerStarsMan12: calls 100
*** FLOP *** [7d Kd 6d]
color_singleton: bets 425
dockstarr: folds 
Klemtonius: raises 1700 to 2125
PokerStarsMan12: folds 
color_singleton: calls 1700
*** TURN *** [7d Kd 6d] [9c]
color_singleton: checks 
Klemtonius: checks 
*** RIVER *** [7d Kd 6d 9c] [Th]
color_singleton: checks 
Klemtonius: checks 
*** SHOW DOWN ***
color_singleton: shows [Ad 3c] (high card Ace)
Klemtonius: shows [5d 4d] (a flush, King high)
Klemtonius collected 4867 from pot
*** SUMMARY ***
Total pot 5150 | Rake 283 
Board [7d Kd 6d 9c Th]
Seat 1: color_singleton (small blind) showed [Ad 3c] and lost with high card Ace
Seat 2: JeBoyDirk (big blind) folded before Flop
Seat 3: dockstarr folded on the Flop
Seat 5: Klemtonius showed [5d 4d] and won (4867) with a flush, King high
Seat 9: PokerStarsMan12 (button) folded on the Flop



PokerStars Home Game Hand #228491212907: {DaPokaStars}  Hold'em No Limit (50/100) - 2021/07/22 17:11:22 ET
Table 'Halleria II' 9-max (Play Money) Seat #1 is the button
Seat 1: color_singleton (8981 in chips) 
Seat 2: JeBoyDirk (23364 in chips) 
Seat 3: dockstarr (16210 in chips) 
Seat 5: Klemtonius (10760 in chips) 
Seat 9: PokerStarsMan12 (9200 in chips) 
JeBoyDirk: posts small blind 50
dockstarr: posts big blind 100
*** HOLE CARDS ***
Dealt to PokerStarsMan12 [As Kd]
Klemtonius: calls 100
PokerStarsMan12: raises 300 to 400
color_singleton: calls 400
JeBoyDirk: folds 
dockstarr: calls 300
Klemtonius: folds 
*** FLOP *** [5s 2c Kh]
dockstarr: checks 
PokerStarsMan12: checks 
color_singleton: bets 638
dockstarr: calls 638
PokerStarsMan12: calls 638
*** TURN *** [5s 2c Kh] [Qh]
dockstarr: checks 
PokerStarsMan12: bets 1000
color_singleton: calls 1000
dockstarr: folds 
*** RIVER *** [5s 2c Kh Qh] [Ad]
PokerStarsMan12: bets 2700
color_singleton: raises 4243 to 6943 and is all-in
PokerStarsMan12: calls 4243
*** SHOW DOWN ***
color_singleton: shows [Qc Qs] (three of a kind, Queens)
PokerStarsMan12: shows [As Kd] (two pair, Aces and Kings)
color_singleton collected 18097 from pot
*** SUMMARY ***
Total pot 19150 | Rake 1053 
Board [5s 2c Kh Qh Ad]
Seat 1: color_singleton (button) showed [Qc Qs] and won (18097) with three of a kind, Queens
Seat 2: JeBoyDirk (small blind) folded before Flop
Seat 3: dockstarr (big blind) folded on the Turn
Seat 5: Klemtonius folded before Flop
Seat 9: PokerStarsMan12 showed [As Kd] and lost with two pair, Aces and Kings



PokerStars Home Game Hand #228491244761: {DaPokaStars}  Hold'em No Limit (50/100) - 2021/07/22 17:12:30 ET
Table 'Halleria II' 9-max (Play Money) Seat #2 is the button
Seat 1: color_singleton (18097 in chips) 
Seat 2: JeBoyDirk (23314 in chips) 
Seat 3: dockstarr (15172 in chips) 
Seat 5: Klemtonius (10660 in chips) 
Seat 9: PokerStarsMan12 (219 in chips) 
dockstarr: posts small blind 50
Klemtonius: posts big blind 100
*** HOLE CARDS ***
Dealt to PokerStarsMan12 [7c 5h]
PokerStarsMan12: raises 119 to 219 and is all-in
color_singleton: folds 
JeBoyDirk: folds 
dockstarr: folds 
Klemtonius: calls 119
*** FLOP *** [6d Ac Ks]
*** TURN *** [6d Ac Ks] [6s]
*** RIVER *** [6d Ac Ks 6s] [2d]
*** SHOW DOWN ***
Klemtonius: shows [Kd 6h] (a full house, Sixes full of Kings)
PokerStarsMan12: shows [7c 5h] (a pair of Sixes)
Klemtonius collected 461 from pot
*** SUMMARY ***
Total pot 488 | Rake 27 
Board [6d Ac Ks 6s 2d]
Seat 1: color_singleton folded before Flop (didn't bet)
Seat 2: JeBoyDirk (button) folded before Flop (didn't bet)
Seat 3: dockstarr (small blind) folded before Flop
Seat 5: Klemtonius (big blind) showed [Kd 6h] and won (461) with a full house, Sixes full of Kings
Seat 9: PokerStarsMan12 showed [7c 5h] and lost with a pair of Sixes



PokerStars Home Game Hand #228491326730: {DaPokaStars}  Hold'em No Limit (50/100) - 2021/07/22 17:15:14 ET
Table 'Halleria II' 9-max (Play Money) Seat #3 is the button
Seat 1: color_singleton (18306 in chips) 
Seat 2: JeBoyDirk (23023 in chips) 
Seat 3: dockstarr (15055 in chips) 
Seat 5: Klemtonius (11002 in chips) 
Seat 9: PokerStarsMan12 (10000 in chips) 
Klemtonius: posts small blind 50
PokerStarsMan12: posts big blind 100
*** HOLE CARDS ***
Dealt to PokerStarsMan12 [5d 6s]
color_singleton: folds 
JeBoyDirk: calls 100
dockstarr: calls 100
Klemtonius: raises 100 to 200
PokerStarsMan12: calls 100
JeBoyDirk: calls 100
dockstarr: calls 100
*** FLOP *** [9d Qh Ah]
Klemtonius: checks 
PokerStarsMan12: checks 
JeBoyDirk: checks 
dockstarr: checks 
*** TURN *** [9d Qh Ah] [Kh]
Klemtonius: bets 756
PokerStarsMan12: folds 
JeBoyDirk: folds 
dockstarr: folds 
Uncalled bet (756) returned to Klemtonius
Klemtonius collected 756 from pot
Klemtonius: doesn't show hand 
*** SUMMARY ***
Total pot 800 | Rake 44 
Board [9d Qh Ah Kh]
Seat 1: color_singleton folded before Flop (didn't bet)
Seat 2: JeBoyDirk folded on the Turn
Seat 3: dockstarr (button) folded on the Turn
Seat 5: Klemtonius (small blind) collected (756)
Seat 9: PokerStarsMan12 (big blind) folded on the Turn



PokerStars Home Game Hand #228491347895: {DaPokaStars}  Hold'em No Limit (50/100) - 2021/07/22 17:15:59 ET
Table 'Halleria II' 9-max (Play Money) Seat #5 is the button
Seat 1: color_singleton (18306 in chips) 
Seat 2: JeBoyDirk (22823 in chips) 
Seat 3: dockstarr (14855 in chips) 
Seat 5: Klemtonius (11558 in chips) 
Seat 9: PokerStarsMan12 (9800 in chips) 
PokerStarsMan12: posts small blind 50
color_singleton: posts big blind 100
*** HOLE CARDS ***
Dealt to PokerStarsMan12 [Kh Qd]
JeBoyDirk: folds 
dockstarr: folds 
Klemtonius: calls 100
PokerStarsMan12: raises 200 to 300
color_singleton: calls 200
Klemtonius: calls 200
*** FLOP *** [9h 5h 9s]
PokerStarsMan12: checks 
color_singleton: bets 425
Klemtonius: calls 425
PokerStarsMan12: calls 425
*** TURN *** [9h 5h 9s] [9c]
PokerStarsMan12: checks 
color_singleton: bets 2055
Klemtonius: calls 2055
PokerStarsMan12: folds 
*** RIVER *** [9h 5h 9s 9c] [8c]
color_singleton: bets 5939
Klemtonius: folds 
Uncalled bet (5939) returned to color_singleton
color_singleton collected 5939 from pot
color_singleton: doesn't show hand 
*** SUMMARY ***
Total pot 6285 | Rake 346 
Board [9h 5h 9s 9c 8c]
Seat 1: color_singleton (big blind) collected (5939)
Seat 2: JeBoyDirk folded before Flop (didn't bet)
Seat 3: dockstarr folded before Flop (didn't bet)
Seat 5: Klemtonius (button) folded on the River
Seat 9: PokerStarsMan12 (small blind) folded on the Turn



PokerStars Home Game Hand #228491373714: {DaPokaStars}  Hold'em No Limit (50/100) - 2021/07/22 17:16:55 ET
Table 'Halleria II' 9-max (Play Money) Seat #9 is the button
Seat 1: color_singleton (21465 in chips) 
Seat 2: JeBoyDirk (22823 in chips) 
Seat 3: dockstarr (14855 in chips) 
Seat 5: Klemtonius (8778 in chips) 
Seat 9: PokerStarsMan12 (9075 in chips) 
color_singleton: posts small blind 50
JeBoyDirk: posts big blind 100
*** HOLE CARDS ***
Dealt to PokerStarsMan12 [7s 7h]
dockstarr: folds 
Klemtonius: calls 100
PokerStarsMan12: raises 300 to 400
color_singleton: folds 
JeBoyDirk: folds 
Klemtonius: calls 300
*** FLOP *** [Qh Td 5d]
Klemtonius: checks 
PokerStarsMan12: bets 500
Klemtonius: calls 500
*** TURN *** [Qh Td 5d] [Kc]
Klemtonius: checks 
PokerStarsMan12: bets 100
Klemtonius: calls 100
*** RIVER *** [Qh Td 5d Kc] [Kd]
Klemtonius: checks 
PokerStarsMan12: checks 
*** SHOW DOWN ***
Klemtonius: shows [Ad 3d] (a flush, Ace high)
PokerStarsMan12: mucks hand 
Klemtonius collected 2032 from pot
*** SUMMARY ***
Total pot 2150 | Rake 118 
Board [Qh Td 5d Kc Kd]
Seat 1: color_singleton (small blind) folded before Flop
Seat 2: JeBoyDirk (big blind) folded before Flop
Seat 3: dockstarr folded before Flop (didn't bet)
Seat 5: Klemtonius showed [Ad 3d] and won (2032) with a flush, Ace high
Seat 9: PokerStarsMan12 (button) mucked [7s 7h]



PokerStars Home Game Hand #228491401242: {DaPokaStars}  Hold'em No Limit (50/100) - 2021/07/22 17:17:54 ET
Table 'Halleria II' 9-max (Play Money) Seat #1 is the button
Seat 1: color_singleton (21415 in chips) 
Seat 2: JeBoyDirk (22723 in chips) 
Seat 5: Klemtonius (9810 in chips) 
Seat 9: PokerStarsMan12 (8075 in chips) 
JeBoyDirk: posts small blind 50
Klemtonius: posts big blind 100
*** HOLE CARDS ***
Dealt to PokerStarsMan12 [Jc Tc]
PokerStarsMan12: raises 200 to 300
color_singleton: calls 300
JeBoyDirk: calls 250
Klemtonius: calls 200
*** FLOP *** [Qh 6c 3h]
JeBoyDirk: checks 
Klemtonius: checks 
PokerStarsMan12: checks 
color_singleton: checks 
*** TURN *** [Qh 6c 3h] [5s]
JeBoyDirk: checks 
Klemtonius: checks 
PokerStarsMan12: checks 
color_singleton: bets 567
JeBoyDirk: folds 
Klemtonius: folds 
PokerStarsMan12: folds 
Uncalled bet (567) returned to color_singleton
color_singleton collected 1134 from pot
color_singleton: doesn't show hand 
*** SUMMARY ***
Total pot 1200 | Rake 66 
Board [Qh 6c 3h 5s]
Seat 1: color_singleton (button) collected (1134)
Seat 2: JeBoyDirk (small blind) folded on the Turn
Seat 5: Klemtonius (big blind) folded on the Turn
Seat 9: PokerStarsMan12 folded on the Turn



PokerStars Home Game Hand #228491421659: {DaPokaStars}  Hold'em No Limit (50/100) - 2021/07/22 17:18:38 ET
Table 'Halleria II' 9-max (Play Money) Seat #2 is the button
Seat 1: color_singleton (22249 in chips) 
Seat 2: JeBoyDirk (22423 in chips) 
Seat 5: Klemtonius (9510 in chips) 
Seat 9: PokerStarsMan12 (7775 in chips) 
Klemtonius: posts small blind 50
PokerStarsMan12: posts big blind 100
*** HOLE CARDS ***
Dealt to PokerStarsMan12 [Ts Qd]
color_singleton: raises 100 to 200
JeBoyDirk: folds 
Klemtonius: calls 150
PokerStarsMan12: calls 100
*** FLOP *** [2c 3h Th]
Klemtonius: checks 
PokerStarsMan12: bets 300
color_singleton: folds 
Klemtonius: folds 
Uncalled bet (300) returned to PokerStarsMan12
PokerStarsMan12 collected 567 from pot
*** SUMMARY ***
Total pot 600 | Rake 33 
Board [2c 3h Th]
Seat 1: color_singleton folded on the Flop
Seat 2: JeBoyDirk (button) folded before Flop (didn't bet)
Seat 5: Klemtonius (small blind) folded on the Flop
Seat 9: PokerStarsMan12 (big blind) collected (567)



PokerStars Home Game Hand #228491438016: {DaPokaStars}  Hold'em No Limit (50/100) - 2021/07/22 17:19:14 ET
Table 'Halleria II' 9-max (Play Money) Seat #5 is the button
Seat 1: color_singleton (22049 in chips) 
Seat 2: JeBoyDirk (22423 in chips) 
Seat 3: dockstarr (14855 in chips) 
Seat 5: Klemtonius (9310 in chips) 
Seat 9: PokerStarsMan12 (8142 in chips) 
PokerStarsMan12: posts small blind 50
color_singleton: posts big blind 100
dockstarr: posts small & big blinds 150
*** HOLE CARDS ***
Dealt to PokerStarsMan12 [6h 8c]
JeBoyDirk: folds 
dockstarr: raises 100 to 200
Klemtonius: calls 200
PokerStarsMan12: folds 
color_singleton: calls 100
*** FLOP *** [7s 2c Jh]
color_singleton: bets 330
dockstarr: folds 
Klemtonius: raises 330 to 660
color_singleton: calls 330
*** TURN *** [7s 2c Jh] [2s]
color_singleton: checks 
Klemtonius: bets 1909
color_singleton: folds 
Uncalled bet (1909) returned to Klemtonius
Klemtonius collected 1909 from pot
Klemtonius: doesn't show hand 
*** SUMMARY ***
Total pot 2020 | Rake 111 
Board [7s 2c Jh 2s]
Seat 1: color_singleton (big blind) folded on the Turn
Seat 2: JeBoyDirk folded before Flop (didn't bet)
Seat 3: dockstarr folded on the Flop
Seat 5: Klemtonius (button) collected (1909)
Seat 9: PokerStarsMan12 (small blind) folded before Flop



PokerStars Home Game Hand #228491455769: {DaPokaStars}  Hold'em No Limit (50/100) - 2021/07/22 17:19:52 ET
Table 'Halleria II' 9-max (Play Money) Seat #9 is the button
Seat 1: color_singleton (21189 in chips) 
Seat 2: JeBoyDirk (22423 in chips) 
Seat 3: dockstarr (14605 in chips) 
Seat 5: Klemtonius (10359 in chips) 
Seat 9: PokerStarsMan12 (8092 in chips) 
color_singleton: posts small blind 50
JeBoyDirk: posts big blind 100
*** HOLE CARDS ***
Dealt to PokerStarsMan12 [8c 3h]
dockstarr: folds 
Klemtonius: folds 
PokerStarsMan12: folds 
color_singleton: raises 100 to 200
JeBoyDirk: raises 100 to 300
color_singleton: calls 100
*** FLOP *** [Qd Th 4h]
color_singleton: checks 
JeBoyDirk: bets 300
color_singleton: folds 
Uncalled bet (300) returned to JeBoyDirk
JeBoyDirk collected 567 from pot
*** SUMMARY ***
Total pot 600 | Rake 33 
Board [Qd Th 4h]
Seat 1: color_singleton (small blind) folded on the Flop
Seat 2: JeBoyDirk (big blind) collected (567)
Seat 3: dockstarr folded before Flop (didn't bet)
Seat 5: Klemtonius folded before Flop (didn't bet)
Seat 9: PokerStarsMan12 (button) folded before Flop (didn't bet)



PokerStars Home Game Hand #228491465063: {DaPokaStars}  Hold'em No Limit (50/100) - 2021/07/22 17:20:13 ET
Table 'Halleria II' 9-max (Play Money) Seat #1 is the button
Seat 1: color_singleton (20889 in chips) 
Seat 2: JeBoyDirk (22690 in chips) 
Seat 3: dockstarr (14605 in chips) 
Seat 5: Klemtonius (10359 in chips) 
Seat 9: PokerStarsMan12 (8092 in chips) 
JeBoyDirk: posts small blind 50
dockstarr: posts big blind 100
*** HOLE CARDS ***
Dealt to PokerStarsMan12 [7c 4c]
Klemtonius: folds 
PokerStarsMan12: raises 300 to 400
color_singleton: calls 400
JeBoyDirk: calls 350
dockstarr: folds 
*** FLOP *** [9s Ac As]
JeBoyDirk: checks 
PokerStarsMan12: checks 
color_singleton: bets 300
JeBoyDirk: calls 300
PokerStarsMan12: folds 
*** TURN *** [9s Ac As] [5h]
JeBoyDirk: checks 
color_singleton: checks 
*** RIVER *** [9s Ac As 5h] [6d]
JeBoyDirk: bets 1000
color_singleton: folds 
Uncalled bet (1000) returned to JeBoyDirk
JeBoyDirk collected 1795 from pot
*** SUMMARY ***
Total pot 1900 | Rake 105 
Board [9s Ac As 5h 6d]
Seat 1: color_singleton (button) folded on the River
Seat 2: JeBoyDirk (small blind) collected (1795)
Seat 3: dockstarr (big blind) folded before Flop
Seat 5: Klemtonius folded before Flop (didn't bet)
Seat 9: PokerStarsMan12 folded on the Flop



PokerStars Home Game Hand #228491489509: {DaPokaStars}  Hold'em No Limit (50/100) - 2021/07/22 17:21:06 ET
Table 'Halleria II' 9-max (Play Money) Seat #2 is the button
Seat 1: color_singleton (20189 in chips) 
Seat 2: JeBoyDirk (23785 in chips) 
Seat 3: dockstarr (14505 in chips) 
Seat 5: Klemtonius (10359 in chips) 
Seat 9: PokerStarsMan12 (7692 in chips) 
dockstarr: posts small blind 50
Klemtonius: posts big blind 100
*** HOLE CARDS ***
Dealt to PokerStarsMan12 [Ks 6d]
PokerStarsMan12: calls 100
color_singleton: raises 400 to 500
JeBoyDirk: folds 
dockstarr: folds 
Klemtonius: folds 
PokerStarsMan12: folds 
Uncalled bet (400) returned to color_singleton
color_singleton collected 350 from pot
color_singleton: doesn't show hand 
*** SUMMARY ***
Total pot 350 | Rake 0 
Seat 1: color_singleton collected (350)
Seat 2: JeBoyDirk (button) folded before Flop (didn't bet)
Seat 3: dockstarr (small blind) folded before Flop
Seat 5: Klemtonius (big blind) folded before Flop
Seat 9: PokerStarsMan12 folded before Flop



PokerStars Home Game Hand #228491501145: {DaPokaStars}  Hold'em No Limit (50/100) - 2021/07/22 17:21:31 ET
Table 'Halleria II' 9-max (Play Money) Seat #3 is the button
Seat 1: color_singleton (20439 in chips) 
Seat 2: JeBoyDirk (23785 in chips) 
Seat 3: dockstarr (14455 in chips) 
Seat 5: Klemtonius (10259 in chips) 
Seat 9: PokerStarsMan12 (7592 in chips) 
Klemtonius: posts small blind 50
PokerStarsMan12: posts big blind 100
*** HOLE CARDS ***
Dealt to PokerStarsMan12 [4c Kd]
color_singleton: folds 
JeBoyDirk: folds 
dockstarr: folds 
Klemtonius: raises 100 to 200
PokerStarsMan12: calls 100
*** FLOP *** [Js 5d 8s]
Klemtonius: checks 
PokerStarsMan12: checks 
*** TURN *** [Js 5d 8s] [6c]
Klemtonius: checks 
PokerStarsMan12: checks 
*** RIVER *** [Js 5d 8s 6c] [Ad]
Klemtonius: checks 
PokerStarsMan12: checks 
*** SHOW DOWN ***
Klemtonius: shows [Kc Th] (high card Ace)
PokerStarsMan12: mucks hand 
Klemtonius collected 378 from pot
*** SUMMARY ***
Total pot 400 | Rake 22 
Board [Js 5d 8s 6c Ad]
Seat 1: color_singleton folded before Flop (didn't bet)
Seat 2: JeBoyDirk folded before Flop (didn't bet)
Seat 3: dockstarr (button) folded before Flop (didn't bet)
Seat 5: Klemtonius (small blind) showed [Kc Th] and won (378) with high card Ace
Seat 9: PokerStarsMan12 (big blind) mucked [4c Kd]



PokerStars Home Game Hand #228491516463: {DaPokaStars}  Hold'em No Limit (50/100) - 2021/07/22 17:22:05 ET
Table 'Halleria II' 9-max (Play Money) Seat #5 is the button
Seat 1: color_singleton (20439 in chips) 
Seat 2: JeBoyDirk (23785 in chips) 
Seat 3: dockstarr (14455 in chips) 
Seat 5: Klemtonius (10437 in chips) 
Seat 9: PokerStarsMan12 (7392 in chips) 
PokerStarsMan12: posts small blind 50
color_singleton: posts big blind 100
*** HOLE CARDS ***
Dealt to PokerStarsMan12 [2s 3d]
JeBoyDirk: folds 
dockstarr: folds 
Klemtonius: raises 100 to 200
PokerStarsMan12: folds 
color_singleton: calls 100
*** FLOP *** [8c Kc Kh]
color_singleton: bets 425
Klemtonius: calls 425
*** TURN *** [8c Kc Kh] [9d]
color_singleton: bets 1228
Klemtonius: calls 1228
*** RIVER *** [8c Kc Kh 9d] [6s]
color_singleton: bets 1774
Klemtonius: calls 1774
*** SHOW DOWN ***
color_singleton: shows [8h As] (two pair, Kings and Eights)
Klemtonius: shows [Tc Kd] (three of a kind, Kings)
Klemtonius collected 6902 from pot
*** SUMMARY ***
Total pot 7304 | Rake 402 
Board [8c Kc Kh 9d 6s]
Seat 1: color_singleton (big blind) showed [8h As] and lost with two pair, Kings and Eights
Seat 2: JeBoyDirk folded before Flop (didn't bet)
Seat 3: dockstarr folded before Flop (didn't bet)
Seat 5: Klemtonius (button) showed [Tc Kd] and won (6902) with three of a kind, Kings
Seat 9: PokerStarsMan12 (small blind) folded before Flop



PokerStars Home Game Hand #228491536824: {DaPokaStars}  Hold'em No Limit (50/100) - 2021/07/22 17:22:49 ET
Table 'Halleria II' 9-max (Play Money) Seat #9 is the button
Seat 1: color_singleton (16812 in chips) 
Seat 2: JeBoyDirk (23785 in chips) 
Seat 3: dockstarr (14455 in chips) 
Seat 5: Klemtonius (13712 in chips) 
Seat 9: PokerStarsMan12 (7342 in chips) 
color_singleton: posts small blind 50
JeBoyDirk: posts big blind 100
*** HOLE CARDS ***
Dealt to PokerStarsMan12 [7d 3s]
dockstarr: calls 100
Klemtonius: calls 100
PokerStarsMan12: folds 
color_singleton: raises 200 to 300
JeBoyDirk: folds 
dockstarr: calls 200
Klemtonius: calls 200
*** FLOP *** [Qs 8s 6c]
color_singleton: checks 
dockstarr: checks 
Klemtonius: checks 
*** TURN *** [Qs 8s 6c] [Ks]
color_singleton: checks 
dockstarr: checks 
Klemtonius: checks 
*** RIVER *** [Qs 8s 6c Ks] [Ad]
color_singleton: bets 472
dockstarr: calls 472
Klemtonius: folds 
*** SHOW DOWN ***
color_singleton: shows [Ah Th] (a pair of Aces)
dockstarr: mucks hand 
color_singleton collected 1837 from pot
*** SUMMARY ***
Total pot 1944 | Rake 107 
Board [Qs 8s 6c Ks Ad]
Seat 1: color_singleton (small blind) showed [Ah Th] and won (1837) with a pair of Aces
Seat 2: JeBoyDirk (big blind) folded before Flop
Seat 3: dockstarr mucked [5c Ac]
Seat 5: Klemtonius folded on the River
Seat 9: PokerStarsMan12 (button) folded before Flop (didn't bet)



PokerStars Home Game Hand #228491560380: {DaPokaStars}  Hold'em No Limit (50/100) - 2021/07/22 17:23:41 ET
Table 'Halleria II' 9-max (Play Money) Seat #1 is the button
Seat 1: color_singleton (17877 in chips) 
Seat 2: JeBoyDirk (23685 in chips) 
Seat 3: dockstarr (13683 in chips) 
Seat 5: Klemtonius (13412 in chips) 
Seat 9: PokerStarsMan12 (7342 in chips) 
JeBoyDirk: posts small blind 50
dockstarr: posts big blind 100
*** HOLE CARDS ***
Dealt to PokerStarsMan12 [7c 2s]
Klemtonius: calls 100
PokerStarsMan12: folds 
color_singleton: calls 100
JeBoyDirk: calls 50
dockstarr: checks 
*** FLOP *** [5h Ks 5d]
JeBoyDirk: bets 300
dockstarr: calls 300
Klemtonius: folds 
color_singleton: calls 300
*** TURN *** [5h Ks 5d] [Jc]
JeBoyDirk: checks 
dockstarr: bets 100
color_singleton: calls 100
JeBoyDirk: calls 100
*** RIVER *** [5h Ks 5d Jc] [Tc]
JeBoyDirk: checks 
dockstarr: bets 756
color_singleton: folds 
JeBoyDirk: folds 
Uncalled bet (756) returned to dockstarr
dockstarr collected 1512 from pot
dockstarr: doesn't show hand 
*** SUMMARY ***
Total pot 1600 | Rake 88 
Board [5h Ks 5d Jc Tc]
Seat 1: color_singleton (button) folded on the River
Seat 2: JeBoyDirk (small blind) folded on the River
Seat 3: dockstarr (big blind) collected (1512)
Seat 5: Klemtonius folded on the Flop
Seat 9: PokerStarsMan12 folded before Flop (didn't bet)



PokerStars Home Game Hand #228491584908: {DaPokaStars}  Hold'em No Limit (50/100) - 2021/07/22 17:24:35 ET
Table 'Halleria II' 9-max (Play Money) Seat #2 is the button
Seat 1: color_singleton (17377 in chips) 
Seat 2: JeBoyDirk (23185 in chips) 
Seat 3: dockstarr (14695 in chips) 
Seat 5: Klemtonius (13312 in chips) 
Seat 9: PokerStarsMan12 (7342 in chips) 
dockstarr: posts small blind 50
Klemtonius: posts big blind 100
*** HOLE CARDS ***
Dealt to PokerStarsMan12 [5c Js]
PokerStarsMan12: folds 
color_singleton: folds 
JeBoyDirk: calls 100
dockstarr: calls 50
Klemtonius: checks 
*** FLOP *** [6d Ah 2s]
dockstarr: checks 
Klemtonius: checks 
JeBoyDirk: checks 
*** TURN *** [6d Ah 2s] [Ks]
dockstarr: checks 
Klemtonius: checks 
JeBoyDirk: checks 
*** RIVER *** [6d Ah 2s Ks] [9h]
dockstarr: checks 
Klemtonius: checks 
JeBoyDirk: checks 
*** SHOW DOWN ***
dockstarr: shows [Jd 7d] (high card Ace)
Klemtonius: shows [6s 8h] (a pair of Sixes)
JeBoyDirk: shows [9c 3c] (a pair of Nines)
JeBoyDirk collected 283 from pot
*** SUMMARY ***
Total pot 300 | Rake 17 
Board [6d Ah 2s Ks 9h]
Seat 1: color_singleton folded before Flop (didn't bet)
Seat 2: JeBoyDirk (button) showed [9c 3c] and won (283) with a pair of Nines
Seat 3: dockstarr (small blind) showed [Jd 7d] and lost with high card Ace
Seat 5: Klemtonius (big blind) showed [6s 8h] and lost with a pair of Sixes
Seat 9: PokerStarsMan12 folded before Flop (didn't bet)



PokerStars Home Game Hand #228491602886: {DaPokaStars}  Hold'em No Limit (50/100) - 2021/07/22 17:25:15 ET
Table 'Halleria II' 9-max (Play Money) Seat #3 is the button
Seat 1: color_singleton (17377 in chips) 
Seat 2: JeBoyDirk (23368 in chips) 
Seat 3: dockstarr (14595 in chips) 
Seat 5: Klemtonius (13212 in chips) 
Seat 9: PokerStarsMan12 (7342 in chips) 
Klemtonius: posts small blind 50
PokerStarsMan12: posts big blind 100
*** HOLE CARDS ***
Dealt to PokerStarsMan12 [8c 7h]
color_singleton: raises 200 to 300
JeBoyDirk: folds 
dockstarr: calls 300
Klemtonius: calls 250
PokerStarsMan12: calls 200
*** FLOP *** [7c Js Ts]
Klemtonius: checks 
PokerStarsMan12: checks 
color_singleton: bets 567
dockstarr: folds 
Klemtonius: calls 567
PokerStarsMan12: folds 
*** TURN *** [7c Js Ts] [2s]
Klemtonius: checks 
color_singleton: bets 1300
Klemtonius: calls 1300
*** RIVER *** [7c Js Ts 2s] [Th]
Klemtonius: checks 
color_singleton: checks 
*** SHOW DOWN ***
Klemtonius: shows [4c Tc] (three of a kind, Tens)
color_singleton: mucks hand 
Klemtonius collected 4663 from pot
*** SUMMARY ***
Total pot 4934 | Rake 271 
Board [7c Js Ts 2s Th]
Seat 1: color_singleton mucked [Kd Qh]
Seat 2: JeBoyDirk folded before Flop (didn't bet)
Seat 3: dockstarr (button) folded on the Flop
Seat 5: Klemtonius (small blind) showed [4c Tc] and won (4663) with three of a kind, Tens
Seat 9: PokerStarsMan12 (big blind) folded on the Flop



PokerStars Home Game Hand #228491630959: {DaPokaStars}  Hold'em No Limit (50/100) - 2021/07/22 17:26:15 ET
Table 'Halleria II' 9-max (Play Money) Seat #5 is the button
Seat 1: color_singleton (15210 in chips) 
Seat 2: JeBoyDirk (23368 in chips) 
Seat 3: dockstarr (14295 in chips) 
Seat 5: Klemtonius (15708 in chips) 
Seat 9: PokerStarsMan12 (7042 in chips) 
PokerStarsMan12: posts small blind 50
color_singleton: posts big blind 100
*** HOLE CARDS ***
Dealt to PokerStarsMan12 [8c 2d]
JeBoyDirk: calls 100
dockstarr: folds 
Klemtonius: calls 100
PokerStarsMan12: calls 50
color_singleton: raises 200 to 300
JeBoyDirk: calls 200
Klemtonius: calls 200
PokerStarsMan12: folds 
*** FLOP *** [2c 5c Ah]
color_singleton: bets 472
JeBoyDirk: folds 
Klemtonius: folds 
Uncalled bet (472) returned to color_singleton
color_singleton collected 945 from pot
color_singleton: doesn't show hand 
*** SUMMARY ***
Total pot 1000 | Rake 55 
Board [2c 5c Ah]
Seat 1: color_singleton (big blind) collected (945)
Seat 2: JeBoyDirk folded on the Flop
Seat 3: dockstarr folded before Flop (didn't bet)
Seat 5: Klemtonius (button) folded on the Flop
Seat 9: PokerStarsMan12 (small blind) folded before Flop



PokerStars Home Game Hand #228491641264: {DaPokaStars}  Hold'em No Limit (50/100) - 2021/07/22 17:26:38 ET
Table 'Halleria II' 9-max (Play Money) Seat #9 is the button
Seat 1: color_singleton (15855 in chips) 
Seat 2: JeBoyDirk (23068 in chips) 
Seat 3: dockstarr (14295 in chips) 
Seat 5: Klemtonius (15408 in chips) 
Seat 9: PokerStarsMan12 (6942 in chips) 
color_singleton: posts small blind 50
JeBoyDirk: posts big blind 100
*** HOLE CARDS ***
Dealt to PokerStarsMan12 [9d Ac]
dockstarr: folds 
Klemtonius: calls 100
PokerStarsMan12: calls 100
color_singleton: raises 200 to 300
JeBoyDirk: folds 
Klemtonius: folds 
PokerStarsMan12: calls 200
*** FLOP *** [Th Ks 3h]
color_singleton: bets 378
PokerStarsMan12: folds 
Uncalled bet (378) returned to color_singleton
color_singleton collected 756 from pot
color_singleton: doesn't show hand 
*** SUMMARY ***
Total pot 800 | Rake 44 
Board [Th Ks 3h]
Seat 1: color_singleton (small blind) collected (756)
Seat 2: JeBoyDirk (big blind) folded before Flop
Seat 3: dockstarr folded before Flop (didn't bet)
Seat 5: Klemtonius folded before Flop
Seat 9: PokerStarsMan12 (button) folded on the Flop



PokerStars Home Game Hand #228491655589: {DaPokaStars}  Hold'em No Limit (50/100) - 2021/07/22 17:27:10 ET
Table 'Halleria II' 9-max (Play Money) Seat #1 is the button
Seat 1: color_singleton (16311 in chips) 
Seat 2: JeBoyDirk (22968 in chips) 
Seat 3: dockstarr (14295 in chips) 
Seat 5: Klemtonius (15308 in chips) 
Seat 9: PokerStarsMan12 (6642 in chips) 
JeBoyDirk: posts small blind 50
dockstarr: posts big blind 100
*** HOLE CARDS ***
Dealt to PokerStarsMan12 [Ah 4d]
Klemtonius: raises 100 to 200
PokerStarsMan12: calls 200
color_singleton: calls 200
JeBoyDirk: calls 150
dockstarr: calls 100
*** FLOP *** [6d 9h 8c]
JeBoyDirk: checks 
dockstarr: checks 
Klemtonius: bets 100
PokerStarsMan12: folds 
color_singleton: calls 100
JeBoyDirk: calls 100
dockstarr: calls 100
*** TURN *** [6d 9h 8c] [7d]
JeBoyDirk: checks 
dockstarr: checks 
Klemtonius: checks 
color_singleton: checks 
*** RIVER *** [6d 9h 8c 7d] [4h]
JeBoyDirk: checks 
dockstarr: bets 661
Klemtonius: folds 
color_singleton: folds 
JeBoyDirk: folds 
Uncalled bet (661) returned to dockstarr
dockstarr collected 1323 from pot
dockstarr: doesn't show hand 
*** SUMMARY ***
Total pot 1400 | Rake 77 
Board [6d 9h 8c 7d 4h]
Seat 1: color_singleton (button) folded on the River
Seat 2: JeBoyDirk (small blind) folded on the River
Seat 3: dockstarr (big blind) collected (1323)
Seat 5: Klemtonius folded on the River
Seat 9: PokerStarsMan12 folded on the Flop



PokerStars Home Game Hand #228491679498: {DaPokaStars}  Hold'em No Limit (50/100) - 2021/07/22 17:28:03 ET
Table 'Halleria II' 9-max (Play Money) Seat #2 is the button
Seat 1: color_singleton (16011 in chips) 
Seat 2: JeBoyDirk (22668 in chips) 
Seat 3: dockstarr (15318 in chips) 
Seat 5: Klemtonius (15008 in chips) 
Seat 9: PokerStarsMan12 (6442 in chips) 
dockstarr: posts small blind 50
Klemtonius: posts big blind 100
*** HOLE CARDS ***
Dealt to PokerStarsMan12 [9h 9s]
PokerStarsMan12: raises 200 to 300
color_singleton: folds 
JeBoyDirk: folds 
dockstarr: folds 
Klemtonius: calls 200
*** FLOP *** [3h 6c 8s]
Klemtonius: checks 
PokerStarsMan12: bets 500
Klemtonius: folds 
Uncalled bet (500) returned to PokerStarsMan12
PokerStarsMan12 collected 614 from pot
*** SUMMARY ***
Total pot 650 | Rake 36 
Board [3h 6c 8s]
Seat 1: color_singleton folded before Flop (didn't bet)
Seat 2: JeBoyDirk (button) folded before Flop (didn't bet)
Seat 3: dockstarr (small blind) folded before Flop
Seat 5: Klemtonius (big blind) folded on the Flop
Seat 9: PokerStarsMan12 collected (614)



PokerStars Home Game Hand #228491693333: {DaPokaStars}  Hold'em No Limit (50/100) - 2021/07/22 17:28:34 ET
Table 'Halleria II' 9-max (Play Money) Seat #3 is the button
Seat 1: color_singleton (16011 in chips) 
Seat 2: JeBoyDirk (22668 in chips) 
Seat 3: dockstarr (15268 in chips) 
Seat 5: Klemtonius (14708 in chips) 
Seat 9: PokerStarsMan12 (6756 in chips) 
Klemtonius: posts small blind 50
PokerStarsMan12: posts big blind 100
*** HOLE CARDS ***
Dealt to PokerStarsMan12 [5c 6s]
color_singleton: folds 
JeBoyDirk: folds 
dockstarr: calls 100
Klemtonius: folds 
PokerStarsMan12: checks 
*** FLOP *** [Kc Qs Qh]
PokerStarsMan12: checks 
dockstarr: checks 
*** TURN *** [Kc Qs Qh] [7c]
PokerStarsMan12: checks 
dockstarr: checks 
*** RIVER *** [Kc Qs Qh 7c] [9c]
PokerStarsMan12: checks 
dockstarr: checks 
*** SHOW DOWN ***
PokerStarsMan12: shows [5c 6s] (a pair of Queens)
dockstarr: shows [4h Ah] (a pair of Queens - Ace kicker)
dockstarr collected 236 from pot
*** SUMMARY ***
Total pot 250 | Rake 14 
Board [Kc Qs Qh 7c 9c]
Seat 1: color_singleton folded before Flop (didn't bet)
Seat 2: JeBoyDirk folded before Flop (didn't bet)
Seat 3: dockstarr (button) showed [4h Ah] and won (236) with a pair of Queens
Seat 5: Klemtonius (small blind) folded before Flop
Seat 9: PokerStarsMan12 (big blind) showed [5c 6s] and lost with a pair of Queens



PokerStars Home Game Hand #228491703942: {DaPokaStars}  Hold'em No Limit (50/100) - 2021/07/22 17:28:55 ET
Table 'Halleria II' 9-max (Play Money) Seat #5 is the button
Seat 1: color_singleton (16011 in chips) 
Seat 2: JeBoyDirk (22668 in chips) 
Seat 3: dockstarr (15404 in chips) 
Seat 5: Klemtonius (14658 in chips) 
Seat 9: PokerStarsMan12 (6656 in chips) 
PokerStarsMan12: posts small blind 50
color_singleton: posts big blind 100
*** HOLE CARDS ***
Dealt to PokerStarsMan12 [2s Jh]
JeBoyDirk: calls 100
dockstarr: folds 
Klemtonius: raises 100 to 200
PokerStarsMan12: folds 
color_singleton: calls 100
JeBoyDirk: calls 100
*** FLOP *** [6c 2c 7c]
color_singleton: bets 307
JeBoyDirk: folds 
Klemtonius: folds 
Uncalled bet (307) returned to color_singleton
color_singleton collected 614 from pot
color_singleton: doesn't show hand 
*** SUMMARY ***
Total pot 650 | Rake 36 
Board [6c 2c 7c]
Seat 1: color_singleton (big blind) collected (614)
Seat 2: JeBoyDirk folded on the Flop
Seat 3: dockstarr folded before Flop (didn't bet)
Seat 5: Klemtonius (button) folded on the Flop
Seat 9: PokerStarsMan12 (small blind) folded before Flop



PokerStars Home Game Hand #228491714402: {DaPokaStars}  Hold'em No Limit (50/100) - 2021/07/22 17:29:19 ET
Table 'Halleria II' 9-max (Play Money) Seat #9 is the button
Seat 1: color_singleton (16425 in chips) 
Seat 2: JeBoyDirk (22468 in chips) 
Seat 3: dockstarr (15404 in chips) 
Seat 5: Klemtonius (14458 in chips) 
Seat 9: PokerStarsMan12 (6606 in chips) 
color_singleton: posts small blind 50
JeBoyDirk: posts big blind 100
*** HOLE CARDS ***
Dealt to PokerStarsMan12 [Th 5s]
dockstarr: folds 
Klemtonius: calls 100
PokerStarsMan12: folds 
color_singleton: raises 200 to 300
JeBoyDirk: calls 200
Klemtonius: calls 200
*** FLOP *** [5c Tc 8s]
color_singleton: bets 425
JeBoyDirk: calls 425
Klemtonius: raises 1062 to 1487
color_singleton: folds 
JeBoyDirk: calls 1062
*** TURN *** [5c Tc 8s] [3h]
JeBoyDirk: checks 
Klemtonius: bets 4063
JeBoyDirk: folds 
Uncalled bet (4063) returned to Klemtonius
Klemtonius collected 4063 from pot
Klemtonius: doesn't show hand 
*** SUMMARY ***
Total pot 4299 | Rake 236 
Board [5c Tc 8s 3h]
Seat 1: color_singleton (small blind) folded on the Flop
Seat 2: JeBoyDirk (big blind) folded on the Turn
Seat 3: dockstarr folded before Flop (didn't bet)
Seat 5: Klemtonius collected (4063)
Seat 9: PokerStarsMan12 (button) folded before Flop (didn't bet)



PokerStars Home Game Hand #228491738522: {DaPokaStars}  Hold'em No Limit (50/100) - 2021/07/22 17:30:11 ET
Table 'Halleria II' 9-max (Play Money) Seat #1 is the button
Seat 1: color_singleton (15700 in chips) 
Seat 2: JeBoyDirk (20681 in chips) 
Seat 3: dockstarr (15404 in chips) 
Seat 5: Klemtonius (16734 in chips) 
Seat 9: PokerStarsMan12 (6606 in chips) 
JeBoyDirk: posts small blind 50
dockstarr: posts big blind 100
*** HOLE CARDS ***
Dealt to PokerStarsMan12 [5h Ts]
Klemtonius: raises 100 to 200
PokerStarsMan12: folds 
color_singleton: folds 
JeBoyDirk: calls 150
dockstarr: calls 100
*** FLOP *** [Jc 7h 9d]
JeBoyDirk: checks 
dockstarr: checks 
Klemtonius: checks 
*** TURN *** [Jc 7h 9d] [Tc]
JeBoyDirk: checks 
dockstarr: checks 
Klemtonius: bets 283
JeBoyDirk: folds 
dockstarr: folds 
Uncalled bet (283) returned to Klemtonius
Klemtonius collected 567 from pot
Klemtonius: doesn't show hand 
*** SUMMARY ***
Total pot 600 | Rake 33 
Board [Jc 7h 9d Tc]
Seat 1: color_singleton (button) folded before Flop (didn't bet)
Seat 2: JeBoyDirk (small blind) folded on the Turn
Seat 3: dockstarr (big blind) folded on the Turn
Seat 5: Klemtonius collected (567)
Seat 9: PokerStarsMan12 folded before Flop (didn't bet)



PokerStars Home Game Hand #228491750554: {DaPokaStars}  Hold'em No Limit (50/100) - 2021/07/22 17:30:35 ET
Table 'Halleria II' 9-max (Play Money) Seat #2 is the button
Seat 1: color_singleton (15700 in chips) 
Seat 2: JeBoyDirk (20481 in chips) 
Seat 3: dockstarr (15204 in chips) 
Seat 5: Klemtonius (17101 in chips) 
Seat 9: PokerStarsMan12 (6606 in chips) 
dockstarr: posts small blind 50
Klemtonius: posts big blind 100
*** HOLE CARDS ***
Dealt to PokerStarsMan12 [5h 4s]
PokerStarsMan12: calls 100
color_singleton: calls 100
JeBoyDirk: calls 100
dockstarr: folds 
Klemtonius: raises 450 to 550
PokerStarsMan12: folds 
color_singleton: folds 
JeBoyDirk: calls 450
*** FLOP *** [3c 2h 3d]
Klemtonius: checks 
JeBoyDirk: checks 
*** TURN *** [3c 2h 3d] [7d]
Klemtonius: bets 1276
JeBoyDirk: folds 
Uncalled bet (1276) returned to Klemtonius
Klemtonius collected 1276 from pot
Klemtonius: doesn't show hand 
*** SUMMARY ***
Total pot 1350 | Rake 74 
Board [3c 2h 3d 7d]
Seat 1: color_singleton folded before Flop
Seat 2: JeBoyDirk (button) folded on the Turn
Seat 3: dockstarr (small blind) folded before Flop
Seat 5: Klemtonius (big blind) collected (1276)
Seat 9: PokerStarsMan12 folded before Flop



PokerStars Home Game Hand #228491768031: {DaPokaStars}  Hold'em No Limit (50/100) - 2021/07/22 17:31:09 ET
Table 'Halleria II' 9-max (Play Money) Seat #3 is the button
Seat 1: color_singleton (15600 in chips) 
Seat 2: JeBoyDirk (19931 in chips) 
Seat 3: dockstarr (15154 in chips) 
Seat 5: Klemtonius (17827 in chips) 
Seat 9: PokerStarsMan12 (6506 in chips) 
Klemtonius: posts small blind 50
PokerStarsMan12: posts big blind 100
*** HOLE CARDS ***
Dealt to PokerStarsMan12 [8c Kd]
color_singleton: folds 
JeBoyDirk: calls 100
dockstarr: calls 100
Klemtonius: raises 400 to 500
PokerStarsMan12: folds 
JeBoyDirk: folds 
dockstarr: folds 
Uncalled bet (400) returned to Klemtonius
Klemtonius collected 400 from pot
Klemtonius: doesn't show hand 
*** SUMMARY ***
Total pot 400 | Rake 0 
Seat 1: color_singleton folded before Flop (didn't bet)
Seat 2: JeBoyDirk folded before Flop
Seat 3: dockstarr (button) folded before Flop
Seat 5: Klemtonius (small blind) collected (400)
Seat 9: PokerStarsMan12 (big blind) folded before Flop



PokerStars Home Game Hand #228491785173: {DaPokaStars}  Hold'em No Limit (50/100) - 2021/07/22 17:31:42 ET
Table 'Halleria II' 9-max (Play Money) Seat #5 is the button
Seat 1: color_singleton (15600 in chips) 
Seat 2: JeBoyDirk (19831 in chips) 
Seat 3: dockstarr (15054 in chips) 
Seat 5: Klemtonius (18127 in chips) 
Seat 9: PokerStarsMan12 (6406 in chips) 
PokerStarsMan12: posts small blind 50
color_singleton: posts big blind 100
*** HOLE CARDS ***
Dealt to PokerStarsMan12 [Ah Ac]
JeBoyDirk: folds 
dockstarr: folds 
Klemtonius: raises 100 to 200
PokerStarsMan12: raises 400 to 600
color_singleton: folds 
Klemtonius: calls 400
*** FLOP *** [Qs 8s 3h]
PokerStarsMan12: bets 800
Klemtonius: folds 
Uncalled bet (800) returned to PokerStarsMan12
PokerStarsMan12 collected 1228 from pot
*** SUMMARY ***
Total pot 1300 | Rake 72 
Board [Qs 8s 3h]
Seat 1: color_singleton (big blind) folded before Flop
Seat 2: JeBoyDirk folded before Flop (didn't bet)
Seat 3: dockstarr folded before Flop (didn't bet)
Seat 5: Klemtonius (button) folded on the Flop
Seat 9: PokerStarsMan12 (small blind) collected (1228)



PokerStars Home Game Hand #228491795537: {DaPokaStars}  Hold'em No Limit (50/100) - 2021/07/22 17:32:01 ET
Table 'Halleria II' 9-max (Play Money) Seat #9 is the button
Seat 1: color_singleton (15500 in chips) 
Seat 2: JeBoyDirk (19831 in chips) 
Seat 3: dockstarr (15054 in chips) 
Seat 5: Klemtonius (17527 in chips) 
Seat 9: PokerStarsMan12 (7034 in chips) 
color_singleton: posts small blind 50
JeBoyDirk: posts big blind 100
*** HOLE CARDS ***
Dealt to PokerStarsMan12 [9h 3h]
dockstarr: calls 100
Klemtonius: calls 100
PokerStarsMan12: folds 
color_singleton: calls 50
JeBoyDirk: checks 
*** FLOP *** [Qd Qh Td]
color_singleton: checks 
JeBoyDirk: checks 
dockstarr: checks 
Klemtonius: checks 
*** TURN *** [Qd Qh Td] [7d]
color_singleton: checks 
JeBoyDirk: checks 
dockstarr: bets 100
Klemtonius: calls 100
color_singleton: folds 
JeBoyDirk: folds 
*** RIVER *** [Qd Qh Td 7d] [7h]
dockstarr: bets 100
Klemtonius: raises 100 to 200
dockstarr: raises 100 to 300
Klemtonius: raises 100 to 400
dockstarr: raises 100 to 500
Klemtonius: raises 100 to 600
dockstarr: calls 100
*** SHOW DOWN ***
Klemtonius: shows [4s 7s] (a full house, Sevens full of Queens)
dockstarr: mucks hand 
Klemtonius collected 1701 from pot
*** SUMMARY ***
Total pot 1800 | Rake 99 
Board [Qd Qh Td 7d 7h]
Seat 1: color_singleton (small blind) folded on the Turn
Seat 2: JeBoyDirk (big blind) folded on the Turn
Seat 3: dockstarr mucked [9d Jd]
Seat 5: Klemtonius showed [4s 7s] and won (1701) with a full house, Sevens full of Queens
Seat 9: PokerStarsMan12 (button) folded before Flop (didn't bet)



PokerStars Home Game Hand #228491824704: {DaPokaStars}  Hold'em No Limit (50/100) - 2021/07/22 17:32:57 ET
Table 'Halleria II' 9-max (Play Money) Seat #1 is the button
Seat 1: color_singleton (15400 in chips) 
Seat 2: JeBoyDirk (19731 in chips) 
Seat 3: dockstarr (14254 in chips) 
Seat 5: Klemtonius (18428 in chips) 
Seat 9: PokerStarsMan12 (7034 in chips) 
JeBoyDirk: posts small blind 50
dockstarr: posts big blind 100
*** HOLE CARDS ***
Dealt to PokerStarsMan12 [7d 5s]
Klemtonius: calls 100
PokerStarsMan12: folds 
color_singleton: raises 200 to 300
JeBoyDirk: folds 
dockstarr: folds 
Klemtonius: calls 200
*** FLOP *** [3s 8c 4c]
Klemtonius: checks 
color_singleton: checks 
*** TURN *** [3s 8c 4c] [Ad]
Klemtonius: checks 
color_singleton: bets 354
Klemtonius: folds 
Uncalled bet (354) returned to color_singleton
color_singleton collected 709 from pot
color_singleton: doesn't show hand 
*** SUMMARY ***
Total pot 750 | Rake 41 
Board [3s 8c 4c Ad]
Seat 1: color_singleton (button) collected (709)
Seat 2: JeBoyDirk (small blind) folded before Flop
Seat 3: dockstarr (big blind) folded before Flop
Seat 5: Klemtonius folded on the Turn
Seat 9: PokerStarsMan12 folded before Flop (didn't bet)



PokerStars Home Game Hand #228491838143: {DaPokaStars}  Hold'em No Limit (50/100) - 2021/07/22 17:33:23 ET
Table 'Halleria II' 9-max (Play Money) Seat #2 is the button
Seat 1: color_singleton (15809 in chips) 
Seat 2: JeBoyDirk (19681 in chips) 
Seat 3: dockstarr (14154 in chips) 
Seat 5: Klemtonius (18128 in chips) 
Seat 9: PokerStarsMan12 (7034 in chips) 
dockstarr: posts small blind 50
Klemtonius: posts big blind 100
*** HOLE CARDS ***
Dealt to PokerStarsMan12 [Th 3d]
PokerStarsMan12: folds 
color_singleton: raises 200 to 300
JeBoyDirk: calls 300
dockstarr: calls 250
Klemtonius: calls 200
*** FLOP *** [Td Tc 6s]
dockstarr: checks 
Klemtonius: checks 
color_singleton: bets 567
JeBoyDirk: calls 567
dockstarr: folds 
Klemtonius: raises 567 to 1134
color_singleton: folds 
JeBoyDirk: raises 567 to 1701
Klemtonius: raises 1399 to 3100
JeBoyDirk: raises 16281 to 19381 and is all-in
Klemtonius: calls 14728 and is all-in
Uncalled bet (1553) returned to JeBoyDirk
*** TURN *** [Td Tc 6s] [Jc]
*** RIVER *** [Td Tc 6s Jc] [3s]
*** SHOW DOWN ***
Klemtonius: shows [Ts 7c] (three of a kind, Tens)
JeBoyDirk: shows [6d 6h] (a full house, Sixes full of Tens)
JeBoyDirk collected 35365 from pot
*** SUMMARY ***
Total pot 37423 | Rake 2058 
Board [Td Tc 6s Jc 3s]
Seat 1: color_singleton folded on the Flop
Seat 2: JeBoyDirk (button) showed [6d 6h] and won (35365) with a full house, Sixes full of Tens
Seat 3: dockstarr (small blind) folded on the Flop
Seat 5: Klemtonius (big blind) showed [Ts 7c] and lost with three of a kind, Tens
Seat 9: PokerStarsMan12 folded before Flop (didn't bet)



PokerStars Home Game Hand #228491889149: {DaPokaStars}  Hold'em No Limit (50/100) - 2021/07/22 17:34:45 ET
Table 'Halleria II' 9-max (Play Money) Seat #3 is the button
Seat 1: color_singleton (14942 in chips) 
Seat 2: JeBoyDirk (36918 in chips) 
Seat 3: dockstarr (13854 in chips) 
Seat 9: PokerStarsMan12 (7034 in chips) 
PokerStarsMan12: posts small blind 50
color_singleton: posts big blind 100
*** HOLE CARDS ***
Dealt to PokerStarsMan12 [5s Ks]
JeBoyDirk: folds 
dockstarr: folds 
PokerStarsMan12: calls 50
color_singleton: raises 200 to 300
PokerStarsMan12: calls 200
*** FLOP *** [Ad 3h 6c]
PokerStarsMan12: checks 
color_singleton: bets 283
PokerStarsMan12: folds 
Uncalled bet (283) returned to color_singleton
color_singleton collected 567 from pot
color_singleton: doesn't show hand 
*** SUMMARY ***
Total pot 600 | Rake 33 
Board [Ad 3h 6c]
Seat 1: color_singleton (big blind) collected (567)
Seat 2: JeBoyDirk folded before Flop (didn't bet)
Seat 3: dockstarr (button) folded before Flop (didn't bet)
Seat 9: PokerStarsMan12 (small blind) folded on the Flop



PokerStars Home Game Hand #228491907016: {DaPokaStars}  Hold'em No Limit (50/100) - 2021/07/22 17:35:19 ET
Table 'Halleria II' 9-max (Play Money) Seat #9 is the button
Seat 1: color_singleton (15209 in chips) 
Seat 2: JeBoyDirk (36918 in chips) 
Seat 3: dockstarr (13854 in chips) 
Seat 9: PokerStarsMan12 (6734 in chips) 
color_singleton: posts small blind 50
JeBoyDirk: posts big blind 100
*** HOLE CARDS ***
Dealt to PokerStarsMan12 [4h 7h]
dockstarr: folds 
PokerStarsMan12: calls 100
color_singleton: folds 
JeBoyDirk: checks 
*** FLOP *** [6c 5c 7s]
JeBoyDirk: checks 
PokerStarsMan12: bets 200
JeBoyDirk: folds 
Uncalled bet (200) returned to PokerStarsMan12
PokerStarsMan12 collected 236 from pot
*** SUMMARY ***
Total pot 250 | Rake 14 
Board [6c 5c 7s]
Seat 1: color_singleton (small blind) folded before Flop
Seat 2: JeBoyDirk (big blind) folded on the Flop
Seat 3: dockstarr folded before Flop (didn't bet)
Seat 9: PokerStarsMan12 (button) collected (236)



PokerStars Home Game Hand #228491916326: {DaPokaStars}  Hold'em No Limit (50/100) - 2021/07/22 17:35:37 ET
Table 'Halleria II' 9-max (Play Money) Seat #1 is the button
Seat 1: color_singleton (15159 in chips) 
Seat 2: JeBoyDirk (36818 in chips) 
Seat 3: dockstarr (13854 in chips) 
Seat 5: Klemtonius (10000 in chips) 
Seat 9: PokerStarsMan12 (6870 in chips) 
JeBoyDirk: posts small blind 50
dockstarr: posts big blind 100
Klemtonius: posts small blind 50
*** HOLE CARDS ***
Dealt to PokerStarsMan12 [Jc 4s]
Klemtonius: calls 100
PokerStarsMan12: folds 
color_singleton: raises 200 to 300
JeBoyDirk: calls 250
dockstarr: calls 200
Klemtonius: calls 200
*** FLOP *** [7h Ac 6c]
JeBoyDirk: checks 
dockstarr: checks 
Klemtonius: checks 
color_singleton: checks 
*** TURN *** [7h Ac 6c] [9c]
JeBoyDirk: checks 
dockstarr: checks 
Klemtonius: bets 1181
color_singleton: calls 1181
JeBoyDirk: folds 
dockstarr: folds 
*** RIVER *** [7h Ac 6c 9c] [9h]
Klemtonius: checks 
color_singleton: bets 2000
Klemtonius: raises 2000 to 4000
color_singleton: raises 9678 to 13678 and is all-in
Klemtonius: calls 4469 and is all-in
Uncalled bet (5209) returned to color_singleton
*** SHOW DOWN ***
color_singleton: shows [Ah Ad] (a full house, Aces full of Nines)
Klemtonius: shows [Ts 8d] (a straight, Six to Ten)
color_singleton collected 19420 from pot
*** SUMMARY ***
Total pot 20550 | Rake 1130 
Board [7h Ac 6c 9c 9h]
Seat 1: color_singleton (button) showed [Ah Ad] and won (19420) with a full house, Aces full of Nines
Seat 2: JeBoyDirk (small blind) folded on the Turn
Seat 3: dockstarr (big blind) folded on the Turn
Seat 5: Klemtonius showed [Ts 8d] and lost with a straight, Six to Ten
Seat 9: PokerStarsMan12 folded before Flop (didn't bet)



PokerStars Home Game Hand #228491959638: {DaPokaStars}  Hold'em No Limit (50/100) - 2021/07/22 17:36:59 ET
Table 'Halleria II' 9-max (Play Money) Seat #2 is the button
Seat 1: color_singleton (24629 in chips) 
Seat 2: JeBoyDirk (36518 in chips) 
Seat 3: dockstarr (13554 in chips) 
Seat 9: PokerStarsMan12 (6870 in chips) 
dockstarr: posts small blind 50
PokerStarsMan12: posts big blind 100
*** HOLE CARDS ***
Dealt to PokerStarsMan12 [2s 5c]
color_singleton has timed out
color_singleton: folds 
JeBoyDirk: raises 100 to 200
dockstarr: folds 
PokerStarsMan12: folds 
Uncalled bet (100) returned to JeBoyDirk
JeBoyDirk collected 250 from pot
*** SUMMARY ***
Total pot 250 | Rake 0 
Seat 1: color_singleton folded before Flop (didn't bet)
Seat 2: JeBoyDirk (button) collected (250)
Seat 3: dockstarr (small blind) folded before Flop
Seat 9: PokerStarsMan12 (big blind) folded before Flop



PokerStars Home Game Hand #228491973118: {DaPokaStars}  Hold'em No Limit (50/100) - 2021/07/22 17:37:25 ET
Table 'Halleria II' 9-max (Play Money) Seat #3 is the button
Seat 2: JeBoyDirk (36668 in chips) 
Seat 3: dockstarr (13504 in chips) 
Seat 9: PokerStarsMan12 (6770 in chips) 
PokerStarsMan12: posts small blind 50
JeBoyDirk: posts big blind 100
*** HOLE CARDS ***
Dealt to PokerStarsMan12 [As 3h]
dockstarr: folds 
PokerStarsMan12: calls 50
JeBoyDirk: checks 
*** FLOP *** [8c 8s 6c]
PokerStarsMan12: checks 
JeBoyDirk: checks 
*** TURN *** [8c 8s 6c] [Kc]
PokerStarsMan12: checks 
JeBoyDirk: checks 
*** RIVER *** [8c 8s 6c Kc] [8d]
PokerStarsMan12: checks 
JeBoyDirk: checks 
*** SHOW DOWN ***
PokerStarsMan12: shows [As 3h] (three of a kind, Eights)
JeBoyDirk: mucks hand 
PokerStarsMan12 collected 189 from pot
*** SUMMARY ***
Total pot 200 | Rake 11 
Board [8c 8s 6c Kc 8d]
Seat 2: JeBoyDirk (big blind) mucked [3c 5s]
Seat 3: dockstarr (button) folded before Flop (didn't bet)
Seat 9: PokerStarsMan12 (small blind) showed [As 3h] and won (189) with three of a kind, Eights



PokerStars Home Game Hand #228491987063: {DaPokaStars}  Hold'em No Limit (50/100) - 2021/07/22 17:37:51 ET
Table 'Halleria II' 9-max (Play Money) Seat #9 is the button
Seat 2: JeBoyDirk (36568 in chips) 
Seat 3: dockstarr (13504 in chips) 
Seat 5: Klemtonius (10000 in chips) 
Seat 9: PokerStarsMan12 (6859 in chips) 
JeBoyDirk: posts small blind 50
dockstarr: posts big blind 100
Klemtonius: posts small & big blinds 150
*** HOLE CARDS ***
Dealt to PokerStarsMan12 [3d Js]
Klemtonius: raises 100 to 200
PokerStarsMan12: folds 
JeBoyDirk: folds 
dockstarr: folds 
Uncalled bet (100) returned to Klemtonius
Klemtonius collected 300 from pot
Klemtonius: doesn't show hand 
*** SUMMARY ***
Total pot 300 | Rake 0 
Seat 2: JeBoyDirk (small blind) folded before Flop
Seat 3: dockstarr (big blind) folded before Flop
Seat 5: Klemtonius collected (300)
Seat 9: PokerStarsMan12 (button) folded before Flop (didn't bet)



PokerStars Home Game Hand #228491997136: {DaPokaStars}  Hold'em No Limit (50/100) - 2021/07/22 17:38:10 ET
Table 'Halleria II' 9-max (Play Money) Seat #2 is the button
Seat 1: color_singleton (24629 in chips) 
Seat 2: JeBoyDirk (36518 in chips) 
Seat 3: dockstarr (13404 in chips) 
Seat 5: Klemtonius (10150 in chips) 
Seat 9: PokerStarsMan12 (6859 in chips) 
dockstarr: posts small blind 50
Klemtonius: posts big blind 100
color_singleton: posts small & big blinds 150
*** HOLE CARDS ***
Dealt to PokerStarsMan12 [9h 3h]
PokerStarsMan12 has timed out
PokerStarsMan12: folds 
color_singleton: checks 
JeBoyDirk: folds 
dockstarr: folds 
Klemtonius: raises 100 to 200
color_singleton: calls 100
*** FLOP *** [Js 3c Jh]
Klemtonius: checks 
color_singleton: checks 
*** TURN *** [Js 3c Jh] [2s]
Klemtonius: checks 
color_singleton: checks 
*** RIVER *** [Js 3c Jh 2s] [5h]
Klemtonius: checks 
color_singleton: checks 
*** SHOW DOWN ***
Klemtonius: shows [Ac Th] (a pair of Jacks)
color_singleton: shows [8c 2d] (two pair, Jacks and Deuces)
color_singleton collected 472 from pot
*** SUMMARY ***
Total pot 500 | Rake 28 
Board [Js 3c Jh 2s 5h]
Seat 1: color_singleton showed [8c 2d] and won (472) with two pair, Jacks and Deuces
Seat 2: JeBoyDirk (button) folded before Flop (didn't bet)
Seat 3: dockstarr (small blind) folded before Flop
Seat 5: Klemtonius (big blind) showed [Ac Th] and lost with a pair of Jacks
Seat 9: PokerStarsMan12 folded before Flop (didn't bet)



PokerStars Home Game Hand #228492024386: {DaPokaStars}  Hold'em No Limit (50/100) - 2021/07/22 17:38:54 ET
Table 'Halleria II' 9-max (Play Money) Seat #3 is the button
Seat 1: color_singleton (24851 in chips) 
Seat 2: JeBoyDirk (36518 in chips) 
Seat 3: dockstarr (13354 in chips) 
Seat 5: Klemtonius (9950 in chips) 
Seat 9: PokerStarsMan12 (6859 in chips) 
Klemtonius: posts small blind 50
PokerStarsMan12: posts big blind 100
*** HOLE CARDS ***
Dealt to PokerStarsMan12 [7s 2s]
color_singleton: raises 100 to 200
JeBoyDirk: calls 200
dockstarr: calls 200
Klemtonius: calls 150
PokerStarsMan12: calls 100
*** FLOP *** [6s Kc 2d]
Klemtonius: checks 
PokerStarsMan12: checks 
color_singleton: checks 
JeBoyDirk: checks 
dockstarr: checks 
*** TURN *** [6s Kc 2d] [Jc]
Klemtonius: checks 
PokerStarsMan12: checks 
color_singleton: bets 472
JeBoyDirk: folds 
dockstarr: folds 
Klemtonius: folds 
PokerStarsMan12: folds 
Uncalled bet (472) returned to color_singleton
color_singleton collected 945 from pot
color_singleton: doesn't show hand 
*** SUMMARY ***
Total pot 1000 | Rake 55 
Board [6s Kc 2d Jc]
Seat 1: color_singleton collected (945)
Seat 2: JeBoyDirk folded on the Turn
Seat 3: dockstarr (button) folded on the Turn
Seat 5: Klemtonius (small blind) folded on the Turn
Seat 9: PokerStarsMan12 (big blind) folded on the Turn



PokerStars Home Game Hand #228492052713: {DaPokaStars}  Hold'em No Limit (50/100) - 2021/07/22 17:39:49 ET
Table 'Halleria II' 9-max (Play Money) Seat #5 is the button
Seat 1: color_singleton (25596 in chips) 
Seat 2: JeBoyDirk (36318 in chips) 
Seat 3: dockstarr (13154 in chips) 
Seat 5: Klemtonius (9750 in chips) 
Seat 9: PokerStarsMan12 (6659 in chips) 
PokerStarsMan12: posts small blind 50
color_singleton: posts big blind 100
*** HOLE CARDS ***
Dealt to PokerStarsMan12 [Jd 9s]
JeBoyDirk: calls 100
dockstarr: calls 100
Klemtonius: calls 100
PokerStarsMan12: calls 50
color_singleton: checks 
*** FLOP *** [3s 7c 4c]
PokerStarsMan12: checks 
color_singleton: bets 236
JeBoyDirk: folds 
dockstarr: folds 
Klemtonius: calls 236
PokerStarsMan12: folds 
*** TURN *** [3s 7c 4c] [3c]
color_singleton: bets 459
Klemtonius: calls 459
*** RIVER *** [3s 7c 4c 3c] [6d]
color_singleton: bets 1786
Klemtonius: folds 
Uncalled bet (1786) returned to color_singleton
color_singleton collected 1786 from pot
color_singleton: doesn't show hand 
*** SUMMARY ***
Total pot 1890 | Rake 104 
Board [3s 7c 4c 3c 6d]
Seat 1: color_singleton (big blind) collected (1786)
Seat 2: JeBoyDirk folded on the Flop
Seat 3: dockstarr folded on the Flop
Seat 5: Klemtonius (button) folded on the River
Seat 9: PokerStarsMan12 (small blind) folded on the Flop



PokerStars Home Game Hand #228492083332: {DaPokaStars}  Hold'em No Limit (50/100) - 2021/07/22 17:40:48 ET
Table 'Halleria II' 9-max (Play Money) Seat #9 is the button
Seat 1: color_singleton (26587 in chips) 
Seat 2: JeBoyDirk (36218 in chips) 
Seat 3: dockstarr (13054 in chips) 
Seat 5: Klemtonius (8955 in chips) 
Seat 9: PokerStarsMan12 (6559 in chips) 
color_singleton: posts small blind 50
JeBoyDirk: posts big blind 100
*** HOLE CARDS ***
Dealt to PokerStarsMan12 [7d 3h]
dockstarr: calls 100
Klemtonius: calls 100
PokerStarsMan12: folds 
color_singleton: raises 300 to 400
JeBoyDirk: calls 300
dockstarr: calls 300
Klemtonius: calls 300
*** FLOP *** [6c 4s 9s]
color_singleton: bets 1512
JeBoyDirk: folds 
dockstarr: folds 
Klemtonius: folds 
Uncalled bet (1512) returned to color_singleton
color_singleton collected 1512 from pot
color_singleton: doesn't show hand 
*** SUMMARY ***
Total pot 1600 | Rake 88 
Board [6c 4s 9s]
Seat 1: color_singleton (small blind) collected (1512)
Seat 2: JeBoyDirk (big blind) folded on the Flop
Seat 3: dockstarr folded on the Flop
Seat 5: Klemtonius folded on the Flop
Seat 9: PokerStarsMan12 (button) folded before Flop (didn't bet)



PokerStars Home Game Hand #228492101728: {DaPokaStars}  Hold'em No Limit (50/100) - 2021/07/22 17:41:24 ET
Table 'Halleria II' 9-max (Play Money) Seat #1 is the button
Seat 1: color_singleton (27699 in chips) 
Seat 2: JeBoyDirk (35818 in chips) 
Seat 3: dockstarr (12654 in chips) 
Seat 5: Klemtonius (8555 in chips) 
Seat 9: PokerStarsMan12 (6559 in chips) 
JeBoyDirk: posts small blind 50
dockstarr: posts big blind 100
*** HOLE CARDS ***
Dealt to PokerStarsMan12 [6c Kc]
Klemtonius: calls 100
PokerStarsMan12: folds 
color_singleton: folds 
JeBoyDirk: calls 50
dockstarr: checks 
*** FLOP *** [Jd As Qs]
JeBoyDirk: checks 
dockstarr: checks 
Klemtonius: checks 
*** TURN *** [Jd As Qs] [4d]
JeBoyDirk: checks 
dockstarr: bets 100
Klemtonius: folds 
JeBoyDirk: calls 100
*** RIVER *** [Jd As Qs 4d] [3c]
JeBoyDirk: checks 
dockstarr: bets 100
JeBoyDirk: calls 100
*** SHOW DOWN ***
dockstarr: shows [Ah Td] (a pair of Aces)
JeBoyDirk: mucks hand 
dockstarr collected 661 from pot
*** SUMMARY ***
Total pot 700 | Rake 39 
Board [Jd As Qs 4d 3c]
Seat 1: color_singleton (button) folded before Flop (didn't bet)
Seat 2: JeBoyDirk (small blind) mucked [Jc Tc]
Seat 3: dockstarr (big blind) showed [Ah Td] and won (661) with a pair of Aces
Seat 5: Klemtonius folded on the Turn
Seat 9: PokerStarsMan12 folded before Flop (didn't bet)



PokerStars Home Game Hand #228492121272: {DaPokaStars}  Hold'em No Limit (50/100) - 2021/07/22 17:42:02 ET
Table 'Halleria II' 9-max (Play Money) Seat #2 is the button
Seat 1: color_singleton (27699 in chips) 
Seat 2: JeBoyDirk (35518 in chips) 
Seat 3: dockstarr (13015 in chips) 
Seat 5: Klemtonius (8455 in chips) 
Seat 9: PokerStarsMan12 (6559 in chips) 
dockstarr: posts small blind 50
Klemtonius: posts big blind 100
*** HOLE CARDS ***
Dealt to PokerStarsMan12 [7c Qc]
PokerStarsMan12: calls 100
color_singleton has timed out
color_singleton: folds 
JeBoyDirk: calls 100
dockstarr: calls 50
Klemtonius: raises 100 to 200
PokerStarsMan12: calls 100
JeBoyDirk: calls 100
dockstarr: calls 100
*** FLOP *** [8h Jd 2s]
dockstarr: checks 
Klemtonius: checks 
PokerStarsMan12: checks 
JeBoyDirk: checks 
*** TURN *** [8h Jd 2s] [2c]
dockstarr: checks 
Klemtonius: checks 
PokerStarsMan12: checks 
JeBoyDirk: checks 
*** RIVER *** [8h Jd 2s 2c] [Kd]
dockstarr: bets 100
Klemtonius: raises 100 to 200
PokerStarsMan12: folds 
JeBoyDirk: calls 200
dockstarr: calls 100
*** SHOW DOWN ***
Klemtonius: shows [5d 5s] (two pair, Fives and Deuces)
JeBoyDirk: shows [Ks Td] (two pair, Kings and Deuces)
dockstarr: shows [6c Kh] (two pair, Kings and Deuces)
dockstarr collected 662 from pot
JeBoyDirk collected 661 from pot
*** SUMMARY ***
Total pot 1400 | Rake 77 
Board [8h Jd 2s 2c Kd]
Seat 1: color_singleton folded before Flop (didn't bet)
Seat 2: JeBoyDirk (button) showed [Ks Td] and won (661) with two pair, Kings and Deuces
Seat 3: dockstarr (small blind) showed [6c Kh] and won (662) with two pair, Kings and Deuces
Seat 5: Klemtonius (big blind) showed [5d 5s] and lost with two pair, Fives and Deuces
Seat 9: PokerStarsMan12 folded on the River



PokerStars Home Game Hand #228492159590: {DaPokaStars}  Hold'em No Limit (50/100) - 2021/07/22 17:43:19 ET
Table 'Halleria II' 9-max (Play Money) Seat #3 is the button
Seat 1: color_singleton (27699 in chips) 
Seat 2: JeBoyDirk (35779 in chips) 
Seat 3: dockstarr (13277 in chips) 
Seat 5: Klemtonius (8055 in chips) 
Seat 9: PokerStarsMan12 (6359 in chips) 
Klemtonius: posts small blind 50
PokerStarsMan12: posts big blind 100
*** HOLE CARDS ***
Dealt to PokerStarsMan12 [9d As]
color_singleton: folds 
JeBoyDirk: calls 100
dockstarr: calls 100
Klemtonius: calls 50
PokerStarsMan12: raises 300 to 400
JeBoyDirk: calls 300
dockstarr: calls 300
Klemtonius: calls 300
*** FLOP *** [9s Kc 2c]
Klemtonius: checks 
PokerStarsMan12: bets 800
JeBoyDirk: folds 
dockstarr: folds 
Klemtonius: folds 
Uncalled bet (800) returned to PokerStarsMan12
PokerStarsMan12 collected 1512 from pot
*** SUMMARY ***
Total pot 1600 | Rake 88 
Board [9s Kc 2c]
Seat 1: color_singleton folded before Flop (didn't bet)
Seat 2: JeBoyDirk folded on the Flop
Seat 3: dockstarr (button) folded on the Flop
Seat 5: Klemtonius (small blind) folded on the Flop
Seat 9: PokerStarsMan12 (big blind) collected (1512)



PokerStars Home Game Hand #228492179103: {DaPokaStars}  Hold'em No Limit (50/100) - 2021/07/22 17:43:58 ET
Table 'Halleria II' 9-max (Play Money) Seat #5 is the button
Seat 1: color_singleton (27699 in chips) 
Seat 2: JeBoyDirk (35379 in chips) 
Seat 3: dockstarr (12877 in chips) 
Seat 5: Klemtonius (7655 in chips) 
Seat 9: PokerStarsMan12 (7471 in chips) 
PokerStarsMan12: posts small blind 50
color_singleton: posts big blind 100
*** HOLE CARDS ***
Dealt to PokerStarsMan12 [Ks 9s]
JeBoyDirk: folds 
dockstarr: calls 100
Klemtonius: raises 100 to 200
JeBoyDirk leaves the table
PokerStarsMan12: calls 150
color_singleton: calls 100
dockstarr: calls 100
*** FLOP *** [4s As 6h]
PokerStarsMan12: bets 400
color_singleton: folds 
dockstarr: calls 400
Klemtonius: raises 400 to 800
PokerStarsMan12: calls 400
dockstarr: calls 400
*** TURN *** [4s As 6h] [3s]
PokerStarsMan12: checks 
dockstarr: checks 
Klemtonius: bets 3024
PokerStarsMan12: calls 3024
dockstarr: folds 
*** RIVER *** [4s As 6h 3s] [Js]
PokerStarsMan12: checks 
Klemtonius: checks 
*** SHOW DOWN ***
PokerStarsMan12: shows [Ks 9s] (a flush, Ace high)
Klemtonius: mucks hand 
PokerStarsMan12 collected 8739 from pot
*** SUMMARY ***
Total pot 9248 | Rake 509 
Board [4s As 6h 3s Js]
Seat 1: color_singleton (big blind) folded on the Flop
Seat 2: JeBoyDirk folded before Flop (didn't bet)
Seat 3: dockstarr folded on the Turn
Seat 5: Klemtonius (button) mucked [Kd Ad]
Seat 9: PokerStarsMan12 (small blind) showed [Ks 9s] and won (8739) with a flush, Ace high



PokerStars Home Game Hand #228492206586: {DaPokaStars}  Hold'em No Limit (50/100) - 2021/07/22 17:44:53 ET
Table 'Halleria II' 9-max (Play Money) Seat #9 is the button
Seat 1: color_singleton (27499 in chips) 
Seat 3: dockstarr (11877 in chips) 
Seat 5: Klemtonius (3631 in chips) 
Seat 9: PokerStarsMan12 (12186 in chips) 
color_singleton: posts small blind 50
dockstarr: posts big blind 100
*** HOLE CARDS ***
Dealt to PokerStarsMan12 [3d 9c]
Klemtonius: raises 100 to 200
PokerStarsMan12: folds 
color_singleton: folds 
dockstarr: folds 
Uncalled bet (100) returned to Klemtonius
Klemtonius collected 250 from pot
Klemtonius: doesn't show hand 
*** SUMMARY ***
Total pot 250 | Rake 0 
Seat 1: color_singleton (small blind) folded before Flop
Seat 3: dockstarr (big blind) folded before Flop
Seat 5: Klemtonius collected (250)
Seat 9: PokerStarsMan12 (button) folded before Flop (didn't bet)



PokerStars Home Game Hand #228492211078: {DaPokaStars}  Hold'em No Limit (50/100) - 2021/07/22 17:45:02 ET
Table 'Halleria II' 9-max (Play Money) Seat #1 is the button
Seat 1: color_singleton (27449 in chips) 
Seat 3: dockstarr (11777 in chips) 
Seat 5: Klemtonius (3781 in chips) 
Seat 9: PokerStarsMan12 (12186 in chips) 
dockstarr: posts small blind 50
Klemtonius: posts big blind 100
*** HOLE CARDS ***
Dealt to PokerStarsMan12 [Ts 2d]
PokerStarsMan12: folds 
color_singleton: folds 
dockstarr: calls 50
Klemtonius: checks 
*** FLOP *** [7d 9c Jc]
dockstarr: checks 
Klemtonius: bets 100
dockstarr: calls 100
*** TURN *** [7d 9c Jc] [Qs]
dockstarr: checks 
Klemtonius: bets 100
dockstarr: calls 100
*** RIVER *** [7d 9c Jc Qs] [8c]
dockstarr: checks 
Klemtonius: checks 
*** SHOW DOWN ***
dockstarr: shows [3s 3c] (a pair of Threes)
Klemtonius: shows [Js 4d] (a pair of Jacks)
Klemtonius collected 567 from pot
*** SUMMARY ***
Total pot 600 | Rake 33 
Board [7d 9c Jc Qs 8c]
Seat 1: color_singleton (button) folded before Flop (didn't bet)
Seat 3: dockstarr (small blind) showed [3s 3c] and lost with a pair of Threes
Seat 5: Klemtonius (big blind) showed [Js 4d] and won (567) with a pair of Jacks
Seat 9: PokerStarsMan12 folded before Flop (didn't bet)



PokerStars Home Game Hand #228492226912: {DaPokaStars}  Hold'em No Limit (50/100) - 2021/07/22 17:45:35 ET
Table 'Halleria II' 9-max (Play Money) Seat #3 is the button
Seat 1: color_singleton (27449 in chips) 
Seat 3: dockstarr (11477 in chips) 
Seat 5: Klemtonius (4048 in chips) 
Seat 9: PokerStarsMan12 (12186 in chips) 
Klemtonius: posts small blind 50
PokerStarsMan12: posts big blind 100
*** HOLE CARDS ***
Dealt to PokerStarsMan12 [5s 3d]
color_singleton: folds 
dockstarr: calls 100
Klemtonius: calls 50
PokerStarsMan12: checks 
*** FLOP *** [5h 9d 3c]
Klemtonius: checks 
PokerStarsMan12: bets 200
dockstarr: calls 200
Klemtonius: folds 
*** TURN *** [5h 9d 3c] [2h]
PokerStarsMan12: bets 400
dockstarr: folds 
Uncalled bet (400) returned to PokerStarsMan12
PokerStarsMan12 collected 661 from pot
*** SUMMARY ***
Total pot 700 | Rake 39 
Board [5h 9d 3c 2h]
Seat 1: color_singleton folded before Flop (didn't bet)
Seat 3: dockstarr (button) folded on the Turn
Seat 5: Klemtonius (small blind) folded on the Flop
Seat 9: PokerStarsMan12 (big blind) collected (661)



PokerStars Home Game Hand #228492243888: {DaPokaStars}  Hold'em No Limit (50/100) - 2021/07/22 17:46:09 ET
Table 'Halleria II' 9-max (Play Money) Seat #5 is the button
Seat 1: color_singleton (27449 in chips) 
Seat 3: dockstarr (11177 in chips) 
Seat 5: Klemtonius (3948 in chips) 
Seat 9: PokerStarsMan12 (12547 in chips) 
PokerStarsMan12: posts small blind 50
color_singleton: posts big blind 100
*** HOLE CARDS ***
Dealt to PokerStarsMan12 [2d 7c]
dockstarr: folds 
Klemtonius: folds 
PokerStarsMan12: calls 50
color_singleton: checks 
*** FLOP *** [5c 8d Ah]
PokerStarsMan12: checks 
color_singleton: bets 189
PokerStarsMan12: folds 
Uncalled bet (189) returned to color_singleton
color_singleton collected 189 from pot
color_singleton: doesn't show hand 
*** SUMMARY ***
Total pot 200 | Rake 11 
Board [5c 8d Ah]
Seat 1: color_singleton (big blind) collected (189)
Seat 3: dockstarr folded before Flop (didn't bet)
Seat 5: Klemtonius (button) folded before Flop (didn't bet)
Seat 9: PokerStarsMan12 (small blind) folded on the Flop



PokerStars Home Game Hand #228492252039: {DaPokaStars}  Hold'em No Limit (50/100) - 2021/07/22 17:46:26 ET
Table 'Halleria II' 9-max (Play Money) Seat #9 is the button
Seat 1: color_singleton (27538 in chips) 
Seat 3: dockstarr (11177 in chips) 
Seat 5: Klemtonius (3948 in chips) 
Seat 9: PokerStarsMan12 (12447 in chips) 
color_singleton: posts small blind 50
dockstarr: posts big blind 100
*** HOLE CARDS ***
Dealt to PokerStarsMan12 [4h Jc]
Klemtonius: raises 100 to 200
PokerStarsMan12: folds 
color_singleton: calls 150
dockstarr: folds 
*** FLOP *** [8h 2c Qs]
color_singleton: bets 236
Klemtonius: calls 236
*** TURN *** [8h 2c Qs] [Ah]
color_singleton: checks 
Klemtonius: bets 459
color_singleton: folds 
Uncalled bet (459) returned to Klemtonius
Klemtonius collected 919 from pot
Klemtonius: doesn't show hand 
*** SUMMARY ***
Total pot 972 | Rake 53 
Board [8h 2c Qs Ah]
Seat 1: color_singleton (small blind) folded on the Turn
Seat 3: dockstarr (big blind) folded before Flop
Seat 5: Klemtonius collected (919)
Seat 9: PokerStarsMan12 (button) folded before Flop (didn't bet)



PokerStars Home Game Hand #228492272196: {DaPokaStars}  Hold'em No Limit (50/100) - 2021/07/22 17:46:56 ET
Table 'Halleria II' 9-max (Play Money) Seat #1 is the button
Seat 1: color_singleton (27102 in chips) 
Seat 3: dockstarr (11077 in chips) 
Seat 5: Klemtonius (4431 in chips) 
Seat 9: PokerStarsMan12 (12447 in chips) 
dockstarr: posts small blind 50
Klemtonius: posts big blind 100
*** HOLE CARDS ***
Dealt to PokerStarsMan12 [2s 9h]
PokerStarsMan12: folds 
color_singleton: folds 
dockstarr: folds 
Uncalled bet (50) returned to Klemtonius
Klemtonius collected 100 from pot
Klemtonius: doesn't show hand 
*** SUMMARY ***
Total pot 100 | Rake 0 
Seat 1: color_singleton (button) folded before Flop (didn't bet)
Seat 3: dockstarr (small blind) folded before Flop
Seat 5: Klemtonius (big blind) collected (100)
Seat 9: PokerStarsMan12 folded before Flop (didn't bet)



PokerStars Home Game Hand #228492275132: {DaPokaStars}  Hold'em No Limit (50/100) - 2021/07/22 17:47:02 ET
Table 'Halleria II' 9-max (Play Money) Seat #3 is the button
Seat 1: color_singleton (27102 in chips) 
Seat 3: dockstarr (11027 in chips) 
Seat 5: Klemtonius (4481 in chips) 
Seat 9: PokerStarsMan12 (12447 in chips) 
Klemtonius: posts small blind 50
PokerStarsMan12: posts big blind 100
*** HOLE CARDS ***
Dealt to PokerStarsMan12 [9d 5c]
color_singleton: folds 
dockstarr: calls 100
Klemtonius: calls 50
PokerStarsMan12: checks 
*** FLOP *** [6d 4c 7c]
Klemtonius: checks 
PokerStarsMan12: bets 200
dockstarr: folds 
Klemtonius: raises 200 to 400
PokerStarsMan12: calls 200
*** TURN *** [6d 4c 7c] [2h]
Klemtonius: checks 
PokerStarsMan12: bets 600
Klemtonius: folds 
Uncalled bet (600) returned to PokerStarsMan12
PokerStarsMan12 collected 1039 from pot
*** SUMMARY ***
Total pot 1100 | Rake 61 
Board [6d 4c 7c 2h]
Seat 1: color_singleton folded before Flop (didn't bet)
Seat 3: dockstarr (button) folded on the Flop
Seat 5: Klemtonius (small blind) folded on the Turn
Seat 9: PokerStarsMan12 (big blind) collected (1039)



PokerStars Home Game Hand #228492288744: {DaPokaStars}  Hold'em No Limit (50/100) - 2021/07/22 17:47:29 ET
Table 'Halleria II' 9-max (Play Money) Seat #5 is the button
Seat 1: color_singleton (27102 in chips) 
Seat 3: dockstarr (10927 in chips) 
Seat 5: Klemtonius (3981 in chips) 
Seat 9: PokerStarsMan12 (12986 in chips) 
PokerStarsMan12: posts small blind 50
color_singleton: posts big blind 100
*** HOLE CARDS ***
Dealt to PokerStarsMan12 [2h 9c]
dockstarr: calls 100
Klemtonius: calls 100
PokerStarsMan12: folds 
color_singleton: raises 200 to 300
dockstarr: calls 200
Klemtonius: calls 200
*** FLOP *** [3s Jd Th]
color_singleton: bets 898
dockstarr: folds 
Klemtonius: folds 
Uncalled bet (898) returned to color_singleton
color_singleton collected 898 from pot
color_singleton: doesn't show hand 
*** SUMMARY ***
Total pot 950 | Rake 52 
Board [3s Jd Th]
Seat 1: color_singleton (big blind) collected (898)
Seat 3: dockstarr folded on the Flop
Seat 5: Klemtonius (button) folded on the Flop
Seat 9: PokerStarsMan12 (small blind) folded before Flop



PokerStars Home Game Hand #228492302419: {DaPokaStars}  Hold'em No Limit (50/100) - 2021/07/22 17:47:57 ET
Table 'Halleria II' 9-max (Play Money) Seat #9 is the button
Seat 1: color_singleton (27700 in chips) 
Seat 3: dockstarr (10627 in chips) 
Seat 5: Klemtonius (3681 in chips) 
Seat 9: PokerStarsMan12 (12936 in chips) 
color_singleton: posts small blind 50
dockstarr: posts big blind 100
*** HOLE CARDS ***
Dealt to PokerStarsMan12 [7h Td]
Klemtonius: raises 100 to 200
PokerStarsMan12: folds 
color_singleton: calls 150
dockstarr: calls 100
*** FLOP *** [3c Kh Ah]
color_singleton: bets 283
dockstarr: folds 
Klemtonius: calls 283
*** TURN *** [3c Kh Ah] [9c]
color_singleton: checks 
Klemtonius: checks 
*** RIVER *** [3c Kh Ah 9c] [Th]
color_singleton: checks 
Klemtonius: bets 551
color_singleton: folds 
Uncalled bet (551) returned to Klemtonius
Klemtonius collected 1102 from pot
Klemtonius: doesn't show hand 
*** SUMMARY ***
Total pot 1166 | Rake 64 
Board [3c Kh Ah 9c Th]
Seat 1: color_singleton (small blind) folded on the River
Seat 3: dockstarr (big blind) folded on the Flop
Seat 5: Klemtonius collected (1102)
Seat 9: PokerStarsMan12 (button) folded before Flop (didn't bet)



PokerStars Home Game Hand #228492322293: {DaPokaStars}  Hold'em No Limit (50/100) - 2021/07/22 17:48:37 ET
Table 'Halleria II' 9-max (Play Money) Seat #1 is the button
Seat 1: color_singleton (27217 in chips) 
Seat 3: dockstarr (10427 in chips) 
Seat 5: Klemtonius (4300 in chips) 
Seat 9: PokerStarsMan12 (12936 in chips) 
dockstarr: posts small blind 50
Klemtonius: posts big blind 100
*** HOLE CARDS ***
Dealt to PokerStarsMan12 [6d 7s]
PokerStarsMan12: raises 200 to 300
color_singleton: folds 
dockstarr: folds 
Klemtonius: raises 200 to 500
PokerStarsMan12: calls 200
*** FLOP *** [Qh 5h 2d]
Klemtonius: checks 
PokerStarsMan12: checks 
*** TURN *** [Qh 5h 2d] [Ks]
Klemtonius: bets 496
PokerStarsMan12: folds 
Uncalled bet (496) returned to Klemtonius
Klemtonius collected 992 from pot
Klemtonius: doesn't show hand 
*** SUMMARY ***
Total pot 1050 | Rake 58 
Board [Qh 5h 2d Ks]
Seat 1: color_singleton (button) folded before Flop (didn't bet)
Seat 3: dockstarr (small blind) folded before Flop
Seat 5: Klemtonius (big blind) collected (992)
Seat 9: PokerStarsMan12 folded on the Turn



PokerStars Home Game Hand #228492331483: {DaPokaStars}  Hold'em No Limit (50/100) - 2021/07/22 17:48:56 ET
Table 'Halleria II' 9-max (Play Money) Seat #3 is the button
Seat 1: color_singleton (27217 in chips) 
Seat 3: dockstarr (10377 in chips) 
Seat 5: Klemtonius (4792 in chips) 
Seat 9: PokerStarsMan12 (12436 in chips) 
Klemtonius: posts small blind 50
PokerStarsMan12: posts big blind 100
*** HOLE CARDS ***
Dealt to PokerStarsMan12 [7s Jh]
color_singleton: raises 200 to 300
dockstarr: folds 
Klemtonius: folds 
PokerStarsMan12: calls 200
*** FLOP *** [3c 5h 4d]
PokerStarsMan12: checks 
color_singleton: bets 307
PokerStarsMan12: folds 
Uncalled bet (307) returned to color_singleton
color_singleton collected 614 from pot
color_singleton: doesn't show hand 
*** SUMMARY ***
Total pot 650 | Rake 36 
Board [3c 5h 4d]
Seat 1: color_singleton collected (614)
Seat 3: dockstarr (button) folded before Flop (didn't bet)
Seat 5: Klemtonius (small blind) folded before Flop
Seat 9: PokerStarsMan12 (big blind) folded on the Flop



PokerStars Home Game Hand #228492338723: {DaPokaStars}  Hold'em No Limit (50/100) - 2021/07/22 17:49:10 ET
Table 'Halleria II' 9-max (Play Money) Seat #5 is the button
Seat 1: color_singleton (27531 in chips) 
Seat 3: dockstarr (10377 in chips) 
Seat 5: Klemtonius (4742 in chips) 
Seat 9: PokerStarsMan12 (12136 in chips) 
PokerStarsMan12: posts small blind 50
color_singleton: posts big blind 100
*** HOLE CARDS ***
Dealt to PokerStarsMan12 [8c 3d]
dockstarr: folds 
Klemtonius: folds 
PokerStarsMan12: calls 50
color_singleton: raises 200 to 300
PokerStarsMan12: folds 
Uncalled bet (200) returned to color_singleton
color_singleton collected 200 from pot
color_singleton: doesn't show hand 
*** SUMMARY ***
Total pot 200 | Rake 0 
Seat 1: color_singleton (big blind) collected (200)
Seat 3: dockstarr folded before Flop (didn't bet)
Seat 5: Klemtonius (button) folded before Flop (didn't bet)
Seat 9: PokerStarsMan12 (small blind) folded before Flop



PokerStars Home Game Hand #228492343966: {DaPokaStars}  Hold'em No Limit (50/100) - 2021/07/22 17:49:21 ET
Table 'Halleria II' 9-max (Play Money) Seat #9 is the button
Seat 1: color_singleton (27631 in chips) 
Seat 3: dockstarr (10377 in chips) 
Seat 5: Klemtonius (4742 in chips) 
Seat 9: PokerStarsMan12 (12036 in chips) 
color_singleton: posts small blind 50
dockstarr: posts big blind 100
*** HOLE CARDS ***
Dealt to PokerStarsMan12 [2d Kc]
Klemtonius: raises 100 to 200
PokerStarsMan12: folds 
color_singleton: calls 150
dockstarr: folds 
*** FLOP *** [Jc 3d 7c]
color_singleton: checks 
Klemtonius: checks 
*** TURN *** [Jc 3d 7c] [As]
color_singleton: checks 
Klemtonius: checks 
*** RIVER *** [Jc 3d 7c As] [Qs]
color_singleton: bets 472
Klemtonius: folds 
Uncalled bet (472) returned to color_singleton
color_singleton collected 472 from pot
color_singleton: doesn't show hand 
*** SUMMARY ***
Total pot 500 | Rake 28 
Board [Jc 3d 7c As Qs]
Seat 1: color_singleton (small blind) collected (472)
Seat 3: dockstarr (big blind) folded before Flop
Seat 5: Klemtonius folded on the River
Seat 9: PokerStarsMan12 (button) folded before Flop (didn't bet)



PokerStars Home Game Hand #228492362372: {DaPokaStars}  Hold'em No Limit (50/100) - 2021/07/22 17:49:58 ET
Table 'Halleria II' 9-max (Play Money) Seat #1 is the button
Seat 1: color_singleton (27903 in chips) 
Seat 3: dockstarr (10277 in chips) 
Seat 5: Klemtonius (4542 in chips) 
Seat 9: PokerStarsMan12 (12036 in chips) 
dockstarr: posts small blind 50
Klemtonius: posts big blind 100
*** HOLE CARDS ***
Dealt to PokerStarsMan12 [4d Ad]
PokerStarsMan12: raises 200 to 300
color_singleton: folds 
dockstarr: folds 
Klemtonius: calls 200
*** FLOP *** [7d 9h 2c]
Klemtonius: checks 
PokerStarsMan12: checks 
*** TURN *** [7d 9h 2c] [Jh]
Klemtonius: checks 
PokerStarsMan12: bets 400
Klemtonius: calls 400
*** RIVER *** [7d 9h 2c Jh] [8s]
Klemtonius: checks 
PokerStarsMan12: bets 700
Klemtonius: raises 700 to 1400
PokerStarsMan12: folds 
Uncalled bet (700) returned to Klemtonius
Klemtonius collected 2693 from pot
Klemtonius: doesn't show hand 
*** SUMMARY ***
Total pot 2850 | Rake 157 
Board [7d 9h 2c Jh 8s]
Seat 1: color_singleton (button) folded before Flop (didn't bet)
Seat 3: dockstarr (small blind) folded before Flop
Seat 5: Klemtonius (big blind) collected (2693)
Seat 9: PokerStarsMan12 folded on the River



PokerStars Home Game Hand #228492378910: {DaPokaStars}  Hold'em No Limit (50/100) - 2021/07/22 17:50:32 ET
Table 'Halleria II' 9-max (Play Money) Seat #3 is the button
Seat 1: color_singleton (27903 in chips) 
Seat 3: dockstarr (10227 in chips) 
Seat 5: Klemtonius (5835 in chips) 
Seat 9: PokerStarsMan12 (10636 in chips) 
Klemtonius: posts small blind 50
PokerStarsMan12: posts big blind 100
*** HOLE CARDS ***
Dealt to PokerStarsMan12 [4s 5d]
color_singleton: raises 200 to 300
dockstarr: folds 
Klemtonius: calls 250
PokerStarsMan12: calls 200
*** FLOP *** [Qd 8s Jd]
Klemtonius: bets 850
PokerStarsMan12: folds 
color_singleton: folds 
Uncalled bet (850) returned to Klemtonius
Klemtonius collected 850 from pot
Klemtonius: doesn't show hand 
*** SUMMARY ***
Total pot 900 | Rake 50 
Board [Qd 8s Jd]
Seat 1: color_singleton folded on the Flop
Seat 3: dockstarr (button) folded before Flop (didn't bet)
Seat 5: Klemtonius (small blind) collected (850)
Seat 9: PokerStarsMan12 (big blind) folded on the Flop



PokerStars Home Game Hand #228492389972: {DaPokaStars}  Hold'em No Limit (50/100) - 2021/07/22 17:50:54 ET
Table 'Halleria II' 9-max (Play Money) Seat #5 is the button
Seat 1: color_singleton (27603 in chips) 
Seat 3: dockstarr (10227 in chips) 
Seat 5: Klemtonius (6385 in chips) 
Seat 9: PokerStarsMan12 (10336 in chips) 
PokerStarsMan12: posts small blind 50
color_singleton: posts big blind 100
*** HOLE CARDS ***
Dealt to PokerStarsMan12 [Kh Js]
dockstarr: calls 100
Klemtonius: calls 100
PokerStarsMan12: raises 200 to 300
color_singleton: folds 
dockstarr: calls 200
Klemtonius: calls 200
*** FLOP *** [Jc 2d 3s]
PokerStarsMan12: checks 
dockstarr: checks 
Klemtonius: checks 
*** TURN *** [Jc 2d 3s] [2h]
PokerStarsMan12: bets 600
dockstarr: calls 600
Klemtonius: calls 600
*** RIVER *** [Jc 2d 3s 2h] [Kd]
PokerStarsMan12: bets 1400
dockstarr: folds 
Klemtonius: calls 1400
*** SHOW DOWN ***
PokerStarsMan12: shows [Kh Js] (two pair, Kings and Jacks)
Klemtonius: shows [2s 6d] (three of a kind, Deuces)
Klemtonius collected 5292 from pot
*** SUMMARY ***
Total pot 5600 | Rake 308 
Board [Jc 2d 3s 2h Kd]
Seat 1: color_singleton (big blind) folded before Flop
Seat 3: dockstarr folded on the River
Seat 5: Klemtonius (button) showed [2s 6d] and won (5292) with three of a kind, Deuces
Seat 9: PokerStarsMan12 (small blind) showed [Kh Js] and lost with two pair, Kings and Jacks



PokerStars Home Game Hand #228492416005: {DaPokaStars}  Hold'em No Limit (50/100) - 2021/07/22 17:51:47 ET
Table 'Halleria II' 9-max (Play Money) Seat #9 is the button
Seat 1: color_singleton (27503 in chips) 
Seat 3: dockstarr (9327 in chips) 
Seat 5: Klemtonius (9377 in chips) 
Seat 9: PokerStarsMan12 (8036 in chips) 
color_singleton: posts small blind 50
dockstarr: posts big blind 100
*** HOLE CARDS ***
Dealt to PokerStarsMan12 [2s 7c]
Klemtonius: raises 100 to 200
PokerStarsMan12: folds 
color_singleton: calls 150
dockstarr: calls 100
*** FLOP *** [5d 7d 6d]
color_singleton: bets 283
dockstarr: calls 283
Klemtonius: raises 8894 to 9177 and is all-in
color_singleton: folds 
dockstarr: folds 
Uncalled bet (8894) returned to Klemtonius
Klemtonius collected 1369 from pot
Klemtonius: doesn't show hand 
*** SUMMARY ***
Total pot 1449 | Rake 80 
Board [5d 7d 6d]
Seat 1: color_singleton (small blind) folded on the Flop
Seat 3: dockstarr (big blind) folded on the Flop
Seat 5: Klemtonius collected (1369)
Seat 9: PokerStarsMan12 (button) folded before Flop (didn't bet)



PokerStars Home Game Hand #228492427955: {DaPokaStars}  Hold'em No Limit (50/100) - 2021/07/22 17:52:12 ET
Table 'Halleria II' 9-max (Play Money) Seat #1 is the button
Seat 1: color_singleton (27020 in chips) 
Seat 3: dockstarr (8844 in chips) 
Seat 5: Klemtonius (10263 in chips) 
Seat 9: PokerStarsMan12 (8036 in chips) 
dockstarr: posts small blind 50
Klemtonius: posts big blind 100
*** HOLE CARDS ***
Dealt to PokerStarsMan12 [6c 8d]
PokerStarsMan12: folds 
color_singleton: raises 200 to 300
dockstarr: folds 
Klemtonius: calls 200
*** FLOP *** [Js Td 8c]
Klemtonius: checks 
color_singleton: bets 307
Klemtonius: calls 307
*** TURN *** [Js Td 8c] [As]
Klemtonius: checks 
color_singleton: bets 597
Klemtonius: folds 
Uncalled bet (597) returned to color_singleton
color_singleton collected 1194 from pot
color_singleton: doesn't show hand 
*** SUMMARY ***
Total pot 1264 | Rake 70 
Board [Js Td 8c As]
Seat 1: color_singleton (button) collected (1194)
Seat 3: dockstarr (small blind) folded before Flop
Seat 5: Klemtonius (big blind) folded on the Turn
Seat 9: PokerStarsMan12 folded before Flop (didn't bet)



PokerStars Home Game Hand #228492449223: {DaPokaStars}  Hold'em No Limit (50/100) - 2021/07/22 17:52:56 ET
Table 'Halleria II' 9-max (Play Money) Seat #3 is the button
Seat 1: color_singleton (27607 in chips) 
Seat 3: dockstarr (8794 in chips) 
Seat 5: Klemtonius (9656 in chips) 
Seat 9: PokerStarsMan12 (8036 in chips) 
Klemtonius: posts small blind 50
PokerStarsMan12: posts big blind 100
*** HOLE CARDS ***
Dealt to PokerStarsMan12 [6h Jh]
color_singleton: raises 200 to 300
dockstarr: folds 
Klemtonius: folds 
PokerStarsMan12: folds 
Uncalled bet (200) returned to color_singleton
color_singleton collected 250 from pot
color_singleton: doesn't show hand 
*** SUMMARY ***
Total pot 250 | Rake 0 
Seat 1: color_singleton collected (250)
Seat 3: dockstarr (button) folded before Flop (didn't bet)
Seat 5: Klemtonius (small blind) folded before Flop
Seat 9: PokerStarsMan12 (big blind) folded before Flop



PokerStars Home Game Hand #228492457380: {DaPokaStars}  Hold'em No Limit (50/100) - 2021/07/22 17:53:13 ET
Table 'Halleria II' 9-max (Play Money) Seat #5 is the button
Seat 1: color_singleton (27757 in chips) 
Seat 3: dockstarr (8794 in chips) 
Seat 5: Klemtonius (9606 in chips) 
Seat 9: PokerStarsMan12 (7936 in chips) 
PokerStarsMan12: posts small blind 50
color_singleton: posts big blind 100
*** HOLE CARDS ***
Dealt to PokerStarsMan12 [Kd Th]
dockstarr: calls 100
Klemtonius: raises 100 to 200
PokerStarsMan12: calls 150
color_singleton: calls 100
dockstarr: calls 100
*** FLOP *** [8d Js 7s]
PokerStarsMan12: checks 
color_singleton: bets 378
dockstarr: calls 378
Klemtonius: folds 
PokerStarsMan12: folds 
*** TURN *** [8d Js 7s] [4h]
color_singleton: checks 
dockstarr: bets 100
color_singleton: calls 100
*** RIVER *** [8d Js 7s 4h] [3s]
color_singleton: checks 
dockstarr: checks 
*** SHOW DOWN ***
color_singleton: shows [Tc Ts] (a pair of Tens)
dockstarr: shows [Ks Jh] (a pair of Jacks)
dockstarr collected 1659 from pot
*** SUMMARY ***
Total pot 1756 | Rake 97 
Board [8d Js 7s 4h 3s]
Seat 1: color_singleton (big blind) showed [Tc Ts] and lost with a pair of Tens
Seat 3: dockstarr showed [Ks Jh] and won (1659) with a pair of Jacks
Seat 5: Klemtonius (button) folded on the Flop
Seat 9: PokerStarsMan12 (small blind) folded on the Flop



PokerStars Home Game Hand #228492479914: {DaPokaStars}  Hold'em No Limit (50/100) - 2021/07/22 17:54:00 ET
Table 'Halleria II' 9-max (Play Money) Seat #9 is the button
Seat 1: color_singleton (27079 in chips) 
Seat 3: dockstarr (9775 in chips) 
Seat 5: Klemtonius (9406 in chips) 
Seat 9: PokerStarsMan12 (7736 in chips) 
color_singleton: posts small blind 50
dockstarr: posts big blind 100
*** HOLE CARDS ***
Dealt to PokerStarsMan12 [Ts Ad]
Klemtonius: raises 100 to 200
PokerStarsMan12: raises 200 to 400
color_singleton: folds 
dockstarr: calls 300
Klemtonius: raises 500 to 900
PokerStarsMan12: calls 500
dockstarr: folds 
*** FLOP *** [3h 7d Ks]
Klemtonius: bets 2126
PokerStarsMan12: folds 
Uncalled bet (2126) returned to Klemtonius
Klemtonius collected 2126 from pot
Klemtonius: doesn't show hand 
*** SUMMARY ***
Total pot 2250 | Rake 124 
Board [3h 7d Ks]
Seat 1: color_singleton (small blind) folded before Flop
Seat 3: dockstarr (big blind) folded before Flop
Seat 5: Klemtonius collected (2126)
Seat 9: PokerStarsMan12 (button) folded on the Flop



PokerStars Home Game Hand #228492495958: {DaPokaStars}  Hold'em No Limit (50/100) - 2021/07/22 17:54:33 ET
Table 'Halleria II' 9-max (Play Money) Seat #1 is the button
Seat 1: color_singleton (27029 in chips) 
Seat 3: dockstarr (9375 in chips) 
Seat 5: Klemtonius (10632 in chips) 
Seat 9: PokerStarsMan12 (6836 in chips) 
dockstarr: posts small blind 50
Klemtonius: posts big blind 100
*** HOLE CARDS ***
Dealt to PokerStarsMan12 [5s Kd]
PokerStarsMan12: folds 
color_singleton: folds 
dockstarr: folds 
Uncalled bet (50) returned to Klemtonius
Klemtonius collected 100 from pot
Klemtonius: doesn't show hand 
*** SUMMARY ***
Total pot 100 | Rake 0 
Seat 1: color_singleton (button) folded before Flop (didn't bet)
Seat 3: dockstarr (small blind) folded before Flop
Seat 5: Klemtonius (big blind) collected (100)
Seat 9: PokerStarsMan12 folded before Flop (didn't bet)



PokerStars Home Game Hand #228492498871: {DaPokaStars}  Hold'em No Limit (50/100) - 2021/07/22 17:54:39 ET
Table 'Halleria II' 9-max (Play Money) Seat #3 is the button
Seat 1: color_singleton (27029 in chips) 
Seat 3: dockstarr (9325 in chips) 
Seat 5: Klemtonius (10682 in chips) 
Seat 9: PokerStarsMan12 (6836 in chips) 
Klemtonius: posts small blind 50
PokerStarsMan12: posts big blind 100
*** HOLE CARDS ***
Dealt to PokerStarsMan12 [8h Ac]
color_singleton: raises 300 to 400
dockstarr: folds 
Klemtonius: calls 350
PokerStarsMan12: calls 300
*** FLOP *** [4s Ah 5d]
Klemtonius: bets 567
PokerStarsMan12: calls 567
color_singleton: calls 567
*** TURN *** [4s Ah 5d] [8s]
Klemtonius: bets 1370
PokerStarsMan12: raises 1430 to 2800
color_singleton: folds 
Klemtonius: calls 1430
*** RIVER *** [4s Ah 5d 8s] [Qc]
Klemtonius: checks 
PokerStarsMan12: bets 2000
Klemtonius: calls 2000
*** SHOW DOWN ***
PokerStarsMan12: shows [8h Ac] (two pair, Aces and Eights)
Klemtonius: mucks hand 
PokerStarsMan12 collected 11813 from pot
*** SUMMARY ***
Total pot 12501 | Rake 688 
Board [4s Ah 5d 8s Qc]
Seat 1: color_singleton folded on the Turn
Seat 3: dockstarr (button) folded before Flop (didn't bet)
Seat 5: Klemtonius (small blind) mucked [As 4h]
Seat 9: PokerStarsMan12 (big blind) showed [8h Ac] and won (11813) with two pair, Aces and Eights



PokerStars Home Game Hand #228492517519: {DaPokaStars}  Hold'em No Limit (50/100) - 2021/07/22 17:55:21 ET
Table 'Halleria II' 9-max (Play Money) Seat #5 is the button
Seat 1: color_singleton (26062 in chips) 
Seat 3: dockstarr (9325 in chips) 
Seat 5: Klemtonius (4915 in chips) 
Seat 9: PokerStarsMan12 (12882 in chips) 
PokerStarsMan12: posts small blind 50
color_singleton: posts big blind 100
*** HOLE CARDS ***
Dealt to PokerStarsMan12 [Td 7d]
dockstarr: calls 100
Klemtonius: calls 100
PokerStarsMan12: calls 50
color_singleton: checks 
*** FLOP *** [6h As 8c]
PokerStarsMan12: checks 
color_singleton: checks 
dockstarr: bets 100
Klemtonius: calls 100
PokerStarsMan12: folds 
color_singleton: folds 
*** TURN *** [6h As 8c] [7h]
dockstarr: bets 100
Klemtonius: folds 
Uncalled bet (100) returned to dockstarr
dockstarr collected 567 from pot
dockstarr: doesn't show hand 
*** SUMMARY ***
Total pot 600 | Rake 33 
Board [6h As 8c 7h]
Seat 1: color_singleton (big blind) folded on the Flop
Seat 3: dockstarr collected (567)
Seat 5: Klemtonius (button) folded on the Turn
Seat 9: PokerStarsMan12 (small blind) folded on the Flop



PokerStars Home Game Hand #228492527313: {DaPokaStars}  Hold'em No Limit (50/100) - 2021/07/22 17:55:53 ET
Table 'Halleria II' 9-max (Play Money) Seat #9 is the button
Seat 1: color_singleton (25962 in chips) 
Seat 3: dockstarr (9692 in chips) 
Seat 5: Klemtonius (4715 in chips) 
Seat 9: PokerStarsMan12 (12782 in chips) 
color_singleton: posts small blind 50
dockstarr: posts big blind 100
*** HOLE CARDS ***
Dealt to PokerStarsMan12 [3h 2c]
Klemtonius: calls 100
PokerStarsMan12: folds 
color_singleton: raises 200 to 300
dockstarr: folds 
Klemtonius: calls 200
*** FLOP *** [Kh Qh Qs]
color_singleton: bets 330
Klemtonius: calls 330
*** TURN *** [Kh Qh Qs] [8s]
color_singleton: checks 
Klemtonius: checks 
*** RIVER *** [Kh Qh Qs 8s] [4h]
color_singleton: checks 
Klemtonius: checks 
*** SHOW DOWN ***
color_singleton: shows [7h Ks] (two pair, Kings and Queens)
Klemtonius: shows [6d Kd] (two pair, Kings and Queens)
color_singleton collected 643 from pot
Klemtonius collected 642 from pot
*** SUMMARY ***
Total pot 1360 | Rake 75 
Board [Kh Qh Qs 8s 4h]
Seat 1: color_singleton (small blind) showed [7h Ks] and won (643) with two pair, Kings and Queens
Seat 3: dockstarr (big blind) folded before Flop
Seat 5: Klemtonius showed [6d Kd] and won (642) with two pair, Kings and Queens
Seat 9: PokerStarsMan12 (button) folded before Flop (didn't bet)



PokerStars Home Game Hand #228492535116: {DaPokaStars}  Hold'em No Limit (50/100) - 2021/07/22 17:56:18 ET
Table 'Halleria II' 9-max (Play Money) Seat #1 is the button
Seat 1: color_singleton (25975 in chips) 
Seat 3: dockstarr (9592 in chips) 
Seat 5: Klemtonius (4727 in chips) 
Seat 9: PokerStarsMan12 (12782 in chips) 
dockstarr: posts small blind 50
Klemtonius: posts big blind 100
*** HOLE CARDS ***
Dealt to PokerStarsMan12 [5d 7s]
PokerStarsMan12: folds 
color_singleton: calls 100
dockstarr: calls 50
Klemtonius: checks 
*** FLOP *** [3h Ad Qd]
dockstarr: bets 100
Klemtonius: folds 
color_singleton: calls 100
*** TURN *** [3h Ad Qd] [4c]
dockstarr: bets 100
color_singleton: raises 200 to 300
dockstarr: folds 
Uncalled bet (200) returned to color_singleton
color_singleton collected 661 from pot
color_singleton: doesn't show hand 
*** SUMMARY ***
Total pot 700 | Rake 39 
Board [3h Ad Qd 4c]
Seat 1: color_singleton (button) collected (661)
Seat 3: dockstarr (small blind) folded on the Turn
Seat 5: Klemtonius (big blind) folded on the Flop
Seat 9: PokerStarsMan12 folded before Flop (didn't bet)



PokerStars Home Game Hand #228492549620: {DaPokaStars}  Hold'em No Limit (50/100) - 2021/07/22 17:57:05 ET
Table 'Halleria II' 9-max (Play Money) Seat #5 is the button
Seat 1: color_singleton (26336 in chips) 
Seat 5: Klemtonius (4627 in chips) 
Seat 9: PokerStarsMan12 (12782 in chips) 
PokerStarsMan12: posts small blind 50
color_singleton: posts big blind 100
*** HOLE CARDS ***
Dealt to PokerStarsMan12 [5s 3s]
Klemtonius: calls 100
PokerStarsMan12: calls 50
color_singleton: checks 
*** FLOP *** [Ac Qc 4c]
PokerStarsMan12: checks 
color_singleton: checks 
Klemtonius: bets 141
PokerStarsMan12: folds 
color_singleton: folds 
Uncalled bet (141) returned to Klemtonius
Klemtonius collected 283 from pot
Klemtonius: doesn't show hand 
*** SUMMARY ***
Total pot 300 | Rake 17 
Board [Ac Qc 4c]
Seat 1: color_singleton (big blind) folded on the Flop
Seat 5: Klemtonius (button) collected (283)
Seat 9: PokerStarsMan12 (small blind) folded on the Flop



