PokerStars Home Game Hand #229539307198: {DaPokaStars}  Hold'em No Limit (50/100) - 2021/09/02 15:28:10 ET
Table 'summer poker' 9-max (Play Money) Seat #6 is the button
Seat 2: dockstarr (9656 in chips) 
Seat 3: PokerStarsMan12 (10000 in chips) 
Seat 6: HighCardJasper (10323 in chips) 
dockstarr: posts small blind 50
PokerStarsMan12: posts big blind 100
*** HOLE CARDS ***
Dealt to PokerStarsMan12 [3c 7c]
HighCardJasper: calls 100
dockstarr: folds 
PokerStarsMan12: checks 
*** FLOP *** [8h 4d Th]
PokerStarsMan12: checks 
HighCardJasper: bets 200
PokerStarsMan12: folds 
Uncalled bet (200) returned to HighCardJasper
HighCardJasper collected 236 from pot
HighCardJasper: doesn't show hand 
*** SUMMARY ***
Total pot 250 | Rake 14 
Board [8h 4d Th]
Seat 2: dockstarr (small blind) folded before Flop
Seat 3: PokerStarsMan12 (big blind) folded on the Flop
Seat 6: HighCardJasper (button) collected (236)



PokerStars Home Game Hand #229539340141: {DaPokaStars}  Hold'em No Limit (50/100) - 2021/09/02 15:29:03 ET
Table 'summer poker' 9-max (Play Money) Seat #2 is the button
Seat 2: dockstarr (9606 in chips) 
Seat 3: PokerStarsMan12 (9900 in chips) 
Seat 6: HighCardJasper (10459 in chips) 
PokerStarsMan12: posts small blind 50
HighCardJasper: posts big blind 100
*** HOLE CARDS ***
Dealt to PokerStarsMan12 [3h 8c]
dockstarr: calls 100
PokerStarsMan12: folds 
HighCardJasper: checks 
*** FLOP *** [8s 4h Td]
HighCardJasper: checks 
dockstarr: bets 100
HighCardJasper: calls 100
*** TURN *** [8s 4h Td] [5h]
HighCardJasper: checks 
dockstarr: bets 100
HighCardJasper: calls 100
*** RIVER *** [8s 4h Td 5h] [7c]
HighCardJasper: bets 307
dockstarr: raises 307 to 614
HighCardJasper: calls 307
*** SHOW DOWN ***
dockstarr: shows [Ts Tc] (three of a kind, Tens)
HighCardJasper: mucks hand 
dockstarr collected 1775 from pot
*** SUMMARY ***
Total pot 1878 | Rake 103 
Board [8s 4h Td 5h 7c]
Seat 2: dockstarr (button) showed [Ts Tc] and won (1775) with three of a kind, Tens
Seat 3: PokerStarsMan12 (small blind) folded before Flop
Seat 6: HighCardJasper (big blind) mucked [7h 5c]



PokerStars Home Game Hand #229539375930: {DaPokaStars}  Hold'em No Limit (50/100) - 2021/09/02 15:30:05 ET
Table 'summer poker' 9-max (Play Money) Seat #3 is the button
Seat 1: color_singleton (9900 in chips) 
Seat 2: dockstarr (10467 in chips) 
Seat 3: PokerStarsMan12 (9850 in chips) 
Seat 6: HighCardJasper (9545 in chips) 
HighCardJasper: posts small blind 50
color_singleton: posts big blind 100
*** HOLE CARDS ***
Dealt to PokerStarsMan12 [Kc 5c]
dockstarr: folds 
PokerStarsMan12: folds 
HighCardJasper: calls 50
color_singleton: checks 
*** FLOP *** [9h 7c 6s]
HighCardJasper: checks 
color_singleton: bets 189
HighCardJasper: calls 189
*** TURN *** [9h 7c 6s] [2d]
HighCardJasper: checks 
color_singleton: checks 
*** RIVER *** [9h 7c 6s 2d] [8d]
HighCardJasper: bets 273
color_singleton: raises 273 to 546
HighCardJasper: calls 273
*** SHOW DOWN ***
color_singleton: shows [6h 5h] (a straight, Five to Nine)
HighCardJasper: mucks hand 
color_singleton collected 1578 from pot
*** SUMMARY ***
Total pot 1670 | Rake 92 
Board [9h 7c 6s 2d 8d]
Seat 1: color_singleton (big blind) showed [6h 5h] and won (1578) with a straight, Five to Nine
Seat 2: dockstarr folded before Flop (didn't bet)
Seat 3: PokerStarsMan12 (button) folded before Flop (didn't bet)
Seat 6: HighCardJasper (small blind) mucked [9d Qh]



PokerStars Home Game Hand #229539402346: {DaPokaStars}  Hold'em No Limit (50/100) - 2021/09/02 15:30:57 ET
Table 'summer poker' 9-max (Play Money) Seat #6 is the button
Seat 1: color_singleton (10643 in chips) 
Seat 2: dockstarr (10467 in chips) 
Seat 3: PokerStarsMan12 (9850 in chips) 
Seat 6: HighCardJasper (8710 in chips) 
color_singleton: posts small blind 50
dockstarr: posts big blind 100
*** HOLE CARDS ***
Dealt to PokerStarsMan12 [Kh 6d]
PokerStarsMan12: calls 100
HighCardJasper: folds 
color_singleton: calls 50
dockstarr: checks 
*** FLOP *** [Qs 7s 7h]
color_singleton: checks 
dockstarr: checks 
PokerStarsMan12: checks 
*** TURN *** [Qs 7s 7h] [9s]
color_singleton: bets 141
dockstarr: calls 141
PokerStarsMan12: folds 
*** RIVER *** [Qs 7s 7h 9s] [8c]
color_singleton: bets 275
dockstarr: raises 275 to 550
color_singleton: calls 275
*** SHOW DOWN ***
dockstarr: shows [4s 3s] (a flush, Queen high)
color_singleton: mucks hand 
dockstarr collected 1589 from pot
*** SUMMARY ***
Total pot 1682 | Rake 93 
Board [Qs 7s 7h 9s 8c]
Seat 1: color_singleton (small blind) mucked [Qh 3h]
Seat 2: dockstarr (big blind) showed [4s 3s] and won (1589) with a flush, Queen high
Seat 3: PokerStarsMan12 folded on the Turn
Seat 6: HighCardJasper (button) folded before Flop (didn't bet)



PokerStars Home Game Hand #229539427808: {DaPokaStars}  Hold'em No Limit (50/100) - 2021/09/02 15:31:47 ET
Table 'summer poker' 9-max (Play Money) Seat #1 is the button
Seat 1: color_singleton (9852 in chips) 
Seat 2: dockstarr (11265 in chips) 
Seat 3: PokerStarsMan12 (9750 in chips) 
Seat 6: HighCardJasper (8710 in chips) 
dockstarr: posts small blind 50
PokerStarsMan12: posts big blind 100
*** HOLE CARDS ***
Dealt to PokerStarsMan12 [Qd 7d]
HighCardJasper: calls 100
color_singleton: folds 
dockstarr: folds 
PokerStarsMan12: checks 
*** FLOP *** [6c Ts 3c]
PokerStarsMan12: checks 
HighCardJasper: checks 
*** TURN *** [6c Ts 3c] [Ac]
PokerStarsMan12: checks 
HighCardJasper: checks 
*** RIVER *** [6c Ts 3c Ac] [Tc]
PokerStarsMan12: checks 
HighCardJasper: checks 
*** SHOW DOWN ***
PokerStarsMan12: shows [Qd 7d] (a pair of Tens)
HighCardJasper: mucks hand 
PokerStarsMan12 collected 236 from pot
*** SUMMARY ***
Total pot 250 | Rake 14 
Board [6c Ts 3c Ac Tc]
Seat 1: color_singleton (button) folded before Flop (didn't bet)
Seat 2: dockstarr (small blind) folded before Flop
Seat 3: PokerStarsMan12 (big blind) showed [Qd 7d] and won (236) with a pair of Tens
Seat 6: HighCardJasper mucked [7h 9h]



PokerStars Home Game Hand #229539440197: {DaPokaStars}  Hold'em No Limit (50/100) - 2021/09/02 15:32:11 ET
Table 'summer poker' 9-max (Play Money) Seat #2 is the button
Seat 1: color_singleton (9852 in chips) 
Seat 2: dockstarr (11215 in chips) 
Seat 3: PokerStarsMan12 (9886 in chips) 
Seat 6: HighCardJasper (8610 in chips) 
PokerStarsMan12: posts small blind 50
HighCardJasper: posts big blind 100
*** HOLE CARDS ***
Dealt to PokerStarsMan12 [8d As]
color_singleton: raises 200 to 300
dockstarr: calls 300
PokerStarsMan12: calls 250
HighCardJasper: calls 200
*** FLOP *** [3s Kd 7h]
PokerStarsMan12: checks 
HighCardJasper: checks 
color_singleton: checks 
dockstarr: checks 
*** TURN *** [3s Kd 7h] [5c]
PokerStarsMan12: checks 
HighCardJasper: checks 
color_singleton: checks 
dockstarr: checks 
*** RIVER *** [3s Kd 7h 5c] [Td]
PokerStarsMan12: checks 
HighCardJasper: bets 567
color_singleton: folds 
dockstarr: folds 
PokerStarsMan12: folds 
Uncalled bet (567) returned to HighCardJasper
HighCardJasper collected 1134 from pot
HighCardJasper: doesn't show hand 
*** SUMMARY ***
Total pot 1200 | Rake 66 
Board [3s Kd 7h 5c Td]
Seat 1: color_singleton folded on the River
Seat 2: dockstarr (button) folded on the River
Seat 3: PokerStarsMan12 (small blind) folded on the River
Seat 6: HighCardJasper (big blind) collected (1134)



PokerStars Home Game Hand #229539462272: {DaPokaStars}  Hold'em No Limit (50/100) - 2021/09/02 15:32:55 ET
Table 'summer poker' 9-max (Play Money) Seat #3 is the button
Seat 1: color_singleton (9552 in chips) 
Seat 2: dockstarr (10915 in chips) 
Seat 3: PokerStarsMan12 (9586 in chips) 
Seat 6: HighCardJasper (9444 in chips) 
HighCardJasper: posts small blind 50
color_singleton: posts big blind 100
*** HOLE CARDS ***
Dealt to PokerStarsMan12 [Qh 6s]
dockstarr: calls 100
PokerStarsMan12: folds 
HighCardJasper: calls 50
color_singleton: checks 
*** FLOP *** [Kc 3h 2c]
HighCardJasper: checks 
color_singleton: checks 
dockstarr: checks 
*** TURN *** [Kc 3h 2c] [6h]
HighCardJasper: checks 
color_singleton: checks 
dockstarr: checks 
*** RIVER *** [Kc 3h 2c 6h] [3c]
HighCardJasper: checks 
color_singleton: checks 
dockstarr: checks 
*** SHOW DOWN ***
HighCardJasper: shows [7c As] (a pair of Threes)
color_singleton: mucks hand 
dockstarr: shows [Jh Ah] (a pair of Threes - Ace+King+Jack kicker)
dockstarr collected 283 from pot
*** SUMMARY ***
Total pot 300 | Rake 17 
Board [Kc 3h 2c 6h 3c]
Seat 1: color_singleton (big blind) mucked [Js 7h]
Seat 2: dockstarr showed [Jh Ah] and won (283) with a pair of Threes
Seat 3: PokerStarsMan12 (button) folded before Flop (didn't bet)
Seat 6: HighCardJasper (small blind) showed [7c As] and lost with a pair of Threes



PokerStars Home Game Hand #229539478838: {DaPokaStars}  Hold'em No Limit (50/100) - 2021/09/02 15:33:29 ET
Table 'summer poker' 9-max (Play Money) Seat #6 is the button
Seat 1: color_singleton (9452 in chips) 
Seat 2: dockstarr (11098 in chips) 
Seat 3: PokerStarsMan12 (9586 in chips) 
Seat 6: HighCardJasper (9344 in chips) 
color_singleton: posts small blind 50
dockstarr: posts big blind 100
*** HOLE CARDS ***
Dealt to PokerStarsMan12 [Ts Kh]
PokerStarsMan12: raises 200 to 300
HighCardJasper: folds 
color_singleton: folds 
dockstarr: calls 200
*** FLOP *** [3h 3c 3d]
dockstarr: bets 100
PokerStarsMan12: calls 100
*** TURN *** [3h 3c 3d] [Tc]
dockstarr: checks 
PokerStarsMan12: bets 500
dockstarr: calls 500
*** RIVER *** [3h 3c 3d Tc] [Th]
dockstarr: checks 
PokerStarsMan12: bets 2000
dockstarr: calls 2000
*** SHOW DOWN ***
PokerStarsMan12: shows [Ts Kh] (a full house, Tens full of Threes)
dockstarr: mucks hand 
PokerStarsMan12 collected 5528 from pot
*** SUMMARY ***
Total pot 5850 | Rake 322 
Board [3h 3c 3d Tc Th]
Seat 1: color_singleton (small blind) folded before Flop
Seat 2: dockstarr (big blind) mucked [Ah Qd]
Seat 3: PokerStarsMan12 showed [Ts Kh] and won (5528) with a full house, Tens full of Threes
Seat 6: HighCardJasper (button) folded before Flop (didn't bet)



PokerStars Home Game Hand #229539493119: {DaPokaStars}  Hold'em No Limit (50/100) - 2021/09/02 15:33:57 ET
Table 'summer poker' 9-max (Play Money) Seat #1 is the button
Seat 1: color_singleton (9402 in chips) 
Seat 2: dockstarr (8198 in chips) 
Seat 3: PokerStarsMan12 (12214 in chips) 
Seat 6: HighCardJasper (9344 in chips) 
dockstarr: posts small blind 50
PokerStarsMan12: posts big blind 100
*** HOLE CARDS ***
Dealt to PokerStarsMan12 [9d As]
HighCardJasper: calls 100
color_singleton: raises 200 to 300
dockstarr: folds 
PokerStarsMan12: calls 200
HighCardJasper: calls 200
*** FLOP *** [3h 6d 3d]
PokerStarsMan12: checks 
HighCardJasper: checks 
color_singleton: bets 898
PokerStarsMan12: folds 
HighCardJasper: folds 
Uncalled bet (898) returned to color_singleton
color_singleton collected 898 from pot
color_singleton: doesn't show hand 
*** SUMMARY ***
Total pot 950 | Rake 52 
Board [3h 6d 3d]
Seat 1: color_singleton (button) collected (898)
Seat 2: dockstarr (small blind) folded before Flop
Seat 3: PokerStarsMan12 (big blind) folded on the Flop
Seat 6: HighCardJasper folded on the Flop



PokerStars Home Game Hand #229539512804: {DaPokaStars}  Hold'em No Limit (50/100) - 2021/09/02 15:34:36 ET
Table 'summer poker' 9-max (Play Money) Seat #2 is the button
Seat 1: color_singleton (10000 in chips) 
Seat 2: dockstarr (8148 in chips) 
Seat 3: PokerStarsMan12 (11914 in chips) 
Seat 6: HighCardJasper (9044 in chips) 
PokerStarsMan12: posts small blind 50
HighCardJasper: posts big blind 100
*** HOLE CARDS ***
Dealt to PokerStarsMan12 [8d Ad]
color_singleton: folds 
dockstarr: calls 100
PokerStarsMan12: calls 50
HighCardJasper: checks 
*** FLOP *** [Th 6s 7s]
PokerStarsMan12: checks 
HighCardJasper: checks 
dockstarr: checks 
*** TURN *** [Th 6s 7s] [5c]
PokerStarsMan12: bets 200
HighCardJasper: calls 200
dockstarr: folds 
*** RIVER *** [Th 6s 7s 5c] [Qh]
PokerStarsMan12: checks 
HighCardJasper: checks 
*** SHOW DOWN ***
PokerStarsMan12: shows [8d Ad] (high card Ace)
HighCardJasper: mucks hand 
PokerStarsMan12 collected 661 from pot
*** SUMMARY ***
Total pot 700 | Rake 39 
Board [Th 6s 7s 5c Qh]
Seat 1: color_singleton folded before Flop (didn't bet)
Seat 2: dockstarr (button) folded on the Turn
Seat 3: PokerStarsMan12 (small blind) showed [8d Ad] and won (661) with high card Ace
Seat 6: HighCardJasper (big blind) mucked [Jd 9d]



PokerStars Home Game Hand #229539533651: {DaPokaStars}  Hold'em No Limit (50/100) - 2021/09/02 15:35:18 ET
Table 'summer poker' 9-max (Play Money) Seat #3 is the button
Seat 1: color_singleton (10000 in chips) 
Seat 2: dockstarr (8048 in chips) 
Seat 3: PokerStarsMan12 (12275 in chips) 
Seat 6: HighCardJasper (8744 in chips) 
HighCardJasper: posts small blind 50
color_singleton: posts big blind 100
*** HOLE CARDS ***
Dealt to PokerStarsMan12 [9h Tc]
dockstarr: folds 
PokerStarsMan12: calls 100
HighCardJasper: folds 
color_singleton: checks 
*** FLOP *** [3h 8s 5h]
color_singleton: checks 
PokerStarsMan12: checks 
*** TURN *** [3h 8s 5h] [9d]
color_singleton: checks 
PokerStarsMan12: checks 
*** RIVER *** [3h 8s 5h 9d] [Td]
color_singleton: bets 236
PokerStarsMan12: raises 436 to 672
color_singleton: raises 436 to 1108
PokerStarsMan12: folds 
Uncalled bet (436) returned to color_singleton
color_singleton collected 1506 from pot
color_singleton: doesn't show hand 
*** SUMMARY ***
Total pot 1594 | Rake 88 
Board [3h 8s 5h 9d Td]
Seat 1: color_singleton (big blind) collected (1506)
Seat 2: dockstarr folded before Flop (didn't bet)
Seat 3: PokerStarsMan12 (button) folded on the River
Seat 6: HighCardJasper (small blind) folded before Flop



PokerStars Home Game Hand #229539561886: {DaPokaStars}  Hold'em No Limit (50/100) - 2021/09/02 15:36:14 ET
Table 'summer poker' 9-max (Play Money) Seat #6 is the button
Seat 1: color_singleton (10734 in chips) 
Seat 2: dockstarr (8048 in chips) 
Seat 3: PokerStarsMan12 (11503 in chips) 
Seat 6: HighCardJasper (8694 in chips) 
color_singleton: posts small blind 50
dockstarr: posts big blind 100
*** HOLE CARDS ***
Dealt to PokerStarsMan12 [5s 3s]
PokerStarsMan12: calls 100
HighCardJasper: calls 100
color_singleton: calls 50
dockstarr: checks 
*** FLOP *** [Th Qc 6h]
color_singleton: checks 
dockstarr: checks 
PokerStarsMan12: checks 
HighCardJasper: checks 
*** TURN *** [Th Qc 6h] [Kh]
color_singleton: checks 
dockstarr: checks 
PokerStarsMan12: checks 
HighCardJasper: checks 
*** RIVER *** [Th Qc 6h Kh] [4s]
color_singleton: checks 
dockstarr: checks 
PokerStarsMan12: checks 
HighCardJasper: checks 
*** SHOW DOWN ***
color_singleton: shows [6d 3d] (a pair of Sixes)
dockstarr: mucks hand 
PokerStarsMan12: mucks hand 
HighCardJasper: mucks hand 
color_singleton collected 378 from pot
*** SUMMARY ***
Total pot 400 | Rake 22 
Board [Th Qc 6h Kh 4s]
Seat 1: color_singleton (small blind) showed [6d 3d] and won (378) with a pair of Sixes
Seat 2: dockstarr (big blind) mucked [8d 2s]
Seat 3: PokerStarsMan12 mucked [5s 3s]
Seat 6: HighCardJasper (button) mucked [As 9s]



PokerStars Home Game Hand #229539581416: {DaPokaStars}  Hold'em No Limit (50/100) - 2021/09/02 15:36:53 ET
Table 'summer poker' 9-max (Play Money) Seat #1 is the button
Seat 1: color_singleton (11012 in chips) 
Seat 2: dockstarr (7948 in chips) 
Seat 3: PokerStarsMan12 (11403 in chips) 
Seat 6: HighCardJasper (8594 in chips) 
dockstarr: posts small blind 50
PokerStarsMan12: posts big blind 100
*** HOLE CARDS ***
Dealt to PokerStarsMan12 [4d 2d]
HighCardJasper: calls 100
color_singleton: folds 
dockstarr: calls 50
PokerStarsMan12: checks 
*** FLOP *** [Js 9s 4c]
dockstarr: checks 
PokerStarsMan12: checks 
HighCardJasper: checks 
*** TURN *** [Js 9s 4c] [Jc]
dockstarr: checks 
PokerStarsMan12: bets 200
HighCardJasper: folds 
dockstarr: folds 
Uncalled bet (200) returned to PokerStarsMan12
PokerStarsMan12 collected 283 from pot
*** SUMMARY ***
Total pot 300 | Rake 17 
Board [Js 9s 4c Jc]
Seat 1: color_singleton (button) folded before Flop (didn't bet)
Seat 2: dockstarr (small blind) folded on the Turn
Seat 3: PokerStarsMan12 (big blind) collected (283)
Seat 6: HighCardJasper folded on the Turn



PokerStars Home Game Hand #229539603276: {DaPokaStars}  Hold'em No Limit (50/100) - 2021/09/02 15:37:36 ET
Table 'summer poker' 9-max (Play Money) Seat #2 is the button
Seat 1: color_singleton (11012 in chips) 
Seat 2: dockstarr (7848 in chips) 
Seat 3: PokerStarsMan12 (11586 in chips) 
Seat 6: HighCardJasper (8494 in chips) 
PokerStarsMan12: posts small blind 50
HighCardJasper: posts big blind 100
*** HOLE CARDS ***
Dealt to PokerStarsMan12 [5s 9h]
color_singleton: folds 
dockstarr: folds 
PokerStarsMan12: calls 50
HighCardJasper: raises 100 to 200
PokerStarsMan12: calls 100
*** FLOP *** [9c 2h 3c]
PokerStarsMan12: bets 200
HighCardJasper: calls 200
*** TURN *** [9c 2h 3c] [6h]
PokerStarsMan12: bets 400
HighCardJasper: folds 
Uncalled bet (400) returned to PokerStarsMan12
PokerStarsMan12 collected 756 from pot
*** SUMMARY ***
Total pot 800 | Rake 44 
Board [9c 2h 3c 6h]
Seat 1: color_singleton folded before Flop (didn't bet)
Seat 2: dockstarr (button) folded before Flop (didn't bet)
Seat 3: PokerStarsMan12 (small blind) collected (756)
Seat 6: HighCardJasper (big blind) folded on the Turn



PokerStars Home Game Hand #229539632560: {DaPokaStars}  Hold'em No Limit (50/100) - 2021/09/02 15:38:33 ET
Table 'summer poker' 9-max (Play Money) Seat #3 is the button
Seat 1: color_singleton (11012 in chips) 
Seat 2: dockstarr (7848 in chips) 
Seat 3: PokerStarsMan12 (11942 in chips) 
Seat 6: HighCardJasper (8094 in chips) 
HighCardJasper: posts small blind 50
color_singleton: posts big blind 100
*** HOLE CARDS ***
Dealt to PokerStarsMan12 [9d Qs]
dockstarr: calls 100
PokerStarsMan12: calls 100
HighCardJasper: calls 50
color_singleton: raises 300 to 400
dockstarr: folds 
PokerStarsMan12: calls 300
HighCardJasper: folds 
*** FLOP *** [Kc Ad 2s]
color_singleton: bets 472
PokerStarsMan12: folds 
Uncalled bet (472) returned to color_singleton
color_singleton collected 945 from pot
color_singleton: doesn't show hand 
*** SUMMARY ***
Total pot 1000 | Rake 55 
Board [Kc Ad 2s]
Seat 1: color_singleton (big blind) collected (945)
Seat 2: dockstarr folded before Flop
Seat 3: PokerStarsMan12 (button) folded on the Flop
Seat 6: HighCardJasper (small blind) folded before Flop



PokerStars Home Game Hand #229539650495: {DaPokaStars}  Hold'em No Limit (50/100) - 2021/09/02 15:39:08 ET
Table 'summer poker' 9-max (Play Money) Seat #6 is the button
Seat 1: color_singleton (11557 in chips) 
Seat 2: dockstarr (7748 in chips) 
Seat 3: PokerStarsMan12 (11542 in chips) 
Seat 6: HighCardJasper (7994 in chips) 
color_singleton: posts small blind 50
dockstarr: posts big blind 100
*** HOLE CARDS ***
Dealt to PokerStarsMan12 [As 7d]
PokerStarsMan12: raises 200 to 300
HighCardJasper: folds 
color_singleton: folds 
dockstarr: folds 
Uncalled bet (200) returned to PokerStarsMan12
PokerStarsMan12 collected 250 from pot
*** SUMMARY ***
Total pot 250 | Rake 0 
Seat 1: color_singleton (small blind) folded before Flop
Seat 2: dockstarr (big blind) folded before Flop
Seat 3: PokerStarsMan12 collected (250)
Seat 6: HighCardJasper (button) folded before Flop (didn't bet)



PokerStars Home Game Hand #229539657083: {DaPokaStars}  Hold'em No Limit (50/100) - 2021/09/02 15:39:21 ET
Table 'summer poker' 9-max (Play Money) Seat #1 is the button
Seat 1: color_singleton (11507 in chips) 
Seat 2: dockstarr (7648 in chips) 
Seat 3: PokerStarsMan12 (11692 in chips) 
Seat 6: HighCardJasper (7994 in chips) 
dockstarr: posts small blind 50
PokerStarsMan12: posts big blind 100
*** HOLE CARDS ***
Dealt to PokerStarsMan12 [Ac 5c]
HighCardJasper: calls 100
color_singleton: raises 300 to 400
dockstarr: folds 
PokerStarsMan12: calls 300
HighCardJasper: folds 
*** FLOP *** [7h Js 2h]
PokerStarsMan12: checks 
color_singleton: checks 
*** TURN *** [7h Js 2h] [6s]
PokerStarsMan12: checks 
color_singleton: checks 
*** RIVER *** [7h Js 2h 6s] [Td]
PokerStarsMan12: bets 400
color_singleton: folds 
Uncalled bet (400) returned to PokerStarsMan12
PokerStarsMan12 collected 898 from pot
*** SUMMARY ***
Total pot 950 | Rake 52 
Board [7h Js 2h 6s Td]
Seat 1: color_singleton (button) folded on the River
Seat 2: dockstarr (small blind) folded before Flop
Seat 3: PokerStarsMan12 (big blind) collected (898)
Seat 6: HighCardJasper folded before Flop



PokerStars Home Game Hand #229539688353: {DaPokaStars}  Hold'em No Limit (50/100) - 2021/09/02 15:40:23 ET
Table 'summer poker' 9-max (Play Money) Seat #2 is the button
Seat 1: color_singleton (11107 in chips) 
Seat 2: dockstarr (7598 in chips) 
Seat 3: PokerStarsMan12 (12190 in chips) 
Seat 6: HighCardJasper (7894 in chips) 
PokerStarsMan12: posts small blind 50
HighCardJasper: posts big blind 100
*** HOLE CARDS ***
Dealt to PokerStarsMan12 [9s Qh]
color_singleton: folds 
dockstarr: calls 100
PokerStarsMan12: calls 50
HighCardJasper: checks 
*** FLOP *** [7h 6d 7d]
PokerStarsMan12: checks 
HighCardJasper: checks 
dockstarr: checks 
*** TURN *** [7h 6d 7d] [Jh]
PokerStarsMan12: checks 
HighCardJasper: checks 
dockstarr: checks 
*** RIVER *** [7h 6d 7d Jh] [7c]
PokerStarsMan12: checks 
HighCardJasper: checks 
dockstarr: checks 
*** SHOW DOWN ***
PokerStarsMan12: shows [9s Qh] (three of a kind, Sevens)
HighCardJasper: shows [As 3c] (three of a kind, Sevens - Ace kicker)
dockstarr: mucks hand 
HighCardJasper collected 283 from pot
*** SUMMARY ***
Total pot 300 | Rake 17 
Board [7h 6d 7d Jh 7c]
Seat 1: color_singleton folded before Flop (didn't bet)
Seat 2: dockstarr (button) mucked [5s Kc]
Seat 3: PokerStarsMan12 (small blind) showed [9s Qh] and lost with three of a kind, Sevens
Seat 6: HighCardJasper (big blind) showed [As 3c] and won (283) with three of a kind, Sevens



PokerStars Home Game Hand #229539712159: {DaPokaStars}  Hold'em No Limit (50/100) - 2021/09/02 15:41:09 ET
Table 'summer poker' 9-max (Play Money) Seat #3 is the button
Seat 1: color_singleton (11107 in chips) 
Seat 2: dockstarr (7498 in chips) 
Seat 3: PokerStarsMan12 (12090 in chips) 
Seat 6: HighCardJasper (8077 in chips) 
HighCardJasper: posts small blind 50
color_singleton: posts big blind 100
*** HOLE CARDS ***
Dealt to PokerStarsMan12 [5c Kd]
dockstarr: calls 100
PokerStarsMan12: calls 100
HighCardJasper: calls 50
color_singleton: raises 300 to 400
dockstarr: calls 300
PokerStarsMan12: folds 
HighCardJasper: folds 
*** FLOP *** [9s 2s Tc]
color_singleton: bets 472
dockstarr: folds 
Uncalled bet (472) returned to color_singleton
color_singleton collected 945 from pot
color_singleton: doesn't show hand 
*** SUMMARY ***
Total pot 1000 | Rake 55 
Board [9s 2s Tc]
Seat 1: color_singleton (big blind) collected (945)
Seat 2: dockstarr folded on the Flop
Seat 3: PokerStarsMan12 (button) folded before Flop
Seat 6: HighCardJasper (small blind) folded before Flop



PokerStars Home Game Hand #229539729494: {DaPokaStars}  Hold'em No Limit (50/100) - 2021/09/02 15:41:44 ET
Table 'summer poker' 9-max (Play Money) Seat #6 is the button
Seat 1: color_singleton (11652 in chips) 
Seat 2: dockstarr (7098 in chips) 
Seat 3: PokerStarsMan12 (11990 in chips) 
Seat 6: HighCardJasper (7977 in chips) 
color_singleton: posts small blind 50
dockstarr: posts big blind 100
*** HOLE CARDS ***
Dealt to PokerStarsMan12 [Kh Th]
PokerStarsMan12: raises 200 to 300
HighCardJasper: calls 300
color_singleton: calls 250
dockstarr: folds 
*** FLOP *** [9h 8c 4c]
color_singleton: checks 
PokerStarsMan12: bets 500
HighCardJasper: calls 500
color_singleton: folds 
*** TURN *** [9h 8c 4c] [7h]
PokerStarsMan12: bets 1000
HighCardJasper: folds 
Uncalled bet (1000) returned to PokerStarsMan12
PokerStarsMan12 collected 1890 from pot
*** SUMMARY ***
Total pot 2000 | Rake 110 
Board [9h 8c 4c 7h]
Seat 1: color_singleton (small blind) folded on the Flop
Seat 2: dockstarr (big blind) folded before Flop
Seat 3: PokerStarsMan12 collected (1890)
Seat 6: HighCardJasper (button) folded on the Turn



PokerStars Home Game Hand #229539753800: {DaPokaStars}  Hold'em No Limit (50/100) - 2021/09/02 15:42:31 ET
Table 'summer poker' 9-max (Play Money) Seat #1 is the button
Seat 1: color_singleton (11352 in chips) 
Seat 2: dockstarr (6998 in chips) 
Seat 3: PokerStarsMan12 (13080 in chips) 
Seat 6: HighCardJasper (7177 in chips) 
dockstarr: posts small blind 50
PokerStarsMan12: posts big blind 100
*** HOLE CARDS ***
Dealt to PokerStarsMan12 [7d 8s]
HighCardJasper: calls 100
color_singleton: folds 
dockstarr: calls 50
PokerStarsMan12: checks 
*** FLOP *** [Jh Th 7c]
dockstarr: checks 
PokerStarsMan12: checks 
HighCardJasper: bets 141
dockstarr: calls 141
PokerStarsMan12: calls 141
*** TURN *** [Jh Th 7c] [9d]
dockstarr: checks 
PokerStarsMan12: bets 500
HighCardJasper: folds 
dockstarr: folds 
Uncalled bet (500) returned to PokerStarsMan12
PokerStarsMan12 collected 683 from pot
*** SUMMARY ***
Total pot 723 | Rake 40 
Board [Jh Th 7c 9d]
Seat 1: color_singleton (button) folded before Flop (didn't bet)
Seat 2: dockstarr (small blind) folded on the Turn
Seat 3: PokerStarsMan12 (big blind) collected (683)
Seat 6: HighCardJasper folded on the Turn



PokerStars Home Game Hand #229539783978: {Club #3225207}  Hold'em No Limit (50/100) - 2021/09/02 15:43:20 ET
Table 'summer poker' 9-max (Play Money) Seat #2 is the button
Seat 1: color_singleton (11352 in chips) 
Seat 2: dockstarr (6757 in chips) 
Seat 3: PokerStarsMan12 (13522 in chips) 
Seat 6: HighCardJasper (6936 in chips) 
PokerStarsMan12: posts small blind 50
HighCardJasper: posts big blind 100
*** HOLE CARDS ***
Dealt to PokerStarsMan12 [6d 7d]
color_singleton: raises 100 to 200
dockstarr: folds 
PokerStarsMan12: calls 150
HighCardJasper: calls 100
*** FLOP *** [Qc Ad Kd]
PokerStarsMan12: bets 300
HighCardJasper: folds 
color_singleton: calls 300
*** TURN *** [Qc Ad Kd] [5s]
PokerStarsMan12: bets 700
color_singleton: calls 700
*** RIVER *** [Qc Ad Kd 5s] [3s]
PokerStarsMan12: bets 1400
color_singleton: raises 1400 to 2800
PokerStarsMan12 has timed out
PokerStarsMan12: folds 
Uncalled bet (1400) returned to color_singleton
color_singleton collected 5103 from pot
color_singleton: doesn't show hand 
*** SUMMARY ***
Total pot 5400 | Rake 297 
Board [Qc Ad Kd 5s 3s]
Seat 1: color_singleton collected (5103)
Seat 2: dockstarr (button) folded before Flop (didn't bet)
Seat 3: PokerStarsMan12 (small blind) folded on the River
Seat 6: HighCardJasper (big blind) folded on the Flop



PokerStars Home Game Hand #229539835285: {DaPokaStars}  Hold'em No Limit (50/100) - 2021/09/02 15:45:00 ET
Table 'summer poker' 9-max (Play Money) Seat #1 is the button
Seat 1: color_singleton (13955 in chips) 
Seat 2: dockstarr (6657 in chips) 
Seat 3: PokerStarsMan12 (10922 in chips) 
Seat 6: HighCardJasper (6736 in chips) 
dockstarr: posts small blind 50
PokerStarsMan12: posts big blind 100
*** HOLE CARDS ***
Dealt to PokerStarsMan12 [Qd 2d]
HighCardJasper: calls 100
color_singleton: folds 
dockstarr: calls 50
PokerStarsMan12: checks 
*** FLOP *** [3d Ad 3c]
dockstarr: checks 
PokerStarsMan12: bets 141
HighCardJasper: folds 
dockstarr: calls 141
*** TURN *** [3d Ad 3c] [6h]
dockstarr: checks 
PokerStarsMan12: bets 300
dockstarr: calls 300
*** RIVER *** [3d Ad 3c 6h] [4h]
dockstarr: checks 
PokerStarsMan12: checks 
*** SHOW DOWN ***
dockstarr: shows [Jh As] (two pair, Aces and Threes)
PokerStarsMan12: mucks hand 
dockstarr collected 1117 from pot
*** SUMMARY ***
Total pot 1182 | Rake 65 
Board [3d Ad 3c 6h 4h]
Seat 1: color_singleton (button) folded before Flop (didn't bet)
Seat 2: dockstarr (small blind) showed [Jh As] and won (1117) with two pair, Aces and Threes
Seat 3: PokerStarsMan12 (big blind) mucked [Qd 2d]
Seat 6: HighCardJasper folded on the Flop



PokerStars Home Game Hand #229539864401: {DaPokaStars}  Hold'em No Limit (50/100) - 2021/09/02 15:45:57 ET
Table 'summer poker' 9-max (Play Money) Seat #2 is the button
Seat 1: color_singleton (13955 in chips) 
Seat 2: dockstarr (7233 in chips) 
Seat 3: PokerStarsMan12 (10381 in chips) 
Seat 6: HighCardJasper (6636 in chips) 
PokerStarsMan12: posts small blind 50
HighCardJasper: posts big blind 100
*** HOLE CARDS ***
Dealt to PokerStarsMan12 [9c Ts]
color_singleton: raises 200 to 300
dockstarr: folds 
PokerStarsMan12: calls 250
HighCardJasper: folds 
*** FLOP *** [4c 6c Qd]
PokerStarsMan12: checks 
color_singleton: checks 
*** TURN *** [4c 6c Qd] [3h]
PokerStarsMan12: checks 
color_singleton: checks 
*** RIVER *** [4c 6c Qd 3h] [3s]
PokerStarsMan12: checks 
color_singleton: checks 
*** SHOW DOWN ***
PokerStarsMan12: shows [9c Ts] (a pair of Threes)
color_singleton: shows [2c 2s] (two pair, Threes and Deuces)
color_singleton collected 661 from pot
*** SUMMARY ***
Total pot 700 | Rake 39 
Board [4c 6c Qd 3h 3s]
Seat 1: color_singleton showed [2c 2s] and won (661) with two pair, Threes and Deuces
Seat 2: dockstarr (button) folded before Flop (didn't bet)
Seat 3: PokerStarsMan12 (small blind) showed [9c Ts] and lost with a pair of Threes
Seat 6: HighCardJasper (big blind) folded before Flop



PokerStars Home Game Hand #229539878233: {DaPokaStars}  Hold'em No Limit (50/100) - 2021/09/02 15:46:24 ET
Table 'summer poker' 9-max (Play Money) Seat #3 is the button
Seat 1: color_singleton (14316 in chips) 
Seat 2: dockstarr (7233 in chips) 
Seat 3: PokerStarsMan12 (10081 in chips) 
Seat 6: HighCardJasper (6536 in chips) 
HighCardJasper: posts small blind 50
color_singleton: posts big blind 100
*** HOLE CARDS ***
Dealt to PokerStarsMan12 [3d Ah]
dockstarr: calls 100
PokerStarsMan12: calls 100
HighCardJasper has timed out
HighCardJasper: folds 
color_singleton: raises 200 to 300
dockstarr: calls 200
PokerStarsMan12: calls 200
*** FLOP *** [Ac Kc 4h]
color_singleton: bets 449
dockstarr: calls 449
PokerStarsMan12: calls 449
*** TURN *** [Ac Kc 4h] [9c]
color_singleton: bets 1085
dockstarr: folds 
PokerStarsMan12: folds 
Uncalled bet (1085) returned to color_singleton
color_singleton collected 2171 from pot
color_singleton: doesn't show hand 
*** SUMMARY ***
Total pot 2297 | Rake 126 
Board [Ac Kc 4h 9c]
Seat 1: color_singleton (big blind) collected (2171)
Seat 2: dockstarr folded on the Turn
Seat 3: PokerStarsMan12 (button) folded on the Turn
Seat 6: HighCardJasper (small blind) folded before Flop



PokerStars Home Game Hand #229539907822: {DaPokaStars}  Hold'em No Limit (50/100) - 2021/09/02 15:47:21 ET
Table 'summer poker' 9-max (Play Money) Seat #6 is the button
Seat 1: color_singleton (15738 in chips) 
Seat 2: dockstarr (6484 in chips) 
Seat 3: PokerStarsMan12 (9332 in chips) 
Seat 6: HighCardJasper (6486 in chips) 
color_singleton: posts small blind 50
dockstarr: posts big blind 100
*** HOLE CARDS ***
Dealt to PokerStarsMan12 [8d Ad]
PokerStarsMan12: raises 200 to 300
HighCardJasper: folds 
color_singleton: calls 250
dockstarr: folds 
*** FLOP *** [8c 9c 4h]
color_singleton: checks 
PokerStarsMan12: checks 
*** TURN *** [8c 9c 4h] [7s]
color_singleton: checks 
PokerStarsMan12: checks 
*** RIVER *** [8c 9c 4h 7s] [Ts]
color_singleton: bets 661
PokerStarsMan12: folds 
Uncalled bet (661) returned to color_singleton
color_singleton collected 661 from pot
color_singleton: doesn't show hand 
*** SUMMARY ***
Total pot 700 | Rake 39 
Board [8c 9c 4h 7s Ts]
Seat 1: color_singleton (small blind) collected (661)
Seat 2: dockstarr (big blind) folded before Flop
Seat 3: PokerStarsMan12 folded on the River
Seat 6: HighCardJasper (button) folded before Flop (didn't bet)



PokerStars Home Game Hand #229539928179: {DaPokaStars}  Hold'em No Limit (50/100) - 2021/09/02 15:48:01 ET
Table 'summer poker' 9-max (Play Money) Seat #1 is the button
Seat 1: color_singleton (16099 in chips) 
Seat 2: dockstarr (6384 in chips) 
Seat 3: PokerStarsMan12 (9032 in chips) 
Seat 6: HighCardJasper (6486 in chips) 
dockstarr: posts small blind 50
PokerStarsMan12: posts big blind 100
*** HOLE CARDS ***
Dealt to PokerStarsMan12 [3c 4c]
HighCardJasper: calls 100
color_singleton: folds 
dockstarr: calls 50
PokerStarsMan12: checks 
*** FLOP *** [3d Ac Kc]
dockstarr: checks 
PokerStarsMan12: bets 200
HighCardJasper: calls 200
dockstarr: calls 200
*** TURN *** [3d Ac Kc] [4d]
dockstarr: checks 
PokerStarsMan12: bets 500
HighCardJasper: calls 500
dockstarr: calls 500
*** RIVER *** [3d Ac Kc 4d] [2s]
dockstarr: checks 
PokerStarsMan12: bets 1000
HighCardJasper: calls 1000
dockstarr: folds 
*** SHOW DOWN ***
PokerStarsMan12: shows [3c 4c] (two pair, Fours and Threes)
HighCardJasper: shows [4s As] (two pair, Aces and Fours)
HighCardJasper collected 4158 from pot
manon327 joins the table at seat #5 
*** SUMMARY ***
Total pot 4400 | Rake 242 
Board [3d Ac Kc 4d 2s]
Seat 1: color_singleton (button) folded before Flop (didn't bet)
Seat 2: dockstarr (small blind) folded on the River
Seat 3: PokerStarsMan12 (big blind) showed [3c 4c] and lost with two pair, Fours and Threes
Seat 6: HighCardJasper showed [4s As] and won (4158) with two pair, Aces and Fours



PokerStars Home Game Hand #229539956281: {DaPokaStars}  Hold'em No Limit (50/100) - 2021/09/02 15:48:56 ET
Table 'summer poker' 9-max (Play Money) Seat #2 is the button
Seat 1: color_singleton (16099 in chips) 
Seat 2: dockstarr (5584 in chips) 
Seat 3: PokerStarsMan12 (7232 in chips) 
Seat 5: manon327 (10000 in chips) 
Seat 6: HighCardJasper (8844 in chips) 
PokerStarsMan12: posts small blind 50
manon327: posts big blind 100
*** HOLE CARDS ***
Dealt to PokerStarsMan12 [6c Jh]
HighCardJasper: calls 100
color_singleton: calls 100
dockstarr: calls 100
PokerStarsMan12: calls 50
manon327: checks 
*** FLOP *** [Th 4s 5d]
PokerStarsMan12: checks 
manon327: checks 
HighCardJasper: checks 
color_singleton: bets 236
dockstarr: calls 236
PokerStarsMan12: folds 
manon327: folds 
HighCardJasper: folds 
*** TURN *** [Th 4s 5d] [Jc]
color_singleton: bets 459
dockstarr: folds 
Uncalled bet (459) returned to color_singleton
color_singleton collected 919 from pot
color_singleton: doesn't show hand 
*** SUMMARY ***
Total pot 972 | Rake 53 
Board [Th 4s 5d Jc]
Seat 1: color_singleton collected (919)
Seat 2: dockstarr (button) folded on the Turn
Seat 3: PokerStarsMan12 (small blind) folded on the Flop
Seat 5: manon327 (big blind) folded on the Flop
Seat 6: HighCardJasper folded on the Flop



PokerStars Home Game Hand #229539994548: {DaPokaStars}  Hold'em No Limit (50/100) - 2021/09/02 15:50:11 ET
Table 'summer poker' 9-max (Play Money) Seat #3 is the button
Seat 1: color_singleton (16682 in chips) 
Seat 2: dockstarr (5248 in chips) 
Seat 3: PokerStarsMan12 (7132 in chips) 
Seat 5: manon327 (9900 in chips) 
Seat 6: HighCardJasper (8744 in chips) 
manon327: posts small blind 50
HighCardJasper: posts big blind 100
*** HOLE CARDS ***
Dealt to PokerStarsMan12 [7d Qh]
color_singleton: folds 
dockstarr: folds 
PokerStarsMan12: folds 
manon327: calls 50
HighCardJasper: checks 
*** FLOP *** [6c 2d 4d]
manon327: bets 100
HighCardJasper: calls 100
*** TURN *** [6c 2d 4d] [Qd]
manon327: checks 
HighCardJasper: checks 
*** RIVER *** [6c 2d 4d Qd] [4c]
manon327: bets 189
HighCardJasper: folds 
Uncalled bet (189) returned to manon327
manon327 collected 378 from pot
*** SUMMARY ***
Total pot 400 | Rake 22 
Board [6c 2d 4d Qd 4c]
Seat 1: color_singleton folded before Flop (didn't bet)
Seat 2: dockstarr folded before Flop (didn't bet)
Seat 3: PokerStarsMan12 (button) folded before Flop (didn't bet)
Seat 5: manon327 (small blind) collected (378)
Seat 6: HighCardJasper (big blind) folded on the River



PokerStars Home Game Hand #229540013661: {DaPokaStars}  Hold'em No Limit (50/100) - 2021/09/02 15:50:49 ET
Table 'summer poker' 9-max (Play Money) Seat #5 is the button
Seat 1: color_singleton (16682 in chips) 
Seat 2: dockstarr (5248 in chips) 
Seat 3: PokerStarsMan12 (7132 in chips) 
Seat 5: manon327 (10078 in chips) 
Seat 6: HighCardJasper (8544 in chips) 
HighCardJasper: posts small blind 50
color_singleton: posts big blind 100
*** HOLE CARDS ***
Dealt to PokerStarsMan12 [3s Th]
dockstarr: calls 100
PokerStarsMan12: folds 
manon327: folds 
HighCardJasper: calls 50
color_singleton: raises 200 to 300
dockstarr: calls 200
HighCardJasper: calls 200
*** FLOP *** [3c As Qc]
HighCardJasper: checks 
color_singleton: bets 425
dockstarr: folds 
HighCardJasper: folds 
Uncalled bet (425) returned to color_singleton
color_singleton collected 850 from pot
color_singleton: doesn't show hand 
*** SUMMARY ***
Total pot 900 | Rake 50 
Board [3c As Qc]
Seat 1: color_singleton (big blind) collected (850)
Seat 2: dockstarr folded on the Flop
Seat 3: PokerStarsMan12 folded before Flop (didn't bet)
Seat 5: manon327 (button) folded before Flop (didn't bet)
Seat 6: HighCardJasper (small blind) folded on the Flop



PokerStars Home Game Hand #229540036063: {DaPokaStars}  Hold'em No Limit (50/100) - 2021/09/02 15:51:33 ET
Table 'summer poker' 9-max (Play Money) Seat #6 is the button
Seat 1: color_singleton (17232 in chips) 
Seat 2: dockstarr (4948 in chips) 
Seat 3: PokerStarsMan12 (7132 in chips) 
Seat 5: manon327 (10078 in chips) 
Seat 6: HighCardJasper (8244 in chips) 
color_singleton: posts small blind 50
dockstarr: posts big blind 100
*** HOLE CARDS ***
Dealt to PokerStarsMan12 [9s 6c]
PokerStarsMan12: folds 
manon327: calls 100
HighCardJasper: calls 100
color_singleton: calls 50
dockstarr: checks 
*** FLOP *** [Jh Qs 4d]
color_singleton: bets 189
dockstarr: calls 189
manon327: folds 
HighCardJasper: calls 189
*** TURN *** [Jh Qs 4d] [7d]
color_singleton: checks 
dockstarr: bets 100
HighCardJasper: calls 100
color_singleton: calls 100
*** RIVER *** [Jh Qs 4d 7d] [Tc]
color_singleton: checks 
dockstarr: checks 
HighCardJasper: checks 
*** SHOW DOWN ***
color_singleton: shows [Js 2d] (a pair of Jacks)
dockstarr: shows [Qh 8c] (a pair of Queens)
HighCardJasper: mucks hand 
dockstarr collected 1197 from pot
*** SUMMARY ***
Total pot 1267 | Rake 70 
Board [Jh Qs 4d 7d Tc]
Seat 1: color_singleton (small blind) showed [Js 2d] and lost with a pair of Jacks
Seat 2: dockstarr (big blind) showed [Qh 8c] and won (1197) with a pair of Queens
Seat 3: PokerStarsMan12 folded before Flop (didn't bet)
Seat 5: manon327 folded on the Flop
Seat 6: HighCardJasper (button) mucked [2h 2c]



PokerStars Home Game Hand #229540059003: {DaPokaStars}  Hold'em No Limit (50/100) - 2021/09/02 15:52:19 ET
Table 'summer poker' 9-max (Play Money) Seat #1 is the button
Seat 1: color_singleton (16843 in chips) 
Seat 2: dockstarr (5756 in chips) 
Seat 3: PokerStarsMan12 (7132 in chips) 
Seat 5: manon327 (9978 in chips) 
Seat 6: HighCardJasper (7855 in chips) 
dockstarr: posts small blind 50
PokerStarsMan12: posts big blind 100
*** HOLE CARDS ***
Dealt to PokerStarsMan12 [8s Qd]
manon327: calls 100
HighCardJasper: calls 100
color_singleton: folds 
dockstarr: calls 50
PokerStarsMan12: checks 
*** FLOP *** [Kh 6s 3d]
dockstarr: checks 
PokerStarsMan12: checks 
manon327: bets 100
HighCardJasper: calls 100
dockstarr: folds 
PokerStarsMan12: folds 
*** TURN *** [Kh 6s 3d] [Js]
manon327: bets 283
HighCardJasper: calls 283
*** RIVER *** [Kh 6s 3d Js] [2d]
manon327: bets 1102
HighCardJasper: calls 1102
*** SHOW DOWN ***
manon327: shows [Ks 3h] (two pair, Kings and Threes)
HighCardJasper: mucks hand 
manon327 collected 3185 from pot
*** SUMMARY ***
Total pot 3370 | Rake 185 
Board [Kh 6s 3d Js 2d]
Seat 1: color_singleton (button) folded before Flop (didn't bet)
Seat 2: dockstarr (small blind) folded on the Flop
Seat 3: PokerStarsMan12 (big blind) folded on the Flop
Seat 5: manon327 showed [Ks 3h] and won (3185) with two pair, Kings and Threes
Seat 6: HighCardJasper mucked [2s Kd]



PokerStars Home Game Hand #229540085189: {DaPokaStars}  Hold'em No Limit (50/100) - 2021/09/02 15:53:11 ET
Table 'summer poker' 9-max (Play Money) Seat #2 is the button
Seat 1: color_singleton (16843 in chips) 
Seat 2: dockstarr (5656 in chips) 
Seat 3: PokerStarsMan12 (7032 in chips) 
Seat 5: manon327 (11578 in chips) 
Seat 6: HighCardJasper (6270 in chips) 
PokerStarsMan12: posts small blind 50
manon327: posts big blind 100
*** HOLE CARDS ***
Dealt to PokerStarsMan12 [Ac 3d]
HighCardJasper: calls 100
color_singleton: folds 
dockstarr: calls 100
PokerStarsMan12: calls 50
manon327: checks 
*** FLOP *** [4h 6h Ad]
PokerStarsMan12: bets 200
manon327: folds 
HighCardJasper: calls 200
dockstarr: folds 
*** TURN *** [4h 6h Ad] [2h]
PokerStarsMan12: bets 378
HighCardJasper: folds 
Uncalled bet (378) returned to PokerStarsMan12
PokerStarsMan12 collected 756 from pot
*** SUMMARY ***
Total pot 800 | Rake 44 
Board [4h 6h Ad 2h]
Seat 1: color_singleton folded before Flop (didn't bet)
Seat 2: dockstarr (button) folded on the Flop
Seat 3: PokerStarsMan12 (small blind) collected (756)
Seat 5: manon327 (big blind) folded on the Flop
Seat 6: HighCardJasper folded on the Turn



PokerStars Home Game Hand #229540118237: {DaPokaStars}  Hold'em No Limit (50/100) - 2021/09/02 15:54:04 ET
Table 'summer poker' 9-max (Play Money) Seat #3 is the button
Seat 1: color_singleton (16843 in chips) 
Seat 2: dockstarr (5556 in chips) 
Seat 3: PokerStarsMan12 (7488 in chips) 
Seat 5: manon327 (11478 in chips) 
Seat 6: HighCardJasper (5970 in chips) 
manon327: posts small blind 50
HighCardJasper: posts big blind 100
*** HOLE CARDS ***
Dealt to PokerStarsMan12 [7s Js]
color_singleton: raises 200 to 300
dockstarr: folds 
PokerStarsMan12: calls 300
manon327: folds 
HighCardJasper: folds 
*** FLOP *** [8s Ks Ac]
color_singleton: checks 
PokerStarsMan12: bets 400
color_singleton: folds 
Uncalled bet (400) returned to PokerStarsMan12
PokerStarsMan12 collected 709 from pot
*** SUMMARY ***
Total pot 750 | Rake 41 
Board [8s Ks Ac]
Seat 1: color_singleton folded on the Flop
Seat 2: dockstarr folded before Flop (didn't bet)
Seat 3: PokerStarsMan12 (button) collected (709)
Seat 5: manon327 (small blind) folded before Flop
Seat 6: HighCardJasper (big blind) folded before Flop



PokerStars Home Game Hand #229540138022: {DaPokaStars}  Hold'em No Limit (50/100) - 2021/09/02 15:54:44 ET
Table 'summer poker' 9-max (Play Money) Seat #5 is the button
Seat 1: color_singleton (16543 in chips) 
Seat 2: dockstarr (5556 in chips) 
Seat 3: PokerStarsMan12 (7897 in chips) 
Seat 5: manon327 (11428 in chips) 
Seat 6: HighCardJasper (5870 in chips) 
HighCardJasper: posts small blind 50
color_singleton: posts big blind 100
*** HOLE CARDS ***
Dealt to PokerStarsMan12 [Qh Qd]
dockstarr: folds 
PokerStarsMan12: raises 300 to 400
manon327: calls 400
HighCardJasper: folds 
color_singleton: calls 300
*** FLOP *** [Jh Tc 9h]
color_singleton: bets 590
PokerStarsMan12: raises 1110 to 1700
manon327: folds 
color_singleton: folds 
Uncalled bet (1110) returned to PokerStarsMan12
PokerStarsMan12 collected 2296 from pot
*** SUMMARY ***
Total pot 2430 | Rake 134 
Board [Jh Tc 9h]
Seat 1: color_singleton (big blind) folded on the Flop
Seat 2: dockstarr folded before Flop (didn't bet)
Seat 3: PokerStarsMan12 collected (2296)
Seat 5: manon327 (button) folded on the Flop
Seat 6: HighCardJasper (small blind) folded before Flop



PokerStars Home Game Hand #229540158208: {DaPokaStars}  Hold'em No Limit (50/100) - 2021/09/02 15:55:33 ET
Table 'summer poker' 9-max (Play Money) Seat #6 is the button
Seat 1: color_singleton (15553 in chips) 
Seat 2: dockstarr (5556 in chips) 
Seat 3: PokerStarsMan12 (9203 in chips) 
Seat 5: manon327 (11028 in chips) 
Seat 6: HighCardJasper (5820 in chips) 
color_singleton: posts small blind 50
dockstarr: posts big blind 100
*** HOLE CARDS ***
Dealt to PokerStarsMan12 [4c 9c]
PokerStarsMan12: folds 
manon327: calls 100
HighCardJasper: folds 
color_singleton: calls 50
dockstarr: checks 
*** FLOP *** [As Jc 3h]
color_singleton: bets 141
dockstarr: folds 
manon327: calls 141
*** TURN *** [As Jc 3h] [Tc]
color_singleton: bets 275
manon327: folds 
Uncalled bet (275) returned to color_singleton
color_singleton collected 550 from pot
color_singleton: doesn't show hand 
*** SUMMARY ***
Total pot 582 | Rake 32 
Board [As Jc 3h Tc]
Seat 1: color_singleton (small blind) collected (550)
Seat 2: dockstarr (big blind) folded on the Flop
Seat 3: PokerStarsMan12 folded before Flop (didn't bet)
Seat 5: manon327 folded on the Turn
Seat 6: HighCardJasper (button) folded before Flop (didn't bet)



PokerStars Home Game Hand #229540182625: {DaPokaStars}  Hold'em No Limit (50/100) - 2021/09/02 15:56:16 ET
Table 'summer poker' 9-max (Play Money) Seat #1 is the button
Seat 1: color_singleton (15862 in chips) 
Seat 2: dockstarr (5456 in chips) 
Seat 3: PokerStarsMan12 (9203 in chips) 
Seat 5: manon327 (10787 in chips) 
Seat 6: HighCardJasper (5820 in chips) 
dockstarr: posts small blind 50
PokerStarsMan12: posts big blind 100
*** HOLE CARDS ***
Dealt to PokerStarsMan12 [Js 6s]
manon327: folds 
HighCardJasper: calls 100
color_singleton: raises 200 to 300
dockstarr: folds 
PokerStarsMan12: calls 200
HighCardJasper: calls 200
*** FLOP *** [Kd 9s 2d]
PokerStarsMan12: checks 
HighCardJasper: checks 
color_singleton: checks 
*** TURN *** [Kd 9s 2d] [3c]
PokerStarsMan12: checks 
HighCardJasper: checks 
color_singleton: checks 
*** RIVER *** [Kd 9s 2d 3c] [9c]
PokerStarsMan12: checks 
HighCardJasper: checks 
color_singleton: bets 700
PokerStarsMan12: folds 
HighCardJasper: folds 
Uncalled bet (700) returned to color_singleton
color_singleton collected 898 from pot
color_singleton: doesn't show hand 
*** SUMMARY ***
Total pot 950 | Rake 52 
Board [Kd 9s 2d 3c 9c]
Seat 1: color_singleton (button) collected (898)
Seat 2: dockstarr (small blind) folded before Flop
Seat 3: PokerStarsMan12 (big blind) folded on the River
Seat 5: manon327 folded before Flop (didn't bet)
Seat 6: HighCardJasper folded on the River



PokerStars Home Game Hand #229540202762: {DaPokaStars}  Hold'em No Limit (50/100) - 2021/09/02 15:57:14 ET
Table 'summer poker' 9-max (Play Money) Seat #3 is the button
Seat 1: color_singleton (16460 in chips) 
Seat 3: PokerStarsMan12 (8903 in chips) 
Seat 5: manon327 (10787 in chips) 
Seat 6: HighCardJasper (5520 in chips) 
manon327: posts small blind 50
HighCardJasper: posts big blind 100
*** HOLE CARDS ***
Dealt to PokerStarsMan12 [Kc Kh]
color_singleton: folds 
PokerStarsMan12: raises 300 to 400
manon327: folds 
HighCardJasper: folds 
Uncalled bet (300) returned to PokerStarsMan12
PokerStarsMan12 collected 250 from pot
*** SUMMARY ***
Total pot 250 | Rake 0 
Seat 1: color_singleton folded before Flop (didn't bet)
Seat 3: PokerStarsMan12 (button) collected (250)
Seat 5: manon327 (small blind) folded before Flop
Seat 6: HighCardJasper (big blind) folded before Flop



PokerStars Home Game Hand #229540210442: {DaPokaStars}  Hold'em No Limit (50/100) - 2021/09/02 15:57:36 ET
Table 'summer poker' 9-max (Play Money) Seat #5 is the button
Seat 1: color_singleton (16460 in chips) 
Seat 3: PokerStarsMan12 (9053 in chips) 
Seat 5: manon327 (10737 in chips) 
Seat 6: HighCardJasper (5420 in chips) 
HighCardJasper: posts small blind 50
color_singleton: posts big blind 100
*** HOLE CARDS ***
Dealt to PokerStarsMan12 [Ah 8s]
PokerStarsMan12: raises 200 to 300
manon327: folds 
HighCardJasper: folds 
color_singleton: calls 200
*** FLOP *** [5h Qc 7h]
color_singleton: checks 
PokerStarsMan12: checks 
*** TURN *** [5h Qc 7h] [Td]
color_singleton: checks 
PokerStarsMan12: bets 300
color_singleton: folds 
Uncalled bet (300) returned to PokerStarsMan12
PokerStarsMan12 collected 614 from pot
*** SUMMARY ***
Total pot 650 | Rake 36 
Board [5h Qc 7h Td]
Seat 1: color_singleton (big blind) folded on the Turn
Seat 3: PokerStarsMan12 collected (614)
Seat 5: manon327 (button) folded before Flop (didn't bet)
Seat 6: HighCardJasper (small blind) folded before Flop



PokerStars Home Game Hand #229540222946: {DaPokaStars}  Hold'em No Limit (50/100) - 2021/09/02 15:58:11 ET
Table 'summer poker' 9-max (Play Money) Seat #6 is the button
Seat 1: color_singleton (16160 in chips) 
Seat 2: dockstarr (5406 in chips) 
Seat 3: PokerStarsMan12 (9367 in chips) 
Seat 5: manon327 (10737 in chips) 
Seat 6: HighCardJasper (5370 in chips) 
color_singleton: posts small blind 50
dockstarr: posts big blind 100
*** HOLE CARDS ***
Dealt to PokerStarsMan12 [5h 2c]
PokerStarsMan12: folds 
manon327: folds 
HighCardJasper: calls 100
color_singleton: raises 200 to 300
dockstarr: calls 200
HighCardJasper: folds 
*** FLOP *** [Kh Ts 3c]
color_singleton: bets 330
dockstarr: calls 330
*** TURN *** [Kh Ts 3c] [Th]
color_singleton: checks 
dockstarr: checks 
*** RIVER *** [Kh Ts 3c Th] [7c]
color_singleton: checks 
dockstarr: checks 
*** SHOW DOWN ***
color_singleton: shows [Ah 7s] (two pair, Tens and Sevens)
dockstarr: mucks hand 
color_singleton collected 1285 from pot
*** SUMMARY ***
Total pot 1360 | Rake 75 
Board [Kh Ts 3c Th 7c]
Seat 1: color_singleton (small blind) showed [Ah 7s] and won (1285) with two pair, Tens and Sevens
Seat 2: dockstarr (big blind) mucked [Qc Jd]
Seat 3: PokerStarsMan12 folded before Flop (didn't bet)
Seat 5: manon327 folded before Flop (didn't bet)
Seat 6: HighCardJasper (button) folded before Flop



PokerStars Home Game Hand #229540236237: {DaPokaStars}  Hold'em No Limit (50/100) - 2021/09/02 15:58:48 ET
Table 'summer poker' 9-max (Play Money) Seat #1 is the button
Seat 1: color_singleton (16815 in chips) 
Seat 2: dockstarr (4776 in chips) 
Seat 3: PokerStarsMan12 (9367 in chips) 
Seat 5: manon327 (10737 in chips) 
Seat 6: HighCardJasper (5270 in chips) 
dockstarr: posts small blind 50
PokerStarsMan12: posts big blind 100
*** HOLE CARDS ***
Dealt to PokerStarsMan12 [9s Ts]
manon327: folds 
HighCardJasper: folds 
color_singleton: raises 200 to 300
dockstarr: folds 
PokerStarsMan12: calls 200
*** FLOP *** [Tc 6c 5s]
PokerStarsMan12: bets 400
color_singleton: calls 400
*** TURN *** [Tc 6c 5s] [Ac]
PokerStarsMan12: checks 
color_singleton: checks 
*** RIVER *** [Tc 6c 5s Ac] [5c]
PokerStarsMan12: checks 
color_singleton: checks 
*** SHOW DOWN ***
PokerStarsMan12: shows [9s Ts] (two pair, Tens and Fives)
color_singleton: mucks hand 
PokerStarsMan12 collected 1370 from pot
*** SUMMARY ***
Total pot 1450 | Rake 80 
Board [Tc 6c 5s Ac 5c]
Seat 1: color_singleton (button) mucked [7d 6d]
Seat 2: dockstarr (small blind) folded before Flop
Seat 3: PokerStarsMan12 (big blind) showed [9s Ts] and won (1370) with two pair, Tens and Fives
Seat 5: manon327 folded before Flop (didn't bet)
Seat 6: HighCardJasper folded before Flop (didn't bet)



PokerStars Home Game Hand #229540253159: {DaPokaStars}  Hold'em No Limit (50/100) - 2021/09/02 15:59:37 ET
Table 'summer poker' 9-max (Play Money) Seat #2 is the button
Seat 1: color_singleton (16115 in chips) 
Seat 2: dockstarr (4726 in chips) 
Seat 3: PokerStarsMan12 (10037 in chips) 
Seat 5: manon327 (10737 in chips) 
Seat 6: HighCardJasper (5270 in chips) 
PokerStarsMan12: posts small blind 50
manon327: posts big blind 100
*** HOLE CARDS ***
Dealt to PokerStarsMan12 [2h 6s]
HighCardJasper: folds 
color_singleton: calls 100
dockstarr: calls 100
PokerStarsMan12: calls 50
manon327: checks 
*** FLOP *** [8d 2c As]
PokerStarsMan12: checks 
manon327: checks 
color_singleton: bets 189
dockstarr: calls 189
PokerStarsMan12: calls 189
manon327: folds 
*** TURN *** [8d 2c As] [Ks]
PokerStarsMan12: checks 
color_singleton: checks 
dockstarr: checks 
*** RIVER *** [8d 2c As Ks] [8s]
PokerStarsMan12: checks 
color_singleton: bets 914
dockstarr: folds 
PokerStarsMan12: folds 
Uncalled bet (914) returned to color_singleton
color_singleton collected 914 from pot
color_singleton: doesn't show hand 
*** SUMMARY ***
Total pot 967 | Rake 53 
Board [8d 2c As Ks 8s]
Seat 1: color_singleton collected (914)
Seat 2: dockstarr (button) folded on the River
Seat 3: PokerStarsMan12 (small blind) folded on the River
Seat 5: manon327 (big blind) folded on the Flop
Seat 6: HighCardJasper folded before Flop (didn't bet)



PokerStars Home Game Hand #229540281143: {DaPokaStars}  Hold'em No Limit (50/100) - 2021/09/02 16:00:52 ET
Table 'summer poker' 9-max (Play Money) Seat #3 is the button
Seat 1: color_singleton (16740 in chips) 
Seat 2: dockstarr (4437 in chips) 
Seat 3: PokerStarsMan12 (9748 in chips) 
Seat 5: manon327 (10637 in chips) 
Seat 6: HighCardJasper (5270 in chips) 
manon327: posts small blind 50
HighCardJasper: posts big blind 100
*** HOLE CARDS ***
Dealt to PokerStarsMan12 [2d Kh]
color_singleton: folds 
dockstarr: folds 
PokerStarsMan12: folds 
manon327: folds 
Uncalled bet (50) returned to HighCardJasper
HighCardJasper collected 100 from pot
HighCardJasper: doesn't show hand 
*** SUMMARY ***
Total pot 100 | Rake 0 
Seat 1: color_singleton folded before Flop (didn't bet)
Seat 2: dockstarr folded before Flop (didn't bet)
Seat 3: PokerStarsMan12 (button) folded before Flop (didn't bet)
Seat 5: manon327 (small blind) folded before Flop
Seat 6: HighCardJasper (big blind) collected (100)



PokerStars Home Game Hand #229540284973: {DaPokaStars}  Hold'em No Limit (50/100) - 2021/09/02 16:01:01 ET
Table 'summer poker' 9-max (Play Money) Seat #5 is the button
Seat 1: color_singleton (16740 in chips) 
Seat 2: dockstarr (4437 in chips) 
Seat 3: PokerStarsMan12 (9748 in chips) 
Seat 5: manon327 (10587 in chips) 
Seat 6: HighCardJasper (5320 in chips) 
HighCardJasper: posts small blind 50
color_singleton: posts big blind 100
*** HOLE CARDS ***
Dealt to PokerStarsMan12 [9s 5h]
dockstarr: calls 100
PokerStarsMan12: folds 
manon327: folds 
HighCardJasper: calls 50
color_singleton: checks 
*** FLOP *** [5d 3c 6s]
HighCardJasper: checks 
color_singleton: bets 141
dockstarr: calls 141
HighCardJasper: calls 141
*** TURN *** [5d 3c 6s] [Kh]
HighCardJasper: checks 
color_singleton: checks 
dockstarr: checks 
*** RIVER *** [5d 3c 6s Kh] [Jd]
HighCardJasper: bets 341
color_singleton: raises 341 to 682
dockstarr: folds 
HighCardJasper: calls 341
*** SHOW DOWN ***
color_singleton: shows [5s Js] (two pair, Jacks and Fives)
HighCardJasper: mucks hand 
color_singleton collected 1972 from pot
*** SUMMARY ***
Total pot 2087 | Rake 115 
Board [5d 3c 6s Kh Jd]
Seat 1: color_singleton (big blind) showed [5s Js] and won (1972) with two pair, Jacks and Fives
Seat 2: dockstarr folded on the River
Seat 3: PokerStarsMan12 folded before Flop (didn't bet)
Seat 5: manon327 (button) folded before Flop (didn't bet)
Seat 6: HighCardJasper (small blind) mucked [Jc 3s]



PokerStars Home Game Hand #229540308791: {DaPokaStars}  Hold'em No Limit (50/100) - 2021/09/02 16:01:54 ET
Table 'summer poker' 9-max (Play Money) Seat #6 is the button
Seat 1: color_singleton (17789 in chips) 
Seat 2: dockstarr (4196 in chips) 
Seat 3: PokerStarsMan12 (9748 in chips) 
Seat 5: manon327 (10587 in chips) 
Seat 6: HighCardJasper (4397 in chips) 
color_singleton: posts small blind 50
dockstarr: posts big blind 100
*** HOLE CARDS ***
Dealt to PokerStarsMan12 [Th Td]
PokerStarsMan12: raises 300 to 400
manon327: folds 
HighCardJasper: calls 400
color_singleton: calls 350
dockstarr: folds 
*** FLOP *** [4d 3s 5c]
color_singleton: checks 
PokerStarsMan12: bets 700
HighCardJasper: folds 
color_singleton: folds 
Uncalled bet (700) returned to PokerStarsMan12
PokerStarsMan12 collected 1228 from pot
*** SUMMARY ***
Total pot 1300 | Rake 72 
Board [4d 3s 5c]
Seat 1: color_singleton (small blind) folded on the Flop
Seat 2: dockstarr (big blind) folded before Flop
Seat 3: PokerStarsMan12 collected (1228)
Seat 5: manon327 folded before Flop (didn't bet)
Seat 6: HighCardJasper (button) folded on the Flop



PokerStars Home Game Hand #229540322730: {DaPokaStars}  Hold'em No Limit (50/100) - 2021/09/02 16:02:23 ET
Table 'summer poker' 9-max (Play Money) Seat #1 is the button
Seat 1: color_singleton (17389 in chips) 
Seat 2: dockstarr (4096 in chips) 
Seat 3: PokerStarsMan12 (10576 in chips) 
Seat 5: manon327 (10587 in chips) 
Seat 6: HighCardJasper (3997 in chips) 
dockstarr: posts small blind 50
PokerStarsMan12: posts big blind 100
*** HOLE CARDS ***
Dealt to PokerStarsMan12 [Jc As]
manon327: calls 100
HighCardJasper: calls 100
color_singleton: calls 100
dockstarr: calls 50
PokerStarsMan12: raises 300 to 400
manon327: calls 300
HighCardJasper: calls 300
color_singleton: calls 300
dockstarr: calls 300
*** FLOP *** [7d 8d 3h]
dockstarr has timed out
dockstarr: checks 
PokerStarsMan12: checks 
manon327: checks 
HighCardJasper: checks 
color_singleton: checks 
*** TURN *** [7d 8d 3h] [4s]
dockstarr: checks 
PokerStarsMan12: checks 
manon327: checks 
HighCardJasper: checks 
color_singleton: checks 
*** RIVER *** [7d 8d 3h 4s] [7s]
dockstarr: checks 
PokerStarsMan12: checks 
manon327: checks 
HighCardJasper: bets 300
color_singleton: folds 
dockstarr: folds 
PokerStarsMan12: folds 
manon327: folds 
Uncalled bet (300) returned to HighCardJasper
HighCardJasper collected 1890 from pot
HighCardJasper: doesn't show hand 
*** SUMMARY ***
Total pot 2000 | Rake 110 
Board [7d 8d 3h 4s 7s]
Seat 1: color_singleton (button) folded on the River
Seat 2: dockstarr (small blind) folded on the River
Seat 3: PokerStarsMan12 (big blind) folded on the River
Seat 5: manon327 folded on the River
Seat 6: HighCardJasper collected (1890)



PokerStars Home Game Hand #229540379186: {DaPokaStars}  Hold'em No Limit (50/100) - 2021/09/02 16:04:18 ET
Table 'summer poker' 9-max (Play Money) Seat #2 is the button
Seat 1: color_singleton (16989 in chips) 
Seat 2: dockstarr (3696 in chips) 
Seat 3: PokerStarsMan12 (10176 in chips) 
Seat 5: manon327 (10187 in chips) 
Seat 6: HighCardJasper (5487 in chips) 
PokerStarsMan12: posts small blind 50
manon327: posts big blind 100
*** HOLE CARDS ***
Dealt to PokerStarsMan12 [5d Kc]
HighCardJasper: calls 100
color_singleton: folds 
dockstarr: calls 100
PokerStarsMan12: calls 50
manon327: checks 
*** FLOP *** [9s 2d Qc]
PokerStarsMan12: checks 
manon327: checks 
HighCardJasper: checks 
dockstarr: checks 
*** TURN *** [9s 2d Qc] [Ks]
PokerStarsMan12: bets 200
manon327: folds 
HighCardJasper: calls 200
dockstarr: calls 200
*** RIVER *** [9s 2d Qc Ks] [Td]
PokerStarsMan12: bets 400
HighCardJasper: raises 400 to 800
dockstarr: folds 
PokerStarsMan12: folds 
Uncalled bet (400) returned to HighCardJasper
HighCardJasper collected 1701 from pot
HighCardJasper: doesn't show hand 
*** SUMMARY ***
Total pot 1800 | Rake 99 
Board [9s 2d Qc Ks Td]
Seat 1: color_singleton folded before Flop (didn't bet)
Seat 2: dockstarr (button) folded on the River
Seat 3: PokerStarsMan12 (small blind) folded on the River
Seat 5: manon327 (big blind) folded on the Turn
Seat 6: HighCardJasper collected (1701)



PokerStars Home Game Hand #229540418455: {DaPokaStars}  Hold'em No Limit (50/100) - 2021/09/02 16:05:36 ET
Table 'summer poker' 9-max (Play Money) Seat #3 is the button
Seat 1: color_singleton (16989 in chips) 
Seat 2: dockstarr (3396 in chips) 
Seat 3: PokerStarsMan12 (9476 in chips) 
Seat 5: manon327 (10087 in chips) 
Seat 6: HighCardJasper (6488 in chips) 
manon327: posts small blind 50
HighCardJasper: posts big blind 100
*** HOLE CARDS ***
Dealt to PokerStarsMan12 [Qd Ks]
color_singleton has timed out
color_singleton: folds 
dockstarr: folds 
PokerStarsMan12: raises 200 to 300
manon327: folds 
HighCardJasper: folds 
Uncalled bet (200) returned to PokerStarsMan12
PokerStarsMan12 collected 250 from pot
*** SUMMARY ***
Total pot 250 | Rake 0 
Seat 1: color_singleton folded before Flop (didn't bet)
Seat 2: dockstarr folded before Flop (didn't bet)
Seat 3: PokerStarsMan12 (button) collected (250)
Seat 5: manon327 (small blind) folded before Flop
Seat 6: HighCardJasper (big blind) folded before Flop



PokerStars Home Game Hand #229540435578: {DaPokaStars}  Hold'em No Limit (50/100) - 2021/09/02 16:06:10 ET
Table 'summer poker' 9-max (Play Money) Seat #5 is the button
Seat 1: color_singleton (16989 in chips) 
Seat 2: dockstarr (3396 in chips) 
Seat 3: PokerStarsMan12 (9626 in chips) 
Seat 5: manon327 (10037 in chips) 
Seat 6: HighCardJasper (6388 in chips) 
HighCardJasper: posts small blind 50
color_singleton: posts big blind 100
*** HOLE CARDS ***
Dealt to PokerStarsMan12 [Kc 3d]
dockstarr: folds 
PokerStarsMan12: folds 
manon327: calls 100
HighCardJasper: calls 50
color_singleton: checks 
*** FLOP *** [3s 6s Td]
HighCardJasper: bets 141
color_singleton: folds 
manon327: calls 141
*** TURN *** [3s 6s Td] [Kh]
HighCardJasper: checks 
manon327: checks 
*** RIVER *** [3s 6s Td Kh] [Tc]
HighCardJasper: checks 
manon327: checks 
*** SHOW DOWN ***
HighCardJasper: shows [Qs As] (a pair of Tens)
manon327: mucks hand 
HighCardJasper collected 550 from pot
*** SUMMARY ***
Total pot 582 | Rake 32 
Board [3s 6s Td Kh Tc]
Seat 1: color_singleton (big blind) folded on the Flop
Seat 2: dockstarr folded before Flop (didn't bet)
Seat 3: PokerStarsMan12 folded before Flop (didn't bet)
Seat 5: manon327 (button) mucked [4d 2d]
Seat 6: HighCardJasper (small blind) showed [Qs As] and won (550) with a pair of Tens



PokerStars Home Game Hand #229540460086: {DaPokaStars}  Hold'em No Limit (50/100) - 2021/09/02 16:06:59 ET
Table 'summer poker' 9-max (Play Money) Seat #6 is the button
Seat 1: color_singleton (16889 in chips) 
Seat 2: dockstarr (3396 in chips) 
Seat 3: PokerStarsMan12 (9626 in chips) 
Seat 5: manon327 (9796 in chips) 
Seat 6: HighCardJasper (6697 in chips) 
color_singleton: posts small blind 50
dockstarr: posts big blind 100
*** HOLE CARDS ***
Dealt to PokerStarsMan12 [9d Jd]
PokerStarsMan12: calls 100
manon327: calls 100
HighCardJasper: calls 100
color_singleton: calls 50
dockstarr: checks 
*** FLOP *** [9h Ts 2h]
color_singleton: checks 
dockstarr: checks 
PokerStarsMan12: bets 200
manon327: calls 200
HighCardJasper: folds 
color_singleton: calls 200
dockstarr: folds 
*** TURN *** [9h Ts 2h] [7c]
color_singleton: checks 
PokerStarsMan12: checks 
manon327: checks 
*** RIVER *** [9h Ts 2h 7c] [Qs]
color_singleton: checks 
PokerStarsMan12: checks 
manon327: bets 1039
color_singleton: folds 
PokerStarsMan12: folds 
Uncalled bet (1039) returned to manon327
manon327 collected 1039 from pot
*** SUMMARY ***
Total pot 1100 | Rake 61 
Board [9h Ts 2h 7c Qs]
Seat 1: color_singleton (small blind) folded on the River
Seat 2: dockstarr (big blind) folded on the Flop
Seat 3: PokerStarsMan12 folded on the River
Seat 5: manon327 collected (1039)
Seat 6: HighCardJasper (button) folded on the Flop



PokerStars Home Game Hand #229540498790: {DaPokaStars}  Hold'em No Limit (50/100) - 2021/09/02 16:08:17 ET
Table 'summer poker' 9-max (Play Money) Seat #1 is the button
Seat 1: color_singleton (16589 in chips) 
Seat 2: dockstarr (3296 in chips) 
Seat 3: PokerStarsMan12 (9326 in chips) 
Seat 5: manon327 (10535 in chips) 
Seat 6: HighCardJasper (6597 in chips) 
dockstarr: posts small blind 50
PokerStarsMan12: posts big blind 100
*** HOLE CARDS ***
Dealt to PokerStarsMan12 [7s 3d]
manon327: calls 100
HighCardJasper: folds 
color_singleton: folds 
dockstarr: folds 
PokerStarsMan12: checks 
*** FLOP *** [Jh 2c 8h]
PokerStarsMan12: checks 
manon327: checks 
*** TURN *** [Jh 2c 8h] [9s]
PokerStarsMan12: checks 
manon327: checks 
*** RIVER *** [Jh 2c 8h 9s] [2d]
PokerStarsMan12: checks 
manon327: bets 236
PokerStarsMan12: folds 
Uncalled bet (236) returned to manon327
manon327 collected 236 from pot
*** SUMMARY ***
Total pot 250 | Rake 14 
Board [Jh 2c 8h 9s 2d]
Seat 1: color_singleton (button) folded before Flop (didn't bet)
Seat 2: dockstarr (small blind) folded before Flop
Seat 3: PokerStarsMan12 (big blind) folded on the River
Seat 5: manon327 collected (236)
Seat 6: HighCardJasper folded before Flop (didn't bet)



PokerStars Home Game Hand #229540517532: {DaPokaStars}  Hold'em No Limit (50/100) - 2021/09/02 16:08:55 ET
Table 'summer poker' 9-max (Play Money) Seat #2 is the button
Seat 1: color_singleton (16589 in chips) 
Seat 2: dockstarr (3246 in chips) 
Seat 3: PokerStarsMan12 (9226 in chips) 
Seat 5: manon327 (10671 in chips) 
Seat 6: HighCardJasper (6597 in chips) 
PokerStarsMan12: posts small blind 50
manon327: posts big blind 100
*** HOLE CARDS ***
Dealt to PokerStarsMan12 [2h 3h]
HighCardJasper: folds 
color_singleton: folds 
dockstarr: calls 100
PokerStarsMan12: calls 50
manon327: checks 
*** FLOP *** [9h 8h Qd]
PokerStarsMan12 has timed out
PokerStarsMan12: checks 
manon327: checks 
dockstarr: bets 100
PokerStarsMan12: raises 200 to 300
manon327: folds 
dockstarr: calls 200
*** TURN *** [9h 8h Qd] [Kc]
PokerStarsMan12: bets 400
dockstarr: calls 400
*** RIVER *** [9h 8h Qd Kc] [Qs]
PokerStarsMan12: bets 1000
dockstarr: calls 1000
*** SHOW DOWN ***
PokerStarsMan12: shows [2h 3h] (a pair of Queens)
dockstarr: shows [Kh 5h] (two pair, Kings and Queens)
dockstarr collected 3496 from pot
*** SUMMARY ***
Total pot 3700 | Rake 204 
Board [9h 8h Qd Kc Qs]
Seat 1: color_singleton folded before Flop (didn't bet)
Seat 2: dockstarr (button) showed [Kh 5h] and won (3496) with two pair, Kings and Queens
Seat 3: PokerStarsMan12 (small blind) showed [2h 3h] and lost with a pair of Queens
Seat 5: manon327 (big blind) folded on the Flop
Seat 6: HighCardJasper folded before Flop (didn't bet)



PokerStars Home Game Hand #229540550108: {DaPokaStars}  Hold'em No Limit (50/100) - 2021/09/02 16:10:00 ET
Table 'summer poker' 9-max (Play Money) Seat #3 is the button
Seat 1: color_singleton (16589 in chips) 
Seat 2: dockstarr (4942 in chips) 
Seat 3: PokerStarsMan12 (7426 in chips) 
Seat 5: manon327 (10571 in chips) 
Seat 6: HighCardJasper (6597 in chips) 
manon327: posts small blind 50
HighCardJasper: posts big blind 100
*** HOLE CARDS ***
Dealt to PokerStarsMan12 [6d Kh]
color_singleton: calls 100
dockstarr: folds 
PokerStarsMan12: calls 100
manon327: calls 50
HighCardJasper: raises 200 to 300
color_singleton: calls 200
PokerStarsMan12: calls 200
manon327: folds 
*** FLOP *** [3c Jh Tc]
HighCardJasper: bets 472
color_singleton: calls 472
PokerStarsMan12: folds 
*** TURN *** [3c Jh Tc] [Jc]
HighCardJasper: bets 918
color_singleton: folds 
Uncalled bet (918) returned to HighCardJasper
HighCardJasper collected 1837 from pot
HighCardJasper: doesn't show hand 
*** SUMMARY ***
Total pot 1944 | Rake 107 
Board [3c Jh Tc Jc]
Seat 1: color_singleton folded on the Turn
Seat 2: dockstarr folded before Flop (didn't bet)
Seat 3: PokerStarsMan12 (button) folded on the Flop
Seat 5: manon327 (small blind) folded before Flop
Seat 6: HighCardJasper (big blind) collected (1837)



PokerStars Home Game Hand #229540574720: {DaPokaStars}  Hold'em No Limit (50/100) - 2021/09/02 16:10:50 ET
Table 'summer poker' 9-max (Play Money) Seat #5 is the button
Seat 1: color_singleton (15817 in chips) 
Seat 2: dockstarr (4942 in chips) 
Seat 3: PokerStarsMan12 (7126 in chips) 
Seat 5: manon327 (10471 in chips) 
Seat 6: HighCardJasper (7662 in chips) 
HighCardJasper: posts small blind 50
color_singleton: posts big blind 100
*** HOLE CARDS ***
Dealt to PokerStarsMan12 [3d 3s]
dockstarr: calls 100
PokerStarsMan12: calls 100
manon327: folds 
HighCardJasper: calls 50
color_singleton: raises 300 to 400
dockstarr: calls 300
PokerStarsMan12: calls 300
HighCardJasper: calls 300
*** FLOP *** [Ks Qh 5d]
HighCardJasper: checks 
color_singleton: checks 
dockstarr: checks 
PokerStarsMan12: checks 
*** TURN *** [Ks Qh 5d] [8h]
HighCardJasper: checks 
color_singleton: bets 500
dockstarr: calls 500
PokerStarsMan12: folds 
HighCardJasper: folds 
*** RIVER *** [Ks Qh 5d 8h] [2d]
color_singleton: bets 1200
dockstarr: folds 
Uncalled bet (1200) returned to color_singleton
color_singleton collected 2457 from pot
color_singleton: doesn't show hand 
*** SUMMARY ***
Total pot 2600 | Rake 143 
Board [Ks Qh 5d 8h 2d]
Seat 1: color_singleton (big blind) collected (2457)
Seat 2: dockstarr folded on the River
Seat 3: PokerStarsMan12 folded on the Turn
Seat 5: manon327 (button) folded before Flop (didn't bet)
Seat 6: HighCardJasper (small blind) folded on the Turn



PokerStars Home Game Hand #229540614750: {DaPokaStars}  Hold'em No Limit (50/100) - 2021/09/02 16:12:11 ET
Table 'summer poker' 9-max (Play Money) Seat #6 is the button
Seat 1: color_singleton (17374 in chips) 
Seat 2: dockstarr (4042 in chips) 
Seat 3: PokerStarsMan12 (6726 in chips) 
Seat 5: manon327 (10471 in chips) 
Seat 6: HighCardJasper (7262 in chips) 
color_singleton: posts small blind 50
dockstarr: posts big blind 100
*** HOLE CARDS ***
Dealt to PokerStarsMan12 [Jd Qc]
PokerStarsMan12: raises 200 to 300
manon327: folds 
HighCardJasper: calls 300
color_singleton: calls 250
dockstarr: raises 200 to 500
PokerStarsMan12: calls 200
HighCardJasper: calls 200
color_singleton: calls 200
*** FLOP *** [5c 7d Ks]
color_singleton: checks 
dockstarr: bets 100
PokerStarsMan12 is connected 
PokerStarsMan12 has timed out
PokerStarsMan12: folds 
HighCardJasper: folds 
color_singleton: folds 
Uncalled bet (100) returned to dockstarr
dockstarr collected 1890 from pot
dockstarr: doesn't show hand 
*** SUMMARY ***
Total pot 2000 | Rake 110 
Board [5c 7d Ks]
Seat 1: color_singleton (small blind) folded on the Flop
Seat 2: dockstarr (big blind) collected (1890)
Seat 3: PokerStarsMan12 folded on the Flop
Seat 5: manon327 folded before Flop (didn't bet)
Seat 6: HighCardJasper (button) folded on the Flop



PokerStars Home Game Hand #229540668124: {DaPokaStars}  Hold'em No Limit (50/100) - 2021/09/02 16:13:58 ET
Table 'summer poker' 9-max (Play Money) Seat #1 is the button
Seat 1: color_singleton (16874 in chips) 
Seat 2: dockstarr (5432 in chips) 
Seat 3: PokerStarsMan12 (6226 in chips) 
Seat 5: manon327 (10471 in chips) 
Seat 6: HighCardJasper (6762 in chips) 
dockstarr: posts small blind 50
PokerStarsMan12: posts big blind 100
*** HOLE CARDS ***
Dealt to PokerStarsMan12 [Ac Qc]
manon327: calls 100
HighCardJasper: calls 100
color_singleton: raises 200 to 300
dockstarr: calls 250
PokerStarsMan12: calls 200
manon327: calls 200
HighCardJasper: folds 
*** FLOP *** [2s 9d 5h]
dockstarr: checks 
PokerStarsMan12: checks 
manon327: checks 
color_singleton: bets 614
dockstarr: folds 
PokerStarsMan12: folds 
manon327: folds 
Uncalled bet (614) returned to color_singleton
color_singleton collected 1228 from pot
color_singleton: doesn't show hand 
*** SUMMARY ***
Total pot 1300 | Rake 72 
Board [2s 9d 5h]
Seat 1: color_singleton (button) collected (1228)
Seat 2: dockstarr (small blind) folded on the Flop
Seat 3: PokerStarsMan12 (big blind) folded on the Flop
Seat 5: manon327 folded on the Flop
Seat 6: HighCardJasper folded before Flop



PokerStars Home Game Hand #229540697085: {DaPokaStars}  Hold'em No Limit (50/100) - 2021/09/02 16:14:57 ET
Table 'summer poker' 9-max (Play Money) Seat #2 is the button
Seat 1: color_singleton (17802 in chips) 
Seat 2: dockstarr (5132 in chips) 
Seat 3: PokerStarsMan12 (5926 in chips) 
Seat 5: manon327 (10171 in chips) 
Seat 6: HighCardJasper (6662 in chips) 
PokerStarsMan12: posts small blind 50
manon327: posts big blind 100
*** HOLE CARDS ***
Dealt to PokerStarsMan12 [Kc Qd]
HighCardJasper: folds 
color_singleton: raises 200 to 300
dockstarr: folds 
PokerStarsMan12: calls 250
manon327: folds 
*** FLOP *** [4h 5s 7s]
PokerStarsMan12: checks 
color_singleton: checks 
*** TURN *** [4h 5s 7s] [Qs]
PokerStarsMan12: bets 400
color_singleton: folds 
Uncalled bet (400) returned to PokerStarsMan12
PokerStarsMan12 collected 661 from pot
*** SUMMARY ***
Total pot 700 | Rake 39 
Board [4h 5s 7s Qs]
Seat 1: color_singleton folded on the Turn
Seat 2: dockstarr (button) folded before Flop (didn't bet)
Seat 3: PokerStarsMan12 (small blind) collected (661)
Seat 5: manon327 (big blind) folded before Flop
Seat 6: HighCardJasper folded before Flop (didn't bet)



PokerStars Home Game Hand #229540715423: {DaPokaStars}  Hold'em No Limit (50/100) - 2021/09/02 16:15:32 ET
Table 'summer poker' 9-max (Play Money) Seat #3 is the button
Seat 1: color_singleton (17502 in chips) 
Seat 2: dockstarr (5132 in chips) 
Seat 3: PokerStarsMan12 (6287 in chips) 
Seat 5: manon327 (10071 in chips) 
Seat 6: HighCardJasper (6662 in chips) 
manon327: posts small blind 50
HighCardJasper: posts big blind 100
*** HOLE CARDS ***
Dealt to PokerStarsMan12 [8d 9h]
color_singleton has timed out
color_singleton: folds 
dockstarr: folds 
PokerStarsMan12: calls 100
manon327: calls 50
HighCardJasper: checks 
*** FLOP *** [8h 6s 3h]
manon327: checks 
HighCardJasper: checks 
PokerStarsMan12: bets 200
manon327: folds 
HighCardJasper: folds 
Uncalled bet (200) returned to PokerStarsMan12
PokerStarsMan12 collected 283 from pot
*** SUMMARY ***
Total pot 300 | Rake 17 
Board [8h 6s 3h]
Seat 1: color_singleton folded before Flop (didn't bet)
Seat 2: dockstarr folded before Flop (didn't bet)
Seat 3: PokerStarsMan12 (button) collected (283)
Seat 5: manon327 (small blind) folded on the Flop
Seat 6: HighCardJasper (big blind) folded on the Flop



PokerStars Home Game Hand #229540739023: {DaPokaStars}  Hold'em No Limit (50/100) - 2021/09/02 16:16:18 ET
Table 'summer poker' 9-max (Play Money) Seat #5 is the button
Seat 1: color_singleton (17502 in chips) 
Seat 2: dockstarr (5132 in chips) 
Seat 3: PokerStarsMan12 (6470 in chips) 
Seat 5: manon327 (9971 in chips) 
Seat 6: HighCardJasper (6562 in chips) 
HighCardJasper: posts small blind 50
color_singleton: posts big blind 100
*** HOLE CARDS ***
Dealt to PokerStarsMan12 [7s Ts]
dockstarr: folds 
PokerStarsMan12: calls 100
manon327: calls 100
HighCardJasper: calls 50
color_singleton: checks 
*** FLOP *** [4s Qh 3d]
HighCardJasper: checks 
color_singleton: checks 
PokerStarsMan12: checks 
manon327: checks 
*** TURN *** [4s Qh 3d] [As]
HighCardJasper: checks 
color_singleton: bets 189
PokerStarsMan12 has timed out
PokerStarsMan12: folds 
manon327: calls 189
HighCardJasper: folds 
*** RIVER *** [4s Qh 3d As] [Qd]
color_singleton: bets 500
manon327: folds 
Uncalled bet (500) returned to color_singleton
color_singleton collected 735 from pot
color_singleton: doesn't show hand 
*** SUMMARY ***
Total pot 778 | Rake 43 
Board [4s Qh 3d As Qd]
Seat 1: color_singleton (big blind) collected (735)
Seat 2: dockstarr folded before Flop (didn't bet)
Seat 3: PokerStarsMan12 folded on the Turn
Seat 5: manon327 (button) folded on the River
Seat 6: HighCardJasper (small blind) folded on the Turn



PokerStars Home Game Hand #229540776313: {DaPokaStars}  Hold'em No Limit (50/100) - 2021/09/02 16:17:31 ET
Table 'summer poker' 9-max (Play Money) Seat #6 is the button
Seat 1: color_singleton (17948 in chips) 
Seat 2: dockstarr (5132 in chips) 
Seat 3: PokerStarsMan12 (6370 in chips) 
Seat 5: manon327 (9682 in chips) 
Seat 6: HighCardJasper (6462 in chips) 
color_singleton: posts small blind 50
dockstarr: posts big blind 100
*** HOLE CARDS ***
Dealt to PokerStarsMan12 [Jh Kh]
PokerStarsMan12: raises 300 to 400
manon327: calls 400
HighCardJasper: folds 
color_singleton: folds 
dockstarr: folds 
*** FLOP *** [As 5c 6h]
PokerStarsMan12: checks 
manon327: checks 
*** TURN *** [As 5c 6h] [7c]
PokerStarsMan12: checks 
manon327: checks 
*** RIVER *** [As 5c 6h 7c] [3d]
PokerStarsMan12: checks 
manon327: checks 
*** SHOW DOWN ***
PokerStarsMan12: shows [Jh Kh] (high card Ace)
manon327: shows [Ks Jc] (high card Ace)
PokerStarsMan12 collected 449 from pot
manon327 collected 449 from pot
*** SUMMARY ***
Total pot 950 | Rake 52 
Board [As 5c 6h 7c 3d]
Seat 1: color_singleton (small blind) folded before Flop
Seat 2: dockstarr (big blind) folded before Flop
Seat 3: PokerStarsMan12 showed [Jh Kh] and won (449) with high card Ace
Seat 5: manon327 showed [Ks Jc] and won (449) with high card Ace
Seat 6: HighCardJasper (button) folded before Flop (didn't bet)



PokerStars Home Game Hand #229540792243: {DaPokaStars}  Hold'em No Limit (50/100) - 2021/09/02 16:18:02 ET
Table 'summer poker' 9-max (Play Money) Seat #1 is the button
Seat 1: color_singleton (17898 in chips) 
Seat 2: dockstarr (5032 in chips) 
Seat 3: PokerStarsMan12 (6419 in chips) 
Seat 5: manon327 (9731 in chips) 
Seat 6: HighCardJasper (6462 in chips) 
dockstarr: posts small blind 50
PokerStarsMan12: posts big blind 100
*** HOLE CARDS ***
Dealt to PokerStarsMan12 [4h Qc]
manon327: raises 100 to 200
HighCardJasper: folds 
color_singleton: calls 200
dockstarr: folds 
PokerStarsMan12: calls 100
*** FLOP *** [4s 9d 3h]
PokerStarsMan12: checks 
manon327: checks 
color_singleton: checks 
*** TURN *** [4s 9d 3h] [Kc]
PokerStarsMan12: checks 
manon327: checks 
color_singleton: checks 
*** RIVER *** [4s 9d 3h Kc] [Tc]
PokerStarsMan12: checks 
manon327: bets 614
color_singleton: folds 
PokerStarsMan12: folds 
Uncalled bet (614) returned to manon327
manon327 collected 614 from pot
*** SUMMARY ***
Total pot 650 | Rake 36 
Board [4s 9d 3h Kc Tc]
Seat 1: color_singleton (button) folded on the River
Seat 2: dockstarr (small blind) folded before Flop
Seat 3: PokerStarsMan12 (big blind) folded on the River
Seat 5: manon327 collected (614)
Seat 6: HighCardJasper folded before Flop (didn't bet)



PokerStars Home Game Hand #229540824063: {DaPokaStars}  Hold'em No Limit (50/100) - 2021/09/02 16:18:53 ET
Table 'summer poker' 9-max (Play Money) Seat #2 is the button
Seat 1: color_singleton (17698 in chips) 
Seat 2: dockstarr (4982 in chips) 
Seat 3: PokerStarsMan12 (6219 in chips) 
Seat 5: manon327 (10145 in chips) 
Seat 6: HighCardJasper (6462 in chips) 
PokerStarsMan12: posts small blind 50
manon327: posts big blind 100
*** HOLE CARDS ***
Dealt to PokerStarsMan12 [6s 7h]
HighCardJasper: raises 100 to 200
color_singleton: calls 200
dockstarr: folds 
PokerStarsMan12: calls 150
manon327: calls 100
*** FLOP *** [Ac 9s 9c]
PokerStarsMan12: checks 
manon327: bets 378
HighCardJasper: calls 378
color_singleton: folds 
PokerStarsMan12: folds 
*** TURN *** [Ac 9s 9c] [Jc]
manon327: bets 1470
HighCardJasper: calls 1470
*** RIVER *** [Ac 9s 9c Jc] [4h]
manon327: checks 
HighCardJasper: checks 
*** SHOW DOWN ***
manon327: shows [4d Ad] (two pair, Aces and Nines)
HighCardJasper: shows [As Ks] (two pair, Aces and Nines - King kicker)
HighCardJasper collected 4249 from pot
*** SUMMARY ***
Total pot 4496 | Rake 247 
Board [Ac 9s 9c Jc 4h]
Seat 1: color_singleton folded on the Flop
Seat 2: dockstarr (button) folded before Flop (didn't bet)
Seat 3: PokerStarsMan12 (small blind) folded on the Flop
Seat 5: manon327 (big blind) showed [4d Ad] and lost with two pair, Aces and Nines
Seat 6: HighCardJasper showed [As Ks] and won (4249) with two pair, Aces and Nines



PokerStars Home Game Hand #229540862903: {DaPokaStars}  Hold'em No Limit (50/100) - 2021/09/02 16:20:08 ET
Table 'summer poker' 9-max (Play Money) Seat #3 is the button
Seat 1: color_singleton (17498 in chips) 
Seat 2: dockstarr (4982 in chips) 
Seat 3: PokerStarsMan12 (6019 in chips) 
Seat 5: manon327 (8097 in chips) 
Seat 6: HighCardJasper (8663 in chips) 
manon327: posts small blind 50
HighCardJasper: posts big blind 100
*** HOLE CARDS ***
Dealt to PokerStarsMan12 [3h 7d]
color_singleton: folds 
dockstarr: calls 100
PokerStarsMan12: folds 
manon327: calls 50
HighCardJasper: checks 
*** FLOP *** [2c 6c 7c]
manon327: checks 
HighCardJasper: checks 
dockstarr: checks 
*** TURN *** [2c 6c 7c] [8s]
manon327: bets 100
HighCardJasper: folds 
dockstarr: calls 100
*** RIVER *** [2c 6c 7c 8s] [Qh]
manon327: checks 
dockstarr: checks 
*** SHOW DOWN ***
manon327: shows [Ah 9s] (high card Ace)
dockstarr: shows [8c As] (a pair of Eights)
dockstarr collected 472 from pot
*** SUMMARY ***
Total pot 500 | Rake 28 
Board [2c 6c 7c 8s Qh]
Seat 1: color_singleton folded before Flop (didn't bet)
Seat 2: dockstarr showed [8c As] and won (472) with a pair of Eights
Seat 3: PokerStarsMan12 (button) folded before Flop (didn't bet)
Seat 5: manon327 (small blind) showed [Ah 9s] and lost with high card Ace
Seat 6: HighCardJasper (big blind) folded on the Turn



PokerStars Home Game Hand #229540883271: {DaPokaStars}  Hold'em No Limit (50/100) - 2021/09/02 16:20:48 ET
Table 'summer poker' 9-max (Play Money) Seat #5 is the button
Seat 1: color_singleton (17498 in chips) 
Seat 2: dockstarr (5254 in chips) 
Seat 3: PokerStarsMan12 (6019 in chips) 
Seat 5: manon327 (7897 in chips) 
Seat 6: HighCardJasper (8563 in chips) 
HighCardJasper: posts small blind 50
color_singleton: posts big blind 100
*** HOLE CARDS ***
Dealt to PokerStarsMan12 [7d 2h]
dockstarr: calls 100
PokerStarsMan12: folds 
manon327: calls 100
HighCardJasper: calls 50
color_singleton: checks 
*** FLOP *** [7h Js 9h]
HighCardJasper: checks 
color_singleton: checks 
dockstarr: checks 
manon327: bets 100
HighCardJasper: calls 100
color_singleton: folds 
dockstarr: calls 100
*** TURN *** [7h Js 9h] [Kc]
HighCardJasper: checks 
dockstarr: bets 100
manon327: raises 100 to 200
HighCardJasper: folds 
dockstarr: calls 100
*** RIVER *** [7h Js 9h Kc] [Jh]
dockstarr: checks 
manon327: bets 1039
dockstarr: folds 
Uncalled bet (1039) returned to manon327
manon327 collected 1039 from pot
*** SUMMARY ***
Total pot 1100 | Rake 61 
Board [7h Js 9h Kc Jh]
Seat 1: color_singleton (big blind) folded on the Flop
Seat 2: dockstarr folded on the River
Seat 3: PokerStarsMan12 folded before Flop (didn't bet)
Seat 5: manon327 (button) collected (1039)
Seat 6: HighCardJasper (small blind) folded on the Turn



PokerStars Home Game Hand #229540918042: {DaPokaStars}  Hold'em No Limit (50/100) - 2021/09/02 16:21:57 ET
Table 'summer poker' 9-max (Play Money) Seat #6 is the button
Seat 1: color_singleton (17398 in chips) 
Seat 2: dockstarr (4854 in chips) 
Seat 3: PokerStarsMan12 (6019 in chips) 
Seat 5: manon327 (8536 in chips) 
Seat 6: HighCardJasper (8363 in chips) 
color_singleton: posts small blind 50
dockstarr: posts big blind 100
*** HOLE CARDS ***
Dealt to PokerStarsMan12 [Ks 8c]
PokerStarsMan12: calls 100
manon327: calls 100
HighCardJasper: calls 100
color_singleton: calls 50
dockstarr: checks 
*** FLOP *** [As 5s 5d]
color_singleton: checks 
dockstarr: checks 
PokerStarsMan12: checks 
manon327: checks 
HighCardJasper: checks 
*** TURN *** [As 5s 5d] [Jh]
color_singleton: checks 
dockstarr: checks 
PokerStarsMan12: checks 
manon327: checks 
HighCardJasper: checks 
*** RIVER *** [As 5s 5d Jh] [Ah]
color_singleton: checks 
dockstarr: checks 
PokerStarsMan12: checks 
manon327: checks 
HighCardJasper: checks 
*** SHOW DOWN ***
color_singleton: shows [Kc 9s] (two pair, Aces and Fives)
dockstarr: shows [Qd Jc] (two pair, Aces and Jacks)
PokerStarsMan12: mucks hand 
manon327: mucks hand 
HighCardJasper: mucks hand 
dockstarr collected 472 from pot
*** SUMMARY ***
Total pot 500 | Rake 28 
Board [As 5s 5d Jh Ah]
Seat 1: color_singleton (small blind) showed [Kc 9s] and lost with two pair, Aces and Fives
Seat 2: dockstarr (big blind) showed [Qd Jc] and won (472) with two pair, Aces and Jacks
Seat 3: PokerStarsMan12 mucked [Ks 8c]
Seat 5: manon327 mucked [8h 2h]
Seat 6: HighCardJasper (button) mucked [2d Qh]



PokerStars Home Game Hand #229540952617: {DaPokaStars}  Hold'em No Limit (50/100) - 2021/09/02 16:23:01 ET
Table 'summer poker' 9-max (Play Money) Seat #1 is the button
Seat 1: color_singleton (17298 in chips) 
Seat 2: dockstarr (5226 in chips) 
Seat 3: PokerStarsMan12 (5919 in chips) 
Seat 5: manon327 (8436 in chips) 
Seat 6: HighCardJasper (8263 in chips) 
dockstarr: posts small blind 50
PokerStarsMan12: posts big blind 100
*** HOLE CARDS ***
Dealt to PokerStarsMan12 [3d 6c]
manon327: folds 
HighCardJasper: calls 100
color_singleton: folds 
dockstarr: folds 
PokerStarsMan12: checks 
*** FLOP *** [8h 9h 2d]
PokerStarsMan12: checks 
HighCardJasper: checks 
*** TURN *** [8h 9h 2d] [Qc]
PokerStarsMan12: checks 
HighCardJasper: checks 
*** RIVER *** [8h 9h 2d Qc] [2h]
PokerStarsMan12: checks 
HighCardJasper: checks 
*** SHOW DOWN ***
PokerStarsMan12: shows [3d 6c] (a pair of Deuces)
HighCardJasper: shows [9s Tc] (two pair, Nines and Deuces)
HighCardJasper collected 236 from pot
*** SUMMARY ***
Total pot 250 | Rake 14 
Board [8h 9h 2d Qc 2h]
Seat 1: color_singleton (button) folded before Flop (didn't bet)
Seat 2: dockstarr (small blind) folded before Flop
Seat 3: PokerStarsMan12 (big blind) showed [3d 6c] and lost with a pair of Deuces
Seat 5: manon327 folded before Flop (didn't bet)
Seat 6: HighCardJasper showed [9s Tc] and won (236) with two pair, Nines and Deuces



PokerStars Home Game Hand #229540971367: {DaPokaStars}  Hold'em No Limit (50/100) - 2021/09/02 16:23:38 ET
Table 'summer poker' 9-max (Play Money) Seat #2 is the button
Seat 1: color_singleton (17298 in chips) 
Seat 2: dockstarr (5176 in chips) 
Seat 3: PokerStarsMan12 (5819 in chips) 
Seat 5: manon327 (8436 in chips) 
Seat 6: HighCardJasper (8399 in chips) 
PokerStarsMan12: posts small blind 50
manon327: posts big blind 100
*** HOLE CARDS ***
Dealt to PokerStarsMan12 [Jd Qc]
HighCardJasper: calls 100
color_singleton: folds 
dockstarr: calls 100
PokerStarsMan12: calls 50
manon327: checks 
*** FLOP *** [Kd 8h 7c]
PokerStarsMan12: checks 
manon327: checks 
HighCardJasper: checks 
dockstarr: checks 
*** TURN *** [Kd 8h 7c] [3h]
PokerStarsMan12: checks 
manon327: checks 
HighCardJasper: checks 
dockstarr: checks 
*** RIVER *** [Kd 8h 7c 3h] [Ks]
PokerStarsMan12: checks 
manon327: checks 
HighCardJasper: checks 
dockstarr: checks 
*** SHOW DOWN ***
PokerStarsMan12: shows [Jd Qc] (a pair of Kings)
manon327: shows [Th 7h] (two pair, Kings and Sevens)
HighCardJasper: mucks hand 
dockstarr: mucks hand 
manon327 collected 378 from pot
*** SUMMARY ***
Total pot 400 | Rake 22 
Board [Kd 8h 7c 3h Ks]
Seat 1: color_singleton folded before Flop (didn't bet)
Seat 2: dockstarr (button) mucked [5c Tc]
Seat 3: PokerStarsMan12 (small blind) showed [Jd Qc] and lost with a pair of Kings
Seat 5: manon327 (big blind) showed [Th 7h] and won (378) with two pair, Kings and Sevens
Seat 6: HighCardJasper mucked [5s 9s]



PokerStars Home Game Hand #229540995890: {DaPokaStars}  Hold'em No Limit (50/100) - 2021/09/02 16:24:26 ET
Table 'summer poker' 9-max (Play Money) Seat #3 is the button
Seat 1: color_singleton (17298 in chips) 
Seat 2: dockstarr (5076 in chips) 
Seat 3: PokerStarsMan12 (5719 in chips) 
Seat 5: manon327 (8714 in chips) 
Seat 6: HighCardJasper (8299 in chips) 
manon327: posts small blind 50
HighCardJasper: posts big blind 100
*** HOLE CARDS ***
Dealt to PokerStarsMan12 [Tc 2h]
color_singleton: raises 200 to 300
dockstarr: calls 300
PokerStarsMan12: folds 
manon327: folds 
HighCardJasper: calls 200
*** FLOP *** [6c As 4h]
HighCardJasper: checks 
color_singleton: checks 
dockstarr: checks 
*** TURN *** [6c As 4h] [Qh]
HighCardJasper: bets 449
color_singleton: calls 449
dockstarr: folds 
*** RIVER *** [6c As 4h Qh] [6d]
HighCardJasper: bets 873
color_singleton: calls 873
*** SHOW DOWN ***
HighCardJasper: shows [Ac 5c] (two pair, Aces and Sixes)
color_singleton: mucks hand 
HighCardJasper collected 3396 from pot
*** SUMMARY ***
Total pot 3594 | Rake 198 
Board [6c As 4h Qh 6d]
Seat 1: color_singleton mucked [Qs Js]
Seat 2: dockstarr folded on the Turn
Seat 3: PokerStarsMan12 (button) folded before Flop (didn't bet)
Seat 5: manon327 (small blind) folded before Flop
Seat 6: HighCardJasper (big blind) showed [Ac 5c] and won (3396) with two pair, Aces and Sixes



PokerStars Home Game Hand #229541017872: {DaPokaStars}  Hold'em No Limit (50/100) - 2021/09/02 16:25:10 ET
Table 'summer poker' 9-max (Play Money) Seat #5 is the button
Seat 1: color_singleton (15676 in chips) 
Seat 2: dockstarr (4776 in chips) 
Seat 3: PokerStarsMan12 (5719 in chips) 
Seat 5: manon327 (8664 in chips) 
Seat 6: HighCardJasper (10073 in chips) 
HighCardJasper: posts small blind 50
color_singleton: posts big blind 100
*** HOLE CARDS ***
Dealt to PokerStarsMan12 [2h Qc]
dockstarr: folds 
PokerStarsMan12: folds 
manon327: folds 
HighCardJasper: calls 50
color_singleton: raises 200 to 300
HighCardJasper: folds 
Uncalled bet (200) returned to color_singleton
color_singleton collected 200 from pot
color_singleton: doesn't show hand 
*** SUMMARY ***
Total pot 200 | Rake 0 
Seat 1: color_singleton (big blind) collected (200)
Seat 2: dockstarr folded before Flop (didn't bet)
Seat 3: PokerStarsMan12 folded before Flop (didn't bet)
Seat 5: manon327 (button) folded before Flop (didn't bet)
Seat 6: HighCardJasper (small blind) folded before Flop



PokerStars Home Game Hand #229541024862: {DaPokaStars}  Hold'em No Limit (50/100) - 2021/09/02 16:25:23 ET
Table 'summer poker' 9-max (Play Money) Seat #6 is the button
Seat 1: color_singleton (15776 in chips) 
Seat 2: dockstarr (4776 in chips) 
Seat 3: PokerStarsMan12 (5719 in chips) 
Seat 5: manon327 (8664 in chips) 
Seat 6: HighCardJasper (9973 in chips) 
color_singleton: posts small blind 50
dockstarr: posts big blind 100
*** HOLE CARDS ***
Dealt to PokerStarsMan12 [6c Ts]
PokerStarsMan12: folds 
manon327: calls 100
HighCardJasper: calls 100
color_singleton: raises 300 to 400
dockstarr: folds 
manon327: folds 
HighCardJasper: folds 
Uncalled bet (300) returned to color_singleton
color_singleton collected 400 from pot
color_singleton: doesn't show hand 
*** SUMMARY ***
Total pot 400 | Rake 0 
Seat 1: color_singleton (small blind) collected (400)
Seat 2: dockstarr (big blind) folded before Flop
Seat 3: PokerStarsMan12 folded before Flop (didn't bet)
Seat 5: manon327 folded before Flop
Seat 6: HighCardJasper (button) folded before Flop



PokerStars Home Game Hand #229541037653: {DaPokaStars}  Hold'em No Limit (50/100) - 2021/09/02 16:25:49 ET
Table 'summer poker' 9-max (Play Money) Seat #1 is the button
Seat 1: color_singleton (16076 in chips) 
Seat 2: dockstarr (4676 in chips) 
Seat 3: PokerStarsMan12 (5719 in chips) 
Seat 5: manon327 (8564 in chips) 
Seat 6: HighCardJasper (9873 in chips) 
dockstarr: posts small blind 50
PokerStarsMan12: posts big blind 100
*** HOLE CARDS ***
Dealt to PokerStarsMan12 [6s Qc]
manon327: folds 
HighCardJasper: calls 100
color_singleton: raises 300 to 400
dockstarr: folds 
PokerStarsMan12: folds 
HighCardJasper: folds 
Uncalled bet (300) returned to color_singleton
color_singleton collected 350 from pot
color_singleton: doesn't show hand 
*** SUMMARY ***
Total pot 350 | Rake 0 
Seat 1: color_singleton (button) collected (350)
Seat 2: dockstarr (small blind) folded before Flop
Seat 3: PokerStarsMan12 (big blind) folded before Flop
Seat 5: manon327 folded before Flop (didn't bet)
Seat 6: HighCardJasper folded before Flop



PokerStars Home Game Hand #229541047223: {DaPokaStars}  Hold'em No Limit (50/100) - 2021/09/02 16:26:08 ET
Table 'summer poker' 9-max (Play Money) Seat #2 is the button
Seat 1: color_singleton (16326 in chips) 
Seat 2: dockstarr (4626 in chips) 
Seat 3: PokerStarsMan12 (5619 in chips) 
Seat 5: manon327 (8564 in chips) 
Seat 6: HighCardJasper (9773 in chips) 
PokerStarsMan12: posts small blind 50
manon327: posts big blind 100
*** HOLE CARDS ***
Dealt to PokerStarsMan12 [8h Th]
HighCardJasper: calls 100
color_singleton: folds 
dockstarr: folds 
PokerStarsMan12: calls 50
manon327: checks 
*** FLOP *** [As 7h 3d]
PokerStarsMan12: checks 
manon327: checks 
HighCardJasper: checks 
*** TURN *** [As 7h 3d] [Jc]
PokerStarsMan12: checks 
manon327: checks 
HighCardJasper: checks 
*** RIVER *** [As 7h 3d Jc] [3c]
PokerStarsMan12: checks 
manon327: bets 100
HighCardJasper: folds 
PokerStarsMan12: folds 
Uncalled bet (100) returned to manon327
manon327 collected 283 from pot
*** SUMMARY ***
Total pot 300 | Rake 17 
Board [As 7h 3d Jc 3c]
Seat 1: color_singleton folded before Flop (didn't bet)
Seat 2: dockstarr (button) folded before Flop (didn't bet)
Seat 3: PokerStarsMan12 (small blind) folded on the River
Seat 5: manon327 (big blind) collected (283)
Seat 6: HighCardJasper folded on the River



PokerStars Home Game Hand #229541075478: {DaPokaStars}  Hold'em No Limit (50/100) - 2021/09/02 16:27:04 ET
Table 'summer poker' 9-max (Play Money) Seat #3 is the button
Seat 1: color_singleton (16326 in chips) 
Seat 2: dockstarr (4626 in chips) 
Seat 3: PokerStarsMan12 (5519 in chips) 
Seat 5: manon327 (8747 in chips) 
Seat 6: HighCardJasper (9673 in chips) 
manon327: posts small blind 50
HighCardJasper: posts big blind 100
*** HOLE CARDS ***
Dealt to PokerStarsMan12 [8s 4h]
color_singleton: raises 200 to 300
dockstarr: calls 300
PokerStarsMan12: folds 
manon327: folds 
HighCardJasper: calls 200
*** FLOP *** [Qs 6h Kh]
HighCardJasper: checks 
color_singleton: checks 
dockstarr: checks 
*** TURN *** [Qs 6h Kh] [3c]
HighCardJasper: bets 200
color_singleton: folds 
dockstarr: calls 200
*** RIVER *** [Qs 6h Kh 3c] [9h]
HighCardJasper: bets 500
dockstarr: calls 500
*** SHOW DOWN ***
HighCardJasper: shows [3h 3d] (three of a kind, Threes)
dockstarr: mucks hand 
HighCardJasper collected 2221 from pot
*** SUMMARY ***
Total pot 2350 | Rake 129 
Board [Qs 6h Kh 3c 9h]
Seat 1: color_singleton folded on the Turn
Seat 2: dockstarr mucked [8h Ks]
Seat 3: PokerStarsMan12 (button) folded before Flop (didn't bet)
Seat 5: manon327 (small blind) folded before Flop
Seat 6: HighCardJasper (big blind) showed [3h 3d] and won (2221) with three of a kind, Threes



PokerStars Home Game Hand #229541105129: {DaPokaStars}  Hold'em No Limit (50/100) - 2021/09/02 16:28:03 ET
Table 'summer poker' 9-max (Play Money) Seat #5 is the button
Seat 1: color_singleton (16026 in chips) 
Seat 2: dockstarr (3626 in chips) 
Seat 3: PokerStarsMan12 (5519 in chips) 
Seat 5: manon327 (8697 in chips) 
Seat 6: HighCardJasper (10894 in chips) 
HighCardJasper: posts small blind 50
color_singleton: posts big blind 100
*** HOLE CARDS ***
Dealt to PokerStarsMan12 [3c Kd]
dockstarr: folds 
PokerStarsMan12: folds 
manon327: calls 100
HighCardJasper: calls 50
color_singleton: raises 300 to 400
manon327: calls 300
HighCardJasper: folds 
*** FLOP *** [Kh 6d Ts]
color_singleton: bets 425
manon327: folds 
Uncalled bet (425) returned to color_singleton
color_singleton collected 850 from pot
color_singleton: doesn't show hand 
*** SUMMARY ***
Total pot 900 | Rake 50 
Board [Kh 6d Ts]
Seat 1: color_singleton (big blind) collected (850)
Seat 2: dockstarr folded before Flop (didn't bet)
Seat 3: PokerStarsMan12 folded before Flop (didn't bet)
Seat 5: manon327 (button) folded on the Flop
Seat 6: HighCardJasper (small blind) folded before Flop



PokerStars Home Game Hand #229541127422: {DaPokaStars}  Hold'em No Limit (50/100) - 2021/09/02 16:28:47 ET
Table 'summer poker' 9-max (Play Money) Seat #6 is the button
Seat 1: color_singleton (16476 in chips) 
Seat 2: dockstarr (3626 in chips) 
Seat 3: PokerStarsMan12 (5519 in chips) 
Seat 5: manon327 (8297 in chips) 
Seat 6: HighCardJasper (10794 in chips) 
color_singleton: posts small blind 50
dockstarr: posts big blind 100
*** HOLE CARDS ***
Dealt to PokerStarsMan12 [5h 5s]
PokerStarsMan12: raises 200 to 300
manon327: folds 
HighCardJasper: folds 
color_singleton: folds 
dockstarr: calls 200
*** FLOP *** [4s 2d 6h]
dockstarr: checks 
PokerStarsMan12: bets 400
dockstarr: calls 400
*** TURN *** [4s 2d 6h] [8c]
dockstarr: checks 
PokerStarsMan12: bets 700
dockstarr: calls 700
*** RIVER *** [4s 2d 6h 8c] [8h]
dockstarr: checks 
PokerStarsMan12: bets 1300
dockstarr: calls 1300
*** SHOW DOWN ***
PokerStarsMan12: shows [5h 5s] (two pair, Eights and Fives)
dockstarr: mucks hand 
PokerStarsMan12 collected 5150 from pot
*** SUMMARY ***
Total pot 5450 | Rake 300 
Board [4s 2d 6h 8c 8h]
Seat 1: color_singleton (small blind) folded before Flop
Seat 2: dockstarr (big blind) mucked [As Qd]
Seat 3: PokerStarsMan12 showed [5h 5s] and won (5150) with two pair, Eights and Fives
Seat 5: manon327 folded before Flop (didn't bet)
Seat 6: HighCardJasper (button) folded before Flop (didn't bet)



PokerStars Home Game Hand #229541149346: {DaPokaStars}  Hold'em No Limit (50/100) - 2021/09/02 16:29:31 ET
Table 'summer poker' 9-max (Play Money) Seat #1 is the button
Seat 1: color_singleton (16426 in chips) 
Seat 2: dockstarr (926 in chips) 
Seat 3: PokerStarsMan12 (7969 in chips) 
Seat 5: manon327 (8297 in chips) 
Seat 6: HighCardJasper (10794 in chips) 
dockstarr: posts small blind 50
PokerStarsMan12: posts big blind 100
*** HOLE CARDS ***
Dealt to PokerStarsMan12 [2d Qh]
manon327: folds 
HighCardJasper: folds 
color_singleton: folds 
dockstarr: raises 826 to 926 and is all-in
PokerStarsMan12: folds 
Uncalled bet (826) returned to dockstarr
dockstarr collected 200 from pot
dockstarr: doesn't show hand 
*** SUMMARY ***
Total pot 200 | Rake 0 
Seat 1: color_singleton (button) folded before Flop (didn't bet)
Seat 2: dockstarr (small blind) collected (200)
Seat 3: PokerStarsMan12 (big blind) folded before Flop
Seat 5: manon327 folded before Flop (didn't bet)
Seat 6: HighCardJasper folded before Flop (didn't bet)



PokerStars Home Game Hand #229541159045: {DaPokaStars}  Hold'em No Limit (50/100) - 2021/09/02 16:29:51 ET
Table 'summer poker' 9-max (Play Money) Seat #2 is the button
Seat 1: color_singleton (16426 in chips) 
Seat 2: dockstarr (1026 in chips) 
Seat 3: PokerStarsMan12 (7869 in chips) 
Seat 5: manon327 (8297 in chips) 
Seat 6: HighCardJasper (10794 in chips) 
PokerStarsMan12: posts small blind 50
manon327: posts big blind 100
*** HOLE CARDS ***
Dealt to PokerStarsMan12 [4h Ad]
HighCardJasper: folds 
color_singleton: folds 
dockstarr: folds 
PokerStarsMan12: calls 50
manon327: checks 
*** FLOP *** [Jc 9s Qc]
PokerStarsMan12: checks 
manon327: bets 100
PokerStarsMan12: folds 
Uncalled bet (100) returned to manon327
manon327 collected 189 from pot
*** SUMMARY ***
Total pot 200 | Rake 11 
Board [Jc 9s Qc]
Seat 1: color_singleton folded before Flop (didn't bet)
Seat 2: dockstarr (button) folded before Flop (didn't bet)
Seat 3: PokerStarsMan12 (small blind) folded on the Flop
Seat 5: manon327 (big blind) collected (189)
Seat 6: HighCardJasper folded before Flop (didn't bet)



PokerStars Home Game Hand #229541173956: {DaPokaStars}  Hold'em No Limit (50/100) - 2021/09/02 16:30:21 ET
Table 'summer poker' 9-max (Play Money) Seat #3 is the button
Seat 1: color_singleton (16426 in chips) 
Seat 2: dockstarr (1026 in chips) 
Seat 3: PokerStarsMan12 (7769 in chips) 
Seat 5: manon327 (8386 in chips) 
Seat 6: HighCardJasper (10794 in chips) 
manon327: posts small blind 50
HighCardJasper: posts big blind 100
*** HOLE CARDS ***
Dealt to PokerStarsMan12 [9c Ac]
color_singleton: folds 
dockstarr: calls 100
PokerStarsMan12: raises 200 to 300
manon327: folds 
HighCardJasper: calls 200
dockstarr: calls 200
*** FLOP *** [4d 8s 3d]
HighCardJasper: checks 
dockstarr: checks 
PokerStarsMan12: checks 
*** TURN *** [4d 8s 3d] [9s]
HighCardJasper: bets 100
dockstarr: calls 100
PokerStarsMan12: raises 300 to 400
HighCardJasper: folds 
dockstarr: folds 
Uncalled bet (300) returned to PokerStarsMan12
PokerStarsMan12 collected 1181 from pot
*** SUMMARY ***
Total pot 1250 | Rake 69 
Board [4d 8s 3d 9s]
Seat 1: color_singleton folded before Flop (didn't bet)
Seat 2: dockstarr folded on the Turn
Seat 3: PokerStarsMan12 (button) collected (1181)
Seat 5: manon327 (small blind) folded before Flop
Seat 6: HighCardJasper (big blind) folded on the Turn



PokerStars Home Game Hand #229541205636: {DaPokaStars}  Hold'em No Limit (50/100) - 2021/09/02 16:31:24 ET
Table 'summer poker' 9-max (Play Money) Seat #5 is the button
Seat 1: color_singleton (16426 in chips) 
Seat 2: dockstarr (626 in chips) 
Seat 3: PokerStarsMan12 (8550 in chips) 
Seat 5: manon327 (8336 in chips) 
Seat 6: HighCardJasper (10394 in chips) 
HighCardJasper: posts small blind 50
color_singleton: posts big blind 100
*** HOLE CARDS ***
Dealt to PokerStarsMan12 [3h Qh]
dockstarr: raises 526 to 626 and is all-in
PokerStarsMan12: folds 
manon327: calls 626
HighCardJasper: folds 
color_singleton: folds 
*** FLOP *** [Th 8d 2s]
*** TURN *** [Th 8d 2s] [9h]
*** RIVER *** [Th 8d 2s 9h] [Tc]
*** SHOW DOWN ***
dockstarr: shows [6d 6h] (two pair, Tens and Sixes)
manon327: shows [As 9d] (two pair, Tens and Nines)
manon327 collected 1325 from pot
*** SUMMARY ***
Total pot 1402 | Rake 77 
Board [Th 8d 2s 9h Tc]
Seat 1: color_singleton (big blind) folded before Flop
Seat 2: dockstarr showed [6d 6h] and lost with two pair, Tens and Sixes
Seat 3: PokerStarsMan12 folded before Flop (didn't bet)
Seat 5: manon327 (button) showed [As 9d] and won (1325) with two pair, Tens and Nines
Seat 6: HighCardJasper (small blind) folded before Flop



PokerStars Home Game Hand #229541218528: {DaPokaStars}  Hold'em No Limit (50/100) - 2021/09/02 16:31:50 ET
Table 'summer poker' 9-max (Play Money) Seat #6 is the button
Seat 1: color_singleton (16326 in chips) 
Seat 3: PokerStarsMan12 (8550 in chips) 
Seat 5: manon327 (9035 in chips) 
Seat 6: HighCardJasper (10344 in chips) 
color_singleton: posts small blind 50
PokerStarsMan12: posts big blind 100
*** HOLE CARDS ***
Dealt to PokerStarsMan12 [9c 4d]
manon327: calls 100
HighCardJasper: calls 100
color_singleton: raises 300 to 400
PokerStarsMan12: folds 
manon327: folds 
HighCardJasper: calls 300
*** FLOP *** [Ts 2d Jh]
color_singleton: bets 472
HighCardJasper: calls 472
*** TURN *** [Ts 2d Jh] [As]
color_singleton: bets 918
HighCardJasper: folds 
Uncalled bet (918) returned to color_singleton
color_singleton collected 1837 from pot
color_singleton: doesn't show hand 
*** SUMMARY ***
Total pot 1944 | Rake 107 
Board [Ts 2d Jh As]
Seat 1: color_singleton (small blind) collected (1837)
Seat 3: PokerStarsMan12 (big blind) folded before Flop
Seat 5: manon327 folded before Flop
Seat 6: HighCardJasper (button) folded on the Turn



PokerStars Home Game Hand #229541241348: {DaPokaStars}  Hold'em No Limit (50/100) - 2021/09/02 16:32:37 ET
Table 'summer poker' 9-max (Play Money) Seat #1 is the button
Seat 1: color_singleton (17291 in chips) 
Seat 3: PokerStarsMan12 (8450 in chips) 
Seat 5: manon327 (8935 in chips) 
Seat 6: HighCardJasper (9472 in chips) 
PokerStarsMan12: posts small blind 50
manon327: posts big blind 100
*** HOLE CARDS ***
Dealt to PokerStarsMan12 [2h Jd]
HighCardJasper: calls 100
color_singleton: raises 200 to 300
PokerStarsMan12: folds 
manon327: calls 200
HighCardJasper: folds 
*** FLOP *** [Qc 5c 5d]
manon327: checks 
color_singleton: bets 354
manon327: folds 
Uncalled bet (354) returned to color_singleton
color_singleton collected 709 from pot
color_singleton: doesn't show hand 
*** SUMMARY ***
Total pot 750 | Rake 41 
Board [Qc 5c 5d]
Seat 1: color_singleton (button) collected (709)
Seat 3: PokerStarsMan12 (small blind) folded before Flop
Seat 5: manon327 (big blind) folded on the Flop
Seat 6: HighCardJasper folded before Flop



PokerStars Home Game Hand #229541263694: {DaPokaStars}  Hold'em No Limit (50/100) - 2021/09/02 16:33:22 ET
Table 'summer poker' 9-max (Play Money) Seat #3 is the button
Seat 1: color_singleton (17700 in chips) 
Seat 2: dockstarr (10000 in chips) 
Seat 3: PokerStarsMan12 (8400 in chips) 
Seat 5: manon327 (8635 in chips) 
Seat 6: HighCardJasper (9372 in chips) 
manon327: posts small blind 50
HighCardJasper: posts big blind 100
dockstarr: posts small & big blinds 150
*** HOLE CARDS ***
Dealt to PokerStarsMan12 [6c 4c]
color_singleton: raises 200 to 300
dockstarr: folds 
PokerStarsMan12: folds 
manon327: calls 250
HighCardJasper: calls 200
*** FLOP *** [Ks Tc Jh]
manon327: checks 
HighCardJasper: checks 
color_singleton: bets 200
manon327: calls 200
HighCardJasper: calls 200
*** TURN *** [Ks Tc Jh] [4s]
manon327: checks 
HighCardJasper: checks 
color_singleton: bets 400
manon327: calls 400
HighCardJasper: calls 400
*** RIVER *** [Ks Tc Jh 4s] [4d]
manon327: checks 
HighCardJasper: checks 
color_singleton: bets 2693
manon327: folds 
HighCardJasper: folds 
Uncalled bet (2693) returned to color_singleton
color_singleton collected 2693 from pot
color_singleton: doesn't show hand 
*** SUMMARY ***
Total pot 2850 | Rake 157 
Board [Ks Tc Jh 4s 4d]
Seat 1: color_singleton collected (2693)
Seat 2: dockstarr folded before Flop (didn't bet)
Seat 3: PokerStarsMan12 (button) folded before Flop (didn't bet)
Seat 5: manon327 (small blind) folded on the River
Seat 6: HighCardJasper (big blind) folded on the River



PokerStars Home Game Hand #229541304748: {DaPokaStars}  Hold'em No Limit (50/100) - 2021/09/02 16:34:45 ET
Table 'summer poker' 9-max (Play Money) Seat #5 is the button
Seat 1: color_singleton (19493 in chips) 
Seat 2: dockstarr (9850 in chips) 
Seat 3: PokerStarsMan12 (8400 in chips) 
Seat 5: manon327 (7735 in chips) 
Seat 6: HighCardJasper (8472 in chips) 
HighCardJasper: posts small blind 50
color_singleton: posts big blind 100
*** HOLE CARDS ***
Dealt to PokerStarsMan12 [Jc 6s]
dockstarr: calls 100
PokerStarsMan12: folds 
manon327: calls 100
HighCardJasper: calls 50
color_singleton: checks 
*** FLOP *** [Ad 5h Ks]
HighCardJasper: checks 
color_singleton: checks 
dockstarr: checks 
manon327: bets 189
HighCardJasper: folds 
color_singleton: calls 189
dockstarr: folds 
*** TURN *** [Ad 5h Ks] [Jh]
color_singleton: checks 
manon327: bets 367
color_singleton: folds 
Uncalled bet (367) returned to manon327
manon327 collected 735 from pot
*** SUMMARY ***
Total pot 778 | Rake 43 
Board [Ad 5h Ks Jh]
Seat 1: color_singleton (big blind) folded on the Turn
Seat 2: dockstarr folded on the Flop
Seat 3: PokerStarsMan12 folded before Flop (didn't bet)
Seat 5: manon327 (button) collected (735)
Seat 6: HighCardJasper (small blind) folded on the Flop



PokerStars Home Game Hand #229541325730: {DaPokaStars}  Hold'em No Limit (50/100) - 2021/09/02 16:35:28 ET
Table 'summer poker' 9-max (Play Money) Seat #6 is the button
Seat 1: color_singleton (19204 in chips) 
Seat 2: dockstarr (9750 in chips) 
Seat 3: PokerStarsMan12 (8400 in chips) 
Seat 5: manon327 (8181 in chips) 
Seat 6: HighCardJasper (8372 in chips) 
color_singleton: posts small blind 50
dockstarr: posts big blind 100
*** HOLE CARDS ***
Dealt to PokerStarsMan12 [Js 2d]
PokerStarsMan12: folds 
manon327: calls 100
HighCardJasper: calls 100
color_singleton: raises 100 to 200
dockstarr: calls 100
manon327: calls 100
HighCardJasper: calls 100
*** FLOP *** [6s 5h 3h]
color_singleton: checks 
dockstarr: checks 
manon327: checks 
HighCardJasper: checks 
*** TURN *** [6s 5h 3h] [6h]
color_singleton: checks 
dockstarr: checks 
manon327: checks 
HighCardJasper: checks 
*** RIVER *** [6s 5h 3h 6h] [4d]
color_singleton: checks 
dockstarr: bets 100
manon327: folds 
HighCardJasper: raises 100 to 200
color_singleton: folds 
dockstarr: calls 100
*** SHOW DOWN ***
HighCardJasper: shows [7s Td] (a straight, Three to Seven)
dockstarr: mucks hand 
HighCardJasper collected 1134 from pot
*** SUMMARY ***
Total pot 1200 | Rake 66 
Board [6s 5h 3h 6h 4d]
Seat 1: color_singleton (small blind) folded on the River
Seat 2: dockstarr (big blind) mucked [Kc Qd]
Seat 3: PokerStarsMan12 folded before Flop (didn't bet)
Seat 5: manon327 folded on the River
Seat 6: HighCardJasper (button) showed [7s Td] and won (1134) with a straight, Three to Seven



PokerStars Home Game Hand #229541377247: {DaPokaStars}  Hold'em No Limit (50/100) - 2021/09/02 16:36:53 ET
Table 'summer poker' 9-max (Play Money) Seat #1 is the button
Seat 1: color_singleton (19004 in chips) 
Seat 2: dockstarr (9350 in chips) 
Seat 3: PokerStarsMan12 (8400 in chips) 
Seat 5: manon327 (7981 in chips) 
Seat 6: HighCardJasper (9106 in chips) 
dockstarr: posts small blind 50
PokerStarsMan12: posts big blind 100
*** HOLE CARDS ***
Dealt to PokerStarsMan12 [5h 6h]
manon327: calls 100
HighCardJasper: calls 100
color_singleton: folds 
dockstarr: calls 50
PokerStarsMan12: checks 
*** FLOP *** [Ad 5s 7c]
dockstarr: checks 
PokerStarsMan12: checks 
manon327: checks 
HighCardJasper: checks 
*** TURN *** [Ad 5s 7c] [As]
dockstarr: checks 
PokerStarsMan12: bets 200
manon327: folds 
HighCardJasper: folds 
dockstarr: folds 
Uncalled bet (200) returned to PokerStarsMan12
PokerStarsMan12 collected 378 from pot
*** SUMMARY ***
Total pot 400 | Rake 22 
Board [Ad 5s 7c As]
Seat 1: color_singleton (button) folded before Flop (didn't bet)
Seat 2: dockstarr (small blind) folded on the Turn
Seat 3: PokerStarsMan12 (big blind) collected (378)
Seat 5: manon327 folded on the Turn
Seat 6: HighCardJasper folded on the Turn



PokerStars Home Game Hand #229541399318: {DaPokaStars}  Hold'em No Limit (50/100) - 2021/09/02 16:37:39 ET
Table 'summer poker' 9-max (Play Money) Seat #2 is the button
Seat 1: color_singleton (19004 in chips) 
Seat 2: dockstarr (9250 in chips) 
Seat 3: PokerStarsMan12 (8678 in chips) 
Seat 5: manon327 (7881 in chips) 
Seat 6: HighCardJasper (9006 in chips) 
PokerStarsMan12: posts small blind 50
manon327: posts big blind 100
*** HOLE CARDS ***
Dealt to PokerStarsMan12 [Kc Th]
HighCardJasper: calls 100
color_singleton: folds 
dockstarr: folds 
PokerStarsMan12: calls 50
manon327: checks 
*** FLOP *** [Tc 8d 2c]
PokerStarsMan12: bets 200
manon327: calls 200
HighCardJasper: folds 
*** TURN *** [Tc 8d 2c] [4h]
PokerStarsMan12: bets 400
manon327: calls 400
*** RIVER *** [Tc 8d 2c 4h] [2d]
PokerStarsMan12: bets 700
manon327: raises 700 to 1400
PokerStarsMan12: calls 700
*** SHOW DOWN ***
manon327: shows [4c 4s] (a full house, Fours full of Deuces)
PokerStarsMan12: mucks hand 
manon327 collected 4063 from pot
*** SUMMARY ***
Total pot 4300 | Rake 237 
Board [Tc 8d 2c 4h 2d]
Seat 1: color_singleton folded before Flop (didn't bet)
Seat 2: dockstarr (button) folded before Flop (didn't bet)
Seat 3: PokerStarsMan12 (small blind) mucked [Kc Th]
Seat 5: manon327 (big blind) showed [4c 4s] and won (4063) with a full house, Fours full of Deuces
Seat 6: HighCardJasper folded on the Flop



PokerStars Home Game Hand #229541430395: {DaPokaStars}  Hold'em No Limit (50/100) - 2021/09/02 16:38:37 ET
Table 'summer poker' 9-max (Play Money) Seat #3 is the button
Seat 1: color_singleton (19004 in chips) 
Seat 2: dockstarr (9250 in chips) 
Seat 3: PokerStarsMan12 (6578 in chips) 
Seat 5: manon327 (9844 in chips) 
Seat 6: HighCardJasper (8906 in chips) 
manon327: posts small blind 50
HighCardJasper: posts big blind 100
*** HOLE CARDS ***
Dealt to PokerStarsMan12 [5c Qh]
color_singleton: folds 
dockstarr: calls 100
PokerStarsMan12: folds 
manon327: calls 50
HighCardJasper: checks 
*** FLOP *** [7h 9d 8s]
manon327: bets 141
HighCardJasper: calls 141
dockstarr: calls 141
*** TURN *** [7h 9d 8s] [3c]
manon327: bets 341
HighCardJasper: folds 
dockstarr: calls 341
*** RIVER *** [7h 9d 8s 3c] [Kc]
manon327: bets 664
dockstarr: folds 
Uncalled bet (664) returned to manon327
manon327 collected 1328 from pot
*** SUMMARY ***
Total pot 1405 | Rake 77 
Board [7h 9d 8s 3c Kc]
Seat 1: color_singleton folded before Flop (didn't bet)
Seat 2: dockstarr folded on the River
Seat 3: PokerStarsMan12 (button) folded before Flop (didn't bet)
Seat 5: manon327 (small blind) collected (1328)
Seat 6: HighCardJasper (big blind) folded on the Turn



PokerStars Home Game Hand #229541449234: {DaPokaStars}  Hold'em No Limit (50/100) - 2021/09/02 16:39:16 ET
Table 'summer poker' 9-max (Play Money) Seat #5 is the button
Seat 1: color_singleton (19004 in chips) 
Seat 2: dockstarr (8668 in chips) 
Seat 3: PokerStarsMan12 (6578 in chips) 
Seat 5: manon327 (10590 in chips) 
Seat 6: HighCardJasper (8665 in chips) 
HighCardJasper: posts small blind 50
color_singleton: posts big blind 100
*** HOLE CARDS ***
Dealt to PokerStarsMan12 [2h Ac]
dockstarr: calls 100
PokerStarsMan12: calls 100
manon327: folds 
HighCardJasper: calls 50
color_singleton: raises 300 to 400
dockstarr: calls 300
PokerStarsMan12: calls 300
HighCardJasper: calls 300
*** FLOP *** [8c 7d Jh]
HighCardJasper: checks 
color_singleton: checks 
dockstarr: checks 
PokerStarsMan12: checks 
*** TURN *** [8c 7d Jh] [2s]
HighCardJasper: checks 
color_singleton: checks 
dockstarr: checks 
PokerStarsMan12: checks 
*** RIVER *** [8c 7d Jh 2s] [3h]
HighCardJasper: checks 
color_singleton: checks 
dockstarr: checks 
PokerStarsMan12: checks 
*** SHOW DOWN ***
HighCardJasper: shows [Tc Ks] (high card King)
color_singleton: shows [Qc Ad] (high card Ace)
dockstarr: shows [Js Qd] (a pair of Jacks)
PokerStarsMan12: mucks hand 
dockstarr collected 1512 from pot
*** SUMMARY ***
Total pot 1600 | Rake 88 
Board [8c 7d Jh 2s 3h]
Seat 1: color_singleton (big blind) showed [Qc Ad] and lost with high card Ace
Seat 2: dockstarr showed [Js Qd] and won (1512) with a pair of Jacks
Seat 3: PokerStarsMan12 mucked [2h Ac]
Seat 5: manon327 (button) folded before Flop (didn't bet)
Seat 6: HighCardJasper (small blind) showed [Tc Ks] and lost with high card King



PokerStars Home Game Hand #229541474159: {DaPokaStars}  Hold'em No Limit (50/100) - 2021/09/02 16:40:08 ET
Table 'summer poker' 9-max (Play Money) Seat #6 is the button
Seat 1: color_singleton (18604 in chips) 
Seat 2: dockstarr (9780 in chips) 
Seat 3: PokerStarsMan12 (6178 in chips) 
Seat 5: manon327 (10590 in chips) 
Seat 6: HighCardJasper (8265 in chips) 
color_singleton: posts small blind 50
dockstarr: posts big blind 100
*** HOLE CARDS ***
Dealt to PokerStarsMan12 [4d As]
PokerStarsMan12: raises 200 to 300
manon327: calls 300
HighCardJasper: calls 300
color_singleton: calls 250
dockstarr: calls 200
*** FLOP *** [4c 8c Th]
color_singleton: checks 
dockstarr: checks 
PokerStarsMan12: checks 
manon327: checks 
HighCardJasper: checks 
*** TURN *** [4c 8c Th] [9h]
color_singleton: checks 
dockstarr: checks 
PokerStarsMan12: checks 
manon327: bets 708
HighCardJasper: folds 
color_singleton: folds 
dockstarr: folds 
PokerStarsMan12: folds 
Uncalled bet (708) returned to manon327
manon327 collected 1417 from pot
*** SUMMARY ***
Total pot 1500 | Rake 83 
Board [4c 8c Th 9h]
Seat 1: color_singleton (small blind) folded on the Turn
Seat 2: dockstarr (big blind) folded on the Turn
Seat 3: PokerStarsMan12 folded on the Turn
Seat 5: manon327 collected (1417)
Seat 6: HighCardJasper (button) folded on the Turn



PokerStars Home Game Hand #229541512637: {DaPokaStars}  Hold'em No Limit (50/100) - 2021/09/02 16:41:28 ET
Table 'summer poker' 9-max (Play Money) Seat #1 is the button
Seat 1: color_singleton (18304 in chips) 
Seat 2: dockstarr (9480 in chips) 
Seat 3: PokerStarsMan12 (5878 in chips) 
Seat 5: manon327 (11707 in chips) 
Seat 6: HighCardJasper (7965 in chips) 
dockstarr: posts small blind 50
PokerStarsMan12: posts big blind 100
*** HOLE CARDS ***
Dealt to PokerStarsMan12 [4c 9h]
manon327: folds 
HighCardJasper: calls 100
color_singleton: calls 100
dockstarr: folds 
PokerStarsMan12: checks 
*** FLOP *** [3c 5c Js]
PokerStarsMan12: checks 
HighCardJasper: checks 
color_singleton: checks 
*** TURN *** [3c 5c Js] [6s]
PokerStarsMan12: bets 200
HighCardJasper: calls 200
color_singleton: calls 200
*** RIVER *** [3c 5c Js 6s] [Tc]
PokerStarsMan12: checks 
HighCardJasper: bets 100
color_singleton: calls 100
PokerStarsMan12: folds 
*** SHOW DOWN ***
HighCardJasper: shows [Jh Ad] (a pair of Jacks)
color_singleton: mucks hand 
HighCardJasper collected 1087 from pot
*** SUMMARY ***
Total pot 1150 | Rake 63 
Board [3c 5c Js 6s Tc]
Seat 1: color_singleton (button) mucked [5d Kd]
Seat 2: dockstarr (small blind) folded before Flop
Seat 3: PokerStarsMan12 (big blind) folded on the River
Seat 5: manon327 folded before Flop (didn't bet)
Seat 6: HighCardJasper showed [Jh Ad] and won (1087) with a pair of Jacks



PokerStars Home Game Hand #229541543393: {DaPokaStars}  Hold'em No Limit (50/100) - 2021/09/02 16:42:32 ET
Table 'summer poker' 9-max (Play Money) Seat #2 is the button
Seat 1: color_singleton (17904 in chips) 
Seat 2: dockstarr (9430 in chips) 
Seat 3: PokerStarsMan12 (5578 in chips) 
Seat 5: manon327 (11707 in chips) 
Seat 6: HighCardJasper (8652 in chips) 
PokerStarsMan12: posts small blind 50
manon327: posts big blind 100
*** HOLE CARDS ***
Dealt to PokerStarsMan12 [Qc 4d]
HighCardJasper: calls 100
color_singleton: raises 300 to 400
dockstarr: calls 400
PokerStarsMan12: folds 
manon327: folds 
HighCardJasper: folds 
*** FLOP *** [6c 9s 2c]
color_singleton: bets 992
dockstarr: folds 
Uncalled bet (992) returned to color_singleton
color_singleton collected 992 from pot
color_singleton: doesn't show hand 
*** SUMMARY ***
Total pot 1050 | Rake 58 
Board [6c 9s 2c]
Seat 1: color_singleton collected (992)
Seat 2: dockstarr (button) folded on the Flop
Seat 3: PokerStarsMan12 (small blind) folded before Flop
Seat 5: manon327 (big blind) folded before Flop
Seat 6: HighCardJasper folded before Flop



PokerStars Home Game Hand #229541563581: {DaPokaStars}  Hold'em No Limit (50/100) - 2021/09/02 16:43:14 ET
Table 'summer poker' 9-max (Play Money) Seat #3 is the button
Seat 1: color_singleton (18496 in chips) 
Seat 2: dockstarr (9030 in chips) 
Seat 3: PokerStarsMan12 (5528 in chips) 
Seat 5: manon327 (11607 in chips) 
Seat 6: HighCardJasper (8552 in chips) 
manon327: posts small blind 50
HighCardJasper: posts big blind 100
*** HOLE CARDS ***
Dealt to PokerStarsMan12 [5h 2d]
color_singleton: raises 200 to 300
dockstarr: calls 300
PokerStarsMan12: folds 
manon327: folds 
HighCardJasper: folds 
*** FLOP *** [2s 5c Ks]
color_singleton: checks 
dockstarr: checks 
*** TURN *** [2s 5c Ks] [5s]
color_singleton: checks 
dockstarr: checks 
*** RIVER *** [2s 5c Ks 5s] [Js]
color_singleton: checks 
dockstarr: checks 
*** SHOW DOWN ***
color_singleton: shows [Qc Th] (a pair of Fives)
dockstarr: shows [8d Ac] (a pair of Fives - Ace kicker)
dockstarr collected 709 from pot
*** SUMMARY ***
Total pot 750 | Rake 41 
Board [2s 5c Ks 5s Js]
Seat 1: color_singleton showed [Qc Th] and lost with a pair of Fives
Seat 2: dockstarr showed [8d Ac] and won (709) with a pair of Fives
Seat 3: PokerStarsMan12 (button) folded before Flop (didn't bet)
Seat 5: manon327 (small blind) folded before Flop
Seat 6: HighCardJasper (big blind) folded before Flop



PokerStars Home Game Hand #229541595427: {DaPokaStars}  Hold'em No Limit (50/100) - 2021/09/02 16:44:02 ET
Table 'summer poker' 9-max (Play Money) Seat #5 is the button
Seat 1: color_singleton (18196 in chips) 
Seat 2: dockstarr (9439 in chips) 
Seat 3: PokerStarsMan12 (5528 in chips) 
Seat 5: manon327 (11557 in chips) 
Seat 6: HighCardJasper (8452 in chips) 
HighCardJasper: posts small blind 50
color_singleton: posts big blind 100
*** HOLE CARDS ***
Dealt to PokerStarsMan12 [Td Kc]
dockstarr: folds 
PokerStarsMan12: raises 200 to 300
manon327: folds 
HighCardJasper: calls 250
color_singleton: calls 200
*** FLOP *** [3d 2d Ah]
HighCardJasper: checks 
color_singleton: bets 425
PokerStarsMan12: folds 
HighCardJasper: folds 
Uncalled bet (425) returned to color_singleton
color_singleton collected 850 from pot
color_singleton: doesn't show hand 
*** SUMMARY ***
Total pot 900 | Rake 50 
Board [3d 2d Ah]
Seat 1: color_singleton (big blind) collected (850)
Seat 2: dockstarr folded before Flop (didn't bet)
Seat 3: PokerStarsMan12 folded on the Flop
Seat 5: manon327 (button) folded before Flop (didn't bet)
Seat 6: HighCardJasper (small blind) folded on the Flop



PokerStars Home Game Hand #229541611198: {DaPokaStars}  Hold'em No Limit (50/100) - 2021/09/02 16:44:35 ET
Table 'summer poker' 9-max (Play Money) Seat #6 is the button
Seat 1: color_singleton (18746 in chips) 
Seat 2: dockstarr (9439 in chips) 
Seat 3: PokerStarsMan12 (5228 in chips) 
Seat 5: manon327 (11557 in chips) 
Seat 6: HighCardJasper (8152 in chips) 
color_singleton: posts small blind 50
dockstarr: posts big blind 100
*** HOLE CARDS ***
Dealt to PokerStarsMan12 [Ts 6h]
PokerStarsMan12: folds 
manon327: folds 
HighCardJasper: calls 100
color_singleton: raises 200 to 300
dockstarr: folds 
HighCardJasper: folds 
Uncalled bet (200) returned to color_singleton
color_singleton collected 300 from pot
color_singleton: doesn't show hand 
*** SUMMARY ***
Total pot 300 | Rake 0 
Seat 1: color_singleton (small blind) collected (300)
Seat 2: dockstarr (big blind) folded before Flop
Seat 3: PokerStarsMan12 folded before Flop (didn't bet)
Seat 5: manon327 folded before Flop (didn't bet)
Seat 6: HighCardJasper (button) folded before Flop



PokerStars Home Game Hand #229541616802: {DaPokaStars}  Hold'em No Limit (50/100) - 2021/09/02 16:44:46 ET
Table 'summer poker' 9-max (Play Money) Seat #1 is the button
Seat 1: color_singleton (18946 in chips) 
Seat 2: dockstarr (9339 in chips) 
Seat 3: PokerStarsMan12 (5228 in chips) 
Seat 5: manon327 (11557 in chips) 
Seat 6: HighCardJasper (8052 in chips) 
dockstarr: posts small blind 50
PokerStarsMan12: posts big blind 100
*** HOLE CARDS ***
Dealt to PokerStarsMan12 [5c 7s]
manon327: calls 100
HighCardJasper: calls 100
color_singleton: calls 100
dockstarr: folds 
PokerStarsMan12: checks 
*** FLOP *** [As 5d Qh]
PokerStarsMan12: checks 
manon327: checks 
HighCardJasper: checks 
color_singleton: checks 
*** TURN *** [As 5d Qh] [3h]
PokerStarsMan12: bets 212
manon327: folds 
HighCardJasper: folds 
color_singleton: calls 212
*** RIVER *** [As 5d Qh 3h] [7h]
PokerStarsMan12: bets 413
color_singleton: raises 413 to 826
PokerStarsMan12: calls 413
*** SHOW DOWN ***
color_singleton: shows [7c 5s] (two pair, Sevens and Fives)
PokerStarsMan12: shows [5c 7s] (two pair, Sevens and Fives)
PokerStarsMan12 collected 1194 from pot
color_singleton collected 1193 from pot
*** SUMMARY ***
Total pot 2526 | Rake 139 
Board [As 5d Qh 3h 7h]
Seat 1: color_singleton (button) showed [7c 5s] and won (1193) with two pair, Sevens and Fives
Seat 2: dockstarr (small blind) folded before Flop
Seat 3: PokerStarsMan12 (big blind) showed [5c 7s] and won (1194) with two pair, Sevens and Fives
Seat 5: manon327 folded on the Turn
Seat 6: HighCardJasper folded on the Turn



PokerStars Home Game Hand #229541642651: {DaPokaStars}  Hold'em No Limit (50/100) - 2021/09/02 16:45:39 ET
Table 'summer poker' 9-max (Play Money) Seat #2 is the button
Seat 1: color_singleton (19001 in chips) 
Seat 2: dockstarr (9289 in chips) 
Seat 3: PokerStarsMan12 (5284 in chips) 
Seat 5: manon327 (11457 in chips) 
Seat 6: HighCardJasper (7952 in chips) 
PokerStarsMan12: posts small blind 50
manon327: posts big blind 100
*** HOLE CARDS ***
Dealt to PokerStarsMan12 [9d 6d]
HighCardJasper: folds 
color_singleton: calls 100
dockstarr: folds 
PokerStarsMan12: calls 50
manon327: checks 
*** FLOP *** [5s Jh 7h]
PokerStarsMan12: checks 
manon327: bets 100
color_singleton: calls 100
PokerStarsMan12: folds 
*** TURN *** [5s Jh 7h] [2c]
manon327: bets 236
color_singleton: folds 
Uncalled bet (236) returned to manon327
manon327 collected 472 from pot
*** SUMMARY ***
Total pot 500 | Rake 28 
Board [5s Jh 7h 2c]
Seat 1: color_singleton folded on the Turn
Seat 2: dockstarr (button) folded before Flop (didn't bet)
Seat 3: PokerStarsMan12 (small blind) folded on the Flop
Seat 5: manon327 (big blind) collected (472)
Seat 6: HighCardJasper folded before Flop (didn't bet)



PokerStars Home Game Hand #229541659024: {DaPokaStars}  Hold'em No Limit (50/100) - 2021/09/02 16:46:13 ET
Table 'summer poker' 9-max (Play Money) Seat #3 is the button
Seat 1: color_singleton (18801 in chips) 
Seat 2: dockstarr (9289 in chips) 
Seat 3: PokerStarsMan12 (5184 in chips) 
Seat 5: manon327 (11729 in chips) 
Seat 6: HighCardJasper (7952 in chips) 
manon327: posts small blind 50
HighCardJasper: posts big blind 100
*** HOLE CARDS ***
Dealt to PokerStarsMan12 [8d 5c]
color_singleton: raises 200 to 300
dockstarr: calls 300
PokerStarsMan12: folds 
manon327: calls 250
HighCardJasper: calls 200
*** FLOP *** [Qd 4c 5s]
manon327: checks 
HighCardJasper: checks 
color_singleton: checks 
dockstarr: checks 
*** TURN *** [Qd 4c 5s] [3s]
manon327: bets 567
HighCardJasper: folds 
color_singleton: folds 
dockstarr: folds 
Uncalled bet (567) returned to manon327
manon327 collected 1134 from pot
*** SUMMARY ***
Total pot 1200 | Rake 66 
Board [Qd 4c 5s 3s]
Seat 1: color_singleton folded on the Turn
Seat 2: dockstarr folded on the Turn
Seat 3: PokerStarsMan12 (button) folded before Flop (didn't bet)
Seat 5: manon327 (small blind) collected (1134)
Seat 6: HighCardJasper (big blind) folded on the Turn



PokerStars Home Game Hand #229541686640: {DaPokaStars}  Hold'em No Limit (50/100) - 2021/09/02 16:47:08 ET
Table 'summer poker' 9-max (Play Money) Seat #5 is the button
Seat 1: color_singleton (18501 in chips) 
Seat 2: dockstarr (8989 in chips) 
Seat 3: PokerStarsMan12 (5184 in chips) 
Seat 5: manon327 (12563 in chips) 
Seat 6: HighCardJasper (7652 in chips) 
HighCardJasper: posts small blind 50
color_singleton: posts big blind 100
*** HOLE CARDS ***
Dealt to PokerStarsMan12 [Tc Qd]
dockstarr: folds 
PokerStarsMan12: raises 200 to 300
manon327: calls 300
HighCardJasper: calls 250
color_singleton: calls 200
*** FLOP *** [Td 5d 4h]
HighCardJasper: checks 
color_singleton: bets 567
PokerStarsMan12: calls 567
manon327: folds 
HighCardJasper: folds 
*** TURN *** [Td 5d 4h] [2s]
color_singleton: bets 1103
PokerStarsMan12: calls 1103
*** RIVER *** [Td 5d 4h 2s] [Qs]
color_singleton: checks 
PokerStarsMan12: bets 3214 and is all-in
color_singleton: folds 
Uncalled bet (3214) returned to PokerStarsMan12
PokerStarsMan12 collected 4290 from pot
*** SUMMARY ***
Total pot 4540 | Rake 250 
Board [Td 5d 4h 2s Qs]
Seat 1: color_singleton (big blind) folded on the River
Seat 2: dockstarr folded before Flop (didn't bet)
Seat 3: PokerStarsMan12 collected (4290)
Seat 5: manon327 (button) folded on the Flop
Seat 6: HighCardJasper (small blind) folded on the Flop



PokerStars Home Game Hand #229541724294: {DaPokaStars}  Hold'em No Limit (50/100) - 2021/09/02 16:48:17 ET
Table 'summer poker' 9-max (Play Money) Seat #6 is the button
Seat 1: color_singleton (16531 in chips) 
Seat 2: dockstarr (8989 in chips) 
Seat 3: PokerStarsMan12 (7504 in chips) 
Seat 5: manon327 (12263 in chips) 
Seat 6: HighCardJasper (7352 in chips) 
color_singleton: posts small blind 50
dockstarr: posts big blind 100
*** HOLE CARDS ***
Dealt to PokerStarsMan12 [Jc 7s]
PokerStarsMan12: folds 
manon327: folds 
HighCardJasper: calls 100
color_singleton: raises 200 to 300
dockstarr: calls 200
HighCardJasper: calls 200
*** FLOP *** [6d 4d 9h]
color_singleton: checks 
dockstarr: checks 
HighCardJasper: checks 
*** TURN *** [6d 4d 9h] [4c]
color_singleton: bets 425
dockstarr: folds 
HighCardJasper: calls 425
*** RIVER *** [6d 4d 9h 4c] [Qd]
color_singleton: checks 
HighCardJasper: bets 400
color_singleton: folds 
Uncalled bet (400) returned to HighCardJasper
HighCardJasper collected 1654 from pot
HighCardJasper: doesn't show hand 
*** SUMMARY ***
Total pot 1750 | Rake 96 
Board [6d 4d 9h 4c Qd]
Seat 1: color_singleton (small blind) folded on the River
Seat 2: dockstarr (big blind) folded on the Turn
Seat 3: PokerStarsMan12 folded before Flop (didn't bet)
Seat 5: manon327 folded before Flop (didn't bet)
Seat 6: HighCardJasper (button) collected (1654)



PokerStars Home Game Hand #229541751486: {DaPokaStars}  Hold'em No Limit (50/100) - 2021/09/02 16:49:12 ET
Table 'summer poker' 9-max (Play Money) Seat #1 is the button
Seat 1: color_singleton (15806 in chips) 
Seat 2: dockstarr (8689 in chips) 
Seat 3: PokerStarsMan12 (7504 in chips) 
Seat 5: manon327 (12263 in chips) 
Seat 6: HighCardJasper (8281 in chips) 
dockstarr: posts small blind 50
PokerStarsMan12: posts big blind 100
*** HOLE CARDS ***
Dealt to PokerStarsMan12 [4h 3s]
manon327: calls 100
HighCardJasper: calls 100
color_singleton: raises 300 to 400
dockstarr: folds 
PokerStarsMan12: folds 
manon327: calls 300
HighCardJasper: folds 
*** FLOP *** [9s Tc Th]
manon327: checks 
color_singleton: bets 496
manon327: folds 
Uncalled bet (496) returned to color_singleton
color_singleton collected 992 from pot
color_singleton: doesn't show hand 
*** SUMMARY ***
Total pot 1050 | Rake 58 
Board [9s Tc Th]
Seat 1: color_singleton (button) collected (992)
Seat 2: dockstarr (small blind) folded before Flop
Seat 3: PokerStarsMan12 (big blind) folded before Flop
Seat 5: manon327 folded on the Flop
Seat 6: HighCardJasper folded before Flop



PokerStars Home Game Hand #229541774301: {DaPokaStars}  Hold'em No Limit (50/100) - 2021/09/02 16:49:59 ET
Table 'summer poker' 9-max (Play Money) Seat #2 is the button
Seat 1: color_singleton (16398 in chips) 
Seat 2: dockstarr (8639 in chips) 
Seat 3: PokerStarsMan12 (7404 in chips) 
Seat 5: manon327 (11863 in chips) 
Seat 6: HighCardJasper (8181 in chips) 
PokerStarsMan12: posts small blind 50
manon327: posts big blind 100
*** HOLE CARDS ***
Dealt to PokerStarsMan12 [2s 8d]
HighCardJasper: folds 
color_singleton: raises 200 to 300
dockstarr: folds 
PokerStarsMan12: folds 
manon327: calls 200
*** FLOP *** [7d 2c Qh]
manon327: checks 
color_singleton: checks 
*** TURN *** [7d 2c Qh] [8h]
manon327: checks 
color_singleton: checks 
*** RIVER *** [7d 2c Qh 8h] [7s]
manon327: checks 
color_singleton: checks 
*** SHOW DOWN ***
manon327: shows [Kh 3s] (a pair of Sevens)
color_singleton: mucks hand 
manon327 collected 614 from pot
*** SUMMARY ***
Total pot 650 | Rake 36 
Board [7d 2c Qh 8h 7s]
Seat 1: color_singleton mucked [Ts Jc]
Seat 2: dockstarr (button) folded before Flop (didn't bet)
Seat 3: PokerStarsMan12 (small blind) folded before Flop
Seat 5: manon327 (big blind) showed [Kh 3s] and won (614) with a pair of Sevens
Seat 6: HighCardJasper folded before Flop (didn't bet)



PokerStars Home Game Hand #229541786898: {DaPokaStars}  Hold'em No Limit (50/100) - 2021/09/02 16:50:24 ET
Table 'summer poker' 9-max (Play Money) Seat #3 is the button
Seat 1: color_singleton (16098 in chips) 
Seat 2: dockstarr (8639 in chips) 
Seat 3: PokerStarsMan12 (7354 in chips) 
Seat 5: manon327 (12177 in chips) 
Seat 6: HighCardJasper (8181 in chips) 
manon327: posts small blind 50
HighCardJasper: posts big blind 100
*** HOLE CARDS ***
Dealt to PokerStarsMan12 [6s 3d]
color_singleton: raises 200 to 300
dockstarr: folds 
PokerStarsMan12: folds 
manon327: calls 250
HighCardJasper: calls 200
*** FLOP *** [8c 2h Jh]
manon327: bets 425
HighCardJasper: calls 425
color_singleton: calls 425
*** TURN *** [8c 2h Jh] [Ks]
manon327: checks 
HighCardJasper: checks 
color_singleton: checks 
*** RIVER *** [8c 2h Jh Ks] [8s]
manon327: bets 1027
HighCardJasper: folds 
color_singleton: folds 
Uncalled bet (1027) returned to manon327
manon327 collected 2055 from pot
*** SUMMARY ***
Total pot 2175 | Rake 120 
Board [8c 2h Jh Ks 8s]
Seat 1: color_singleton folded on the River
Seat 2: dockstarr folded before Flop (didn't bet)
Seat 3: PokerStarsMan12 (button) folded before Flop (didn't bet)
Seat 5: manon327 (small blind) collected (2055)
Seat 6: HighCardJasper (big blind) folded on the River



PokerStars Home Game Hand #229541807843: {DaPokaStars}  Hold'em No Limit (50/100) - 2021/09/02 16:51:08 ET
Table 'summer poker' 9-max (Play Money) Seat #5 is the button
Seat 1: color_singleton (15373 in chips) 
Seat 2: dockstarr (8639 in chips) 
Seat 3: PokerStarsMan12 (7354 in chips) 
Seat 5: manon327 (13507 in chips) 
Seat 6: HighCardJasper (7456 in chips) 
HighCardJasper: posts small blind 50
color_singleton: posts big blind 100
*** HOLE CARDS ***
Dealt to PokerStarsMan12 [Qh 3s]
dockstarr: folds 
PokerStarsMan12: folds 
manon327: calls 100
HighCardJasper: calls 50
color_singleton: checks 
*** FLOP *** [5c As Jc]
HighCardJasper: checks 
color_singleton: checks 
manon327: checks 
*** TURN *** [5c As Jc] [Qd]
HighCardJasper: checks 
color_singleton: checks 
manon327: bets 141
HighCardJasper: folds 
color_singleton: folds 
Uncalled bet (141) returned to manon327
manon327 collected 283 from pot
*** SUMMARY ***
Total pot 300 | Rake 17 
Board [5c As Jc Qd]
Seat 1: color_singleton (big blind) folded on the Turn
Seat 2: dockstarr folded before Flop (didn't bet)
Seat 3: PokerStarsMan12 folded before Flop (didn't bet)
Seat 5: manon327 (button) collected (283)
Seat 6: HighCardJasper (small blind) folded on the Turn



PokerStars Home Game Hand #229541826655: {DaPokaStars}  Hold'em No Limit (50/100) - 2021/09/02 16:51:45 ET
Table 'summer poker' 9-max (Play Money) Seat #6 is the button
Seat 1: color_singleton (15273 in chips) 
Seat 2: dockstarr (8639 in chips) 
Seat 3: PokerStarsMan12 (7354 in chips) 
Seat 5: manon327 (13690 in chips) 
Seat 6: HighCardJasper (7356 in chips) 
color_singleton: posts small blind 50
dockstarr: posts big blind 100
*** HOLE CARDS ***
Dealt to PokerStarsMan12 [6h Kc]
PokerStarsMan12: folds 
manon327: calls 100
HighCardJasper: folds 
color_singleton: raises 200 to 300
dockstarr: folds 
manon327: calls 200
*** FLOP *** [4c 8h 2h]
color_singleton: bets 330
manon327: folds 
Uncalled bet (330) returned to color_singleton
color_singleton collected 661 from pot
color_singleton: doesn't show hand 
*** SUMMARY ***
Total pot 700 | Rake 39 
Board [4c 8h 2h]
Seat 1: color_singleton (small blind) collected (661)
Seat 2: dockstarr (big blind) folded before Flop
Seat 3: PokerStarsMan12 folded before Flop (didn't bet)
Seat 5: manon327 folded on the Flop
Seat 6: HighCardJasper (button) folded before Flop (didn't bet)



PokerStars Home Game Hand #229541838485: {DaPokaStars}  Hold'em No Limit (50/100) - 2021/09/02 16:52:10 ET
Table 'summer poker' 9-max (Play Money) Seat #1 is the button
Seat 1: color_singleton (15634 in chips) 
Seat 2: dockstarr (8539 in chips) 
Seat 3: PokerStarsMan12 (7354 in chips) 
Seat 5: manon327 (13390 in chips) 
Seat 6: HighCardJasper (7356 in chips) 
dockstarr: posts small blind 50
PokerStarsMan12: posts big blind 100
*** HOLE CARDS ***
Dealt to PokerStarsMan12 [Kc 8h]
manon327: calls 100
HighCardJasper: calls 100
color_singleton: folds 
dockstarr: calls 50
PokerStarsMan12: checks 
*** FLOP *** [Ks 7s 5s]
dockstarr: checks 
PokerStarsMan12: bets 300
manon327: calls 300
HighCardJasper: folds 
dockstarr: folds 
*** TURN *** [Ks 7s 5s] [Ah]
PokerStarsMan12: checks 
manon327: checks 
*** RIVER *** [Ks 7s 5s Ah] [4d]
PokerStarsMan12: checks 
manon327: checks 
*** SHOW DOWN ***
PokerStarsMan12: shows [Kc 8h] (a pair of Kings)
manon327: mucks hand 
PokerStarsMan12 collected 945 from pot
*** SUMMARY ***
Total pot 1000 | Rake 55 
Board [Ks 7s 5s Ah 4d]
Seat 1: color_singleton (button) folded before Flop (didn't bet)
Seat 2: dockstarr (small blind) folded on the Flop
Seat 3: PokerStarsMan12 (big blind) showed [Kc 8h] and won (945) with a pair of Kings
Seat 5: manon327 mucked [Qh 4c]
Seat 6: HighCardJasper folded on the Flop



PokerStars Home Game Hand #229541869707: {DaPokaStars}  Hold'em No Limit (50/100) - 2021/09/02 16:53:14 ET
Table 'summer poker' 9-max (Play Money) Seat #2 is the button
Seat 1: color_singleton (15634 in chips) 
Seat 2: dockstarr (8439 in chips) 
Seat 3: PokerStarsMan12 (7899 in chips) 
Seat 5: manon327 (12990 in chips) 
Seat 6: HighCardJasper (7256 in chips) 
PokerStarsMan12: posts small blind 50
manon327: posts big blind 100
*** HOLE CARDS ***
Dealt to PokerStarsMan12 [2d 9c]
HighCardJasper: folds 
color_singleton: raises 200 to 300
dockstarr: folds 
PokerStarsMan12: folds 
manon327: folds 
Uncalled bet (200) returned to color_singleton
color_singleton collected 250 from pot
color_singleton: doesn't show hand 
*** SUMMARY ***
Total pot 250 | Rake 0 
Seat 1: color_singleton collected (250)
Seat 2: dockstarr (button) folded before Flop (didn't bet)
Seat 3: PokerStarsMan12 (small blind) folded before Flop
Seat 5: manon327 (big blind) folded before Flop
Seat 6: HighCardJasper folded before Flop (didn't bet)



PokerStars Home Game Hand #229541882648: {DaPokaStars}  Hold'em No Limit (50/100) - 2021/09/02 16:53:41 ET
Table 'summer poker' 9-max (Play Money) Seat #3 is the button
Seat 1: color_singleton (15784 in chips) 
Seat 2: dockstarr (8439 in chips) 
Seat 3: PokerStarsMan12 (7849 in chips) 
Seat 5: manon327 (12890 in chips) 
Seat 6: HighCardJasper (7256 in chips) 
manon327: posts small blind 50
HighCardJasper: posts big blind 100
*** HOLE CARDS ***
Dealt to PokerStarsMan12 [5c 8s]
color_singleton: folds 
dockstarr: folds 
PokerStarsMan12: folds 
manon327: raises 100 to 200
HighCardJasper: folds 
Uncalled bet (100) returned to manon327
manon327 collected 200 from pot
*** SUMMARY ***
Total pot 200 | Rake 0 
Seat 1: color_singleton folded before Flop (didn't bet)
Seat 2: dockstarr folded before Flop (didn't bet)
Seat 3: PokerStarsMan12 (button) folded before Flop (didn't bet)
Seat 5: manon327 (small blind) collected (200)
Seat 6: HighCardJasper (big blind) folded before Flop



PokerStars Home Game Hand #229541888589: {DaPokaStars}  Hold'em No Limit (50/100) - 2021/09/02 16:53:53 ET
Table 'summer poker' 9-max (Play Money) Seat #5 is the button
Seat 1: color_singleton (15784 in chips) 
Seat 2: dockstarr (8439 in chips) 
Seat 3: PokerStarsMan12 (7849 in chips) 
Seat 5: manon327 (12990 in chips) 
Seat 6: HighCardJasper (7156 in chips) 
HighCardJasper: posts small blind 50
color_singleton: posts big blind 100
*** HOLE CARDS ***
Dealt to PokerStarsMan12 [4c 4h]
dockstarr: folds 
PokerStarsMan12: raises 200 to 300
manon327: calls 300
HighCardJasper: folds 
color_singleton: raises 500 to 800
PokerStarsMan12: calls 500
manon327: calls 500
*** FLOP *** [Td 7s 5s]
color_singleton: bets 2315
PokerStarsMan12: folds 
manon327: folds 
Uncalled bet (2315) returned to color_singleton
color_singleton collected 2315 from pot
color_singleton: doesn't show hand 
*** SUMMARY ***
Total pot 2450 | Rake 135 
Board [Td 7s 5s]
Seat 1: color_singleton (big blind) collected (2315)
Seat 2: dockstarr folded before Flop (didn't bet)
Seat 3: PokerStarsMan12 folded on the Flop
Seat 5: manon327 (button) folded on the Flop
Seat 6: HighCardJasper (small blind) folded before Flop



PokerStars Home Game Hand #229541904441: {DaPokaStars}  Hold'em No Limit (50/100) - 2021/09/02 16:54:26 ET
Table 'summer poker' 9-max (Play Money) Seat #6 is the button
Seat 1: color_singleton (17299 in chips) 
Seat 2: dockstarr (8439 in chips) 
Seat 3: PokerStarsMan12 (7049 in chips) 
Seat 5: manon327 (12190 in chips) 
Seat 6: HighCardJasper (7106 in chips) 
color_singleton: posts small blind 50
dockstarr: posts big blind 100
*** HOLE CARDS ***
Dealt to PokerStarsMan12 [4d 8h]
PokerStarsMan12: folds 
manon327: folds 
HighCardJasper: calls 100
color_singleton: folds 
dockstarr: checks 
*** FLOP *** [9d Tc 2h]
dockstarr: checks 
HighCardJasper: bets 100
dockstarr: folds 
Uncalled bet (100) returned to HighCardJasper
HighCardJasper collected 236 from pot
HighCardJasper: doesn't show hand 
*** SUMMARY ***
Total pot 250 | Rake 14 
Board [9d Tc 2h]
Seat 1: color_singleton (small blind) folded before Flop
Seat 2: dockstarr (big blind) folded on the Flop
Seat 3: PokerStarsMan12 folded before Flop (didn't bet)
Seat 5: manon327 folded before Flop (didn't bet)
Seat 6: HighCardJasper (button) collected (236)



PokerStars Home Game Hand #229541913561: {DaPokaStars}  Hold'em No Limit (50/100) - 2021/09/02 16:54:45 ET
Table 'summer poker' 9-max (Play Money) Seat #1 is the button
Seat 1: color_singleton (17249 in chips) 
Seat 2: dockstarr (8339 in chips) 
Seat 3: PokerStarsMan12 (7049 in chips) 
Seat 5: manon327 (12190 in chips) 
Seat 6: HighCardJasper (7242 in chips) 
dockstarr: posts small blind 50
PokerStarsMan12: posts big blind 100
*** HOLE CARDS ***
Dealt to PokerStarsMan12 [Ad 5c]
manon327: folds 
HighCardJasper: folds 
color_singleton: folds 
dockstarr: calls 50
PokerStarsMan12: checks 
*** FLOP *** [8c 9c Tc]
dockstarr: bets 100
PokerStarsMan12: calls 100
*** TURN *** [8c 9c Tc] [Kc]
dockstarr: checks 
PokerStarsMan12: bets 200
dockstarr: calls 200
*** RIVER *** [8c 9c Tc Kc] [5h]
dockstarr: checks 
PokerStarsMan12: checks 
*** SHOW DOWN ***
dockstarr: shows [9h 9d] (three of a kind, Nines)
PokerStarsMan12: shows [Ad 5c] (a flush, King high)
PokerStarsMan12 collected 756 from pot
*** SUMMARY ***
Total pot 800 | Rake 44 
Board [8c 9c Tc Kc 5h]
Seat 1: color_singleton (button) folded before Flop (didn't bet)
Seat 2: dockstarr (small blind) showed [9h 9d] and lost with three of a kind, Nines
Seat 3: PokerStarsMan12 (big blind) showed [Ad 5c] and won (756) with a flush, King high
Seat 5: manon327 folded before Flop (didn't bet)
Seat 6: HighCardJasper folded before Flop (didn't bet)



PokerStars Home Game Hand #229541928463: {DaPokaStars}  Hold'em No Limit (50/100) - 2021/09/02 16:55:20 ET
Table 'summer poker' 9-max (Play Money) Seat #2 is the button
Seat 1: color_singleton (17249 in chips) 
Seat 2: dockstarr (7939 in chips) 
Seat 3: PokerStarsMan12 (7405 in chips) 
Seat 5: manon327 (12190 in chips) 
Seat 6: HighCardJasper (7242 in chips) 
PokerStarsMan12: posts small blind 50
manon327: posts big blind 100
*** HOLE CARDS ***
Dealt to PokerStarsMan12 [Kd 2s]
HighCardJasper: calls 100
color_singleton: raises 200 to 300
dockstarr: folds 
PokerStarsMan12: folds 
manon327: calls 200
HighCardJasper: calls 200
*** FLOP *** [Qc 5s 2c]
manon327: bets 449
HighCardJasper: calls 449
color_singleton: calls 449
*** TURN *** [Qc 5s 2c] [Ac]
manon327: checks 
HighCardJasper: checks 
color_singleton: bets 1085
manon327: folds 
HighCardJasper: folds 
Uncalled bet (1085) returned to color_singleton
color_singleton collected 2171 from pot
color_singleton: doesn't show hand 
*** SUMMARY ***
Total pot 2297 | Rake 126 
Board [Qc 5s 2c Ac]
Seat 1: color_singleton collected (2171)
Seat 2: dockstarr (button) folded before Flop (didn't bet)
Seat 3: PokerStarsMan12 (small blind) folded before Flop
Seat 5: manon327 (big blind) folded on the Turn
Seat 6: HighCardJasper folded on the Turn



PokerStars Home Game Hand #229541948538: {DaPokaStars}  Hold'em No Limit (50/100) - 2021/09/02 16:56:18 ET
Table 'summer poker' 9-max (Play Money) Seat #3 is the button
Seat 1: color_singleton (18671 in chips) 
Seat 2: dockstarr (7939 in chips) 
Seat 3: PokerStarsMan12 (7355 in chips) 
Seat 5: manon327 (11441 in chips) 
Seat 6: HighCardJasper (6493 in chips) 
manon327: posts small blind 50
HighCardJasper: posts big blind 100
*** HOLE CARDS ***
Dealt to PokerStarsMan12 [Qh Jc]
color_singleton: raises 200 to 300
dockstarr: calls 300
PokerStarsMan12: calls 300
manon327: folds 
HighCardJasper: folds 
*** FLOP *** [9h 3c 6s]
color_singleton: bets 992
dockstarr: folds 
PokerStarsMan12: folds 
Uncalled bet (992) returned to color_singleton
color_singleton collected 992 from pot
color_singleton: doesn't show hand 
*** SUMMARY ***
Total pot 1050 | Rake 58 
Board [9h 3c 6s]
Seat 1: color_singleton collected (992)
Seat 2: dockstarr folded on the Flop
Seat 3: PokerStarsMan12 (button) folded on the Flop
Seat 5: manon327 (small blind) folded before Flop
Seat 6: HighCardJasper (big blind) folded before Flop



PokerStars Home Game Hand #229541962250: {DaPokaStars}  Hold'em No Limit (50/100) - 2021/09/02 16:56:57 ET
Table 'summer poker' 9-max (Play Money) Seat #5 is the button
Seat 1: color_singleton (19363 in chips) 
Seat 2: dockstarr (7639 in chips) 
Seat 3: PokerStarsMan12 (7055 in chips) 
Seat 5: manon327 (11391 in chips) 
Seat 6: HighCardJasper (6393 in chips) 
HighCardJasper: posts small blind 50
color_singleton: posts big blind 100
*** HOLE CARDS ***
Dealt to PokerStarsMan12 [Th 2h]
dockstarr: folds 
PokerStarsMan12: folds 
manon327: calls 100
HighCardJasper: calls 50
color_singleton: checks 
*** FLOP *** [Ad 5c 8s]
HighCardJasper: checks 
color_singleton: checks 
manon327: checks 
*** TURN *** [Ad 5c 8s] [As]
HighCardJasper: checks 
color_singleton: checks 
manon327: checks 
*** RIVER *** [Ad 5c 8s As] [9c]
HighCardJasper: checks 
color_singleton: bets 200
manon327: calls 200
HighCardJasper: folds 
*** SHOW DOWN ***
color_singleton: shows [Qc 9h] (two pair, Aces and Nines)
manon327: shows [9d Kh] (two pair, Aces and Nines - King kicker)
manon327 collected 661 from pot
*** SUMMARY ***
Total pot 700 | Rake 39 
Board [Ad 5c 8s As 9c]
Seat 1: color_singleton (big blind) showed [Qc 9h] and lost with two pair, Aces and Nines
Seat 2: dockstarr folded before Flop (didn't bet)
Seat 3: PokerStarsMan12 folded before Flop (didn't bet)
Seat 5: manon327 (button) showed [9d Kh] and won (661) with two pair, Aces and Nines
Seat 6: HighCardJasper (small blind) folded on the River



PokerStars Home Game Hand #229541983422: {DaPokaStars}  Hold'em No Limit (50/100) - 2021/09/02 16:57:57 ET
Table 'summer poker' 9-max (Play Money) Seat #6 is the button
Seat 1: color_singleton (19063 in chips) 
Seat 2: dockstarr (7639 in chips) 
Seat 3: PokerStarsMan12 (7055 in chips) 
Seat 5: manon327 (11752 in chips) 
Seat 6: HighCardJasper (6293 in chips) 
color_singleton: posts small blind 50
dockstarr: posts big blind 100
*** HOLE CARDS ***
Dealt to PokerStarsMan12 [5h 8c]
PokerStarsMan12: folds 
manon327: calls 100
HighCardJasper: calls 100
color_singleton: calls 50
dockstarr: checks 
*** FLOP *** [6c 9c 7c]
color_singleton: bets 378
dockstarr: folds 
manon327: calls 378
HighCardJasper: folds 
*** TURN *** [6c 9c 7c] [3s]
color_singleton: bets 546
manon327: calls 546
*** RIVER *** [6c 9c 7c 3s] [Ad]
color_singleton: checks 
manon327: bets 2124
color_singleton: folds 
Uncalled bet (2124) returned to manon327
manon327 collected 2124 from pot
*** SUMMARY ***
Total pot 2248 | Rake 124 
Board [6c 9c 7c 3s Ad]
Seat 1: color_singleton (small blind) folded on the River
Seat 2: dockstarr (big blind) folded on the Flop
Seat 3: PokerStarsMan12 folded before Flop (didn't bet)
Seat 5: manon327 collected (2124)
Seat 6: HighCardJasper (button) folded on the Flop



PokerStars Home Game Hand #229542012347: {DaPokaStars}  Hold'em No Limit (50/100) - 2021/09/02 16:59:20 ET
Table 'summer poker' 9-max (Play Money) Seat #1 is the button
Seat 1: color_singleton (18039 in chips) 
Seat 2: dockstarr (7539 in chips) 
Seat 3: PokerStarsMan12 (7055 in chips) 
Seat 5: manon327 (12852 in chips) 
Seat 6: HighCardJasper (6193 in chips) 
dockstarr: posts small blind 50
PokerStarsMan12: posts big blind 100
*** HOLE CARDS ***
Dealt to PokerStarsMan12 [Td 7c]
manon327: calls 100
HighCardJasper: calls 100
color_singleton: raises 300 to 400
dockstarr: folds 
PokerStarsMan12: folds 
manon327: calls 300
HighCardJasper: folds 
*** FLOP *** [Kh Ad 5c]
manon327: checks 
color_singleton: checks 
*** TURN *** [Kh Ad 5c] [9d]
manon327: checks 
color_singleton: bets 496
manon327: folds 
Uncalled bet (496) returned to color_singleton
color_singleton collected 992 from pot
color_singleton: doesn't show hand 
*** SUMMARY ***
Total pot 1050 | Rake 58 
Board [Kh Ad 5c 9d]
Seat 1: color_singleton (button) collected (992)
Seat 2: dockstarr (small blind) folded before Flop
Seat 3: PokerStarsMan12 (big blind) folded before Flop
Seat 5: manon327 folded on the Turn
Seat 6: HighCardJasper folded before Flop



PokerStars Home Game Hand #229542027027: {DaPokaStars}  Hold'em No Limit (50/100) - 2021/09/02 17:00:02 ET
Table 'summer poker' 9-max (Play Money) Seat #2 is the button
Seat 1: color_singleton (18631 in chips) 
Seat 2: dockstarr (7489 in chips) 
Seat 3: PokerStarsMan12 (6955 in chips) 
Seat 5: manon327 (12452 in chips) 
Seat 6: HighCardJasper (6093 in chips) 
PokerStarsMan12: posts small blind 50
manon327: posts big blind 100
*** HOLE CARDS ***
Dealt to PokerStarsMan12 [Th 5c]
HighCardJasper: calls 100
color_singleton: calls 100
dockstarr: calls 100
PokerStarsMan12: calls 50
manon327: checks 
*** FLOP *** [Qs 8d Jc]
PokerStarsMan12: checks 
manon327: checks 
HighCardJasper: checks 
color_singleton: checks 
dockstarr: checks 
*** TURN *** [Qs 8d Jc] [5d]
PokerStarsMan12: checks 
manon327: checks 
HighCardJasper: checks 
color_singleton: bets 236
dockstarr: folds 
PokerStarsMan12: folds 
manon327: folds 
HighCardJasper: folds 
Uncalled bet (236) returned to color_singleton
color_singleton collected 472 from pot
color_singleton: doesn't show hand 
*** SUMMARY ***
Total pot 500 | Rake 28 
Board [Qs 8d Jc 5d]
Seat 1: color_singleton collected (472)
Seat 2: dockstarr (button) folded on the Turn
Seat 3: PokerStarsMan12 (small blind) folded on the Turn
Seat 5: manon327 (big blind) folded on the Turn
Seat 6: HighCardJasper folded on the Turn



PokerStars Home Game Hand #229542051233: {DaPokaStars}  Hold'em No Limit (50/100) - 2021/09/02 17:01:06 ET
Table 'summer poker' 9-max (Play Money) Seat #3 is the button
Seat 1: color_singleton (19003 in chips) 
Seat 2: dockstarr (7389 in chips) 
Seat 3: PokerStarsMan12 (6855 in chips) 
Seat 5: manon327 (12352 in chips) 
Seat 6: HighCardJasper (5993 in chips) 
manon327: posts small blind 50
HighCardJasper: posts big blind 100
*** HOLE CARDS ***
Dealt to PokerStarsMan12 [7s 3d]
color_singleton: raises 200 to 300
dockstarr: folds 
PokerStarsMan12: folds 
manon327: calls 250
HighCardJasper: folds 
*** FLOP *** [6c 4s 4h]
manon327: checks 
color_singleton: bets 330
manon327: folds 
Uncalled bet (330) returned to color_singleton
color_singleton collected 661 from pot
color_singleton: doesn't show hand 
*** SUMMARY ***
Total pot 700 | Rake 39 
Board [6c 4s 4h]
Seat 1: color_singleton collected (661)
Seat 2: dockstarr folded before Flop (didn't bet)
Seat 3: PokerStarsMan12 (button) folded before Flop (didn't bet)
Seat 5: manon327 (small blind) folded on the Flop
Seat 6: HighCardJasper (big blind) folded before Flop



PokerStars Home Game Hand #229542077338: {DaPokaStars}  Hold'em No Limit (50/100) - 2021/09/02 17:01:59 ET
Table 'summer poker' 9-max (Play Money) Seat #5 is the button
Seat 1: color_singleton (19364 in chips) 
Seat 2: dockstarr (7389 in chips) 
Seat 3: PokerStarsMan12 (6855 in chips) 
Seat 5: manon327 (12052 in chips) 
Seat 6: HighCardJasper (5893 in chips) 
HighCardJasper: posts small blind 50
color_singleton: posts big blind 100
*** HOLE CARDS ***
Dealt to PokerStarsMan12 [7h 3h]
dockstarr: folds 
PokerStarsMan12: calls 100
manon327: calls 100
HighCardJasper: calls 50
color_singleton: raises 200 to 300
PokerStarsMan12: calls 200
manon327: calls 200
HighCardJasper: folds 
*** FLOP *** [Js 5h 5c]
color_singleton: checks 
PokerStarsMan12: checks 
manon327: checks 
*** TURN *** [Js 5h 5c] [9s]
color_singleton: bets 472
PokerStarsMan12: folds 
manon327: folds 
Uncalled bet (472) returned to color_singleton
color_singleton collected 945 from pot
color_singleton: doesn't show hand 
*** SUMMARY ***
Total pot 1000 | Rake 55 
Board [Js 5h 5c 9s]
Seat 1: color_singleton (big blind) collected (945)
Seat 2: dockstarr folded before Flop (didn't bet)
Seat 3: PokerStarsMan12 folded on the Turn
Seat 5: manon327 (button) folded on the Turn
Seat 6: HighCardJasper (small blind) folded before Flop



PokerStars Home Game Hand #229542101655: {DaPokaStars}  Hold'em No Limit (50/100) - 2021/09/02 17:02:50 ET
Table 'summer poker' 9-max (Play Money) Seat #6 is the button
Seat 1: color_singleton (20009 in chips) 
Seat 2: dockstarr (7389 in chips) 
Seat 3: PokerStarsMan12 (6555 in chips) 
Seat 5: manon327 (11752 in chips) 
Seat 6: HighCardJasper (5793 in chips) 
color_singleton: posts small blind 50
dockstarr: posts big blind 100
*** HOLE CARDS ***
Dealt to PokerStarsMan12 [7c Jh]
PokerStarsMan12: folds 
manon327: folds 
HighCardJasper: calls 100
color_singleton: calls 50
dockstarr: checks 
*** FLOP *** [6c Ts Qc]
color_singleton: checks 
dockstarr: checks 
HighCardJasper: checks 
*** TURN *** [6c Ts Qc] [Jd]
color_singleton: bets 141
dockstarr: folds 
HighCardJasper: calls 141
*** RIVER *** [6c Ts Qc Jd] [4c]
color_singleton: checks 
HighCardJasper: bets 275
color_singleton: folds 
Uncalled bet (275) returned to HighCardJasper
HighCardJasper collected 550 from pot
HighCardJasper: doesn't show hand 
*** SUMMARY ***
Total pot 582 | Rake 32 
Board [6c Ts Qc Jd 4c]
Seat 1: color_singleton (small blind) folded on the River
Seat 2: dockstarr (big blind) folded on the Turn
Seat 3: PokerStarsMan12 folded before Flop (didn't bet)
Seat 5: manon327 folded before Flop (didn't bet)
Seat 6: HighCardJasper (button) collected (550)



PokerStars Home Game Hand #229542125756: {DaPokaStars}  Hold'em No Limit (50/100) - 2021/09/02 17:03:41 ET
Table 'summer poker' 9-max (Play Money) Seat #1 is the button
Seat 1: color_singleton (19768 in chips) 
Seat 2: dockstarr (7289 in chips) 
Seat 3: PokerStarsMan12 (6555 in chips) 
Seat 5: manon327 (11752 in chips) 
Seat 6: HighCardJasper (6102 in chips) 
dockstarr: posts small blind 50
PokerStarsMan12: posts big blind 100
*** HOLE CARDS ***
Dealt to PokerStarsMan12 [5h Ts]
manon327: calls 100
HighCardJasper: calls 100
color_singleton: raises 200 to 300
dockstarr: folds 
PokerStarsMan12: calls 200
manon327: calls 200
HighCardJasper: calls 200
*** FLOP *** [Ac 9h Ks]
PokerStarsMan12: checks 
manon327: checks 
HighCardJasper: checks 
color_singleton: checks 
*** TURN *** [Ac 9h Ks] [Kd]
PokerStarsMan12: checks 
manon327: checks 
HighCardJasper: checks 
color_singleton: bets 590
PokerStarsMan12: folds 
manon327: folds 
HighCardJasper: folds 
Uncalled bet (590) returned to color_singleton
color_singleton collected 1181 from pot
color_singleton: doesn't show hand 
*** SUMMARY ***
Total pot 1250 | Rake 69 
Board [Ac 9h Ks Kd]
Seat 1: color_singleton (button) collected (1181)
Seat 2: dockstarr (small blind) folded before Flop
Seat 3: PokerStarsMan12 (big blind) folded on the Turn
Seat 5: manon327 folded on the Turn
Seat 6: HighCardJasper folded on the Turn



PokerStars Home Game Hand #229542160200: {DaPokaStars}  Hold'em No Limit (50/100) - 2021/09/02 17:04:53 ET
Table 'summer poker' 9-max (Play Money) Seat #2 is the button
Seat 1: color_singleton (20649 in chips) 
Seat 2: dockstarr (7239 in chips) 
Seat 3: PokerStarsMan12 (6255 in chips) 
Seat 5: manon327 (11452 in chips) 
Seat 6: HighCardJasper (5802 in chips) 
PokerStarsMan12: posts small blind 50
manon327: posts big blind 100
*** HOLE CARDS ***
Dealt to PokerStarsMan12 [9s Ah]
HighCardJasper: calls 100
color_singleton: calls 100
dockstarr: calls 100
PokerStarsMan12: calls 50
manon327: checks 
*** FLOP *** [8h 7s 2s]
PokerStarsMan12: checks 
manon327: checks 
HighCardJasper: checks 
color_singleton: bets 236
dockstarr: calls 236
PokerStarsMan12: calls 236
manon327: calls 236
HighCardJasper: calls 236
*** TURN *** [8h 7s 2s] [5d]
PokerStarsMan12: checks 
manon327: checks 
HighCardJasper: checks 
color_singleton: bets 200
dockstarr: folds 
PokerStarsMan12: calls 200
manon327: folds 
HighCardJasper: calls 200
*** RIVER *** [8h 7s 2s 5d] [Tc]
PokerStarsMan12: checks 
HighCardJasper: checks 
color_singleton: bets 1077
PokerStarsMan12: folds 
HighCardJasper: folds 
Uncalled bet (1077) returned to color_singleton
color_singleton collected 2155 from pot
color_singleton: doesn't show hand 
*** SUMMARY ***
Total pot 2280 | Rake 125 
Board [8h 7s 2s 5d Tc]
Seat 1: color_singleton collected (2155)
Seat 2: dockstarr (button) folded on the Turn
Seat 3: PokerStarsMan12 (small blind) folded on the River
Seat 5: manon327 (big blind) folded on the Turn
Seat 6: HighCardJasper folded on the River



PokerStars Home Game Hand #229542207417: {DaPokaStars}  Hold'em No Limit (50/100) - 2021/09/02 17:06:30 ET
Table 'summer poker' 9-max (Play Money) Seat #3 is the button
Seat 1: color_singleton (22268 in chips) 
Seat 2: dockstarr (6903 in chips) 
Seat 3: PokerStarsMan12 (5719 in chips) 
Seat 5: manon327 (11116 in chips) 
Seat 6: HighCardJasper (5266 in chips) 
manon327: posts small blind 50
HighCardJasper: posts big blind 100
*** HOLE CARDS ***
Dealt to PokerStarsMan12 [9c Ac]
color_singleton: folds 
dockstarr: folds 
PokerStarsMan12: raises 200 to 300
manon327: calls 250
HighCardJasper: folds 
*** FLOP *** [6s 3h 7d]
manon327: checks 
PokerStarsMan12: checks 
*** TURN *** [6s 3h 7d] [4d]
manon327: checks 
PokerStarsMan12: bets 300
manon327: folds 
Uncalled bet (300) returned to PokerStarsMan12
PokerStarsMan12 collected 661 from pot
*** SUMMARY ***
Total pot 700 | Rake 39 
Board [6s 3h 7d 4d]
Seat 1: color_singleton folded before Flop (didn't bet)
Seat 2: dockstarr folded before Flop (didn't bet)
Seat 3: PokerStarsMan12 (button) collected (661)
Seat 5: manon327 (small blind) folded on the Turn
Seat 6: HighCardJasper (big blind) folded before Flop



PokerStars Home Game Hand #229542219285: {DaPokaStars}  Hold'em No Limit (50/100) - 2021/09/02 17:06:55 ET
Table 'summer poker' 9-max (Play Money) Seat #5 is the button
Seat 1: color_singleton (22268 in chips) 
Seat 2: dockstarr (6903 in chips) 
Seat 3: PokerStarsMan12 (6080 in chips) 
Seat 5: manon327 (10816 in chips) 
Seat 6: HighCardJasper (5166 in chips) 
HighCardJasper: posts small blind 50
color_singleton: posts big blind 100
*** HOLE CARDS ***
Dealt to PokerStarsMan12 [9h Ts]
dockstarr: calls 100
PokerStarsMan12: calls 100
manon327: folds 
HighCardJasper: calls 50
color_singleton has timed out
color_singleton: checks 
*** FLOP *** [3s 5d 5s]
HighCardJasper: bets 100
color_singleton has timed out
color_singleton: folds 
dockstarr: calls 100
PokerStarsMan12: calls 100
*** TURN *** [3s 5d 5s] [7c]
HighCardJasper: checks 
dockstarr: checks 
PokerStarsMan12: checks 
*** RIVER *** [3s 5d 5s 7c] [9c]
HighCardJasper: checks 
dockstarr: bets 100
PokerStarsMan12: raises 400 to 500
HighCardJasper: folds 
dockstarr: folds 
Uncalled bet (400) returned to PokerStarsMan12
PokerStarsMan12 collected 850 from pot
*** SUMMARY ***
Total pot 900 | Rake 50 
Board [3s 5d 5s 7c 9c]
Seat 1: color_singleton (big blind) folded on the Flop
Seat 2: dockstarr folded on the River
Seat 3: PokerStarsMan12 collected (850)
Seat 5: manon327 (button) folded before Flop (didn't bet)
Seat 6: HighCardJasper (small blind) folded on the River



PokerStars Home Game Hand #229542261063: {DaPokaStars}  Hold'em No Limit (50/100) - 2021/09/02 17:08:22 ET
Table 'summer poker' 9-max (Play Money) Seat #6 is the button
Seat 2: dockstarr (6603 in chips) 
Seat 3: PokerStarsMan12 (6630 in chips) 
Seat 5: manon327 (10816 in chips) 
Seat 6: HighCardJasper (4966 in chips) 
dockstarr: posts small blind 50
PokerStarsMan12: posts big blind 100
*** HOLE CARDS ***
Dealt to PokerStarsMan12 [7s 3d]
manon327: calls 100
HighCardJasper: calls 100
dockstarr: folds 
PokerStarsMan12: checks 
*** FLOP *** [2h 6h 7d]
PokerStarsMan12: bets 200
manon327: calls 200
HighCardJasper: folds 
*** TURN *** [2h 6h 7d] [Qc]
PokerStarsMan12 has timed out
PokerStarsMan12: checks 
manon327: checks 
*** RIVER *** [2h 6h 7d Qc] [Qd]
PokerStarsMan12: bets 400
manon327: folds 
Uncalled bet (400) returned to PokerStarsMan12
PokerStarsMan12 collected 709 from pot
*** SUMMARY ***
Total pot 750 | Rake 41 
Board [2h 6h 7d Qc Qd]
Seat 2: dockstarr (small blind) folded before Flop
Seat 3: PokerStarsMan12 (big blind) collected (709)
Seat 5: manon327 folded on the River
Seat 6: HighCardJasper (button) folded on the Flop



PokerStars Home Game Hand #229542300626: {DaPokaStars}  Hold'em No Limit (50/100) - 2021/09/02 17:09:25 ET
Table 'summer poker' 9-max (Play Money) Seat #2 is the button
Seat 1: color_singleton (22168 in chips) 
Seat 2: dockstarr (6553 in chips) 
Seat 3: PokerStarsMan12 (7039 in chips) 
Seat 5: manon327 (10516 in chips) 
Seat 6: HighCardJasper (4866 in chips) 
PokerStarsMan12: posts small blind 50
manon327: posts big blind 100
color_singleton: posts small blind 50
*** HOLE CARDS ***
Dealt to PokerStarsMan12 [7h Kc]
HighCardJasper: folds 
color_singleton: raises 200 to 300
dockstarr: folds 
PokerStarsMan12: folds 
manon327: calls 200
*** FLOP *** [3h Ks 2s]
manon327: checks 
color_singleton: bets 330
manon327: folds 
Uncalled bet (330) returned to color_singleton
color_singleton collected 661 from pot
color_singleton: doesn't show hand 
*** SUMMARY ***
Total pot 700 | Rake 39 
Board [3h Ks 2s]
Seat 1: color_singleton collected (661)
Seat 2: dockstarr (button) folded before Flop (didn't bet)
Seat 3: PokerStarsMan12 (small blind) folded before Flop
Seat 5: manon327 (big blind) folded on the Flop
Seat 6: HighCardJasper folded before Flop (didn't bet)



PokerStars Home Game Hand #229542322653: {DaPokaStars}  Hold'em No Limit (50/100) - 2021/09/02 17:10:11 ET
Table 'summer poker' 9-max (Play Money) Seat #3 is the button
Seat 1: color_singleton (22479 in chips) 
Seat 2: dockstarr (6553 in chips) 
Seat 3: PokerStarsMan12 (6989 in chips) 
Seat 5: manon327 (10216 in chips) 
Seat 6: HighCardJasper (4866 in chips) 
manon327: posts small blind 50
HighCardJasper: posts big blind 100
*** HOLE CARDS ***
Dealt to PokerStarsMan12 [Tc Ks]
color_singleton: raises 200 to 300
dockstarr: folds 
PokerStarsMan12: calls 300
manon327: calls 250
HighCardJasper: calls 200
*** FLOP *** [Jc 7d Qh]
manon327: bets 567
HighCardJasper: folds 
color_singleton: folds 
PokerStarsMan12: calls 567
*** TURN *** [Jc 7d Qh] [Ah]
manon327: bets 1103
PokerStarsMan12: raises 1103 to 2206
manon327: calls 1103
*** RIVER *** [Jc 7d Qh Ah] [9h]
manon327: checks 
PokerStarsMan12: bets 2000
manon327: calls 2000
*** SHOW DOWN ***
PokerStarsMan12: shows [Tc Ks] (a straight, Ten to Ace)
manon327: mucks hand 
PokerStarsMan12 collected 10155 from pot
*** SUMMARY ***
Total pot 10746 | Rake 591 
Board [Jc 7d Qh Ah 9h]
Seat 1: color_singleton folded on the Flop
Seat 2: dockstarr folded before Flop (didn't bet)
Seat 3: PokerStarsMan12 (button) showed [Tc Ks] and won (10155) with a straight, Ten to Ace
Seat 5: manon327 (small blind) mucked [7h 7c]
Seat 6: HighCardJasper (big blind) folded on the Flop



PokerStars Home Game Hand #229542351870: {DaPokaStars}  Hold'em No Limit (50/100) - 2021/09/02 17:11:11 ET
Table 'summer poker' 9-max (Play Money) Seat #5 is the button
Seat 1: color_singleton (22179 in chips) 
Seat 2: dockstarr (6553 in chips) 
Seat 3: PokerStarsMan12 (12071 in chips) 
Seat 5: manon327 (5143 in chips) 
Seat 6: HighCardJasper (4566 in chips) 
HighCardJasper: posts small blind 50
color_singleton: posts big blind 100
*** HOLE CARDS ***
Dealt to PokerStarsMan12 [4d 8d]
dockstarr: folds 
PokerStarsMan12: calls 100
manon327: calls 100
HighCardJasper: calls 50
color_singleton: checks 
*** FLOP *** [Ts Qs 7d]
HighCardJasper: checks 
color_singleton: checks 
PokerStarsMan12: checks 
manon327: checks 
*** TURN *** [Ts Qs 7d] [Jd]
HighCardJasper: checks 
color_singleton: checks 
PokerStarsMan12: checks 
manon327: checks 
*** RIVER *** [Ts Qs 7d Jd] [4h]
HighCardJasper: checks 
color_singleton: checks 
PokerStarsMan12: bets 200
manon327: folds 
HighCardJasper: folds 
color_singleton: calls 200
*** SHOW DOWN ***
PokerStarsMan12: shows [4d 8d] (a pair of Fours)
color_singleton: shows [4s 2c] (a pair of Fours)
color_singleton collected 378 from pot
PokerStarsMan12 collected 378 from pot
*** SUMMARY ***
Total pot 800 | Rake 44 
Board [Ts Qs 7d Jd 4h]
Seat 1: color_singleton (big blind) showed [4s 2c] and won (378) with a pair of Fours
Seat 2: dockstarr folded before Flop (didn't bet)
Seat 3: PokerStarsMan12 showed [4d 8d] and won (378) with a pair of Fours
Seat 5: manon327 (button) folded on the River
Seat 6: HighCardJasper (small blind) folded on the River



PokerStars Home Game Hand #229542382763: {DaPokaStars}  Hold'em No Limit (50/100) - 2021/09/02 17:12:15 ET
Table 'summer poker' 9-max (Play Money) Seat #6 is the button
Seat 1: color_singleton (22257 in chips) 
Seat 2: dockstarr (6553 in chips) 
Seat 3: PokerStarsMan12 (12149 in chips) 
Seat 5: manon327 (5043 in chips) 
Seat 6: HighCardJasper (4466 in chips) 
color_singleton: posts small blind 50
dockstarr: posts big blind 100
*** HOLE CARDS ***
Dealt to PokerStarsMan12 [7h 3s]
PokerStarsMan12: folds 
manon327: calls 100
HighCardJasper: folds 
color_singleton: folds 
dockstarr: checks 
*** FLOP *** [9h 4s 7s]
dockstarr: checks 
manon327: checks 
*** TURN *** [9h 4s 7s] [4h]
dockstarr: checks 
manon327: checks 
*** RIVER *** [9h 4s 7s 4h] [Ad]
dockstarr: checks 
manon327: checks 
*** SHOW DOWN ***
dockstarr: shows [Kh Qd] (a pair of Fours)
manon327: shows [Qc Ks] (a pair of Fours)
dockstarr collected 118 from pot
manon327 collected 118 from pot
*** SUMMARY ***
Total pot 250 | Rake 14 
Board [9h 4s 7s 4h Ad]
Seat 1: color_singleton (small blind) folded before Flop
Seat 2: dockstarr (big blind) showed [Kh Qd] and won (118) with a pair of Fours
Seat 3: PokerStarsMan12 folded before Flop (didn't bet)
Seat 5: manon327 showed [Qc Ks] and won (118) with a pair of Fours
Seat 6: HighCardJasper (button) folded before Flop (didn't bet)



PokerStars Home Game Hand #229542400452: {DaPokaStars}  Hold'em No Limit (50/100) - 2021/09/02 17:12:52 ET
Table 'summer poker' 9-max (Play Money) Seat #1 is the button
Seat 1: color_singleton (22207 in chips) 
Seat 2: dockstarr (6571 in chips) 
Seat 3: PokerStarsMan12 (12149 in chips) 
Seat 5: manon327 (5061 in chips) 
Seat 6: HighCardJasper (4466 in chips) 
dockstarr: posts small blind 50
PokerStarsMan12: posts big blind 100
*** HOLE CARDS ***
Dealt to PokerStarsMan12 [Ts 3s]
manon327: folds 
HighCardJasper: calls 100
color_singleton: folds 
dockstarr: folds 
PokerStarsMan12: checks 
*** FLOP *** [9c 9h 7d]
PokerStarsMan12: checks 
HighCardJasper: checks 
*** TURN *** [9c 9h 7d] [2d]
PokerStarsMan12: checks 
HighCardJasper: bets 118
PokerStarsMan12: folds 
Uncalled bet (118) returned to HighCardJasper
HighCardJasper collected 236 from pot
HighCardJasper: doesn't show hand 
*** SUMMARY ***
Total pot 250 | Rake 14 
Board [9c 9h 7d 2d]
Seat 1: color_singleton (button) folded before Flop (didn't bet)
Seat 2: dockstarr (small blind) folded before Flop
Seat 3: PokerStarsMan12 (big blind) folded on the Turn
Seat 5: manon327 folded before Flop (didn't bet)
Seat 6: HighCardJasper collected (236)



PokerStars Home Game Hand #229542410928: {DaPokaStars}  Hold'em No Limit (50/100) - 2021/09/02 17:13:14 ET
Table 'summer poker' 9-max (Play Money) Seat #2 is the button
Seat 1: color_singleton (22207 in chips) 
Seat 2: dockstarr (6521 in chips) 
Seat 3: PokerStarsMan12 (12049 in chips) 
Seat 5: manon327 (5061 in chips) 
Seat 6: HighCardJasper (4602 in chips) 
PokerStarsMan12: posts small blind 50
manon327: posts big blind 100
*** HOLE CARDS ***
Dealt to PokerStarsMan12 [Jc Ks]
HighCardJasper: calls 100
color_singleton: folds 
dockstarr: folds 
PokerStarsMan12: raises 200 to 300
manon327: folds 
HighCardJasper: calls 200
*** FLOP *** [6s 5d Qc]
PokerStarsMan12: checks 
HighCardJasper: checks 
*** TURN *** [6s 5d Qc] [7s]
PokerStarsMan12: bets 300
HighCardJasper: folds 
Uncalled bet (300) returned to PokerStarsMan12
PokerStarsMan12 collected 661 from pot
*** SUMMARY ***
Total pot 700 | Rake 39 
Board [6s 5d Qc 7s]
Seat 1: color_singleton folded before Flop (didn't bet)
Seat 2: dockstarr (button) folded before Flop (didn't bet)
Seat 3: PokerStarsMan12 (small blind) collected (661)
Seat 5: manon327 (big blind) folded before Flop
Seat 6: HighCardJasper folded on the Turn



PokerStars Home Game Hand #229542425750: {DaPokaStars}  Hold'em No Limit (50/100) - 2021/09/02 17:13:45 ET
Table 'summer poker' 9-max (Play Money) Seat #3 is the button
Seat 1: color_singleton (22207 in chips) 
Seat 2: dockstarr (6521 in chips) 
Seat 3: PokerStarsMan12 (12410 in chips) 
Seat 5: manon327 (4961 in chips) 
Seat 6: HighCardJasper (4302 in chips) 
manon327: posts small blind 50
HighCardJasper: posts big blind 100
*** HOLE CARDS ***
Dealt to PokerStarsMan12 [4d 9h]
color_singleton: raises 200 to 300
dockstarr: calls 300
PokerStarsMan12: folds 
manon327: calls 250
HighCardJasper: folds 
*** FLOP *** [6d Jh Qs]
manon327: checks 
color_singleton: checks 
dockstarr: checks 
*** TURN *** [6d Jh Qs] [5h]
manon327: checks 
color_singleton: checks 
dockstarr: checks 
*** RIVER *** [6d Jh Qs 5h] [6c]
manon327: bets 945
color_singleton: folds 
dockstarr: folds 
Uncalled bet (945) returned to manon327
manon327 collected 945 from pot
*** SUMMARY ***
Total pot 1000 | Rake 55 
Board [6d Jh Qs 5h 6c]
Seat 1: color_singleton folded on the River
Seat 2: dockstarr folded on the River
Seat 3: PokerStarsMan12 (button) folded before Flop (didn't bet)
Seat 5: manon327 (small blind) collected (945)
Seat 6: HighCardJasper (big blind) folded before Flop



PokerStars Home Game Hand #229542453494: {DaPokaStars}  Hold'em No Limit (50/100) - 2021/09/02 17:14:43 ET
Table 'summer poker' 9-max (Play Money) Seat #5 is the button
Seat 1: color_singleton (21907 in chips) 
Seat 2: dockstarr (6221 in chips) 
Seat 3: PokerStarsMan12 (12410 in chips) 
Seat 5: manon327 (5606 in chips) 
Seat 6: HighCardJasper (4202 in chips) 
HighCardJasper: posts small blind 50
color_singleton: posts big blind 100
*** HOLE CARDS ***
Dealt to PokerStarsMan12 [3s 7d]
dockstarr: calls 100
PokerStarsMan12: folds 
manon327: calls 100
HighCardJasper: calls 50
color_singleton: raises 200 to 300
dockstarr: calls 200
manon327: calls 200
HighCardJasper: folds 
*** FLOP *** [2s 4d 8d]
color_singleton: checks 
dockstarr: checks 
manon327: checks 
*** TURN *** [2s 4d 8d] [2h]
color_singleton: checks 
dockstarr: checks 
manon327: bets 472
color_singleton: folds 
dockstarr: folds 
Uncalled bet (472) returned to manon327
manon327 collected 945 from pot
*** SUMMARY ***
Total pot 1000 | Rake 55 
Board [2s 4d 8d 2h]
Seat 1: color_singleton (big blind) folded on the Turn
Seat 2: dockstarr folded on the Turn
Seat 3: PokerStarsMan12 folded before Flop (didn't bet)
Seat 5: manon327 (button) collected (945)
Seat 6: HighCardJasper (small blind) folded before Flop



PokerStars Home Game Hand #229542475782: {DaPokaStars}  Hold'em No Limit (50/100) - 2021/09/02 17:15:30 ET
Table 'summer poker' 9-max (Play Money) Seat #6 is the button
Seat 1: color_singleton (21607 in chips) 
Seat 2: dockstarr (5921 in chips) 
Seat 3: PokerStarsMan12 (12410 in chips) 
Seat 5: manon327 (6251 in chips) 
Seat 6: HighCardJasper (4102 in chips) 
color_singleton: posts small blind 50
dockstarr: posts big blind 100
*** HOLE CARDS ***
Dealt to PokerStarsMan12 [Qs Kh]
PokerStarsMan12: raises 200 to 300
manon327: folds 
HighCardJasper: folds 
color_singleton: calls 250
dockstarr: calls 200
*** FLOP *** [Ah 8s As]
color_singleton: bets 425
dockstarr: folds 
PokerStarsMan12: folds 
Uncalled bet (425) returned to color_singleton
color_singleton collected 850 from pot
color_singleton: doesn't show hand 
*** SUMMARY ***
Total pot 900 | Rake 50 
Board [Ah 8s As]
Seat 1: color_singleton (small blind) collected (850)
Seat 2: dockstarr (big blind) folded on the Flop
Seat 3: PokerStarsMan12 folded on the Flop
Seat 5: manon327 folded before Flop (didn't bet)
Seat 6: HighCardJasper (button) folded before Flop (didn't bet)



PokerStars Home Game Hand #229542498498: {DaPokaStars}  Hold'em No Limit (50/100) - 2021/09/02 17:16:18 ET
Table 'summer poker' 9-max (Play Money) Seat #1 is the button
Seat 1: color_singleton (22157 in chips) 
Seat 2: dockstarr (5621 in chips) 
Seat 3: PokerStarsMan12 (12110 in chips) 
Seat 5: manon327 (6251 in chips) 
Seat 6: HighCardJasper (4102 in chips) 
dockstarr: posts small blind 50
PokerStarsMan12: posts big blind 100
*** HOLE CARDS ***
Dealt to PokerStarsMan12 [4h 3h]
manon327: calls 100
HighCardJasper: calls 100
color_singleton: calls 100
dockstarr: raises 100 to 200
PokerStarsMan12: calls 100
manon327: calls 100
HighCardJasper: calls 100
color_singleton: calls 100
*** FLOP *** [9h 6d 6s]
dockstarr: checks 
PokerStarsMan12: checks 
manon327: bets 472
HighCardJasper: folds 
color_singleton: folds 
dockstarr: calls 472
PokerStarsMan12: folds 
*** TURN *** [9h 6d 6s] [4s]
dockstarr: checks 
manon327: bets 918
dockstarr: folds 
Uncalled bet (918) returned to manon327
manon327 collected 1837 from pot
*** SUMMARY ***
Total pot 1944 | Rake 107 
Board [9h 6d 6s 4s]
Seat 1: color_singleton (button) folded on the Flop
Seat 2: dockstarr (small blind) folded on the Turn
Seat 3: PokerStarsMan12 (big blind) folded on the Flop
Seat 5: manon327 collected (1837)
Seat 6: HighCardJasper folded on the Flop



PokerStars Home Game Hand #229542525248: {DaPokaStars}  Hold'em No Limit (50/100) - 2021/09/02 17:17:14 ET
Table 'summer poker' 9-max (Play Money) Seat #2 is the button
Seat 1: color_singleton (21957 in chips) 
Seat 2: dockstarr (4949 in chips) 
Seat 3: PokerStarsMan12 (11910 in chips) 
Seat 5: manon327 (7416 in chips) 
Seat 6: HighCardJasper (3902 in chips) 
PokerStarsMan12: posts small blind 50
manon327: posts big blind 100
*** HOLE CARDS ***
Dealt to PokerStarsMan12 [2h Th]
HighCardJasper: folds 
color_singleton: raises 200 to 300
dockstarr: calls 300
PokerStarsMan12: folds 
manon327: calls 200
*** FLOP *** [4c 2c As]
manon327: checks 
color_singleton: bets 449
dockstarr: calls 449
manon327: folds 
*** TURN *** [4c 2c As] [6s]
color_singleton: checks 
dockstarr: checks 
*** RIVER *** [4c 2c As 6s] [Qs]
color_singleton: checks 
dockstarr: checks 
*** SHOW DOWN ***
color_singleton: shows [5d 2d] (a pair of Deuces)
dockstarr: shows [8d Ah] (a pair of Aces)
dockstarr collected 1746 from pot
*** SUMMARY ***
Total pot 1848 | Rake 102 
Board [4c 2c As 6s Qs]
Seat 1: color_singleton showed [5d 2d] and lost with a pair of Deuces
Seat 2: dockstarr (button) showed [8d Ah] and won (1746) with a pair of Aces
Seat 3: PokerStarsMan12 (small blind) folded before Flop
Seat 5: manon327 (big blind) folded on the Flop
Seat 6: HighCardJasper folded before Flop (didn't bet)



PokerStars Home Game Hand #229542550253: {DaPokaStars}  Hold'em No Limit (50/100) - 2021/09/02 17:18:07 ET
Table 'summer poker' 9-max (Play Money) Seat #3 is the button
Seat 1: color_singleton (21208 in chips) 
Seat 2: dockstarr (5946 in chips) 
Seat 3: PokerStarsMan12 (11860 in chips) 
Seat 5: manon327 (7116 in chips) 
Seat 6: HighCardJasper (3902 in chips) 
manon327: posts small blind 50
HighCardJasper: posts big blind 100
*** HOLE CARDS ***
Dealt to PokerStarsMan12 [2s 8c]
color_singleton: folds 
dockstarr: calls 100
PokerStarsMan12: folds 
manon327: calls 50
HighCardJasper: checks 
*** FLOP *** [8d 4c 4s]
manon327: checks 
HighCardJasper: checks 
dockstarr: bets 283
manon327: folds 
HighCardJasper: folds 
Uncalled bet (283) returned to dockstarr
dockstarr collected 283 from pot
dockstarr: doesn't show hand 
*** SUMMARY ***
Total pot 300 | Rake 17 
Board [8d 4c 4s]
Seat 1: color_singleton folded before Flop (didn't bet)
Seat 2: dockstarr collected (283)
Seat 3: PokerStarsMan12 (button) folded before Flop (didn't bet)
Seat 5: manon327 (small blind) folded on the Flop
Seat 6: HighCardJasper (big blind) folded on the Flop



PokerStars Home Game Hand #229542560636: {DaPokaStars}  Hold'em No Limit (50/100) - 2021/09/02 17:18:29 ET
Table 'summer poker' 9-max (Play Money) Seat #5 is the button
Seat 1: color_singleton (21208 in chips) 
Seat 2: dockstarr (6129 in chips) 
Seat 3: PokerStarsMan12 (11860 in chips) 
Seat 5: manon327 (7016 in chips) 
Seat 6: HighCardJasper (3802 in chips) 
HighCardJasper: posts small blind 50
color_singleton: posts big blind 100
*** HOLE CARDS ***
Dealt to PokerStarsMan12 [7d 8s]
dockstarr: calls 100
PokerStarsMan12: calls 100
manon327: folds 
HighCardJasper: calls 50
color_singleton: checks 
*** FLOP *** [5s 6s 4c]
HighCardJasper: checks 
color_singleton: checks 
dockstarr: checks 
PokerStarsMan12: bets 150
HighCardJasper: calls 150
color_singleton: folds 
dockstarr: folds 
*** TURN *** [5s 6s 4c] [Ah]
HighCardJasper: checks 
PokerStarsMan12: bets 300
HighCardJasper: calls 300
*** RIVER *** [5s 6s 4c Ah] [2s]
HighCardJasper: checks 
PokerStarsMan12: checks 
*** SHOW DOWN ***
HighCardJasper: shows [Ac Kc] (a pair of Aces)
PokerStarsMan12: shows [7d 8s] (a straight, Four to Eight)
PokerStarsMan12 collected 1228 from pot
*** SUMMARY ***
Total pot 1300 | Rake 72 
Board [5s 6s 4c Ah 2s]
Seat 1: color_singleton (big blind) folded on the Flop
Seat 2: dockstarr folded on the Flop
Seat 3: PokerStarsMan12 showed [7d 8s] and won (1228) with a straight, Four to Eight
Seat 5: manon327 (button) folded before Flop (didn't bet)
Seat 6: HighCardJasper (small blind) showed [Ac Kc] and lost with a pair of Aces



PokerStars Home Game Hand #229542605712: {DaPokaStars}  Hold'em No Limit (50/100) - 2021/09/02 17:20:03 ET
Table 'summer poker' 9-max (Play Money) Seat #6 is the button
Seat 1: color_singleton (21108 in chips) 
Seat 3: PokerStarsMan12 (12538 in chips) 
Seat 5: manon327 (7016 in chips) 
Seat 6: HighCardJasper (3252 in chips) 
color_singleton: posts small blind 50
PokerStarsMan12: posts big blind 100
*** HOLE CARDS ***
Dealt to PokerStarsMan12 [8s 9d]
manon327: calls 100
HighCardJasper: calls 100
color_singleton: raises 300 to 400
PokerStarsMan12: calls 300
manon327: calls 300
HighCardJasper: folds 
*** FLOP *** [7s 9h As]
color_singleton: checks 
PokerStarsMan12: checks 
manon327: bets 614
color_singleton: folds 
PokerStarsMan12: folds 
Uncalled bet (614) returned to manon327
manon327 collected 1228 from pot
*** SUMMARY ***
Total pot 1300 | Rake 72 
Board [7s 9h As]
Seat 1: color_singleton (small blind) folded on the Flop
Seat 3: PokerStarsMan12 (big blind) folded on the Flop
Seat 5: manon327 collected (1228)
Seat 6: HighCardJasper (button) folded before Flop



PokerStars Home Game Hand #229542630862: {DaPokaStars}  Hold'em No Limit (50/100) - 2021/09/02 17:20:56 ET
Table 'summer poker' 9-max (Play Money) Seat #1 is the button
Seat 1: color_singleton (20708 in chips) 
Seat 3: PokerStarsMan12 (12138 in chips) 
Seat 5: manon327 (7844 in chips) 
Seat 6: HighCardJasper (3152 in chips) 
PokerStarsMan12: posts small blind 50
manon327: posts big blind 100
*** HOLE CARDS ***
Dealt to PokerStarsMan12 [Ac 2c]
HighCardJasper: calls 100
color_singleton: raises 200 to 300
PokerStarsMan12: folds 
manon327: calls 200
HighCardJasper: calls 200
*** FLOP *** [2s Ad 9c]
manon327: checks 
HighCardJasper: checks 
color_singleton: checks 
*** TURN *** [2s Ad 9c] [3d]
manon327: checks 
HighCardJasper: bets 449
color_singleton: folds 
manon327: folds 
Uncalled bet (449) returned to HighCardJasper
HighCardJasper collected 898 from pot
HighCardJasper: doesn't show hand 
*** SUMMARY ***
Total pot 950 | Rake 52 
Board [2s Ad 9c 3d]
Seat 1: color_singleton (button) folded on the Turn
Seat 3: PokerStarsMan12 (small blind) folded before Flop
Seat 5: manon327 (big blind) folded on the Turn
Seat 6: HighCardJasper collected (898)



PokerStars Home Game Hand #229542653981: {DaPokaStars}  Hold'em No Limit (50/100) - 2021/09/02 17:21:45 ET
Table 'summer poker' 9-max (Play Money) Seat #3 is the button
Seat 1: color_singleton (20408 in chips) 
Seat 2: dockstarr (6029 in chips) 
Seat 3: PokerStarsMan12 (12088 in chips) 
Seat 5: manon327 (7544 in chips) 
Seat 6: HighCardJasper (3750 in chips) 
manon327: posts small blind 50
HighCardJasper: posts big blind 100
dockstarr: posts small & big blinds 150
*** HOLE CARDS ***
Dealt to PokerStarsMan12 [5h Ad]
color_singleton: folds 
dockstarr: checks 
PokerStarsMan12: calls 100
manon327: calls 50
HighCardJasper: checks 
*** FLOP *** [6s 8h Jc]
manon327: checks 
HighCardJasper: checks 
dockstarr: checks 
PokerStarsMan12: checks 
*** TURN *** [6s 8h Jc] [4c]
manon327: checks 
HighCardJasper: checks 
dockstarr: bets 100
PokerStarsMan12: folds 
manon327: folds 
HighCardJasper: calls 100
*** RIVER *** [6s 8h Jc 4c] [As]
HighCardJasper: checks 
dockstarr: checks 
*** SHOW DOWN ***
HighCardJasper: shows [6c 3h] (a pair of Sixes)
dockstarr: shows [Jd Kh] (a pair of Jacks)
dockstarr collected 614 from pot
*** SUMMARY ***
Total pot 650 | Rake 36 
Board [6s 8h Jc 4c As]
Seat 1: color_singleton folded before Flop (didn't bet)
Seat 2: dockstarr showed [Jd Kh] and won (614) with a pair of Jacks
Seat 3: PokerStarsMan12 (button) folded on the Turn
Seat 5: manon327 (small blind) folded on the Turn
Seat 6: HighCardJasper (big blind) showed [6c 3h] and lost with a pair of Sixes



PokerStars Home Game Hand #229542682270: {DaPokaStars}  Hold'em No Limit (50/100) - 2021/09/02 17:22:45 ET
Table 'summer poker' 9-max (Play Money) Seat #5 is the button
Seat 1: color_singleton (20408 in chips) 
Seat 2: dockstarr (6393 in chips) 
Seat 3: PokerStarsMan12 (11988 in chips) 
Seat 5: manon327 (7444 in chips) 
Seat 6: HighCardJasper (3550 in chips) 
HighCardJasper: posts small blind 50
color_singleton: posts big blind 100
*** HOLE CARDS ***
Dealt to PokerStarsMan12 [4h 3d]
dockstarr: folds 
PokerStarsMan12: folds 
manon327: calls 100
HighCardJasper: calls 50
color_singleton: checks 
*** FLOP *** [Ah Ad 5d]
HighCardJasper: checks 
color_singleton: checks 
manon327: bets 141
HighCardJasper: folds 
color_singleton: calls 141
*** TURN *** [Ah Ad 5d] [Qh]
color_singleton: checks 
manon327: bets 275
color_singleton: calls 275
*** RIVER *** [Ah Ad 5d Qh] [8d]
color_singleton: checks 
manon327: bets 1070
color_singleton: folds 
Uncalled bet (1070) returned to manon327
manon327 collected 1070 from pot
*** SUMMARY ***
Total pot 1132 | Rake 62 
Board [Ah Ad 5d Qh 8d]
Seat 1: color_singleton (big blind) folded on the River
Seat 2: dockstarr folded before Flop (didn't bet)
Seat 3: PokerStarsMan12 folded before Flop (didn't bet)
Seat 5: manon327 (button) collected (1070)
Seat 6: HighCardJasper (small blind) folded on the Flop



PokerStars Home Game Hand #229542707728: {DaPokaStars}  Hold'em No Limit (50/100) - 2021/09/02 17:23:39 ET
Table 'summer poker' 9-max (Play Money) Seat #6 is the button
Seat 1: color_singleton (19892 in chips) 
Seat 2: dockstarr (6393 in chips) 
Seat 3: PokerStarsMan12 (11988 in chips) 
Seat 5: manon327 (7998 in chips) 
Seat 6: HighCardJasper (3450 in chips) 
color_singleton: posts small blind 50
dockstarr: posts big blind 100
*** HOLE CARDS ***
Dealt to PokerStarsMan12 [3c Td]
PokerStarsMan12: folds 
manon327: calls 100
HighCardJasper: calls 100
color_singleton: calls 50
dockstarr: checks 
*** FLOP *** [Th 7c 9c]
color_singleton: checks 
dockstarr: checks 
manon327: bets 100
HighCardJasper: calls 100
color_singleton: calls 100
dockstarr: folds 
*** TURN *** [Th 7c 9c] [Kc]
color_singleton: checks 
manon327: bets 330
HighCardJasper: calls 330
color_singleton: folds 
*** RIVER *** [Th 7c 9c Kc] [8h]
manon327: bets 642
HighCardJasper: calls 642
*** SHOW DOWN ***
manon327: shows [Qs Kh] (a pair of Kings)
HighCardJasper: shows [7d Kd] (two pair, Kings and Sevens)
HighCardJasper collected 2499 from pot
*** SUMMARY ***
Total pot 2644 | Rake 145 
Board [Th 7c 9c Kc 8h]
Seat 1: color_singleton (small blind) folded on the Turn
Seat 2: dockstarr (big blind) folded on the Flop
Seat 3: PokerStarsMan12 folded before Flop (didn't bet)
Seat 5: manon327 showed [Qs Kh] and lost with a pair of Kings
Seat 6: HighCardJasper (button) showed [7d Kd] and won (2499) with two pair, Kings and Sevens



PokerStars Home Game Hand #229542734620: {DaPokaStars}  Hold'em No Limit (50/100) - 2021/09/02 17:24:36 ET
Table 'summer poker' 9-max (Play Money) Seat #1 is the button
Seat 1: color_singleton (19692 in chips) 
Seat 2: dockstarr (6293 in chips) 
Seat 3: PokerStarsMan12 (11988 in chips) 
Seat 5: manon327 (6826 in chips) 
Seat 6: HighCardJasper (4777 in chips) 
dockstarr: posts small blind 50
PokerStarsMan12: posts big blind 100
*** HOLE CARDS ***
Dealt to PokerStarsMan12 [8c 8h]
manon327: raises 100 to 200
HighCardJasper: calls 200
color_singleton: folds 
dockstarr: folds 
PokerStarsMan12: raises 300 to 500
manon327: calls 300
HighCardJasper: folds 
*** FLOP *** [5d Qc 7s]
PokerStarsMan12: bets 700
manon327: folds 
Uncalled bet (700) returned to PokerStarsMan12
PokerStarsMan12 collected 1181 from pot
*** SUMMARY ***
Total pot 1250 | Rake 69 
Board [5d Qc 7s]
Seat 1: color_singleton (button) folded before Flop (didn't bet)
Seat 2: dockstarr (small blind) folded before Flop
Seat 3: PokerStarsMan12 (big blind) collected (1181)
Seat 5: manon327 folded on the Flop
Seat 6: HighCardJasper folded before Flop



PokerStars Home Game Hand #229542752211: {DaPokaStars}  Hold'em No Limit (50/100) - 2021/09/02 17:25:13 ET
Table 'summer poker' 9-max (Play Money) Seat #2 is the button
Seat 1: color_singleton (19692 in chips) 
Seat 2: dockstarr (6243 in chips) 
Seat 3: PokerStarsMan12 (12669 in chips) 
Seat 5: manon327 (6326 in chips) 
Seat 6: HighCardJasper (4577 in chips) 
PokerStarsMan12: posts small blind 50
manon327: posts big blind 100
*** HOLE CARDS ***
Dealt to PokerStarsMan12 [Ac Ad]
HighCardJasper: folds 
color_singleton: raises 100 to 200
dockstarr: folds 
PokerStarsMan12: raises 300 to 500
manon327: folds 
color_singleton: calls 300
*** FLOP *** [2h Ks 8h]
PokerStarsMan12: bets 600
color_singleton: folds 
Uncalled bet (600) returned to PokerStarsMan12
PokerStarsMan12 collected 1039 from pot
*** SUMMARY ***
Total pot 1100 | Rake 61 
Board [2h Ks 8h]
Seat 1: color_singleton folded on the Flop
Seat 2: dockstarr (button) folded before Flop (didn't bet)
Seat 3: PokerStarsMan12 (small blind) collected (1039)
Seat 5: manon327 (big blind) folded before Flop
Seat 6: HighCardJasper folded before Flop (didn't bet)



PokerStars Home Game Hand #229542766677: {DaPokaStars}  Hold'em No Limit (50/100) - 2021/09/02 17:25:44 ET
Table 'summer poker' 9-max (Play Money) Seat #3 is the button
Seat 1: color_singleton (19192 in chips) 
Seat 2: dockstarr (6243 in chips) 
Seat 3: PokerStarsMan12 (13208 in chips) 
Seat 5: manon327 (6226 in chips) 
Seat 6: HighCardJasper (4577 in chips) 
manon327: posts small blind 50
HighCardJasper: posts big blind 100
*** HOLE CARDS ***
Dealt to PokerStarsMan12 [Qc 5h]
color_singleton: folds 
dockstarr: calls 100
PokerStarsMan12: folds 
manon327: calls 50
HighCardJasper: checks 
*** FLOP *** [Qd As Js]
manon327: bets 141
HighCardJasper: folds 
dockstarr: calls 141
*** TURN *** [Qd As Js] [Ts]
manon327: bets 275
dockstarr: folds 
Uncalled bet (275) returned to manon327
manon327 collected 550 from pot
*** SUMMARY ***
Total pot 582 | Rake 32 
Board [Qd As Js Ts]
Seat 1: color_singleton folded before Flop (didn't bet)
Seat 2: dockstarr folded on the Turn
Seat 3: PokerStarsMan12 (button) folded before Flop (didn't bet)
Seat 5: manon327 (small blind) collected (550)
Seat 6: HighCardJasper (big blind) folded on the Flop



PokerStars Home Game Hand #229542782868: {DaPokaStars}  Hold'em No Limit (50/100) - 2021/09/02 17:26:20 ET
Table 'summer poker' 9-max (Play Money) Seat #5 is the button
Seat 1: color_singleton (19192 in chips) 
Seat 2: dockstarr (6002 in chips) 
Seat 3: PokerStarsMan12 (13208 in chips) 
Seat 5: manon327 (6535 in chips) 
Seat 6: HighCardJasper (4477 in chips) 
HighCardJasper: posts small blind 50
color_singleton: posts big blind 100
*** HOLE CARDS ***
Dealt to PokerStarsMan12 [4d 6s]
dockstarr: calls 100
PokerStarsMan12: folds 
manon327: folds 
HighCardJasper: raises 100 to 200
color_singleton: folds 
dockstarr: calls 100
*** FLOP *** [8c Ks 8d]
HighCardJasper: checks 
dockstarr: checks 
*** TURN *** [8c Ks 8d] [2s]
HighCardJasper: checks 
dockstarr: checks 
*** RIVER *** [8c Ks 8d 2s] [5h]
HighCardJasper: bets 236
dockstarr: calls 236
*** SHOW DOWN ***
HighCardJasper: shows [Ad 6d] (a pair of Eights)
dockstarr: mucks hand 
HighCardJasper collected 919 from pot
*** SUMMARY ***
Total pot 972 | Rake 53 
Board [8c Ks 8d 2s 5h]
Seat 1: color_singleton (big blind) folded before Flop
Seat 2: dockstarr mucked [Js Td]
Seat 3: PokerStarsMan12 folded before Flop (didn't bet)
Seat 5: manon327 (button) folded before Flop (didn't bet)
Seat 6: HighCardJasper (small blind) showed [Ad 6d] and won (919) with a pair of Eights



PokerStars Home Game Hand #229542799558: {DaPokaStars}  Hold'em No Limit (50/100) - 2021/09/02 17:26:56 ET
Table 'summer poker' 9-max (Play Money) Seat #6 is the button
Seat 1: color_singleton (19092 in chips) 
Seat 2: dockstarr (5566 in chips) 
Seat 3: PokerStarsMan12 (13208 in chips) 
Seat 5: manon327 (6535 in chips) 
Seat 6: HighCardJasper (4960 in chips) 
color_singleton: posts small blind 50
dockstarr: posts big blind 100
*** HOLE CARDS ***
Dealt to PokerStarsMan12 [Ac 6c]
PokerStarsMan12: calls 100
manon327: calls 100
HighCardJasper: raises 100 to 200
color_singleton: folds 
dockstarr: folds 
PokerStarsMan12: calls 100
manon327: calls 100
*** FLOP *** [Tc Kc 9d]
PokerStarsMan12: bets 400
manon327: calls 400
HighCardJasper: folds 
*** TURN *** [Tc Kc 9d] [Jh]
PokerStarsMan12: bets 700
manon327: raises 700 to 1400
PokerStarsMan12: calls 700
*** RIVER *** [Tc Kc 9d Jh] [8h]
PokerStarsMan12: checks 
manon327: bets 4111
PokerStarsMan12: folds 
Uncalled bet (4111) returned to manon327
manon327 collected 4111 from pot
*** SUMMARY ***
Total pot 4350 | Rake 239 
Board [Tc Kc 9d Jh 8h]
Seat 1: color_singleton (small blind) folded before Flop
Seat 2: dockstarr (big blind) folded before Flop
Seat 3: PokerStarsMan12 folded on the River
Seat 5: manon327 collected (4111)
Seat 6: HighCardJasper (button) folded on the Flop



PokerStars Home Game Hand #229542842725: {DaPokaStars}  Hold'em No Limit (50/100) - 2021/09/02 17:28:10 ET
Table 'summer poker' 9-max (Play Money) Seat #1 is the button
Seat 1: color_singleton (19042 in chips) 
Seat 2: dockstarr (5466 in chips) 
Seat 3: PokerStarsMan12 (11208 in chips) 
Seat 5: manon327 (8646 in chips) 
Seat 6: HighCardJasper (4760 in chips) 
dockstarr: posts small blind 50
PokerStarsMan12: posts big blind 100
*** HOLE CARDS ***
Dealt to PokerStarsMan12 [2s 2c]
manon327: folds 
HighCardJasper: calls 100
color_singleton: raises 200 to 300
dockstarr: calls 250
PokerStarsMan12: calls 200
HighCardJasper: calls 200
*** FLOP *** [7c Ah 9h]
dockstarr: checks 
PokerStarsMan12: checks 
HighCardJasper: bets 567
color_singleton: folds 
dockstarr: folds 
PokerStarsMan12: folds 
Uncalled bet (567) returned to HighCardJasper
HighCardJasper collected 1134 from pot
HighCardJasper: doesn't show hand 
*** SUMMARY ***
Total pot 1200 | Rake 66 
Board [7c Ah 9h]
Seat 1: color_singleton (button) folded on the Flop
Seat 2: dockstarr (small blind) folded on the Flop
Seat 3: PokerStarsMan12 (big blind) folded on the Flop
Seat 5: manon327 folded before Flop (didn't bet)
Seat 6: HighCardJasper collected (1134)



PokerStars Home Game Hand #229542858992: {DaPokaStars}  Hold'em No Limit (50/100) - 2021/09/02 17:28:46 ET
Table 'summer poker' 9-max (Play Money) Seat #2 is the button
Seat 1: color_singleton (18742 in chips) 
Seat 2: dockstarr (5166 in chips) 
Seat 3: PokerStarsMan12 (10908 in chips) 
Seat 5: manon327 (8646 in chips) 
Seat 6: HighCardJasper (5594 in chips) 
PokerStarsMan12: posts small blind 50
manon327: posts big blind 100
*** HOLE CARDS ***
Dealt to PokerStarsMan12 [5d 6s]
HighCardJasper: folds 
color_singleton: raises 200 to 300
dockstarr: folds 
PokerStarsMan12: calls 250
manon327: folds 
*** FLOP *** [4c 4s Kh]
PokerStarsMan12: checks 
color_singleton: checks 
*** TURN *** [4c 4s Kh] [9h]
PokerStarsMan12: checks 
color_singleton: bets 330
PokerStarsMan12: folds 
Uncalled bet (330) returned to color_singleton
color_singleton collected 661 from pot
color_singleton: doesn't show hand 
*** SUMMARY ***
Total pot 700 | Rake 39 
Board [4c 4s Kh 9h]
Seat 1: color_singleton collected (661)
Seat 2: dockstarr (button) folded before Flop (didn't bet)
Seat 3: PokerStarsMan12 (small blind) folded on the Turn
Seat 5: manon327 (big blind) folded before Flop
Seat 6: HighCardJasper folded before Flop (didn't bet)



PokerStars Home Game Hand #229542874572: {DaPokaStars}  Hold'em No Limit (50/100) - 2021/09/02 17:29:21 ET
Table 'summer poker' 9-max (Play Money) Seat #3 is the button
Seat 1: color_singleton (19103 in chips) 
Seat 2: dockstarr (5166 in chips) 
Seat 3: PokerStarsMan12 (10608 in chips) 
Seat 5: manon327 (8546 in chips) 
Seat 6: HighCardJasper (5594 in chips) 
manon327: posts small blind 50
HighCardJasper: posts big blind 100
*** HOLE CARDS ***
Dealt to PokerStarsMan12 [4h Td]
color_singleton: folds 
dockstarr: folds 
PokerStarsMan12: folds 
manon327: calls 50
HighCardJasper: checks 
*** FLOP *** [5d 7d Ac]
manon327: checks 
HighCardJasper: bets 100
manon327: calls 100
*** TURN *** [5d 7d Ac] [5s]
manon327: checks 
HighCardJasper: checks 
*** RIVER *** [5d 7d Ac 5s] [2d]
manon327: checks 
HighCardJasper: checks 
*** SHOW DOWN ***
manon327: shows [3s Kc] (a pair of Fives)
HighCardJasper: mucks hand 
manon327 collected 378 from pot
*** SUMMARY ***
Total pot 400 | Rake 22 
Board [5d 7d Ac 5s 2d]
Seat 1: color_singleton folded before Flop (didn't bet)
Seat 2: dockstarr folded before Flop (didn't bet)
Seat 3: PokerStarsMan12 (button) folded before Flop (didn't bet)
Seat 5: manon327 (small blind) showed [3s Kc] and won (378) with a pair of Fives
Seat 6: HighCardJasper (big blind) mucked [9d 6h]



PokerStars Home Game Hand #229542889150: {DaPokaStars}  Hold'em No Limit (50/100) - 2021/09/02 17:29:52 ET
Table 'summer poker' 9-max (Play Money) Seat #5 is the button
Seat 1: color_singleton (19103 in chips) 
Seat 2: dockstarr (5166 in chips) 
Seat 3: PokerStarsMan12 (10608 in chips) 
Seat 5: manon327 (8724 in chips) 
Seat 6: HighCardJasper (5394 in chips) 
HighCardJasper: posts small blind 50
color_singleton: posts big blind 100
*** HOLE CARDS ***
Dealt to PokerStarsMan12 [5c 7d]
dockstarr: folds 
PokerStarsMan12: folds 
manon327: folds 
HighCardJasper: calls 50
color_singleton: checks 
*** FLOP *** [As 8h 6d]
HighCardJasper: checks 
color_singleton: bets 189
HighCardJasper: calls 189
*** TURN *** [As 8h 6d] [Kh]
HighCardJasper: checks 
color_singleton: checks 
*** RIVER *** [As 8h 6d Kh] [3c]
HighCardJasper: checks 
color_singleton: checks 
*** SHOW DOWN ***
HighCardJasper: shows [9c Tc] (high card Ace)
color_singleton: shows [8d 4c] (a pair of Eights)
color_singleton collected 546 from pot
*** SUMMARY ***
Total pot 578 | Rake 32 
Board [As 8h 6d Kh 3c]
Seat 1: color_singleton (big blind) showed [8d 4c] and won (546) with a pair of Eights
Seat 2: dockstarr folded before Flop (didn't bet)
Seat 3: PokerStarsMan12 folded before Flop (didn't bet)
Seat 5: manon327 (button) folded before Flop (didn't bet)
Seat 6: HighCardJasper (small blind) showed [9c Tc] and lost with high card Ace



PokerStars Home Game Hand #229542910811: {DaPokaStars}  Hold'em No Limit (50/100) - 2021/09/02 17:30:39 ET
Table 'summer poker' 9-max (Play Money) Seat #6 is the button
Seat 1: color_singleton (19360 in chips) 
Seat 2: dockstarr (5166 in chips) 
Seat 3: PokerStarsMan12 (10608 in chips) 
Seat 5: manon327 (8724 in chips) 
Seat 6: HighCardJasper (5105 in chips) 
color_singleton: posts small blind 50
dockstarr: posts big blind 100
*** HOLE CARDS ***
Dealt to PokerStarsMan12 [7c 9c]
PokerStarsMan12: calls 100
manon327: folds 
HighCardJasper: folds 
color_singleton: folds 
dockstarr: checks 
*** FLOP *** [Ah 6h 5s]
dockstarr: checks 
PokerStarsMan12: checks 
*** TURN *** [Ah 6h 5s] [Qc]
dockstarr: checks 
PokerStarsMan12: checks 
*** RIVER *** [Ah 6h 5s Qc] [8c]
dockstarr: checks 
PokerStarsMan12: bets 500
dockstarr: folds 
Uncalled bet (500) returned to PokerStarsMan12
PokerStarsMan12 collected 236 from pot
*** SUMMARY ***
Total pot 250 | Rake 14 
Board [Ah 6h 5s Qc 8c]
Seat 1: color_singleton (small blind) folded before Flop
Seat 2: dockstarr (big blind) folded on the River
Seat 3: PokerStarsMan12 collected (236)
Seat 5: manon327 folded before Flop (didn't bet)
Seat 6: HighCardJasper (button) folded before Flop (didn't bet)



PokerStars Home Game Hand #229542927172: {DaPokaStars}  Hold'em No Limit (50/100) - 2021/09/02 17:31:15 ET
Table 'summer poker' 9-max (Play Money) Seat #1 is the button
Seat 1: color_singleton (19310 in chips) 
Seat 2: dockstarr (5066 in chips) 
Seat 3: PokerStarsMan12 (10744 in chips) 
Seat 5: manon327 (8724 in chips) 
Seat 6: HighCardJasper (5105 in chips) 
dockstarr: posts small blind 50
PokerStarsMan12: posts big blind 100
*** HOLE CARDS ***
Dealt to PokerStarsMan12 [9h 2d]
manon327: calls 100
HighCardJasper: calls 100
color_singleton: calls 100
dockstarr: folds 
PokerStarsMan12: checks 
*** FLOP *** [6s 5s Kh]
PokerStarsMan12: checks 
manon327: checks 
HighCardJasper: checks 
color_singleton: checks 
*** TURN *** [6s 5s Kh] [5c]
PokerStarsMan12: checks 
manon327: bets 212
HighCardJasper: folds 
color_singleton: folds 
PokerStarsMan12: folds 
Uncalled bet (212) returned to manon327
manon327 collected 425 from pot
*** SUMMARY ***
Total pot 450 | Rake 25 
Board [6s 5s Kh 5c]
Seat 1: color_singleton (button) folded on the Turn
Seat 2: dockstarr (small blind) folded before Flop
Seat 3: PokerStarsMan12 (big blind) folded on the Turn
Seat 5: manon327 collected (425)
Seat 6: HighCardJasper folded on the Turn



PokerStars Home Game Hand #229542944472: {DaPokaStars}  Hold'em No Limit (50/100) - 2021/09/02 17:31:52 ET
Table 'summer poker' 9-max (Play Money) Seat #2 is the button
Seat 1: color_singleton (19210 in chips) 
Seat 2: dockstarr (5016 in chips) 
Seat 3: PokerStarsMan12 (10644 in chips) 
Seat 5: manon327 (9049 in chips) 
Seat 6: HighCardJasper (5005 in chips) 
PokerStarsMan12: posts small blind 50
manon327: posts big blind 100
*** HOLE CARDS ***
Dealt to PokerStarsMan12 [9h 8d]
HighCardJasper: folds 
color_singleton: raises 100 to 200
dockstarr: folds 
PokerStarsMan12: calls 150
manon327: calls 100
*** FLOP *** [Th 9d 9s]
PokerStarsMan12: checks 
manon327: checks 
color_singleton: bets 283
PokerStarsMan12: calls 283
manon327: folds 
*** TURN *** [Th 9d 9s] [Jc]
PokerStarsMan12: bets 600
color_singleton: calls 600
*** RIVER *** [Th 9d 9s Jc] [6s]
PokerStarsMan12: bets 800
color_singleton: folds 
Uncalled bet (800) returned to PokerStarsMan12
PokerStarsMan12 collected 2236 from pot
*** SUMMARY ***
Total pot 2366 | Rake 130 
Board [Th 9d 9s Jc 6s]
Seat 1: color_singleton folded on the River
Seat 2: dockstarr (button) folded before Flop (didn't bet)
Seat 3: PokerStarsMan12 (small blind) collected (2236)
Seat 5: manon327 (big blind) folded on the Flop
Seat 6: HighCardJasper folded before Flop (didn't bet)



PokerStars Home Game Hand #229542973269: {DaPokaStars}  Hold'em No Limit (50/100) - 2021/09/02 17:32:55 ET
Table 'summer poker' 9-max (Play Money) Seat #3 is the button
Seat 1: color_singleton (18127 in chips) 
Seat 2: dockstarr (5016 in chips) 
Seat 3: PokerStarsMan12 (11797 in chips) 
Seat 5: manon327 (8849 in chips) 
Seat 6: HighCardJasper (5005 in chips) 
manon327: posts small blind 50
HighCardJasper: posts big blind 100
*** HOLE CARDS ***
Dealt to PokerStarsMan12 [Th 8s]
color_singleton: folds 
dockstarr: calls 100
PokerStarsMan12: calls 100
manon327: raises 100 to 200
HighCardJasper: calls 100
dockstarr: calls 100
PokerStarsMan12: calls 100
*** FLOP *** [6c 7d 2h]
manon327: checks 
HighCardJasper: checks 
dockstarr: checks 
PokerStarsMan12: checks 
*** TURN *** [6c 7d 2h] [Qc]
manon327: checks 
HighCardJasper: checks 
dockstarr: checks 
PokerStarsMan12: checks 
*** RIVER *** [6c 7d 2h Qc] [8h]
manon327: bets 378
HighCardJasper: folds 
dockstarr: folds 
PokerStarsMan12: calls 378
*** SHOW DOWN ***
manon327: shows [Ah Ad] (a pair of Aces)
PokerStarsMan12: mucks hand 
manon327 collected 1470 from pot
*** SUMMARY ***
Total pot 1556 | Rake 86 
Board [6c 7d 2h Qc 8h]
Seat 1: color_singleton folded before Flop (didn't bet)
Seat 2: dockstarr folded on the River
Seat 3: PokerStarsMan12 (button) mucked [Th 8s]
Seat 5: manon327 (small blind) showed [Ah Ad] and won (1470) with a pair of Aces
Seat 6: HighCardJasper (big blind) folded on the River



PokerStars Home Game Hand #229542997862: {DaPokaStars}  Hold'em No Limit (50/100) - 2021/09/02 17:33:49 ET
Table 'summer poker' 9-max (Play Money) Seat #5 is the button
Seat 1: color_singleton (18127 in chips) 
Seat 2: dockstarr (4816 in chips) 
Seat 3: PokerStarsMan12 (11219 in chips) 
Seat 5: manon327 (9741 in chips) 
Seat 6: HighCardJasper (4805 in chips) 
HighCardJasper: posts small blind 50
color_singleton: posts big blind 100
*** HOLE CARDS ***
Dealt to PokerStarsMan12 [Ts Js]
dockstarr: folds 
PokerStarsMan12: raises 300 to 400
manon327: folds 
HighCardJasper: calls 350
color_singleton: calls 300
*** FLOP *** [2c 4s Qh]
HighCardJasper: checks 
color_singleton: checks 
PokerStarsMan12: checks 
*** TURN *** [2c 4s Qh] [9d]
HighCardJasper: checks 
color_singleton: checks 
PokerStarsMan12: bets 600
HighCardJasper: folds 
color_singleton: folds 
Uncalled bet (600) returned to PokerStarsMan12
PokerStarsMan12 collected 1134 from pot
*** SUMMARY ***
Total pot 1200 | Rake 66 
Board [2c 4s Qh 9d]
Seat 1: color_singleton (big blind) folded on the Turn
Seat 2: dockstarr folded before Flop (didn't bet)
Seat 3: PokerStarsMan12 collected (1134)
Seat 5: manon327 (button) folded before Flop (didn't bet)
Seat 6: HighCardJasper (small blind) folded on the Turn



PokerStars Home Game Hand #229543021014: {DaPokaStars}  Hold'em No Limit (50/100) - 2021/09/02 17:34:40 ET
Table 'summer poker' 9-max (Play Money) Seat #6 is the button
Seat 1: color_singleton (17727 in chips) 
Seat 2: dockstarr (4816 in chips) 
Seat 3: PokerStarsMan12 (11953 in chips) 
Seat 5: manon327 (9741 in chips) 
Seat 6: HighCardJasper (4405 in chips) 
color_singleton: posts small blind 50
dockstarr: posts big blind 100
*** HOLE CARDS ***
Dealt to PokerStarsMan12 [4s 7h]
PokerStarsMan12: folds 
manon327: calls 100
HighCardJasper: calls 100
color_singleton: calls 50
dockstarr: checks 
*** FLOP *** [2d 8s As]
color_singleton: checks 
dockstarr: checks 
manon327: checks 
HighCardJasper: bets 189
color_singleton: folds 
dockstarr: folds 
manon327: folds 
Uncalled bet (189) returned to HighCardJasper
HighCardJasper collected 378 from pot
HighCardJasper: doesn't show hand 
*** SUMMARY ***
Total pot 400 | Rake 22 
Board [2d 8s As]
Seat 1: color_singleton (small blind) folded on the Flop
Seat 2: dockstarr (big blind) folded on the Flop
Seat 3: PokerStarsMan12 folded before Flop (didn't bet)
Seat 5: manon327 folded on the Flop
Seat 6: HighCardJasper (button) collected (378)



PokerStars Home Game Hand #229543041603: {DaPokaStars}  Hold'em No Limit (50/100) - 2021/09/02 17:35:26 ET
Table 'summer poker' 9-max (Play Money) Seat #1 is the button
Seat 1: color_singleton (17627 in chips) 
Seat 2: dockstarr (4716 in chips) 
Seat 3: PokerStarsMan12 (11953 in chips) 
Seat 5: manon327 (9641 in chips) 
Seat 6: HighCardJasper (4683 in chips) 
dockstarr: posts small blind 50
PokerStarsMan12: posts big blind 100
*** HOLE CARDS ***
Dealt to PokerStarsMan12 [Th 3c]
manon327: calls 100
HighCardJasper: calls 100
color_singleton: calls 100
dockstarr: calls 50
PokerStarsMan12: checks 
*** FLOP *** [5h Td Qh]
dockstarr: checks 
PokerStarsMan12: checks 
manon327: bets 236
HighCardJasper: folds 
color_singleton: calls 236
dockstarr: calls 236
PokerStarsMan12: calls 236
*** TURN *** [5h Td Qh] [Qd]
dockstarr: checks 
PokerStarsMan12: checks 
manon327: bets 682
color_singleton: calls 682
dockstarr: folds 
PokerStarsMan12: calls 682
*** RIVER *** [5h Td Qh Qd] [Kh]
PokerStarsMan12: checks 
manon327: checks 
color_singleton: bets 1649
PokerStarsMan12: folds 
manon327: folds 
Uncalled bet (1649) returned to color_singleton
color_singleton collected 3298 from pot
color_singleton: doesn't show hand 
*** SUMMARY ***
Total pot 3490 | Rake 192 
Board [5h Td Qh Qd Kh]
Seat 1: color_singleton (button) collected (3298)
Seat 2: dockstarr (small blind) folded on the Turn
Seat 3: PokerStarsMan12 (big blind) folded on the River
Seat 5: manon327 folded on the River
Seat 6: HighCardJasper folded on the Flop



PokerStars Home Game Hand #229543078280: {DaPokaStars}  Hold'em No Limit (50/100) - 2021/09/02 17:36:48 ET
Table 'summer poker' 9-max (Play Money) Seat #2 is the button
Seat 1: color_singleton (19907 in chips) 
Seat 2: dockstarr (4380 in chips) 
Seat 3: PokerStarsMan12 (10935 in chips) 
Seat 5: manon327 (8623 in chips) 
Seat 6: HighCardJasper (4583 in chips) 
PokerStarsMan12: posts small blind 50
manon327: posts big blind 100
*** HOLE CARDS ***
Dealt to PokerStarsMan12 [Td 5h]
HighCardJasper: folds 
color_singleton: folds 
dockstarr: folds 
PokerStarsMan12: calls 50
manon327: checks 
*** FLOP *** [Qs 7d Tc]
PokerStarsMan12: checks 
manon327: checks 
*** TURN *** [Qs 7d Tc] [Ah]
PokerStarsMan12: bets 200
manon327: calls 200
*** RIVER *** [Qs 7d Tc Ah] [9d]
PokerStarsMan12: checks 
manon327: checks 
*** SHOW DOWN ***
PokerStarsMan12: shows [Td 5h] (a pair of Tens)
manon327: mucks hand 
PokerStarsMan12 collected 567 from pot
*** SUMMARY ***
Total pot 600 | Rake 33 
Board [Qs 7d Tc Ah 9d]
Seat 1: color_singleton folded before Flop (didn't bet)
Seat 2: dockstarr (button) folded before Flop (didn't bet)
Seat 3: PokerStarsMan12 (small blind) showed [Td 5h] and won (567) with a pair of Tens
Seat 5: manon327 (big blind) mucked [Jc 4c]
Seat 6: HighCardJasper folded before Flop (didn't bet)



PokerStars Home Game Hand #229543095418: {DaPokaStars}  Hold'em No Limit (50/100) - 2021/09/02 17:37:27 ET
Table 'summer poker' 9-max (Play Money) Seat #3 is the button
Seat 1: color_singleton (19907 in chips) 
Seat 2: dockstarr (4380 in chips) 
Seat 3: PokerStarsMan12 (11202 in chips) 
Seat 5: manon327 (8323 in chips) 
Seat 6: HighCardJasper (4583 in chips) 
manon327: posts small blind 50
HighCardJasper: posts big blind 100
*** HOLE CARDS ***
Dealt to PokerStarsMan12 [7s Ac]
color_singleton: raises 200 to 300
dockstarr: folds 
PokerStarsMan12: calls 300
manon327: calls 250
HighCardJasper: calls 200
*** FLOP *** [6c 9c 2h]
manon327: checks 
HighCardJasper: checks 
color_singleton: bets 567
PokerStarsMan12: folds 
manon327: folds 
HighCardJasper: folds 
Uncalled bet (567) returned to color_singleton
color_singleton collected 1134 from pot
color_singleton: doesn't show hand 
*** SUMMARY ***
Total pot 1200 | Rake 66 
Board [6c 9c 2h]
Seat 1: color_singleton collected (1134)
Seat 2: dockstarr folded before Flop (didn't bet)
Seat 3: PokerStarsMan12 (button) folded on the Flop
Seat 5: manon327 (small blind) folded on the Flop
Seat 6: HighCardJasper (big blind) folded on the Flop



PokerStars Home Game Hand #229543121069: {DaPokaStars}  Hold'em No Limit (50/100) - 2021/09/02 17:38:24 ET
Table 'summer poker' 9-max (Play Money) Seat #5 is the button
Seat 1: color_singleton (20741 in chips) 
Seat 2: dockstarr (4380 in chips) 
Seat 3: PokerStarsMan12 (10902 in chips) 
Seat 5: manon327 (8023 in chips) 
Seat 6: HighCardJasper (4283 in chips) 
HighCardJasper: posts small blind 50
color_singleton: posts big blind 100
*** HOLE CARDS ***
Dealt to PokerStarsMan12 [7d 4d]
dockstarr: folds 
PokerStarsMan12: calls 100
manon327: folds 
HighCardJasper: calls 50
color_singleton: checks 
*** FLOP *** [Ad 5h 2s]
HighCardJasper: checks 
color_singleton: bets 141
PokerStarsMan12: folds 
HighCardJasper: calls 141
*** TURN *** [Ad 5h 2s] [3c]
HighCardJasper: checks 
color_singleton: bets 275
HighCardJasper: folds 
Uncalled bet (275) returned to color_singleton
color_singleton collected 550 from pot
color_singleton: doesn't show hand 
*** SUMMARY ***
Total pot 582 | Rake 32 
Board [Ad 5h 2s 3c]
Seat 1: color_singleton (big blind) collected (550)
Seat 2: dockstarr folded before Flop (didn't bet)
Seat 3: PokerStarsMan12 folded on the Flop
Seat 5: manon327 (button) folded before Flop (didn't bet)
Seat 6: HighCardJasper (small blind) folded on the Turn



PokerStars Home Game Hand #229543145346: {DaPokaStars}  Hold'em No Limit (50/100) - 2021/09/02 17:39:18 ET
Table 'summer poker' 9-max (Play Money) Seat #6 is the button
Seat 1: color_singleton (21050 in chips) 
Seat 2: dockstarr (4380 in chips) 
Seat 3: PokerStarsMan12 (10802 in chips) 
Seat 5: manon327 (8023 in chips) 
Seat 6: HighCardJasper (4042 in chips) 
color_singleton: posts small blind 50
dockstarr: posts big blind 100
*** HOLE CARDS ***
Dealt to PokerStarsMan12 [5h Ah]
PokerStarsMan12: raises 200 to 300
manon327: folds 
HighCardJasper: calls 300
color_singleton: folds 
dockstarr: calls 200
*** FLOP *** [Jd 2h Js]
dockstarr: checks 
PokerStarsMan12: checks 
HighCardJasper: checks 
*** TURN *** [Jd 2h Js] [8c]
dockstarr: checks 
PokerStarsMan12: checks 
HighCardJasper: checks 
*** RIVER *** [Jd 2h Js 8c] [Tc]
dockstarr: checks 
PokerStarsMan12: checks 
HighCardJasper: bets 300
dockstarr: folds 
PokerStarsMan12: folds 
Uncalled bet (300) returned to HighCardJasper
HighCardJasper collected 898 from pot
HighCardJasper: doesn't show hand 
*** SUMMARY ***
Total pot 950 | Rake 52 
Board [Jd 2h Js 8c Tc]
Seat 1: color_singleton (small blind) folded before Flop
Seat 2: dockstarr (big blind) folded on the River
Seat 3: PokerStarsMan12 folded on the River
Seat 5: manon327 folded before Flop (didn't bet)
Seat 6: HighCardJasper (button) collected (898)



PokerStars Home Game Hand #229543164523: {DaPokaStars}  Hold'em No Limit (50/100) - 2021/09/02 17:40:01 ET
Table 'summer poker' 9-max (Play Money) Seat #1 is the button
Seat 1: color_singleton (21000 in chips) 
Seat 2: dockstarr (4080 in chips) 
Seat 3: PokerStarsMan12 (10502 in chips) 
Seat 5: manon327 (8023 in chips) 
Seat 6: HighCardJasper (4640 in chips) 
dockstarr: posts small blind 50
PokerStarsMan12: posts big blind 100
*** HOLE CARDS ***
Dealt to PokerStarsMan12 [4d 4h]
manon327: folds 
HighCardJasper: calls 100
color_singleton: folds 
dockstarr: folds 
PokerStarsMan12: raises 200 to 300
HighCardJasper: calls 200
*** FLOP *** [Qs As Qd]
PokerStarsMan12: checks 
HighCardJasper: checks 
*** TURN *** [Qs As Qd] [8s]
PokerStarsMan12: checks 
HighCardJasper: bets 307
PokerStarsMan12: folds 
Uncalled bet (307) returned to HighCardJasper
HighCardJasper collected 614 from pot
HighCardJasper: doesn't show hand 
*** SUMMARY ***
Total pot 650 | Rake 36 
Board [Qs As Qd 8s]
Seat 1: color_singleton (button) folded before Flop (didn't bet)
Seat 2: dockstarr (small blind) folded before Flop
Seat 3: PokerStarsMan12 (big blind) folded on the Turn
Seat 5: manon327 folded before Flop (didn't bet)
Seat 6: HighCardJasper collected (614)



PokerStars Home Game Hand #229543185120: {DaPokaStars}  Hold'em No Limit (50/100) - 2021/09/02 17:40:47 ET
Table 'summer poker' 9-max (Play Money) Seat #2 is the button
Seat 1: color_singleton (21000 in chips) 
Seat 2: dockstarr (4030 in chips) 
Seat 3: PokerStarsMan12 (10202 in chips) 
Seat 5: manon327 (8023 in chips) 
Seat 6: HighCardJasper (4954 in chips) 
PokerStarsMan12: posts small blind 50
manon327: posts big blind 100
*** HOLE CARDS ***
Dealt to PokerStarsMan12 [8d Kc]
HighCardJasper: calls 100
color_singleton: folds 
dockstarr: calls 100
PokerStarsMan12: calls 50
manon327: raises 100 to 200
HighCardJasper: calls 100
dockstarr: calls 100
PokerStarsMan12: calls 100
*** FLOP *** [Ac 8c Ah]
PokerStarsMan12: checks 
manon327: bets 378
HighCardJasper: folds 
dockstarr: folds 
PokerStarsMan12: calls 378
*** TURN *** [Ac 8c Ah] [Kd]
PokerStarsMan12: checks 
manon327: bets 735
PokerStarsMan12: calls 735
*** RIVER *** [Ac 8c Ah Kd] [8s]
PokerStarsMan12: checks 
manon327: bets 2860
PokerStarsMan12 has timed out
PokerStarsMan12: folds 
Uncalled bet (2860) returned to manon327
manon327 collected 2860 from pot
*** SUMMARY ***
Total pot 3026 | Rake 166 
Board [Ac 8c Ah Kd 8s]
Seat 1: color_singleton folded before Flop (didn't bet)
Seat 2: dockstarr (button) folded on the Flop
Seat 3: PokerStarsMan12 (small blind) folded on the River
Seat 5: manon327 (big blind) collected (2860)
Seat 6: HighCardJasper folded on the Flop



PokerStars Home Game Hand #229543228359: {DaPokaStars}  Hold'em No Limit (50/100) - 2021/09/02 17:42:25 ET
Table 'summer poker' 9-max (Play Money) Seat #3 is the button
Seat 1: color_singleton (21000 in chips) 
Seat 2: dockstarr (3830 in chips) 
Seat 3: PokerStarsMan12 (8889 in chips) 
Seat 5: manon327 (9570 in chips) 
Seat 6: HighCardJasper (4754 in chips) 
manon327: posts small blind 50
HighCardJasper: posts big blind 100
*** HOLE CARDS ***
Dealt to PokerStarsMan12 [Th 4h]
color_singleton: raises 200 to 300
dockstarr: calls 300
PokerStarsMan12: folds 
manon327: calls 250
HighCardJasper: folds 
*** FLOP *** [5d Js Ad]
manon327: bets 472
color_singleton: calls 472
dockstarr: folds 
*** TURN *** [5d Js Ad] [6d]
manon327: checks 
color_singleton: checks 
*** RIVER *** [5d Js Ad 6d] [8s]
manon327: bets 918
color_singleton: folds 
Uncalled bet (918) returned to manon327
manon327 collected 1837 from pot
*** SUMMARY ***
Total pot 1944 | Rake 107 
Board [5d Js Ad 6d 8s]
Seat 1: color_singleton folded on the River
Seat 2: dockstarr folded on the Flop
Seat 3: PokerStarsMan12 (button) folded before Flop (didn't bet)
Seat 5: manon327 (small blind) collected (1837)
Seat 6: HighCardJasper (big blind) folded before Flop



PokerStars Home Game Hand #229543260711: {DaPokaStars}  Hold'em No Limit (50/100) - 2021/09/02 17:43:17 ET
Table 'summer poker' 9-max (Play Money) Seat #5 is the button
Seat 1: color_singleton (20228 in chips) 
Seat 2: dockstarr (3530 in chips) 
Seat 3: PokerStarsMan12 (8889 in chips) 
Seat 5: manon327 (10635 in chips) 
Seat 6: HighCardJasper (4654 in chips) 
HighCardJasper: posts small blind 50
color_singleton: posts big blind 100
*** HOLE CARDS ***
Dealt to PokerStarsMan12 [6d Kc]
dockstarr: folds 
PokerStarsMan12: folds 
manon327: raises 100 to 200
HighCardJasper: folds 
color_singleton: folds 
Uncalled bet (100) returned to manon327
manon327 collected 250 from pot
*** SUMMARY ***
Total pot 250 | Rake 0 
Seat 1: color_singleton (big blind) folded before Flop
Seat 2: dockstarr folded before Flop (didn't bet)
Seat 3: PokerStarsMan12 folded before Flop (didn't bet)
Seat 5: manon327 (button) collected (250)
Seat 6: HighCardJasper (small blind) folded before Flop



PokerStars Home Game Hand #229543265781: {DaPokaStars}  Hold'em No Limit (50/100) - 2021/09/02 17:43:29 ET
Table 'summer poker' 9-max (Play Money) Seat #6 is the button
Seat 1: color_singleton (20128 in chips) 
Seat 2: dockstarr (3530 in chips) 
Seat 3: PokerStarsMan12 (8889 in chips) 
Seat 5: manon327 (10785 in chips) 
Seat 6: HighCardJasper (4604 in chips) 
color_singleton: posts small blind 50
dockstarr: posts big blind 100
*** HOLE CARDS ***
Dealt to PokerStarsMan12 [Ts 3c]
PokerStarsMan12: folds 
manon327: calls 100
HighCardJasper: calls 100
color_singleton: folds 
dockstarr: checks 
*** FLOP *** [8h 5s 4d]
dockstarr: checks 
manon327: checks 
HighCardJasper: bets 100
dockstarr: calls 100
manon327: folds 
*** TURN *** [8h 5s 4d] [9d]
dockstarr: checks 
HighCardJasper: bets 260
dockstarr: folds 
Uncalled bet (260) returned to HighCardJasper
HighCardJasper collected 520 from pot
HighCardJasper: doesn't show hand 
*** SUMMARY ***
Total pot 550 | Rake 30 
Board [8h 5s 4d 9d]
Seat 1: color_singleton (small blind) folded before Flop
Seat 2: dockstarr (big blind) folded on the Turn
Seat 3: PokerStarsMan12 folded before Flop (didn't bet)
Seat 5: manon327 folded on the Flop
Seat 6: HighCardJasper (button) collected (520)



PokerStars Home Game Hand #229543280259: {DaPokaStars}  Hold'em No Limit (50/100) - 2021/09/02 17:44:02 ET
Table 'summer poker' 9-max (Play Money) Seat #1 is the button
Seat 1: color_singleton (20078 in chips) 
Seat 2: dockstarr (3330 in chips) 
Seat 3: PokerStarsMan12 (8889 in chips) 
Seat 5: manon327 (10685 in chips) 
Seat 6: HighCardJasper (4924 in chips) 
dockstarr: posts small blind 50
PokerStarsMan12: posts big blind 100
*** HOLE CARDS ***
Dealt to PokerStarsMan12 [5d 2c]
manon327: calls 100
HighCardJasper: calls 100
color_singleton has timed out
color_singleton: folds 
dockstarr: calls 50
PokerStarsMan12: checks 
*** FLOP *** [Kc 9c 8d]
dockstarr: bets 100
PokerStarsMan12 has timed out
PokerStarsMan12: folds 
manon327: calls 100
HighCardJasper: calls 100
*** TURN *** [Kc 9c 8d] [6c]
dockstarr: bets 100
manon327: folds 
HighCardJasper: calls 100
*** RIVER *** [Kc 9c 8d 6c] [Td]
dockstarr has timed out
dockstarr: checks 
HighCardJasper: bets 425
dockstarr: calls 425
*** SHOW DOWN ***
HighCardJasper: shows [7h Jh] (a straight, Seven to Jack)
dockstarr: mucks hand 
HighCardJasper collected 1654 from pot
*** SUMMARY ***
Total pot 1750 | Rake 96 
Board [Kc 9c 8d 6c Td]
Seat 1: color_singleton (button) folded before Flop (didn't bet)
Seat 2: dockstarr (small blind) mucked [2d Kd]
Seat 3: PokerStarsMan12 (big blind) folded on the Flop
Seat 5: manon327 folded on the Turn
Seat 6: HighCardJasper showed [7h Jh] and won (1654) with a straight, Seven to Jack



PokerStars Home Game Hand #229543354244: {DaPokaStars}  Hold'em No Limit (50/100) - 2021/09/02 17:46:51 ET
Table 'summer poker' 9-max (Play Money) Seat #6 is the button
Seat 1: color_singleton (20261 in chips) 
Seat 2: dockstarr (2605 in chips) 
Seat 3: PokerStarsMan12 (8789 in chips) 
Seat 5: manon327 (10285 in chips) 
Seat 6: HighCardJasper (5842 in chips) 
color_singleton: posts small blind 50
dockstarr: posts big blind 100
PokerStarsMan12: posts small blind 50
*** HOLE CARDS ***
Dealt to PokerStarsMan12 [8s 4s]
PokerStarsMan12: folds 
manon327: folds 
HighCardJasper: folds 
color_singleton: calls 50
dockstarr: checks 
*** FLOP *** [8h 4d 8c]
color_singleton: checks 
dockstarr: checks 
*** TURN *** [8h 4d 8c] [5c]
color_singleton: bets 118
dockstarr: folds 
Uncalled bet (118) returned to color_singleton
color_singleton collected 236 from pot
color_singleton: doesn't show hand 
*** SUMMARY ***
Total pot 250 | Rake 14 
Board [8h 4d 8c 5c]
Seat 1: color_singleton (small blind) collected (236)
Seat 2: dockstarr (big blind) folded on the Turn
Seat 3: PokerStarsMan12 folded before Flop (didn't bet)
Seat 5: manon327 folded before Flop (didn't bet)
Seat 6: HighCardJasper (button) folded before Flop (didn't bet)



PokerStars Home Game Hand #229543376716: {DaPokaStars}  Hold'em No Limit (50/100) - 2021/09/02 17:47:43 ET
Table 'summer poker' 9-max (Play Money) Seat #1 is the button
Seat 1: color_singleton (20397 in chips) 
Seat 2: dockstarr (2505 in chips) 
Seat 3: PokerStarsMan12 (8739 in chips) 
Seat 5: manon327 (10285 in chips) 
Seat 6: HighCardJasper (5842 in chips) 
dockstarr: posts small blind 50
PokerStarsMan12: posts big blind 100
*** HOLE CARDS ***
Dealt to PokerStarsMan12 [8h 3d]
manon327: calls 100
HighCardJasper: calls 100
color_singleton: calls 100
dockstarr: calls 50
PokerStarsMan12: checks 
*** FLOP *** [4c 7s Qd]
dockstarr: checks 
PokerStarsMan12: checks 
manon327: checks 
HighCardJasper: checks 
color_singleton: checks 
*** TURN *** [4c 7s Qd] [8d]
dockstarr: checks 
PokerStarsMan12: bets 300
manon327: folds 
HighCardJasper: folds 
color_singleton: folds 
dockstarr: folds 
Uncalled bet (300) returned to PokerStarsMan12
PokerStarsMan12 collected 472 from pot
*** SUMMARY ***
Total pot 500 | Rake 28 
Board [4c 7s Qd 8d]
Seat 1: color_singleton (button) folded on the Turn
Seat 2: dockstarr (small blind) folded on the Turn
Seat 3: PokerStarsMan12 (big blind) collected (472)
Seat 5: manon327 folded on the Turn
Seat 6: HighCardJasper folded on the Turn



PokerStars Home Game Hand #229543391831: {DaPokaStars}  Hold'em No Limit (50/100) - 2021/09/02 17:48:18 ET
Table 'summer poker' 9-max (Play Money) Seat #2 is the button
Seat 1: color_singleton (20297 in chips) 
Seat 2: dockstarr (2405 in chips) 
Seat 3: PokerStarsMan12 (9111 in chips) 
Seat 5: manon327 (10185 in chips) 
Seat 6: HighCardJasper (5742 in chips) 
PokerStarsMan12: posts small blind 50
manon327: posts big blind 100
*** HOLE CARDS ***
Dealt to PokerStarsMan12 [Jd Th]
HighCardJasper: folds 
color_singleton: folds 
dockstarr: folds 
PokerStarsMan12: calls 50
manon327: checks 
*** FLOP *** [Kc Jc 3h]
PokerStarsMan12: checks 
manon327: checks 
*** TURN *** [Kc Jc 3h] [Js]
PokerStarsMan12: bets 200
manon327: folds 
Uncalled bet (200) returned to PokerStarsMan12
PokerStarsMan12 collected 189 from pot
*** SUMMARY ***
Total pot 200 | Rake 11 
Board [Kc Jc 3h Js]
Seat 1: color_singleton folded before Flop (didn't bet)
Seat 2: dockstarr (button) folded before Flop (didn't bet)
Seat 3: PokerStarsMan12 (small blind) collected (189)
Seat 5: manon327 (big blind) folded on the Turn
Seat 6: HighCardJasper folded before Flop (didn't bet)



PokerStars Home Game Hand #229543406096: {DaPokaStars}  Hold'em No Limit (50/100) - 2021/09/02 17:48:51 ET
Table 'summer poker' 9-max (Play Money) Seat #3 is the button
Seat 1: color_singleton (20297 in chips) 
Seat 2: dockstarr (2405 in chips) 
Seat 3: PokerStarsMan12 (9200 in chips) 
Seat 5: manon327 (10085 in chips) 
Seat 6: HighCardJasper (5742 in chips) 
manon327: posts small blind 50
HighCardJasper: posts big blind 100
*** HOLE CARDS ***
Dealt to PokerStarsMan12 [Ks As]
color_singleton has timed out
color_singleton: folds 
dockstarr: calls 100
PokerStarsMan12: raises 300 to 400
manon327: calls 350
HighCardJasper: folds 
dockstarr: calls 300
*** FLOP *** [3h Ac 3c]
manon327: checks 
dockstarr: checks 
PokerStarsMan12: bets 700
manon327: folds 
dockstarr: folds 
Uncalled bet (700) returned to PokerStarsMan12
PokerStarsMan12 collected 1228 from pot
*** SUMMARY ***
Total pot 1300 | Rake 72 
Board [3h Ac 3c]
Seat 1: color_singleton folded before Flop (didn't bet)
Seat 2: dockstarr folded on the Flop
Seat 3: PokerStarsMan12 (button) collected (1228)
Seat 5: manon327 (small blind) folded on the Flop
Seat 6: HighCardJasper (big blind) folded before Flop



PokerStars Home Game Hand #229543426600: {DaPokaStars}  Hold'em No Limit (50/100) - 2021/09/02 17:49:39 ET
Table 'summer poker' 9-max (Play Money) Seat #5 is the button
Seat 1: color_singleton (20297 in chips) 
Seat 2: dockstarr (2005 in chips) 
Seat 3: PokerStarsMan12 (10028 in chips) 
Seat 5: manon327 (9685 in chips) 
Seat 6: HighCardJasper (5642 in chips) 
HighCardJasper: posts small blind 50
color_singleton: posts big blind 100
*** HOLE CARDS ***
Dealt to PokerStarsMan12 [Td 2c]
dockstarr: folds 
PokerStarsMan12: folds 
manon327: calls 100
HighCardJasper: calls 50
color_singleton: checks 
*** FLOP *** [7h 7c 3d]
HighCardJasper: bets 100
color_singleton: folds 
manon327: folds 
Uncalled bet (100) returned to HighCardJasper
HighCardJasper collected 283 from pot
HighCardJasper: doesn't show hand 
*** SUMMARY ***
Total pot 300 | Rake 17 
Board [7h 7c 3d]
Seat 1: color_singleton (big blind) folded on the Flop
Seat 2: dockstarr folded before Flop (didn't bet)
Seat 3: PokerStarsMan12 folded before Flop (didn't bet)
Seat 5: manon327 (button) folded on the Flop
Seat 6: HighCardJasper (small blind) collected (283)



PokerStars Home Game Hand #229543437974: {DaPokaStars}  Hold'em No Limit (50/100) - 2021/09/02 17:50:05 ET
Table 'summer poker' 9-max (Play Money) Seat #6 is the button
Seat 1: color_singleton (20197 in chips) 
Seat 2: dockstarr (2005 in chips) 
Seat 3: PokerStarsMan12 (10028 in chips) 
Seat 5: manon327 (9585 in chips) 
Seat 6: HighCardJasper (5825 in chips) 
color_singleton: posts small blind 50
dockstarr: posts big blind 100
*** HOLE CARDS ***
Dealt to PokerStarsMan12 [Jh 4s]
PokerStarsMan12: folds 
manon327: folds 
HighCardJasper: calls 100
color_singleton: folds 
dockstarr: checks 
*** FLOP *** [6s 6d Kh]
dockstarr: checks 
HighCardJasper: checks 
*** TURN *** [6s 6d Kh] [8s]
dockstarr: checks 
HighCardJasper: checks 
*** RIVER *** [6s 6d Kh 8s] [Ks]
dockstarr: checks 
HighCardJasper: checks 
*** SHOW DOWN ***
dockstarr: shows [Qd 2h] (two pair, Kings and Sixes)
HighCardJasper: mucks hand 
dockstarr collected 236 from pot
*** SUMMARY ***
Total pot 250 | Rake 14 
Board [6s 6d Kh 8s Ks]
Seat 1: color_singleton (small blind) folded before Flop
Seat 2: dockstarr (big blind) showed [Qd 2h] and won (236) with two pair, Kings and Sixes
Seat 3: PokerStarsMan12 folded before Flop (didn't bet)
Seat 5: manon327 folded before Flop (didn't bet)
Seat 6: HighCardJasper (button) mucked [4c 2s]



PokerStars Home Game Hand #229543449592: {DaPokaStars}  Hold'em No Limit (50/100) - 2021/09/02 17:50:32 ET
Table 'summer poker' 9-max (Play Money) Seat #1 is the button
Seat 1: color_singleton (20147 in chips) 
Seat 2: dockstarr (2141 in chips) 
Seat 3: PokerStarsMan12 (10028 in chips) 
Seat 5: manon327 (9585 in chips) 
Seat 6: HighCardJasper (5725 in chips) 
dockstarr: posts small blind 50
PokerStarsMan12: posts big blind 100
*** HOLE CARDS ***
Dealt to PokerStarsMan12 [8h Qc]
manon327: calls 100
HighCardJasper: folds 
color_singleton: raises 100 to 200
dockstarr: calls 150
PokerStarsMan12: calls 100
manon327: calls 100
*** FLOP *** [9h Td 3s]
dockstarr: checks 
PokerStarsMan12: checks 
manon327: checks 
color_singleton: checks 
*** TURN *** [9h Td 3s] [5d]
dockstarr: checks 
PokerStarsMan12: checks 
manon327: checks 
color_singleton: checks 
*** RIVER *** [9h Td 3s 5d] [7s]
dockstarr: checks 
PokerStarsMan12: checks 
manon327: checks 
color_singleton: checks 
*** SHOW DOWN ***
dockstarr: shows [Jh Kd] (high card King)
PokerStarsMan12: mucks hand 
manon327: mucks hand 
color_singleton: shows [8d Ac] (high card Ace)
color_singleton collected 756 from pot
*** SUMMARY ***
Total pot 800 | Rake 44 
Board [9h Td 3s 5d 7s]
Seat 1: color_singleton (button) showed [8d Ac] and won (756) with high card Ace
Seat 2: dockstarr (small blind) showed [Jh Kd] and lost with high card King
Seat 3: PokerStarsMan12 (big blind) mucked [8h Qc]
Seat 5: manon327 mucked [2d Kc]
Seat 6: HighCardJasper folded before Flop (didn't bet)



PokerStars Home Game Hand #229543484516: {DaPokaStars}  Hold'em No Limit (50/100) - 2021/09/02 17:51:34 ET
Table 'summer poker' 9-max (Play Money) Seat #2 is the button
Seat 1: color_singleton (20703 in chips) 
Seat 2: dockstarr (1941 in chips) 
Seat 3: PokerStarsMan12 (9828 in chips) 
Seat 5: manon327 (9385 in chips) 
Seat 6: HighCardJasper (5725 in chips) 
PokerStarsMan12: posts small blind 50
manon327: posts big blind 100
*** HOLE CARDS ***
Dealt to PokerStarsMan12 [Kc 8h]
HighCardJasper: calls 100
color_singleton: folds 
dockstarr: calls 100
PokerStarsMan12: calls 50
manon327: checks 
*** FLOP *** [5h Jh 4c]
PokerStarsMan12: checks 
manon327: checks 
HighCardJasper: bets 189
dockstarr: folds 
PokerStarsMan12: folds 
manon327: folds 
Uncalled bet (189) returned to HighCardJasper
HighCardJasper collected 378 from pot
HighCardJasper: doesn't show hand 
*** SUMMARY ***
Total pot 400 | Rake 22 
Board [5h Jh 4c]
Seat 1: color_singleton folded before Flop (didn't bet)
Seat 2: dockstarr (button) folded on the Flop
Seat 3: PokerStarsMan12 (small blind) folded on the Flop
Seat 5: manon327 (big blind) folded on the Flop
Seat 6: HighCardJasper collected (378)



PokerStars Home Game Hand #229543500471: {DaPokaStars}  Hold'em No Limit (50/100) - 2021/09/02 17:52:12 ET
Table 'summer poker' 9-max (Play Money) Seat #3 is the button
Seat 1: color_singleton (20703 in chips) 
Seat 2: dockstarr (1841 in chips) 
Seat 3: PokerStarsMan12 (9728 in chips) 
Seat 5: manon327 (9285 in chips) 
Seat 6: HighCardJasper (6003 in chips) 
manon327: posts small blind 50
HighCardJasper: posts big blind 100
*** HOLE CARDS ***
Dealt to PokerStarsMan12 [2d 8s]
color_singleton: folds 
dockstarr: folds 
PokerStarsMan12: folds 
manon327: calls 50
HighCardJasper: checks 
*** FLOP *** [Ah 5c 3c]
manon327: checks 
HighCardJasper: checks 
*** TURN *** [Ah 5c 3c] [9d]
manon327: checks 
HighCardJasper: bets 189
manon327: folds 
Uncalled bet (189) returned to HighCardJasper
HighCardJasper collected 189 from pot
HighCardJasper: doesn't show hand 
*** SUMMARY ***
Total pot 200 | Rake 11 
Board [Ah 5c 3c 9d]
Seat 1: color_singleton folded before Flop (didn't bet)
Seat 2: dockstarr folded before Flop (didn't bet)
Seat 3: PokerStarsMan12 (button) folded before Flop (didn't bet)
Seat 5: manon327 (small blind) folded on the Turn
Seat 6: HighCardJasper (big blind) collected (189)



PokerStars Home Game Hand #229543512760: {DaPokaStars}  Hold'em No Limit (50/100) - 2021/09/02 17:52:42 ET
Table 'summer poker' 9-max (Play Money) Seat #5 is the button
Seat 1: color_singleton (20703 in chips) 
Seat 2: dockstarr (1841 in chips) 
Seat 3: PokerStarsMan12 (9728 in chips) 
Seat 5: manon327 (9185 in chips) 
Seat 6: HighCardJasper (6092 in chips) 
HighCardJasper: posts small blind 50
color_singleton: posts big blind 100
*** HOLE CARDS ***
Dealt to PokerStarsMan12 [9d 8c]
dockstarr: folds 
PokerStarsMan12: calls 100
manon327: folds 
HighCardJasper: calls 50
color_singleton: checks 
*** FLOP *** [2s 3s Ac]
HighCardJasper: checks 
color_singleton: bets 141
PokerStarsMan12: folds 
HighCardJasper: folds 
Uncalled bet (141) returned to color_singleton
color_singleton collected 283 from pot
color_singleton: doesn't show hand 
*** SUMMARY ***
Total pot 300 | Rake 17 
Board [2s 3s Ac]
Seat 1: color_singleton (big blind) collected (283)
Seat 2: dockstarr folded before Flop (didn't bet)
Seat 3: PokerStarsMan12 folded on the Flop
Seat 5: manon327 (button) folded before Flop (didn't bet)
Seat 6: HighCardJasper (small blind) folded on the Flop



PokerStars Home Game Hand #229543525206: {DaPokaStars}  Hold'em No Limit (50/100) - 2021/09/02 17:53:11 ET
Table 'summer poker' 9-max (Play Money) Seat #6 is the button
Seat 1: color_singleton (20886 in chips) 
Seat 2: dockstarr (1841 in chips) 
Seat 3: PokerStarsMan12 (9628 in chips) 
Seat 5: manon327 (9185 in chips) 
Seat 6: HighCardJasper (5992 in chips) 
color_singleton: posts small blind 50
dockstarr: posts big blind 100
*** HOLE CARDS ***
Dealt to PokerStarsMan12 [5d 2h]
PokerStarsMan12: folds 
manon327: calls 100
HighCardJasper: calls 100
color_singleton: calls 50
dockstarr: checks 
*** FLOP *** [3s Kd 6c]
color_singleton: checks 
dockstarr: checks 
manon327: checks 
HighCardJasper: checks 
*** TURN *** [3s Kd 6c] [Ks]
color_singleton: checks 
dockstarr: checks 
manon327: checks 
HighCardJasper: checks 
*** RIVER *** [3s Kd 6c Ks] [Ts]
color_singleton: checks 
dockstarr: checks 
manon327: checks 
HighCardJasper: checks 
*** SHOW DOWN ***
color_singleton: shows [8h Jd] (a pair of Kings)
dockstarr: shows [3d 9d] (two pair, Kings and Threes)
manon327: mucks hand 
HighCardJasper: mucks hand 
dockstarr collected 378 from pot
*** SUMMARY ***
Total pot 400 | Rake 22 
Board [3s Kd 6c Ks Ts]
Seat 1: color_singleton (small blind) showed [8h Jd] and lost with a pair of Kings
Seat 2: dockstarr (big blind) showed [3d 9d] and won (378) with two pair, Kings and Threes
Seat 3: PokerStarsMan12 folded before Flop (didn't bet)
Seat 5: manon327 mucked [7h Ac]
Seat 6: HighCardJasper (button) mucked [2s 8c]



PokerStars Home Game Hand #229543542706: {DaPokaStars}  Hold'em No Limit (50/100) - 2021/09/02 17:53:53 ET
Table 'summer poker' 9-max (Play Money) Seat #1 is the button
Seat 1: color_singleton (20786 in chips) 
Seat 2: dockstarr (2119 in chips) 
Seat 3: PokerStarsMan12 (9628 in chips) 
Seat 5: manon327 (9085 in chips) 
Seat 6: HighCardJasper (5892 in chips) 
dockstarr: posts small blind 50
PokerStarsMan12: posts big blind 100
*** HOLE CARDS ***
Dealt to PokerStarsMan12 [Td Qd]
manon327: calls 100
HighCardJasper: calls 100
color_singleton: folds 
dockstarr: calls 50
PokerStarsMan12: raises 200 to 300
manon327: calls 200
HighCardJasper: calls 200
dockstarr: calls 200
*** FLOP *** [7s Jd 8s]
dockstarr: checks 
PokerStarsMan12: checks 
manon327: checks 
HighCardJasper: checks 
*** TURN *** [7s Jd 8s] [2h]
dockstarr: checks 
PokerStarsMan12: checks 
manon327: checks 
HighCardJasper: checks 
*** RIVER *** [7s Jd 8s 2h] [4h]
dockstarr: checks 
PokerStarsMan12: checks 
manon327: checks 
HighCardJasper: checks 
*** SHOW DOWN ***
dockstarr: shows [Ad 8d] (a pair of Eights)
PokerStarsMan12: mucks hand 
manon327: mucks hand 
HighCardJasper: mucks hand 
dockstarr collected 1134 from pot
*** SUMMARY ***
Total pot 1200 | Rake 66 
Board [7s Jd 8s 2h 4h]
Seat 1: color_singleton (button) folded before Flop (didn't bet)
Seat 2: dockstarr (small blind) showed [Ad 8d] and won (1134) with a pair of Eights
Seat 3: PokerStarsMan12 (big blind) mucked [Td Qd]
Seat 5: manon327 mucked [Ah 2s]
Seat 6: HighCardJasper mucked [6d Qc]



PokerStars Home Game Hand #229543567268: {DaPokaStars}  Hold'em No Limit (50/100) - 2021/09/02 17:54:52 ET
Table 'summer poker' 9-max (Play Money) Seat #2 is the button
Seat 1: color_singleton (20786 in chips) 
Seat 2: dockstarr (2953 in chips) 
Seat 3: PokerStarsMan12 (9328 in chips) 
Seat 5: manon327 (8785 in chips) 
Seat 6: HighCardJasper (5592 in chips) 
PokerStarsMan12: posts small blind 50
manon327: posts big blind 100
*** HOLE CARDS ***
Dealt to PokerStarsMan12 [4h 6s]
HighCardJasper: calls 100
color_singleton: calls 100
dockstarr: folds 
PokerStarsMan12: calls 50
manon327: checks 
*** FLOP *** [5d 5c 8c]
PokerStarsMan12: checks 
manon327: bets 189
HighCardJasper: calls 189
color_singleton: calls 189
PokerStarsMan12: folds 
*** TURN *** [5d 5c 8c] [Ac]
manon327: bets 457
HighCardJasper: calls 457
color_singleton: folds 
*** RIVER *** [5d 5c 8c Ac] [3d]
manon327: bets 889
HighCardJasper: folds 
Uncalled bet (889) returned to manon327
manon327 collected 1778 from pot
*** SUMMARY ***
Total pot 1881 | Rake 103 
Board [5d 5c 8c Ac 3d]
Seat 1: color_singleton folded on the Turn
Seat 2: dockstarr (button) folded before Flop (didn't bet)
Seat 3: PokerStarsMan12 (small blind) folded on the Flop
Seat 5: manon327 (big blind) collected (1778)
Seat 6: HighCardJasper folded on the River



PokerStars Home Game Hand #229543580281: {DaPokaStars}  Hold'em No Limit (50/100) - 2021/09/02 17:55:29 ET
Table 'summer poker' 9-max (Play Money) Seat #3 is the button
Seat 1: color_singleton (20497 in chips) 
Seat 2: dockstarr (2953 in chips) 
Seat 3: PokerStarsMan12 (9228 in chips) 
Seat 5: manon327 (9817 in chips) 
Seat 6: HighCardJasper (4846 in chips) 
manon327: posts small blind 50
HighCardJasper: posts big blind 100
*** HOLE CARDS ***
Dealt to PokerStarsMan12 [5c 3h]
color_singleton: folds 
dockstarr: calls 100
PokerStarsMan12: calls 100
manon327: folds 
HighCardJasper: checks 
*** FLOP *** [9c 5d 8d]
HighCardJasper: checks 
dockstarr: checks 
PokerStarsMan12: bets 200
HighCardJasper: calls 200
dockstarr: folds 
*** TURN *** [9c 5d 8d] [4h]
HighCardJasper: checks 
PokerStarsMan12: checks 
*** RIVER *** [9c 5d 8d 4h] [3d]
HighCardJasper: checks 
PokerStarsMan12: bets 400
HighCardJasper: folds 
Uncalled bet (400) returned to PokerStarsMan12
PokerStarsMan12 collected 709 from pot
*** SUMMARY ***
Total pot 750 | Rake 41 
Board [9c 5d 8d 4h 3d]
Seat 1: color_singleton folded before Flop (didn't bet)
Seat 2: dockstarr folded on the Flop
Seat 3: PokerStarsMan12 (button) collected (709)
Seat 5: manon327 (small blind) folded before Flop
Seat 6: HighCardJasper (big blind) folded on the River



PokerStars Home Game Hand #229543595642: {DaPokaStars}  Hold'em No Limit (50/100) - 2021/09/02 17:56:19 ET
Table 'summer poker' 9-max (Play Money) Seat #5 is the button
Seat 1: color_singleton (20497 in chips) 
Seat 2: dockstarr (2853 in chips) 
Seat 3: PokerStarsMan12 (9637 in chips) 
Seat 5: manon327 (9767 in chips) 
Seat 6: HighCardJasper (4546 in chips) 
HighCardJasper: posts small blind 50
color_singleton: posts big blind 100
*** HOLE CARDS ***
Dealt to PokerStarsMan12 [8s 2c]
dockstarr: calls 100
PokerStarsMan12: folds 
manon327: calls 100
HighCardJasper: calls 50
color_singleton: raises 200 to 300
dockstarr: calls 200
manon327: calls 200
HighCardJasper: calls 200
*** FLOP *** [4h Jd 9d]
HighCardJasper: checks 
color_singleton: checks 
dockstarr: checks 
manon327: checks 
*** TURN *** [4h Jd 9d] [Qc]
HighCardJasper: checks 
color_singleton: checks 
dockstarr: checks 
manon327: checks 
*** RIVER *** [4h Jd 9d Qc] [8d]
HighCardJasper: checks 
color_singleton: checks 
dockstarr: checks 
manon327: bets 1134
HighCardJasper: folds 
color_singleton: folds 
dockstarr: folds 
Uncalled bet (1134) returned to manon327
manon327 collected 1134 from pot
*** SUMMARY ***
Total pot 1200 | Rake 66 
Board [4h Jd 9d Qc 8d]
Seat 1: color_singleton (big blind) folded on the River
Seat 2: dockstarr folded on the River
Seat 3: PokerStarsMan12 folded before Flop (didn't bet)
Seat 5: manon327 (button) collected (1134)
Seat 6: HighCardJasper (small blind) folded on the River



PokerStars Home Game Hand #229543615048: {DaPokaStars}  Hold'em No Limit (50/100) - 2021/09/02 17:57:22 ET
Table 'summer poker' 9-max (Play Money) Seat #6 is the button
Seat 1: color_singleton (20197 in chips) 
Seat 2: dockstarr (2553 in chips) 
Seat 3: PokerStarsMan12 (9637 in chips) 
Seat 5: manon327 (10601 in chips) 
Seat 6: HighCardJasper (4246 in chips) 
color_singleton: posts small blind 50
dockstarr: posts big blind 100
*** HOLE CARDS ***
Dealt to PokerStarsMan12 [9c 5s]
PokerStarsMan12: folds 
manon327: folds 
HighCardJasper: calls 100
color_singleton: folds 
dockstarr: checks 
*** FLOP *** [9s 8s 7c]
dockstarr: checks 
HighCardJasper: bets 100
dockstarr: folds 
Uncalled bet (100) returned to HighCardJasper
HighCardJasper collected 236 from pot
HighCardJasper: doesn't show hand 
*** SUMMARY ***
Total pot 250 | Rake 14 
Board [9s 8s 7c]
Seat 1: color_singleton (small blind) folded before Flop
Seat 2: dockstarr (big blind) folded on the Flop
Seat 3: PokerStarsMan12 folded before Flop (didn't bet)
Seat 5: manon327 folded before Flop (didn't bet)
Seat 6: HighCardJasper (button) collected (236)



PokerStars Home Game Hand #229543628090: {DaPokaStars}  Hold'em No Limit (50/100) - 2021/09/02 17:58:03 ET
Table 'summer poker' 9-max (Play Money) Seat #1 is the button
Seat 1: color_singleton (20147 in chips) 
Seat 2: dockstarr (2453 in chips) 
Seat 3: PokerStarsMan12 (9637 in chips) 
Seat 5: manon327 (10601 in chips) 
Seat 6: HighCardJasper (4382 in chips) 
dockstarr: posts small blind 50
PokerStarsMan12: posts big blind 100
*** HOLE CARDS ***
Dealt to PokerStarsMan12 [4h Qd]
manon327: calls 100
HighCardJasper: calls 100
color_singleton: folds 
dockstarr: calls 50
PokerStarsMan12: checks 
*** FLOP *** [6c Ad Th]
dockstarr: bets 100
PokerStarsMan12: folds 
manon327: raises 100 to 200
HighCardJasper: folds 
dockstarr: calls 100
*** TURN *** [6c Ad Th] [Kc]
dockstarr: bets 100
manon327: raises 100 to 200
dockstarr: calls 100
*** RIVER *** [6c Ad Th Kc] [Ts]
dockstarr: checks 
manon327: bets 1134
dockstarr: folds 
Uncalled bet (1134) returned to manon327
manon327 collected 1134 from pot
*** SUMMARY ***
Total pot 1200 | Rake 66 
Board [6c Ad Th Kc Ts]
Seat 1: color_singleton (button) folded before Flop (didn't bet)
Seat 2: dockstarr (small blind) folded on the River
Seat 3: PokerStarsMan12 (big blind) folded on the Flop
Seat 5: manon327 collected (1134)
Seat 6: HighCardJasper folded on the Flop



PokerStars Home Game Hand #229543641957: {DaPokaStars}  Hold'em No Limit (50/100) - 2021/09/02 17:58:47 ET
Table 'summer poker' 9-max (Play Money) Seat #2 is the button
Seat 1: color_singleton (20147 in chips) 
Seat 2: dockstarr (1953 in chips) 
Seat 3: PokerStarsMan12 (9537 in chips) 
Seat 5: manon327 (11235 in chips) 
Seat 6: HighCardJasper (4282 in chips) 
PokerStarsMan12: posts small blind 50
manon327: posts big blind 100
*** HOLE CARDS ***
Dealt to PokerStarsMan12 [Ah 2c]
HighCardJasper: calls 100
color_singleton: folds 
dockstarr: calls 100
PokerStarsMan12: calls 50
manon327: raises 100 to 200
HighCardJasper: calls 100
dockstarr: calls 100
PokerStarsMan12: calls 100
*** FLOP *** [Jd Kd 6c]
PokerStarsMan12: checks 
manon327: checks 
HighCardJasper: checks 
dockstarr: checks 
*** TURN *** [Jd Kd 6c] [4c]
PokerStarsMan12: checks 
manon327: bets 378
HighCardJasper: folds 
dockstarr: folds 
PokerStarsMan12: folds 
Uncalled bet (378) returned to manon327
manon327 collected 756 from pot
*** SUMMARY ***
Total pot 800 | Rake 44 
Board [Jd Kd 6c 4c]
Seat 1: color_singleton folded before Flop (didn't bet)
Seat 2: dockstarr (button) folded on the Turn
Seat 3: PokerStarsMan12 (small blind) folded on the Turn
Seat 5: manon327 (big blind) collected (756)
Seat 6: HighCardJasper folded on the Turn



PokerStars Home Game Hand #229543658934: {DaPokaStars}  Hold'em No Limit (50/100) - 2021/09/02 17:59:41 ET
Table 'summer poker' 9-max (Play Money) Seat #3 is the button
Seat 1: color_singleton (20147 in chips) 
Seat 2: dockstarr (1753 in chips) 
Seat 3: PokerStarsMan12 (9337 in chips) 
Seat 5: manon327 (11791 in chips) 
Seat 6: HighCardJasper (4082 in chips) 
manon327: posts small blind 50
HighCardJasper: posts big blind 100
*** HOLE CARDS ***
Dealt to PokerStarsMan12 [2c 9c]
color_singleton: folds 
dockstarr: folds 
PokerStarsMan12: folds 
manon327: calls 50
HighCardJasper: checks 
*** FLOP *** [4c 6c Kc]
manon327: bets 100
HighCardJasper: calls 100
*** TURN *** [4c 6c Kc] [6h]
manon327: bets 189
HighCardJasper: calls 189
*** RIVER *** [4c 6c Kc 6h] [Kh]
manon327: bets 735
HighCardJasper: folds 
Uncalled bet (735) returned to manon327
manon327 collected 735 from pot
*** SUMMARY ***
Total pot 778 | Rake 43 
Board [4c 6c Kc 6h Kh]
Seat 1: color_singleton folded before Flop (didn't bet)
Seat 2: dockstarr folded before Flop (didn't bet)
Seat 3: PokerStarsMan12 (button) folded before Flop (didn't bet)
Seat 5: manon327 (small blind) collected (735)
Seat 6: HighCardJasper (big blind) folded on the River



PokerStars Home Game Hand #229543670161: {DaPokaStars}  Hold'em No Limit (50/100) - 2021/09/02 18:00:16 ET
Table 'summer poker' 9-max (Play Money) Seat #5 is the button
Seat 1: color_singleton (20147 in chips) 
Seat 2: dockstarr (1753 in chips) 
Seat 3: PokerStarsMan12 (9337 in chips) 
Seat 5: manon327 (12137 in chips) 
Seat 6: HighCardJasper (3693 in chips) 
HighCardJasper: posts small blind 50
color_singleton: posts big blind 100
*** HOLE CARDS ***
Dealt to PokerStarsMan12 [Jc 7c]
dockstarr: folds 
PokerStarsMan12: calls 100
manon327: raises 100 to 200
HighCardJasper: calls 150
color_singleton: calls 100
PokerStarsMan12: calls 100
*** FLOP *** [4s 8s 7h]
HighCardJasper: checks 
color_singleton: bets 378
PokerStarsMan12: calls 378
manon327: calls 378
HighCardJasper: folds 
*** TURN *** [4s 8s 7h] [8d]
color_singleton: checks 
PokerStarsMan12: bets 1000
manon327: folds 
color_singleton: folds 
Uncalled bet (1000) returned to PokerStarsMan12
PokerStarsMan12 collected 1828 from pot
*** SUMMARY ***
Total pot 1934 | Rake 106 
Board [4s 8s 7h 8d]
Seat 1: color_singleton (big blind) folded on the Turn
Seat 2: dockstarr folded before Flop (didn't bet)
Seat 3: PokerStarsMan12 collected (1828)
Seat 5: manon327 (button) folded on the Turn
Seat 6: HighCardJasper (small blind) folded on the Flop



PokerStars Home Game Hand #229543687000: {DaPokaStars}  Hold'em No Limit (50/100) - 2021/09/02 18:01:05 ET
Table 'summer poker' 9-max (Play Money) Seat #6 is the button
Seat 1: color_singleton (19569 in chips) 
Seat 2: dockstarr (1753 in chips) 
Seat 3: PokerStarsMan12 (10587 in chips) 
Seat 5: manon327 (11559 in chips) 
Seat 6: HighCardJasper (3493 in chips) 
color_singleton: posts small blind 50
dockstarr: posts big blind 100
*** HOLE CARDS ***
Dealt to PokerStarsMan12 [7s As]
PokerStarsMan12: raises 200 to 300
manon327: calls 300
HighCardJasper: folds 
color_singleton: folds 
dockstarr: folds 
*** FLOP *** [6c 6h Th]
PokerStarsMan12: checks 
manon327: bets 100
PokerStarsMan12: calls 100
*** TURN *** [6c 6h Th] [4c]
PokerStarsMan12: checks 
manon327: checks 
*** RIVER *** [6c 6h Th 4c] [5s]
PokerStarsMan12: checks 
manon327: checks 
*** SHOW DOWN ***
PokerStarsMan12: shows [7s As] (a pair of Sixes)
manon327: mucks hand 
PokerStarsMan12 collected 898 from pot
*** SUMMARY ***
Total pot 950 | Rake 52 
Board [6c 6h Th 4c 5s]
Seat 1: color_singleton (small blind) folded before Flop
Seat 2: dockstarr (big blind) folded before Flop
Seat 3: PokerStarsMan12 showed [7s As] and won (898) with a pair of Sixes
Seat 5: manon327 mucked [Jh 9h]
Seat 6: HighCardJasper (button) folded before Flop (didn't bet)



PokerStars Home Game Hand #229543698472: {DaPokaStars}  Hold'em No Limit (50/100) - 2021/09/02 18:01:35 ET
Table 'summer poker' 9-max (Play Money) Seat #1 is the button
Seat 1: color_singleton (19519 in chips) 
Seat 2: dockstarr (1653 in chips) 
Seat 3: PokerStarsMan12 (11085 in chips) 
Seat 5: manon327 (11159 in chips) 
Seat 6: HighCardJasper (3493 in chips) 
dockstarr: posts small blind 50
PokerStarsMan12: posts big blind 100
*** HOLE CARDS ***
Dealt to PokerStarsMan12 [Jd 3c]
manon327: folds 
HighCardJasper: calls 100
color_singleton: folds 
dockstarr: calls 50
PokerStarsMan12: checks 
*** FLOP *** [6c Js 9c]
dockstarr: checks 
PokerStarsMan12: bets 200
HighCardJasper: calls 200
dockstarr: calls 200
*** TURN *** [6c Js 9c] [Qs]
dockstarr: checks 
PokerStarsMan12: checks 
HighCardJasper: checks 
*** RIVER *** [6c Js 9c Qs] [6s]
dockstarr: checks 
PokerStarsMan12: checks 
HighCardJasper: checks 
*** SHOW DOWN ***
dockstarr: shows [Ad Tc] (a pair of Sixes)
PokerStarsMan12: shows [Jd 3c] (two pair, Jacks and Sixes)
HighCardJasper: mucks hand 
PokerStarsMan12 collected 850 from pot
*** SUMMARY ***
Total pot 900 | Rake 50 
Board [6c Js 9c Qs 6s]
Seat 1: color_singleton (button) folded before Flop (didn't bet)
Seat 2: dockstarr (small blind) showed [Ad Tc] and lost with a pair of Sixes
Seat 3: PokerStarsMan12 (big blind) showed [Jd 3c] and won (850) with two pair, Jacks and Sixes
Seat 5: manon327 folded before Flop (didn't bet)
Seat 6: HighCardJasper mucked [9s 2c]



PokerStars Home Game Hand #229543716016: {DaPokaStars}  Hold'em No Limit (50/100) - 2021/09/02 18:02:20 ET
Table 'summer poker' 9-max (Play Money) Seat #2 is the button
Seat 1: color_singleton (19519 in chips) 
Seat 2: dockstarr (1353 in chips) 
Seat 3: PokerStarsMan12 (11635 in chips) 
Seat 5: manon327 (11159 in chips) 
Seat 6: HighCardJasper (3193 in chips) 
PokerStarsMan12: posts small blind 50
manon327: posts big blind 100
*** HOLE CARDS ***
Dealt to PokerStarsMan12 [5h 2d]
HighCardJasper: folds 
color_singleton: folds 
dockstarr: folds 
PokerStarsMan12: folds 
Uncalled bet (50) returned to manon327
manon327 collected 100 from pot
*** SUMMARY ***
Total pot 100 | Rake 0 
Seat 1: color_singleton folded before Flop (didn't bet)
Seat 2: dockstarr (button) folded before Flop (didn't bet)
Seat 3: PokerStarsMan12 (small blind) folded before Flop
Seat 5: manon327 (big blind) collected (100)
Seat 6: HighCardJasper folded before Flop (didn't bet)



PokerStars Home Game Hand #229543722501: {DaPokaStars}  Hold'em No Limit (50/100) - 2021/09/02 18:02:35 ET
Table 'summer poker' 9-max (Play Money) Seat #3 is the button
Seat 1: color_singleton (19519 in chips) 
Seat 2: dockstarr (1353 in chips) 
Seat 3: PokerStarsMan12 (11585 in chips) 
Seat 5: manon327 (11209 in chips) 
Seat 6: HighCardJasper (3193 in chips) 
manon327: posts small blind 50
HighCardJasper: posts big blind 100
*** HOLE CARDS ***
Dealt to PokerStarsMan12 [4c 2c]
color_singleton: raises 200 to 300
dockstarr: folds 
PokerStarsMan12: folds 
manon327: calls 250
HighCardJasper: calls 200
*** FLOP *** [2s 4h Qh]
manon327: checks 
HighCardJasper: checks 
color_singleton: bets 600
manon327: calls 600
HighCardJasper: folds 
*** TURN *** [2s 4h Qh] [4d]
manon327: checks 
color_singleton: bets 1000
manon327: folds 
Uncalled bet (1000) returned to color_singleton
color_singleton collected 1984 from pot
color_singleton: doesn't show hand 
*** SUMMARY ***
Total pot 2100 | Rake 116 
Board [2s 4h Qh 4d]
Seat 1: color_singleton collected (1984)
Seat 2: dockstarr folded before Flop (didn't bet)
Seat 3: PokerStarsMan12 (button) folded before Flop (didn't bet)
Seat 5: manon327 (small blind) folded on the Turn
Seat 6: HighCardJasper (big blind) folded on the Flop



PokerStars Home Game Hand #229543741782: {DaPokaStars}  Hold'em No Limit (50/100) - 2021/09/02 18:03:22 ET
Table 'summer poker' 9-max (Play Money) Seat #5 is the button
Seat 1: color_singleton (20603 in chips) 
Seat 2: dockstarr (1353 in chips) 
Seat 3: PokerStarsMan12 (11585 in chips) 
Seat 5: manon327 (10309 in chips) 
Seat 6: HighCardJasper (2893 in chips) 
HighCardJasper: posts small blind 50
color_singleton: posts big blind 100
*** HOLE CARDS ***
Dealt to PokerStarsMan12 [Td 6s]
dockstarr: folds 
PokerStarsMan12: folds 
manon327: folds 
HighCardJasper: calls 50
color_singleton: checks 
*** FLOP *** [2h 5s 7c]
HighCardJasper: checks 
color_singleton: bets 189
HighCardJasper: calls 189
*** TURN *** [2h 5s 7c] [5c]
HighCardJasper: checks 
color_singleton: bets 273
HighCardJasper: folds 
Uncalled bet (273) returned to color_singleton
color_singleton collected 546 from pot
color_singleton: doesn't show hand 
*** SUMMARY ***
Total pot 578 | Rake 32 
Board [2h 5s 7c 5c]
Seat 1: color_singleton (big blind) collected (546)
Seat 2: dockstarr folded before Flop (didn't bet)
Seat 3: PokerStarsMan12 folded before Flop (didn't bet)
Seat 5: manon327 (button) folded before Flop (didn't bet)
Seat 6: HighCardJasper (small blind) folded on the Turn



PokerStars Home Game Hand #229543757916: {DaPokaStars}  Hold'em No Limit (50/100) - 2021/09/02 18:04:01 ET
Table 'summer poker' 9-max (Play Money) Seat #6 is the button
Seat 1: color_singleton (20860 in chips) 
Seat 2: dockstarr (1353 in chips) 
Seat 3: PokerStarsMan12 (11585 in chips) 
Seat 5: manon327 (10309 in chips) 
Seat 6: HighCardJasper (2604 in chips) 
color_singleton: posts small blind 50
dockstarr: posts big blind 100
*** HOLE CARDS ***
Dealt to PokerStarsMan12 [Kh Jh]
PokerStarsMan12: raises 200 to 300
manon327: calls 300
HighCardJasper: folds 
color_singleton: folds 
dockstarr: folds 
*** FLOP *** [9s 7c Js]
PokerStarsMan12: bets 400
manon327: folds 
Uncalled bet (400) returned to PokerStarsMan12
PokerStarsMan12 collected 709 from pot
*** SUMMARY ***
Total pot 750 | Rake 41 
Board [9s 7c Js]
Seat 1: color_singleton (small blind) folded before Flop
Seat 2: dockstarr (big blind) folded before Flop
Seat 3: PokerStarsMan12 collected (709)
Seat 5: manon327 folded on the Flop
Seat 6: HighCardJasper (button) folded before Flop (didn't bet)



PokerStars Home Game Hand #229543767658: {DaPokaStars}  Hold'em No Limit (50/100) - 2021/09/02 18:04:25 ET
Table 'summer poker' 9-max (Play Money) Seat #1 is the button
Seat 1: color_singleton (20810 in chips) 
Seat 2: dockstarr (1253 in chips) 
Seat 3: PokerStarsMan12 (11994 in chips) 
Seat 5: manon327 (10009 in chips) 
Seat 6: HighCardJasper (2604 in chips) 
dockstarr: posts small blind 50
PokerStarsMan12: posts big blind 100
*** HOLE CARDS ***
Dealt to PokerStarsMan12 [3s 3c]
manon327: calls 100
HighCardJasper: calls 100
color_singleton: raises 200 to 300
dockstarr: calls 250
PokerStarsMan12: calls 200
manon327: calls 200
HighCardJasper: calls 200
*** FLOP *** [6c Qc Js]
dockstarr: bets 100
PokerStarsMan12: folds 
manon327: calls 100
HighCardJasper: calls 100
color_singleton: calls 100
*** TURN *** [6c Qc Js] [8h]
dockstarr has timed out
dockstarr: checks 
manon327: checks 
HighCardJasper: checks 
color_singleton: bets 897
dockstarr: calls 853 and is all-in
manon327: calls 897
HighCardJasper: folds 
*** RIVER *** [6c Qc Js 8h] [Td]
manon327: checks 
color_singleton: checks 
*** SHOW DOWN ***
manon327: shows [Ac 8c] (a pair of Eights)
color_singleton: shows [Jc Kd] (a pair of Jacks)
color_singleton collected 83 from side pot
dockstarr: shows [As Ah] (a pair of Aces)
dockstarr collected 4214 from main pot
*** SUMMARY ***
Total pot 4547 Main pot 4214. Side pot 83. | Rake 250 
Board [6c Qc Js 8h Td]
Seat 1: color_singleton (button) showed [Jc Kd] and won (83) with a pair of Jacks
Seat 2: dockstarr (small blind) showed [As Ah] and won (4214) with a pair of Aces
Seat 3: PokerStarsMan12 (big blind) folded on the Flop
Seat 5: manon327 showed [Ac 8c] and lost with a pair of Eights
Seat 6: HighCardJasper folded on the Turn



PokerStars Home Game Hand #229543801403: {DaPokaStars}  Hold'em No Limit (50/100) - 2021/09/02 18:05:47 ET
Table 'summer poker' 9-max (Play Money) Seat #2 is the button
Seat 1: color_singleton (19596 in chips) 
Seat 2: dockstarr (4214 in chips) 
Seat 3: PokerStarsMan12 (11694 in chips) 
Seat 5: manon327 (8712 in chips) 
Seat 6: HighCardJasper (2204 in chips) 
PokerStarsMan12: posts small blind 50
manon327: posts big blind 100
*** HOLE CARDS ***
Dealt to PokerStarsMan12 [Qc 2d]
HighCardJasper: calls 100
color_singleton: folds 
dockstarr: folds 
PokerStarsMan12: calls 50
manon327: checks 
*** FLOP *** [As 4d Jd]
PokerStarsMan12: checks 
manon327: checks 
HighCardJasper: checks 
*** TURN *** [As 4d Jd] [5s]
PokerStarsMan12: checks 
manon327: checks 
HighCardJasper: bets 100
PokerStarsMan12: folds 
manon327: folds 
Uncalled bet (100) returned to HighCardJasper
HighCardJasper collected 283 from pot
HighCardJasper: doesn't show hand 
*** SUMMARY ***
Total pot 300 | Rake 17 
Board [As 4d Jd 5s]
Seat 1: color_singleton folded before Flop (didn't bet)
Seat 2: dockstarr (button) folded before Flop (didn't bet)
Seat 3: PokerStarsMan12 (small blind) folded on the Turn
Seat 5: manon327 (big blind) folded on the Turn
Seat 6: HighCardJasper collected (283)



PokerStars Home Game Hand #229543823022: {DaPokaStars}  Hold'em No Limit (50/100) - 2021/09/02 18:06:40 ET
Table 'summer poker' 9-max (Play Money) Seat #3 is the button
Seat 1: color_singleton (19596 in chips) 
Seat 2: dockstarr (4214 in chips) 
Seat 3: PokerStarsMan12 (11594 in chips) 
Seat 5: manon327 (8612 in chips) 
Seat 6: HighCardJasper (2387 in chips) 
manon327: posts small blind 50
HighCardJasper: posts big blind 100
*** HOLE CARDS ***
Dealt to PokerStarsMan12 [Kh 6d]
color_singleton: raises 200 to 300
dockstarr: folds 
PokerStarsMan12: folds 
manon327: calls 250
HighCardJasper: calls 200
*** FLOP *** [3c 6s 4s]
manon327: checks 
HighCardJasper: checks 
color_singleton: checks 
*** TURN *** [3c 6s 4s] [5s]
manon327: checks 
HighCardJasper: checks 
color_singleton: bets 425
manon327: folds 
HighCardJasper: calls 425
*** RIVER *** [3c 6s 4s 5s] [8s]
HighCardJasper: checks 
color_singleton: bets 827
HighCardJasper: raises 835 to 1662 and is all-in
color_singleton: calls 835
*** SHOW DOWN ***
HighCardJasper: shows [8d Ks] (a flush, King high)
color_singleton: shows [7s Ad] (a straight flush, Four to Eight)
color_singleton collected 4795 from pot
*** SUMMARY ***
Total pot 5074 | Rake 279 
Board [3c 6s 4s 5s 8s]
Seat 1: color_singleton showed [7s Ad] and won (4795) with a straight flush, Four to Eight
Seat 2: dockstarr folded before Flop (didn't bet)
Seat 3: PokerStarsMan12 (button) folded before Flop (didn't bet)
Seat 5: manon327 (small blind) folded on the Turn
Seat 6: HighCardJasper (big blind) showed [8d Ks] and lost with a flush, King high



PokerStars Home Game Hand #229543852317: {DaPokaStars}  Hold'em No Limit (50/100) - 2021/09/02 18:07:52 ET
Table 'summer poker' 9-max (Play Money) Seat #5 is the button
Seat 1: color_singleton (22004 in chips) 
Seat 2: dockstarr (4214 in chips) 
Seat 3: PokerStarsMan12 (11594 in chips) 
Seat 5: manon327 (8312 in chips) 
color_singleton: posts small blind 50
dockstarr: posts big blind 100
*** HOLE CARDS ***
Dealt to PokerStarsMan12 [5c 5d]
PokerStarsMan12: raises 300 to 400
manon327: calls 400
color_singleton: folds 
dockstarr: folds 
*** FLOP *** [5s Qd Ks]
PokerStarsMan12: checks 
manon327: bets 100
PokerStarsMan12: raises 200 to 300
manon327: calls 200
*** TURN *** [5s Qd Ks] [9s]
PokerStarsMan12: checks 
manon327: checks 
*** RIVER *** [5s Qd Ks 9s] [Tc]
PokerStarsMan12: bets 800
manon327: folds 
Uncalled bet (800) returned to PokerStarsMan12
PokerStarsMan12 collected 1465 from pot
*** SUMMARY ***
Total pot 1550 | Rake 85 
Board [5s Qd Ks 9s Tc]
Seat 1: color_singleton (small blind) folded before Flop
Seat 2: dockstarr (big blind) folded before Flop
Seat 3: PokerStarsMan12 collected (1465)
Seat 5: manon327 (button) folded on the River



PokerStars Home Game Hand #229543878525: {DaPokaStars}  Hold'em No Limit (50/100) - 2021/09/02 18:08:44 ET
Table 'summer poker' 9-max (Play Money) Seat #1 is the button
Seat 1: color_singleton (21954 in chips) 
Seat 2: dockstarr (4114 in chips) 
Seat 3: PokerStarsMan12 (12359 in chips) 
Seat 5: manon327 (7612 in chips) 
Seat 6: HighCardJasper (10000 in chips) 
dockstarr: posts small blind 50
PokerStarsMan12: posts big blind 100
HighCardJasper: posts small blind 50
*** HOLE CARDS ***
Dealt to PokerStarsMan12 [Kh Ad]
manon327: folds 
HighCardJasper: calls 100
color_singleton: folds 
dockstarr: calls 50
PokerStarsMan12: raises 300 to 400
HighCardJasper: folds 
dockstarr: calls 300
*** FLOP *** [3c 9s 2c]
dockstarr: checks 
PokerStarsMan12: checks 
*** TURN *** [3c 9s 2c] [Ah]
dockstarr: checks 
PokerStarsMan12: bets 400
dockstarr: folds 
Uncalled bet (400) returned to PokerStarsMan12
PokerStarsMan12 collected 898 from pot
*** SUMMARY ***
Total pot 950 | Rake 52 
Board [3c 9s 2c Ah]
Seat 1: color_singleton (button) folded before Flop (didn't bet)
Seat 2: dockstarr (small blind) folded on the Turn
Seat 3: PokerStarsMan12 (big blind) collected (898)
Seat 5: manon327 folded before Flop (didn't bet)
Seat 6: HighCardJasper folded before Flop



PokerStars Home Game Hand #229543900777: {DaPokaStars}  Hold'em No Limit (50/100) - 2021/09/02 18:09:39 ET
Table 'summer poker' 9-max (Play Money) Seat #2 is the button
Seat 1: color_singleton (21954 in chips) 
Seat 2: dockstarr (3714 in chips) 
Seat 3: PokerStarsMan12 (12857 in chips) 
Seat 5: manon327 (7612 in chips) 
Seat 6: HighCardJasper (9850 in chips) 
PokerStarsMan12: posts small blind 50
manon327: posts big blind 100
*** HOLE CARDS ***
Dealt to PokerStarsMan12 [5d Jh]
HighCardJasper: calls 100
color_singleton: raises 300 to 400
dockstarr: folds 
PokerStarsMan12: folds 
manon327: folds 
HighCardJasper: folds 
Uncalled bet (300) returned to color_singleton
color_singleton collected 350 from pot
color_singleton: doesn't show hand 
*** SUMMARY ***
Total pot 350 | Rake 0 
Seat 1: color_singleton collected (350)
Seat 2: dockstarr (button) folded before Flop (didn't bet)
Seat 3: PokerStarsMan12 (small blind) folded before Flop
Seat 5: manon327 (big blind) folded before Flop
Seat 6: HighCardJasper folded before Flop



PokerStars Home Game Hand #229543911920: {DaPokaStars}  Hold'em No Limit (50/100) - 2021/09/02 18:10:06 ET
Table 'summer poker' 9-max (Play Money) Seat #3 is the button
Seat 1: color_singleton (22204 in chips) 
Seat 3: PokerStarsMan12 (12807 in chips) 
Seat 5: manon327 (7512 in chips) 
Seat 6: HighCardJasper (9750 in chips) 
manon327: posts small blind 50
HighCardJasper: posts big blind 100
*** HOLE CARDS ***
Dealt to PokerStarsMan12 [Ah Ts]
color_singleton: folds 
PokerStarsMan12: raises 200 to 300
manon327: folds 
HighCardJasper: calls 200
*** FLOP *** [7h Ac Td]
HighCardJasper: checks 
PokerStarsMan12: bets 400
HighCardJasper: folds 
Uncalled bet (400) returned to PokerStarsMan12
PokerStarsMan12 collected 614 from pot
*** SUMMARY ***
Total pot 650 | Rake 36 
Board [7h Ac Td]
Seat 1: color_singleton folded before Flop (didn't bet)
Seat 3: PokerStarsMan12 (button) collected (614)
Seat 5: manon327 (small blind) folded before Flop
Seat 6: HighCardJasper (big blind) folded on the Flop



PokerStars Home Game Hand #229543925983: {DaPokaStars}  Hold'em No Limit (50/100) - 2021/09/02 18:10:42 ET
Table 'summer poker' 9-max (Play Money) Seat #5 is the button
Seat 1: color_singleton (22204 in chips) 
Seat 3: PokerStarsMan12 (13121 in chips) 
Seat 5: manon327 (7462 in chips) 
Seat 6: HighCardJasper (9450 in chips) 
HighCardJasper: posts small blind 50
color_singleton: posts big blind 100
*** HOLE CARDS ***
Dealt to PokerStarsMan12 [9c Ac]
PokerStarsMan12: raises 200 to 300
manon327: folds 
HighCardJasper: folds 
color_singleton: calls 200
*** FLOP *** [3h 5s 9h]
color_singleton: bets 614
PokerStarsMan12: calls 614
*** TURN *** [3h 5s 9h] [Ks]
color_singleton: bets 887
PokerStarsMan12: calls 887
*** RIVER *** [3h 5s 9h Ks] [8h]
color_singleton: checks 
PokerStarsMan12: checks 
*** SHOW DOWN ***
color_singleton: shows [9d Tc] (a pair of Nines)
PokerStarsMan12: shows [9c Ac] (a pair of Nines - Ace kicker)
PokerStarsMan12 collected 3451 from pot
*** SUMMARY ***
Total pot 3652 | Rake 201 
Board [3h 5s 9h Ks 8h]
Seat 1: color_singleton (big blind) showed [9d Tc] and lost with a pair of Nines
Seat 3: PokerStarsMan12 showed [9c Ac] and won (3451) with a pair of Nines
Seat 5: manon327 (button) folded before Flop (didn't bet)
Seat 6: HighCardJasper (small blind) folded before Flop



PokerStars Home Game Hand #229543942477: {DaPokaStars}  Hold'em No Limit (50/100) - 2021/09/02 18:11:23 ET
Table 'summer poker' 9-max (Play Money) Seat #6 is the button
Seat 1: color_singleton (20403 in chips) 
Seat 2: dockstarr (3714 in chips) 
Seat 3: PokerStarsMan12 (14771 in chips) 
Seat 5: manon327 (7462 in chips) 
Seat 6: HighCardJasper (9400 in chips) 
color_singleton: posts small blind 50
dockstarr: posts big blind 100
*** HOLE CARDS ***
Dealt to PokerStarsMan12 [8d 2h]
PokerStarsMan12: folds 
manon327: calls 100
HighCardJasper: calls 100
color_singleton: calls 50
dockstarr: checks 
*** FLOP *** [7c Js Tc]
color_singleton: checks 
dockstarr: checks 
manon327: checks 
HighCardJasper: checks 
*** TURN *** [7c Js Tc] [9c]
color_singleton: bets 189
dockstarr: folds 
manon327: calls 189
HighCardJasper: calls 189
*** RIVER *** [7c Js Tc 9c] [Qh]
color_singleton: bets 600
manon327: raises 600 to 1200
HighCardJasper: calls 1200
color_singleton: calls 600
*** SHOW DOWN ***
manon327: shows [Kh 7h] (a straight, Nine to King)
HighCardJasper: shows [Ks 8h] (a straight, Nine to King)
color_singleton: shows [Kd 3c] (a straight, Nine to King)
color_singleton collected 1439 from pot
manon327 collected 1439 from pot
HighCardJasper collected 1438 from pot
*** SUMMARY ***
Total pot 4567 | Rake 251 
Board [7c Js Tc 9c Qh]
Seat 1: color_singleton (small blind) showed [Kd 3c] and won (1439) with a straight, Nine to King
Seat 2: dockstarr (big blind) folded on the Turn
Seat 3: PokerStarsMan12 folded before Flop (didn't bet)
Seat 5: manon327 showed [Kh 7h] and won (1439) with a straight, Nine to King
Seat 6: HighCardJasper (button) showed [Ks 8h] and won (1438) with a straight, Nine to King



PokerStars Home Game Hand #229543966558: {DaPokaStars}  Hold'em No Limit (50/100) - 2021/09/02 18:12:23 ET
Table 'summer poker' 9-max (Play Money) Seat #1 is the button
Seat 1: color_singleton (20353 in chips) 
Seat 2: dockstarr (3614 in chips) 
Seat 3: PokerStarsMan12 (14771 in chips) 
Seat 5: manon327 (7412 in chips) 
Seat 6: HighCardJasper (9349 in chips) 
dockstarr: posts small blind 50
PokerStarsMan12: posts big blind 100
*** HOLE CARDS ***
Dealt to PokerStarsMan12 [4s Kd]
manon327: calls 100
HighCardJasper: folds 
color_singleton: raises 200 to 300
dockstarr: folds 
PokerStarsMan12: calls 200
manon327: calls 200
*** FLOP *** [7c Ah 9s]
PokerStarsMan12: checks 
manon327: bets 449
color_singleton: calls 449
PokerStarsMan12: folds 
*** TURN *** [7c Ah 9s] [3c]
manon327: checks 
color_singleton: checks 
*** RIVER *** [7c Ah 9s 3c] [6h]
manon327: bets 873
color_singleton: raises 873 to 1746
manon327: folds 
Uncalled bet (873) returned to color_singleton
color_singleton collected 3396 from pot
color_singleton: doesn't show hand 
*** SUMMARY ***
Total pot 3594 | Rake 198 
Board [7c Ah 9s 3c 6h]
Seat 1: color_singleton (button) collected (3396)
Seat 2: dockstarr (small blind) folded before Flop
Seat 3: PokerStarsMan12 (big blind) folded on the Flop
Seat 5: manon327 folded on the River
Seat 6: HighCardJasper folded before Flop (didn't bet)



PokerStars Home Game Hand #229543993866: {DaPokaStars}  Hold'em No Limit (50/100) - 2021/09/02 18:13:31 ET
Table 'summer poker' 9-max (Play Money) Seat #2 is the button
Seat 1: color_singleton (22127 in chips) 
Seat 2: dockstarr (3564 in chips) 
Seat 3: PokerStarsMan12 (14471 in chips) 
Seat 5: manon327 (5790 in chips) 
Seat 6: HighCardJasper (9349 in chips) 
PokerStarsMan12: posts small blind 50
manon327: posts big blind 100
*** HOLE CARDS ***
Dealt to PokerStarsMan12 [Kd 4d]
HighCardJasper: calls 100
color_singleton: folds 
dockstarr: calls 100
PokerStarsMan12: calls 50
manon327: checks 
*** FLOP *** [2s Ks 3h]
PokerStarsMan12: bets 200
manon327: folds 
HighCardJasper: calls 200
dockstarr: folds 
*** TURN *** [2s Ks 3h] [7d]
PokerStarsMan12: bets 400
HighCardJasper: calls 400
*** RIVER *** [2s Ks 3h 7d] [Ah]
PokerStarsMan12: checks 
HighCardJasper: checks 
*** SHOW DOWN ***
PokerStarsMan12: shows [Kd 4d] (a pair of Kings)
HighCardJasper: shows [Kc Qh] (a pair of Kings - Ace+Queen kicker)
HighCardJasper collected 1512 from pot
*** SUMMARY ***
Total pot 1600 | Rake 88 
Board [2s Ks 3h 7d Ah]
Seat 1: color_singleton folded before Flop (didn't bet)
Seat 2: dockstarr (button) folded on the Flop
Seat 3: PokerStarsMan12 (small blind) showed [Kd 4d] and lost with a pair of Kings
Seat 5: manon327 (big blind) folded on the Flop
Seat 6: HighCardJasper showed [Kc Qh] and won (1512) with a pair of Kings



PokerStars Home Game Hand #229544012533: {DaPokaStars}  Hold'em No Limit (50/100) - 2021/09/02 18:14:18 ET
Table 'summer poker' 9-max (Play Money) Seat #3 is the button
Seat 1: color_singleton (22127 in chips) 
Seat 2: dockstarr (3464 in chips) 
Seat 3: PokerStarsMan12 (13771 in chips) 
Seat 5: manon327 (5690 in chips) 
Seat 6: HighCardJasper (10161 in chips) 
manon327: posts small blind 50
HighCardJasper: posts big blind 100
*** HOLE CARDS ***
Dealt to PokerStarsMan12 [8c As]
color_singleton: folds 
dockstarr: folds 
PokerStarsMan12: raises 200 to 300
manon327: folds 
HighCardJasper: folds 
Uncalled bet (200) returned to PokerStarsMan12
PokerStarsMan12 collected 250 from pot
*** SUMMARY ***
Total pot 250 | Rake 0 
Seat 1: color_singleton folded before Flop (didn't bet)
Seat 2: dockstarr folded before Flop (didn't bet)
Seat 3: PokerStarsMan12 (button) collected (250)
Seat 5: manon327 (small blind) folded before Flop
Seat 6: HighCardJasper (big blind) folded before Flop



PokerStars Home Game Hand #229544021266: {DaPokaStars}  Hold'em No Limit (50/100) - 2021/09/02 18:14:40 ET
Table 'summer poker' 9-max (Play Money) Seat #5 is the button
Seat 1: color_singleton (22127 in chips) 
Seat 2: dockstarr (3464 in chips) 
Seat 3: PokerStarsMan12 (13921 in chips) 
Seat 5: manon327 (5640 in chips) 
Seat 6: HighCardJasper (10061 in chips) 
HighCardJasper: posts small blind 50
color_singleton: posts big blind 100
*** HOLE CARDS ***
Dealt to PokerStarsMan12 [9c 5h]
dockstarr: calls 100
PokerStarsMan12: folds 
manon327: calls 100
HighCardJasper: calls 50
color_singleton: checks 
*** FLOP *** [7s Jh Kd]
HighCardJasper: checks 
color_singleton: bets 189
dockstarr: calls 189
manon327: folds 
HighCardJasper: calls 189
*** TURN *** [7s Jh Kd] [As]
HighCardJasper: checks 
color_singleton: bets 457
dockstarr: folds 
HighCardJasper: calls 457
*** RIVER *** [7s Jh Kd As] [7d]
HighCardJasper: checks 
color_singleton: checks 
*** SHOW DOWN ***
HighCardJasper: shows [Ts 6s] (a pair of Sevens)
color_singleton: shows [5s Js] (two pair, Jacks and Sevens)
color_singleton collected 1778 from pot
*** SUMMARY ***
Total pot 1881 | Rake 103 
Board [7s Jh Kd As 7d]
Seat 1: color_singleton (big blind) showed [5s Js] and won (1778) with two pair, Jacks and Sevens
Seat 2: dockstarr folded on the Turn
Seat 3: PokerStarsMan12 folded before Flop (didn't bet)
Seat 5: manon327 (button) folded on the Flop
Seat 6: HighCardJasper (small blind) showed [Ts 6s] and lost with a pair of Sevens



PokerStars Home Game Hand #229544064270: {DaPokaStars}  Hold'em No Limit (50/100) - 2021/09/02 18:16:08 ET
Table 'summer poker' 9-max (Play Money) Seat #6 is the button
Seat 1: color_singleton (23159 in chips) 
Seat 2: dockstarr (3175 in chips) 
Seat 3: PokerStarsMan12 (13921 in chips) 
Seat 5: manon327 (5540 in chips) 
Seat 6: HighCardJasper (9315 in chips) 
color_singleton: posts small blind 50
dockstarr: posts big blind 100
*** HOLE CARDS ***
Dealt to PokerStarsMan12 [6h Td]
PokerStarsMan12: folds 
manon327: calls 100
HighCardJasper: calls 100
color_singleton: calls 50
dockstarr: checks 
*** FLOP *** [7d 4d 8c]
color_singleton: checks 
dockstarr: checks 
manon327: checks 
HighCardJasper: checks 
*** TURN *** [7d 4d 8c] [As]
color_singleton: checks 
dockstarr: checks 
manon327: checks 
HighCardJasper: checks 
*** RIVER *** [7d 4d 8c As] [Ac]
color_singleton: checks 
dockstarr: checks 
manon327: checks 
HighCardJasper: checks 
*** SHOW DOWN ***
color_singleton: shows [Ks 5h] (a pair of Aces)
dockstarr: shows [Kh Qd] (a pair of Aces - King+Queen kicker)
manon327: mucks hand 
HighCardJasper: mucks hand 
dockstarr collected 378 from pot
*** SUMMARY ***
Total pot 400 | Rake 22 
Board [7d 4d 8c As Ac]
Seat 1: color_singleton (small blind) showed [Ks 5h] and lost with a pair of Aces
Seat 2: dockstarr (big blind) showed [Kh Qd] and won (378) with a pair of Aces
Seat 3: PokerStarsMan12 folded before Flop (didn't bet)
Seat 5: manon327 mucked [Jh 3s]
Seat 6: HighCardJasper (button) mucked [9c 2h]



PokerStars Home Game Hand #229544090334: {DaPokaStars}  Hold'em No Limit (50/100) - 2021/09/02 18:17:14 ET
Table 'summer poker' 9-max (Play Money) Seat #1 is the button
Seat 1: color_singleton (23059 in chips) 
Seat 2: dockstarr (3453 in chips) 
Seat 3: PokerStarsMan12 (13921 in chips) 
Seat 5: manon327 (5440 in chips) 
Seat 6: HighCardJasper (9215 in chips) 
dockstarr: posts small blind 50
PokerStarsMan12: posts big blind 100
*** HOLE CARDS ***
Dealt to PokerStarsMan12 [5d 8c]
manon327: calls 100
HighCardJasper: folds 
color_singleton: calls 100
dockstarr: calls 50
PokerStarsMan12: checks 
*** FLOP *** [Ad 8h Ks]
dockstarr: checks 
PokerStarsMan12: checks 
manon327: checks 
color_singleton: bets 189
dockstarr: folds 
PokerStarsMan12: folds 
manon327: folds 
Uncalled bet (189) returned to color_singleton
color_singleton collected 378 from pot
color_singleton: doesn't show hand 
*** SUMMARY ***
Total pot 400 | Rake 22 
Board [Ad 8h Ks]
Seat 1: color_singleton (button) collected (378)
Seat 2: dockstarr (small blind) folded on the Flop
Seat 3: PokerStarsMan12 (big blind) folded on the Flop
Seat 5: manon327 folded on the Flop
Seat 6: HighCardJasper folded before Flop (didn't bet)



PokerStars Home Game Hand #229544115491: {DaPokaStars}  Hold'em No Limit (50/100) - 2021/09/02 18:18:17 ET
Table 'summer poker' 9-max (Play Money) Seat #2 is the button
Seat 1: color_singleton (23337 in chips) 
Seat 2: dockstarr (3353 in chips) 
Seat 3: PokerStarsMan12 (13821 in chips) 
Seat 5: manon327 (5340 in chips) 
Seat 6: HighCardJasper (9215 in chips) 
PokerStarsMan12: posts small blind 50
manon327: posts big blind 100
*** HOLE CARDS ***
Dealt to PokerStarsMan12 [Kh Qs]
HighCardJasper: calls 100
color_singleton: raises 200 to 300
dockstarr: folds 
PokerStarsMan12: calls 250
manon327: folds 
HighCardJasper: folds 
*** FLOP *** [8c 9d 9s]
PokerStarsMan12: checks 
color_singleton: checks 
*** TURN *** [8c 9d 9s] [Jd]
PokerStarsMan12: checks 
color_singleton: checks 
*** RIVER *** [8c 9d 9s Jd] [8h]
PokerStarsMan12: checks 
color_singleton: checks 
*** SHOW DOWN ***
PokerStarsMan12: shows [Kh Qs] (two pair, Nines and Eights)
color_singleton: shows [Qh Ah] (two pair, Nines and Eights - Ace kicker)
color_singleton collected 756 from pot
*** SUMMARY ***
Total pot 800 | Rake 44 
Board [8c 9d 9s Jd 8h]
Seat 1: color_singleton showed [Qh Ah] and won (756) with two pair, Nines and Eights
Seat 2: dockstarr (button) folded before Flop (didn't bet)
Seat 3: PokerStarsMan12 (small blind) showed [Kh Qs] and lost with two pair, Nines and Eights
Seat 5: manon327 (big blind) folded before Flop
Seat 6: HighCardJasper folded before Flop



PokerStars Home Game Hand #229544132666: {DaPokaStars}  Hold'em No Limit (50/100) - 2021/09/02 18:19:01 ET
Table 'summer poker' 9-max (Play Money) Seat #3 is the button
Seat 1: color_singleton (23793 in chips) 
Seat 2: dockstarr (3353 in chips) 
Seat 3: PokerStarsMan12 (13521 in chips) 
Seat 5: manon327 (5240 in chips) 
Seat 6: HighCardJasper (9115 in chips) 
manon327: posts small blind 50
HighCardJasper: posts big blind 100
*** HOLE CARDS ***
Dealt to PokerStarsMan12 [Kh 8d]
color_singleton: folds 
dockstarr: folds 
PokerStarsMan12: calls 100
manon327: calls 50
HighCardJasper: checks 
*** FLOP *** [8s 6d Tc]
manon327: bets 141
HighCardJasper: calls 141
PokerStarsMan12: calls 141
*** TURN *** [8s 6d Tc] [3c]
manon327: bets 341
HighCardJasper: folds 
PokerStarsMan12: calls 341
*** RIVER *** [8s 6d Tc 3c] [8c]
manon327: bets 664
PokerStarsMan12: raises 664 to 1328
manon327: calls 664
*** SHOW DOWN ***
PokerStarsMan12: shows [Kh 8d] (three of a kind, Eights)
manon327: shows [7d 9h] (a straight, Six to Ten)
manon327 collected 3838 from pot
*** SUMMARY ***
Total pot 4061 | Rake 223 
Board [8s 6d Tc 3c 8c]
Seat 1: color_singleton folded before Flop (didn't bet)
Seat 2: dockstarr folded before Flop (didn't bet)
Seat 3: PokerStarsMan12 (button) showed [Kh 8d] and lost with three of a kind, Eights
Seat 5: manon327 (small blind) showed [7d 9h] and won (3838) with a straight, Six to Ten
Seat 6: HighCardJasper (big blind) folded on the Turn



PokerStars Home Game Hand #229544149242: {DaPokaStars}  Hold'em No Limit (50/100) - 2021/09/02 18:19:43 ET
Table 'summer poker' 9-max (Play Money) Seat #5 is the button
Seat 1: color_singleton (23793 in chips) 
Seat 2: dockstarr (3353 in chips) 
Seat 3: PokerStarsMan12 (11611 in chips) 
Seat 5: manon327 (7168 in chips) 
Seat 6: HighCardJasper (8874 in chips) 
HighCardJasper: posts small blind 50
color_singleton: posts big blind 100
*** HOLE CARDS ***
Dealt to PokerStarsMan12 [As 6c]
dockstarr: calls 100
PokerStarsMan12: calls 100
manon327: folds 
HighCardJasper: calls 50
color_singleton: raises 200 to 300
dockstarr: folds 
PokerStarsMan12: calls 200
HighCardJasper: calls 200
*** FLOP *** [Qh 5h 7d]
HighCardJasper: checks 
color_singleton: bets 472
PokerStarsMan12: folds 
HighCardJasper: folds 
Uncalled bet (472) returned to color_singleton
color_singleton collected 945 from pot
color_singleton: doesn't show hand 
*** SUMMARY ***
Total pot 1000 | Rake 55 
Board [Qh 5h 7d]
Seat 1: color_singleton (big blind) collected (945)
Seat 2: dockstarr folded before Flop
Seat 3: PokerStarsMan12 folded on the Flop
Seat 5: manon327 (button) folded before Flop (didn't bet)
Seat 6: HighCardJasper (small blind) folded on the Flop



PokerStars Home Game Hand #229544170470: {DaPokaStars}  Hold'em No Limit (50/100) - 2021/09/02 18:20:37 ET
Table 'summer poker' 9-max (Play Money) Seat #6 is the button
Seat 1: color_singleton (24438 in chips) 
Seat 2: dockstarr (3253 in chips) 
Seat 3: PokerStarsMan12 (11311 in chips) 
Seat 5: manon327 (7168 in chips) 
Seat 6: HighCardJasper (8574 in chips) 
color_singleton: posts small blind 50
dockstarr: posts big blind 100
*** HOLE CARDS ***
Dealt to PokerStarsMan12 [9d Ad]
PokerStarsMan12: raises 200 to 300
manon327: calls 300
HighCardJasper: folds 
color_singleton: folds 
dockstarr: folds 
*** FLOP *** [Ac 7d 7c]
PokerStarsMan12: bets 400
manon327: calls 400
*** TURN *** [Ac 7d 7c] [Jc]
PokerStarsMan12: checks 
manon327: bets 732
PokerStarsMan12: calls 732
*** RIVER *** [Ac 7d 7c Jc] [2h]
PokerStarsMan12: checks 
manon327: bets 1424
PokerStarsMan12: calls 1424
*** SHOW DOWN ***
manon327: shows [Kh 7h] (three of a kind, Sevens)
PokerStarsMan12: mucks hand 
manon327 collected 5540 from pot
*** SUMMARY ***
Total pot 5862 | Rake 322 
Board [Ac 7d 7c Jc 2h]
Seat 1: color_singleton (small blind) folded before Flop
Seat 2: dockstarr (big blind) folded before Flop
Seat 3: PokerStarsMan12 mucked [9d Ad]
Seat 5: manon327 showed [Kh 7h] and won (5540) with three of a kind, Sevens
Seat 6: HighCardJasper (button) folded before Flop (didn't bet)



PokerStars Home Game Hand #229544195304: {DaPokaStars}  Hold'em No Limit (50/100) - 2021/09/02 18:21:40 ET
Table 'summer poker' 9-max (Play Money) Seat #1 is the button
Seat 1: color_singleton (24388 in chips) 
Seat 2: dockstarr (3153 in chips) 
Seat 3: PokerStarsMan12 (8455 in chips) 
Seat 5: manon327 (9852 in chips) 
Seat 6: HighCardJasper (8574 in chips) 
dockstarr: posts small blind 50
PokerStarsMan12: posts big blind 100
*** HOLE CARDS ***
Dealt to PokerStarsMan12 [6d Ah]
manon327: calls 100
HighCardJasper: calls 100
color_singleton: calls 100
dockstarr: folds 
PokerStarsMan12: checks 
*** FLOP *** [Jd 3d 6h]
PokerStarsMan12: bets 200
manon327: calls 200
HighCardJasper: folds 
color_singleton: calls 200
*** TURN *** [Jd 3d 6h] [4c]
PokerStarsMan12: checks 
manon327: checks 
color_singleton: bets 992
PokerStarsMan12: folds 
manon327: folds 
Uncalled bet (992) returned to color_singleton
color_singleton collected 992 from pot
color_singleton: doesn't show hand 
*** SUMMARY ***
Total pot 1050 | Rake 58 
Board [Jd 3d 6h 4c]
Seat 1: color_singleton (button) collected (992)
Seat 2: dockstarr (small blind) folded before Flop
Seat 3: PokerStarsMan12 (big blind) folded on the Turn
Seat 5: manon327 folded on the Turn
Seat 6: HighCardJasper folded on the Flop



PokerStars Home Game Hand #229544211149: {DaPokaStars}  Hold'em No Limit (50/100) - 2021/09/02 18:22:21 ET
Table 'summer poker' 9-max (Play Money) Seat #2 is the button
Seat 1: color_singleton (25080 in chips) 
Seat 2: dockstarr (3103 in chips) 
Seat 3: PokerStarsMan12 (8155 in chips) 
Seat 5: manon327 (9552 in chips) 
Seat 6: HighCardJasper (8474 in chips) 
PokerStarsMan12: posts small blind 50
manon327: posts big blind 100
*** HOLE CARDS ***
Dealt to PokerStarsMan12 [Th 4c]
HighCardJasper: calls 100
color_singleton: raises 200 to 300
dockstarr: folds 
PokerStarsMan12: folds 
manon327: calls 200
HighCardJasper: calls 200
*** FLOP *** [2c 7d 6c]
manon327: checks 
HighCardJasper: checks 
color_singleton: bets 449
manon327: folds 
HighCardJasper: folds 
Uncalled bet (449) returned to color_singleton
color_singleton collected 898 from pot
color_singleton: doesn't show hand 
*** SUMMARY ***
Total pot 950 | Rake 52 
Board [2c 7d 6c]
Seat 1: color_singleton collected (898)
Seat 2: dockstarr (button) folded before Flop (didn't bet)
Seat 3: PokerStarsMan12 (small blind) folded before Flop
Seat 5: manon327 (big blind) folded on the Flop
Seat 6: HighCardJasper folded on the Flop



PokerStars Home Game Hand #229544223079: {DaPokaStars}  Hold'em No Limit (50/100) - 2021/09/02 18:22:52 ET
Table 'summer poker' 9-max (Play Money) Seat #3 is the button
Seat 1: color_singleton (25678 in chips) 
Seat 2: dockstarr (3103 in chips) 
Seat 3: PokerStarsMan12 (8105 in chips) 
Seat 5: manon327 (9252 in chips) 
Seat 6: HighCardJasper (8174 in chips) 
manon327: posts small blind 50
HighCardJasper: posts big blind 100
*** HOLE CARDS ***
Dealt to PokerStarsMan12 [2c Ah]
color_singleton: raises 200 to 300
dockstarr: folds 
PokerStarsMan12: calls 300
manon327: folds 
HighCardJasper: calls 200
*** FLOP *** [6s As Jd]
HighCardJasper: checks 
color_singleton: checks 
PokerStarsMan12: bets 500
HighCardJasper: folds 
color_singleton: folds 
Uncalled bet (500) returned to PokerStarsMan12
PokerStarsMan12 collected 898 from pot
*** SUMMARY ***
Total pot 950 | Rake 52 
Board [6s As Jd]
Seat 1: color_singleton folded on the Flop
Seat 2: dockstarr folded before Flop (didn't bet)
Seat 3: PokerStarsMan12 (button) collected (898)
Seat 5: manon327 (small blind) folded before Flop
Seat 6: HighCardJasper (big blind) folded on the Flop



PokerStars Home Game Hand #229544237890: {DaPokaStars}  Hold'em No Limit (50/100) - 2021/09/02 18:23:31 ET
Table 'summer poker' 9-max (Play Money) Seat #5 is the button
Seat 1: color_singleton (25378 in chips) 
Seat 2: dockstarr (3103 in chips) 
Seat 3: PokerStarsMan12 (8703 in chips) 
Seat 5: manon327 (9202 in chips) 
Seat 6: HighCardJasper (7874 in chips) 
HighCardJasper: posts small blind 50
color_singleton: posts big blind 100
*** HOLE CARDS ***
Dealt to PokerStarsMan12 [5c Qh]
dockstarr: calls 100
PokerStarsMan12: folds 
manon327: folds 
HighCardJasper: calls 50
color_singleton: checks 
*** FLOP *** [2s Jh 5d]
HighCardJasper: checks 
color_singleton: bets 141
dockstarr: folds 
HighCardJasper: folds 
Uncalled bet (141) returned to color_singleton
color_singleton collected 283 from pot
color_singleton: doesn't show hand 
*** SUMMARY ***
Total pot 300 | Rake 17 
Board [2s Jh 5d]
Seat 1: color_singleton (big blind) collected (283)
Seat 2: dockstarr folded on the Flop
Seat 3: PokerStarsMan12 folded before Flop (didn't bet)
Seat 5: manon327 (button) folded before Flop (didn't bet)
Seat 6: HighCardJasper (small blind) folded on the Flop



PokerStars Home Game Hand #229544247936: {DaPokaStars}  Hold'em No Limit (50/100) - 2021/09/02 18:23:57 ET
Table 'summer poker' 9-max (Play Money) Seat #6 is the button
Seat 1: color_singleton (25561 in chips) 
Seat 2: dockstarr (3003 in chips) 
Seat 3: PokerStarsMan12 (8703 in chips) 
Seat 5: manon327 (9202 in chips) 
Seat 6: HighCardJasper (7774 in chips) 
color_singleton: posts small blind 50
dockstarr: posts big blind 100
*** HOLE CARDS ***
Dealt to PokerStarsMan12 [Jh 6h]
PokerStarsMan12: folds 
manon327 has timed out
manon327: folds 
HighCardJasper: folds 
color_singleton: raises 200 to 300
dockstarr: folds 
Uncalled bet (200) returned to color_singleton
color_singleton collected 200 from pot
color_singleton: doesn't show hand 
*** SUMMARY ***
Total pot 200 | Rake 0 
Seat 1: color_singleton (small blind) collected (200)
Seat 2: dockstarr (big blind) folded before Flop
Seat 3: PokerStarsMan12 folded before Flop (didn't bet)
Seat 5: manon327 folded before Flop (didn't bet)
Seat 6: HighCardJasper (button) folded before Flop (didn't bet)



PokerStars Home Game Hand #229544259391: {DaPokaStars}  Hold'em No Limit (50/100) - 2021/09/02 18:24:27 ET
Table 'summer poker' 9-max (Play Money) Seat #1 is the button
Seat 1: color_singleton (25661 in chips) 
Seat 2: dockstarr (2903 in chips) 
Seat 3: PokerStarsMan12 (8703 in chips) 
Seat 6: HighCardJasper (7774 in chips) 
dockstarr: posts small blind 50
PokerStarsMan12: posts big blind 100
*** HOLE CARDS ***
Dealt to PokerStarsMan12 [2h Kd]
HighCardJasper: calls 100
color_singleton: folds 
dockstarr: folds 
PokerStarsMan12: checks 
*** FLOP *** [6h 7s 8d]
PokerStarsMan12: checks 
HighCardJasper: checks 
*** TURN *** [6h 7s 8d] [Qd]
PokerStarsMan12: checks 
HighCardJasper: checks 
*** RIVER *** [6h 7s 8d Qd] [3d]
PokerStarsMan12: checks 
HighCardJasper: checks 
*** SHOW DOWN ***
PokerStarsMan12: shows [2h Kd] (high card King)
HighCardJasper: shows [Ad 7c] (a pair of Sevens)
HighCardJasper collected 236 from pot
*** SUMMARY ***
Total pot 250 | Rake 14 
Board [6h 7s 8d Qd 3d]
Seat 1: color_singleton (button) folded before Flop (didn't bet)
Seat 2: dockstarr (small blind) folded before Flop
Seat 3: PokerStarsMan12 (big blind) showed [2h Kd] and lost with high card King
Seat 6: HighCardJasper showed [Ad 7c] and won (236) with a pair of Sevens



PokerStars Home Game Hand #229544270521: {DaPokaStars}  Hold'em No Limit (50/100) - 2021/09/02 18:24:56 ET
Table 'summer poker' 9-max (Play Money) Seat #2 is the button
Seat 1: color_singleton (25661 in chips) 
Seat 2: dockstarr (2853 in chips) 
Seat 3: PokerStarsMan12 (8603 in chips) 
Seat 6: HighCardJasper (7910 in chips) 
PokerStarsMan12: posts small blind 50
HighCardJasper: posts big blind 100
*** HOLE CARDS ***
Dealt to PokerStarsMan12 [Ad 8h]
color_singleton: raises 200 to 300
dockstarr: folds 
PokerStarsMan12: calls 250
HighCardJasper: calls 200
*** FLOP *** [Qs Ac 3d]
PokerStarsMan12: checks 
HighCardJasper: checks 
color_singleton: bets 425
PokerStarsMan12: calls 425
HighCardJasper: folds 
*** TURN *** [Qs Ac 3d] [9c]
PokerStarsMan12: checks 
color_singleton: bets 827
PokerStarsMan12: calls 827
*** RIVER *** [Qs Ac 3d 9c] [6h]
PokerStarsMan12: checks 
color_singleton: checks 
*** SHOW DOWN ***
PokerStarsMan12: shows [Ad 8h] (a pair of Aces)
color_singleton: shows [9s Qc] (two pair, Queens and Nines)
color_singleton collected 3217 from pot
*** SUMMARY ***
Total pot 3404 | Rake 187 
Board [Qs Ac 3d 9c 6h]
Seat 1: color_singleton showed [9s Qc] and won (3217) with two pair, Queens and Nines
Seat 2: dockstarr (button) folded before Flop (didn't bet)
Seat 3: PokerStarsMan12 (small blind) showed [Ad 8h] and lost with a pair of Aces
Seat 6: HighCardJasper (big blind) folded on the Flop



PokerStars Home Game Hand #229544286224: {DaPokaStars}  Hold'em No Limit (50/100) - 2021/09/02 18:25:36 ET
Table 'summer poker' 9-max (Play Money) Seat #3 is the button
Seat 1: color_singleton (27326 in chips) 
Seat 2: dockstarr (2853 in chips) 
Seat 3: PokerStarsMan12 (7051 in chips) 
Seat 6: HighCardJasper (7610 in chips) 
HighCardJasper: posts small blind 50
color_singleton: posts big blind 100
*** HOLE CARDS ***
Dealt to PokerStarsMan12 [Jd 2s]
dockstarr: calls 100
PokerStarsMan12: folds 
HighCardJasper: calls 50
color_singleton: raises 200 to 300
dockstarr: calls 200
HighCardJasper: folds 
*** FLOP *** [Kc 3c 3d]
color_singleton: checks 
dockstarr: checks 
*** TURN *** [Kc 3c 3d] [4d]
color_singleton: checks 
dockstarr: checks 
*** RIVER *** [Kc 3c 3d 4d] [6d]
color_singleton: checks 
dockstarr: checks 
*** SHOW DOWN ***
color_singleton: shows [Td 7h] (a pair of Threes)
dockstarr: shows [Qh Ah] (a pair of Threes - Ace kicker)
dockstarr collected 661 from pot
*** SUMMARY ***
Total pot 700 | Rake 39 
Board [Kc 3c 3d 4d 6d]
Seat 1: color_singleton (big blind) showed [Td 7h] and lost with a pair of Threes
Seat 2: dockstarr showed [Qh Ah] and won (661) with a pair of Threes
Seat 3: PokerStarsMan12 (button) folded before Flop (didn't bet)
Seat 6: HighCardJasper (small blind) folded before Flop



PokerStars Home Game Hand #229544301910: {DaPokaStars}  Hold'em No Limit (50/100) - 2021/09/02 18:26:17 ET
Table 'summer poker' 9-max (Play Money) Seat #6 is the button
Seat 1: color_singleton (27026 in chips) 
Seat 2: dockstarr (3214 in chips) 
Seat 3: PokerStarsMan12 (7051 in chips) 
Seat 6: HighCardJasper (7510 in chips) 
color_singleton: posts small blind 50
dockstarr: posts big blind 100
*** HOLE CARDS ***
Dealt to PokerStarsMan12 [3c Kc]
PokerStarsMan12: folds 
HighCardJasper: folds 
color_singleton: raises 200 to 300
dockstarr: calls 200
*** FLOP *** [6s 5h 6d]
color_singleton has timed out
color_singleton: checks 
dockstarr: checks 
*** TURN *** [6s 5h 6d] [5d]
color_singleton: bets 283
dockstarr: calls 283
*** RIVER *** [6s 5h 6d 5d] [7c]
color_singleton: bets 551
dockstarr has timed out
dockstarr: folds 
Uncalled bet (551) returned to color_singleton
color_singleton collected 1102 from pot
color_singleton: doesn't show hand 
*** SUMMARY ***
Total pot 1166 | Rake 64 
Board [6s 5h 6d 5d 7c]
Seat 1: color_singleton (small blind) collected (1102)
Seat 2: dockstarr (big blind) folded on the River
Seat 3: PokerStarsMan12 folded before Flop (didn't bet)
Seat 6: HighCardJasper (button) folded before Flop (didn't bet)



PokerStars Home Game Hand #229544328114: {DaPokaStars}  Hold'em No Limit (50/100) - 2021/09/02 18:27:26 ET
Table 'summer poker' 9-max (Play Money) Seat #1 is the button
Seat 1: color_singleton (27545 in chips) 
Seat 3: PokerStarsMan12 (7051 in chips) 
Seat 6: HighCardJasper (7510 in chips) 
PokerStarsMan12: posts small blind 50
HighCardJasper: posts big blind 100
*** HOLE CARDS ***
Dealt to PokerStarsMan12 [3h Ad]
color_singleton: folds 
PokerStarsMan12: calls 50
HighCardJasper: checks 
*** FLOP *** [5d 2s Js]
PokerStarsMan12: checks 
HighCardJasper: checks 
*** TURN *** [5d 2s Js] [5h]
PokerStarsMan12: bets 100
HighCardJasper: folds 
Uncalled bet (100) returned to PokerStarsMan12
PokerStarsMan12 collected 189 from pot
*** SUMMARY ***
Total pot 200 | Rake 11 
Board [5d 2s Js 5h]
Seat 1: color_singleton (button) folded before Flop (didn't bet)
Seat 3: PokerStarsMan12 (small blind) collected (189)
Seat 6: HighCardJasper (big blind) folded on the Turn



PokerStars Home Game Hand #229544337608: {DaPokaStars}  Hold'em No Limit (50/100) - 2021/09/02 18:27:51 ET
Table 'summer poker' 9-max (Play Money) Seat #3 is the button
Seat 1: color_singleton (27545 in chips) 
Seat 2: dockstarr (2631 in chips) 
Seat 3: PokerStarsMan12 (7140 in chips) 
Seat 6: HighCardJasper (7410 in chips) 
HighCardJasper: posts small blind 50
color_singleton: posts big blind 100
dockstarr: posts small blind 50
*** HOLE CARDS ***
Dealt to PokerStarsMan12 [2h 8s]
dockstarr: folds 
PokerStarsMan12: folds 
HighCardJasper: calls 50
manon327 leaves the table
color_singleton has timed out
color_singleton: checks 
*** FLOP *** [6c 4d Qc]
HighCardJasper: bets 118
color_singleton: calls 118
*** TURN *** [6c 4d Qc] [2s]
HighCardJasper: checks 
color_singleton: checks 
*** RIVER *** [6c 4d Qc 2s] [As]
HighCardJasper: checks 
color_singleton: bets 400
HighCardJasper: folds 
Uncalled bet (400) returned to color_singleton
color_singleton collected 459 from pot
color_singleton: doesn't show hand 
*** SUMMARY ***
Total pot 486 | Rake 27 
Board [6c 4d Qc 2s As]
Seat 1: color_singleton (big blind) collected (459)
Seat 2: dockstarr folded before Flop (didn't bet)
Seat 3: PokerStarsMan12 (button) folded before Flop (didn't bet)
Seat 6: HighCardJasper (small blind) folded on the River



PokerStars Home Game Hand #229544360578: {DaPokaStars}  Hold'em No Limit (50/100) - 2021/09/02 18:28:52 ET
Table 'summer poker' 9-max (Play Money) Seat #6 is the button
Seat 1: color_singleton (27786 in chips) 
Seat 2: dockstarr (2581 in chips) 
Seat 3: PokerStarsMan12 (7140 in chips) 
Seat 6: HighCardJasper (7192 in chips) 
color_singleton: posts small blind 50
dockstarr: posts big blind 100
*** HOLE CARDS ***
Dealt to PokerStarsMan12 [Ad 8c]
PokerStarsMan12: raises 200 to 300
HighCardJasper: calls 300
color_singleton: calls 250
dockstarr: folds 
*** FLOP *** [2h Qc Ts]
color_singleton: checks 
PokerStarsMan12: checks 
HighCardJasper: checks 
*** TURN *** [2h Qc Ts] [4d]
color_singleton: checks 
PokerStarsMan12: checks 
HighCardJasper: checks 
*** RIVER *** [2h Qc Ts 4d] [Ac]
color_singleton: checks 
PokerStarsMan12: bets 400
HighCardJasper: calls 400
color_singleton: folds 
*** SHOW DOWN ***
PokerStarsMan12: shows [Ad 8c] (a pair of Aces)
HighCardJasper: shows [Ah 8d] (a pair of Aces)
PokerStarsMan12 collected 851 from pot
HighCardJasper collected 850 from pot
*** SUMMARY ***
Total pot 1800 | Rake 99 
Board [2h Qc Ts 4d Ac]
Seat 1: color_singleton (small blind) folded on the River
Seat 2: dockstarr (big blind) folded before Flop
Seat 3: PokerStarsMan12 showed [Ad 8c] and won (851) with a pair of Aces
Seat 6: HighCardJasper (button) showed [Ah 8d] and won (850) with a pair of Aces



PokerStars Home Game Hand #229544375889: {DaPokaStars}  Hold'em No Limit (50/100) - 2021/09/02 18:29:33 ET
Table 'summer poker' 9-max (Play Money) Seat #1 is the button
Seat 1: color_singleton (27486 in chips) 
Seat 2: dockstarr (2481 in chips) 
Seat 3: PokerStarsMan12 (7291 in chips) 
Seat 6: HighCardJasper (7342 in chips) 
dockstarr: posts small blind 50
PokerStarsMan12: posts big blind 100
*** HOLE CARDS ***
Dealt to PokerStarsMan12 [Kd 7c]
HighCardJasper: calls 100
color_singleton: raises 200 to 300
dockstarr: calls 250
PokerStarsMan12: calls 200
HighCardJasper: calls 200
*** FLOP *** [Kc 2c 4c]
dockstarr: checks 
PokerStarsMan12: bets 600
HighCardJasper: folds 
color_singleton: folds 
dockstarr: folds 
Uncalled bet (600) returned to PokerStarsMan12
PokerStarsMan12 collected 1134 from pot
*** SUMMARY ***
Total pot 1200 | Rake 66 
Board [Kc 2c 4c]
Seat 1: color_singleton (button) folded on the Flop
Seat 2: dockstarr (small blind) folded on the Flop
Seat 3: PokerStarsMan12 (big blind) collected (1134)
Seat 6: HighCardJasper folded on the Flop



PokerStars Home Game Hand #229544392682: {DaPokaStars}  Hold'em No Limit (50/100) - 2021/09/02 18:30:16 ET
Table 'summer poker' 9-max (Play Money) Seat #2 is the button
Seat 1: color_singleton (27186 in chips) 
Seat 2: dockstarr (2181 in chips) 
Seat 3: PokerStarsMan12 (8125 in chips) 
Seat 6: HighCardJasper (7042 in chips) 
PokerStarsMan12: posts small blind 50
HighCardJasper: posts big blind 100
*** HOLE CARDS ***
Dealt to PokerStarsMan12 [As 9d]
color_singleton: raises 200 to 300
dockstarr: calls 300
PokerStarsMan12: calls 250
HighCardJasper: calls 200
*** FLOP *** [Td 7c Kd]
PokerStarsMan12: checks 
HighCardJasper: checks 
color_singleton: checks 
dockstarr: checks 
*** TURN *** [Td 7c Kd] [6h]
PokerStarsMan12: checks 
HighCardJasper: checks 
color_singleton: checks 
dockstarr: checks 
*** RIVER *** [Td 7c Kd 6h] [Jh]
PokerStarsMan12: checks 
HighCardJasper: checks 
color_singleton: checks 
dockstarr: checks 
*** SHOW DOWN ***
PokerStarsMan12: shows [As 9d] (high card Ace)
HighCardJasper: shows [Ah 9s] (high card Ace)
color_singleton: mucks hand 
dockstarr: shows [Kc 9h] (a pair of Kings)
dockstarr collected 1134 from pot
*** SUMMARY ***
Total pot 1200 | Rake 66 
Board [Td 7c Kd 6h Jh]
Seat 1: color_singleton mucked [Qh 2h]
Seat 2: dockstarr (button) showed [Kc 9h] and won (1134) with a pair of Kings
Seat 3: PokerStarsMan12 (small blind) showed [As 9d] and lost with high card Ace
Seat 6: HighCardJasper (big blind) showed [Ah 9s] and lost with high card Ace



PokerStars Home Game Hand #229544421091: {DaPokaStars}  Hold'em No Limit (50/100) - 2021/09/02 18:31:16 ET
Table 'summer poker' 9-max (Play Money) Seat #3 is the button
Seat 1: color_singleton (26886 in chips) 
Seat 2: dockstarr (3015 in chips) 
Seat 3: PokerStarsMan12 (7825 in chips) 
Seat 6: HighCardJasper (6742 in chips) 
HighCardJasper: posts small blind 50
color_singleton: posts big blind 100
*** HOLE CARDS ***
Dealt to PokerStarsMan12 [Kd 3c]
dockstarr: calls 100
PokerStarsMan12: folds 
HighCardJasper: folds 
color_singleton: raises 200 to 300
dockstarr: calls 200
*** FLOP *** [8h 6s 6d]
color_singleton: bets 307
dockstarr: calls 307
*** TURN *** [8h 6s 6d] [Qs]
color_singleton: checks 
dockstarr: checks 
*** RIVER *** [8h 6s 6d Qs] [5d]
color_singleton: checks 
dockstarr: checks 
*** SHOW DOWN ***
color_singleton: shows [Th 9c] (a pair of Sixes)
dockstarr: shows [Js As] (a pair of Sixes - Ace kicker)
dockstarr collected 1194 from pot
*** SUMMARY ***
Total pot 1264 | Rake 70 
Board [8h 6s 6d Qs 5d]
Seat 1: color_singleton (big blind) showed [Th 9c] and lost with a pair of Sixes
Seat 2: dockstarr showed [Js As] and won (1194) with a pair of Sixes
Seat 3: PokerStarsMan12 (button) folded before Flop (didn't bet)
Seat 6: HighCardJasper (small blind) folded before Flop



PokerStars Home Game Hand #229544435340: {DaPokaStars}  Hold'em No Limit (50/100) - 2021/09/02 18:31:53 ET
Table 'summer poker' 9-max (Play Money) Seat #6 is the button
Seat 1: color_singleton (26279 in chips) 
Seat 2: dockstarr (3602 in chips) 
Seat 3: PokerStarsMan12 (7825 in chips) 
Seat 6: HighCardJasper (6692 in chips) 
color_singleton: posts small blind 50
dockstarr: posts big blind 100
*** HOLE CARDS ***
Dealt to PokerStarsMan12 [Jh 5h]
PokerStarsMan12: calls 100
HighCardJasper: calls 100
color_singleton: calls 50
dockstarr: checks 
*** FLOP *** [9h Jd 4c]
color_singleton: checks 
dockstarr: checks 
PokerStarsMan12: bets 200
HighCardJasper: folds 
color_singleton: folds 
dockstarr: folds 
Uncalled bet (200) returned to PokerStarsMan12
PokerStarsMan12 collected 378 from pot
*** SUMMARY ***
Total pot 400 | Rake 22 
Board [9h Jd 4c]
Seat 1: color_singleton (small blind) folded on the Flop
Seat 2: dockstarr (big blind) folded on the Flop
Seat 3: PokerStarsMan12 collected (378)
Seat 6: HighCardJasper (button) folded on the Flop



PokerStars Home Game Hand #229544449962: {DaPokaStars}  Hold'em No Limit (50/100) - 2021/09/02 18:32:31 ET
Table 'summer poker' 9-max (Play Money) Seat #1 is the button
Seat 1: color_singleton (26179 in chips) 
Seat 2: dockstarr (3502 in chips) 
Seat 3: PokerStarsMan12 (8103 in chips) 
Seat 6: HighCardJasper (6592 in chips) 
dockstarr: posts small blind 50
PokerStarsMan12: posts big blind 100
*** HOLE CARDS ***
Dealt to PokerStarsMan12 [Ts 2s]
HighCardJasper: calls 100
color_singleton: raises 200 to 300
dockstarr: folds 
PokerStarsMan12: folds 
HighCardJasper: folds 
Uncalled bet (200) returned to color_singleton
color_singleton collected 350 from pot
color_singleton: doesn't show hand 
*** SUMMARY ***
Total pot 350 | Rake 0 
Seat 1: color_singleton (button) collected (350)
Seat 2: dockstarr (small blind) folded before Flop
Seat 3: PokerStarsMan12 (big blind) folded before Flop
Seat 6: HighCardJasper folded before Flop



PokerStars Home Game Hand #229544461893: {DaPokaStars}  Hold'em No Limit (50/100) - 2021/09/02 18:33:02 ET
Table 'summer poker' 9-max (Play Money) Seat #2 is the button
Seat 1: color_singleton (26429 in chips) 
Seat 2: dockstarr (3452 in chips) 
Seat 3: PokerStarsMan12 (8003 in chips) 
Seat 6: HighCardJasper (6492 in chips) 
PokerStarsMan12: posts small blind 50
HighCardJasper: posts big blind 100
*** HOLE CARDS ***
Dealt to PokerStarsMan12 [Td Js]
color_singleton: raises 200 to 300
dockstarr: folds 
PokerStarsMan12: calls 250
HighCardJasper: folds 
*** FLOP *** [3s 6s 7s]
PokerStarsMan12: bets 330
color_singleton: calls 330
*** TURN *** [3s 6s 7s] [6c]
PokerStarsMan12: checks 
color_singleton: bets 642
PokerStarsMan12: calls 642
*** RIVER *** [3s 6s 7s 6c] [8s]
PokerStarsMan12: bets 1100
color_singleton: folds 
Uncalled bet (1100) returned to PokerStarsMan12
PokerStarsMan12 collected 2499 from pot
*** SUMMARY ***
Total pot 2644 | Rake 145 
Board [3s 6s 7s 6c 8s]
Seat 1: color_singleton folded on the River
Seat 2: dockstarr (button) folded before Flop (didn't bet)
Seat 3: PokerStarsMan12 (small blind) collected (2499)
Seat 6: HighCardJasper (big blind) folded before Flop



PokerStars Home Game Hand #229544487425: {DaPokaStars}  Hold'em No Limit (50/100) - 2021/09/02 18:34:10 ET
Table 'summer poker' 9-max (Play Money) Seat #3 is the button
Seat 1: color_singleton (25157 in chips) 
Seat 2: dockstarr (3452 in chips) 
Seat 3: PokerStarsMan12 (9230 in chips) 
Seat 6: HighCardJasper (6392 in chips) 
HighCardJasper: posts small blind 50
color_singleton: posts big blind 100
*** HOLE CARDS ***
Dealt to PokerStarsMan12 [2s 6c]
dockstarr: calls 100
PokerStarsMan12: folds 
HighCardJasper: calls 50
color_singleton: checks 
*** FLOP *** [5h Kd 3h]
HighCardJasper: checks 
color_singleton: checks 
dockstarr: checks 
*** TURN *** [5h Kd 3h] [8h]
HighCardJasper: checks 
color_singleton: checks 
dockstarr: bets 100
HighCardJasper: calls 100
color_singleton: calls 100
*** RIVER *** [5h Kd 3h 8h] [3c]
HighCardJasper: checks 
color_singleton: checks 
dockstarr: bets 567
HighCardJasper: folds 
color_singleton: folds 
Uncalled bet (567) returned to dockstarr
dockstarr collected 567 from pot
dockstarr: doesn't show hand 
*** SUMMARY ***
Total pot 600 | Rake 33 
Board [5h Kd 3h 8h 3c]
Seat 1: color_singleton (big blind) folded on the River
Seat 2: dockstarr collected (567)
Seat 3: PokerStarsMan12 (button) folded before Flop (didn't bet)
Seat 6: HighCardJasper (small blind) folded on the River



PokerStars Home Game Hand #229544507401: {DaPokaStars}  Hold'em No Limit (50/100) - 2021/09/02 18:35:02 ET
Table 'summer poker' 9-max (Play Money) Seat #6 is the button
Seat 1: color_singleton (24957 in chips) 
Seat 2: dockstarr (3819 in chips) 
Seat 3: PokerStarsMan12 (9230 in chips) 
Seat 6: HighCardJasper (6192 in chips) 
color_singleton: posts small blind 50
dockstarr: posts big blind 100
*** HOLE CARDS ***
Dealt to PokerStarsMan12 [Ks Qc]
PokerStarsMan12: raises 200 to 300
HighCardJasper: folds 
color_singleton: calls 250
dockstarr: folds 
*** FLOP *** [9s Qd Qh]
color_singleton: bets 330
PokerStarsMan12: calls 330
*** TURN *** [9s Qd Qh] [7h]
color_singleton: checks 
PokerStarsMan12: bets 700
color_singleton: calls 700
*** RIVER *** [9s Qd Qh 7h] [9c]
color_singleton: checks 
PokerStarsMan12: bets 1500
color_singleton: folds 
Uncalled bet (1500) returned to PokerStarsMan12
PokerStarsMan12 collected 2608 from pot
*** SUMMARY ***
Total pot 2760 | Rake 152 
Board [9s Qd Qh 7h 9c]
Seat 1: color_singleton (small blind) folded on the River
Seat 2: dockstarr (big blind) folded before Flop
Seat 3: PokerStarsMan12 collected (2608)
Seat 6: HighCardJasper (button) folded before Flop (didn't bet)



PokerStars Home Game Hand #229544524429: {DaPokaStars}  Hold'em No Limit (50/100) - 2021/09/02 18:35:48 ET
Table 'summer poker' 9-max (Play Money) Seat #1 is the button
Seat 1: color_singleton (23627 in chips) 
Seat 2: dockstarr (3719 in chips) 
Seat 3: PokerStarsMan12 (10508 in chips) 
Seat 6: HighCardJasper (6192 in chips) 
dockstarr: posts small blind 50
PokerStarsMan12: posts big blind 100
*** HOLE CARDS ***
Dealt to PokerStarsMan12 [Kc Qd]
HighCardJasper: folds 
color_singleton: folds 
dockstarr: folds 
Uncalled bet (50) returned to PokerStarsMan12
PokerStarsMan12 collected 100 from pot
*** SUMMARY ***
Total pot 100 | Rake 0 
Seat 1: color_singleton (button) folded before Flop (didn't bet)
Seat 2: dockstarr (small blind) folded before Flop
Seat 3: PokerStarsMan12 (big blind) collected (100)
Seat 6: HighCardJasper folded before Flop (didn't bet)



PokerStars Home Game Hand #229544528515: {DaPokaStars}  Hold'em No Limit (50/100) - 2021/09/02 18:35:59 ET
Table 'summer poker' 9-max (Play Money) Seat #2 is the button
Seat 1: color_singleton (23627 in chips) 
Seat 2: dockstarr (3669 in chips) 
Seat 3: PokerStarsMan12 (10558 in chips) 
Seat 6: HighCardJasper (6192 in chips) 
PokerStarsMan12: posts small blind 50
HighCardJasper: posts big blind 100
*** HOLE CARDS ***
Dealt to PokerStarsMan12 [4c 4d]
color_singleton: folds 
dockstarr: calls 100
PokerStarsMan12: raises 200 to 300
HighCardJasper: folds 
dockstarr: calls 200
*** FLOP *** [9c 2d 3s]
PokerStarsMan12: bets 300
dockstarr: calls 300
*** TURN *** [9c 2d 3s] [7s]
PokerStarsMan12: bets 600
dockstarr: folds 
Uncalled bet (600) returned to PokerStarsMan12
PokerStarsMan12 collected 1228 from pot
*** SUMMARY ***
Total pot 1300 | Rake 72 
Board [9c 2d 3s 7s]
Seat 1: color_singleton folded before Flop (didn't bet)
Seat 2: dockstarr (button) folded on the Turn
Seat 3: PokerStarsMan12 (small blind) collected (1228)
Seat 6: HighCardJasper (big blind) folded before Flop



PokerStars Home Game Hand #229544541757: {DaPokaStars}  Hold'em No Limit (50/100) - 2021/09/02 18:36:34 ET
Table 'summer poker' 9-max (Play Money) Seat #3 is the button
Seat 1: color_singleton (23627 in chips) 
Seat 2: dockstarr (3069 in chips) 
Seat 3: PokerStarsMan12 (11186 in chips) 
Seat 6: HighCardJasper (6092 in chips) 
HighCardJasper: posts small blind 50
color_singleton: posts big blind 100
*** HOLE CARDS ***
Dealt to PokerStarsMan12 [Td Ac]
dockstarr: folds 
PokerStarsMan12: raises 200 to 300
HighCardJasper: calls 250
color_singleton: calls 200
*** FLOP *** [Qh 2c 2d]
HighCardJasper: checks 
color_singleton: bets 425
PokerStarsMan12: folds 
HighCardJasper: folds 
Uncalled bet (425) returned to color_singleton
color_singleton collected 850 from pot
color_singleton: doesn't show hand 
*** SUMMARY ***
Total pot 900 | Rake 50 
Board [Qh 2c 2d]
Seat 1: color_singleton (big blind) collected (850)
Seat 2: dockstarr folded before Flop (didn't bet)
Seat 3: PokerStarsMan12 (button) folded on the Flop
Seat 6: HighCardJasper (small blind) folded on the Flop



PokerStars Home Game Hand #229544554298: {DaPokaStars}  Hold'em No Limit (50/100) - 2021/09/02 18:37:08 ET
Table 'summer poker' 9-max (Play Money) Seat #6 is the button
Seat 1: color_singleton (24177 in chips) 
Seat 2: dockstarr (3069 in chips) 
Seat 3: PokerStarsMan12 (10886 in chips) 
Seat 6: HighCardJasper (5792 in chips) 
color_singleton: posts small blind 50
dockstarr: posts big blind 100
*** HOLE CARDS ***
Dealt to PokerStarsMan12 [6s 4s]
PokerStarsMan12: calls 100
HighCardJasper: calls 100
color_singleton: raises 200 to 300
dockstarr: calls 200
PokerStarsMan12: calls 200
HighCardJasper: calls 200
*** FLOP *** [8d 3c As]
color_singleton: bets 567
dockstarr: folds 
PokerStarsMan12: folds 
HighCardJasper: folds 
Uncalled bet (567) returned to color_singleton
color_singleton collected 1134 from pot
color_singleton: doesn't show hand 
*** SUMMARY ***
Total pot 1200 | Rake 66 
Board [8d 3c As]
Seat 1: color_singleton (small blind) collected (1134)
Seat 2: dockstarr (big blind) folded on the Flop
Seat 3: PokerStarsMan12 folded on the Flop
Seat 6: HighCardJasper (button) folded on the Flop



PokerStars Home Game Hand #229544569822: {DaPokaStars}  Hold'em No Limit (50/100) - 2021/09/02 18:37:49 ET
Table 'summer poker' 9-max (Play Money) Seat #1 is the button
Seat 1: color_singleton (25011 in chips) 
Seat 2: dockstarr (2769 in chips) 
Seat 3: PokerStarsMan12 (10586 in chips) 
Seat 6: HighCardJasper (5492 in chips) 
dockstarr: posts small blind 50
PokerStarsMan12: posts big blind 100
*** HOLE CARDS ***
Dealt to PokerStarsMan12 [Jc 8s]
HighCardJasper: calls 100
color_singleton: raises 200 to 300
dockstarr: calls 250
PokerStarsMan12: folds 
HighCardJasper: calls 200
*** FLOP *** [9h 6h 8d]
dockstarr: checks 
HighCardJasper: checks 
color_singleton: bets 472
dockstarr has timed out
dockstarr: folds 
HighCardJasper: folds 
Uncalled bet (472) returned to color_singleton
color_singleton collected 945 from pot
color_singleton: doesn't show hand 
*** SUMMARY ***
Total pot 1000 | Rake 55 
Board [9h 6h 8d]
Seat 1: color_singleton (button) collected (945)
Seat 2: dockstarr (small blind) folded on the Flop
Seat 3: PokerStarsMan12 (big blind) folded before Flop
Seat 6: HighCardJasper folded on the Flop



PokerStars Home Game Hand #229544588055: {DaPokaStars}  Hold'em No Limit (50/100) - 2021/09/02 18:38:38 ET
Table 'summer poker' 9-max (Play Money) Seat #2 is the button
Seat 1: color_singleton (25656 in chips) 
Seat 2: dockstarr (2469 in chips) 
Seat 3: PokerStarsMan12 (10486 in chips) 
Seat 6: HighCardJasper (5192 in chips) 
PokerStarsMan12: posts small blind 50
HighCardJasper: posts big blind 100
*** HOLE CARDS ***
Dealt to PokerStarsMan12 [Kd Kc]
color_singleton: raises 200 to 300
dockstarr: folds 
PokerStarsMan12: raises 300 to 600
HighCardJasper: folds 
color_singleton: calls 300
*** FLOP *** [Th 6h Ah]
PokerStarsMan12: bets 600
color_singleton: folds 
Uncalled bet (600) returned to PokerStarsMan12
PokerStarsMan12 collected 1228 from pot
*** SUMMARY ***
Total pot 1300 | Rake 72 
Board [Th 6h Ah]
Seat 1: color_singleton folded on the Flop
Seat 2: dockstarr (button) folded before Flop (didn't bet)
Seat 3: PokerStarsMan12 (small blind) collected (1228)
Seat 6: HighCardJasper (big blind) folded before Flop



PokerStars Home Game Hand #229544602144: {DaPokaStars}  Hold'em No Limit (50/100) - 2021/09/02 18:39:16 ET
Table 'summer poker' 9-max (Play Money) Seat #3 is the button
Seat 1: color_singleton (25056 in chips) 
Seat 2: dockstarr (2469 in chips) 
Seat 3: PokerStarsMan12 (11114 in chips) 
Seat 6: HighCardJasper (5092 in chips) 
HighCardJasper: posts small blind 50
color_singleton: posts big blind 100
*** HOLE CARDS ***
Dealt to PokerStarsMan12 [5s 9d]
dockstarr: folds 
PokerStarsMan12: folds 
HighCardJasper: folds 
Uncalled bet (50) returned to color_singleton
color_singleton collected 100 from pot
color_singleton: doesn't show hand 
*** SUMMARY ***
Total pot 100 | Rake 0 
Seat 1: color_singleton (big blind) collected (100)
Seat 2: dockstarr folded before Flop (didn't bet)
Seat 3: PokerStarsMan12 (button) folded before Flop (didn't bet)
Seat 6: HighCardJasper (small blind) folded before Flop



PokerStars Home Game Hand #229544604358: {DaPokaStars}  Hold'em No Limit (50/100) - 2021/09/02 18:39:22 ET
Table 'summer poker' 9-max (Play Money) Seat #6 is the button
Seat 1: color_singleton (25106 in chips) 
Seat 2: dockstarr (2469 in chips) 
Seat 3: PokerStarsMan12 (11114 in chips) 
Seat 6: HighCardJasper (5042 in chips) 
color_singleton: posts small blind 50
dockstarr: posts big blind 100
*** HOLE CARDS ***
Dealt to PokerStarsMan12 [5h 8s]
PokerStarsMan12: folds 
HighCardJasper: folds 
color_singleton: raises 300 to 400
dockstarr: calls 300
*** FLOP *** [9s Qc 6h]
color_singleton: checks 
dockstarr: bets 756
color_singleton: calls 756
*** TURN *** [9s Qc 6h] [2s]
color_singleton: checks 
dockstarr: checks 
*** RIVER *** [9s Qc 6h 2s] [5s]
color_singleton: bets 1300
dockstarr: calls 1300
*** SHOW DOWN ***
color_singleton: shows [Qd Qs] (three of a kind, Queens)
dockstarr: mucks hand 
color_singleton collected 4642 from pot
*** SUMMARY ***
Total pot 4912 | Rake 270 
Board [9s Qc 6h 2s 5s]
Seat 1: color_singleton (small blind) showed [Qd Qs] and won (4642) with three of a kind, Queens
Seat 2: dockstarr (big blind) mucked [Ad Ah]
Seat 3: PokerStarsMan12 folded before Flop (didn't bet)
Seat 6: HighCardJasper (button) folded before Flop (didn't bet)



PokerStars Home Game Hand #229544618576: {DaPokaStars}  Hold'em No Limit (50/100) - 2021/09/02 18:40:01 ET
Table 'summer poker' 9-max (Play Money) Seat #1 is the button
Seat 1: color_singleton (27292 in chips) 
Seat 3: PokerStarsMan12 (11114 in chips) 
Seat 6: HighCardJasper (5042 in chips) 
PokerStarsMan12: posts small blind 50
HighCardJasper: posts big blind 100
*** HOLE CARDS ***
Dealt to PokerStarsMan12 [9c As]
color_singleton: folds 
PokerStarsMan12: raises 200 to 300
HighCardJasper: calls 200
*** FLOP *** [9d Jc Ks]
PokerStarsMan12: checks 
HighCardJasper: checks 
*** TURN *** [9d Jc Ks] [Qs]
PokerStarsMan12: checks 
HighCardJasper: bets 283
PokerStarsMan12: folds 
Uncalled bet (283) returned to HighCardJasper
HighCardJasper collected 567 from pot
HighCardJasper: doesn't show hand 
*** SUMMARY ***
Total pot 600 | Rake 33 
Board [9d Jc Ks Qs]
Seat 1: color_singleton (button) folded before Flop (didn't bet)
Seat 3: PokerStarsMan12 (small blind) folded on the Turn
Seat 6: HighCardJasper (big blind) collected (567)



PokerStars Home Game Hand #229544627784: {DaPokaStars}  Hold'em No Limit (50/100) - 2021/09/02 18:40:26 ET
Table 'summer poker' 9-max (Play Money) Seat #3 is the button
Seat 1: color_singleton (27292 in chips) 
Seat 3: PokerStarsMan12 (10814 in chips) 
Seat 6: HighCardJasper (5309 in chips) 
HighCardJasper: posts small blind 50
color_singleton: posts big blind 100
*** HOLE CARDS ***
Dealt to PokerStarsMan12 [2s Qh]
PokerStarsMan12: folds 
HighCardJasper: folds 
Uncalled bet (50) returned to color_singleton
color_singleton collected 100 from pot
color_singleton: doesn't show hand 
*** SUMMARY ***
Total pot 100 | Rake 0 
Seat 1: color_singleton (big blind) collected (100)
Seat 3: PokerStarsMan12 (button) folded before Flop (didn't bet)
Seat 6: HighCardJasper (small blind) folded before Flop



PokerStars Home Game Hand #229544630721: {DaPokaStars}  Hold'em No Limit (50/100) - 2021/09/02 18:40:34 ET
Table 'summer poker' 9-max (Play Money) Seat #6 is the button
Seat 1: color_singleton (27342 in chips) 
Seat 3: PokerStarsMan12 (10814 in chips) 
Seat 6: HighCardJasper (5259 in chips) 
color_singleton: posts small blind 50
PokerStarsMan12: posts big blind 100
*** HOLE CARDS ***
Dealt to PokerStarsMan12 [Jd Kd]
HighCardJasper: raises 100 to 200
color_singleton: folds 
PokerStarsMan12: calls 100
*** FLOP *** [Qc 5d 4d]
PokerStarsMan12: bets 300
HighCardJasper: calls 300
*** TURN *** [Qc 5d 4d] [7d]
PokerStarsMan12: bets 700
HighCardJasper: calls 700
*** RIVER *** [Qc 5d 4d 7d] [Td]
PokerStarsMan12: checks 
HighCardJasper: bets 600
PokerStarsMan12: calls 600
*** SHOW DOWN ***
HighCardJasper: shows [3d Ad] (a flush, Ace high)
PokerStarsMan12: mucks hand 
HighCardJasper collected 3449 from pot
*** SUMMARY ***
Total pot 3650 | Rake 201 
Board [Qc 5d 4d 7d Td]
Seat 1: color_singleton (small blind) folded before Flop
Seat 3: PokerStarsMan12 (big blind) mucked [Jd Kd]
Seat 6: HighCardJasper (button) showed [3d Ad] and won (3449) with a flush, Ace high



PokerStars Home Game Hand #229544657738: {DaPokaStars}  Hold'em No Limit (50/100) - 2021/09/02 18:41:25 ET
Table 'summer poker' 9-max (Play Money) Seat #1 is the button
Seat 1: color_singleton (27292 in chips) 
Seat 3: PokerStarsMan12 (9014 in chips) 
Seat 6: HighCardJasper (6908 in chips) 
PokerStarsMan12: posts small blind 50
HighCardJasper: posts big blind 100
*** HOLE CARDS ***
Dealt to PokerStarsMan12 [9s Jd]
color_singleton: raises 200 to 300
PokerStarsMan12: calls 250
HighCardJasper: folds 
*** FLOP *** [Th Td 6c]
PokerStarsMan12: checks 
color_singleton: bets 661
PokerStarsMan12: folds 
Uncalled bet (661) returned to color_singleton
color_singleton collected 661 from pot
color_singleton: doesn't show hand 
*** SUMMARY ***
Total pot 700 | Rake 39 
Board [Th Td 6c]
Seat 1: color_singleton (button) collected (661)
Seat 3: PokerStarsMan12 (small blind) folded on the Flop
Seat 6: HighCardJasper (big blind) folded before Flop



PokerStars Home Game Hand #229544669010: {DaPokaStars}  Hold'em No Limit (50/100) - 2021/09/02 18:41:56 ET
Table 'summer poker' 9-max (Play Money) Seat #3 is the button
Seat 1: color_singleton (27653 in chips) 
Seat 3: PokerStarsMan12 (8714 in chips) 
Seat 6: HighCardJasper (6808 in chips) 
HighCardJasper: posts small blind 50
color_singleton: posts big blind 100
*** HOLE CARDS ***
Dealt to PokerStarsMan12 [9h Qh]
PokerStarsMan12: raises 200 to 300
HighCardJasper: calls 250
color_singleton: folds 
*** FLOP *** [6s Td 7c]
HighCardJasper: checks 
PokerStarsMan12: checks 
*** TURN *** [6s Td 7c] [2s]
HighCardJasper: bets 330
PokerStarsMan12: folds 
Uncalled bet (330) returned to HighCardJasper
HighCardJasper collected 661 from pot
HighCardJasper: doesn't show hand 
*** SUMMARY ***
Total pot 700 | Rake 39 
Board [6s Td 7c 2s]
Seat 1: color_singleton (big blind) folded before Flop
Seat 3: PokerStarsMan12 (button) folded on the Turn
Seat 6: HighCardJasper (small blind) collected (661)



PokerStars Home Game Hand #229544677003: {DaPokaStars}  Hold'em No Limit (50/100) - 2021/09/02 18:42:17 ET
Table 'summer poker' 9-max (Play Money) Seat #6 is the button
Seat 1: color_singleton (27553 in chips) 
Seat 3: PokerStarsMan12 (8414 in chips) 
Seat 6: HighCardJasper (7169 in chips) 
color_singleton: posts small blind 50
PokerStarsMan12: posts big blind 100
*** HOLE CARDS ***
Dealt to PokerStarsMan12 [2d Ac]
HighCardJasper: calls 100
color_singleton: calls 50
PokerStarsMan12: checks 
*** FLOP *** [Qs 3s 3d]
color_singleton: checks 
PokerStarsMan12: checks 
HighCardJasper: checks 
*** TURN *** [Qs 3s 3d] [7h]
color_singleton: checks 
PokerStarsMan12: checks 
HighCardJasper: checks 
*** RIVER *** [Qs 3s 3d 7h] [6s]
color_singleton: checks 
PokerStarsMan12: bets 200
HighCardJasper: calls 200
color_singleton: folds 
*** SHOW DOWN ***
PokerStarsMan12: shows [2d Ac] (a pair of Threes)
HighCardJasper: shows [Jh 6c] (two pair, Sixes and Threes)
HighCardJasper collected 661 from pot
*** SUMMARY ***
Total pot 700 | Rake 39 
Board [Qs 3s 3d 7h 6s]
Seat 1: color_singleton (small blind) folded on the River
Seat 3: PokerStarsMan12 (big blind) showed [2d Ac] and lost with a pair of Threes
Seat 6: HighCardJasper (button) showed [Jh 6c] and won (661) with two pair, Sixes and Threes



PokerStars Home Game Hand #229544689454: {DaPokaStars}  Hold'em No Limit (50/100) - 2021/09/02 18:42:51 ET
Table 'summer poker' 9-max (Play Money) Seat #1 is the button
Seat 1: color_singleton (27453 in chips) 
Seat 3: PokerStarsMan12 (8114 in chips) 
Seat 6: HighCardJasper (7530 in chips) 
PokerStarsMan12: posts small blind 50
HighCardJasper: posts big blind 100
*** HOLE CARDS ***
Dealt to PokerStarsMan12 [4h 4c]
color_singleton: raises 200 to 300
PokerStarsMan12: calls 250
HighCardJasper: calls 200
*** FLOP *** [2s 5c 8s]
PokerStarsMan12: bets 500
HighCardJasper: calls 500
color_singleton: calls 500
*** TURN *** [2s 5c 8s] [6s]
PokerStarsMan12: checks 
HighCardJasper: bets 2268
color_singleton: folds 
PokerStarsMan12: folds 
Uncalled bet (2268) returned to HighCardJasper
HighCardJasper collected 2268 from pot
HighCardJasper: doesn't show hand 
*** SUMMARY ***
Total pot 2400 | Rake 132 
Board [2s 5c 8s 6s]
Seat 1: color_singleton (button) folded on the Turn
Seat 3: PokerStarsMan12 (small blind) folded on the Turn
Seat 6: HighCardJasper (big blind) collected (2268)



PokerStars Home Game Hand #229544702570: {DaPokaStars}  Hold'em No Limit (50/100) - 2021/09/02 18:43:26 ET
Table 'summer poker' 9-max (Play Money) Seat #3 is the button
Seat 1: color_singleton (26653 in chips) 
Seat 3: PokerStarsMan12 (7314 in chips) 
Seat 6: HighCardJasper (8998 in chips) 
HighCardJasper: posts small blind 50
color_singleton: posts big blind 100
*** HOLE CARDS ***
Dealt to PokerStarsMan12 [6s 5c]
PokerStarsMan12: calls 100
HighCardJasper: folds 
color_singleton: raises 200 to 300
PokerStarsMan12: calls 200
*** FLOP *** [5s Jc Qs]
color_singleton: bets 614
PokerStarsMan12: folds 
Uncalled bet (614) returned to color_singleton
color_singleton collected 614 from pot
color_singleton: doesn't show hand 
*** SUMMARY ***
Total pot 650 | Rake 36 
Board [5s Jc Qs]
Seat 1: color_singleton (big blind) collected (614)
Seat 3: PokerStarsMan12 (button) folded on the Flop
Seat 6: HighCardJasper (small blind) folded before Flop



PokerStars Home Game Hand #229544710386: {DaPokaStars}  Hold'em No Limit (50/100) - 2021/09/02 18:43:48 ET
Table 'summer poker' 9-max (Play Money) Seat #6 is the button
Seat 1: color_singleton (26967 in chips) 
Seat 3: PokerStarsMan12 (7014 in chips) 
Seat 6: HighCardJasper (8948 in chips) 
color_singleton: posts small blind 50
PokerStarsMan12: posts big blind 100
*** HOLE CARDS ***
Dealt to PokerStarsMan12 [Ts As]
HighCardJasper: calls 100
color_singleton: folds 
PokerStarsMan12: raises 200 to 300
HighCardJasper: calls 200
*** FLOP *** [3h 2c 7h]
PokerStarsMan12: checks 
HighCardJasper: bets 307
PokerStarsMan12: calls 307
*** TURN *** [3h 2c 7h] [8s]
PokerStarsMan12: checks 
HighCardJasper: checks 
*** RIVER *** [3h 2c 7h 8s] [5c]
PokerStarsMan12: bets 700
HighCardJasper: raises 2594 to 3294
PokerStarsMan12: folds 
Uncalled bet (2594) returned to HighCardJasper
HighCardJasper collected 2517 from pot
HighCardJasper: doesn't show hand 
*** SUMMARY ***
Total pot 2664 | Rake 147 
Board [3h 2c 7h 8s 5c]
Seat 1: color_singleton (small blind) folded before Flop
Seat 3: PokerStarsMan12 (big blind) folded on the River
Seat 6: HighCardJasper (button) collected (2517)



PokerStars Home Game Hand #229544727951: {DaPokaStars}  Hold'em No Limit (50/100) - 2021/09/02 18:44:35 ET
Table 'summer poker' 9-max (Play Money) Seat #1 is the button
Seat 1: color_singleton (26917 in chips) 
Seat 3: PokerStarsMan12 (5707 in chips) 
Seat 6: HighCardJasper (10158 in chips) 
PokerStarsMan12: posts small blind 50
HighCardJasper: posts big blind 100
*** HOLE CARDS ***
Dealt to PokerStarsMan12 [4d Ad]
color_singleton: folds 
PokerStarsMan12: raises 100 to 200
HighCardJasper: calls 100
*** FLOP *** [4h 9c 7s]
PokerStarsMan12: bets 200
dockstarr leaves the table
HighCardJasper: folds 
Uncalled bet (200) returned to PokerStarsMan12
PokerStarsMan12 collected 378 from pot
*** SUMMARY ***
Total pot 400 | Rake 22 
Board [4h 9c 7s]
Seat 1: color_singleton (button) folded before Flop (didn't bet)
Seat 3: PokerStarsMan12 (small blind) collected (378)
Seat 6: HighCardJasper (big blind) folded on the Flop



PokerStars Home Game Hand #229544738387: {DaPokaStars}  Hold'em No Limit (50/100) - 2021/09/02 18:45:04 ET
Table 'summer poker' 9-max (Play Money) Seat #3 is the button
Seat 1: color_singleton (26917 in chips) 
Seat 3: PokerStarsMan12 (5885 in chips) 
Seat 6: HighCardJasper (9958 in chips) 
HighCardJasper: posts small blind 50
color_singleton: posts big blind 100
*** HOLE CARDS ***
Dealt to PokerStarsMan12 [5h 8h]
PokerStarsMan12: calls 100
HighCardJasper: calls 50
color_singleton: checks 
*** FLOP *** [Jh 5d As]
HighCardJasper: checks 
color_singleton: checks 
PokerStarsMan12: checks 
*** TURN *** [Jh 5d As] [Th]
HighCardJasper: bets 141
color_singleton: calls 141
PokerStarsMan12: calls 141
*** RIVER *** [Jh 5d As Th] [9d]
HighCardJasper: checks 
color_singleton: checks 
PokerStarsMan12: checks 
*** SHOW DOWN ***
HighCardJasper: shows [Tc Qc] (a pair of Tens)
color_singleton: mucks hand 
PokerStarsMan12: mucks hand 
HighCardJasper collected 683 from pot
*** SUMMARY ***
Total pot 723 | Rake 40 
Board [Jh 5d As Th 9d]
Seat 1: color_singleton (big blind) mucked [8s Kd]
Seat 3: PokerStarsMan12 (button) mucked [5h 8h]
Seat 6: HighCardJasper (small blind) showed [Tc Qc] and won (683) with a pair of Tens



PokerStars Home Game Hand #229544749676: {DaPokaStars}  Hold'em No Limit (50/100) - 2021/09/02 18:45:34 ET
Table 'summer poker' 9-max (Play Money) Seat #6 is the button
Seat 1: color_singleton (26676 in chips) 
Seat 3: PokerStarsMan12 (5644 in chips) 
Seat 6: HighCardJasper (10400 in chips) 
color_singleton: posts small blind 50
PokerStarsMan12: posts big blind 100
*** HOLE CARDS ***
Dealt to PokerStarsMan12 [7d 5s]
HighCardJasper: calls 100
color_singleton: calls 50
PokerStarsMan12: checks 
*** FLOP *** [7c 2s Kd]
color_singleton: checks 
PokerStarsMan12: bets 200
HighCardJasper: folds 
color_singleton: calls 200
*** TURN *** [7c 2s Kd] [4s]
color_singleton: checks 
PokerStarsMan12: bets 400
color_singleton: folds 
Uncalled bet (400) returned to PokerStarsMan12
PokerStarsMan12 collected 661 from pot
*** SUMMARY ***
Total pot 700 | Rake 39 
Board [7c 2s Kd 4s]
Seat 1: color_singleton (small blind) folded on the Turn
Seat 3: PokerStarsMan12 (big blind) collected (661)
Seat 6: HighCardJasper (button) folded on the Flop



PokerStars Home Game Hand #229544760400: {DaPokaStars}  Hold'em No Limit (50/100) - 2021/09/02 18:46:04 ET
Table 'summer poker' 9-max (Play Money) Seat #1 is the button
Seat 1: color_singleton (26376 in chips) 
Seat 3: PokerStarsMan12 (6005 in chips) 
Seat 6: HighCardJasper (10300 in chips) 
PokerStarsMan12: posts small blind 50
HighCardJasper: posts big blind 100
*** HOLE CARDS ***
Dealt to PokerStarsMan12 [Jc 3c]
color_singleton: raises 200 to 300
PokerStarsMan12: folds 
HighCardJasper: folds 
Uncalled bet (200) returned to color_singleton
color_singleton collected 250 from pot
color_singleton: doesn't show hand 
*** SUMMARY ***
Total pot 250 | Rake 0 
Seat 1: color_singleton (button) collected (250)
Seat 3: PokerStarsMan12 (small blind) folded before Flop
Seat 6: HighCardJasper (big blind) folded before Flop



PokerStars Home Game Hand #229544766460: {DaPokaStars}  Hold'em No Limit (50/100) - 2021/09/02 18:46:21 ET
Table 'summer poker' 9-max (Play Money) Seat #3 is the button
Seat 1: color_singleton (26526 in chips) 
Seat 3: PokerStarsMan12 (5955 in chips) 
Seat 6: HighCardJasper (10200 in chips) 
HighCardJasper: posts small blind 50
color_singleton: posts big blind 100
*** HOLE CARDS ***
Dealt to PokerStarsMan12 [2c 3s]
PokerStarsMan12: raises 300 to 400
HighCardJasper: calls 350
color_singleton: calls 300
*** FLOP *** [5h Td 5c]
HighCardJasper: checks 
color_singleton: bets 567
PokerStarsMan12: folds 
HighCardJasper: folds 
Uncalled bet (567) returned to color_singleton
color_singleton collected 1134 from pot
color_singleton: doesn't show hand 
*** SUMMARY ***
Total pot 1200 | Rake 66 
Board [5h Td 5c]
Seat 1: color_singleton (big blind) collected (1134)
Seat 3: PokerStarsMan12 (button) folded on the Flop
Seat 6: HighCardJasper (small blind) folded on the Flop



PokerStars Home Game Hand #229544773909: {DaPokaStars}  Hold'em No Limit (50/100) - 2021/09/02 18:46:41 ET
Table 'summer poker' 9-max (Play Money) Seat #6 is the button
Seat 1: color_singleton (27260 in chips) 
Seat 3: PokerStarsMan12 (5555 in chips) 
Seat 6: HighCardJasper (9800 in chips) 
color_singleton: posts small blind 50
PokerStarsMan12: posts big blind 100
*** HOLE CARDS ***
Dealt to PokerStarsMan12 [Th 4h]
HighCardJasper: calls 100
color_singleton: calls 50
PokerStarsMan12: checks 
*** FLOP *** [Qs Jh 2h]
color_singleton: checks 
PokerStarsMan12: bets 200
HighCardJasper: calls 200
color_singleton: calls 200
*** TURN *** [Qs Jh 2h] [9h]
color_singleton: checks 
PokerStarsMan12: bets 500
HighCardJasper: calls 500
color_singleton: calls 500
*** RIVER *** [Qs Jh 2h 9h] [8d]
color_singleton: checks 
PokerStarsMan12: bets 2000
HighCardJasper: folds 
color_singleton: calls 2000
*** SHOW DOWN ***
PokerStarsMan12: shows [Th 4h] (a flush, Jack high)
color_singleton: mucks hand 
PokerStarsMan12 collected 6048 from pot
*** SUMMARY ***
Total pot 6400 | Rake 352 
Board [Qs Jh 2h 9h 8d]
Seat 1: color_singleton (small blind) mucked [2s Jd]
Seat 3: PokerStarsMan12 (big blind) showed [Th 4h] and won (6048) with a flush, Jack high
Seat 6: HighCardJasper (button) folded on the River



