PokerStars Home Game Hand #222892140721: {DaPokaStars}  Hold'em No Limit (50/100) - 2021/01/21 15:37:27 ET
Table 'testnsdfgh' 9-max (Play Money) Seat #6 is the button
Seat 1: manon327 (10394 in chips) 
Seat 2: HighCardJasper (6601 in chips) 
Seat 3: FantasticDouble (10000 in chips) 
Seat 6: color_singleton (10283 in chips) 
Seat 8: poorrick1338 (9437 in chips) 
Seat 9: dhduncan (948 in chips) 
poorrick1338: posts small blind 50
dhduncan: posts big blind 100
FantasticDouble: posts big blind 100
*** HOLE CARDS ***
Dealt to FantasticDouble [3h As]
manon327: calls 100
HighCardJasper: calls 100
FantasticDouble: checks 
color_singleton: folds 
poorrick1338: calls 50
dhduncan: checks 
*** FLOP *** [5h 3s 8s]
poorrick1338: checks 
dhduncan: checks 
manon327: checks 
HighCardJasper: checks 
FantasticDouble: bets 200
poorrick1338: calls 200
dhduncan: folds 
manon327: calls 200
HighCardJasper: calls 200
*** TURN *** [5h 3s 8s] [Jh]
poorrick1338: bets 300
manon327: folds 
HighCardJasper: calls 300
FantasticDouble has timed out
FantasticDouble: folds 
*** RIVER *** [5h 3s 8s Jh] [Qh]
poorrick1338: checks 
HighCardJasper: bets 700
poorrick1338: calls 700
*** SHOW DOWN ***
HighCardJasper: shows [6h 2h] (a flush, Queen high)
poorrick1338: mucks hand 
HighCardJasper collected 3118 from pot
*** SUMMARY ***
Total pot 3300 | Rake 182 
Board [5h 3s 8s Jh Qh]
Seat 1: manon327 folded on the Turn
Seat 2: HighCardJasper showed [6h 2h] and won (3118) with a flush, Queen high
Seat 3: FantasticDouble folded on the Turn
Seat 6: color_singleton (button) folded before Flop (didn't bet)
Seat 8: poorrick1338 (small blind) mucked [7s 7d]
Seat 9: dhduncan (big blind) folded on the Flop



PokerStars Home Game Hand #222892277740: {DaPokaStars}  Hold'em No Limit (50/100) - 2021/01/21 15:40:35 ET
Table 'testnsdfgh' 9-max (Play Money) Seat #1 is the button
Seat 1: manon327 (10411 in chips) 
Seat 2: HighCardJasper (8219 in chips) 
Seat 3: FantasticDouble (9700 in chips) 
Seat 6: color_singleton (10283 in chips) 
Seat 8: poorrick1338 (7937 in chips) 
Seat 9: dhduncan (873 in chips) 
HighCardJasper: posts small blind 50
FantasticDouble: posts big blind 100
*** HOLE CARDS ***
Dealt to FantasticDouble [3s Jd]
color_singleton: raises 200 to 300
poorrick1338: folds 
dhduncan: folds 
manon327: calls 300
HighCardJasper: calls 250
FantasticDouble: folds 
*** FLOP *** [2s Js Qs]
HighCardJasper: checks 
color_singleton: bets 472
manon327: folds 
HighCardJasper: folds 
Uncalled bet (472) returned to color_singleton
color_singleton collected 945 from pot
color_singleton: doesn't show hand 
*** SUMMARY ***
Total pot 1000 | Rake 55 
Board [2s Js Qs]
Seat 1: manon327 (button) folded on the Flop
Seat 2: HighCardJasper (small blind) folded on the Flop
Seat 3: FantasticDouble (big blind) folded before Flop
Seat 6: color_singleton collected (945)
Seat 8: poorrick1338 folded before Flop (didn't bet)
Seat 9: dhduncan folded before Flop (didn't bet)



PokerStars Home Game Hand #222892315575: {DaPokaStars}  Hold'em No Limit (50/100) - 2021/01/21 15:41:26 ET
Table 'testnsdfgh' 9-max (Play Money) Seat #2 is the button
Seat 1: manon327 (10111 in chips) 
Seat 2: HighCardJasper (7919 in chips) 
Seat 3: FantasticDouble (9600 in chips) 
Seat 6: color_singleton (10928 in chips) 
Seat 8: poorrick1338 (7937 in chips) 
Seat 9: dhduncan (873 in chips) 
FantasticDouble: posts small blind 50
color_singleton: posts big blind 100
*** HOLE CARDS ***
Dealt to FantasticDouble [6d 4s]
poorrick1338: calls 100
dhduncan: calls 100
manon327: folds 
HighCardJasper: raises 100 to 200
FantasticDouble: calls 150
color_singleton: calls 100
poorrick1338: raises 100 to 300
dhduncan: folds 
HighCardJasper: calls 100
FantasticDouble: calls 100
color_singleton: calls 100
*** FLOP *** [5c 4c Tc]
FantasticDouble: checks 
color_singleton: bets 800
poorrick1338: folds 
HighCardJasper: folds 
FantasticDouble: folds 
Uncalled bet (800) returned to color_singleton
color_singleton collected 1228 from pot
color_singleton: doesn't show hand 
*** SUMMARY ***
Total pot 1300 | Rake 72 
Board [5c 4c Tc]
Seat 1: manon327 folded before Flop (didn't bet)
Seat 2: HighCardJasper (button) folded on the Flop
Seat 3: FantasticDouble (small blind) folded on the Flop
Seat 6: color_singleton (big blind) collected (1228)
Seat 8: poorrick1338 folded on the Flop
Seat 9: dhduncan folded before Flop



PokerStars Home Game Hand #222892357371: {DaPokaStars}  Hold'em No Limit (50/100) - 2021/01/21 15:42:24 ET
Table 'testnsdfgh' 9-max (Play Money) Seat #3 is the button
Seat 1: manon327 (10111 in chips) 
Seat 2: HighCardJasper (7619 in chips) 
Seat 3: FantasticDouble (9300 in chips) 
Seat 6: color_singleton (11856 in chips) 
Seat 8: poorrick1338 (7637 in chips) 
Seat 9: dhduncan (773 in chips) 
color_singleton: posts small blind 50
poorrick1338: posts big blind 100
*** HOLE CARDS ***
Dealt to FantasticDouble [Kc 4d]
dhduncan: calls 100
manon327: folds 
HighCardJasper: calls 100
FantasticDouble: folds 
color_singleton: calls 50
poorrick1338: checks 
*** FLOP *** [9d 2d Qd]
color_singleton: checks 
poorrick1338: checks 
dhduncan: bets 673 and is all-in
HighCardJasper: folds 
color_singleton: folds 
poorrick1338: folds 
Uncalled bet (673) returned to dhduncan
dhduncan collected 378 from pot
dhduncan: doesn't show hand 
*** SUMMARY ***
Total pot 400 | Rake 22 
Board [9d 2d Qd]
Seat 1: manon327 folded before Flop (didn't bet)
Seat 2: HighCardJasper folded on the Flop
Seat 3: FantasticDouble (button) folded before Flop (didn't bet)
Seat 6: color_singleton (small blind) folded on the Flop
Seat 8: poorrick1338 (big blind) folded on the Flop
Seat 9: dhduncan collected (378)



PokerStars Home Game Hand #222892386763: {DaPokaStars}  Hold'em No Limit (50/100) - 2021/01/21 15:43:04 ET
Table 'testnsdfgh' 9-max (Play Money) Seat #6 is the button
Seat 1: manon327 (10111 in chips) 
Seat 2: HighCardJasper (7519 in chips) 
Seat 3: FantasticDouble (9300 in chips) 
Seat 6: color_singleton (11756 in chips) 
Seat 8: poorrick1338 (7537 in chips) 
Seat 9: dhduncan (1051 in chips) 
poorrick1338: posts small blind 50
dhduncan: posts big blind 100
*** HOLE CARDS ***
Dealt to FantasticDouble [Tc 8s]
manon327: raises 100 to 200
HighCardJasper: folds 
FantasticDouble: calls 200
color_singleton: folds 
poorrick1338: folds 
dhduncan: calls 100
*** FLOP *** [2h Td Kh]
dhduncan: bets 307
manon327: raises 307 to 614
FantasticDouble: folds 
dhduncan: raises 237 to 851 and is all-in
manon327: calls 237
*** TURN *** [2h Td Kh] [6h]
*** RIVER *** [2h Td Kh 6h] [Jd]
*** SHOW DOWN ***
dhduncan: shows [Ts Kc] (two pair, Kings and Tens)
manon327: shows [Ac Ad] (a pair of Aces)
dhduncan collected 2223 from pot
*** SUMMARY ***
Total pot 2352 | Rake 129 
Board [2h Td Kh 6h Jd]
Seat 1: manon327 showed [Ac Ad] and lost with a pair of Aces
Seat 2: HighCardJasper folded before Flop (didn't bet)
Seat 3: FantasticDouble folded on the Flop
Seat 6: color_singleton (button) folded before Flop (didn't bet)
Seat 8: poorrick1338 (small blind) folded before Flop
Seat 9: dhduncan (big blind) showed [Ts Kc] and won (2223) with two pair, Kings and Tens



PokerStars Home Game Hand #222892417277: {DaPokaStars}  Hold'em No Limit (50/100) - 2021/01/21 15:43:46 ET
Table 'testnsdfgh' 9-max (Play Money) Seat #8 is the button
Seat 1: manon327 (9060 in chips) 
Seat 2: HighCardJasper (7519 in chips) 
Seat 3: FantasticDouble (9100 in chips) 
Seat 6: color_singleton (11756 in chips) 
Seat 8: poorrick1338 (7487 in chips) 
Seat 9: dhduncan (2223 in chips) 
dhduncan: posts small blind 50
manon327: posts big blind 100
*** HOLE CARDS ***
Dealt to FantasticDouble [6d 2d]
HighCardJasper: calls 100
FantasticDouble: folds 
color_singleton: folds 
poorrick1338: calls 100
dhduncan: calls 50
manon327: checks 
*** FLOP *** [9h Ah 4h]
dhduncan: checks 
manon327: checks 
HighCardJasper: checks 
poorrick1338: checks 
*** TURN *** [9h Ah 4h] [7d]
dhduncan: checks 
manon327: checks 
HighCardJasper: bets 100
poorrick1338: folds 
dhduncan: folds 
manon327: calls 100
*** RIVER *** [9h Ah 4h 7d] [6s]
manon327: checks 
HighCardJasper: checks 
*** SHOW DOWN ***
manon327: shows [8c 8s] (a pair of Eights)
HighCardJasper: mucks hand 
manon327 collected 567 from pot
*** SUMMARY ***
Total pot 600 | Rake 33 
Board [9h Ah 4h 7d 6s]
Seat 1: manon327 (big blind) showed [8c 8s] and won (567) with a pair of Eights
Seat 2: HighCardJasper mucked [Qs 7c]
Seat 3: FantasticDouble folded before Flop (didn't bet)
Seat 6: color_singleton folded before Flop (didn't bet)
Seat 8: poorrick1338 (button) folded on the Turn
Seat 9: dhduncan (small blind) folded on the Turn



PokerStars Home Game Hand #222892479795: {DaPokaStars}  Hold'em No Limit (50/100) - 2021/01/21 15:45:12 ET
Table 'testnsdfgh' 9-max (Play Money) Seat #9 is the button
Seat 1: manon327 (9427 in chips) 
Seat 2: HighCardJasper (7319 in chips) 
Seat 3: FantasticDouble (9100 in chips) 
Seat 6: color_singleton (11756 in chips) 
Seat 8: poorrick1338 (7387 in chips) 
Seat 9: dhduncan (2123 in chips) 
manon327: posts small blind 50
HighCardJasper: posts big blind 100
*** HOLE CARDS ***
Dealt to FantasticDouble [7c Ts]
FantasticDouble: folds 
color_singleton: folds 
poorrick1338: raises 100 to 200
dhduncan: calls 200
manon327: folds 
HighCardJasper: calls 100
*** FLOP *** [3h As Qd]
HighCardJasper: checks 
poorrick1338: bets 307
dhduncan: folds 
HighCardJasper: folds 
Uncalled bet (307) returned to poorrick1338
poorrick1338 collected 614 from pot
poorrick1338: doesn't show hand 
*** SUMMARY ***
Total pot 650 | Rake 36 
Board [3h As Qd]
Seat 1: manon327 (small blind) folded before Flop
Seat 2: HighCardJasper (big blind) folded on the Flop
Seat 3: FantasticDouble folded before Flop (didn't bet)
Seat 6: color_singleton folded before Flop (didn't bet)
Seat 8: poorrick1338 collected (614)
Seat 9: dhduncan (button) folded on the Flop



PokerStars Home Game Hand #222892507147: {DaPokaStars}  Hold'em No Limit (50/100) - 2021/01/21 15:45:50 ET
Table 'testnsdfgh' 9-max (Play Money) Seat #1 is the button
Seat 1: manon327 (9377 in chips) 
Seat 2: HighCardJasper (7119 in chips) 
Seat 3: FantasticDouble (9100 in chips) 
Seat 6: color_singleton (11756 in chips) 
Seat 8: poorrick1338 (7801 in chips) 
Seat 9: dhduncan (1923 in chips) 
HighCardJasper: posts small blind 50
FantasticDouble: posts big blind 100
*** HOLE CARDS ***
Dealt to FantasticDouble [Ah 7h]
color_singleton: raises 100 to 200
poorrick1338: calls 200
dhduncan: calls 200
manon327: folds 
HighCardJasper: folds 
FantasticDouble: calls 100
*** FLOP *** [8s 5s 4c]
FantasticDouble: checks 
color_singleton: checks 
poorrick1338: checks 
dhduncan: checks 
*** TURN *** [8s 5s 4c] [Ac]
FantasticDouble: bets 500
color_singleton: folds 
poorrick1338: folds 
dhduncan: folds 
Uncalled bet (500) returned to FantasticDouble
FantasticDouble collected 803 from pot
*** SUMMARY ***
Total pot 850 | Rake 47 
Board [8s 5s 4c Ac]
Seat 1: manon327 (button) folded before Flop (didn't bet)
Seat 2: HighCardJasper (small blind) folded before Flop
Seat 3: FantasticDouble (big blind) collected (803)
Seat 6: color_singleton folded on the Turn
Seat 8: poorrick1338 folded on the Turn
Seat 9: dhduncan folded on the Turn



PokerStars Home Game Hand #222892549309: {DaPokaStars}  Hold'em No Limit (50/100) - 2021/01/21 15:46:48 ET
Table 'testnsdfgh' 9-max (Play Money) Seat #2 is the button
Seat 1: manon327 (9377 in chips) 
Seat 2: HighCardJasper (7069 in chips) 
Seat 3: FantasticDouble (9703 in chips) 
Seat 6: color_singleton (11556 in chips) 
Seat 9: dhduncan (1723 in chips) 
FantasticDouble: posts small blind 50
color_singleton: posts big blind 100
*** HOLE CARDS ***
Dealt to FantasticDouble [Qd 6d]
dhduncan: calls 100
manon327: calls 100
HighCardJasper: calls 100
FantasticDouble: calls 50
color_singleton: checks 
*** FLOP *** [7c Jd 6s]
FantasticDouble: checks 
color_singleton: checks 
dhduncan: bets 236
manon327: folds 
HighCardJasper: calls 236
FantasticDouble: folds 
color_singleton: calls 236
*** TURN *** [7c Jd 6s] [2s]
color_singleton: checks 
dhduncan: bets 571
HighCardJasper: calls 571
color_singleton: folds 
*** RIVER *** [7c Jd 6s 2s] [Qs]
dhduncan: bets 816 and is all-in
HighCardJasper: calls 816
*** SHOW DOWN ***
dhduncan: shows [6h As] (a pair of Sixes)
HighCardJasper: shows [5d Js] (a pair of Jacks)
HighCardJasper collected 3763 from pot
*** SUMMARY ***
Total pot 3982 | Rake 219 
Board [7c Jd 6s 2s Qs]
Seat 1: manon327 folded on the Flop
Seat 2: HighCardJasper (button) showed [5d Js] and won (3763) with a pair of Jacks
Seat 3: FantasticDouble (small blind) folded on the Flop
Seat 6: color_singleton (big blind) folded on the Turn
Seat 9: dhduncan showed [6h As] and lost with a pair of Sixes



PokerStars Home Game Hand #222892610752: {DaPokaStars}  Hold'em No Limit (50/100) - 2021/01/21 15:48:14 ET
Table 'testnsdfgh' 9-max (Play Money) Seat #3 is the button
Seat 1: manon327 (9277 in chips) 
Seat 2: HighCardJasper (9109 in chips) 
Seat 3: FantasticDouble (9603 in chips) 
Seat 6: color_singleton (11220 in chips) 
Seat 8: poorrick1338 (7601 in chips) 
color_singleton: posts small blind 50
poorrick1338: posts big blind 100
*** HOLE CARDS ***
Dealt to FantasticDouble [Ad 4d]
manon327: calls 100
HighCardJasper: calls 100
FantasticDouble: calls 100
color_singleton: calls 50
poorrick1338 has timed out
poorrick1338: checks 
*** FLOP *** [6h 2h Kh]
color_singleton: checks 
poorrick1338: bets 100
manon327: calls 100
HighCardJasper: folds 
FantasticDouble: folds 
color_singleton: folds 
*** TURN *** [6h 2h Kh] [Jh]
poorrick1338: bets 330
manon327: raises 330 to 660
poorrick1338: calls 330
*** RIVER *** [6h 2h Kh Jh] [Ts]
poorrick1338: checks 
manon327: bets 954
poorrick1338: folds 
Uncalled bet (954) returned to manon327
manon327 collected 1909 from pot
*** SUMMARY ***
Total pot 2020 | Rake 111 
Board [6h 2h Kh Jh Ts]
Seat 1: manon327 collected (1909)
Seat 2: HighCardJasper folded on the Flop
Seat 3: FantasticDouble (button) folded on the Flop
Seat 6: color_singleton (small blind) folded on the Flop
Seat 8: poorrick1338 (big blind) folded on the River



PokerStars Home Game Hand #222892680364: {DaPokaStars}  Hold'em No Limit (50/100) - 2021/01/21 15:49:50 ET
Table 'testnsdfgh' 9-max (Play Money) Seat #6 is the button
Seat 1: manon327 (10326 in chips) 
Seat 2: HighCardJasper (9009 in chips) 
Seat 3: FantasticDouble (9503 in chips) 
Seat 6: color_singleton (11120 in chips) 
Seat 8: poorrick1338 (6741 in chips) 
Seat 9: dhduncan (10000 in chips) 
poorrick1338: posts small blind 50
dhduncan: posts big blind 100
*** HOLE CARDS ***
Dealt to FantasticDouble [9c 8h]
manon327: raises 100 to 200
HighCardJasper: calls 200
FantasticDouble: calls 200
color_singleton: calls 200
poorrick1338: folds 
dhduncan: calls 100
*** FLOP *** [Jd 7s 6s]
dhduncan: checks 
manon327: bets 496
HighCardJasper: calls 496
FantasticDouble: calls 496
color_singleton: folds 
dhduncan: folds 
*** TURN *** [Jd 7s 6s] [7d]
manon327: bets 2398
HighCardJasper: calls 2398
FantasticDouble: folds 
*** RIVER *** [Jd 7s 6s 7d] [5c]
manon327: checks 
HighCardJasper: checks 
*** SHOW DOWN ***
manon327: shows [Ac As] (two pair, Aces and Sevens)
HighCardJasper: shows [6h 6d] (a full house, Sixes full of Sevens)
HighCardJasper collected 6931 from pot
*** SUMMARY ***
Total pot 7334 | Rake 403 
Board [Jd 7s 6s 7d 5c]
Seat 1: manon327 showed [Ac As] and lost with two pair, Aces and Sevens
Seat 2: HighCardJasper showed [6h 6d] and won (6931) with a full house, Sixes full of Sevens
Seat 3: FantasticDouble folded on the Turn
Seat 6: color_singleton (button) folded on the Flop
Seat 8: poorrick1338 (small blind) folded before Flop
Seat 9: dhduncan (big blind) folded on the Flop



PokerStars Home Game Hand #222892730714: {DaPokaStars}  Hold'em No Limit (50/100) - 2021/01/21 15:51:00 ET
Table 'testnsdfgh' 9-max (Play Money) Seat #8 is the button
Seat 1: manon327 (7232 in chips) 
Seat 2: HighCardJasper (12846 in chips) 
Seat 3: FantasticDouble (8807 in chips) 
Seat 6: color_singleton (10920 in chips) 
Seat 8: poorrick1338 (6691 in chips) 
Seat 9: dhduncan (9800 in chips) 
dhduncan: posts small blind 50
manon327: posts big blind 100
*** HOLE CARDS ***
Dealt to FantasticDouble [2d As]
HighCardJasper: calls 100
FantasticDouble: folds 
color_singleton: calls 100
poorrick1338: calls 100
dhduncan: calls 50
manon327: checks 
*** FLOP *** [Qd 8s 3d]
dhduncan: bets 236
manon327: folds 
HighCardJasper: folds 
color_singleton: folds 
poorrick1338: calls 236
*** TURN *** [Qd 8s 3d] [4d]
dhduncan: bets 459
poorrick1338: raises 459 to 918
dhduncan: folds 
Uncalled bet (459) returned to poorrick1338
poorrick1338 collected 1786 from pot
poorrick1338: doesn't show hand 
*** SUMMARY ***
Total pot 1890 | Rake 104 
Board [Qd 8s 3d 4d]
Seat 1: manon327 (big blind) folded on the Flop
Seat 2: HighCardJasper folded on the Flop
Seat 3: FantasticDouble folded before Flop (didn't bet)
Seat 6: color_singleton folded on the Flop
Seat 8: poorrick1338 (button) collected (1786)
Seat 9: dhduncan (small blind) folded on the Turn



PokerStars Home Game Hand #222892790783: {DaPokaStars}  Hold'em No Limit (50/100) - 2021/01/21 15:52:23 ET
Table 'testnsdfgh' 9-max (Play Money) Seat #9 is the button
Seat 1: manon327 (7132 in chips) 
Seat 2: HighCardJasper (12746 in chips) 
Seat 3: FantasticDouble (8807 in chips) 
Seat 6: color_singleton (10820 in chips) 
Seat 8: poorrick1338 (7682 in chips) 
Seat 9: dhduncan (9005 in chips) 
manon327: posts small blind 50
HighCardJasper: posts big blind 100
*** HOLE CARDS ***
Dealt to FantasticDouble [7d Qh]
FantasticDouble: folds 
color_singleton: folds 
poorrick1338: calls 100
dhduncan: calls 100
manon327: folds 
HighCardJasper: checks 
*** FLOP *** [Jc Qc 5h]
HighCardJasper: bets 200
poorrick1338: folds 
dhduncan: raises 200 to 400
HighCardJasper: calls 200
*** TURN *** [Jc Qc 5h] [Ks]
HighCardJasper: checks 
dhduncan: checks 
*** RIVER *** [Jc Qc 5h Ks] [Tc]
HighCardJasper: bets 300
dhduncan: calls 300
*** SHOW DOWN ***
HighCardJasper: shows [5c Ah] (a straight, Ten to Ace)
dhduncan: mucks hand 
HighCardJasper collected 1654 from pot
*** SUMMARY ***
Total pot 1750 | Rake 96 
Board [Jc Qc 5h Ks Tc]
Seat 1: manon327 (small blind) folded before Flop
Seat 2: HighCardJasper (big blind) showed [5c Ah] and won (1654) with a straight, Ten to Ace
Seat 3: FantasticDouble folded before Flop (didn't bet)
Seat 6: color_singleton folded before Flop (didn't bet)
Seat 8: poorrick1338 folded on the Flop
Seat 9: dhduncan (button) mucked [Qd 6s]



PokerStars Home Game Hand #222892836899: {DaPokaStars}  Hold'em No Limit (50/100) - 2021/01/21 15:53:27 ET
Table 'testnsdfgh' 9-max (Play Money) Seat #1 is the button
Seat 1: manon327 (7082 in chips) 
Seat 2: HighCardJasper (13600 in chips) 
Seat 3: FantasticDouble (8807 in chips) 
Seat 6: color_singleton (10820 in chips) 
Seat 8: poorrick1338 (7582 in chips) 
Seat 9: dhduncan (8205 in chips) 
HighCardJasper: posts small blind 50
FantasticDouble: posts big blind 100
*** HOLE CARDS ***
Dealt to FantasticDouble [4s 3s]
color_singleton: folds 
poorrick1338: folds 
dhduncan: folds 
manon327: calls 100
HighCardJasper: calls 50
FantasticDouble: checks 
*** FLOP *** [Kd 6c 6h]
HighCardJasper: checks 
FantasticDouble: checks 
manon327: checks 
*** TURN *** [Kd 6c 6h] [9d]
HighCardJasper: checks 
FantasticDouble: checks 
manon327: bets 141
HighCardJasper: folds 
FantasticDouble: folds 
Uncalled bet (141) returned to manon327
manon327 collected 283 from pot
*** SUMMARY ***
Total pot 300 | Rake 17 
Board [Kd 6c 6h 9d]
Seat 1: manon327 (button) collected (283)
Seat 2: HighCardJasper (small blind) folded on the Turn
Seat 3: FantasticDouble (big blind) folded on the Turn
Seat 6: color_singleton folded before Flop (didn't bet)
Seat 8: poorrick1338 folded before Flop (didn't bet)
Seat 9: dhduncan folded before Flop (didn't bet)



PokerStars Home Game Hand #222892863001: {DaPokaStars}  Hold'em No Limit (50/100) - 2021/01/21 15:54:04 ET
Table 'testnsdfgh' 9-max (Play Money) Seat #2 is the button
Seat 1: manon327 (7265 in chips) 
Seat 2: HighCardJasper (13500 in chips) 
Seat 3: FantasticDouble (8707 in chips) 
Seat 6: color_singleton (10820 in chips) 
Seat 8: poorrick1338 (7582 in chips) 
Seat 9: dhduncan (8205 in chips) 
FantasticDouble: posts small blind 50
color_singleton: posts big blind 100
*** HOLE CARDS ***
Dealt to FantasticDouble [Ts 5c]
poorrick1338: calls 100
dhduncan: calls 100
manon327: calls 100
HighCardJasper: calls 100
FantasticDouble: calls 50
color_singleton: checks 
*** FLOP *** [2d Kh 5h]
FantasticDouble: checks 
color_singleton: checks 
poorrick1338: bets 100
dhduncan: calls 100
manon327: calls 100
HighCardJasper: folds 
FantasticDouble: folds 
color_singleton: calls 100
*** TURN *** [2d Kh 5h] [3c]
color_singleton: bets 472
poorrick1338: calls 472
dhduncan: folds 
manon327: folds 
*** RIVER *** [2d Kh 5h 3c] [Tc]
color_singleton: checks 
poorrick1338 said, "5"
poorrick1338: bets 518
color_singleton: folds 
Uncalled bet (518) returned to poorrick1338
poorrick1338 collected 1837 from pot
poorrick1338: doesn't show hand 
*** SUMMARY ***
Total pot 1944 | Rake 107 
Board [2d Kh 5h 3c Tc]
Seat 1: manon327 folded on the Turn
Seat 2: HighCardJasper (button) folded on the Flop
Seat 3: FantasticDouble (small blind) folded on the Flop
Seat 6: color_singleton (big blind) folded on the River
Seat 8: poorrick1338 collected (1837)
Seat 9: dhduncan folded on the Turn



PokerStars Home Game Hand #222892924117: {DaPokaStars}  Hold'em No Limit (50/100) - 2021/01/21 15:55:39 ET
Table 'testnsdfgh' 9-max (Play Money) Seat #3 is the button
Seat 1: manon327 (7065 in chips) 
Seat 2: HighCardJasper (13400 in chips) 
Seat 3: FantasticDouble (8607 in chips) 
Seat 6: color_singleton (10148 in chips) 
Seat 8: poorrick1338 (8747 in chips) 
Seat 9: dhduncan (8005 in chips) 
color_singleton: posts small blind 50
poorrick1338: posts big blind 100
*** HOLE CARDS ***
Dealt to FantasticDouble [Jd Qc]
dhduncan: folds 
manon327: calls 100
HighCardJasper: calls 100
FantasticDouble: raises 300 to 400
color_singleton: folds 
poorrick1338: calls 300
manon327: calls 300
HighCardJasper: folds 
*** FLOP *** [8d 3s 7h]
poorrick1338 has timed out
poorrick1338: checks 
manon327: checks 
FantasticDouble: bets 650
poorrick1338: folds 
manon327: folds 
Uncalled bet (650) returned to FantasticDouble
FantasticDouble collected 1276 from pot
*** SUMMARY ***
Total pot 1350 | Rake 74 
Board [8d 3s 7h]
Seat 1: manon327 folded on the Flop
Seat 2: HighCardJasper folded before Flop
Seat 3: FantasticDouble (button) collected (1276)
Seat 6: color_singleton (small blind) folded before Flop
Seat 8: poorrick1338 (big blind) folded on the Flop
Seat 9: dhduncan folded before Flop (didn't bet)



PokerStars Home Game Hand #222892961661: {DaPokaStars}  Hold'em No Limit (50/100) - 2021/01/21 15:56:49 ET
Table 'testnsdfgh' 9-max (Play Money) Seat #6 is the button
Seat 1: manon327 (6665 in chips) 
Seat 2: HighCardJasper (13300 in chips) 
Seat 3: FantasticDouble (9483 in chips) 
Seat 6: color_singleton (10098 in chips) 
Seat 8: poorrick1338 (8347 in chips) 
Seat 9: dhduncan (8005 in chips) 
poorrick1338: posts small blind 50
dhduncan: posts big blind 100
*** HOLE CARDS ***
Dealt to FantasticDouble [Qh Ks]
manon327: calls 100
HighCardJasper: calls 100
FantasticDouble: raises 300 to 400
color_singleton: calls 400
poorrick1338: folds 
dhduncan: calls 300
manon327: folds 
HighCardJasper: folds 
*** FLOP *** [5h 4d 7h]
dhduncan: checks 
FantasticDouble: checks 
color_singleton: checks 
*** TURN *** [5h 4d 7h] [4h]
dhduncan: checks 
FantasticDouble: checks 
color_singleton: bets 685
dhduncan: calls 685
FantasticDouble: folds 
*** RIVER *** [5h 4d 7h 4h] [Jc]
dhduncan: checks 
color_singleton: checks 
*** SHOW DOWN ***
dhduncan: shows [Ad 2d] (a pair of Fours)
color_singleton: shows [2c 2s] (two pair, Fours and Deuces)
color_singleton collected 2665 from pot
*** SUMMARY ***
Total pot 2820 | Rake 155 
Board [5h 4d 7h 4h Jc]
Seat 1: manon327 folded before Flop
Seat 2: HighCardJasper folded before Flop
Seat 3: FantasticDouble folded on the Turn
Seat 6: color_singleton (button) showed [2c 2s] and won (2665) with two pair, Fours and Deuces
Seat 8: poorrick1338 (small blind) folded before Flop
Seat 9: dhduncan (big blind) showed [Ad 2d] and lost with a pair of Fours



PokerStars Home Game Hand #222892990773: {DaPokaStars}  Hold'em No Limit (50/100) - 2021/01/21 15:57:44 ET
Table 'testnsdfgh' 9-max (Play Money) Seat #8 is the button
Seat 1: manon327 (6565 in chips) 
Seat 2: HighCardJasper (13200 in chips) 
Seat 3: FantasticDouble (9083 in chips) 
Seat 6: color_singleton (11678 in chips) 
Seat 8: poorrick1338 (8297 in chips) 
Seat 9: dhduncan (6920 in chips) 
dhduncan: posts small blind 50
manon327: posts big blind 100
*** HOLE CARDS ***
Dealt to FantasticDouble [8c 6d]
HighCardJasper: calls 100
FantasticDouble: folds 
color_singleton: folds 
poorrick1338: calls 100
dhduncan: calls 50
manon327: checks 
*** FLOP *** [Jh Qc Ac]
dhduncan: bets 200
manon327: calls 200
HighCardJasper: calls 200
poorrick1338: folds 
*** TURN *** [Jh Qc Ac] [Th]
dhduncan: bets 200
manon327: calls 200
HighCardJasper: calls 200
*** RIVER *** [Jh Qc Ac Th] [3c]
dhduncan: bets 1512
manon327: folds 
HighCardJasper: raises 1512 to 3024
dhduncan: calls 1512
*** SHOW DOWN ***
HighCardJasper: shows [Kd 7c] (a straight, Ten to Ace)
dhduncan: mucks hand 
HighCardJasper collected 7227 from pot
*** SUMMARY ***
Total pot 7648 | Rake 421 
Board [Jh Qc Ac Th 3c]
Seat 1: manon327 (big blind) folded on the River
Seat 2: HighCardJasper showed [Kd 7c] and won (7227) with a straight, Ten to Ace
Seat 3: FantasticDouble folded before Flop (didn't bet)
Seat 6: color_singleton folded before Flop (didn't bet)
Seat 8: poorrick1338 (button) folded on the Flop
Seat 9: dhduncan (small blind) mucked [Jc As]



PokerStars Home Game Hand #222893020874: {DaPokaStars}  Hold'em No Limit (50/100) - 2021/01/21 15:58:40 ET
Table 'testnsdfgh' 9-max (Play Money) Seat #9 is the button
Seat 1: manon327 (6065 in chips) 
Seat 2: HighCardJasper (16903 in chips) 
Seat 3: FantasticDouble (9083 in chips) 
Seat 6: color_singleton (11678 in chips) 
Seat 8: poorrick1338 (8197 in chips) 
Seat 9: dhduncan (3396 in chips) 
manon327: posts small blind 50
HighCardJasper: posts big blind 100
*** HOLE CARDS ***
Dealt to FantasticDouble [Ts 9s]
FantasticDouble: raises 300 to 400
color_singleton: calls 400
poorrick1338: folds 
dhduncan: calls 400
manon327: folds 
HighCardJasper: folds 
*** FLOP *** [Td Ad Qc]
FantasticDouble: checks 
color_singleton: checks 
dhduncan: checks 
*** TURN *** [Td Ad Qc] [Ah]
FantasticDouble: bets 800
color_singleton: folds 
dhduncan: folds 
Uncalled bet (800) returned to FantasticDouble
FantasticDouble collected 1276 from pot
*** SUMMARY ***
Total pot 1350 | Rake 74 
Board [Td Ad Qc Ah]
Seat 1: manon327 (small blind) folded before Flop
Seat 2: HighCardJasper (big blind) folded before Flop
Seat 3: FantasticDouble collected (1276)
Seat 6: color_singleton folded on the Turn
Seat 8: poorrick1338 folded before Flop (didn't bet)
Seat 9: dhduncan (button) folded on the Turn



PokerStars Home Game Hand #222893047033: {DaPokaStars}  Hold'em No Limit (50/100) - 2021/01/21 15:59:30 ET
Table 'testnsdfgh' 9-max (Play Money) Seat #1 is the button
Seat 1: manon327 (6015 in chips) 
Seat 2: HighCardJasper (16803 in chips) 
Seat 3: FantasticDouble (9959 in chips) 
Seat 6: color_singleton (11278 in chips) 
Seat 8: poorrick1338 (8197 in chips) 
Seat 9: dhduncan (2996 in chips) 
HighCardJasper: posts small blind 50
FantasticDouble: posts big blind 100
*** HOLE CARDS ***
Dealt to FantasticDouble [5h 8h]
color_singleton: folds 
poorrick1338: calls 100
dhduncan: folds 
manon327: calls 100
HighCardJasper: folds 
FantasticDouble: checks 
*** FLOP *** [9d 7s Jd]
FantasticDouble: checks 
poorrick1338: checks 
manon327: checks 
*** TURN *** [9d 7s Jd] [Kd]
FantasticDouble: checks 
poorrick1338: bets 100
manon327: calls 100
FantasticDouble: folds 
*** RIVER *** [9d 7s Jd Kd] [9s]
poorrick1338: bets 100
manon327: raises 100 to 200
poorrick1338: calls 100
*** SHOW DOWN ***
manon327: shows [Jh Tc] (two pair, Jacks and Nines)
poorrick1338: shows [Qs 9h] (three of a kind, Nines)
poorrick1338 collected 898 from pot
*** SUMMARY ***
Total pot 950 | Rake 52 
Board [9d 7s Jd Kd 9s]
Seat 1: manon327 (button) showed [Jh Tc] and lost with two pair, Jacks and Nines
Seat 2: HighCardJasper (small blind) folded before Flop
Seat 3: FantasticDouble (big blind) folded on the Turn
Seat 6: color_singleton folded before Flop (didn't bet)
Seat 8: poorrick1338 showed [Qs 9h] and won (898) with three of a kind, Nines
Seat 9: dhduncan folded before Flop (didn't bet)



PokerStars Home Game Hand #222893082661: {DaPokaStars}  Hold'em No Limit (50/100) - 2021/01/21 16:00:34 ET
Table 'testnsdfgh' 9-max (Play Money) Seat #2 is the button
Seat 1: manon327 (5615 in chips) 
Seat 2: HighCardJasper (16753 in chips) 
Seat 3: FantasticDouble (9859 in chips) 
Seat 6: color_singleton (11278 in chips) 
Seat 8: poorrick1338 (8695 in chips) 
Seat 9: dhduncan (2996 in chips) 
FantasticDouble: posts small blind 50
color_singleton: posts big blind 100
*** HOLE CARDS ***
Dealt to FantasticDouble [9s 6h]
poorrick1338: calls 100
dhduncan: folds 
manon327: folds 
HighCardJasper: folds 
FantasticDouble: calls 50
color_singleton: checks 
*** FLOP *** [8s 4s 4d]
FantasticDouble: checks 
color_singleton: bets 141
poorrick1338: calls 141
FantasticDouble: folds 
*** TURN *** [8s 4s 4d] [Qh]
color_singleton: bets 275
poorrick1338: calls 275
*** RIVER *** [8s 4s 4d Qh] [8h]
color_singleton: checks 
poorrick1338: checks 
*** SHOW DOWN ***
color_singleton: shows [2c 2h] (two pair, Eights and Fours)
poorrick1338: shows [Tc Js] (two pair, Eights and Fours)
color_singleton collected 535 from pot
poorrick1338 collected 535 from pot
*** SUMMARY ***
Total pot 1132 | Rake 62 
Board [8s 4s 4d Qh 8h]
Seat 1: manon327 folded before Flop (didn't bet)
Seat 2: HighCardJasper (button) folded before Flop (didn't bet)
Seat 3: FantasticDouble (small blind) folded on the Flop
Seat 6: color_singleton (big blind) showed [2c 2h] and won (535) with two pair, Eights and Fours
Seat 8: poorrick1338 showed [Tc Js] and won (535) with two pair, Eights and Fours
Seat 9: dhduncan folded before Flop (didn't bet)



PokerStars Home Game Hand #222893106689: {DaPokaStars}  Hold'em No Limit (50/100) - 2021/01/21 16:01:13 ET
Table 'testnsdfgh' 9-max (Play Money) Seat #3 is the button
Seat 1: manon327 (5615 in chips) 
Seat 2: HighCardJasper (16753 in chips) 
Seat 3: FantasticDouble (9759 in chips) 
Seat 6: color_singleton (11297 in chips) 
Seat 8: poorrick1338 (8714 in chips) 
Seat 9: dhduncan (2996 in chips) 
color_singleton: posts small blind 50
poorrick1338: posts big blind 100
*** HOLE CARDS ***
Dealt to FantasticDouble [Js Jc]
dhduncan: calls 100
manon327: calls 100
HighCardJasper: folds 
FantasticDouble: raises 300 to 400
color_singleton: folds 
poorrick1338: calls 300
dhduncan: folds 
manon327: calls 300
*** FLOP *** [Ad Kd 3c]
poorrick1338: bets 100
manon327: calls 100
FantasticDouble: calls 100
*** TURN *** [Ad Kd 3c] [9s]
poorrick1338: bets 779
manon327: calls 779
FantasticDouble: folds 
*** RIVER *** [Ad Kd 3c 9s] [9h]
poorrick1338: bets 100
manon327: raises 3232 to 3332
poorrick1338: calls 3232
*** SHOW DOWN ***
manon327: shows [As 6s] (two pair, Aces and Nines)
poorrick1338: shows [6c Ah] (two pair, Aces and Nines)
poorrick1338 collected 4665 from pot
manon327 collected 4664 from pot
*** SUMMARY ***
Total pot 9872 | Rake 543 
Board [Ad Kd 3c 9s 9h]
Seat 1: manon327 showed [As 6s] and won (4664) with two pair, Aces and Nines
Seat 2: HighCardJasper folded before Flop (didn't bet)
Seat 3: FantasticDouble (button) folded on the Turn
Seat 6: color_singleton (small blind) folded before Flop
Seat 8: poorrick1338 (big blind) showed [6c Ah] and won (4665) with two pair, Aces and Nines
Seat 9: dhduncan folded before Flop



PokerStars Home Game Hand #222893150263: {DaPokaStars}  Hold'em No Limit (50/100) - 2021/01/21 16:02:17 ET
Table 'testnsdfgh' 9-max (Play Money) Seat #6 is the button
Seat 1: manon327 (5668 in chips) 
Seat 2: HighCardJasper (16753 in chips) 
Seat 3: FantasticDouble (9259 in chips) 
Seat 6: color_singleton (11247 in chips) 
Seat 8: poorrick1338 (8768 in chips) 
Seat 9: dhduncan (2896 in chips) 
poorrick1338: posts small blind 50
dhduncan: posts big blind 100
*** HOLE CARDS ***
Dealt to FantasticDouble [7s 4s]
manon327: folds 
HighCardJasper: calls 100
FantasticDouble: folds 
color_singleton: calls 100
poorrick1338: calls 50
dhduncan: checks 
*** FLOP *** [7h Kh Th]
poorrick1338: bets 100
dhduncan: folds 
HighCardJasper: folds 
color_singleton: raises 200 to 300
poorrick1338: folds 
Uncalled bet (200) returned to color_singleton
color_singleton collected 567 from pot
color_singleton: doesn't show hand 
*** SUMMARY ***
Total pot 600 | Rake 33 
Board [7h Kh Th]
Seat 1: manon327 folded before Flop (didn't bet)
Seat 2: HighCardJasper folded on the Flop
Seat 3: FantasticDouble folded before Flop (didn't bet)
Seat 6: color_singleton (button) collected (567)
Seat 8: poorrick1338 (small blind) folded on the Flop
Seat 9: dhduncan (big blind) folded on the Flop



PokerStars Home Game Hand #222893184520: {DaPokaStars}  Hold'em No Limit (50/100) - 2021/01/21 16:03:06 ET
Table 'testnsdfgh' 9-max (Play Money) Seat #8 is the button
Seat 1: manon327 (5668 in chips) 
Seat 2: HighCardJasper (16653 in chips) 
Seat 3: FantasticDouble (9259 in chips) 
Seat 6: color_singleton (11614 in chips) 
Seat 8: poorrick1338 (8568 in chips) 
Seat 9: dhduncan (2796 in chips) 
dhduncan: posts small blind 50
manon327: posts big blind 100
*** HOLE CARDS ***
Dealt to FantasticDouble [Jh 5s]
HighCardJasper: calls 100
FantasticDouble: folds 
color_singleton: raises 100 to 200
poorrick1338: calls 200
dhduncan: folds 
manon327: calls 100
HighCardJasper: calls 100
*** FLOP *** [Jc Qs 6c]
manon327: bets 401
HighCardJasper: calls 401
color_singleton: calls 401
poorrick1338: folds 
*** TURN *** [Jc Qs 6c] [6h]
manon327: bets 970
HighCardJasper: calls 970
color_singleton: folds 
*** RIVER *** [Jc Qs 6c 6h] [4d]
manon327: bets 3773
HighCardJasper: raises 3773 to 7546
manon327: calls 324 and is all-in
Uncalled bet (3449) returned to HighCardJasper
*** SHOW DOWN ***
HighCardJasper: shows [6s 6d] (four of a kind, Sixes)
manon327: shows [Qd Jd] (two pair, Queens and Jacks)
HighCardJasper collected 11517 from pot
*** SUMMARY ***
Total pot 12187 | Rake 670 
Board [Jc Qs 6c 6h 4d]
Seat 1: manon327 (big blind) showed [Qd Jd] and lost with two pair, Queens and Jacks
Seat 2: HighCardJasper showed [6s 6d] and won (11517) with four of a kind, Sixes
Seat 3: FantasticDouble folded before Flop (didn't bet)
Seat 6: color_singleton folded on the Turn
Seat 8: poorrick1338 (button) folded on the Flop
Seat 9: dhduncan (small blind) folded before Flop



PokerStars Home Game Hand #222893242811: {DaPokaStars}  Hold'em No Limit (50/100) - 2021/01/21 16:04:29 ET
Table 'testnsdfgh' 9-max (Play Money) Seat #9 is the button
Seat 2: HighCardJasper (22502 in chips) 
Seat 3: FantasticDouble (9259 in chips) 
Seat 6: color_singleton (11013 in chips) 
Seat 8: poorrick1338 (8368 in chips) 
Seat 9: dhduncan (2746 in chips) 
HighCardJasper: posts small blind 50
FantasticDouble: posts big blind 100
*** HOLE CARDS ***
Dealt to FantasticDouble [Jc 8s]
color_singleton: folds 
poorrick1338: folds 
dhduncan: folds 
HighCardJasper: calls 50
FantasticDouble: checks 
*** FLOP *** [Qd Kd Kh]
HighCardJasper: checks 
FantasticDouble: checks 
*** TURN *** [Qd Kd Kh] [Td]
HighCardJasper: checks 
FantasticDouble: bets 200
HighCardJasper: calls 200
*** RIVER *** [Qd Kd Kh Td] [9c]
HighCardJasper: checks 
FantasticDouble: bets 600
HighCardJasper: calls 600
*** SHOW DOWN ***
FantasticDouble: shows [Jc 8s] (a straight, Nine to King)
HighCardJasper: mucks hand 
FantasticDouble collected 1701 from pot
*** SUMMARY ***
Total pot 1800 | Rake 99 
Board [Qd Kd Kh Td 9c]
Seat 2: HighCardJasper (small blind) mucked [3s 3d]
Seat 3: FantasticDouble (big blind) showed [Jc 8s] and won (1701) with a straight, Nine to King
Seat 6: color_singleton folded before Flop (didn't bet)
Seat 8: poorrick1338 folded before Flop (didn't bet)
Seat 9: dhduncan (button) folded before Flop (didn't bet)



PokerStars Home Game Hand #222893295956: {DaPokaStars}  Hold'em No Limit (50/100) - 2021/01/21 16:05:32 ET
Table 'testnsdfgh' 9-max (Play Money) Seat #2 is the button
Seat 1: manon327 (10000 in chips) 
Seat 2: HighCardJasper (21602 in chips) 
Seat 3: FantasticDouble (10060 in chips) 
Seat 6: color_singleton (11013 in chips) 
Seat 8: poorrick1338 (8368 in chips) 
Seat 9: dhduncan (2746 in chips) 
FantasticDouble: posts small blind 50
color_singleton: posts big blind 100
manon327: posts small blind 50
*** HOLE CARDS ***
Dealt to FantasticDouble [8d 2h]
poorrick1338: raises 100 to 200
dhduncan: folds 
manon327: folds 
HighCardJasper: folds 
FantasticDouble: folds 
color_singleton: calls 100
*** FLOP *** [4s 2d 6s]
color_singleton: checks 
poorrick1338: checks 
*** TURN *** [4s 2d 6s] [Jh]
color_singleton: bets 200
poorrick1338: calls 200
*** RIVER *** [4s 2d 6s Jh] [Js]
color_singleton: bets 1000
poorrick1338: folds 
Uncalled bet (1000) returned to color_singleton
color_singleton collected 850 from pot
color_singleton: doesn't show hand 
*** SUMMARY ***
Total pot 900 | Rake 50 
Board [4s 2d 6s Jh Js]
Seat 1: manon327 folded before Flop (didn't bet)
Seat 2: HighCardJasper (button) folded before Flop (didn't bet)
Seat 3: FantasticDouble (small blind) folded before Flop
Seat 6: color_singleton (big blind) collected (850)
Seat 8: poorrick1338 folded on the River
Seat 9: dhduncan folded before Flop (didn't bet)



PokerStars Home Game Hand #222893328373: {DaPokaStars}  Hold'em No Limit (50/100) - 2021/01/21 16:06:18 ET
Table 'testnsdfgh' 9-max (Play Money) Seat #3 is the button
Seat 1: manon327 (9950 in chips) 
Seat 2: HighCardJasper (21602 in chips) 
Seat 3: FantasticDouble (10010 in chips) 
Seat 6: color_singleton (11463 in chips) 
Seat 8: poorrick1338 (7968 in chips) 
Seat 9: dhduncan (2746 in chips) 
color_singleton: posts small blind 50
poorrick1338: posts big blind 100
*** HOLE CARDS ***
Dealt to FantasticDouble [Qh 6s]
dhduncan: calls 100
manon327: folds 
HighCardJasper: raises 100 to 200
FantasticDouble: folds 
color_singleton: folds 
poorrick1338: calls 100
dhduncan: folds 
*** FLOP *** [6d 6h Jd]
poorrick1338 has timed out
poorrick1338: checks 
HighCardJasper: checks 
*** TURN *** [6d 6h Jd] [7c]
poorrick1338: bets 700
HighCardJasper: folds 
Uncalled bet (700) returned to poorrick1338
poorrick1338 collected 520 from pot
poorrick1338: doesn't show hand 
*** SUMMARY ***
Total pot 550 | Rake 30 
Board [6d 6h Jd 7c]
Seat 1: manon327 folded before Flop (didn't bet)
Seat 2: HighCardJasper folded on the Turn
Seat 3: FantasticDouble (button) folded before Flop (didn't bet)
Seat 6: color_singleton (small blind) folded before Flop
Seat 8: poorrick1338 (big blind) collected (520)
Seat 9: dhduncan folded before Flop



PokerStars Home Game Hand #222893377892: {DaPokaStars}  Hold'em No Limit (50/100) - 2021/01/21 16:07:27 ET
Table 'testnsdfgh' 9-max (Play Money) Seat #6 is the button
Seat 1: manon327 (9950 in chips) 
Seat 2: HighCardJasper (21402 in chips) 
Seat 3: FantasticDouble (10010 in chips) 
Seat 6: color_singleton (11413 in chips) 
Seat 8: poorrick1338 (8288 in chips) 
Seat 9: dhduncan (2646 in chips) 
poorrick1338: posts small blind 50
dhduncan: posts big blind 100
*** HOLE CARDS ***
Dealt to FantasticDouble [Ts 5d]
manon327: folds 
HighCardJasper: calls 100
FantasticDouble: folds 
color_singleton: raises 100 to 200
poorrick1338: calls 150
dhduncan: folds 
HighCardJasper: calls 100
*** FLOP *** [Jh 4s Jd]
poorrick1338: checks 
HighCardJasper: checks 
color_singleton: bets 330
poorrick1338: folds 
HighCardJasper: folds 
Uncalled bet (330) returned to color_singleton
color_singleton collected 661 from pot
color_singleton: doesn't show hand 
*** SUMMARY ***
Total pot 700 | Rake 39 
Board [Jh 4s Jd]
Seat 1: manon327 folded before Flop (didn't bet)
Seat 2: HighCardJasper folded on the Flop
Seat 3: FantasticDouble folded before Flop (didn't bet)
Seat 6: color_singleton (button) collected (661)
Seat 8: poorrick1338 (small blind) folded on the Flop
Seat 9: dhduncan (big blind) folded before Flop



PokerStars Home Game Hand #222893406638: {DaPokaStars}  Hold'em No Limit (50/100) - 2021/01/21 16:08:08 ET
Table 'testnsdfgh' 9-max (Play Money) Seat #8 is the button
Seat 1: manon327 (9950 in chips) 
Seat 2: HighCardJasper (21202 in chips) 
Seat 3: FantasticDouble (10010 in chips) 
Seat 6: color_singleton (11874 in chips) 
Seat 8: poorrick1338 (8088 in chips) 
Seat 9: dhduncan (2546 in chips) 
dhduncan: posts small blind 50
manon327: posts big blind 100
*** HOLE CARDS ***
Dealt to FantasticDouble [Kh 7s]
HighCardJasper: raises 100 to 200
FantasticDouble: folds 
color_singleton: folds 
poorrick1338: folds 
dhduncan: calls 150
manon327: calls 100
*** FLOP *** [6s Ts 2d]
dhduncan: checks 
manon327: checks 
HighCardJasper: bets 300
dhduncan: calls 300
manon327: folds 
*** TURN *** [6s Ts 2d] [9s]
dhduncan: checks 
HighCardJasper: bets 400
dhduncan: folds 
Uncalled bet (400) returned to HighCardJasper
HighCardJasper collected 1134 from pot
HighCardJasper: doesn't show hand 
*** SUMMARY ***
Total pot 1200 | Rake 66 
Board [6s Ts 2d 9s]
Seat 1: manon327 (big blind) folded on the Flop
Seat 2: HighCardJasper collected (1134)
Seat 3: FantasticDouble folded before Flop (didn't bet)
Seat 6: color_singleton folded before Flop (didn't bet)
Seat 8: poorrick1338 (button) folded before Flop (didn't bet)
Seat 9: dhduncan (small blind) folded on the Turn



PokerStars Home Game Hand #222893447993: {DaPokaStars}  Hold'em No Limit (50/100) - 2021/01/21 16:09:06 ET
Table 'testnsdfgh' 9-max (Play Money) Seat #9 is the button
Seat 1: manon327 (9750 in chips) 
Seat 2: HighCardJasper (21836 in chips) 
Seat 3: FantasticDouble (10010 in chips) 
Seat 6: color_singleton (11874 in chips) 
Seat 8: poorrick1338 (8088 in chips) 
Seat 9: dhduncan (2046 in chips) 
manon327: posts small blind 50
HighCardJasper: posts big blind 100
*** HOLE CARDS ***
Dealt to FantasticDouble [Qs Jd]
FantasticDouble: raises 300 to 400
color_singleton: calls 400
poorrick1338: calls 400
dhduncan: folds 
manon327: folds 
HighCardJasper: folds 
*** FLOP *** [Tc Qc 4h]
FantasticDouble: bets 500
color_singleton: calls 500
poorrick1338: folds 
*** TURN *** [Tc Qc 4h] [7c]
FantasticDouble: checks 
color_singleton: checks 
*** RIVER *** [Tc Qc 4h 7c] [Ts]
FantasticDouble: bets 1000
color_singleton: folds 
Uncalled bet (1000) returned to FantasticDouble
FantasticDouble collected 2221 from pot
*** SUMMARY ***
Total pot 2350 | Rake 129 
Board [Tc Qc 4h 7c Ts]
Seat 1: manon327 (small blind) folded before Flop
Seat 2: HighCardJasper (big blind) folded before Flop
Seat 3: FantasticDouble collected (2221)
Seat 6: color_singleton folded on the River
Seat 8: poorrick1338 folded on the Flop
Seat 9: dhduncan (button) folded before Flop (didn't bet)



PokerStars Home Game Hand #222893482074: {DaPokaStars}  Hold'em No Limit (50/100) - 2021/01/21 16:09:53 ET
Table 'testnsdfgh' 9-max (Play Money) Seat #1 is the button
Seat 1: manon327 (9700 in chips) 
Seat 2: HighCardJasper (21736 in chips) 
Seat 3: FantasticDouble (11331 in chips) 
Seat 6: color_singleton (10974 in chips) 
Seat 8: poorrick1338 (7688 in chips) 
Seat 9: dhduncan (2046 in chips) 
HighCardJasper: posts small blind 50
FantasticDouble: posts big blind 100
*** HOLE CARDS ***
Dealt to FantasticDouble [As Ad]
color_singleton: folds 
poorrick1338: folds 
dhduncan: folds 
manon327: calls 100
HighCardJasper: calls 50
FantasticDouble: raises 400 to 500
manon327: calls 400
HighCardJasper: folds 
*** FLOP *** [9d Kc Qs]
FantasticDouble: bets 700
manon327: folds 
Uncalled bet (700) returned to FantasticDouble
FantasticDouble collected 1039 from pot
*** SUMMARY ***
Total pot 1100 | Rake 61 
Board [9d Kc Qs]
Seat 1: manon327 (button) folded on the Flop
Seat 2: HighCardJasper (small blind) folded before Flop
Seat 3: FantasticDouble (big blind) collected (1039)
Seat 6: color_singleton folded before Flop (didn't bet)
Seat 8: poorrick1338 folded before Flop (didn't bet)
Seat 9: dhduncan folded before Flop (didn't bet)



PokerStars Home Game Hand #222893510323: {DaPokaStars}  Hold'em No Limit (50/100) - 2021/01/21 16:10:21 ET
Table 'testnsdfgh' 9-max (Play Money) Seat #2 is the button
Seat 1: manon327 (9200 in chips) 
Seat 2: HighCardJasper (21636 in chips) 
Seat 3: FantasticDouble (11870 in chips) 
Seat 6: color_singleton (10974 in chips) 
Seat 8: poorrick1338 (7688 in chips) 
Seat 9: dhduncan (2046 in chips) 
FantasticDouble: posts small blind 50
color_singleton: posts big blind 100
*** HOLE CARDS ***
Dealt to FantasticDouble [Ks 6d]
poorrick1338: folds 
dhduncan: folds 
manon327: calls 100
HighCardJasper: calls 100
FantasticDouble: calls 50
color_singleton: checks 
*** FLOP *** [7h Tc 7c]
FantasticDouble: checks 
color_singleton: checks 
manon327: checks 
HighCardJasper: checks 
*** TURN *** [7h Tc 7c] [Jd]
FantasticDouble: checks 
color_singleton: checks 
manon327: checks 
HighCardJasper: checks 
*** RIVER *** [7h Tc 7c Jd] [As]
FantasticDouble: checks 
color_singleton: checks 
manon327: bets 189
HighCardJasper: folds 
FantasticDouble: folds 
color_singleton: folds 
Uncalled bet (189) returned to manon327
manon327 collected 378 from pot
*** SUMMARY ***
Total pot 400 | Rake 22 
Board [7h Tc 7c Jd As]
Seat 1: manon327 collected (378)
Seat 2: HighCardJasper (button) folded on the River
Seat 3: FantasticDouble (small blind) folded on the River
Seat 6: color_singleton (big blind) folded on the River
Seat 8: poorrick1338 folded before Flop (didn't bet)
Seat 9: dhduncan folded before Flop (didn't bet)



PokerStars Home Game Hand #222893555058: {DaPokaStars}  Hold'em No Limit (50/100) - 2021/01/21 16:11:24 ET
Table 'testnsdfgh' 9-max (Play Money) Seat #3 is the button
Seat 1: manon327 (9478 in chips) 
Seat 2: HighCardJasper (21536 in chips) 
Seat 3: FantasticDouble (11770 in chips) 
Seat 6: color_singleton (10874 in chips) 
Seat 8: poorrick1338 (7688 in chips) 
Seat 9: dhduncan (2046 in chips) 
color_singleton: posts small blind 50
poorrick1338: posts big blind 100
*** HOLE CARDS ***
Dealt to FantasticDouble [Td 8s]
dhduncan: calls 100
manon327: folds 
HighCardJasper: calls 100
FantasticDouble: folds 
color_singleton: calls 50
poorrick1338: checks 
*** FLOP *** [Kd 3h Ad]
color_singleton: bets 189
poorrick1338: calls 189
dhduncan: calls 189
HighCardJasper: folds 
*** TURN *** [Kd 3h Ad] [6s]
color_singleton: bets 914
poorrick1338: calls 914
dhduncan: folds 
*** RIVER *** [Kd 3h Ad 6s] [5s]
color_singleton: bets 1320
poorrick1338: calls 1320
*** SHOW DOWN ***
color_singleton: shows [Ks 3d] (two pair, Kings and Threes)
poorrick1338: shows [3s Kh] (two pair, Kings and Threes)
color_singleton collected 2568 from pot
poorrick1338 collected 2568 from pot
*** SUMMARY ***
Total pot 5435 | Rake 299 
Board [Kd 3h Ad 6s 5s]
Seat 1: manon327 folded before Flop (didn't bet)
Seat 2: HighCardJasper folded on the Flop
Seat 3: FantasticDouble (button) folded before Flop (didn't bet)
Seat 6: color_singleton (small blind) showed [Ks 3d] and won (2568) with two pair, Kings and Threes
Seat 8: poorrick1338 (big blind) showed [3s Kh] and won (2568) with two pair, Kings and Threes
Seat 9: dhduncan folded on the Turn



PokerStars Home Game Hand #222893604098: {DaPokaStars}  Hold'em No Limit (50/100) - 2021/01/21 16:12:33 ET
Table 'testnsdfgh' 9-max (Play Money) Seat #6 is the button
Seat 1: manon327 (9478 in chips) 
Seat 2: HighCardJasper (21436 in chips) 
Seat 3: FantasticDouble (11770 in chips) 
Seat 6: color_singleton (10919 in chips) 
Seat 8: poorrick1338 (7733 in chips) 
Seat 9: dhduncan (1757 in chips) 
poorrick1338: posts small blind 50
dhduncan: posts big blind 100
*** HOLE CARDS ***
Dealt to FantasticDouble [4h 3h]
manon327: folds 
HighCardJasper has timed out
HighCardJasper: folds 
FantasticDouble: calls 100
color_singleton: calls 100
poorrick1338: calls 50
dhduncan: checks 
*** FLOP *** [Kc 6s 8s]
poorrick1338: bets 189
dhduncan: folds 
FantasticDouble: folds 
color_singleton: folds 
Uncalled bet (189) returned to poorrick1338
poorrick1338 collected 378 from pot
poorrick1338: doesn't show hand 
*** SUMMARY ***
Total pot 400 | Rake 22 
Board [Kc 6s 8s]
Seat 1: manon327 folded before Flop (didn't bet)
Seat 2: HighCardJasper folded before Flop (didn't bet)
Seat 3: FantasticDouble folded on the Flop
Seat 6: color_singleton (button) folded on the Flop
Seat 8: poorrick1338 (small blind) collected (378)
Seat 9: dhduncan (big blind) folded on the Flop



PokerStars Home Game Hand #222893637204: {DaPokaStars}  Hold'em No Limit (50/100) - 2021/01/21 16:13:19 ET
Table 'testnsdfgh' 9-max (Play Money) Seat #8 is the button
Seat 1: manon327 (9478 in chips) 
Seat 3: FantasticDouble (11670 in chips) 
Seat 6: color_singleton (10819 in chips) 
Seat 8: poorrick1338 (8011 in chips) 
Seat 9: dhduncan (1657 in chips) 
dhduncan: posts small blind 50
manon327: posts big blind 100
*** HOLE CARDS ***
Dealt to FantasticDouble [Ac 6c]
FantasticDouble: raises 200 to 300
color_singleton: calls 300
poorrick1338: calls 300
dhduncan: calls 250
manon327: calls 200
*** FLOP *** [9h Jc 5h]
dhduncan: bets 1357 and is all-in
manon327: folds 
FantasticDouble: folds 
color_singleton: folds 
poorrick1338: folds 
Uncalled bet (1357) returned to dhduncan
dhduncan collected 1417 from pot
dhduncan: doesn't show hand 
*** SUMMARY ***
Total pot 1500 | Rake 83 
Board [9h Jc 5h]
Seat 1: manon327 (big blind) folded on the Flop
Seat 3: FantasticDouble folded on the Flop
Seat 6: color_singleton folded on the Flop
Seat 8: poorrick1338 (button) folded on the Flop
Seat 9: dhduncan (small blind) collected (1417)



PokerStars Home Game Hand #222893667258: {DaPokaStars}  Hold'em No Limit (50/100) - 2021/01/21 16:14:01 ET
Table 'testnsdfgh' 9-max (Play Money) Seat #9 is the button
Seat 1: manon327 (9178 in chips) 
Seat 3: FantasticDouble (11370 in chips) 
Seat 6: color_singleton (10519 in chips) 
Seat 8: poorrick1338 (7711 in chips) 
Seat 9: dhduncan (2774 in chips) 
manon327: posts small blind 50
FantasticDouble: posts big blind 100
*** HOLE CARDS ***
Dealt to FantasticDouble [8s 7c]
color_singleton: folds 
poorrick1338: folds 
dhduncan: calls 100
manon327: calls 50
FantasticDouble: checks 
*** FLOP *** [7d 4h 2c]
manon327: checks 
FantasticDouble: bets 200
dhduncan: folds 
manon327: calls 200
*** TURN *** [7d 4h 2c] [5s]
manon327: checks 
FantasticDouble: bets 400
manon327: folds 
Uncalled bet (400) returned to FantasticDouble
FantasticDouble collected 661 from pot
*** SUMMARY ***
Total pot 700 | Rake 39 
Board [7d 4h 2c 5s]
Seat 1: manon327 (small blind) folded on the Turn
Seat 3: FantasticDouble (big blind) collected (661)
Seat 6: color_singleton folded before Flop (didn't bet)
Seat 8: poorrick1338 folded before Flop (didn't bet)
Seat 9: dhduncan (button) folded on the Flop



PokerStars Home Game Hand #222893698804: {DaPokaStars}  Hold'em No Limit (50/100) - 2021/01/21 16:14:46 ET
Table 'testnsdfgh' 9-max (Play Money) Seat #1 is the button
Seat 1: manon327 (8878 in chips) 
Seat 3: FantasticDouble (11731 in chips) 
Seat 6: color_singleton (10519 in chips) 
Seat 8: poorrick1338 (7711 in chips) 
Seat 9: dhduncan (2674 in chips) 
FantasticDouble: posts small blind 50
color_singleton: posts big blind 100
*** HOLE CARDS ***
Dealt to FantasticDouble [Ac Qh]
poorrick1338: calls 100
dhduncan: calls 100
manon327: calls 100
FantasticDouble: raises 300 to 400
color_singleton has timed out
color_singleton: folds 
poorrick1338: folds 
dhduncan: calls 300
manon327: folds 
*** FLOP *** [Qs 4c 3c]
FantasticDouble: bets 600
dhduncan: folds 
Uncalled bet (600) returned to FantasticDouble
FantasticDouble collected 1039 from pot
*** SUMMARY ***
Total pot 1100 | Rake 61 
Board [Qs 4c 3c]
Seat 1: manon327 (button) folded before Flop
Seat 3: FantasticDouble (small blind) collected (1039)
Seat 6: color_singleton (big blind) folded before Flop
Seat 8: poorrick1338 folded before Flop
Seat 9: dhduncan folded on the Flop



PokerStars Home Game Hand #222893736776: {DaPokaStars}  Hold'em No Limit (50/100) - 2021/01/21 16:15:38 ET
Table 'testnsdfgh' 9-max (Play Money) Seat #3 is the button
Seat 1: manon327 (8778 in chips) 
Seat 3: FantasticDouble (12370 in chips) 
Seat 8: poorrick1338 (7611 in chips) 
Seat 9: dhduncan (2274 in chips) 
poorrick1338: posts small blind 50
dhduncan: posts big blind 100
*** HOLE CARDS ***
Dealt to FantasticDouble [7d 9s]
manon327: folds 
FantasticDouble: raises 200 to 300
poorrick1338: folds 
dhduncan: folds 
Uncalled bet (200) returned to FantasticDouble
FantasticDouble collected 250 from pot
*** SUMMARY ***
Total pot 250 | Rake 0 
Seat 1: manon327 folded before Flop (didn't bet)
Seat 3: FantasticDouble (button) collected (250)
Seat 8: poorrick1338 (small blind) folded before Flop
Seat 9: dhduncan (big blind) folded before Flop



PokerStars Home Game Hand #222893754949: {DaPokaStars}  Hold'em No Limit (50/100) - 2021/01/21 16:16:03 ET
Table 'testnsdfgh' 9-max (Play Money) Seat #8 is the button
Seat 1: manon327 (8778 in chips) 
Seat 3: FantasticDouble (12520 in chips) 
Seat 6: color_singleton (10419 in chips) 
Seat 8: poorrick1338 (7561 in chips) 
Seat 9: dhduncan (2174 in chips) 
dhduncan: posts small blind 50
manon327: posts big blind 100
color_singleton: posts small blind 50
*** HOLE CARDS ***
Dealt to FantasticDouble [Ts 5h]
FantasticDouble: folds 
color_singleton: raises 100 to 200
poorrick1338: calls 200
dhduncan: calls 150
manon327: calls 100
*** FLOP *** [Ks Qd 4c]
dhduncan: checks 
manon327: bets 401
color_singleton: calls 401
poorrick1338: calls 401
dhduncan: folds 
*** TURN *** [Ks Qd 4c] [5s]
manon327: checks 
color_singleton: bets 970
poorrick1338: folds 
manon327: folds 
Uncalled bet (970) returned to color_singleton
color_singleton collected 1940 from pot
color_singleton: doesn't show hand 
*** SUMMARY ***
Total pot 2053 | Rake 113 
Board [Ks Qd 4c 5s]
Seat 1: manon327 (big blind) folded on the Turn
Seat 3: FantasticDouble folded before Flop (didn't bet)
Seat 6: color_singleton collected (1940)
Seat 8: poorrick1338 (button) folded on the Turn
Seat 9: dhduncan (small blind) folded on the Flop



PokerStars Home Game Hand #222893807794: {DaPokaStars}  Hold'em No Limit (50/100) - 2021/01/21 16:17:14 ET
Table 'testnsdfgh' 9-max (Play Money) Seat #9 is the button
Seat 1: manon327 (8177 in chips) 
Seat 3: FantasticDouble (12520 in chips) 
Seat 6: color_singleton (11708 in chips) 
Seat 8: poorrick1338 (6960 in chips) 
Seat 9: dhduncan (1974 in chips) 
manon327: posts small blind 50
FantasticDouble: posts big blind 100
*** HOLE CARDS ***
Dealt to FantasticDouble [Jd 9c]
color_singleton: raises 100 to 200
poorrick1338: calls 200
dhduncan: calls 200
manon327: folds 
FantasticDouble: calls 100
*** FLOP *** [Ts 9h 6c]
FantasticDouble: bets 300
color_singleton: raises 300 to 600
poorrick1338: calls 600
dhduncan: folds 
FantasticDouble: calls 300
*** TURN *** [Ts 9h 6c] [7s]
FantasticDouble has timed out
FantasticDouble: checks 
color_singleton: checks 
poorrick1338: checks 
*** RIVER *** [Ts 9h 6c 7s] [Qs]
FantasticDouble: checks 
color_singleton: checks 
poorrick1338: checks 
*** SHOW DOWN ***
FantasticDouble: shows [Jd 9c] (a pair of Nines)
color_singleton: shows [Th Jh] (a pair of Tens)
poorrick1338: mucks hand 
color_singleton collected 2504 from pot
*** SUMMARY ***
Total pot 2650 | Rake 146 
Board [Ts 9h 6c 7s Qs]
Seat 1: manon327 (small blind) folded before Flop
Seat 3: FantasticDouble (big blind) showed [Jd 9c] and lost with a pair of Nines
Seat 6: color_singleton showed [Th Jh] and won (2504) with a pair of Tens
Seat 8: poorrick1338 mucked [Ah Js]
Seat 9: dhduncan (button) folded on the Flop



PokerStars Home Game Hand #222893869270: {DaPokaStars}  Hold'em No Limit (50/100) - 2021/01/21 16:18:38 ET
Table 'testnsdfgh' 9-max (Play Money) Seat #1 is the button
Seat 1: manon327 (8127 in chips) 
Seat 3: FantasticDouble (11720 in chips) 
Seat 6: color_singleton (13412 in chips) 
Seat 8: poorrick1338 (6160 in chips) 
Seat 9: dhduncan (1774 in chips) 
FantasticDouble: posts small blind 50
color_singleton: posts big blind 100
*** HOLE CARDS ***
Dealt to FantasticDouble [8s 2h]
poorrick1338: folds 
dhduncan: calls 100
manon327: calls 100
FantasticDouble: calls 50
color_singleton: checks 
*** FLOP *** [Ks 6d As]
FantasticDouble: checks 
color_singleton: checks 
dhduncan: checks 
manon327: checks 
*** TURN *** [Ks 6d As] [2s]
FantasticDouble: bets 200
color_singleton: calls 200
dhduncan: raises 200 to 400
manon327: folds 
FantasticDouble: folds 
color_singleton: calls 200
*** RIVER *** [Ks 6d As 2s] [9s]
color_singleton: bets 1323
dhduncan: folds 
Uncalled bet (1323) returned to color_singleton
color_singleton collected 1323 from pot
color_singleton: doesn't show hand 
*** SUMMARY ***
Total pot 1400 | Rake 77 
Board [Ks 6d As 2s 9s]
Seat 1: manon327 (button) folded on the Turn
Seat 3: FantasticDouble (small blind) folded on the Turn
Seat 6: color_singleton (big blind) collected (1323)
Seat 8: poorrick1338 folded before Flop (didn't bet)
Seat 9: dhduncan folded on the River



PokerStars Home Game Hand #222893908417: {DaPokaStars}  Hold'em No Limit (50/100) - 2021/01/21 16:19:31 ET
Table 'testnsdfgh' 9-max (Play Money) Seat #3 is the button
Seat 1: manon327 (8027 in chips) 
Seat 3: FantasticDouble (11420 in chips) 
Seat 6: color_singleton (14235 in chips) 
Seat 8: poorrick1338 (6160 in chips) 
Seat 9: dhduncan (1274 in chips) 
color_singleton: posts small blind 50
poorrick1338: posts big blind 100
*** HOLE CARDS ***
Dealt to FantasticDouble [4h 9h]
dhduncan: raises 100 to 200
manon327: folds 
FantasticDouble: folds 
color_singleton: folds 
poorrick1338: calls 100
*** FLOP *** [5s 5d 6c]
poorrick1338: checks 
dhduncan: checks 
*** TURN *** [5s 5d 6c] [2s]
poorrick1338: checks 
dhduncan: checks 
*** RIVER *** [5s 5d 6c 2s] [7c]
poorrick1338: checks 
dhduncan: checks 
*** SHOW DOWN ***
poorrick1338: shows [3c Kc] (a pair of Fives)
dhduncan: mucks hand 
poorrick1338 collected 425 from pot
*** SUMMARY ***
Total pot 450 | Rake 25 
Board [5s 5d 6c 2s 7c]
Seat 1: manon327 folded before Flop (didn't bet)
Seat 3: FantasticDouble (button) folded before Flop (didn't bet)
Seat 6: color_singleton (small blind) folded before Flop
Seat 8: poorrick1338 (big blind) showed [3c Kc] and won (425) with a pair of Fives
Seat 9: dhduncan mucked [Js 8d]



PokerStars Home Game Hand #222893937015: {DaPokaStars}  Hold'em No Limit (50/100) - 2021/01/21 16:20:10 ET
Table 'testnsdfgh' 9-max (Play Money) Seat #6 is the button
Seat 1: manon327 (8027 in chips) 
Seat 2: HighCardJasper (21436 in chips) 
Seat 3: FantasticDouble (11420 in chips) 
Seat 6: color_singleton (14185 in chips) 
Seat 8: poorrick1338 (6385 in chips) 
Seat 9: dhduncan (1074 in chips) 
poorrick1338: posts small blind 50
dhduncan: posts big blind 100
HighCardJasper: posts small & big blinds 150
*** HOLE CARDS ***
Dealt to FantasticDouble [4h 5d]
manon327: folds 
HighCardJasper: checks 
FantasticDouble: calls 100
color_singleton: folds 
poorrick1338 has timed out
poorrick1338: folds 
dhduncan: checks 
*** FLOP *** [Ad As 6c]
dhduncan: checks 
HighCardJasper: bets 300
FantasticDouble: folds 
dhduncan: folds 
Uncalled bet (300) returned to HighCardJasper
HighCardJasper collected 378 from pot
HighCardJasper: doesn't show hand 
*** SUMMARY ***
Total pot 400 | Rake 22 
Board [Ad As 6c]
Seat 1: manon327 folded before Flop (didn't bet)
Seat 2: HighCardJasper collected (378)
Seat 3: FantasticDouble folded on the Flop
Seat 6: color_singleton (button) folded before Flop (didn't bet)
Seat 8: poorrick1338 (small blind) folded before Flop
Seat 9: dhduncan (big blind) folded on the Flop



PokerStars Home Game Hand #222893973533: {DaPokaStars}  Hold'em No Limit (50/100) - 2021/01/21 16:20:59 ET
Table 'testnsdfgh' 9-max (Play Money) Seat #9 is the button
Seat 1: manon327 (8027 in chips) 
Seat 2: HighCardJasper (21664 in chips) 
Seat 3: FantasticDouble (11320 in chips) 
Seat 6: color_singleton (14185 in chips) 
Seat 9: dhduncan (974 in chips) 
manon327: posts small blind 50
HighCardJasper: posts big blind 100
*** HOLE CARDS ***
Dealt to FantasticDouble [Ac 5s]
FantasticDouble has timed out
FantasticDouble: folds 
color_singleton: raises 200 to 300
dhduncan: calls 300
manon327: calls 250
HighCardJasper: calls 200
*** FLOP *** [2c 5c 3c]
manon327: checks 
HighCardJasper: checks 
color_singleton: bets 1134
dhduncan: folds 
manon327: folds 
HighCardJasper: folds 
Uncalled bet (1134) returned to color_singleton
color_singleton collected 1134 from pot
color_singleton: doesn't show hand 
*** SUMMARY ***
Total pot 1200 | Rake 66 
Board [2c 5c 3c]
Seat 1: manon327 (small blind) folded on the Flop
Seat 2: HighCardJasper (big blind) folded on the Flop
Seat 3: FantasticDouble folded before Flop (didn't bet)
Seat 6: color_singleton collected (1134)
Seat 9: dhduncan (button) folded on the Flop



PokerStars Home Game Hand #222894008893: {DaPokaStars}  Hold'em No Limit (50/100) - 2021/01/21 16:21:46 ET
Table 'testnsdfgh' 9-max (Play Money) Seat #1 is the button
Seat 1: manon327 (7727 in chips) 
Seat 2: HighCardJasper (21364 in chips) 
Seat 3: FantasticDouble (11320 in chips) 
Seat 6: color_singleton (15019 in chips) 
Seat 9: dhduncan (674 in chips) 
HighCardJasper: posts small blind 50
FantasticDouble: posts big blind 100
*** HOLE CARDS ***
Dealt to FantasticDouble [Jc 5h]
color_singleton: folds 
dhduncan: calls 100
manon327: folds 
HighCardJasper: calls 50
FantasticDouble: checks 
*** FLOP *** [7d Qc Ac]
HighCardJasper: bets 100
FantasticDouble: folds 
dhduncan: folds 
Uncalled bet (100) returned to HighCardJasper
HighCardJasper collected 283 from pot
HighCardJasper: doesn't show hand 
*** SUMMARY ***
Total pot 300 | Rake 17 
Board [7d Qc Ac]
Seat 1: manon327 (button) folded before Flop (didn't bet)
Seat 2: HighCardJasper (small blind) collected (283)
Seat 3: FantasticDouble (big blind) folded on the Flop
Seat 6: color_singleton folded before Flop (didn't bet)
Seat 9: dhduncan folded on the Flop



PokerStars Home Game Hand #222894027758: {DaPokaStars}  Hold'em No Limit (50/100) - 2021/01/21 16:22:12 ET
Table 'testnsdfgh' 9-max (Play Money) Seat #2 is the button
Seat 1: manon327 (7727 in chips) 
Seat 2: HighCardJasper (21547 in chips) 
Seat 3: FantasticDouble (11220 in chips) 
Seat 6: color_singleton (15019 in chips) 
Seat 8: poorrick1338 (6335 in chips) 
Seat 9: dhduncan (574 in chips) 
FantasticDouble: posts small blind 50
color_singleton: posts big blind 100
*** HOLE CARDS ***
Dealt to FantasticDouble [3h Qh]
poorrick1338: folds 
dhduncan: calls 100
manon327: folds 
HighCardJasper: calls 100
FantasticDouble: calls 50
color_singleton: raises 200 to 300
dhduncan: folds 
HighCardJasper: calls 200
FantasticDouble: calls 200
*** FLOP *** [Kh 6d 3s]
FantasticDouble has timed out
FantasticDouble: checks 
color_singleton: bets 945
HighCardJasper: folds 
FantasticDouble: folds 
Uncalled bet (945) returned to color_singleton
color_singleton collected 945 from pot
color_singleton: doesn't show hand 
*** SUMMARY ***
Total pot 1000 | Rake 55 
Board [Kh 6d 3s]
Seat 1: manon327 folded before Flop (didn't bet)
Seat 2: HighCardJasper (button) folded on the Flop
Seat 3: FantasticDouble (small blind) folded on the Flop
Seat 6: color_singleton (big blind) collected (945)
Seat 8: poorrick1338 folded before Flop (didn't bet)
Seat 9: dhduncan folded before Flop



PokerStars Home Game Hand #222894060644: {DaPokaStars}  Hold'em No Limit (50/100) - 2021/01/21 16:22:57 ET
Table 'testnsdfgh' 9-max (Play Money) Seat #3 is the button
Seat 1: manon327 (7727 in chips) 
Seat 2: HighCardJasper (21247 in chips) 
Seat 3: FantasticDouble (10920 in chips) 
Seat 6: color_singleton (15664 in chips) 
Seat 8: poorrick1338 (6335 in chips) 
Seat 9: dhduncan (474 in chips) 
color_singleton: posts small blind 50
poorrick1338: posts big blind 100
*** HOLE CARDS ***
Dealt to FantasticDouble [9d 9c]
dhduncan: raises 374 to 474 and is all-in
manon327: folds 
HighCardJasper: folds 
FantasticDouble: raises 526 to 1000
color_singleton: folds 
poorrick1338: calls 900
*** FLOP *** [Th Kc 5d]
poorrick1338: checks 
FantasticDouble: bets 800
poorrick1338: calls 800
*** TURN *** [Th Kc 5d] [Qh]
poorrick1338: bets 600
FantasticDouble: calls 600
*** RIVER *** [Th Kc 5d Qh] [7s]
poorrick1338: checks 
FantasticDouble: checks 
*** SHOW DOWN ***
poorrick1338: shows [Qs As] (a pair of Queens)
FantasticDouble: mucks hand 
poorrick1338 collected 3640 from side pot
dhduncan: shows [Kh 6d] (a pair of Kings)
dhduncan collected 1391 from main pot
*** SUMMARY ***
Total pot 5324 Main pot 1391. Side pot 3640. | Rake 293 
Board [Th Kc 5d Qh 7s]
Seat 1: manon327 folded before Flop (didn't bet)
Seat 2: HighCardJasper folded before Flop (didn't bet)
Seat 3: FantasticDouble (button) mucked [9d 9c]
Seat 6: color_singleton (small blind) folded before Flop
Seat 8: poorrick1338 (big blind) showed [Qs As] and won (3640) with a pair of Queens
Seat 9: dhduncan showed [Kh 6d] and won (1391) with a pair of Kings



PokerStars Home Game Hand #222894113394: {DaPokaStars}  Hold'em No Limit (50/100) - 2021/01/21 16:24:09 ET
Table 'testnsdfgh' 9-max (Play Money) Seat #6 is the button
Seat 1: manon327 (7727 in chips) 
Seat 2: HighCardJasper (21247 in chips) 
Seat 3: FantasticDouble (8520 in chips) 
Seat 6: color_singleton (15614 in chips) 
Seat 8: poorrick1338 (7575 in chips) 
Seat 9: dhduncan (1391 in chips) 
poorrick1338: posts small blind 50
dhduncan: posts big blind 100
*** HOLE CARDS ***
Dealt to FantasticDouble [8c 6d]
manon327: folds 
HighCardJasper: folds 
FantasticDouble: folds 
color_singleton: calls 100
poorrick1338: calls 50
dhduncan: checks 
*** FLOP *** [6s 9c Jc]
poorrick1338: bets 100
dhduncan: folds 
color_singleton: folds 
Uncalled bet (100) returned to poorrick1338
poorrick1338 collected 283 from pot
poorrick1338: doesn't show hand 
*** SUMMARY ***
Total pot 300 | Rake 17 
Board [6s 9c Jc]
Seat 1: manon327 folded before Flop (didn't bet)
Seat 2: HighCardJasper folded before Flop (didn't bet)
Seat 3: FantasticDouble folded before Flop (didn't bet)
Seat 6: color_singleton (button) folded on the Flop
Seat 8: poorrick1338 (small blind) collected (283)
Seat 9: dhduncan (big blind) folded on the Flop



PokerStars Home Game Hand #222894154205: {DaPokaStars}  Hold'em No Limit (50/100) - 2021/01/21 16:25:04 ET
Table 'testnsdfgh' 9-max (Play Money) Seat #8 is the button
Seat 1: manon327 (7727 in chips) 
Seat 2: HighCardJasper (21247 in chips) 
Seat 3: FantasticDouble (8520 in chips) 
Seat 6: color_singleton (15514 in chips) 
Seat 8: poorrick1338 (7758 in chips) 
manon327: posts small blind 50
HighCardJasper: posts big blind 100
*** HOLE CARDS ***
Dealt to FantasticDouble [7h 4c]
FantasticDouble: folds 
color_singleton: raises 100 to 200
poorrick1338: raises 100 to 300
manon327: folds 
HighCardJasper: folds 
color_singleton: calls 100
*** FLOP *** [4h Kd Js]
color_singleton: bets 400
poorrick1338: calls 400
*** TURN *** [4h Kd Js] [Ah]
color_singleton: bets 732
poorrick1338: calls 732
*** RIVER *** [4h Kd Js Ah] [Ac]
color_singleton: checks 
poorrick1338: bets 1424
color_singleton: folds 
Uncalled bet (1424) returned to poorrick1338
poorrick1338 collected 2848 from pot
poorrick1338: doesn't show hand 
*** SUMMARY ***
Total pot 3014 | Rake 166 
Board [4h Kd Js Ah Ac]
Seat 1: manon327 (small blind) folded before Flop
Seat 2: HighCardJasper (big blind) folded before Flop
Seat 3: FantasticDouble folded before Flop (didn't bet)
Seat 6: color_singleton folded on the River
Seat 8: poorrick1338 (button) collected (2848)



PokerStars Home Game Hand #222894196202: {DaPokaStars}  Hold'em No Limit (50/100) - 2021/01/21 16:26:02 ET
Table 'testnsdfgh' 9-max (Play Money) Seat #1 is the button
Seat 1: manon327 (7677 in chips) 
Seat 2: HighCardJasper (21147 in chips) 
Seat 3: FantasticDouble (8520 in chips) 
Seat 6: color_singleton (14082 in chips) 
Seat 8: poorrick1338 (9174 in chips) 
HighCardJasper: posts small blind 50
FantasticDouble: posts big blind 100
*** HOLE CARDS ***
Dealt to FantasticDouble [Qh Ac]
color_singleton: raises 200 to 300
poorrick1338: calls 300
manon327: folds 
HighCardJasper: folds 
FantasticDouble: calls 200
*** FLOP *** [7s 5s 4c]
FantasticDouble: checks 
color_singleton: checks 
poorrick1338: bets 100
FantasticDouble: calls 100
color_singleton: calls 100
*** TURN *** [7s 5s 4c] [Qc]
FantasticDouble: bets 700
color_singleton: calls 700
poorrick1338: calls 700
*** RIVER *** [7s 5s 4c Qc] [2c]
FantasticDouble: checks 
color_singleton: checks 
poorrick1338: checks 
*** SHOW DOWN ***
FantasticDouble: shows [Qh Ac] (a pair of Queens)
color_singleton: mucks hand 
poorrick1338: mucks hand 
FantasticDouble collected 3166 from pot
*** SUMMARY ***
Total pot 3350 | Rake 184 
Board [7s 5s 4c Qc 2c]
Seat 1: manon327 (button) folded before Flop (didn't bet)
Seat 2: HighCardJasper (small blind) folded before Flop
Seat 3: FantasticDouble (big blind) showed [Qh Ac] and won (3166) with a pair of Queens
Seat 6: color_singleton mucked [Qd Ks]
Seat 8: poorrick1338 mucked [Jd 7d]



PokerStars Home Game Hand #222894234830: {DaPokaStars}  Hold'em No Limit (50/100) - 2021/01/21 16:26:54 ET
Table 'testnsdfgh' 9-max (Play Money) Seat #2 is the button
Seat 1: manon327 (7677 in chips) 
Seat 2: HighCardJasper (21097 in chips) 
Seat 3: FantasticDouble (10586 in chips) 
Seat 6: color_singleton (12982 in chips) 
Seat 8: poorrick1338 (8074 in chips) 
Seat 9: dhduncan (1291 in chips) 
FantasticDouble: posts small blind 50
color_singleton: posts big blind 100
dhduncan: posts small blind 50
*** HOLE CARDS ***
Dealt to FantasticDouble [9h 2h]
poorrick1338: calls 100
dhduncan: folds 
manon327: folds 
HighCardJasper: folds 
FantasticDouble: folds 
color_singleton: raises 100 to 200
poorrick1338: calls 100
*** FLOP *** [7d 2c Td]
color_singleton: bets 236
poorrick1338: folds 
Uncalled bet (236) returned to color_singleton
color_singleton collected 472 from pot
color_singleton: doesn't show hand 
*** SUMMARY ***
Total pot 500 | Rake 28 
Board [7d 2c Td]
Seat 1: manon327 folded before Flop (didn't bet)
Seat 2: HighCardJasper (button) folded before Flop (didn't bet)
Seat 3: FantasticDouble (small blind) folded before Flop
Seat 6: color_singleton (big blind) collected (472)
Seat 8: poorrick1338 folded on the Flop
Seat 9: dhduncan folded before Flop (didn't bet)



PokerStars Home Game Hand #222894266644: {DaPokaStars}  Hold'em No Limit (50/100) - 2021/01/21 16:27:38 ET
Table 'testnsdfgh' 9-max (Play Money) Seat #3 is the button
Seat 1: manon327 (7677 in chips) 
Seat 2: HighCardJasper (21097 in chips) 
Seat 3: FantasticDouble (10536 in chips) 
Seat 6: color_singleton (13254 in chips) 
Seat 8: poorrick1338 (7874 in chips) 
Seat 9: dhduncan (1241 in chips) 
color_singleton: posts small blind 50
poorrick1338: posts big blind 100
*** HOLE CARDS ***
Dealt to FantasticDouble [3s 3h]
dhduncan: calls 100
manon327: folds 
HighCardJasper: raises 200 to 300
FantasticDouble: calls 300
color_singleton: folds 
poorrick1338: folds 
dhduncan: calls 200
*** FLOP *** [9d Ac Qd]
dhduncan: bets 941 and is all-in
HighCardJasper: folds 
FantasticDouble: folds 
Uncalled bet (941) returned to dhduncan
dhduncan collected 992 from pot
dhduncan: doesn't show hand 
*** SUMMARY ***
Total pot 1050 | Rake 58 
Board [9d Ac Qd]
Seat 1: manon327 folded before Flop (didn't bet)
Seat 2: HighCardJasper folded on the Flop
Seat 3: FantasticDouble (button) folded on the Flop
Seat 6: color_singleton (small blind) folded before Flop
Seat 8: poorrick1338 (big blind) folded before Flop
Seat 9: dhduncan collected (992)



PokerStars Home Game Hand #222894291492: {DaPokaStars}  Hold'em No Limit (50/100) - 2021/01/21 16:28:12 ET
Table 'testnsdfgh' 9-max (Play Money) Seat #6 is the button
Seat 1: manon327 (7677 in chips) 
Seat 2: HighCardJasper (20797 in chips) 
Seat 3: FantasticDouble (10236 in chips) 
Seat 6: color_singleton (13204 in chips) 
Seat 8: poorrick1338 (7774 in chips) 
Seat 9: dhduncan (1933 in chips) 
poorrick1338: posts small blind 50
dhduncan: posts big blind 100
*** HOLE CARDS ***
Dealt to FantasticDouble [8d 6c]
manon327: calls 100
HighCardJasper: folds 
FantasticDouble: folds 
color_singleton: raises 200 to 300
poorrick1338: folds 
dhduncan: folds 
manon327: folds 
Uncalled bet (200) returned to color_singleton
color_singleton collected 350 from pot
color_singleton: doesn't show hand 
*** SUMMARY ***
Total pot 350 | Rake 0 
Seat 1: manon327 folded before Flop
Seat 2: HighCardJasper folded before Flop (didn't bet)
Seat 3: FantasticDouble folded before Flop (didn't bet)
Seat 6: color_singleton (button) collected (350)
Seat 8: poorrick1338 (small blind) folded before Flop
Seat 9: dhduncan (big blind) folded before Flop



PokerStars Home Game Hand #222894310273: {DaPokaStars}  Hold'em No Limit (50/100) - 2021/01/21 16:28:38 ET
Table 'testnsdfgh' 9-max (Play Money) Seat #8 is the button
Seat 1: manon327 (7577 in chips) 
Seat 2: HighCardJasper (20797 in chips) 
Seat 3: FantasticDouble (10236 in chips) 
Seat 6: color_singleton (13454 in chips) 
Seat 8: poorrick1338 (7724 in chips) 
Seat 9: dhduncan (1833 in chips) 
dhduncan: posts small blind 50
manon327: posts big blind 100
*** HOLE CARDS ***
Dealt to FantasticDouble [Js Jh]
HighCardJasper: folds 
FantasticDouble: raises 300 to 400
color_singleton: calls 400
poorrick1338: folds 
dhduncan: folds 
manon327: calls 300
*** FLOP *** [2s Ks Ad]
manon327: checks 
FantasticDouble: checks 
color_singleton: checks 
*** TURN *** [2s Ks Ad] [5s]
manon327: checks 
FantasticDouble: bets 600
color_singleton: calls 600
manon327: folds 
*** RIVER *** [2s Ks Ad 5s] [7s]
FantasticDouble: bets 1000
color_singleton: raises 1000 to 2000
FantasticDouble: calls 1000
*** SHOW DOWN ***
color_singleton: shows [As 4s] (a flush, Ace high)
FantasticDouble: mucks hand 
color_singleton collected 6095 from pot
*** SUMMARY ***
Total pot 6450 | Rake 355 
Board [2s Ks Ad 5s 7s]
Seat 1: manon327 (big blind) folded on the Turn
Seat 2: HighCardJasper folded before Flop (didn't bet)
Seat 3: FantasticDouble mucked [Js Jh]
Seat 6: color_singleton showed [As 4s] and won (6095) with a flush, Ace high
Seat 8: poorrick1338 (button) folded before Flop (didn't bet)
Seat 9: dhduncan (small blind) folded before Flop



PokerStars Home Game Hand #222894353386: {DaPokaStars}  Hold'em No Limit (50/100) - 2021/01/21 16:29:37 ET
Table 'testnsdfgh' 9-max (Play Money) Seat #9 is the button
Seat 1: manon327 (7177 in chips) 
Seat 2: HighCardJasper (20797 in chips) 
Seat 3: FantasticDouble (7236 in chips) 
Seat 6: color_singleton (16549 in chips) 
Seat 8: poorrick1338 (7724 in chips) 
Seat 9: dhduncan (1783 in chips) 
manon327: posts small blind 50
HighCardJasper: posts big blind 100
*** HOLE CARDS ***
Dealt to FantasticDouble [As 3d]
FantasticDouble: folds 
color_singleton: folds 
poorrick1338: folds 
dhduncan: calls 100
manon327: folds 
HighCardJasper: checks 
*** FLOP *** [2s Ks 9c]
HighCardJasper: bets 100
dhduncan: calls 100
*** TURN *** [2s Ks 9c] [Ah]
HighCardJasper: bets 200
dhduncan: folds 
Uncalled bet (200) returned to HighCardJasper
HighCardJasper collected 425 from pot
HighCardJasper: doesn't show hand 
*** SUMMARY ***
Total pot 450 | Rake 25 
Board [2s Ks 9c Ah]
Seat 1: manon327 (small blind) folded before Flop
Seat 2: HighCardJasper (big blind) collected (425)
Seat 3: FantasticDouble folded before Flop (didn't bet)
Seat 6: color_singleton folded before Flop (didn't bet)
Seat 8: poorrick1338 folded before Flop (didn't bet)
Seat 9: dhduncan (button) folded on the Turn



PokerStars Home Game Hand #222894389369: {DaPokaStars}  Hold'em No Limit (50/100) - 2021/01/21 16:30:26 ET
Table 'testnsdfgh' 9-max (Play Money) Seat #1 is the button
Seat 1: manon327 (7127 in chips) 
Seat 2: HighCardJasper (21022 in chips) 
Seat 3: FantasticDouble (7236 in chips) 
Seat 6: color_singleton (16549 in chips) 
Seat 8: poorrick1338 (7724 in chips) 
Seat 9: dhduncan (1583 in chips) 
HighCardJasper: posts small blind 50
FantasticDouble: posts big blind 100
*** HOLE CARDS ***
Dealt to FantasticDouble [Jh 7s]
color_singleton: folds 
poorrick1338: calls 100
dhduncan: calls 100
manon327: folds 
HighCardJasper: calls 50
FantasticDouble: checks 
*** FLOP *** [Tc 6h 7c]
HighCardJasper: checks 
FantasticDouble: checks 
poorrick1338: checks 
dhduncan: checks 
*** TURN *** [Tc 6h 7c] [Jd]
HighCardJasper: checks 
FantasticDouble: bets 400
poorrick1338: folds 
dhduncan: folds 
HighCardJasper: folds 
Uncalled bet (400) returned to FantasticDouble
FantasticDouble collected 378 from pot
*** SUMMARY ***
Total pot 400 | Rake 22 
Board [Tc 6h 7c Jd]
Seat 1: manon327 (button) folded before Flop (didn't bet)
Seat 2: HighCardJasper (small blind) folded on the Turn
Seat 3: FantasticDouble (big blind) collected (378)
Seat 6: color_singleton folded before Flop (didn't bet)
Seat 8: poorrick1338 folded on the Turn
Seat 9: dhduncan folded on the Turn



PokerStars Home Game Hand #222894426790: {DaPokaStars}  Hold'em No Limit (50/100) - 2021/01/21 16:31:18 ET
Table 'testnsdfgh' 9-max (Play Money) Seat #2 is the button
Seat 1: manon327 (7127 in chips) 
Seat 2: HighCardJasper (20922 in chips) 
Seat 3: FantasticDouble (7514 in chips) 
Seat 6: color_singleton (16549 in chips) 
Seat 8: poorrick1338 (7624 in chips) 
Seat 9: dhduncan (1483 in chips) 
FantasticDouble: posts small blind 50
color_singleton: posts big blind 100
*** HOLE CARDS ***
Dealt to FantasticDouble [Td 9s]
poorrick1338: folds 
dhduncan: folds 
manon327: folds 
HighCardJasper: folds 
FantasticDouble: calls 50
color_singleton: checks 
*** FLOP *** [2d Qc Js]
FantasticDouble: bets 200
color_singleton: folds 
Uncalled bet (200) returned to FantasticDouble
FantasticDouble collected 189 from pot
*** SUMMARY ***
Total pot 200 | Rake 11 
Board [2d Qc Js]
Seat 1: manon327 folded before Flop (didn't bet)
Seat 2: HighCardJasper (button) folded before Flop (didn't bet)
Seat 3: FantasticDouble (small blind) collected (189)
Seat 6: color_singleton (big blind) folded on the Flop
Seat 8: poorrick1338 folded before Flop (didn't bet)
Seat 9: dhduncan folded before Flop (didn't bet)



PokerStars Home Game Hand #222894443283: {DaPokaStars}  Hold'em No Limit (50/100) - 2021/01/21 16:31:40 ET
Table 'testnsdfgh' 9-max (Play Money) Seat #3 is the button
Seat 1: manon327 (7127 in chips) 
Seat 2: HighCardJasper (20922 in chips) 
Seat 3: FantasticDouble (7603 in chips) 
Seat 6: color_singleton (16449 in chips) 
Seat 8: poorrick1338 (7624 in chips) 
Seat 9: dhduncan (1483 in chips) 
color_singleton: posts small blind 50
poorrick1338: posts big blind 100
*** HOLE CARDS ***
Dealt to FantasticDouble [8h 3h]
dhduncan: calls 100
manon327: calls 100
HighCardJasper: folds 
FantasticDouble: folds 
color_singleton: calls 50
poorrick1338: checks 
*** FLOP *** [8d 4h 7c]
color_singleton: bets 189
poorrick1338: calls 189
dhduncan: folds 
manon327: calls 189
*** TURN *** [8d 4h 7c] [6c]
color_singleton: checks 
poorrick1338: checks 
manon327: bets 914
color_singleton: calls 914
poorrick1338: folds 
*** RIVER *** [8d 4h 7c 6c] [Qc]
color_singleton: bets 1320
manon327: folds 
Uncalled bet (1320) returned to color_singleton
color_singleton collected 2641 from pot
color_singleton: doesn't show hand 
*** SUMMARY ***
Total pot 2795 | Rake 154 
Board [8d 4h 7c 6c Qc]
Seat 1: manon327 folded on the River
Seat 2: HighCardJasper folded before Flop (didn't bet)
Seat 3: FantasticDouble (button) folded before Flop (didn't bet)
Seat 6: color_singleton (small blind) collected (2641)
Seat 8: poorrick1338 (big blind) folded on the Turn
Seat 9: dhduncan folded on the Flop



PokerStars Home Game Hand #222894506387: {DaPokaStars}  Hold'em No Limit (50/100) - 2021/01/21 16:33:07 ET
Table 'testnsdfgh' 9-max (Play Money) Seat #6 is the button
Seat 1: manon327 (5924 in chips) 
Seat 2: HighCardJasper (20922 in chips) 
Seat 3: FantasticDouble (7603 in chips) 
Seat 6: color_singleton (17887 in chips) 
Seat 8: poorrick1338 (7335 in chips) 
Seat 9: dhduncan (1383 in chips) 
poorrick1338: posts small blind 50
dhduncan: posts big blind 100
*** HOLE CARDS ***
Dealt to FantasticDouble [8s Th]
manon327: folds 
HighCardJasper: calls 100
FantasticDouble has timed out
FantasticDouble: folds 
color_singleton: calls 100
poorrick1338: calls 50
dhduncan: checks 
*** FLOP *** [4h 9d 4s]
poorrick1338: checks 
dhduncan: checks 
HighCardJasper: checks 
color_singleton: checks 
*** TURN *** [4h 9d 4s] [6d]
poorrick1338: checks 
dhduncan: checks 
HighCardJasper: checks 
color_singleton: checks 
*** RIVER *** [4h 9d 4s 6d] [Jh]
poorrick1338: checks 
dhduncan: checks 
HighCardJasper: bets 200
color_singleton: folds 
poorrick1338: folds 
dhduncan: folds 
Uncalled bet (200) returned to HighCardJasper
HighCardJasper collected 378 from pot
HighCardJasper: doesn't show hand 
*** SUMMARY ***
Total pot 400 | Rake 22 
Board [4h 9d 4s 6d Jh]
Seat 1: manon327 folded before Flop (didn't bet)
Seat 2: HighCardJasper collected (378)
Seat 3: FantasticDouble folded before Flop (didn't bet)
Seat 6: color_singleton (button) folded on the River
Seat 8: poorrick1338 (small blind) folded on the River
Seat 9: dhduncan (big blind) folded on the River



PokerStars Home Game Hand #222894577177: {DaPokaStars}  Hold'em No Limit (50/100) - 2021/01/21 16:34:46 ET
Table 'testnsdfgh' 9-max (Play Money) Seat #8 is the button
Seat 1: manon327 (5924 in chips) 
Seat 2: HighCardJasper (21200 in chips) 
Seat 3: FantasticDouble (7603 in chips) 
Seat 6: color_singleton (17787 in chips) 
Seat 8: poorrick1338 (7235 in chips) 
Seat 9: dhduncan (1283 in chips) 
dhduncan: posts small blind 50
manon327: posts big blind 100
*** HOLE CARDS ***
Dealt to FantasticDouble [Qd Th]
HighCardJasper: folds 
FantasticDouble: raises 200 to 300
color_singleton: calls 300
poorrick1338: folds 
dhduncan: folds 
manon327: calls 200
*** FLOP *** [3h 7h 2h]
manon327: checks 
FantasticDouble: bets 500
color_singleton: calls 500
manon327: folds 
*** TURN *** [3h 7h 2h] [6c]
FantasticDouble: checks 
color_singleton: bets 921
FantasticDouble: folds 
Uncalled bet (921) returned to color_singleton
color_singleton collected 1843 from pot
color_singleton: doesn't show hand 
*** SUMMARY ***
Total pot 1950 | Rake 107 
Board [3h 7h 2h 6c]
Seat 1: manon327 (big blind) folded on the Flop
Seat 2: HighCardJasper folded before Flop (didn't bet)
Seat 3: FantasticDouble folded on the Turn
Seat 6: color_singleton collected (1843)
Seat 8: poorrick1338 (button) folded before Flop (didn't bet)
Seat 9: dhduncan (small blind) folded before Flop



PokerStars Home Game Hand #222894620102: {DaPokaStars}  Hold'em No Limit (50/100) - 2021/01/21 16:35:46 ET
Table 'testnsdfgh' 9-max (Play Money) Seat #9 is the button
Seat 1: manon327 (5624 in chips) 
Seat 2: HighCardJasper (21200 in chips) 
Seat 3: FantasticDouble (6803 in chips) 
Seat 6: color_singleton (18830 in chips) 
Seat 8: poorrick1338 (7235 in chips) 
Seat 9: dhduncan (1233 in chips) 
manon327: posts small blind 50
HighCardJasper: posts big blind 100
*** HOLE CARDS ***
Dealt to FantasticDouble [2d 6d]
FantasticDouble: calls 100
color_singleton: folds 
poorrick1338: folds 
dhduncan: folds 
manon327: calls 50
HighCardJasper: checks 
*** FLOP *** [Ts 8d 8c]
manon327: bets 100
HighCardJasper: calls 100
FantasticDouble: folds 
*** TURN *** [Ts 8d 8c] [9d]
manon327: bets 472
HighCardJasper: calls 472
*** RIVER *** [Ts 8d 8c 9d] [9s]
manon327: checks 
HighCardJasper: bets 700
manon327: calls 700
*** SHOW DOWN ***
HighCardJasper: shows [3d 8h] (a full house, Eights full of Nines)
manon327: mucks hand 
HighCardJasper collected 2688 from pot
*** SUMMARY ***
Total pot 2844 | Rake 156 
Board [Ts 8d 8c 9d 9s]
Seat 1: manon327 (small blind) mucked [7h Th]
Seat 2: HighCardJasper (big blind) showed [3d 8h] and won (2688) with a full house, Eights full of Nines
Seat 3: FantasticDouble folded on the Flop
Seat 6: color_singleton folded before Flop (didn't bet)
Seat 8: poorrick1338 folded before Flop (didn't bet)
Seat 9: dhduncan (button) folded before Flop (didn't bet)



PokerStars Home Game Hand #222894659389: {DaPokaStars}  Hold'em No Limit (50/100) - 2021/01/21 16:36:41 ET
Table 'testnsdfgh' 9-max (Play Money) Seat #1 is the button
Seat 1: manon327 (4252 in chips) 
Seat 2: HighCardJasper (22516 in chips) 
Seat 3: FantasticDouble (6703 in chips) 
Seat 6: color_singleton (18830 in chips) 
Seat 8: poorrick1338 (7235 in chips) 
Seat 9: dhduncan (1233 in chips) 
HighCardJasper: posts small blind 50
FantasticDouble: posts big blind 100
*** HOLE CARDS ***
Dealt to FantasticDouble [6c Kh]
color_singleton: folds 
poorrick1338: calls 100
dhduncan: folds 
manon327: calls 100
HighCardJasper: raises 100 to 200
FantasticDouble: calls 100
poorrick1338: calls 100
manon327: calls 100
*** FLOP *** [6h 9h 2d]
HighCardJasper: checks 
FantasticDouble: bets 300
poorrick1338: calls 300
manon327: calls 300
HighCardJasper: folds 
*** TURN *** [6h 9h 2d] [6d]
FantasticDouble: bets 900
poorrick1338: calls 900
manon327: folds 
*** RIVER *** [6h 9h 2d 6d] [Ts]
FantasticDouble: bets 2700
poorrick1338: calls 2700
*** SHOW DOWN ***
FantasticDouble: shows [6c Kh] (three of a kind, Sixes)
poorrick1338: mucks hand 
FantasticDouble collected 8410 from pot
*** SUMMARY ***
Total pot 8900 | Rake 490 
Board [6h 9h 2d 6d Ts]
Seat 1: manon327 (button) folded on the Turn
Seat 2: HighCardJasper (small blind) folded on the Flop
Seat 3: FantasticDouble (big blind) showed [6c Kh] and won (8410) with three of a kind, Sixes
Seat 6: color_singleton folded before Flop (didn't bet)
Seat 8: poorrick1338 mucked [Qc 2c]
Seat 9: dhduncan folded before Flop (didn't bet)



PokerStars Home Game Hand #222894697622: {DaPokaStars}  Hold'em No Limit (50/100) - 2021/01/21 16:37:34 ET
Table 'testnsdfgh' 9-max (Play Money) Seat #2 is the button
Seat 1: manon327 (3752 in chips) 
Seat 2: HighCardJasper (22316 in chips) 
Seat 3: FantasticDouble (11013 in chips) 
Seat 6: color_singleton (18830 in chips) 
Seat 8: poorrick1338 (3135 in chips) 
Seat 9: dhduncan (1233 in chips) 
FantasticDouble: posts small blind 50
color_singleton: posts big blind 100
*** HOLE CARDS ***
Dealt to FantasticDouble [Ac 4d]
poorrick1338: calls 100
dhduncan: calls 100
manon327: calls 100
HighCardJasper: calls 100
FantasticDouble: calls 50
color_singleton: checks 
*** FLOP *** [4h 5c 8h]
FantasticDouble: bets 300
color_singleton: folds 
poorrick1338: folds 
dhduncan: folds 
manon327: folds 
HighCardJasper: calls 300
*** TURN *** [4h 5c 8h] [As]
FantasticDouble: bets 800
HighCardJasper: calls 800
*** RIVER *** [4h 5c 8h As] [5h]
FantasticDouble: checks 
HighCardJasper: bets 1000
FantasticDouble: calls 1000
*** SHOW DOWN ***
HighCardJasper: shows [Kh 9h] (a flush, King high)
FantasticDouble: mucks hand 
HighCardJasper collected 4536 from pot
*** SUMMARY ***
Total pot 4800 | Rake 264 
Board [4h 5c 8h As 5h]
Seat 1: manon327 folded on the Flop
Seat 2: HighCardJasper (button) showed [Kh 9h] and won (4536) with a flush, King high
Seat 3: FantasticDouble (small blind) mucked [Ac 4d]
Seat 6: color_singleton (big blind) folded on the Flop
Seat 8: poorrick1338 folded on the Flop
Seat 9: dhduncan folded on the Flop



PokerStars Home Game Hand #222894766081: {DaPokaStars}  Hold'em No Limit (50/100) - 2021/01/21 16:38:57 ET
Table 'testnsdfgh' 9-max (Play Money) Seat #3 is the button
Seat 1: manon327 (3652 in chips) 
Seat 2: HighCardJasper (24652 in chips) 
Seat 3: FantasticDouble (8813 in chips) 
Seat 6: color_singleton (18730 in chips) 
Seat 8: poorrick1338 (3035 in chips) 
Seat 9: dhduncan (1133 in chips) 
color_singleton: posts small blind 50
poorrick1338: posts big blind 100
*** HOLE CARDS ***
Dealt to FantasticDouble [4s Ac]
dhduncan: calls 100
manon327: folds 
HighCardJasper: calls 100
FantasticDouble: raises 400 to 500
color_singleton: calls 450
poorrick1338: calls 400
dhduncan: calls 400
HighCardJasper: folds 
*** FLOP *** [4c 5h Tc]
color_singleton: checks 
poorrick1338: checks 
dhduncan: checks 
FantasticDouble: checks 
*** TURN *** [4c 5h Tc] [7s]
color_singleton: bets 992
poorrick1338: folds 
dhduncan: calls 633 and is all-in
FantasticDouble: folds 
Uncalled bet (359) returned to color_singleton
*** RIVER *** [4c 5h Tc 7s] [5d]
*** SHOW DOWN ***
color_singleton: shows [7h Ad] (two pair, Sevens and Fives)
dhduncan: shows [Jc Kd] (a pair of Fives)
color_singleton collected 3181 from pot
*** SUMMARY ***
Total pot 3366 | Rake 185 
Board [4c 5h Tc 7s 5d]
Seat 1: manon327 folded before Flop (didn't bet)
Seat 2: HighCardJasper folded before Flop
Seat 3: FantasticDouble (button) folded on the Turn
Seat 6: color_singleton (small blind) showed [7h Ad] and won (3181) with two pair, Sevens and Fives
Seat 8: poorrick1338 (big blind) folded on the Turn
Seat 9: dhduncan showed [Jc Kd] and lost with a pair of Fives



PokerStars Home Game Hand #222894807334: {DaPokaStars}  Hold'em No Limit (50/100) - 2021/01/21 16:39:55 ET
Table 'testnsdfgh' 9-max (Play Money) Seat #6 is the button
Seat 1: manon327 (3652 in chips) 
Seat 2: HighCardJasper (24552 in chips) 
Seat 3: FantasticDouble (8313 in chips) 
Seat 6: color_singleton (20778 in chips) 
Seat 8: poorrick1338 (2535 in chips) 
poorrick1338: posts small blind 50
manon327: posts big blind 100
*** HOLE CARDS ***
Dealt to FantasticDouble [3d Qd]
HighCardJasper: calls 100
FantasticDouble: calls 100
color_singleton: calls 100
poorrick1338 has timed out
poorrick1338: folds 
manon327: checks 
*** FLOP *** [Th As Kc]
manon327: bets 212
HighCardJasper: calls 212
FantasticDouble: folds 
color_singleton: calls 212
*** TURN *** [Th As Kc] [Ac]
manon327: bets 1026
HighCardJasper: folds 
color_singleton: folds 
Uncalled bet (1026) returned to manon327
manon327 collected 1026 from pot
*** SUMMARY ***
Total pot 1086 | Rake 60 
Board [Th As Kc Ac]
Seat 1: manon327 (big blind) collected (1026)
Seat 2: HighCardJasper folded on the Turn
Seat 3: FantasticDouble folded on the Flop
Seat 6: color_singleton (button) folded on the Turn
Seat 8: poorrick1338 (small blind) folded before Flop



PokerStars Home Game Hand #222894847437: {DaPokaStars}  Hold'em No Limit (50/100) - 2021/01/21 16:40:52 ET
Table 'testnsdfgh' 9-max (Play Money) Seat #1 is the button
Seat 1: manon327 (4366 in chips) 
Seat 2: HighCardJasper (24240 in chips) 
Seat 3: FantasticDouble (8213 in chips) 
Seat 6: color_singleton (20466 in chips) 
Seat 9: dhduncan (10000 in chips) 
HighCardJasper: posts small blind 50
FantasticDouble: posts big blind 100
dhduncan: posts big blind 100
*** HOLE CARDS ***
Dealt to FantasticDouble [4s 2s]
color_singleton: folds 
dhduncan: checks 
manon327: calls 100
HighCardJasper: calls 50
FantasticDouble: checks 
*** FLOP *** [Kh 2d Kd]
HighCardJasper: checks 
FantasticDouble: checks 
dhduncan: checks 
manon327: checks 
*** TURN *** [Kh 2d Kd] [4c]
HighCardJasper: checks 
FantasticDouble: bets 200
dhduncan: folds 
manon327: folds 
HighCardJasper: folds 
Uncalled bet (200) returned to FantasticDouble
FantasticDouble collected 378 from pot
*** SUMMARY ***
Total pot 400 | Rake 22 
Board [Kh 2d Kd 4c]
Seat 1: manon327 (button) folded on the Turn
Seat 2: HighCardJasper (small blind) folded on the Turn
Seat 3: FantasticDouble (big blind) collected (378)
Seat 6: color_singleton folded before Flop (didn't bet)
Seat 9: dhduncan folded on the Turn (didn't bet)



PokerStars Home Game Hand #222894877722: {DaPokaStars}  Hold'em No Limit (50/100) - 2021/01/21 16:41:35 ET
Table 'testnsdfgh' 9-max (Play Money) Seat #2 is the button
Seat 1: manon327 (4266 in chips) 
Seat 2: HighCardJasper (24140 in chips) 
Seat 3: FantasticDouble (8491 in chips) 
Seat 6: color_singleton (20466 in chips) 
Seat 9: dhduncan (9900 in chips) 
FantasticDouble: posts small blind 50
color_singleton: posts big blind 100
*** HOLE CARDS ***
Dealt to FantasticDouble [Qd 7s]
dhduncan: folds 
manon327: calls 100
HighCardJasper: folds 
FantasticDouble: calls 50
color_singleton: raises 100 to 200
manon327: calls 100
FantasticDouble: calls 100
*** FLOP *** [2s 9c 9h]
FantasticDouble: checks 
color_singleton: bets 567
manon327: folds 
FantasticDouble: folds 
Uncalled bet (567) returned to color_singleton
color_singleton collected 567 from pot
color_singleton: doesn't show hand 
*** SUMMARY ***
Total pot 600 | Rake 33 
Board [2s 9c 9h]
Seat 1: manon327 folded on the Flop
Seat 2: HighCardJasper (button) folded before Flop (didn't bet)
Seat 3: FantasticDouble (small blind) folded on the Flop
Seat 6: color_singleton (big blind) collected (567)
Seat 9: dhduncan folded before Flop (didn't bet)



PokerStars Home Game Hand #222894900646: {DaPokaStars}  Hold'em No Limit (50/100) - 2021/01/21 16:42:08 ET
Table 'testnsdfgh' 9-max (Play Money) Seat #3 is the button
Seat 1: manon327 (4066 in chips) 
Seat 2: HighCardJasper (24140 in chips) 
Seat 3: FantasticDouble (8291 in chips) 
Seat 6: color_singleton (20833 in chips) 
Seat 9: dhduncan (9900 in chips) 
color_singleton: posts small blind 50
dhduncan: posts big blind 100
*** HOLE CARDS ***
Dealt to FantasticDouble [Kd Kc]
manon327: folds 
HighCardJasper: calls 100
FantasticDouble: raises 400 to 500
color_singleton: folds 
dhduncan: folds 
HighCardJasper: calls 400
*** FLOP *** [4s 3d 5h]
HighCardJasper: checks 
FantasticDouble: bets 700
HighCardJasper: calls 700
*** TURN *** [4s 3d 5h] [5c]
HighCardJasper: checks 
FantasticDouble: checks 
*** RIVER *** [4s 3d 5h 5c] [Th]
HighCardJasper: checks 
FantasticDouble: bets 1000
HighCardJasper: folds 
Uncalled bet (1000) returned to FantasticDouble
FantasticDouble collected 2410 from pot
*** SUMMARY ***
Total pot 2550 | Rake 140 
Board [4s 3d 5h 5c Th]
Seat 1: manon327 folded before Flop (didn't bet)
Seat 2: HighCardJasper folded on the River
Seat 3: FantasticDouble (button) collected (2410)
Seat 6: color_singleton (small blind) folded before Flop
Seat 9: dhduncan (big blind) folded before Flop



PokerStars Home Game Hand #222894933633: {DaPokaStars}  Hold'em No Limit (50/100) - 2021/01/21 16:42:55 ET
Table 'testnsdfgh' 9-max (Play Money) Seat #6 is the button
Seat 1: manon327 (4066 in chips) 
Seat 2: HighCardJasper (22940 in chips) 
Seat 3: FantasticDouble (9501 in chips) 
Seat 6: color_singleton (20783 in chips) 
Seat 9: dhduncan (9800 in chips) 
dhduncan: posts small blind 50
manon327: posts big blind 100
*** HOLE CARDS ***
Dealt to FantasticDouble [Tc 3h]
HighCardJasper: raises 200 to 300
FantasticDouble: folds 
color_singleton: calls 300
dhduncan: folds 
manon327: folds 
*** FLOP *** [4h 9h 6d]
HighCardJasper: checks 
color_singleton: checks 
*** TURN *** [4h 9h 6d] [4c]
HighCardJasper: bets 200
color_singleton: calls 200
*** RIVER *** [4h 9h 6d 4c] [Ts]
HighCardJasper: checks 
color_singleton: checks 
*** SHOW DOWN ***
HighCardJasper: shows [Kc Jc] (a pair of Fours)
color_singleton: shows [8s As] (a pair of Fours - Ace kicker)
color_singleton collected 1087 from pot
*** SUMMARY ***
Total pot 1150 | Rake 63 
Board [4h 9h 6d 4c Ts]
Seat 1: manon327 (big blind) folded before Flop
Seat 2: HighCardJasper showed [Kc Jc] and lost with a pair of Fours
Seat 3: FantasticDouble folded before Flop (didn't bet)
Seat 6: color_singleton (button) showed [8s As] and won (1087) with a pair of Fours
Seat 9: dhduncan (small blind) folded before Flop



PokerStars Home Game Hand #222894956974: {DaPokaStars}  Hold'em No Limit (50/100) - 2021/01/21 16:43:28 ET
Table 'testnsdfgh' 9-max (Play Money) Seat #9 is the button
Seat 1: manon327 (3966 in chips) 
Seat 2: HighCardJasper (22440 in chips) 
Seat 3: FantasticDouble (9501 in chips) 
Seat 6: color_singleton (21370 in chips) 
Seat 9: dhduncan (9750 in chips) 
manon327: posts small blind 50
HighCardJasper: posts big blind 100
*** HOLE CARDS ***
Dealt to FantasticDouble [Jh Qd]
FantasticDouble: raises 300 to 400
color_singleton: calls 400
dhduncan: folds 
manon327: folds 
HighCardJasper: folds 
*** FLOP *** [Js Ac 4d]
FantasticDouble: checks 
color_singleton: checks 
*** TURN *** [Js Ac 4d] [9c]
FantasticDouble: bets 500
color_singleton: calls 500
*** RIVER *** [Js Ac 4d 9c] [Ad]
FantasticDouble: checks 
color_singleton: checks 
*** SHOW DOWN ***
FantasticDouble: shows [Jh Qd] (two pair, Aces and Jacks)
color_singleton: mucks hand 
FantasticDouble collected 1843 from pot
*** SUMMARY ***
Total pot 1950 | Rake 107 
Board [Js Ac 4d 9c Ad]
Seat 1: manon327 (small blind) folded before Flop
Seat 2: HighCardJasper (big blind) folded before Flop
Seat 3: FantasticDouble showed [Jh Qd] and won (1843) with two pair, Aces and Jacks
Seat 6: color_singleton mucked [Tc Ks]
Seat 9: dhduncan (button) folded before Flop (didn't bet)



PokerStars Home Game Hand #222894982076: {DaPokaStars}  Hold'em No Limit (50/100) - 2021/01/21 16:44:04 ET
Table 'testnsdfgh' 9-max (Play Money) Seat #1 is the button
Seat 1: manon327 (3916 in chips) 
Seat 2: HighCardJasper (22340 in chips) 
Seat 3: FantasticDouble (10444 in chips) 
Seat 6: color_singleton (20470 in chips) 
Seat 9: dhduncan (9750 in chips) 
HighCardJasper: posts small blind 50
FantasticDouble: posts big blind 100
*** HOLE CARDS ***
Dealt to FantasticDouble [6h Ks]
color_singleton: folds 
dhduncan: folds 
manon327: calls 100
HighCardJasper: folds 
FantasticDouble: checks 
*** FLOP *** [Tc Qc 8d]
FantasticDouble: checks 
manon327: bets 100
FantasticDouble: calls 100
*** TURN *** [Tc Qc 8d] [5c]
FantasticDouble: checks 
manon327: bets 200
FantasticDouble: folds 
Uncalled bet (200) returned to manon327
manon327 collected 425 from pot
*** SUMMARY ***
Total pot 450 | Rake 25 
Board [Tc Qc 8d 5c]
Seat 1: manon327 (button) collected (425)
Seat 2: HighCardJasper (small blind) folded before Flop
Seat 3: FantasticDouble (big blind) folded on the Turn
Seat 6: color_singleton folded before Flop (didn't bet)
Seat 9: dhduncan folded before Flop (didn't bet)



PokerStars Home Game Hand #222895012970: {DaPokaStars}  Hold'em No Limit (50/100) - 2021/01/21 16:44:49 ET
Table 'testnsdfgh' 9-max (Play Money) Seat #2 is the button
Seat 1: manon327 (4141 in chips) 
Seat 2: HighCardJasper (22290 in chips) 
Seat 3: FantasticDouble (10244 in chips) 
Seat 6: color_singleton (20470 in chips) 
Seat 9: dhduncan (9750 in chips) 
FantasticDouble: posts small blind 50
color_singleton: posts big blind 100
*** HOLE CARDS ***
Dealt to FantasticDouble [5s 4s]
dhduncan: raises 100 to 200
manon327: folds 
HighCardJasper: folds 
FantasticDouble: calls 150
color_singleton: calls 100
*** FLOP *** [8c 3h 4c]
FantasticDouble: bets 300
color_singleton: folds 
dhduncan: calls 300
*** TURN *** [8c 3h 4c] [Ad]
FantasticDouble: checks 
dhduncan: bets 1134
FantasticDouble: folds 
Uncalled bet (1134) returned to dhduncan
dhduncan collected 1134 from pot
dhduncan: doesn't show hand 
*** SUMMARY ***
Total pot 1200 | Rake 66 
Board [8c 3h 4c Ad]
Seat 1: manon327 folded before Flop (didn't bet)
Seat 2: HighCardJasper (button) folded before Flop (didn't bet)
Seat 3: FantasticDouble (small blind) folded on the Turn
Seat 6: color_singleton (big blind) folded on the Flop
Seat 9: dhduncan collected (1134)



PokerStars Home Game Hand #222895041917: {DaPokaStars}  Hold'em No Limit (50/100) - 2021/01/21 16:45:30 ET
Table 'testnsdfgh' 9-max (Play Money) Seat #3 is the button
Seat 1: manon327 (4141 in chips) 
Seat 2: HighCardJasper (22290 in chips) 
Seat 3: FantasticDouble (9744 in chips) 
Seat 6: color_singleton (20270 in chips) 
Seat 9: dhduncan (10384 in chips) 
color_singleton: posts small blind 50
dhduncan: posts big blind 100
*** HOLE CARDS ***
Dealt to FantasticDouble [9h Th]
manon327: calls 100
HighCardJasper: calls 100
FantasticDouble: raises 400 to 500
color_singleton: calls 450
dhduncan: folds 
manon327: calls 400
HighCardJasper: folds 
*** FLOP *** [Ks 4c 5c]
color_singleton: bets 803
manon327: folds 
FantasticDouble: folds 
Uncalled bet (803) returned to color_singleton
color_singleton collected 1606 from pot
color_singleton: doesn't show hand 
*** SUMMARY ***
Total pot 1700 | Rake 94 
Board [Ks 4c 5c]
Seat 1: manon327 folded on the Flop
Seat 2: HighCardJasper folded before Flop
Seat 3: FantasticDouble (button) folded on the Flop
Seat 6: color_singleton (small blind) collected (1606)
Seat 9: dhduncan (big blind) folded before Flop



PokerStars Home Game Hand #222895062795: {DaPokaStars}  Hold'em No Limit (50/100) - 2021/01/21 16:45:59 ET
Table 'testnsdfgh' 9-max (Play Money) Seat #6 is the button
Seat 1: manon327 (3641 in chips) 
Seat 2: HighCardJasper (22190 in chips) 
Seat 3: FantasticDouble (9244 in chips) 
Seat 6: color_singleton (21376 in chips) 
Seat 9: dhduncan (10284 in chips) 
dhduncan: posts small blind 50
manon327: posts big blind 100
*** HOLE CARDS ***
Dealt to FantasticDouble [4d 5s]
HighCardJasper: raises 200 to 300
FantasticDouble: folds 
color_singleton: calls 300
dhduncan has timed out
dhduncan: folds 
manon327: calls 200
*** FLOP *** [2c 7h 4c]
manon327: checks 
HighCardJasper: checks 
color_singleton: bets 898
manon327: folds 
HighCardJasper: folds 
Uncalled bet (898) returned to color_singleton
color_singleton collected 898 from pot
color_singleton: doesn't show hand 
*** SUMMARY ***
Total pot 950 | Rake 52 
Board [2c 7h 4c]
Seat 1: manon327 (big blind) folded on the Flop
Seat 2: HighCardJasper folded on the Flop
Seat 3: FantasticDouble folded before Flop (didn't bet)
Seat 6: color_singleton (button) collected (898)
Seat 9: dhduncan (small blind) folded before Flop



PokerStars Home Game Hand #222895093407: {DaPokaStars}  Hold'em No Limit (50/100) - 2021/01/21 16:46:42 ET
Table 'testnsdfgh' 9-max (Play Money) Seat #9 is the button
Seat 1: manon327 (3341 in chips) 
Seat 2: HighCardJasper (21890 in chips) 
Seat 3: FantasticDouble (9244 in chips) 
Seat 6: color_singleton (21974 in chips) 
Seat 9: dhduncan (10234 in chips) 
manon327: posts small blind 50
HighCardJasper: posts big blind 100
*** HOLE CARDS ***
Dealt to FantasticDouble [7d Kh]
FantasticDouble: raises 300 to 400
color_singleton: folds 
dhduncan: folds 
manon327: folds 
HighCardJasper: folds 
Uncalled bet (300) returned to FantasticDouble
FantasticDouble collected 250 from pot
*** SUMMARY ***
Total pot 250 | Rake 0 
Seat 1: manon327 (small blind) folded before Flop
Seat 2: HighCardJasper (big blind) folded before Flop
Seat 3: FantasticDouble collected (250)
Seat 6: color_singleton folded before Flop (didn't bet)
Seat 9: dhduncan (button) folded before Flop (didn't bet)



PokerStars Home Game Hand #222895100144: {DaPokaStars}  Hold'em No Limit (50/100) - 2021/01/21 16:46:52 ET
Table 'testnsdfgh' 9-max (Play Money) Seat #1 is the button
Seat 1: manon327 (3291 in chips) 
Seat 2: HighCardJasper (21790 in chips) 
Seat 3: FantasticDouble (9394 in chips) 
Seat 6: color_singleton (21974 in chips) 
Seat 9: dhduncan (10234 in chips) 
HighCardJasper: posts small blind 50
FantasticDouble: posts big blind 100
*** HOLE CARDS ***
Dealt to FantasticDouble [9c 2h]
color_singleton: raises 100 to 200
dhduncan: folds 
manon327: folds 
HighCardJasper: folds 
FantasticDouble: folds 
Uncalled bet (100) returned to color_singleton
color_singleton collected 250 from pot
color_singleton: doesn't show hand 
*** SUMMARY ***
Total pot 250 | Rake 0 
Seat 1: manon327 (button) folded before Flop (didn't bet)
Seat 2: HighCardJasper (small blind) folded before Flop
Seat 3: FantasticDouble (big blind) folded before Flop
Seat 6: color_singleton collected (250)
Seat 9: dhduncan folded before Flop (didn't bet)



PokerStars Home Game Hand #222895108772: {DaPokaStars}  Hold'em No Limit (50/100) - 2021/01/21 16:47:04 ET
Table 'testnsdfgh' 9-max (Play Money) Seat #2 is the button
Seat 1: manon327 (3291 in chips) 
Seat 2: HighCardJasper (21740 in chips) 
Seat 3: FantasticDouble (9294 in chips) 
Seat 6: color_singleton (22124 in chips) 
Seat 9: dhduncan (10234 in chips) 
FantasticDouble: posts small blind 50
color_singleton: posts big blind 100
*** HOLE CARDS ***
Dealt to FantasticDouble [4s 5c]
dhduncan: folds 
manon327: calls 100
HighCardJasper: folds 
FantasticDouble: calls 50
color_singleton: checks 
*** FLOP *** [6h Jc Qs]
FantasticDouble: checks 
color_singleton: checks 
manon327: checks 
*** TURN *** [6h Jc Qs] [2s]
FantasticDouble: checks 
color_singleton: checks 
manon327: checks 
*** RIVER *** [6h Jc Qs 2s] [9s]
FantasticDouble: checks 
color_singleton: checks 
manon327: bets 283
FantasticDouble: folds 
color_singleton: calls 283
*** SHOW DOWN ***
manon327: shows [Ad 3c] (high card Ace)
color_singleton: shows [9c 5s] (a pair of Nines)
color_singleton collected 818 from pot
*** SUMMARY ***
Total pot 866 | Rake 48 
Board [6h Jc Qs 2s 9s]
Seat 1: manon327 showed [Ad 3c] and lost with high card Ace
Seat 2: HighCardJasper (button) folded before Flop (didn't bet)
Seat 3: FantasticDouble (small blind) folded on the River
Seat 6: color_singleton (big blind) showed [9c 5s] and won (818) with a pair of Nines
Seat 9: dhduncan folded before Flop (didn't bet)



PokerStars Home Game Hand #222895135499: {DaPokaStars}  Hold'em No Limit (50/100) - 2021/01/21 16:47:42 ET
Table 'testnsdfgh' 9-max (Play Money) Seat #3 is the button
Seat 1: manon327 (2908 in chips) 
Seat 2: HighCardJasper (21740 in chips) 
Seat 3: FantasticDouble (9194 in chips) 
Seat 6: color_singleton (22559 in chips) 
Seat 9: dhduncan (10234 in chips) 
color_singleton: posts small blind 50
dhduncan: posts big blind 100
*** HOLE CARDS ***
Dealt to FantasticDouble [6h Qh]
manon327: folds 
HighCardJasper: folds 
FantasticDouble: calls 100
color_singleton: folds 
dhduncan: checks 
*** FLOP *** [9d Ac 8h]
dhduncan: checks 
FantasticDouble: checks 
*** TURN *** [9d Ac 8h] [Jc]
dhduncan: bets 118
FantasticDouble: folds 
Uncalled bet (118) returned to dhduncan
dhduncan collected 236 from pot
dhduncan: doesn't show hand 
*** SUMMARY ***
Total pot 250 | Rake 14 
Board [9d Ac 8h Jc]
Seat 1: manon327 folded before Flop (didn't bet)
Seat 2: HighCardJasper folded before Flop (didn't bet)
Seat 3: FantasticDouble (button) folded on the Turn
Seat 6: color_singleton (small blind) folded before Flop
Seat 9: dhduncan (big blind) collected (236)



PokerStars Home Game Hand #222895156691: {DaPokaStars}  Hold'em No Limit (50/100) - 2021/01/21 16:48:12 ET
Table 'testnsdfgh' 9-max (Play Money) Seat #6 is the button
Seat 1: manon327 (2908 in chips) 
Seat 2: HighCardJasper (21740 in chips) 
Seat 3: FantasticDouble (9094 in chips) 
Seat 6: color_singleton (22509 in chips) 
Seat 9: dhduncan (10370 in chips) 
dhduncan: posts small blind 50
manon327: posts big blind 100
*** HOLE CARDS ***
Dealt to FantasticDouble [9c As]
HighCardJasper: folds 
FantasticDouble: raises 300 to 400
color_singleton: folds 
dhduncan: folds 
manon327: folds 
Uncalled bet (300) returned to FantasticDouble
FantasticDouble collected 250 from pot
*** SUMMARY ***
Total pot 250 | Rake 0 
Seat 1: manon327 (big blind) folded before Flop
Seat 2: HighCardJasper folded before Flop (didn't bet)
Seat 3: FantasticDouble collected (250)
Seat 6: color_singleton (button) folded before Flop (didn't bet)
Seat 9: dhduncan (small blind) folded before Flop



PokerStars Home Game Hand #222895166610: {DaPokaStars}  Hold'em No Limit (50/100) - 2021/01/21 16:48:26 ET
Table 'testnsdfgh' 9-max (Play Money) Seat #9 is the button
Seat 1: manon327 (2808 in chips) 
Seat 2: HighCardJasper (21740 in chips) 
Seat 3: FantasticDouble (9244 in chips) 
Seat 6: color_singleton (22509 in chips) 
Seat 9: dhduncan (10320 in chips) 
manon327: posts small blind 50
HighCardJasper: posts big blind 100
*** HOLE CARDS ***
Dealt to FantasticDouble [6c 8d]
FantasticDouble: folds 
color_singleton: raises 200 to 300
dhduncan: folds 
manon327: folds 
HighCardJasper: calls 200
*** FLOP *** [3c 4c Qh]
HighCardJasper: checks 
color_singleton: checks 
*** TURN *** [3c 4c Qh] [9d]
HighCardJasper: bets 300
color_singleton: calls 300
*** RIVER *** [3c 4c Qh 9d] [Ah]
HighCardJasper: checks 
color_singleton: bets 1181
HighCardJasper: calls 1181
*** SHOW DOWN ***
color_singleton: shows [Qd Qc] (three of a kind, Queens)
HighCardJasper: mucks hand 
color_singleton collected 3413 from pot
*** SUMMARY ***
Total pot 3612 | Rake 199 
Board [3c 4c Qh 9d Ah]
Seat 1: manon327 (small blind) folded before Flop
Seat 2: HighCardJasper (big blind) mucked [As 6s]
Seat 3: FantasticDouble folded before Flop (didn't bet)
Seat 6: color_singleton showed [Qd Qc] and won (3413) with three of a kind, Queens
Seat 9: dhduncan (button) folded before Flop (didn't bet)



PokerStars Home Game Hand #222895199528: {DaPokaStars}  Hold'em No Limit (50/100) - 2021/01/21 16:49:13 ET
Table 'testnsdfgh' 9-max (Play Money) Seat #1 is the button
Seat 1: manon327 (2758 in chips) 
Seat 2: HighCardJasper (19959 in chips) 
Seat 3: FantasticDouble (9244 in chips) 
Seat 6: color_singleton (24141 in chips) 
Seat 9: dhduncan (10320 in chips) 
HighCardJasper: posts small blind 50
FantasticDouble: posts big blind 100
*** HOLE CARDS ***
Dealt to FantasticDouble [9s Ks]
color_singleton: raises 100 to 200
dhduncan: calls 200
manon327: folds 
HighCardJasper: calls 150
FantasticDouble: calls 100
*** FLOP *** [7s Js 4c]
HighCardJasper: checks 
FantasticDouble: bets 400
color_singleton: folds 
dhduncan: calls 400
HighCardJasper: folds 
*** TURN *** [7s Js 4c] [9d]
FantasticDouble: bets 900
dhduncan: calls 900
*** RIVER *** [7s Js 4c 9d] [3c]
FantasticDouble: checks 
dhduncan: checks 
*** SHOW DOWN ***
FantasticDouble: shows [9s Ks] (a pair of Nines)
dhduncan: mucks hand 
FantasticDouble collected 3213 from pot
*** SUMMARY ***
Total pot 3400 | Rake 187 
Board [7s Js 4c 9d 3c]
Seat 1: manon327 (button) folded before Flop (didn't bet)
Seat 2: HighCardJasper (small blind) folded on the Flop
Seat 3: FantasticDouble (big blind) showed [9s Ks] and won (3213) with a pair of Nines
Seat 6: color_singleton folded on the Flop
Seat 9: dhduncan mucked [3s As]



PokerStars Home Game Hand #222895221036: {DaPokaStars}  Hold'em No Limit (50/100) - 2021/01/21 16:49:43 ET
Table 'testnsdfgh' 9-max (Play Money) Seat #2 is the button
Seat 1: manon327 (2758 in chips) 
Seat 2: HighCardJasper (19759 in chips) 
Seat 3: FantasticDouble (10957 in chips) 
Seat 6: color_singleton (23941 in chips) 
Seat 8: poorrick1338 (2485 in chips) 
Seat 9: dhduncan (8820 in chips) 
FantasticDouble: posts small blind 50
color_singleton: posts big blind 100
poorrick1338: posts small & big blinds 150
*** HOLE CARDS ***
Dealt to FantasticDouble [Td 6d]
poorrick1338: raises 100 to 200
dhduncan: folds 
manon327: calls 200
HighCardJasper: folds 
FantasticDouble: calls 150
color_singleton: calls 100
*** FLOP *** [4s Qd 4d]
FantasticDouble: bets 400
color_singleton: folds 
poorrick1338: calls 400
manon327: calls 400
*** TURN *** [4s Qd 4d] [Js]
FantasticDouble: checks 
poorrick1338: bets 600
manon327: calls 600
FantasticDouble: calls 600
*** RIVER *** [4s Qd 4d Js] [4h]
FantasticDouble: checks 
poorrick1338: bets 400
manon327: raises 1158 to 1558 and is all-in
FantasticDouble: folds 
poorrick1338: calls 835 and is all-in
Uncalled bet (323) returned to manon327
*** SHOW DOWN ***
manon327: shows [Qh Ks] (a full house, Fours full of Queens)
poorrick1338: shows [Kc 4c] (four of a kind, Fours)
poorrick1338 collected 5972 from pot
*** SUMMARY ***
Total pot 6320 | Rake 348 
Board [4s Qd 4d Js 4h]
Seat 1: manon327 showed [Qh Ks] and lost with a full house, Fours full of Queens
Seat 2: HighCardJasper (button) folded before Flop (didn't bet)
Seat 3: FantasticDouble (small blind) folded on the River
Seat 6: color_singleton (big blind) folded on the Flop
Seat 8: poorrick1338 showed [Kc 4c] and won (5972) with four of a kind, Fours
Seat 9: dhduncan folded before Flop (didn't bet)



PokerStars Home Game Hand #222895273735: {DaPokaStars}  Hold'em No Limit (50/100) - 2021/01/21 16:50:58 ET
Table 'testnsdfgh' 9-max (Play Money) Seat #3 is the button
Seat 1: manon327 (323 in chips) 
Seat 2: HighCardJasper (19759 in chips) 
Seat 3: FantasticDouble (9757 in chips) 
Seat 6: color_singleton (23741 in chips) 
Seat 8: poorrick1338 (5972 in chips) 
Seat 9: dhduncan (8820 in chips) 
color_singleton: posts small blind 50
poorrick1338: posts big blind 100
*** HOLE CARDS ***
Dealt to FantasticDouble [6s Qc]
dhduncan: folds 
manon327: calls 100
HighCardJasper: calls 100
FantasticDouble: folds 
color_singleton: calls 50
poorrick1338: checks 
*** FLOP *** [9s Ac 6c]
color_singleton: bets 189
poorrick1338: calls 189
manon327: calls 189
HighCardJasper: folds 
*** TURN *** [9s Ac 6c] [Kc]
color_singleton: bets 457
poorrick1338: calls 457
manon327: calls 34 and is all-in
*** RIVER *** [9s Ac 6c Kc] [5h]
color_singleton: bets 905
poorrick1338: folds 
Uncalled bet (905) returned to color_singleton
*** SHOW DOWN ***
color_singleton: shows [6d Ks] (two pair, Kings and Sixes)
color_singleton collected 800 from side pot
manon327: shows [Js Qd] (high card Ace)
color_singleton collected 1010 from main pot
*** SUMMARY ***
Total pot 1915 Main pot 1010. Side pot 800. | Rake 105 
Board [9s Ac 6c Kc 5h]
Seat 1: manon327 showed [Js Qd] and lost with high card Ace
Seat 2: HighCardJasper folded on the Flop
Seat 3: FantasticDouble (button) folded before Flop (didn't bet)
Seat 6: color_singleton (small blind) showed [6d Ks] and won (1810) with two pair, Kings and Sixes
Seat 8: poorrick1338 (big blind) folded on the River
Seat 9: dhduncan folded before Flop (didn't bet)



PokerStars Home Game Hand #222895325454: {DaPokaStars}  Hold'em No Limit (50/100) - 2021/01/21 16:52:13 ET
Table 'testnsdfgh' 9-max (Play Money) Seat #6 is the button
Seat 2: HighCardJasper (19659 in chips) 
Seat 3: FantasticDouble (9757 in chips) 
Seat 6: color_singleton (24805 in chips) 
Seat 8: poorrick1338 (5226 in chips) 
Seat 9: dhduncan (8820 in chips) 
poorrick1338: posts small blind 50
dhduncan: posts big blind 100
*** HOLE CARDS ***
Dealt to FantasticDouble [7c 5s]
HighCardJasper: folds 
FantasticDouble: folds 
color_singleton: folds 
poorrick1338: calls 50
dhduncan: checks 
*** FLOP *** [Ks 7h Ah]
poorrick1338: bets 300
dhduncan: folds 
Uncalled bet (300) returned to poorrick1338
poorrick1338 collected 189 from pot
poorrick1338: doesn't show hand 
*** SUMMARY ***
Total pot 200 | Rake 11 
Board [Ks 7h Ah]
Seat 2: HighCardJasper folded before Flop (didn't bet)
Seat 3: FantasticDouble folded before Flop (didn't bet)
Seat 6: color_singleton (button) folded before Flop (didn't bet)
Seat 8: poorrick1338 (small blind) collected (189)
Seat 9: dhduncan (big blind) folded on the Flop



PokerStars Home Game Hand #222895345241: {DaPokaStars}  Hold'em No Limit (50/100) - 2021/01/21 16:52:41 ET
Table 'testnsdfgh' 9-max (Play Money) Seat #8 is the button
Seat 1: manon327 (10000 in chips) 
Seat 2: HighCardJasper (19659 in chips) 
Seat 3: FantasticDouble (9757 in chips) 
Seat 6: color_singleton (24805 in chips) 
Seat 8: poorrick1338 (5315 in chips) 
Seat 9: dhduncan (8720 in chips) 
dhduncan: posts small blind 50
manon327: posts big blind 100
*** HOLE CARDS ***
Dealt to FantasticDouble [Th 4d]
HighCardJasper: calls 100
FantasticDouble: folds 
color_singleton: folds 
poorrick1338: calls 100
dhduncan: calls 50
manon327: raises 100 to 200
HighCardJasper: calls 100
poorrick1338: calls 100
dhduncan: calls 100
*** FLOP *** [7h 7d 3c]
dhduncan: checks 
manon327: checks 
HighCardJasper: checks 
poorrick1338: bets 300
dhduncan: folds 
manon327: folds 
HighCardJasper: folds 
Uncalled bet (300) returned to poorrick1338
poorrick1338 collected 756 from pot
poorrick1338: doesn't show hand 
*** SUMMARY ***
Total pot 800 | Rake 44 
Board [7h 7d 3c]
Seat 1: manon327 (big blind) folded on the Flop
Seat 2: HighCardJasper folded on the Flop
Seat 3: FantasticDouble folded before Flop (didn't bet)
Seat 6: color_singleton folded before Flop (didn't bet)
Seat 8: poorrick1338 (button) collected (756)
Seat 9: dhduncan (small blind) folded on the Flop



PokerStars Home Game Hand #222895382073: {DaPokaStars}  Hold'em No Limit (50/100) - 2021/01/21 16:53:34 ET
Table 'testnsdfgh' 9-max (Play Money) Seat #9 is the button
Seat 1: manon327 (9800 in chips) 
Seat 2: HighCardJasper (19459 in chips) 
Seat 3: FantasticDouble (9757 in chips) 
Seat 6: color_singleton (24805 in chips) 
Seat 8: poorrick1338 (5871 in chips) 
Seat 9: dhduncan (8520 in chips) 
manon327: posts small blind 50
HighCardJasper: posts big blind 100
*** HOLE CARDS ***
Dealt to FantasticDouble [4h 4c]
FantasticDouble: raises 200 to 300
color_singleton: folds 
poorrick1338: calls 300
dhduncan: folds 
manon327: calls 250
HighCardJasper: folds 
*** FLOP *** [3s Td 7c]
manon327: checks 
FantasticDouble: checks 
poorrick1338: checks 
*** TURN *** [3s Td 7c] [Kc]
manon327: checks 
FantasticDouble: checks 
poorrick1338: bets 400
manon327: folds 
FantasticDouble: folds 
Uncalled bet (400) returned to poorrick1338
poorrick1338 collected 945 from pot
poorrick1338: doesn't show hand 
*** SUMMARY ***
Total pot 1000 | Rake 55 
Board [3s Td 7c Kc]
Seat 1: manon327 (small blind) folded on the Turn
Seat 2: HighCardJasper (big blind) folded before Flop
Seat 3: FantasticDouble folded on the Turn
Seat 6: color_singleton folded before Flop (didn't bet)
Seat 8: poorrick1338 collected (945)
Seat 9: dhduncan (button) folded before Flop (didn't bet)



PokerStars Home Game Hand #222895419393: {DaPokaStars}  Hold'em No Limit (50/100) - 2021/01/21 16:54:28 ET
Table 'testnsdfgh' 9-max (Play Money) Seat #1 is the button
Seat 1: manon327 (9500 in chips) 
Seat 2: HighCardJasper (19359 in chips) 
Seat 3: FantasticDouble (9457 in chips) 
Seat 6: color_singleton (24805 in chips) 
Seat 8: poorrick1338 (6516 in chips) 
Seat 9: dhduncan (8520 in chips) 
HighCardJasper: posts small blind 50
FantasticDouble: posts big blind 100
*** HOLE CARDS ***
Dealt to FantasticDouble [2d 7d]
color_singleton: folds 
poorrick1338: calls 100
dhduncan: calls 100
manon327: calls 100
HighCardJasper: raises 100 to 200
FantasticDouble: calls 100
poorrick1338: calls 100
dhduncan: calls 100
manon327: calls 100
*** FLOP *** [5h Qd 3s]
HighCardJasper: checks 
FantasticDouble: checks 
poorrick1338: checks 
dhduncan: checks 
manon327: checks 
*** TURN *** [5h Qd 3s] [6d]
HighCardJasper: checks 
FantasticDouble: bets 400
poorrick1338: folds 
dhduncan: folds 
manon327: folds 
HighCardJasper: folds 
Uncalled bet (400) returned to FantasticDouble
FantasticDouble collected 945 from pot
*** SUMMARY ***
Total pot 1000 | Rake 55 
Board [5h Qd 3s 6d]
Seat 1: manon327 (button) folded on the Turn
Seat 2: HighCardJasper (small blind) folded on the Turn
Seat 3: FantasticDouble (big blind) collected (945)
Seat 6: color_singleton folded before Flop (didn't bet)
Seat 8: poorrick1338 folded on the Turn
Seat 9: dhduncan folded on the Turn



PokerStars Home Game Hand #222895466447: {DaPokaStars}  Hold'em No Limit (50/100) - 2021/01/21 16:55:50 ET
Table 'testnsdfgh' 9-max (Play Money) Seat #2 is the button
Seat 1: manon327 (9300 in chips) 
Seat 2: HighCardJasper (19159 in chips) 
Seat 3: FantasticDouble (10202 in chips) 
Seat 6: color_singleton (24805 in chips) 
Seat 8: poorrick1338 (6316 in chips) 
Seat 9: dhduncan (8320 in chips) 
FantasticDouble: posts small blind 50
color_singleton: posts big blind 100
*** HOLE CARDS ***
Dealt to FantasticDouble [3h 9h]
poorrick1338: folds 
dhduncan: calls 100
manon327: calls 100
HighCardJasper: calls 100
FantasticDouble: calls 50
color_singleton: checks 
*** FLOP *** [7h Kh 7d]
FantasticDouble: bets 300
color_singleton: folds 
dhduncan: folds 
manon327: calls 300
HighCardJasper: folds 
*** TURN *** [7h Kh 7d] [Jh]
FantasticDouble: bets 700
manon327: raises 700 to 1400
FantasticDouble: calls 700
*** RIVER *** [7h Kh 7d Jh] [Tc]
FantasticDouble: checks 
manon327: bets 3685
FantasticDouble: calls 3685
*** SHOW DOWN ***
manon327: shows [Jc Js] (a full house, Jacks full of Sevens)
FantasticDouble: mucks hand 
manon327 collected 10650 from pot
*** SUMMARY ***
Total pot 11270 | Rake 620 
Board [7h Kh 7d Jh Tc]
Seat 1: manon327 showed [Jc Js] and won (10650) with a full house, Jacks full of Sevens
Seat 2: HighCardJasper (button) folded on the Flop
Seat 3: FantasticDouble (small blind) mucked [3h 9h]
Seat 6: color_singleton (big blind) folded on the Flop
Seat 8: poorrick1338 folded before Flop (didn't bet)
Seat 9: dhduncan folded on the Flop



PokerStars Home Game Hand #222895503577: {DaPokaStars}  Hold'em No Limit (50/100) - 2021/01/21 16:57:04 ET
Table 'testnsdfgh' 9-max (Play Money) Seat #3 is the button
Seat 1: manon327 (14465 in chips) 
Seat 2: HighCardJasper (19059 in chips) 
Seat 3: FantasticDouble (4717 in chips) 
Seat 6: color_singleton (24705 in chips) 
Seat 8: poorrick1338 (6316 in chips) 
Seat 9: dhduncan (8220 in chips) 
color_singleton: posts small blind 50
poorrick1338: posts big blind 100
*** HOLE CARDS ***
Dealt to FantasticDouble [9s 9d]
dhduncan: calls 100
manon327: calls 100
HighCardJasper: calls 100
FantasticDouble: raises 400 to 500
color_singleton: folds 
poorrick1338: calls 400
dhduncan: calls 400
manon327: folds 
HighCardJasper: calls 400
*** FLOP *** [7c 8s 2c]
poorrick1338: checks 
dhduncan: bets 400
HighCardJasper: folds 
FantasticDouble: raises 700 to 1100
poorrick1338: folds 
dhduncan: calls 700
*** TURN *** [7c 8s 2c] [Jh]
dhduncan: checks 
FantasticDouble: bets 3117 and is all-in
dhduncan: calls 3117
*** RIVER *** [7c 8s 2c Jh] [4d]
*** SHOW DOWN ***
dhduncan: shows [7h Ah] (a pair of Sevens)
FantasticDouble: shows [9s 9d] (a pair of Nines)
FantasticDouble collected 10002 from pot
*** SUMMARY ***
Total pot 10584 | Rake 582 
Board [7c 8s 2c Jh 4d]
Seat 1: manon327 folded before Flop
Seat 2: HighCardJasper folded on the Flop
Seat 3: FantasticDouble (button) showed [9s 9d] and won (10002) with a pair of Nines
Seat 6: color_singleton (small blind) folded before Flop
Seat 8: poorrick1338 (big blind) folded on the Flop
Seat 9: dhduncan showed [7h Ah] and lost with a pair of Sevens



PokerStars Home Game Hand #222895543410: {DaPokaStars}  Hold'em No Limit (50/100) - 2021/01/21 16:58:23 ET
Table 'testnsdfgh' 9-max (Play Money) Seat #6 is the button
Seat 1: manon327 (14365 in chips) 
Seat 2: HighCardJasper (18559 in chips) 
Seat 3: FantasticDouble (10002 in chips) 
Seat 6: color_singleton (24655 in chips) 
Seat 8: poorrick1338 (5816 in chips) 
Seat 9: dhduncan (3503 in chips) 
poorrick1338: posts small blind 50
dhduncan: posts big blind 100
*** HOLE CARDS ***
Dealt to FantasticDouble [7s Tc]
manon327: folds 
HighCardJasper: folds 
FantasticDouble: raises 200 to 300
color_singleton: calls 300
poorrick1338: folds 
dhduncan: folds 
*** FLOP *** [2d 6s Qd]
FantasticDouble: checks 
color_singleton: checks 
*** TURN *** [2d 6s Qd] [2c]
FantasticDouble: checks 
color_singleton: bets 354
FantasticDouble: folds 
Uncalled bet (354) returned to color_singleton
color_singleton collected 709 from pot
color_singleton: doesn't show hand 
*** SUMMARY ***
Total pot 750 | Rake 41 
Board [2d 6s Qd 2c]
Seat 1: manon327 folded before Flop (didn't bet)
Seat 2: HighCardJasper folded before Flop (didn't bet)
Seat 3: FantasticDouble folded on the Turn
Seat 6: color_singleton (button) collected (709)
Seat 8: poorrick1338 (small blind) folded before Flop
Seat 9: dhduncan (big blind) folded before Flop



PokerStars Home Game Hand #222895561596: {DaPokaStars}  Hold'em No Limit (50/100) - 2021/01/21 16:58:59 ET
Table 'testnsdfgh' 9-max (Play Money) Seat #8 is the button
Seat 1: manon327 (14365 in chips) 
Seat 2: HighCardJasper (18559 in chips) 
Seat 3: FantasticDouble (9702 in chips) 
Seat 6: color_singleton (25064 in chips) 
Seat 8: poorrick1338 (5766 in chips) 
Seat 9: dhduncan (3403 in chips) 
dhduncan: posts small blind 50
manon327: posts big blind 100
*** HOLE CARDS ***
Dealt to FantasticDouble [3h 5c]
HighCardJasper: raises 100 to 200
FantasticDouble: folds 
color_singleton: raises 300 to 500
poorrick1338: calls 500
dhduncan: folds 
manon327: folds 
HighCardJasper: calls 300
*** FLOP *** [Qh 2s 4c]
HighCardJasper: checks 
color_singleton: checks 
poorrick1338: checks 
*** TURN *** [Qh 2s 4c] [3c]
HighCardJasper: checks 
color_singleton: bets 779
poorrick1338: calls 779
HighCardJasper: folds 
*** RIVER *** [Qh 2s 4c 3c] [Td]
color_singleton: checks 
poorrick1338: checks 
*** SHOW DOWN ***
color_singleton: shows [Ad Ks] (high card Ace)
poorrick1338: mucks hand 
color_singleton collected 3032 from pot
*** SUMMARY ***
Total pot 3208 | Rake 176 
Board [Qh 2s 4c 3c Td]
Seat 1: manon327 (big blind) folded before Flop
Seat 2: HighCardJasper folded on the Turn
Seat 3: FantasticDouble folded before Flop (didn't bet)
Seat 6: color_singleton showed [Ad Ks] and won (3032) with high card Ace
Seat 8: poorrick1338 (button) mucked [6c Ac]
Seat 9: dhduncan (small blind) folded before Flop



PokerStars Home Game Hand #222895590096: {DaPokaStars}  Hold'em No Limit (50/100) - 2021/01/21 16:59:55 ET
Table 'testnsdfgh' 9-max (Play Money) Seat #9 is the button
Seat 1: manon327 (14265 in chips) 
Seat 2: HighCardJasper (18059 in chips) 
Seat 3: FantasticDouble (9702 in chips) 
Seat 6: color_singleton (26817 in chips) 
Seat 8: poorrick1338 (4487 in chips) 
Seat 9: dhduncan (3353 in chips) 
manon327: posts small blind 50
HighCardJasper: posts big blind 100
*** HOLE CARDS ***
Dealt to FantasticDouble [3c Th]
FantasticDouble: folds 
color_singleton: raises 200 to 300
poorrick1338: calls 300
dhduncan: calls 300
manon327: calls 250
HighCardJasper: calls 200
*** FLOP *** [4h 5s 2s]
manon327: checks 
HighCardJasper: checks 
color_singleton: checks 
poorrick1338: bets 400
dhduncan: folds 
manon327: calls 400
HighCardJasper: calls 400
color_singleton: calls 400
*** TURN *** [4h 5s 2s] [8h]
manon327: checks 
HighCardJasper: checks 
color_singleton: checks 
poorrick1338: checks 
*** RIVER *** [4h 5s 2s 8h] [Jh]
manon327: checks 
HighCardJasper: checks 
color_singleton: checks 
poorrick1338: checks 
*** SHOW DOWN ***
manon327: shows [Ks 8s] (a pair of Eights)
HighCardJasper: shows [9h 9s] (a pair of Nines)
color_singleton: mucks hand 
poorrick1338: mucks hand 
HighCardJasper collected 2929 from pot
*** SUMMARY ***
Total pot 3100 | Rake 171 
Board [4h 5s 2s 8h Jh]
Seat 1: manon327 (small blind) showed [Ks 8s] and lost with a pair of Eights
Seat 2: HighCardJasper (big blind) showed [9h 9s] and won (2929) with a pair of Nines
Seat 3: FantasticDouble folded before Flop (didn't bet)
Seat 6: color_singleton mucked [Kc Ac]
Seat 8: poorrick1338 mucked [5h Qc]
Seat 9: dhduncan (button) folded on the Flop



PokerStars Home Game Hand #222895627423: {DaPokaStars}  Hold'em No Limit (50/100) - 2021/01/21 17:01:02 ET
Table 'testnsdfgh' 9-max (Play Money) Seat #1 is the button
Seat 1: manon327 (13565 in chips) 
Seat 2: HighCardJasper (20288 in chips) 
Seat 3: FantasticDouble (9702 in chips) 
Seat 6: color_singleton (26117 in chips) 
Seat 8: poorrick1338 (3787 in chips) 
Seat 9: dhduncan (3053 in chips) 
HighCardJasper: posts small blind 50
FantasticDouble: posts big blind 100
*** HOLE CARDS ***
Dealt to FantasticDouble [9c 2d]
color_singleton: folds 
poorrick1338: calls 100
dhduncan: calls 100
manon327: folds 
HighCardJasper: calls 50
FantasticDouble: checks 
*** FLOP *** [2c 8h 8d]
HighCardJasper: bets 200
FantasticDouble: calls 200
poorrick1338: calls 200
dhduncan: folds 
*** TURN *** [2c 8h 8d] [Qd]
HighCardJasper: bets 200
FantasticDouble: calls 200
poorrick1338: calls 200
*** RIVER *** [2c 8h 8d Qd] [Jd]
HighCardJasper: bets 500
FantasticDouble: folds 
poorrick1338: calls 500
*** SHOW DOWN ***
HighCardJasper: shows [8s Th] (three of a kind, Eights)
poorrick1338: mucks hand 
HighCardJasper collected 2457 from pot
*** SUMMARY ***
Total pot 2600 | Rake 143 
Board [2c 8h 8d Qd Jd]
Seat 1: manon327 (button) folded before Flop (didn't bet)
Seat 2: HighCardJasper (small blind) showed [8s Th] and won (2457) with three of a kind, Eights
Seat 3: FantasticDouble (big blind) folded on the River
Seat 6: color_singleton folded before Flop (didn't bet)
Seat 8: poorrick1338 mucked [Tc 2h]
Seat 9: dhduncan folded on the Flop



PokerStars Home Game Hand #222895662063: {DaPokaStars}  Hold'em No Limit (50/100) - 2021/01/21 17:01:57 ET
Table 'testnsdfgh' 9-max (Play Money) Seat #2 is the button
Seat 1: manon327 (13565 in chips) 
Seat 2: HighCardJasper (21745 in chips) 
Seat 3: FantasticDouble (9202 in chips) 
Seat 6: color_singleton (26117 in chips) 
Seat 8: poorrick1338 (2787 in chips) 
Seat 9: dhduncan (2953 in chips) 
FantasticDouble: posts small blind 50
color_singleton: posts big blind 100
*** HOLE CARDS ***
Dealt to FantasticDouble [Jc Ac]
poorrick1338: calls 100
dhduncan: calls 100
manon327: folds 
HighCardJasper: calls 100
FantasticDouble: raises 400 to 500
color_singleton has timed out
color_singleton: folds 
poorrick1338: calls 400
dhduncan: calls 400
HighCardJasper: folds 
*** FLOP *** [7c Kc 5s]
FantasticDouble: bets 900
poorrick1338: calls 900
dhduncan: calls 900
*** TURN *** [7c Kc 5s] [4h]
FantasticDouble: checks 
poorrick1338: checks 
dhduncan: bets 100
FantasticDouble: calls 100
poorrick1338: raises 400 to 500
dhduncan: calls 400
FantasticDouble: calls 400
*** RIVER *** [7c Kc 5s 4h] [9c]
FantasticDouble: bets 1200
poorrick1338: calls 887 and is all-in
dhduncan: calls 1053 and is all-in
Uncalled bet (147) returned to FantasticDouble
*** SHOW DOWN ***
FantasticDouble: shows [Jc Ac] (a flush, Ace high)
dhduncan: shows [Ks Qs] (a pair of Kings)
FantasticDouble collected 314 from side pot
poorrick1338: shows [4c Kd] (two pair, Kings and Fours)
FantasticDouble collected 8090 from main pot
*** SUMMARY ***
Total pot 8893 Main pot 8090. Side pot 314. | Rake 489 
Board [7c Kc 5s 4h 9c]
Seat 1: manon327 folded before Flop (didn't bet)
Seat 2: HighCardJasper (button) folded before Flop
Seat 3: FantasticDouble (small blind) showed [Jc Ac] and won (8404) with a flush, Ace high
Seat 6: color_singleton (big blind) folded before Flop
Seat 8: poorrick1338 showed [4c Kd] and lost with two pair, Kings and Fours
Seat 9: dhduncan showed [Ks Qs] and lost with a pair of Kings



PokerStars Home Game Hand #222895727922: {DaPokaStars}  Hold'em No Limit (50/100) - 2021/01/21 17:03:34 ET
Table 'testnsdfgh' 9-max (Play Money) Seat #3 is the button
Seat 1: manon327 (13565 in chips) 
Seat 2: HighCardJasper (21645 in chips) 
Seat 3: FantasticDouble (14653 in chips) 
Seat 6: color_singleton (26017 in chips) 
color_singleton: posts small blind 50
manon327: posts big blind 100
*** HOLE CARDS ***
Dealt to FantasticDouble [Td Jd]
HighCardJasper: calls 100
FantasticDouble: raises 300 to 400
color_singleton: calls 350
manon327: folds 
HighCardJasper: folds 
*** FLOP *** [Th 5c 7c]
color_singleton: bets 945
FantasticDouble: calls 945
*** TURN *** [Th 5c 7c] [6h]
color_singleton: bets 1365
FantasticDouble: calls 1365
*** RIVER *** [Th 5c 7c 6h] [Jh]
color_singleton: checks 
FantasticDouble: bets 2500
color_singleton: calls 2500
*** SHOW DOWN ***
FantasticDouble: shows [Td Jd] (two pair, Jacks and Tens)
color_singleton: shows [Jc Ts] (two pair, Jacks and Tens)
color_singleton collected 5018 from pot
FantasticDouble collected 5018 from pot
*** SUMMARY ***
Total pot 10620 | Rake 584 
Board [Th 5c 7c 6h Jh]
Seat 1: manon327 (big blind) folded before Flop
Seat 2: HighCardJasper folded before Flop
Seat 3: FantasticDouble (button) showed [Td Jd] and won (5018) with two pair, Jacks and Tens
Seat 6: color_singleton (small blind) showed [Jc Ts] and won (5018) with two pair, Jacks and Tens



PokerStars Home Game Hand #222895769566: {DaPokaStars}  Hold'em No Limit (50/100) - 2021/01/21 17:04:35 ET
Table 'testnsdfgh' 9-max (Play Money) Seat #6 is the button
Seat 1: manon327 (13465 in chips) 
Seat 2: HighCardJasper (21545 in chips) 
Seat 3: FantasticDouble (14461 in chips) 
Seat 6: color_singleton (25825 in chips) 
manon327: posts small blind 50
HighCardJasper: posts big blind 100
*** HOLE CARDS ***
Dealt to FantasticDouble [6s Ah]
FantasticDouble: calls 100
color_singleton: raises 100 to 200
manon327: folds 
HighCardJasper: calls 100
FantasticDouble: calls 100
*** FLOP *** [5s Ad 7c]
HighCardJasper: checks 
FantasticDouble: bets 400
color_singleton: folds 
HighCardJasper: calls 400
*** TURN *** [5s Ad 7c] [2h]
HighCardJasper: checks 
FantasticDouble: checks 
*** RIVER *** [5s Ad 7c 2h] [Qs]
HighCardJasper: bets 500
FantasticDouble: calls 500
*** SHOW DOWN ***
HighCardJasper: shows [7h Ac] (two pair, Aces and Sevens)
FantasticDouble: mucks hand 
HighCardJasper collected 2315 from pot
*** SUMMARY ***
Total pot 2450 | Rake 135 
Board [5s Ad 7c 2h Qs]
Seat 1: manon327 (small blind) folded before Flop
Seat 2: HighCardJasper (big blind) showed [7h Ac] and won (2315) with two pair, Aces and Sevens
Seat 3: FantasticDouble mucked [6s Ah]
Seat 6: color_singleton (button) folded on the Flop



PokerStars Home Game Hand #222895801893: {DaPokaStars}  Hold'em No Limit (50/100) - 2021/01/21 17:05:22 ET
Table 'testnsdfgh' 9-max (Play Money) Seat #1 is the button
Seat 1: manon327 (13415 in chips) 
Seat 2: HighCardJasper (22760 in chips) 
Seat 3: FantasticDouble (13361 in chips) 
Seat 6: color_singleton (25625 in chips) 
Seat 9: dhduncan (10000 in chips) 
HighCardJasper: posts small blind 50
FantasticDouble: posts big blind 100
dhduncan: posts small & big blinds 150
*** HOLE CARDS ***
Dealt to FantasticDouble [5d Kh]
color_singleton: folds 
dhduncan: checks 
manon327: folds 
HighCardJasper: folds 
FantasticDouble: checks 
*** FLOP *** [4h Kc 2d]
FantasticDouble: bets 200
dhduncan: raises 200 to 400
FantasticDouble: calls 200
*** TURN *** [4h Kc 2d] [7d]
FantasticDouble: checks 
dhduncan: bets 519
FantasticDouble: calls 519
*** RIVER *** [4h Kc 2d 7d] [6h]
FantasticDouble: checks 
dhduncan: checks 
*** SHOW DOWN ***
FantasticDouble: shows [5d Kh] (a pair of Kings)
dhduncan: shows [Kd Ac] (a pair of Kings - Ace kicker)
dhduncan collected 2020 from pot
*** SUMMARY ***
Total pot 2138 | Rake 118 
Board [4h Kc 2d 7d 6h]
Seat 1: manon327 (button) folded before Flop (didn't bet)
Seat 2: HighCardJasper (small blind) folded before Flop
Seat 3: FantasticDouble (big blind) showed [5d Kh] and lost with a pair of Kings
Seat 6: color_singleton folded before Flop (didn't bet)
Seat 9: dhduncan showed [Kd Ac] and won (2020) with a pair of Kings



PokerStars Home Game Hand #222895840671: {DaPokaStars}  Hold'em No Limit (50/100) - 2021/01/21 17:06:19 ET
Table 'testnsdfgh' 9-max (Play Money) Seat #2 is the button
Seat 1: manon327 (13415 in chips) 
Seat 2: HighCardJasper (22710 in chips) 
Seat 3: FantasticDouble (12342 in chips) 
Seat 6: color_singleton (25625 in chips) 
Seat 9: dhduncan (10951 in chips) 
FantasticDouble: posts small blind 50
color_singleton: posts big blind 100
*** HOLE CARDS ***
Dealt to FantasticDouble [4s Ad]
dhduncan: folds 
manon327: folds 
HighCardJasper: calls 100
FantasticDouble: calls 50
color_singleton: checks 
*** FLOP *** [7d 5d 9d]
FantasticDouble: bets 200
color_singleton: calls 200
HighCardJasper: folds 
*** TURN *** [7d 5d 9d] [7h]
FantasticDouble: bets 400
color_singleton: folds 
Uncalled bet (400) returned to FantasticDouble
FantasticDouble collected 661 from pot
*** SUMMARY ***
Total pot 700 | Rake 39 
Board [7d 5d 9d 7h]
Seat 1: manon327 folded before Flop (didn't bet)
Seat 2: HighCardJasper (button) folded on the Flop
Seat 3: FantasticDouble (small blind) collected (661)
Seat 6: color_singleton (big blind) folded on the Turn
Seat 9: dhduncan folded before Flop (didn't bet)



PokerStars Home Game Hand #222895864901: {DaPokaStars}  Hold'em No Limit (50/100) - 2021/01/21 17:06:55 ET
Table 'testnsdfgh' 9-max (Play Money) Seat #3 is the button
Seat 1: manon327 (13415 in chips) 
Seat 2: HighCardJasper (22610 in chips) 
Seat 3: FantasticDouble (12703 in chips) 
Seat 6: color_singleton (25325 in chips) 
Seat 9: dhduncan (10951 in chips) 
color_singleton: posts small blind 50
dhduncan: posts big blind 100
*** HOLE CARDS ***
Dealt to FantasticDouble [Jc Jd]
manon327: calls 100
HighCardJasper: calls 100
FantasticDouble: raises 500 to 600
color_singleton: folds 
dhduncan: folds 
manon327: folds 
HighCardJasper: folds 
Uncalled bet (500) returned to FantasticDouble
FantasticDouble collected 450 from pot
*** SUMMARY ***
Total pot 450 | Rake 0 
Seat 1: manon327 folded before Flop
Seat 2: HighCardJasper folded before Flop
Seat 3: FantasticDouble (button) collected (450)
Seat 6: color_singleton (small blind) folded before Flop
Seat 9: dhduncan (big blind) folded before Flop



PokerStars Home Game Hand #222895876098: {DaPokaStars}  Hold'em No Limit (50/100) - 2021/01/21 17:07:11 ET
Table 'testnsdfgh' 9-max (Play Money) Seat #6 is the button
Seat 1: manon327 (13315 in chips) 
Seat 2: HighCardJasper (22510 in chips) 
Seat 3: FantasticDouble (13053 in chips) 
Seat 6: color_singleton (25275 in chips) 
Seat 9: dhduncan (10851 in chips) 
dhduncan: posts small blind 50
manon327: posts big blind 100
*** HOLE CARDS ***
Dealt to FantasticDouble [Ac 7d]
HighCardJasper: calls 100
FantasticDouble: raises 300 to 400
color_singleton: folds 
dhduncan: folds 
manon327: folds 
HighCardJasper: calls 300
*** FLOP *** [5c 7c Ts]
HighCardJasper: checks 
FantasticDouble: checks 
*** TURN *** [5c 7c Ts] [7s]
HighCardJasper: checks 
FantasticDouble: bets 400
HighCardJasper: calls 400
*** RIVER *** [5c 7c Ts 7s] [5d]
HighCardJasper: checks 
FantasticDouble: bets 900
HighCardJasper: folds 
Uncalled bet (900) returned to FantasticDouble
FantasticDouble collected 1654 from pot
*** SUMMARY ***
Total pot 1750 | Rake 96 
Board [5c 7c Ts 7s 5d]
Seat 1: manon327 (big blind) folded before Flop
Seat 2: HighCardJasper folded on the River
Seat 3: FantasticDouble collected (1654)
Seat 6: color_singleton (button) folded before Flop (didn't bet)
Seat 9: dhduncan (small blind) folded before Flop



PokerStars Home Game Hand #222895896068: {DaPokaStars}  Hold'em No Limit (50/100) - 2021/01/21 17:07:40 ET
Table 'testnsdfgh' 9-max (Play Money) Seat #9 is the button
Seat 1: manon327 (13215 in chips) 
Seat 2: HighCardJasper (21710 in chips) 
Seat 3: FantasticDouble (13907 in chips) 
Seat 6: color_singleton (25275 in chips) 
Seat 9: dhduncan (10801 in chips) 
manon327: posts small blind 50
HighCardJasper: posts big blind 100
*** HOLE CARDS ***
Dealt to FantasticDouble [2s Js]
FantasticDouble: folds 
color_singleton: raises 100 to 200
dhduncan: folds 
manon327: calls 150
HighCardJasper: calls 100
*** FLOP *** [3h 2h 5d]
manon327: checks 
HighCardJasper: checks 
color_singleton: checks 
*** TURN *** [3h 2h 5d] [7d]
manon327: checks 
HighCardJasper: checks 
color_singleton: bets 283
manon327: folds 
HighCardJasper: folds 
Uncalled bet (283) returned to color_singleton
color_singleton collected 567 from pot
color_singleton: doesn't show hand 
*** SUMMARY ***
Total pot 600 | Rake 33 
Board [3h 2h 5d 7d]
Seat 1: manon327 (small blind) folded on the Turn
Seat 2: HighCardJasper (big blind) folded on the Turn
Seat 3: FantasticDouble folded before Flop (didn't bet)
Seat 6: color_singleton collected (567)
Seat 9: dhduncan (button) folded before Flop (didn't bet)



PokerStars Home Game Hand #222895916766: {DaPokaStars}  Hold'em No Limit (50/100) - 2021/01/21 17:08:11 ET
Table 'testnsdfgh' 9-max (Play Money) Seat #1 is the button
Seat 1: manon327 (13015 in chips) 
Seat 2: HighCardJasper (21510 in chips) 
Seat 3: FantasticDouble (13907 in chips) 
Seat 6: color_singleton (25642 in chips) 
Seat 9: dhduncan (10801 in chips) 
HighCardJasper: posts small blind 50
FantasticDouble: posts big blind 100
*** HOLE CARDS ***
Dealt to FantasticDouble [5d 9h]
color_singleton: folds 
dhduncan: folds 
manon327: calls 100
HighCardJasper: calls 50
FantasticDouble: checks 
*** FLOP *** [Jc 3c 3h]
HighCardJasper: bets 100
FantasticDouble: folds 
manon327: calls 100
*** TURN *** [Jc 3c 3h] [6c]
HighCardJasper: bets 200
manon327: calls 200
*** RIVER *** [Jc 3c 3h 6c] [2d]
HighCardJasper: bets 300
manon327: calls 300
*** SHOW DOWN ***
HighCardJasper: shows [3s Qh] (three of a kind, Threes)
manon327: mucks hand 
HighCardJasper collected 1417 from pot
*** SUMMARY ***
Total pot 1500 | Rake 83 
Board [Jc 3c 3h 6c 2d]
Seat 1: manon327 (button) mucked [8d 8c]
Seat 2: HighCardJasper (small blind) showed [3s Qh] and won (1417) with three of a kind, Threes
Seat 3: FantasticDouble (big blind) folded on the Flop
Seat 6: color_singleton folded before Flop (didn't bet)
Seat 9: dhduncan folded before Flop (didn't bet)



PokerStars Home Game Hand #222895950427: {DaPokaStars}  Hold'em No Limit (50/100) - 2021/01/21 17:08:53 ET
Table 'testnsdfgh' 9-max (Play Money) Seat #2 is the button
Seat 1: manon327 (12315 in chips) 
Seat 2: HighCardJasper (22227 in chips) 
Seat 3: FantasticDouble (13807 in chips) 
Seat 6: color_singleton (25642 in chips) 
Seat 9: dhduncan (10801 in chips) 
FantasticDouble: posts small blind 50
color_singleton: posts big blind 100
*** HOLE CARDS ***
Dealt to FantasticDouble [8d 6h]
dhduncan: calls 100
manon327: calls 100
HighCardJasper: calls 100
FantasticDouble: calls 50
color_singleton: checks 
*** FLOP *** [4s Ts Ah]
FantasticDouble: checks 
color_singleton: bets 236
dhduncan: calls 236
manon327: folds 
HighCardJasper: folds 
FantasticDouble: folds 
*** TURN *** [4s Ts Ah] [7h]
color_singleton: checks 
dhduncan: bets 100
color_singleton: calls 100
*** RIVER *** [4s Ts Ah 7h] [3c]
color_singleton: checks 
dhduncan: bets 100
color_singleton: calls 100
*** SHOW DOWN ***
dhduncan: shows [As 6d] (a pair of Aces)
color_singleton: mucks hand 
dhduncan collected 1297 from pot
*** SUMMARY ***
Total pot 1372 | Rake 75 
Board [4s Ts Ah 7h 3c]
Seat 1: manon327 folded on the Flop
Seat 2: HighCardJasper (button) folded on the Flop
Seat 3: FantasticDouble (small blind) folded on the Flop
Seat 6: color_singleton (big blind) mucked [4d 5s]
Seat 9: dhduncan showed [As 6d] and won (1297) with a pair of Aces



PokerStars Home Game Hand #222895991620: {DaPokaStars}  Hold'em No Limit (50/100) - 2021/01/21 17:09:55 ET
Table 'testnsdfgh' 9-max (Play Money) Seat #3 is the button
Seat 1: manon327 (12215 in chips) 
Seat 2: HighCardJasper (22127 in chips) 
Seat 3: FantasticDouble (13707 in chips) 
Seat 6: color_singleton (25106 in chips) 
Seat 9: dhduncan (11562 in chips) 
color_singleton: posts small blind 50
dhduncan: posts big blind 100
*** HOLE CARDS ***
Dealt to FantasticDouble [Qc Kh]
manon327: calls 100
HighCardJasper: calls 100
FantasticDouble: raises 400 to 500
color_singleton: folds 
dhduncan: calls 400
manon327: calls 400
HighCardJasper: folds 
*** FLOP *** [Js Jd Ts]
dhduncan: bets 100
manon327: calls 100
FantasticDouble: raises 600 to 700
dhduncan: calls 600
manon327: folds 
*** TURN *** [Js Jd Ts] [6h]
dhduncan: checks 
FantasticDouble: bets 1200
dhduncan: folds 
Uncalled bet (1200) returned to FantasticDouble
FantasticDouble collected 2977 from pot
*** SUMMARY ***
Total pot 3150 | Rake 173 
Board [Js Jd Ts 6h]
Seat 1: manon327 folded on the Flop
Seat 2: HighCardJasper folded before Flop
Seat 3: FantasticDouble (button) collected (2977)
Seat 6: color_singleton (small blind) folded before Flop
Seat 9: dhduncan (big blind) folded on the Turn



PokerStars Home Game Hand #222896035819: {DaPokaStars}  Hold'em No Limit (50/100) - 2021/01/21 17:10:51 ET
Table 'testnsdfgh' 9-max (Play Money) Seat #6 is the button
Seat 1: manon327 (11615 in chips) 
Seat 2: HighCardJasper (22027 in chips) 
Seat 3: FantasticDouble (15484 in chips) 
Seat 6: color_singleton (25056 in chips) 
Seat 9: dhduncan (10362 in chips) 
dhduncan: posts small blind 50
manon327: posts big blind 100
*** HOLE CARDS ***
Dealt to FantasticDouble [4d Ts]
HighCardJasper: folds 
FantasticDouble: folds 
color_singleton: raises 200 to 300
dhduncan: folds 
manon327: folds 
Uncalled bet (200) returned to color_singleton
color_singleton collected 250 from pot
color_singleton: doesn't show hand 
*** SUMMARY ***
Total pot 250 | Rake 0 
Seat 1: manon327 (big blind) folded before Flop
Seat 2: HighCardJasper folded before Flop (didn't bet)
Seat 3: FantasticDouble folded before Flop (didn't bet)
Seat 6: color_singleton (button) collected (250)
Seat 9: dhduncan (small blind) folded before Flop



PokerStars Home Game Hand #222896040687: {DaPokaStars}  Hold'em No Limit (50/100) - 2021/01/21 17:10:58 ET
Table 'testnsdfgh' 9-max (Play Money) Seat #9 is the button
Seat 1: manon327 (11515 in chips) 
Seat 2: HighCardJasper (22027 in chips) 
Seat 3: FantasticDouble (15484 in chips) 
Seat 6: color_singleton (25206 in chips) 
Seat 9: dhduncan (10312 in chips) 
manon327: posts small blind 50
HighCardJasper: posts big blind 100
*** HOLE CARDS ***
Dealt to FantasticDouble [Qs Jd]
FantasticDouble: raises 200 to 300
color_singleton: folds 
dhduncan: calls 300
manon327: calls 250
HighCardJasper: folds 
*** FLOP *** [Qh 5d Kc]
manon327: checks 
FantasticDouble: bets 500
dhduncan: calls 500
manon327: folds 
*** TURN *** [Qh 5d Kc] [2s]
FantasticDouble: bets 1000
dhduncan: folds 
Uncalled bet (1000) returned to FantasticDouble
FantasticDouble collected 1890 from pot
*** SUMMARY ***
Total pot 2000 | Rake 110 
Board [Qh 5d Kc 2s]
Seat 1: manon327 (small blind) folded on the Flop
Seat 2: HighCardJasper (big blind) folded before Flop
Seat 3: FantasticDouble collected (1890)
Seat 6: color_singleton folded before Flop (didn't bet)
Seat 9: dhduncan (button) folded on the Turn



PokerStars Home Game Hand #222896066677: {DaPokaStars}  Hold'em No Limit (50/100) - 2021/01/21 17:11:37 ET
Table 'testnsdfgh' 9-max (Play Money) Seat #1 is the button
Seat 1: manon327 (11215 in chips) 
Seat 2: HighCardJasper (21927 in chips) 
Seat 3: FantasticDouble (16574 in chips) 
Seat 6: color_singleton (25206 in chips) 
Seat 9: dhduncan (9512 in chips) 
HighCardJasper: posts small blind 50
FantasticDouble: posts big blind 100
*** HOLE CARDS ***
Dealt to FantasticDouble [Jd 5d]
color_singleton: folds 
dhduncan: calls 100
manon327: calls 100
HighCardJasper: calls 50
FantasticDouble: checks 
*** FLOP *** [Jc Ac 9h]
HighCardJasper: checks 
FantasticDouble: checks 
dhduncan: checks 
manon327: checks 
*** TURN *** [Jc Ac 9h] [Ks]
HighCardJasper: checks 
FantasticDouble: checks 
dhduncan: checks 
manon327: checks 
*** RIVER *** [Jc Ac 9h Ks] [Qc]
HighCardJasper: bets 200
FantasticDouble: folds 
dhduncan: calls 200
manon327: folds 
*** SHOW DOWN ***
HighCardJasper: shows [Qh 4s] (a pair of Queens)
dhduncan: shows [2c Qd] (a pair of Queens)
HighCardJasper collected 378 from pot
dhduncan collected 378 from pot
*** SUMMARY ***
Total pot 800 | Rake 44 
Board [Jc Ac 9h Ks Qc]
Seat 1: manon327 (button) folded on the River
Seat 2: HighCardJasper (small blind) showed [Qh 4s] and won (378) with a pair of Queens
Seat 3: FantasticDouble (big blind) folded on the River
Seat 6: color_singleton folded before Flop (didn't bet)
Seat 9: dhduncan showed [2c Qd] and won (378) with a pair of Queens



PokerStars Home Game Hand #222896094678: {DaPokaStars}  Hold'em No Limit (50/100) - 2021/01/21 17:12:19 ET
Table 'testnsdfgh' 9-max (Play Money) Seat #2 is the button
Seat 1: manon327 (11115 in chips) 
Seat 2: HighCardJasper (22005 in chips) 
Seat 3: FantasticDouble (16474 in chips) 
Seat 6: color_singleton (25206 in chips) 
Seat 9: dhduncan (9590 in chips) 
FantasticDouble: posts small blind 50
color_singleton: posts big blind 100
*** HOLE CARDS ***
Dealt to FantasticDouble [6h Ks]
dhduncan: folds 
manon327: calls 100
HighCardJasper: folds 
FantasticDouble: calls 50
color_singleton: checks 
*** FLOP *** [Qd 5h 4s]
FantasticDouble: checks 
color_singleton: checks 
manon327: checks 
*** TURN *** [Qd 5h 4s] [Kc]
FantasticDouble: bets 300
color_singleton: calls 300
manon327: calls 300
*** RIVER *** [Qd 5h 4s Kc] [As]
FantasticDouble: checks 
color_singleton: checks 
manon327: checks 
*** SHOW DOWN ***
FantasticDouble: shows [6h Ks] (a pair of Kings)
color_singleton: shows [9c Kh] (a pair of Kings - Ace+Queen+Nine kicker)
manon327: mucks hand 
color_singleton collected 1134 from pot
*** SUMMARY ***
Total pot 1200 | Rake 66 
Board [Qd 5h 4s Kc As]
Seat 1: manon327 mucked [3c 3d]
Seat 2: HighCardJasper (button) folded before Flop (didn't bet)
Seat 3: FantasticDouble (small blind) showed [6h Ks] and lost with a pair of Kings
Seat 6: color_singleton (big blind) showed [9c Kh] and won (1134) with a pair of Kings
Seat 9: dhduncan folded before Flop (didn't bet)



PokerStars Home Game Hand #222896129735: {DaPokaStars}  Hold'em No Limit (50/100) - 2021/01/21 17:13:11 ET
Table 'testnsdfgh' 9-max (Play Money) Seat #3 is the button
Seat 1: manon327 (10715 in chips) 
Seat 2: HighCardJasper (22005 in chips) 
Seat 3: FantasticDouble (16074 in chips) 
Seat 6: color_singleton (25940 in chips) 
Seat 9: dhduncan (9590 in chips) 
color_singleton: posts small blind 50
dhduncan: posts big blind 100
*** HOLE CARDS ***
Dealt to FantasticDouble [Jc Ts]
manon327: folds 
HighCardJasper: folds 
FantasticDouble: raises 300 to 400
color_singleton: calls 350
dhduncan: calls 300
*** FLOP *** [7d 7h 6s]
color_singleton: checks 
dhduncan: checks 
FantasticDouble: checks 
*** TURN *** [7d 7h 6s] [Qh]
color_singleton: checks 
dhduncan: checks 
FantasticDouble: checks 
*** RIVER *** [7d 7h 6s Qh] [9s]
color_singleton: checks 
dhduncan: checks 
FantasticDouble: checks 
*** SHOW DOWN ***
color_singleton: shows [8s Kh] (a pair of Sevens)
dhduncan: shows [Ah 9c] (two pair, Nines and Sevens)
FantasticDouble: mucks hand 
dhduncan collected 1134 from pot
*** SUMMARY ***
Total pot 1200 | Rake 66 
Board [7d 7h 6s Qh 9s]
Seat 1: manon327 folded before Flop (didn't bet)
Seat 2: HighCardJasper folded before Flop (didn't bet)
Seat 3: FantasticDouble (button) mucked [Jc Ts]
Seat 6: color_singleton (small blind) showed [8s Kh] and lost with a pair of Sevens
Seat 9: dhduncan (big blind) showed [Ah 9c] and won (1134) with two pair, Nines and Sevens



PokerStars Home Game Hand #222896158093: {DaPokaStars}  Hold'em No Limit (50/100) - 2021/01/21 17:13:54 ET
Table 'testnsdfgh' 9-max (Play Money) Seat #6 is the button
Seat 1: manon327 (10715 in chips) 
Seat 2: HighCardJasper (22005 in chips) 
Seat 3: FantasticDouble (15674 in chips) 
Seat 6: color_singleton (25540 in chips) 
Seat 9: dhduncan (10324 in chips) 
dhduncan: posts small blind 50
manon327: posts big blind 100
*** HOLE CARDS ***
Dealt to FantasticDouble [9c 6h]
HighCardJasper: calls 100
FantasticDouble: folds 
color_singleton: calls 100
dhduncan: calls 50
manon327: checks 
*** FLOP *** [5s 4d 4s]
dhduncan: checks 
manon327: checks 
HighCardJasper: checks 
color_singleton: checks 
*** TURN *** [5s 4d 4s] [Kh]
dhduncan: checks 
manon327: checks 
HighCardJasper: checks 
color_singleton: checks 
*** RIVER *** [5s 4d 4s Kh] [6d]
dhduncan: checks 
manon327: checks 
HighCardJasper: checks 
color_singleton: checks 
*** SHOW DOWN ***
dhduncan: shows [6s Ts] (two pair, Sixes and Fours)
manon327: mucks hand 
HighCardJasper: mucks hand 
color_singleton: mucks hand 
dhduncan collected 378 from pot
*** SUMMARY ***
Total pot 400 | Rake 22 
Board [5s 4d 4s Kh 6d]
Seat 1: manon327 (big blind) mucked [8h 2d]
Seat 2: HighCardJasper mucked [7s Jc]
Seat 3: FantasticDouble folded before Flop (didn't bet)
Seat 6: color_singleton (button) mucked [Qs Td]
Seat 9: dhduncan (small blind) showed [6s Ts] and won (378) with two pair, Sixes and Fours



PokerStars Home Game Hand #222896187829: {DaPokaStars}  Hold'em No Limit (50/100) - 2021/01/21 17:14:39 ET
Table 'testnsdfgh' 9-max (Play Money) Seat #9 is the button
Seat 1: manon327 (10615 in chips) 
Seat 2: HighCardJasper (21905 in chips) 
Seat 3: FantasticDouble (15674 in chips) 
Seat 6: color_singleton (25440 in chips) 
Seat 9: dhduncan (10602 in chips) 
manon327: posts small blind 50
HighCardJasper: posts big blind 100
*** HOLE CARDS ***
Dealt to FantasticDouble [Jc 4c]
FantasticDouble: folds 
color_singleton: raises 100 to 200
dhduncan: calls 200
manon327: calls 150
HighCardJasper: calls 100
*** FLOP *** [Kd 2s Ts]
manon327: checks 
HighCardJasper: checks 
color_singleton: bets 378
dhduncan: folds 
manon327: folds 
HighCardJasper: folds 
Uncalled bet (378) returned to color_singleton
color_singleton collected 756 from pot
color_singleton: doesn't show hand 
*** SUMMARY ***
Total pot 800 | Rake 44 
Board [Kd 2s Ts]
Seat 1: manon327 (small blind) folded on the Flop
Seat 2: HighCardJasper (big blind) folded on the Flop
Seat 3: FantasticDouble folded before Flop (didn't bet)
Seat 6: color_singleton collected (756)
Seat 9: dhduncan (button) folded on the Flop



PokerStars Home Game Hand #222896207357: {DaPokaStars}  Hold'em No Limit (50/100) - 2021/01/21 17:15:08 ET
Table 'testnsdfgh' 9-max (Play Money) Seat #1 is the button
Seat 1: manon327 (10415 in chips) 
Seat 2: HighCardJasper (21705 in chips) 
Seat 3: FantasticDouble (15674 in chips) 
Seat 6: color_singleton (25996 in chips) 
Seat 9: dhduncan (10402 in chips) 
HighCardJasper: posts small blind 50
FantasticDouble: posts big blind 100
*** HOLE CARDS ***
Dealt to FantasticDouble [8c 2s]
color_singleton: raises 200 to 300
dhduncan: folds 
manon327: folds 
HighCardJasper: calls 250
FantasticDouble: folds 
*** FLOP *** [Qh Td Js]
HighCardJasper: checks 
color_singleton: bets 330
HighCardJasper: folds 
Uncalled bet (330) returned to color_singleton
color_singleton collected 661 from pot
color_singleton: doesn't show hand 
*** SUMMARY ***
Total pot 700 | Rake 39 
Board [Qh Td Js]
Seat 1: manon327 (button) folded before Flop (didn't bet)
Seat 2: HighCardJasper (small blind) folded on the Flop
Seat 3: FantasticDouble (big blind) folded before Flop
Seat 6: color_singleton collected (661)
Seat 9: dhduncan folded before Flop (didn't bet)



PokerStars Home Game Hand #222896220957: {DaPokaStars}  Hold'em No Limit (50/100) - 2021/01/21 17:15:28 ET
Table 'testnsdfgh' 9-max (Play Money) Seat #2 is the button
Seat 1: manon327 (10415 in chips) 
Seat 2: HighCardJasper (21405 in chips) 
Seat 3: FantasticDouble (15574 in chips) 
Seat 6: color_singleton (26357 in chips) 
Seat 9: dhduncan (10402 in chips) 
FantasticDouble: posts small blind 50
color_singleton: posts big blind 100
*** HOLE CARDS ***
Dealt to FantasticDouble [3s 9h]
dhduncan: folds 
manon327: folds 
HighCardJasper: calls 100
FantasticDouble: calls 50
color_singleton: checks 
*** FLOP *** [Js Qh 5d]
FantasticDouble: checks 
color_singleton: bets 141
HighCardJasper: raises 141 to 282
FantasticDouble: folds 
color_singleton: calls 141
*** TURN *** [Js Qh 5d] [4h]
color_singleton: checks 
HighCardJasper: bets 300
color_singleton: calls 300
*** RIVER *** [Js Qh 5d 4h] [6s]
poorrick1338 leaves the table
color_singleton: checks 
HighCardJasper: bets 800
color_singleton: calls 800
*** SHOW DOWN ***
HighCardJasper: shows [Qc Jd] (two pair, Queens and Jacks)
color_singleton: mucks hand 
HighCardJasper collected 2895 from pot
*** SUMMARY ***
Total pot 3064 | Rake 169 
Board [Js Qh 5d 4h 6s]
Seat 1: manon327 folded before Flop (didn't bet)
Seat 2: HighCardJasper (button) showed [Qc Jd] and won (2895) with two pair, Queens and Jacks
Seat 3: FantasticDouble (small blind) folded on the Flop
Seat 6: color_singleton (big blind) mucked [Qd 2c]
Seat 9: dhduncan folded before Flop (didn't bet)



PokerStars Home Game Hand #222896256074: {DaPokaStars}  Hold'em No Limit (50/100) - 2021/01/21 17:16:22 ET
Table 'testnsdfgh' 9-max (Play Money) Seat #3 is the button
Seat 1: manon327 (10415 in chips) 
Seat 2: HighCardJasper (22818 in chips) 
Seat 3: FantasticDouble (15474 in chips) 
Seat 6: color_singleton (24875 in chips) 
Seat 9: dhduncan (10402 in chips) 
color_singleton: posts small blind 50
dhduncan: posts big blind 100
*** HOLE CARDS ***
Dealt to FantasticDouble [Js 3s]
manon327: folds 
HighCardJasper: calls 100
FantasticDouble: folds 
color_singleton: raises 200 to 300
dhduncan: folds 
HighCardJasper: calls 200
*** FLOP *** [Kd Kh Ah]
color_singleton: checks 
HighCardJasper: checks 
*** TURN *** [Kd Kh Ah] [4h]
color_singleton: bets 330
HighCardJasper: folds 
Uncalled bet (330) returned to color_singleton
color_singleton collected 661 from pot
color_singleton: doesn't show hand 
*** SUMMARY ***
Total pot 700 | Rake 39 
Board [Kd Kh Ah 4h]
Seat 1: manon327 folded before Flop (didn't bet)
Seat 2: HighCardJasper folded on the Turn
Seat 3: FantasticDouble (button) folded before Flop (didn't bet)
Seat 6: color_singleton (small blind) collected (661)
Seat 9: dhduncan (big blind) folded before Flop



PokerStars Home Game Hand #222896277327: {DaPokaStars}  Hold'em No Limit (50/100) - 2021/01/21 17:16:53 ET
Table 'testnsdfgh' 9-max (Play Money) Seat #6 is the button
Seat 1: manon327 (10415 in chips) 
Seat 2: HighCardJasper (22518 in chips) 
Seat 3: FantasticDouble (15474 in chips) 
Seat 6: color_singleton (25236 in chips) 
Seat 9: dhduncan (10302 in chips) 
dhduncan: posts small blind 50
manon327: posts big blind 100
*** HOLE CARDS ***
Dealt to FantasticDouble [2c Tc]
HighCardJasper: folds 
FantasticDouble: folds 
color_singleton: raises 200 to 300
dhduncan: calls 250
manon327: folds 
*** FLOP *** [5c 2d 4h]
dhduncan has timed out
dhduncan: checks 
color_singleton: checks 
*** TURN *** [5c 2d 4h] [7s]
dhduncan: checks 
color_singleton: checks 
*** RIVER *** [5c 2d 4h 7s] [3d]
dhduncan: checks 
color_singleton: checks 
*** SHOW DOWN ***
dhduncan: shows [Ad Th] (a straight, Ace to Five)
color_singleton: mucks hand 
dhduncan collected 661 from pot
*** SUMMARY ***
Total pot 700 | Rake 39 
Board [5c 2d 4h 7s 3d]
Seat 1: manon327 (big blind) folded before Flop
Seat 2: HighCardJasper folded before Flop (didn't bet)
Seat 3: FantasticDouble folded before Flop (didn't bet)
Seat 6: color_singleton (button) mucked [Ks 9h]
Seat 9: dhduncan (small blind) showed [Ad Th] and won (661) with a straight, Ace to Five



PokerStars Home Game Hand #222896318384: {DaPokaStars}  Hold'em No Limit (50/100) - 2021/01/21 17:17:55 ET
Table 'testnsdfgh' 9-max (Play Money) Seat #9 is the button
Seat 1: manon327 (10315 in chips) 
Seat 2: HighCardJasper (22518 in chips) 
Seat 3: FantasticDouble (15474 in chips) 
Seat 6: color_singleton (24936 in chips) 
Seat 9: dhduncan (10663 in chips) 
manon327: posts small blind 50
HighCardJasper: posts big blind 100
*** HOLE CARDS ***
Dealt to FantasticDouble [3h 3c]
FantasticDouble: raises 200 to 300
color_singleton: folds 
dhduncan: folds 
manon327: folds 
HighCardJasper: calls 200
*** FLOP *** [7c 8c Ad]
HighCardJasper: bets 200
FantasticDouble: calls 200
*** TURN *** [7c 8c Ad] [Qh]
HighCardJasper: bets 400
FantasticDouble: folds 
Uncalled bet (400) returned to HighCardJasper
HighCardJasper collected 992 from pot
HighCardJasper: doesn't show hand 
*** SUMMARY ***
Total pot 1050 | Rake 58 
Board [7c 8c Ad Qh]
Seat 1: manon327 (small blind) folded before Flop
Seat 2: HighCardJasper (big blind) collected (992)
Seat 3: FantasticDouble folded on the Turn
Seat 6: color_singleton folded before Flop (didn't bet)
Seat 9: dhduncan (button) folded before Flop (didn't bet)



PokerStars Home Game Hand #222896334552: {DaPokaStars}  Hold'em No Limit (50/100) - 2021/01/21 17:18:20 ET
Table 'testnsdfgh' 9-max (Play Money) Seat #1 is the button
Seat 1: manon327 (10265 in chips) 
Seat 2: HighCardJasper (23010 in chips) 
Seat 3: FantasticDouble (14974 in chips) 
Seat 6: color_singleton (24936 in chips) 
Seat 9: dhduncan (10663 in chips) 
HighCardJasper: posts small blind 50
FantasticDouble: posts big blind 100
*** HOLE CARDS ***
Dealt to FantasticDouble [Tc Qd]
color_singleton: raises 200 to 300
dhduncan: folds 
manon327: folds 
HighCardJasper: folds 
FantasticDouble: calls 200
*** FLOP *** [As 4s 5s]
FantasticDouble: checks 
color_singleton: bets 307
FantasticDouble: folds 
Uncalled bet (307) returned to color_singleton
color_singleton collected 614 from pot
color_singleton: doesn't show hand 
*** SUMMARY ***
Total pot 650 | Rake 36 
Board [As 4s 5s]
Seat 1: manon327 (button) folded before Flop (didn't bet)
Seat 2: HighCardJasper (small blind) folded before Flop
Seat 3: FantasticDouble (big blind) folded on the Flop
Seat 6: color_singleton collected (614)
Seat 9: dhduncan folded before Flop (didn't bet)



PokerStars Home Game Hand #222896347536: {DaPokaStars}  Hold'em No Limit (50/100) - 2021/01/21 17:18:40 ET
Table 'testnsdfgh' 9-max (Play Money) Seat #2 is the button
Seat 1: manon327 (10265 in chips) 
Seat 2: HighCardJasper (22960 in chips) 
Seat 3: FantasticDouble (14674 in chips) 
Seat 6: color_singleton (25250 in chips) 
Seat 9: dhduncan (10663 in chips) 
FantasticDouble: posts small blind 50
color_singleton: posts big blind 100
*** HOLE CARDS ***
Dealt to FantasticDouble [Qh 7h]
dhduncan: folds 
manon327: calls 100
HighCardJasper: raises 100 to 200
FantasticDouble: folds 
color_singleton: calls 100
manon327: calls 100
*** FLOP *** [8c 2c Th]
color_singleton: checks 
manon327: checks 
HighCardJasper: bets 200
color_singleton: folds 
manon327: folds 
Uncalled bet (200) returned to HighCardJasper
HighCardJasper collected 614 from pot
HighCardJasper: doesn't show hand 
*** SUMMARY ***
Total pot 650 | Rake 36 
Board [8c 2c Th]
Seat 1: manon327 folded on the Flop
Seat 2: HighCardJasper (button) collected (614)
Seat 3: FantasticDouble (small blind) folded before Flop
Seat 6: color_singleton (big blind) folded on the Flop
Seat 9: dhduncan folded before Flop (didn't bet)



PokerStars Home Game Hand #222896373437: {DaPokaStars}  Hold'em No Limit (50/100) - 2021/01/21 17:19:19 ET
Table 'testnsdfgh' 9-max (Play Money) Seat #3 is the button
Seat 1: manon327 (10065 in chips) 
Seat 2: HighCardJasper (23374 in chips) 
Seat 3: FantasticDouble (14624 in chips) 
Seat 6: color_singleton (25050 in chips) 
Seat 9: dhduncan (10663 in chips) 
color_singleton: posts small blind 50
dhduncan: posts big blind 100
*** HOLE CARDS ***
Dealt to FantasticDouble [Ts Ac]
manon327: folds 
HighCardJasper: calls 100
FantasticDouble: raises 300 to 400
color_singleton: folds 
dhduncan: folds 
HighCardJasper: folds 
Uncalled bet (300) returned to FantasticDouble
FantasticDouble collected 350 from pot
*** SUMMARY ***
Total pot 350 | Rake 0 
Seat 1: manon327 folded before Flop (didn't bet)
Seat 2: HighCardJasper folded before Flop
Seat 3: FantasticDouble (button) collected (350)
Seat 6: color_singleton (small blind) folded before Flop
Seat 9: dhduncan (big blind) folded before Flop



PokerStars Home Game Hand #222896386326: {DaPokaStars}  Hold'em No Limit (50/100) - 2021/01/21 17:19:39 ET
Table 'testnsdfgh' 9-max (Play Money) Seat #6 is the button
Seat 1: manon327 (10065 in chips) 
Seat 2: HighCardJasper (23274 in chips) 
Seat 3: FantasticDouble (14874 in chips) 
Seat 6: color_singleton (25000 in chips) 
Seat 9: dhduncan (10563 in chips) 
dhduncan: posts small blind 50
manon327: posts big blind 100
*** HOLE CARDS ***
Dealt to FantasticDouble [6s Tc]
HighCardJasper: calls 100
FantasticDouble: folds 
color_singleton: calls 100
dhduncan: folds 
manon327: checks 
*** FLOP *** [Th 2s 8h]
manon327: checks 
HighCardJasper: bets 200
color_singleton: folds 
manon327: folds 
Uncalled bet (200) returned to HighCardJasper
HighCardJasper collected 331 from pot
HighCardJasper: doesn't show hand 
*** SUMMARY ***
Total pot 350 | Rake 19 
Board [Th 2s 8h]
Seat 1: manon327 (big blind) folded on the Flop
Seat 2: HighCardJasper collected (331)
Seat 3: FantasticDouble folded before Flop (didn't bet)
Seat 6: color_singleton (button) folded on the Flop
Seat 9: dhduncan (small blind) folded before Flop



PokerStars Home Game Hand #222896399182: {DaPokaStars}  Hold'em No Limit (50/100) - 2021/01/21 17:19:59 ET
Table 'testnsdfgh' 9-max (Play Money) Seat #9 is the button
Seat 1: manon327 (9965 in chips) 
Seat 2: HighCardJasper (23505 in chips) 
Seat 3: FantasticDouble (14874 in chips) 
Seat 6: color_singleton (24900 in chips) 
Seat 9: dhduncan (10513 in chips) 
manon327: posts small blind 50
HighCardJasper: posts big blind 100
*** HOLE CARDS ***
Dealt to FantasticDouble [6h Qc]
FantasticDouble: folds 
color_singleton: raises 200 to 300
dhduncan: folds 
manon327: folds 
HighCardJasper: calls 200
*** FLOP *** [5c Ah Kd]
HighCardJasper: checks 
color_singleton: checks 
*** TURN *** [5c Ah Kd] [3c]
HighCardJasper: checks 
color_singleton: checks 
*** RIVER *** [5c Ah Kd 3c] [Td]
HighCardJasper: checks 
color_singleton: checks 
*** SHOW DOWN ***
HighCardJasper: shows [Qd 4h] (high card Ace)
color_singleton: shows [2h 2d] (a pair of Deuces)
color_singleton collected 614 from pot
*** SUMMARY ***
Total pot 650 | Rake 36 
Board [5c Ah Kd 3c Td]
Seat 1: manon327 (small blind) folded before Flop
Seat 2: HighCardJasper (big blind) showed [Qd 4h] and lost with high card Ace
Seat 3: FantasticDouble folded before Flop (didn't bet)
Seat 6: color_singleton showed [2h 2d] and won (614) with a pair of Deuces
Seat 9: dhduncan (button) folded before Flop (didn't bet)



PokerStars Home Game Hand #222896414410: {DaPokaStars}  Hold'em No Limit (50/100) - 2021/01/21 17:20:22 ET
Table 'testnsdfgh' 9-max (Play Money) Seat #1 is the button
Seat 1: manon327 (9915 in chips) 
Seat 2: HighCardJasper (23205 in chips) 
Seat 3: FantasticDouble (14874 in chips) 
Seat 6: color_singleton (25214 in chips) 
Seat 9: dhduncan (10513 in chips) 
HighCardJasper: posts small blind 50
FantasticDouble: posts big blind 100
*** HOLE CARDS ***
Dealt to FantasticDouble [Qs 3s]
color_singleton: folds 
dhduncan: folds 
manon327: calls 100
HighCardJasper: calls 50
FantasticDouble: checks 
*** FLOP *** [Qc 8s 6h]
HighCardJasper: checks 
FantasticDouble: bets 300
manon327: calls 300
HighCardJasper: folds 
*** TURN *** [Qc 8s 6h] [7d]
FantasticDouble: checks 
manon327: checks 
*** RIVER *** [Qc 8s 6h 7d] [3d]
FantasticDouble: bets 700
manon327: folds 
Uncalled bet (700) returned to FantasticDouble
FantasticDouble collected 850 from pot
*** SUMMARY ***
Total pot 900 | Rake 50 
Board [Qc 8s 6h 7d 3d]
Seat 1: manon327 (button) folded on the River
Seat 2: HighCardJasper (small blind) folded on the Flop
Seat 3: FantasticDouble (big blind) collected (850)
Seat 6: color_singleton folded before Flop (didn't bet)
Seat 9: dhduncan folded before Flop (didn't bet)



PokerStars Home Game Hand #222896442819: {DaPokaStars}  Hold'em No Limit (50/100) - 2021/01/21 17:21:05 ET
Table 'testnsdfgh' 9-max (Play Money) Seat #2 is the button
Seat 1: manon327 (9515 in chips) 
Seat 2: HighCardJasper (23105 in chips) 
Seat 3: FantasticDouble (15324 in chips) 
Seat 6: color_singleton (25214 in chips) 
Seat 9: dhduncan (10513 in chips) 
FantasticDouble: posts small blind 50
color_singleton: posts big blind 100
*** HOLE CARDS ***
Dealt to FantasticDouble [Jh 9s]
dhduncan: calls 100
manon327: calls 100
HighCardJasper: folds 
FantasticDouble: calls 50
color_singleton: checks 
*** FLOP *** [9d 7s 9c]
FantasticDouble: checks 
color_singleton: checks 
dhduncan: checks 
manon327: checks 
*** TURN *** [9d 7s 9c] [8c]
FantasticDouble: bets 300
color_singleton: folds 
dhduncan: calls 300
manon327: folds 
*** RIVER *** [9d 7s 9c 8c] [9h]
FantasticDouble: bets 800
dhduncan: raises 800 to 1600
FantasticDouble: raises 1800 to 3400
dhduncan: calls 1800
*** SHOW DOWN ***
FantasticDouble: shows [Jh 9s] (four of a kind, Nines)
dhduncan: mucks hand 
FantasticDouble collected 7371 from pot
*** SUMMARY ***
Total pot 7800 | Rake 429 
Board [9d 7s 9c 8c 9h]
Seat 1: manon327 folded on the Turn
Seat 2: HighCardJasper (button) folded before Flop (didn't bet)
Seat 3: FantasticDouble (small blind) showed [Jh 9s] and won (7371) with four of a kind, Nines
Seat 6: color_singleton (big blind) folded on the Turn
Seat 9: dhduncan mucked [8h Js]



PokerStars Home Game Hand #222896472559: {DaPokaStars}  Hold'em No Limit (50/100) - 2021/01/21 17:21:51 ET
Table 'testnsdfgh' 9-max (Play Money) Seat #3 is the button
Seat 1: manon327 (9415 in chips) 
Seat 2: HighCardJasper (23105 in chips) 
Seat 3: FantasticDouble (18895 in chips) 
Seat 6: color_singleton (25114 in chips) 
Seat 9: dhduncan (6713 in chips) 
color_singleton: posts small blind 50
dhduncan: posts big blind 100
*** HOLE CARDS ***
Dealt to FantasticDouble [As 5s]
manon327: calls 100
HighCardJasper: calls 100
FantasticDouble: raises 300 to 400
color_singleton: folds 
dhduncan: calls 300
manon327: calls 300
HighCardJasper: folds 
*** FLOP *** [3d Kc 4d]
dhduncan: checks 
manon327: checks 
FantasticDouble: checks 
*** TURN *** [3d Kc 4d] [Tc]
dhduncan: checks 
manon327: bets 400
FantasticDouble: folds 
dhduncan: folds 
Uncalled bet (400) returned to manon327
manon327 collected 1276 from pot
*** SUMMARY ***
Total pot 1350 | Rake 74 
Board [3d Kc 4d Tc]
Seat 1: manon327 collected (1276)
Seat 2: HighCardJasper folded before Flop
Seat 3: FantasticDouble (button) folded on the Turn
Seat 6: color_singleton (small blind) folded before Flop
Seat 9: dhduncan (big blind) folded on the Turn



PokerStars Home Game Hand #222896505812: {DaPokaStars}  Hold'em No Limit (50/100) - 2021/01/21 17:22:42 ET
Table 'testnsdfgh' 9-max (Play Money) Seat #6 is the button
Seat 1: manon327 (10291 in chips) 
Seat 2: HighCardJasper (23005 in chips) 
Seat 3: FantasticDouble (18495 in chips) 
Seat 6: color_singleton (25064 in chips) 
Seat 9: dhduncan (6313 in chips) 
dhduncan: posts small blind 50
manon327: posts big blind 100
*** HOLE CARDS ***
Dealt to FantasticDouble [9c 4c]
HighCardJasper: calls 100
FantasticDouble: folds 
color_singleton: calls 100
dhduncan: calls 50
manon327: checks 
*** FLOP *** [8h 7h Kh]
dhduncan: checks 
manon327: checks 
HighCardJasper: checks 
color_singleton: bets 189
dhduncan: folds 
manon327: calls 189
HighCardJasper: folds 
*** TURN *** [8h 7h Kh] [6s]
manon327: bets 735
color_singleton: calls 735
*** RIVER *** [8h 7h Kh 6s] [Tc]
manon327: checks 
color_singleton: checks 
*** SHOW DOWN ***
manon327: shows [4d 5d] (a straight, Four to Eight)
color_singleton: mucks hand 
manon327 collected 2124 from pot
*** SUMMARY ***
Total pot 2248 | Rake 124 
Board [8h 7h Kh 6s Tc]
Seat 1: manon327 (big blind) showed [4d 5d] and won (2124) with a straight, Four to Eight
Seat 2: HighCardJasper folded on the Flop
Seat 3: FantasticDouble folded before Flop (didn't bet)
Seat 6: color_singleton (button) mucked [8d 6d]
Seat 9: dhduncan (small blind) folded on the Flop



PokerStars Home Game Hand #222896535966: {DaPokaStars}  Hold'em No Limit (50/100) - 2021/01/21 17:23:28 ET
Table 'testnsdfgh' 9-max (Play Money) Seat #9 is the button
Seat 1: manon327 (11391 in chips) 
Seat 2: HighCardJasper (22905 in chips) 
Seat 3: FantasticDouble (18495 in chips) 
Seat 6: color_singleton (24040 in chips) 
Seat 9: dhduncan (6213 in chips) 
manon327: posts small blind 50
HighCardJasper: posts big blind 100
*** HOLE CARDS ***
Dealt to FantasticDouble [8s 6h]
FantasticDouble: folds 
color_singleton: calls 100
dhduncan: calls 100
manon327: folds 
HighCardJasper: checks 
*** FLOP *** [6s 8c 9d]
HighCardJasper: checks 
color_singleton: checks 
dhduncan has timed out
dhduncan: checks 
*** TURN *** [6s 8c 9d] [Js]
HighCardJasper: checks 
color_singleton: checks 
dhduncan: checks 
*** RIVER *** [6s 8c 9d Js] [Kc]
HighCardJasper: checks 
color_singleton: checks 
dhduncan: bets 100
HighCardJasper: folds 
color_singleton: folds 
Uncalled bet (100) returned to dhduncan
dhduncan collected 331 from pot
dhduncan: doesn't show hand 
*** SUMMARY ***
Total pot 350 | Rake 19 
Board [6s 8c 9d Js Kc]
Seat 1: manon327 (small blind) folded before Flop
Seat 2: HighCardJasper (big blind) folded on the River
Seat 3: FantasticDouble folded before Flop (didn't bet)
Seat 6: color_singleton folded on the River
Seat 9: dhduncan (button) collected (331)



PokerStars Home Game Hand #222896575761: {DaPokaStars}  Hold'em No Limit (50/100) - 2021/01/21 17:24:30 ET
Table 'testnsdfgh' 9-max (Play Money) Seat #1 is the button
Seat 1: manon327 (11341 in chips) 
Seat 2: HighCardJasper (22805 in chips) 
Seat 3: FantasticDouble (18495 in chips) 
Seat 6: color_singleton (23940 in chips) 
Seat 9: dhduncan (6444 in chips) 
HighCardJasper: posts small blind 50
FantasticDouble: posts big blind 100
*** HOLE CARDS ***
Dealt to FantasticDouble [2h 8c]
color_singleton: folds 
dhduncan: folds 
manon327: folds 
HighCardJasper: calls 50
FantasticDouble: checks 
*** FLOP *** [7s Qh 3c]
HighCardJasper: bets 100
FantasticDouble: folds 
Uncalled bet (100) returned to HighCardJasper
HighCardJasper collected 189 from pot
HighCardJasper: doesn't show hand 
*** SUMMARY ***
Total pot 200 | Rake 11 
Board [7s Qh 3c]
Seat 1: manon327 (button) folded before Flop (didn't bet)
Seat 2: HighCardJasper (small blind) collected (189)
Seat 3: FantasticDouble (big blind) folded on the Flop
Seat 6: color_singleton folded before Flop (didn't bet)
Seat 9: dhduncan folded before Flop (didn't bet)



PokerStars Home Game Hand #222896591205: {DaPokaStars}  Hold'em No Limit (50/100) - 2021/01/21 17:24:54 ET
Table 'testnsdfgh' 9-max (Play Money) Seat #2 is the button
Seat 1: manon327 (11341 in chips) 
Seat 2: HighCardJasper (22894 in chips) 
Seat 3: FantasticDouble (18395 in chips) 
Seat 6: color_singleton (23940 in chips) 
Seat 9: dhduncan (6444 in chips) 
FantasticDouble: posts small blind 50
color_singleton: posts big blind 100
*** HOLE CARDS ***
Dealt to FantasticDouble [5c Ah]
dhduncan: folds 
manon327: folds 
HighCardJasper: calls 100
FantasticDouble: calls 50
color_singleton: checks 
*** FLOP *** [4h Td Qd]
FantasticDouble: checks 
color_singleton: bets 141
HighCardJasper: calls 141
FantasticDouble: folds 
*** TURN *** [4h Td Qd] [7s]
color_singleton: checks 
HighCardJasper: bets 300
color_singleton: calls 300
*** RIVER *** [4h Td Qd 7s] [2c]
color_singleton: checks 
HighCardJasper: bets 600
color_singleton: calls 600
*** SHOW DOWN ***
HighCardJasper: shows [Qc Ks] (a pair of Queens)
color_singleton: mucks hand 
HighCardJasper collected 2251 from pot
*** SUMMARY ***
Total pot 2382 | Rake 131 
Board [4h Td Qd 7s 2c]
Seat 1: manon327 folded before Flop (didn't bet)
Seat 2: HighCardJasper (button) showed [Qc Ks] and won (2251) with a pair of Queens
Seat 3: FantasticDouble (small blind) folded on the Flop
Seat 6: color_singleton (big blind) mucked [Ts 3d]
Seat 9: dhduncan folded before Flop (didn't bet)



PokerStars Home Game Hand #222896629898: {DaPokaStars}  Hold'em No Limit (50/100) - 2021/01/21 17:25:54 ET
Table 'testnsdfgh' 9-max (Play Money) Seat #3 is the button
Seat 1: manon327 (11341 in chips) 
Seat 2: HighCardJasper (24004 in chips) 
Seat 3: FantasticDouble (18295 in chips) 
Seat 6: color_singleton (22799 in chips) 
Seat 9: dhduncan (6444 in chips) 
color_singleton: posts small blind 50
dhduncan: posts big blind 100
*** HOLE CARDS ***
Dealt to FantasticDouble [4s 2h]
manon327: calls 100
HighCardJasper: folds 
FantasticDouble: folds 
color_singleton: calls 50
dhduncan: checks 
*** FLOP *** [5d 7h 4d]
color_singleton: bets 283
dhduncan: folds 
manon327: raises 283 to 566
color_singleton: calls 283
*** TURN *** [5d 7h 4d] [Tc]
color_singleton: checks 
manon327: bets 676
color_singleton: folds 
Uncalled bet (676) returned to manon327
manon327 collected 1353 from pot
*** SUMMARY ***
Total pot 1432 | Rake 79 
Board [5d 7h 4d Tc]
Seat 1: manon327 collected (1353)
Seat 2: HighCardJasper folded before Flop (didn't bet)
Seat 3: FantasticDouble (button) folded before Flop (didn't bet)
Seat 6: color_singleton (small blind) folded on the Turn
Seat 9: dhduncan (big blind) folded on the Flop



PokerStars Home Game Hand #222896652466: {DaPokaStars}  Hold'em No Limit (50/100) - 2021/01/21 17:26:29 ET
Table 'testnsdfgh' 9-max (Play Money) Seat #6 is the button
Seat 1: manon327 (12028 in chips) 
Seat 2: HighCardJasper (24004 in chips) 
Seat 3: FantasticDouble (18295 in chips) 
Seat 6: color_singleton (22133 in chips) 
Seat 9: dhduncan (6344 in chips) 
dhduncan: posts small blind 50
manon327: posts big blind 100
*** HOLE CARDS ***
Dealt to FantasticDouble [9h 9s]
HighCardJasper: calls 100
FantasticDouble: raises 300 to 400
color_singleton: folds 
dhduncan: folds 
manon327: folds 
HighCardJasper: calls 300
*** FLOP *** [Jc Tc 5s]
HighCardJasper: bets 600
FantasticDouble: calls 600
*** TURN *** [Jc Tc 5s] [7h]
HighCardJasper: checks 
FantasticDouble: bets 1200
HighCardJasper: calls 1200
*** RIVER *** [Jc Tc 5s 7h] [Kd]
HighCardJasper: bets 2000
FantasticDouble: folds 
Uncalled bet (2000) returned to HighCardJasper
HighCardJasper collected 4300 from pot
HighCardJasper: doesn't show hand 
*** SUMMARY ***
Total pot 4550 | Rake 250 
Board [Jc Tc 5s 7h Kd]
Seat 1: manon327 (big blind) folded before Flop
Seat 2: HighCardJasper collected (4300)
Seat 3: FantasticDouble folded on the River
Seat 6: color_singleton (button) folded before Flop (didn't bet)
Seat 9: dhduncan (small blind) folded before Flop



PokerStars Home Game Hand #222896690470: {DaPokaStars}  Hold'em No Limit (50/100) - 2021/01/21 17:27:28 ET
Table 'testnsdfgh' 9-max (Play Money) Seat #9 is the button
Seat 1: manon327 (11928 in chips) 
Seat 2: HighCardJasper (26104 in chips) 
Seat 3: FantasticDouble (16095 in chips) 
Seat 6: color_singleton (22133 in chips) 
Seat 9: dhduncan (6294 in chips) 
manon327: posts small blind 50
HighCardJasper: posts big blind 100
*** HOLE CARDS ***
Dealt to FantasticDouble [Qd 4d]
FantasticDouble: folds 
color_singleton: raises 200 to 300
dhduncan: folds 
manon327: folds 
HighCardJasper: calls 200
*** FLOP *** [4s 4h Kh]
HighCardJasper: checks 
color_singleton: checks 
*** TURN *** [4s 4h Kh] [3c]
HighCardJasper: checks 
color_singleton: checks 
*** RIVER *** [4s 4h Kh 3c] [Ts]
HighCardJasper: bets 100
color_singleton: calls 100
*** SHOW DOWN ***
HighCardJasper: shows [6h Jc] (a pair of Fours)
color_singleton: shows [Ac 6c] (a pair of Fours - Ace kicker)
color_singleton collected 803 from pot
*** SUMMARY ***
Total pot 850 | Rake 47 
Board [4s 4h Kh 3c Ts]
Seat 1: manon327 (small blind) folded before Flop
Seat 2: HighCardJasper (big blind) showed [6h Jc] and lost with a pair of Fours
Seat 3: FantasticDouble folded before Flop (didn't bet)
Seat 6: color_singleton showed [Ac 6c] and won (803) with a pair of Fours
Seat 9: dhduncan (button) folded before Flop (didn't bet)



PokerStars Home Game Hand #222896716731: {DaPokaStars}  Hold'em No Limit (50/100) - 2021/01/21 17:28:09 ET
Table 'testnsdfgh' 9-max (Play Money) Seat #1 is the button
Seat 1: manon327 (11878 in chips) 
Seat 2: HighCardJasper (25704 in chips) 
Seat 3: FantasticDouble (16095 in chips) 
Seat 6: color_singleton (22536 in chips) 
Seat 9: dhduncan (6294 in chips) 
HighCardJasper: posts small blind 50
FantasticDouble: posts big blind 100
*** HOLE CARDS ***
Dealt to FantasticDouble [6s Kh]
color_singleton: folds 
dhduncan: calls 100
manon327: folds 
HighCardJasper: raises 100 to 200
FantasticDouble: calls 100
dhduncan: calls 100
*** FLOP *** [Kd Jc 4s]
HighCardJasper: bets 200
FantasticDouble: raises 200 to 400
dhduncan: folds 
HighCardJasper: calls 200
*** TURN *** [Kd Jc 4s] [Js]
HighCardJasper: checks 
FantasticDouble: checks 
*** RIVER *** [Kd Jc 4s Js] [7c]
HighCardJasper: checks 
FantasticDouble: bets 700
HighCardJasper: folds 
Uncalled bet (700) returned to FantasticDouble
FantasticDouble collected 1323 from pot
*** SUMMARY ***
Total pot 1400 | Rake 77 
Board [Kd Jc 4s Js 7c]
Seat 1: manon327 (button) folded before Flop (didn't bet)
Seat 2: HighCardJasper (small blind) folded on the River
Seat 3: FantasticDouble (big blind) collected (1323)
Seat 6: color_singleton folded before Flop (didn't bet)
Seat 9: dhduncan folded on the Flop



PokerStars Home Game Hand #222896747316: {DaPokaStars}  Hold'em No Limit (50/100) - 2021/01/21 17:28:57 ET
Table 'testnsdfgh' 9-max (Play Money) Seat #2 is the button
Seat 1: manon327 (11878 in chips) 
Seat 2: HighCardJasper (25104 in chips) 
Seat 3: FantasticDouble (16818 in chips) 
Seat 6: color_singleton (22536 in chips) 
Seat 9: dhduncan (6094 in chips) 
FantasticDouble: posts small blind 50
color_singleton: posts big blind 100
*** HOLE CARDS ***
Dealt to FantasticDouble [3s Td]
dhduncan: folds 
manon327: calls 100
HighCardJasper: folds 
FantasticDouble: folds 
color_singleton: checks 
*** FLOP *** [5h 6s 2d]
color_singleton: checks 
manon327: checks 
*** TURN *** [5h 6s 2d] [8c]
color_singleton: bets 118
manon327: folds 
Uncalled bet (118) returned to color_singleton
color_singleton collected 236 from pot
color_singleton: doesn't show hand 
*** SUMMARY ***
Total pot 250 | Rake 14 
Board [5h 6s 2d 8c]
Seat 1: manon327 folded on the Turn
Seat 2: HighCardJasper (button) folded before Flop (didn't bet)
Seat 3: FantasticDouble (small blind) folded before Flop
Seat 6: color_singleton (big blind) collected (236)
Seat 9: dhduncan folded before Flop (didn't bet)



PokerStars Home Game Hand #222896765331: {DaPokaStars}  Hold'em No Limit (50/100) - 2021/01/21 17:29:25 ET
Table 'testnsdfgh' 9-max (Play Money) Seat #3 is the button
Seat 1: manon327 (11778 in chips) 
Seat 2: HighCardJasper (25104 in chips) 
Seat 3: FantasticDouble (16768 in chips) 
Seat 6: color_singleton (22672 in chips) 
Seat 9: dhduncan (6094 in chips) 
color_singleton: posts small blind 50
dhduncan: posts big blind 100
*** HOLE CARDS ***
Dealt to FantasticDouble [4h Jd]
manon327: calls 100
HighCardJasper: raises 100 to 200
FantasticDouble: folds 
color_singleton: folds 
dhduncan: calls 100
manon327: calls 100
*** FLOP *** [Ts 8d 5s]
dhduncan: bets 100
manon327: calls 100
HighCardJasper: calls 100
*** TURN *** [Ts 8d 5s] [5h]
dhduncan: checks 
manon327: checks 
HighCardJasper: checks 
*** RIVER *** [Ts 8d 5s 5h] [3h]
dhduncan: checks 
manon327: checks 
HighCardJasper: bets 300
dhduncan: folds 
manon327: folds 
Uncalled bet (300) returned to HighCardJasper
HighCardJasper collected 898 from pot
HighCardJasper: doesn't show hand 
*** SUMMARY ***
Total pot 950 | Rake 52 
Board [Ts 8d 5s 5h 3h]
Seat 1: manon327 folded on the River
Seat 2: HighCardJasper collected (898)
Seat 3: FantasticDouble (button) folded before Flop (didn't bet)
Seat 6: color_singleton (small blind) folded before Flop
Seat 9: dhduncan (big blind) folded on the River



PokerStars Home Game Hand #222896811616: {DaPokaStars}  Hold'em No Limit (50/100) - 2021/01/21 17:30:32 ET
Table 'testnsdfgh' 9-max (Play Money) Seat #6 is the button
Seat 1: manon327 (11478 in chips) 
Seat 2: HighCardJasper (25702 in chips) 
Seat 3: FantasticDouble (16768 in chips) 
Seat 6: color_singleton (22622 in chips) 
Seat 9: dhduncan (5794 in chips) 
dhduncan: posts small blind 50
manon327: posts big blind 100
*** HOLE CARDS ***
Dealt to FantasticDouble [8c 2s]
HighCardJasper: calls 100
FantasticDouble: folds 
color_singleton: calls 100
dhduncan: calls 50
manon327: raises 100 to 200
HighCardJasper: calls 100
color_singleton: calls 100
dhduncan: calls 100
*** FLOP *** [3c 8d 6d]
dhduncan: checks 
manon327: checks 
HighCardJasper: checks 
color_singleton: bets 756
dhduncan: calls 756
manon327: calls 756
HighCardJasper: folds 
*** TURN *** [3c 8d 6d] [2h]
dhduncan: checks 
manon327: checks 
color_singleton: bets 1449
dhduncan: folds 
manon327: folds 
Uncalled bet (1449) returned to color_singleton
color_singleton collected 2899 from pot
color_singleton: doesn't show hand 
*** SUMMARY ***
Total pot 3068 | Rake 169 
Board [3c 8d 6d 2h]
Seat 1: manon327 (big blind) folded on the Turn
Seat 2: HighCardJasper folded on the Flop
Seat 3: FantasticDouble folded before Flop (didn't bet)
Seat 6: color_singleton (button) collected (2899)
Seat 9: dhduncan (small blind) folded on the Turn



PokerStars Home Game Hand #222896848134: {DaPokaStars}  Hold'em No Limit (50/100) - 2021/01/21 17:31:29 ET
Table 'testnsdfgh' 9-max (Play Money) Seat #9 is the button
Seat 1: manon327 (10522 in chips) 
Seat 2: HighCardJasper (25502 in chips) 
Seat 3: FantasticDouble (16768 in chips) 
Seat 6: color_singleton (24565 in chips) 
Seat 9: dhduncan (4838 in chips) 
manon327: posts small blind 50
HighCardJasper: posts big blind 100
*** HOLE CARDS ***
Dealt to FantasticDouble [9h Ad]
FantasticDouble: raises 200 to 300
color_singleton: folds 
dhduncan: folds 
manon327: calls 250
HighCardJasper: folds 
*** FLOP *** [Tc Kd 2s]
manon327: checks 
FantasticDouble: checks 
*** TURN *** [Tc Kd 2s] [8d]
manon327: checks 
FantasticDouble: checks 
*** RIVER *** [Tc Kd 2s 8d] [4d]
manon327: checks 
FantasticDouble: checks 
*** SHOW DOWN ***
manon327: shows [6s 4s] (a pair of Fours)
FantasticDouble: mucks hand 
manon327 collected 661 from pot
*** SUMMARY ***
Total pot 700 | Rake 39 
Board [Tc Kd 2s 8d 4d]
Seat 1: manon327 (small blind) showed [6s 4s] and won (661) with a pair of Fours
Seat 2: HighCardJasper (big blind) folded before Flop
Seat 3: FantasticDouble mucked [9h Ad]
Seat 6: color_singleton folded before Flop (didn't bet)
Seat 9: dhduncan (button) folded before Flop (didn't bet)



PokerStars Home Game Hand #222896868522: {DaPokaStars}  Hold'em No Limit (50/100) - 2021/01/21 17:32:01 ET
Table 'testnsdfgh' 9-max (Play Money) Seat #1 is the button
Seat 1: manon327 (10883 in chips) 
Seat 2: HighCardJasper (25402 in chips) 
Seat 3: FantasticDouble (16468 in chips) 
Seat 6: color_singleton (24565 in chips) 
Seat 9: dhduncan (4838 in chips) 
HighCardJasper: posts small blind 50
FantasticDouble: posts big blind 100
*** HOLE CARDS ***
Dealt to FantasticDouble [3h 7s]
color_singleton: raises 200 to 300
dhduncan: calls 300
manon327: folds 
HighCardJasper: calls 250
FantasticDouble: folds 
*** FLOP *** [2c 4s 2d]
HighCardJasper: checks 
color_singleton: checks 
dhduncan: bets 200
HighCardJasper: calls 200
color_singleton: calls 200
*** TURN *** [2c 4s 2d] [Ks]
HighCardJasper: checks 
color_singleton: bets 900
dhduncan: calls 900
HighCardJasper: folds 
*** RIVER *** [2c 4s 2d Ks] [Tc]
color_singleton: bets 1200
dhduncan: calls 1200
*** SHOW DOWN ***
color_singleton: shows [Kh 7h] (two pair, Kings and Deuces)
dhduncan: shows [Ad Ah] (two pair, Aces and Deuces)
dhduncan collected 5481 from pot
*** SUMMARY ***
Total pot 5800 | Rake 319 
Board [2c 4s 2d Ks Tc]
Seat 1: manon327 (button) folded before Flop (didn't bet)
Seat 2: HighCardJasper (small blind) folded on the Turn
Seat 3: FantasticDouble (big blind) folded before Flop
Seat 6: color_singleton showed [Kh 7h] and lost with two pair, Kings and Deuces
Seat 9: dhduncan showed [Ad Ah] and won (5481) with two pair, Aces and Deuces



PokerStars Home Game Hand #222896918231: {DaPokaStars}  Hold'em No Limit (50/100) - 2021/01/21 17:33:20 ET
Table 'testnsdfgh' 9-max (Play Money) Seat #2 is the button
Seat 1: manon327 (10883 in chips) 
Seat 2: HighCardJasper (24902 in chips) 
Seat 3: FantasticDouble (16368 in chips) 
Seat 6: color_singleton (21965 in chips) 
Seat 9: dhduncan (7719 in chips) 
FantasticDouble: posts small blind 50
color_singleton: posts big blind 100
*** HOLE CARDS ***
Dealt to FantasticDouble [9d 6h]
dhduncan: folds 
manon327: folds 
HighCardJasper: calls 100
FantasticDouble: calls 50
color_singleton: checks 
*** FLOP *** [Th Qd Ah]
FantasticDouble: checks 
color_singleton: checks 
HighCardJasper: bets 200
FantasticDouble: folds 
color_singleton: folds 
Uncalled bet (200) returned to HighCardJasper
HighCardJasper collected 283 from pot
HighCardJasper: doesn't show hand 
*** SUMMARY ***
Total pot 300 | Rake 17 
Board [Th Qd Ah]
Seat 1: manon327 folded before Flop (didn't bet)
Seat 2: HighCardJasper (button) collected (283)
Seat 3: FantasticDouble (small blind) folded on the Flop
Seat 6: color_singleton (big blind) folded on the Flop
Seat 9: dhduncan folded before Flop (didn't bet)



PokerStars Home Game Hand #222896937532: {DaPokaStars}  Hold'em No Limit (50/100) - 2021/01/21 17:33:51 ET
Table 'testnsdfgh' 9-max (Play Money) Seat #3 is the button
Seat 1: manon327 (10883 in chips) 
Seat 2: HighCardJasper (25085 in chips) 
Seat 3: FantasticDouble (16268 in chips) 
Seat 6: color_singleton (21865 in chips) 
Seat 9: dhduncan (7719 in chips) 
color_singleton: posts small blind 50
dhduncan: posts big blind 100
*** HOLE CARDS ***
Dealt to FantasticDouble [4s 2c]
manon327: calls 100
HighCardJasper: calls 100
FantasticDouble: folds 
color_singleton: calls 50
dhduncan: checks 
*** FLOP *** [3c Ad Ah]
color_singleton: checks 
dhduncan: checks 
manon327: checks 
HighCardJasper: checks 
*** TURN *** [3c Ad Ah] [4h]
color_singleton: checks 
dhduncan: checks 
manon327: checks 
HighCardJasper: checks 
*** RIVER *** [3c Ad Ah 4h] [5s]
color_singleton: checks 
dhduncan: checks 
manon327: checks 
HighCardJasper: bets 400
color_singleton: folds 
dhduncan: folds 
manon327: folds 
Uncalled bet (400) returned to HighCardJasper
HighCardJasper collected 378 from pot
HighCardJasper: doesn't show hand 
*** SUMMARY ***
Total pot 400 | Rake 22 
Board [3c Ad Ah 4h 5s]
Seat 1: manon327 folded on the River
Seat 2: HighCardJasper collected (378)
Seat 3: FantasticDouble (button) folded before Flop (didn't bet)
Seat 6: color_singleton (small blind) folded on the River
Seat 9: dhduncan (big blind) folded on the River



PokerStars Home Game Hand #222896983168: {DaPokaStars}  Hold'em No Limit (50/100) - 2021/01/21 17:35:04 ET
Table 'testnsdfgh' 9-max (Play Money) Seat #6 is the button
Seat 1: manon327 (10783 in chips) 
Seat 2: HighCardJasper (25363 in chips) 
Seat 3: FantasticDouble (16268 in chips) 
Seat 6: color_singleton (21765 in chips) 
Seat 9: dhduncan (7619 in chips) 
dhduncan: posts small blind 50
manon327: posts big blind 100
*** HOLE CARDS ***
Dealt to FantasticDouble [Qd 5h]
HighCardJasper: calls 100
FantasticDouble: folds 
color_singleton: calls 100
dhduncan: calls 50
manon327: checks 
*** FLOP *** [6h 7s 7h]
dhduncan: checks 
manon327: checks 
HighCardJasper: bets 200
color_singleton: raises 300 to 500
dhduncan: folds 
manon327: folds 
HighCardJasper: calls 300
*** TURN *** [6h 7s 7h] [Ad]
HighCardJasper: checks 
color_singleton: checks 
*** RIVER *** [6h 7s 7h Ad] [Jd]
HighCardJasper: bets 400
color_singleton has timed out
color_singleton: folds 
Uncalled bet (400) returned to HighCardJasper
HighCardJasper collected 1323 from pot
HighCardJasper: doesn't show hand 
*** SUMMARY ***
Total pot 1400 | Rake 77 
Board [6h 7s 7h Ad Jd]
Seat 1: manon327 (big blind) folded on the Flop
Seat 2: HighCardJasper collected (1323)
Seat 3: FantasticDouble folded before Flop (didn't bet)
Seat 6: color_singleton (button) folded on the River
Seat 9: dhduncan (small blind) folded on the Flop



PokerStars Home Game Hand #222897026348: {DaPokaStars}  Hold'em No Limit (50/100) - 2021/01/21 17:36:13 ET
Table 'testnsdfgh' 9-max (Play Money) Seat #9 is the button
Seat 1: manon327 (10683 in chips) 
Seat 2: HighCardJasper (26086 in chips) 
Seat 3: FantasticDouble (16268 in chips) 
Seat 6: color_singleton (21165 in chips) 
Seat 9: dhduncan (7519 in chips) 
manon327: posts small blind 50
HighCardJasper: posts big blind 100
*** HOLE CARDS ***
Dealt to FantasticDouble [2d 9d]
FantasticDouble: folds 
color_singleton: folds 
dhduncan: calls 100
manon327: calls 50
HighCardJasper: checks 
*** FLOP *** [5s 7d 4s]
manon327: checks 
HighCardJasper: checks 
dhduncan: bets 100
manon327: folds 
HighCardJasper: calls 100
*** TURN *** [5s 7d 4s] [7h]
HighCardJasper: checks 
dhduncan: bets 100
HighCardJasper: calls 100
*** RIVER *** [5s 7d 4s 7h] [Ac]
HighCardJasper: checks 
dhduncan: bets 200
HighCardJasper: folds 
Uncalled bet (200) returned to dhduncan
dhduncan collected 661 from pot
dhduncan: doesn't show hand 
*** SUMMARY ***
Total pot 700 | Rake 39 
Board [5s 7d 4s 7h Ac]
Seat 1: manon327 (small blind) folded on the Flop
Seat 2: HighCardJasper (big blind) folded on the River
Seat 3: FantasticDouble folded before Flop (didn't bet)
Seat 6: color_singleton folded before Flop (didn't bet)
Seat 9: dhduncan (button) collected (661)



PokerStars Home Game Hand #222897061787: {DaPokaStars}  Hold'em No Limit (50/100) - 2021/01/21 17:37:09 ET
Table 'testnsdfgh' 9-max (Play Money) Seat #1 is the button
Seat 1: manon327 (10583 in chips) 
Seat 2: HighCardJasper (25786 in chips) 
Seat 3: FantasticDouble (16268 in chips) 
Seat 6: color_singleton (21165 in chips) 
Seat 9: dhduncan (7880 in chips) 
HighCardJasper: posts small blind 50
FantasticDouble: posts big blind 100
*** HOLE CARDS ***
Dealt to FantasticDouble [9c 7h]
color_singleton: folds 
dhduncan: folds 
manon327: raises 100 to 200
HighCardJasper: calls 150
FantasticDouble: calls 100
*** FLOP *** [4c Qh Qc]
HighCardJasper: checks 
FantasticDouble: checks 
manon327: bets 283
HighCardJasper: folds 
FantasticDouble: folds 
Uncalled bet (283) returned to manon327
manon327 collected 567 from pot
*** SUMMARY ***
Total pot 600 | Rake 33 
Board [4c Qh Qc]
Seat 1: manon327 (button) collected (567)
Seat 2: HighCardJasper (small blind) folded on the Flop
Seat 3: FantasticDouble (big blind) folded on the Flop
Seat 6: color_singleton folded before Flop (didn't bet)
Seat 9: dhduncan folded before Flop (didn't bet)



PokerStars Home Game Hand #222897088263: {DaPokaStars}  Hold'em No Limit (50/100) - 2021/01/21 17:37:52 ET
Table 'testnsdfgh' 9-max (Play Money) Seat #2 is the button
Seat 1: manon327 (10950 in chips) 
Seat 2: HighCardJasper (25586 in chips) 
Seat 3: FantasticDouble (16068 in chips) 
Seat 6: color_singleton (21165 in chips) 
FantasticDouble: posts small blind 50
color_singleton: posts big blind 100
*** HOLE CARDS ***
Dealt to FantasticDouble [8c 8h]
manon327: calls 100
HighCardJasper: calls 100
FantasticDouble: raises 300 to 400
color_singleton: folds 
manon327: folds 
HighCardJasper: folds 
Uncalled bet (300) returned to FantasticDouble
FantasticDouble collected 400 from pot
*** SUMMARY ***
Total pot 400 | Rake 0 
Seat 1: manon327 folded before Flop
Seat 2: HighCardJasper (button) folded before Flop
Seat 3: FantasticDouble (small blind) collected (400)
Seat 6: color_singleton (big blind) folded before Flop



PokerStars Home Game Hand #222897100591: {DaPokaStars}  Hold'em No Limit (50/100) - 2021/01/21 17:38:12 ET
Table 'testnsdfgh' 9-max (Play Money) Seat #3 is the button
Seat 1: manon327 (10850 in chips) 
Seat 2: HighCardJasper (25486 in chips) 
Seat 3: FantasticDouble (16368 in chips) 
Seat 6: color_singleton (21065 in chips) 
color_singleton: posts small blind 50
manon327: posts big blind 100
*** HOLE CARDS ***
Dealt to FantasticDouble [5h 7c]
HighCardJasper: calls 100
FantasticDouble: folds 
color_singleton: raises 200 to 300
manon327: calls 200
HighCardJasper: calls 200
*** FLOP *** [4h 9d 9h]
color_singleton: checks 
manon327: checks 
HighCardJasper: checks 
*** TURN *** [4h 9d 9h] [6h]
color_singleton: checks 
manon327: checks 
HighCardJasper: checks 
*** RIVER *** [4h 9d 9h 6h] [4c]
color_singleton: checks 
manon327: checks 
HighCardJasper: checks 
*** SHOW DOWN ***
color_singleton: shows [Ah Ks] (two pair, Nines and Fours)
manon327: shows [Ac 7d] (two pair, Nines and Fours)
HighCardJasper: mucks hand 
color_singleton collected 425 from pot
manon327 collected 425 from pot
*** SUMMARY ***
Total pot 900 | Rake 50 
Board [4h 9d 9h 6h 4c]
Seat 1: manon327 (big blind) showed [Ac 7d] and won (425) with two pair, Nines and Fours
Seat 2: HighCardJasper mucked [2d Td]
Seat 3: FantasticDouble (button) folded before Flop (didn't bet)
Seat 6: color_singleton (small blind) showed [Ah Ks] and won (425) with two pair, Nines and Fours



PokerStars Home Game Hand #222897125146: {DaPokaStars}  Hold'em No Limit (50/100) - 2021/01/21 17:38:52 ET
Table 'testnsdfgh' 9-max (Play Money) Seat #6 is the button
Seat 1: manon327 (10975 in chips) 
Seat 2: HighCardJasper (25186 in chips) 
Seat 3: FantasticDouble (16368 in chips) 
Seat 6: color_singleton (21190 in chips) 
manon327: posts small blind 50
HighCardJasper: posts big blind 100
*** HOLE CARDS ***
Dealt to FantasticDouble [5h Qd]
FantasticDouble: folds 
color_singleton: raises 200 to 300
manon327: calls 250
HighCardJasper: folds 
*** FLOP *** [4c 8d 8c]
manon327: checks 
color_singleton: checks 
*** TURN *** [4c 8d 8c] [6d]
manon327: checks 
color_singleton: checks 
*** RIVER *** [4c 8d 8c 6d] [Ah]
manon327: checks 
color_singleton: checks 
*** SHOW DOWN ***
manon327: shows [Kd 7d] (a pair of Eights)
color_singleton: mucks hand 
manon327 collected 661 from pot
*** SUMMARY ***
Total pot 700 | Rake 39 
Board [4c 8d 8c 6d Ah]
Seat 1: manon327 (small blind) showed [Kd 7d] and won (661) with a pair of Eights
Seat 2: HighCardJasper (big blind) folded before Flop
Seat 3: FantasticDouble folded before Flop (didn't bet)
Seat 6: color_singleton (button) mucked [Jd Qh]



PokerStars Home Game Hand #222897137524: {DaPokaStars}  Hold'em No Limit (50/100) - 2021/01/21 17:39:12 ET
Table 'testnsdfgh' 9-max (Play Money) Seat #1 is the button
Seat 1: manon327 (11336 in chips) 
Seat 2: HighCardJasper (25086 in chips) 
Seat 3: FantasticDouble (16368 in chips) 
Seat 6: color_singleton (20890 in chips) 
HighCardJasper: posts small blind 50
FantasticDouble: posts big blind 100
*** HOLE CARDS ***
Dealt to FantasticDouble [Qs 6d]
color_singleton: raises 200 to 300
manon327: folds 
HighCardJasper: folds 
FantasticDouble: folds 
Uncalled bet (200) returned to color_singleton
color_singleton collected 250 from pot
color_singleton: doesn't show hand 
*** SUMMARY ***
Total pot 250 | Rake 0 
Seat 1: manon327 (button) folded before Flop (didn't bet)
Seat 2: HighCardJasper (small blind) folded before Flop
Seat 3: FantasticDouble (big blind) folded before Flop
Seat 6: color_singleton collected (250)



PokerStars Home Game Hand #222897145241: {DaPokaStars}  Hold'em No Limit (50/100) - 2021/01/21 17:39:24 ET
Table 'testnsdfgh' 9-max (Play Money) Seat #2 is the button
Seat 1: manon327 (11336 in chips) 
Seat 2: HighCardJasper (25036 in chips) 
Seat 3: FantasticDouble (16268 in chips) 
Seat 6: color_singleton (21040 in chips) 
FantasticDouble: posts small blind 50
color_singleton: posts big blind 100
*** HOLE CARDS ***
Dealt to FantasticDouble [2h 4d]
manon327: folds 
HighCardJasper: folds 
FantasticDouble: folds 
Uncalled bet (50) returned to color_singleton
color_singleton collected 100 from pot
color_singleton: doesn't show hand 
*** SUMMARY ***
Total pot 100 | Rake 0 
Seat 1: manon327 folded before Flop (didn't bet)
Seat 2: HighCardJasper (button) folded before Flop (didn't bet)
Seat 3: FantasticDouble (small blind) folded before Flop
Seat 6: color_singleton (big blind) collected (100)



PokerStars Home Game Hand #222897150513: {DaPokaStars}  Hold'em No Limit (50/100) - 2021/01/21 17:39:32 ET
Table 'testnsdfgh' 9-max (Play Money) Seat #3 is the button
Seat 1: manon327 (11336 in chips) 
Seat 2: HighCardJasper (25036 in chips) 
Seat 3: FantasticDouble (16218 in chips) 
Seat 6: color_singleton (21090 in chips) 
color_singleton: posts small blind 50
manon327: posts big blind 100
*** HOLE CARDS ***
Dealt to FantasticDouble [7h 3h]
HighCardJasper: raises 100 to 200
FantasticDouble: folds 
color_singleton: folds 
manon327: folds 
Uncalled bet (100) returned to HighCardJasper
HighCardJasper collected 250 from pot
HighCardJasper: doesn't show hand 
*** SUMMARY ***
Total pot 250 | Rake 0 
Seat 1: manon327 (big blind) folded before Flop
Seat 2: HighCardJasper collected (250)
Seat 3: FantasticDouble (button) folded before Flop (didn't bet)
Seat 6: color_singleton (small blind) folded before Flop



PokerStars Home Game Hand #222897155191: {DaPokaStars}  Hold'em No Limit (50/100) - 2021/01/21 17:39:40 ET
Table 'testnsdfgh' 9-max (Play Money) Seat #6 is the button
Seat 1: manon327 (11236 in chips) 
Seat 2: HighCardJasper (25186 in chips) 
Seat 3: FantasticDouble (16218 in chips) 
Seat 6: color_singleton (21040 in chips) 
manon327: posts small blind 50
HighCardJasper: posts big blind 100
*** HOLE CARDS ***
Dealt to FantasticDouble [Kd 8h]
FantasticDouble: folds 
color_singleton: folds 
manon327: calls 50
HighCardJasper: checks 
*** FLOP *** [Td 4s 6c]
manon327: checks 
HighCardJasper: checks 
*** TURN *** [Td 4s 6c] [Ac]
manon327: checks 
HighCardJasper: checks 
*** RIVER *** [Td 4s 6c Ac] [9h]
manon327: checks 
HighCardJasper: checks 
*** SHOW DOWN ***
manon327: shows [Ks 6s] (a pair of Sixes)
HighCardJasper: mucks hand 
manon327 collected 189 from pot
*** SUMMARY ***
Total pot 200 | Rake 11 
Board [Td 4s 6c Ac 9h]
Seat 1: manon327 (small blind) showed [Ks 6s] and won (189) with a pair of Sixes
Seat 2: HighCardJasper (big blind) mucked [5s Qc]
Seat 3: FantasticDouble folded before Flop (didn't bet)
Seat 6: color_singleton (button) folded before Flop (didn't bet)



PokerStars Home Game Hand #222897173341: {DaPokaStars}  Hold'em No Limit (50/100) - 2021/01/21 17:40:09 ET
Table 'testnsdfgh' 9-max (Play Money) Seat #1 is the button
Seat 1: manon327 (11325 in chips) 
Seat 2: HighCardJasper (25086 in chips) 
Seat 3: FantasticDouble (16218 in chips) 
Seat 6: color_singleton (21040 in chips) 
Seat 9: dhduncan (7880 in chips) 
HighCardJasper: posts small blind 50
FantasticDouble: posts big blind 100
dhduncan: posts small & big blinds 150
*** HOLE CARDS ***
Dealt to FantasticDouble [2d 5h]
color_singleton: raises 200 to 300
dhduncan: calls 200
manon327: folds 
HighCardJasper: folds 
FantasticDouble has timed out
FantasticDouble: folds 
*** FLOP *** [9s 3d As]
color_singleton: checks 
dhduncan: bets 378
color_singleton: raises 378 to 756
dhduncan: calls 378
*** TURN *** [9s 3d As] [Td]
color_singleton: bets 1092
dhduncan: folds 
Uncalled bet (1092) returned to color_singleton
color_singleton collected 2185 from pot
color_singleton: doesn't show hand 
*** SUMMARY ***
Total pot 2312 | Rake 127 
Board [9s 3d As Td]
Seat 1: manon327 (button) folded before Flop (didn't bet)
Seat 2: HighCardJasper (small blind) folded before Flop
Seat 3: FantasticDouble (big blind) folded before Flop
Seat 6: color_singleton collected (2185)
Seat 9: dhduncan folded on the Turn



PokerStars Home Game Hand #222897256897: {DaPokaStars}  Hold'em No Limit (50/100) - 2021/01/21 17:42:13 ET
Table 'testnsdfgh' 9-max (Play Money) Seat #6 is the button
Seat 1: manon327 (11025 in chips) 
Seat 3: FantasticDouble (16118 in chips) 
Seat 6: color_singleton (20617 in chips) 
Seat 9: dhduncan (8439 in chips) 
dhduncan: posts small blind 50
manon327: posts big blind 100
FantasticDouble: posts small blind 50
*** HOLE CARDS ***
Dealt to FantasticDouble [2h Qd]
FantasticDouble: folds 
color_singleton: raises 300 to 400
dhduncan: folds 
manon327: folds 
Uncalled bet (300) returned to color_singleton
color_singleton collected 300 from pot
color_singleton: doesn't show hand 
*** SUMMARY ***
Total pot 300 | Rake 0 
Seat 1: manon327 (big blind) folded before Flop
Seat 3: FantasticDouble folded before Flop (didn't bet)
Seat 6: color_singleton (button) collected (300)
Seat 9: dhduncan (small blind) folded before Flop



PokerStars Home Game Hand #222897261464: {DaPokaStars}  Hold'em No Limit (50/100) - 2021/01/21 17:42:20 ET
Table 'testnsdfgh' 9-max (Play Money) Seat #9 is the button
Seat 1: manon327 (10925 in chips) 
Seat 2: HighCardJasper (25036 in chips) 
Seat 3: FantasticDouble (16068 in chips) 
Seat 6: color_singleton (20817 in chips) 
Seat 9: dhduncan (8389 in chips) 
manon327: posts small blind 50
HighCardJasper: posts big blind 100
*** HOLE CARDS ***
Dealt to FantasticDouble [7c Td]
FantasticDouble: folds 
color_singleton: folds 
dhduncan: folds 
manon327: calls 50
HighCardJasper: raises 100 to 200
manon327: folds 
Uncalled bet (100) returned to HighCardJasper
HighCardJasper collected 200 from pot
HighCardJasper: doesn't show hand 
*** SUMMARY ***
Total pot 200 | Rake 0 
Seat 1: manon327 (small blind) folded before Flop
Seat 2: HighCardJasper (big blind) collected (200)
Seat 3: FantasticDouble folded before Flop (didn't bet)
Seat 6: color_singleton folded before Flop (didn't bet)
Seat 9: dhduncan (button) folded before Flop (didn't bet)



PokerStars Home Game Hand #222897271954: {DaPokaStars}  Hold'em No Limit (50/100) - 2021/01/21 17:42:34 ET
Table 'testnsdfgh' 9-max (Play Money) Seat #1 is the button
Seat 1: manon327 (10825 in chips) 
Seat 2: HighCardJasper (25136 in chips) 
Seat 3: FantasticDouble (16068 in chips) 
Seat 6: color_singleton (20817 in chips) 
Seat 9: dhduncan (8389 in chips) 
HighCardJasper: posts small blind 50
FantasticDouble: posts big blind 100
*** HOLE CARDS ***
Dealt to FantasticDouble [5d 8d]
color_singleton: folds 
dhduncan: calls 100
manon327: folds 
HighCardJasper: calls 50
FantasticDouble has timed out
FantasticDouble: checks 
*** FLOP *** [Ts 9c 7h]
HighCardJasper: checks 
FantasticDouble: bets 300
dhduncan: folds 
HighCardJasper: calls 300
*** TURN *** [Ts 9c 7h] [Jd]
HighCardJasper: checks 
FantasticDouble: bets 700
HighCardJasper: folds 
Uncalled bet (700) returned to FantasticDouble
FantasticDouble collected 850 from pot
*** SUMMARY ***
Total pot 900 | Rake 50 
Board [Ts 9c 7h Jd]
Seat 1: manon327 (button) folded before Flop (didn't bet)
Seat 2: HighCardJasper (small blind) folded on the Turn
Seat 3: FantasticDouble (big blind) collected (850)
Seat 6: color_singleton folded before Flop (didn't bet)
Seat 9: dhduncan folded on the Flop



PokerStars Home Game Hand #222897300667: {DaPokaStars}  Hold'em No Limit (50/100) - 2021/01/21 17:43:21 ET
Table 'testnsdfgh' 9-max (Play Money) Seat #2 is the button
Seat 1: manon327 (10825 in chips) 
Seat 2: HighCardJasper (24736 in chips) 
Seat 3: FantasticDouble (16518 in chips) 
Seat 6: color_singleton (20817 in chips) 
FantasticDouble: posts small blind 50
color_singleton: posts big blind 100
*** HOLE CARDS ***
Dealt to FantasticDouble [7d 6d]
manon327: calls 100
HighCardJasper: raises 200 to 300
FantasticDouble: folds 
color_singleton: calls 200
manon327: calls 200
*** FLOP *** [3d 8h Td]
color_singleton: bets 449
manon327: calls 449
HighCardJasper: calls 449
*** TURN *** [3d 8h Td] [6h]
color_singleton: bets 1085
manon327: folds 
HighCardJasper: raises 1915 to 3000
color_singleton: folds 
Uncalled bet (1915) returned to HighCardJasper
HighCardJasper collected 4221 from pot
HighCardJasper: doesn't show hand 
*** SUMMARY ***
Total pot 4467 | Rake 246 
Board [3d 8h Td 6h]
Seat 1: manon327 folded on the Turn
Seat 2: HighCardJasper (button) collected (4221)
Seat 3: FantasticDouble (small blind) folded before Flop
Seat 6: color_singleton (big blind) folded on the Turn



PokerStars Home Game Hand #222897347092: {DaPokaStars}  Hold'em No Limit (50/100) - 2021/01/21 17:44:38 ET
Table 'testnsdfgh' 9-max (Play Money) Seat #3 is the button
Seat 1: manon327 (10076 in chips) 
Seat 2: HighCardJasper (27123 in chips) 
Seat 3: FantasticDouble (16468 in chips) 
Seat 6: color_singleton (18983 in chips) 
Seat 9: dhduncan (8289 in chips) 
color_singleton: posts small blind 50
dhduncan: posts big blind 100
*** HOLE CARDS ***
Dealt to FantasticDouble [3s 5s]
manon327: calls 100
HighCardJasper: calls 100
FantasticDouble: calls 100
color_singleton: folds 
dhduncan: checks 
*** FLOP *** [Th Jc 2s]
dhduncan: checks 
manon327: checks 
HighCardJasper: bets 100
FantasticDouble: folds 
dhduncan: calls 100
manon327: calls 100
*** TURN *** [Th Jc 2s] [6h]
dhduncan: checks 
manon327: checks 
HighCardJasper: bets 300
dhduncan: folds 
manon327: calls 300
*** RIVER *** [Th Jc 2s 6h] [7s]
manon327: checks 
HighCardJasper: bets 500
manon327: calls 500
*** SHOW DOWN ***
HighCardJasper: shows [As Jd] (a pair of Jacks)
manon327: mucks hand 
HighCardJasper collected 2221 from pot
*** SUMMARY ***
Total pot 2350 | Rake 129 
Board [Th Jc 2s 6h 7s]
Seat 1: manon327 mucked [Js Qs]
Seat 2: HighCardJasper showed [As Jd] and won (2221) with a pair of Jacks
Seat 3: FantasticDouble (button) folded on the Flop
Seat 6: color_singleton (small blind) folded before Flop
Seat 9: dhduncan (big blind) folded on the Turn



PokerStars Home Game Hand #222897393908: {DaPokaStars}  Hold'em No Limit (50/100) - 2021/01/21 17:45:54 ET
Table 'testnsdfgh' 9-max (Play Money) Seat #6 is the button
Seat 1: manon327 (9076 in chips) 
Seat 2: HighCardJasper (28344 in chips) 
Seat 3: FantasticDouble (16368 in chips) 
Seat 6: color_singleton (18933 in chips) 
Seat 9: dhduncan (8089 in chips) 
dhduncan: posts small blind 50
manon327: posts big blind 100
*** HOLE CARDS ***
Dealt to FantasticDouble [Kc Th]
HighCardJasper: raises 200 to 300
FantasticDouble: calls 300
color_singleton: calls 300
dhduncan: calls 250
manon327: folds 
*** FLOP *** [4h 5h 3h]
dhduncan: checks 
HighCardJasper: checks 
FantasticDouble: bets 700
color_singleton: calls 700
dhduncan: folds 
HighCardJasper: folds 
*** TURN *** [4h 5h 3h] [Qd]
FantasticDouble: checks 
color_singleton: bets 1275
FantasticDouble: folds 
Uncalled bet (1275) returned to color_singleton
color_singleton collected 2551 from pot
color_singleton: doesn't show hand 
*** SUMMARY ***
Total pot 2700 | Rake 149 
Board [4h 5h 3h Qd]
Seat 1: manon327 (big blind) folded before Flop
Seat 2: HighCardJasper folded on the Flop
Seat 3: FantasticDouble folded on the Turn
Seat 6: color_singleton (button) collected (2551)
Seat 9: dhduncan (small blind) folded on the Flop



PokerStars Home Game Hand #222897427099: {DaPokaStars}  Hold'em No Limit (50/100) - 2021/01/21 17:46:49 ET
Table 'testnsdfgh' 9-max (Play Money) Seat #9 is the button
Seat 1: manon327 (8976 in chips) 
Seat 2: HighCardJasper (28044 in chips) 
Seat 3: FantasticDouble (15368 in chips) 
Seat 6: color_singleton (20484 in chips) 
Seat 9: dhduncan (7789 in chips) 
manon327: posts small blind 50
HighCardJasper: posts big blind 100
*** HOLE CARDS ***
Dealt to FantasticDouble [5h Qs]
FantasticDouble: folds 
color_singleton: folds 
dhduncan: calls 100
manon327: calls 50
HighCardJasper: raises 100 to 200
dhduncan: calls 100
manon327: calls 100
*** FLOP *** [Kd 2h 9c]
manon327: bets 283
HighCardJasper: folds 
dhduncan: calls 283
*** TURN *** [Kd 2h 9c] [9s]
manon327: bets 551
dhduncan: raises 551 to 1102
manon327: calls 551
*** RIVER *** [Kd 2h 9c 9s] [4h]
manon327: checks 
dhduncan: bets 500
manon327: calls 500
*** SHOW DOWN ***
dhduncan: shows [Ks 9d] (a full house, Nines full of Kings)
manon327: mucks hand 
dhduncan collected 4130 from pot
*** SUMMARY ***
Total pot 4370 | Rake 240 
Board [Kd 2h 9c 9s 4h]
Seat 1: manon327 (small blind) mucked [Kc 3c]
Seat 2: HighCardJasper (big blind) folded on the Flop
Seat 3: FantasticDouble folded before Flop (didn't bet)
Seat 6: color_singleton folded before Flop (didn't bet)
Seat 9: dhduncan (button) showed [Ks 9d] and won (4130) with a full house, Nines full of Kings



PokerStars Home Game Hand #222897465620: {DaPokaStars}  Hold'em No Limit (50/100) - 2021/01/21 17:47:53 ET
Table 'testnsdfgh' 9-max (Play Money) Seat #1 is the button
Seat 1: manon327 (6891 in chips) 
Seat 2: HighCardJasper (27844 in chips) 
Seat 3: FantasticDouble (15368 in chips) 
Seat 6: color_singleton (20484 in chips) 
Seat 9: dhduncan (9834 in chips) 
HighCardJasper: posts small blind 50
FantasticDouble: posts big blind 100
*** HOLE CARDS ***
Dealt to FantasticDouble [6s Jh]
color_singleton: raises 200 to 300
dhduncan: calls 300
manon327: folds 
HighCardJasper: calls 250
FantasticDouble: folds 
*** FLOP *** [7h Ac 9d]
HighCardJasper: checks 
color_singleton: bets 472
dhduncan: folds 
HighCardJasper: folds 
Uncalled bet (472) returned to color_singleton
color_singleton collected 945 from pot
color_singleton: doesn't show hand 
*** SUMMARY ***
Total pot 1000 | Rake 55 
Board [7h Ac 9d]
Seat 1: manon327 (button) folded before Flop (didn't bet)
Seat 2: HighCardJasper (small blind) folded on the Flop
Seat 3: FantasticDouble (big blind) folded before Flop
Seat 6: color_singleton collected (945)
Seat 9: dhduncan folded on the Flop



PokerStars Home Game Hand #222897487835: {DaPokaStars}  Hold'em No Limit (50/100) - 2021/01/21 17:48:28 ET
Table 'testnsdfgh' 9-max (Play Money) Seat #2 is the button
Seat 1: manon327 (6891 in chips) 
Seat 2: HighCardJasper (27544 in chips) 
Seat 3: FantasticDouble (15268 in chips) 
Seat 6: color_singleton (21129 in chips) 
Seat 9: dhduncan (9534 in chips) 
FantasticDouble: posts small blind 50
color_singleton: posts big blind 100
*** HOLE CARDS ***
Dealt to FantasticDouble [Tc 8c]
dhduncan: folds 
manon327: calls 100
HighCardJasper: calls 100
FantasticDouble: calls 50
color_singleton: checks 
*** FLOP *** [Kc 2s Qd]
FantasticDouble: checks 
color_singleton: bets 200
manon327: folds 
HighCardJasper: folds 
FantasticDouble: folds 
Uncalled bet (200) returned to color_singleton
color_singleton collected 378 from pot
color_singleton: doesn't show hand 
*** SUMMARY ***
Total pot 400 | Rake 22 
Board [Kc 2s Qd]
Seat 1: manon327 folded on the Flop
Seat 2: HighCardJasper (button) folded on the Flop
Seat 3: FantasticDouble (small blind) folded on the Flop
Seat 6: color_singleton (big blind) collected (378)
Seat 9: dhduncan folded before Flop (didn't bet)



PokerStars Home Game Hand #222897518555: {DaPokaStars}  Hold'em No Limit (50/100) - 2021/01/21 17:49:19 ET
Table 'testnsdfgh' 9-max (Play Money) Seat #3 is the button
Seat 1: manon327 (6791 in chips) 
Seat 2: HighCardJasper (27444 in chips) 
Seat 3: FantasticDouble (15168 in chips) 
Seat 6: color_singleton (21407 in chips) 
Seat 9: dhduncan (9534 in chips) 
color_singleton: posts small blind 50
dhduncan: posts big blind 100
*** HOLE CARDS ***
Dealt to FantasticDouble [9s 6c]
manon327: folds 
HighCardJasper: calls 100
FantasticDouble: folds 
color_singleton: raises 200 to 300
dhduncan: calls 200
HighCardJasper: calls 200
*** FLOP *** [3c Jh 6d]
color_singleton: checks 
dhduncan: checks 
HighCardJasper: checks 
*** TURN *** [3c Jh 6d] [Ts]
color_singleton: bets 425
dhduncan: folds 
HighCardJasper: calls 425
*** RIVER *** [3c Jh 6d Ts] [Ah]
color_singleton: bets 827
HighCardJasper: folds 
Uncalled bet (827) returned to color_singleton
color_singleton collected 1654 from pot
color_singleton: doesn't show hand 
*** SUMMARY ***
Total pot 1750 | Rake 96 
Board [3c Jh 6d Ts Ah]
Seat 1: manon327 folded before Flop (didn't bet)
Seat 2: HighCardJasper folded on the River
Seat 3: FantasticDouble (button) folded before Flop (didn't bet)
Seat 6: color_singleton (small blind) collected (1654)
Seat 9: dhduncan (big blind) folded on the Turn



PokerStars Home Game Hand #222897555073: {DaPokaStars}  Hold'em No Limit (50/100) - 2021/01/21 17:50:21 ET
Table 'testnsdfgh' 9-max (Play Money) Seat #6 is the button
Seat 1: manon327 (6791 in chips) 
Seat 2: HighCardJasper (26719 in chips) 
Seat 3: FantasticDouble (15168 in chips) 
Seat 6: color_singleton (22336 in chips) 
Seat 9: dhduncan (9234 in chips) 
dhduncan: posts small blind 50
manon327: posts big blind 100
*** HOLE CARDS ***
Dealt to FantasticDouble [5h 4s]
HighCardJasper: raises 100 to 200
FantasticDouble: folds 
color_singleton: calls 200
dhduncan: calls 150
manon327: folds 
*** FLOP *** [Jc 2c Jh]
dhduncan: checks 
HighCardJasper: checks 
color_singleton: checks 
*** TURN *** [Jc 2c Jh] [Kh]
dhduncan: checks 
HighCardJasper: bets 200
color_singleton: folds 
dhduncan: calls 200
*** RIVER *** [Jc 2c Jh Kh] [3h]
dhduncan: checks 
HighCardJasper: bets 600
dhduncan: folds 
Uncalled bet (600) returned to HighCardJasper
HighCardJasper collected 1039 from pot
HighCardJasper: doesn't show hand 
*** SUMMARY ***
Total pot 1100 | Rake 61 
Board [Jc 2c Jh Kh 3h]
Seat 1: manon327 (big blind) folded before Flop
Seat 2: HighCardJasper collected (1039)
Seat 3: FantasticDouble folded before Flop (didn't bet)
Seat 6: color_singleton (button) folded on the Turn
Seat 9: dhduncan (small blind) folded on the River



PokerStars Home Game Hand #222897584099: {DaPokaStars}  Hold'em No Limit (50/100) - 2021/01/21 17:51:10 ET
Table 'testnsdfgh' 9-max (Play Money) Seat #9 is the button
Seat 1: manon327 (6691 in chips) 
Seat 2: HighCardJasper (27358 in chips) 
Seat 3: FantasticDouble (15168 in chips) 
Seat 6: color_singleton (22136 in chips) 
Seat 9: dhduncan (8834 in chips) 
manon327: posts small blind 50
HighCardJasper: posts big blind 100
*** HOLE CARDS ***
Dealt to FantasticDouble [Th 7h]
FantasticDouble: calls 100
color_singleton: folds 
dhduncan: folds 
manon327: folds 
HighCardJasper: checks 
*** FLOP *** [2c 9s Kh]
HighCardJasper: bets 100
FantasticDouble: calls 100
*** TURN *** [2c 9s Kh] [Qc]
HighCardJasper: bets 100
FantasticDouble: calls 100
*** RIVER *** [2c 9s Kh Qc] [8h]
HighCardJasper: bets 400
FantasticDouble: folds 
Uncalled bet (400) returned to HighCardJasper
HighCardJasper collected 614 from pot
HighCardJasper: doesn't show hand 
*** SUMMARY ***
Total pot 650 | Rake 36 
Board [2c 9s Kh Qc 8h]
Seat 1: manon327 (small blind) folded before Flop
Seat 2: HighCardJasper (big blind) collected (614)
Seat 3: FantasticDouble folded on the River
Seat 6: color_singleton folded before Flop (didn't bet)
Seat 9: dhduncan (button) folded before Flop (didn't bet)



PokerStars Home Game Hand #222897603708: {DaPokaStars}  Hold'em No Limit (50/100) - 2021/01/21 17:51:39 ET
Table 'testnsdfgh' 9-max (Play Money) Seat #1 is the button
Seat 1: manon327 (6641 in chips) 
Seat 2: HighCardJasper (27672 in chips) 
Seat 3: FantasticDouble (14868 in chips) 
Seat 6: color_singleton (22136 in chips) 
Seat 9: dhduncan (8834 in chips) 
HighCardJasper: posts small blind 50
FantasticDouble: posts big blind 100
*** HOLE CARDS ***
Dealt to FantasticDouble [Ah Kh]
color_singleton: raises 200 to 300
dhduncan: folds 
manon327: folds 
HighCardJasper: folds 
FantasticDouble: raises 400 to 700
color_singleton: raises 1500 to 2200
FantasticDouble: calls 1500
*** FLOP *** [9s 9c 3d]
FantasticDouble: checks 
color_singleton: checks 
*** TURN *** [9s 9c 3d] [As]
FantasticDouble: bets 12668 and is all-in
color_singleton: calls 12668
*** RIVER *** [9s 9c 3d As] [3c]
*** SHOW DOWN ***
FantasticDouble: shows [Ah Kh] (two pair, Aces and Nines)
color_singleton: shows [Ad Ks] (two pair, Aces and Nines)
FantasticDouble collected 14074 from pot
color_singleton collected 14074 from pot
*** SUMMARY ***
Total pot 29786 | Rake 1638 
Board [9s 9c 3d As 3c]
Seat 1: manon327 (button) folded before Flop (didn't bet)
Seat 2: HighCardJasper (small blind) folded before Flop
Seat 3: FantasticDouble (big blind) showed [Ah Kh] and won (14074) with two pair, Aces and Nines
Seat 6: color_singleton showed [Ad Ks] and won (14074) with two pair, Aces and Nines
Seat 9: dhduncan folded before Flop (didn't bet)



PokerStars Home Game Hand #222897626969: {DaPokaStars}  Hold'em No Limit (50/100) - 2021/01/21 17:52:19 ET
Table 'testnsdfgh' 9-max (Play Money) Seat #2 is the button
Seat 2: HighCardJasper (27622 in chips) 
Seat 3: FantasticDouble (14074 in chips) 
Seat 6: color_singleton (21342 in chips) 
Seat 9: dhduncan (8834 in chips) 
FantasticDouble: posts small blind 50
color_singleton: posts big blind 100
*** HOLE CARDS ***
Dealt to FantasticDouble [Td 6c]
dhduncan: calls 100
HighCardJasper: calls 100
FantasticDouble: folds 
color_singleton: raises 200 to 300
dhduncan: calls 200
HighCardJasper: folds 
*** FLOP *** [9s 8s 9h]
color_singleton: checks 
dhduncan: checks 
*** TURN *** [9s 8s 9h] [Qs]
color_singleton: bets 354
dhduncan: calls 354
*** RIVER *** [9s 8s 9h Qs] [8d]
color_singleton: checks 
dhduncan: checks 
*** SHOW DOWN ***
color_singleton: shows [5s Ac] (two pair, Nines and Eights)
dhduncan: shows [Ad Qd] (two pair, Queens and Nines)
dhduncan collected 1378 from pot
*** SUMMARY ***
Total pot 1458 | Rake 80 
Board [9s 8s 9h Qs 8d]
Seat 2: HighCardJasper (button) folded before Flop
Seat 3: FantasticDouble (small blind) folded before Flop
Seat 6: color_singleton (big blind) showed [5s Ac] and lost with two pair, Nines and Eights
Seat 9: dhduncan showed [Ad Qd] and won (1378) with two pair, Queens and Nines



PokerStars Home Game Hand #222897652324: {DaPokaStars}  Hold'em No Limit (50/100) - 2021/01/21 17:53:01 ET
Table 'testnsdfgh' 9-max (Play Money) Seat #3 is the button
Seat 2: HighCardJasper (27522 in chips) 
Seat 3: FantasticDouble (14024 in chips) 
Seat 6: color_singleton (20688 in chips) 
Seat 9: dhduncan (9558 in chips) 
color_singleton: posts small blind 50
dhduncan: posts big blind 100
*** HOLE CARDS ***
Dealt to FantasticDouble [6s Qs]
HighCardJasper: folds 
FantasticDouble: folds 
color_singleton: raises 200 to 300
dhduncan: folds 
Uncalled bet (200) returned to color_singleton
color_singleton collected 200 from pot
color_singleton: doesn't show hand 
*** SUMMARY ***
Total pot 200 | Rake 0 
Seat 2: HighCardJasper folded before Flop (didn't bet)
Seat 3: FantasticDouble (button) folded before Flop (didn't bet)
Seat 6: color_singleton (small blind) collected (200)
Seat 9: dhduncan (big blind) folded before Flop



PokerStars Home Game Hand #222897660616: {DaPokaStars}  Hold'em No Limit (50/100) - 2021/01/21 17:53:16 ET
Table 'testnsdfgh' 9-max (Play Money) Seat #6 is the button
Seat 2: HighCardJasper (27522 in chips) 
Seat 3: FantasticDouble (14024 in chips) 
Seat 6: color_singleton (20788 in chips) 
Seat 9: dhduncan (9458 in chips) 
dhduncan: posts small blind 50
HighCardJasper: posts big blind 100
*** HOLE CARDS ***
Dealt to FantasticDouble [6d 3h]
FantasticDouble: folds 
color_singleton: folds 
dhduncan: calls 50
HighCardJasper: checks 
*** FLOP *** [Jd 3d 5s]
dhduncan: checks 
HighCardJasper: bets 200
dhduncan: folds 
Uncalled bet (200) returned to HighCardJasper
HighCardJasper collected 189 from pot
HighCardJasper: doesn't show hand 
*** SUMMARY ***
Total pot 200 | Rake 11 
Board [Jd 3d 5s]
Seat 2: HighCardJasper (big blind) collected (189)
Seat 3: FantasticDouble folded before Flop (didn't bet)
Seat 6: color_singleton (button) folded before Flop (didn't bet)
Seat 9: dhduncan (small blind) folded on the Flop



PokerStars Home Game Hand #222897672912: {DaPokaStars}  Hold'em No Limit (50/100) - 2021/01/21 17:53:36 ET
Table 'testnsdfgh' 9-max (Play Money) Seat #9 is the button
Seat 2: HighCardJasper (27611 in chips) 
Seat 3: FantasticDouble (14024 in chips) 
Seat 6: color_singleton (20788 in chips) 
Seat 9: dhduncan (9358 in chips) 
HighCardJasper: posts small blind 50
FantasticDouble: posts big blind 100
*** HOLE CARDS ***
Dealt to FantasticDouble [6c 2h]
color_singleton: raises 200 to 300
dhduncan: folds 
HighCardJasper: calls 250
FantasticDouble: folds 
*** FLOP *** [6h Jh 7d]
HighCardJasper: checks 
color_singleton: bets 330
HighCardJasper: folds 
Uncalled bet (330) returned to color_singleton
color_singleton collected 661 from pot
color_singleton: doesn't show hand 
*** SUMMARY ***
Total pot 700 | Rake 39 
Board [6h Jh 7d]
Seat 2: HighCardJasper (small blind) folded on the Flop
Seat 3: FantasticDouble (big blind) folded before Flop
Seat 6: color_singleton collected (661)
Seat 9: dhduncan (button) folded before Flop (didn't bet)



PokerStars Home Game Hand #222897686796: {DaPokaStars}  Hold'em No Limit (50/100) - 2021/01/21 17:54:00 ET
Table 'testnsdfgh' 9-max (Play Money) Seat #2 is the button
Seat 2: HighCardJasper (27311 in chips) 
Seat 3: FantasticDouble (13924 in chips) 
Seat 6: color_singleton (21149 in chips) 
Seat 9: dhduncan (9358 in chips) 
FantasticDouble: posts small blind 50
color_singleton: posts big blind 100
*** HOLE CARDS ***
Dealt to FantasticDouble [9h 5c]
dhduncan: calls 100
HighCardJasper: calls 100
FantasticDouble: folds 
color_singleton: checks 
*** FLOP *** [Qc 8h Jh]
color_singleton: bets 165
dhduncan: calls 165
HighCardJasper: calls 165
*** TURN *** [Qc 8h Jh] [Ad]
color_singleton: checks 
dhduncan: bets 300
HighCardJasper: calls 300
color_singleton: folds 
*** RIVER *** [Qc 8h Jh Ad] [2h]
dhduncan: bets 1366
HighCardJasper: folds 
Uncalled bet (1366) returned to dhduncan
dhduncan collected 1366 from pot
dhduncan: doesn't show hand 
*** SUMMARY ***
Total pot 1445 | Rake 79 
Board [Qc 8h Jh Ad 2h]
Seat 2: HighCardJasper (button) folded on the River
Seat 3: FantasticDouble (small blind) folded before Flop
Seat 6: color_singleton (big blind) folded on the Turn
Seat 9: dhduncan collected (1366)



PokerStars Home Game Hand #222897709500: {DaPokaStars}  Hold'em No Limit (50/100) - 2021/01/21 17:54:39 ET
Table 'testnsdfgh' 9-max (Play Money) Seat #3 is the button
Seat 1: manon327 (6641 in chips) 
Seat 2: HighCardJasper (26746 in chips) 
Seat 3: FantasticDouble (13874 in chips) 
Seat 6: color_singleton (20884 in chips) 
Seat 9: dhduncan (10159 in chips) 
color_singleton: posts small blind 50
dhduncan: posts big blind 100
manon327: posts small & big blinds 150
*** HOLE CARDS ***
Dealt to FantasticDouble [Kc 2s]
manon327: checks 
HighCardJasper: calls 100
FantasticDouble: folds 
color_singleton: calls 50
dhduncan: checks 
*** FLOP *** [5d 6h 5c]
color_singleton: checks 
dhduncan: checks 
manon327: checks 
HighCardJasper: checks 
*** TURN *** [5d 6h 5c] [Qc]
color_singleton: bets 212
dhduncan: calls 212
manon327: folds 
HighCardJasper: calls 212
*** RIVER *** [5d 6h 5c Qc] [4h]
color_singleton: bets 1026
dhduncan: raises 1026 to 2052
HighCardJasper: folds 
color_singleton: folds 
Uncalled bet (1026) returned to dhduncan
dhduncan collected 2965 from pot
dhduncan: doesn't show hand 
*** SUMMARY ***
Total pot 3138 | Rake 173 
Board [5d 6h 5c Qc 4h]
Seat 1: manon327 folded on the Turn (didn't bet)
Seat 2: HighCardJasper folded on the River
Seat 3: FantasticDouble (button) folded before Flop (didn't bet)
Seat 6: color_singleton (small blind) folded on the River
Seat 9: dhduncan (big blind) collected (2965)



PokerStars Home Game Hand #222897738780: {DaPokaStars}  Hold'em No Limit (50/100) - 2021/01/21 17:55:39 ET
Table 'testnsdfgh' 9-max (Play Money) Seat #6 is the button
Seat 1: manon327 (6491 in chips) 
Seat 2: HighCardJasper (26434 in chips) 
Seat 3: FantasticDouble (13874 in chips) 
Seat 6: color_singleton (19546 in chips) 
Seat 9: dhduncan (11786 in chips) 
dhduncan: posts small blind 50
manon327: posts big blind 100
*** HOLE CARDS ***
Dealt to FantasticDouble [Tc 5s]
HighCardJasper: calls 100
FantasticDouble: folds 
color_singleton: raises 100 to 200
dhduncan: folds 
manon327: calls 100
HighCardJasper: calls 100
*** FLOP *** [4h 2h 2c]
manon327: checks 
HighCardJasper: bets 200
color_singleton: folds 
manon327: calls 200
*** TURN *** [4h 2h 2c] [Qs]
manon327: checks 
HighCardJasper: bets 300
manon327: folds 
Uncalled bet (300) returned to HighCardJasper
HighCardJasper collected 992 from pot
HighCardJasper: doesn't show hand 
*** SUMMARY ***
Total pot 1050 | Rake 58 
Board [4h 2h 2c Qs]
Seat 1: manon327 (big blind) folded on the Turn
Seat 2: HighCardJasper collected (992)
Seat 3: FantasticDouble folded before Flop (didn't bet)
Seat 6: color_singleton (button) folded on the Flop
Seat 9: dhduncan (small blind) folded before Flop



PokerStars Home Game Hand #222897754313: {DaPokaStars}  Hold'em No Limit (50/100) - 2021/01/21 17:56:14 ET
Table 'testnsdfgh' 9-max (Play Money) Seat #9 is the button
Seat 1: manon327 (6091 in chips) 
Seat 2: HighCardJasper (27026 in chips) 
Seat 3: FantasticDouble (13874 in chips) 
Seat 6: color_singleton (19346 in chips) 
Seat 9: dhduncan (11736 in chips) 
manon327: posts small blind 50
HighCardJasper: posts big blind 100
*** HOLE CARDS ***
Dealt to FantasticDouble [3h 8h]
FantasticDouble: folds 
color_singleton has timed out
color_singleton: folds 
dhduncan: calls 100
manon327: calls 50
HighCardJasper: checks 
*** FLOP *** [Qs 6c Kc]
manon327: checks 
HighCardJasper: checks 
dhduncan: bets 100
manon327: calls 100
HighCardJasper: folds 
*** TURN *** [Qs 6c Kc] [7d]
manon327: checks 
dhduncan: checks 
*** RIVER *** [Qs 6c Kc 7d] [4d]
manon327: checks 
dhduncan: checks 
*** SHOW DOWN ***
manon327: shows [As 8s] (high card Ace)
dhduncan: shows [5s 5h] (a pair of Fives)
dhduncan collected 472 from pot
*** SUMMARY ***
Total pot 500 | Rake 28 
Board [Qs 6c Kc 7d 4d]
Seat 1: manon327 (small blind) showed [As 8s] and lost with high card Ace
Seat 2: HighCardJasper (big blind) folded on the Flop
Seat 3: FantasticDouble folded before Flop (didn't bet)
Seat 6: color_singleton folded before Flop (didn't bet)
Seat 9: dhduncan (button) showed [5s 5h] and won (472) with a pair of Fives



PokerStars Home Game Hand #222897780637: {DaPokaStars}  Hold'em No Limit (50/100) - 2021/01/21 17:56:58 ET
Table 'testnsdfgh' 9-max (Play Money) Seat #1 is the button
Seat 1: manon327 (5891 in chips) 
Seat 2: HighCardJasper (26926 in chips) 
Seat 3: FantasticDouble (13874 in chips) 
Seat 9: dhduncan (12008 in chips) 
HighCardJasper: posts small blind 50
FantasticDouble: posts big blind 100
*** HOLE CARDS ***
Dealt to FantasticDouble [6s 7c]
dhduncan: calls 100
manon327: calls 100
HighCardJasper: calls 50
FantasticDouble: checks 
*** FLOP *** [Ah Qh Qd]
HighCardJasper: checks 
FantasticDouble: checks 
dhduncan: checks 
manon327: bets 189
HighCardJasper: folds 
FantasticDouble: folds 
dhduncan: folds 
Uncalled bet (189) returned to manon327
manon327 collected 378 from pot
*** SUMMARY ***
Total pot 400 | Rake 22 
Board [Ah Qh Qd]
Seat 1: manon327 (button) collected (378)
Seat 2: HighCardJasper (small blind) folded on the Flop
Seat 3: FantasticDouble (big blind) folded on the Flop
Seat 9: dhduncan folded on the Flop



PokerStars Home Game Hand #222897796921: {DaPokaStars}  Hold'em No Limit (50/100) - 2021/01/21 17:57:35 ET
Table 'testnsdfgh' 9-max (Play Money) Seat #2 is the button
Seat 1: manon327 (6169 in chips) 
Seat 2: HighCardJasper (26826 in chips) 
Seat 3: FantasticDouble (13774 in chips) 
Seat 9: dhduncan (11908 in chips) 
FantasticDouble: posts small blind 50
dhduncan: posts big blind 100
*** HOLE CARDS ***
Dealt to FantasticDouble [5h 4h]
manon327: calls 100
HighCardJasper: calls 100
FantasticDouble: calls 50
dhduncan: checks 
*** FLOP *** [7c Ad 7s]
FantasticDouble: checks 
dhduncan: checks 
manon327: checks 
HighCardJasper: checks 
*** TURN *** [7c Ad 7s] [4c]
FantasticDouble: bets 200
dhduncan: folds 
manon327: calls 200
HighCardJasper: folds 
*** RIVER *** [7c Ad 7s 4c] [Kd]
FantasticDouble: checks 
manon327: bets 756
FantasticDouble: folds 
Uncalled bet (756) returned to manon327
manon327 collected 756 from pot
*** SUMMARY ***
Total pot 800 | Rake 44 
Board [7c Ad 7s 4c Kd]
Seat 1: manon327 collected (756)
Seat 2: HighCardJasper (button) folded on the Turn
Seat 3: FantasticDouble (small blind) folded on the River
Seat 9: dhduncan (big blind) folded on the Turn



PokerStars Home Game Hand #222897817912: {DaPokaStars}  Hold'em No Limit (50/100) - 2021/01/21 17:58:22 ET
Table 'testnsdfgh' 9-max (Play Money) Seat #3 is the button
Seat 1: manon327 (6625 in chips) 
Seat 2: HighCardJasper (26726 in chips) 
Seat 3: FantasticDouble (13474 in chips) 
Seat 9: dhduncan (11808 in chips) 
dhduncan: posts small blind 50
manon327: posts big blind 100
*** HOLE CARDS ***
Dealt to FantasticDouble [Ks 7h]
HighCardJasper: folds 
FantasticDouble: folds 
dhduncan: calls 50
manon327: checks 
*** FLOP *** [Th Kc 3c]
dhduncan: checks 
manon327: checks 
*** TURN *** [Th Kc 3c] [Ah]
dhduncan: bets 100
manon327: folds 
Uncalled bet (100) returned to dhduncan
dhduncan collected 189 from pot
dhduncan: doesn't show hand 
*** SUMMARY ***
Total pot 200 | Rake 11 
Board [Th Kc 3c Ah]
Seat 1: manon327 (big blind) folded on the Turn
Seat 2: HighCardJasper folded before Flop (didn't bet)
Seat 3: FantasticDouble (button) folded before Flop (didn't bet)
Seat 9: dhduncan (small blind) collected (189)



PokerStars Home Game Hand #222897826669: {DaPokaStars}  Hold'em No Limit (50/100) - 2021/01/21 17:58:41 ET
Table 'testnsdfgh' 9-max (Play Money) Seat #9 is the button
Seat 1: manon327 (6525 in chips) 
Seat 2: HighCardJasper (26726 in chips) 
Seat 3: FantasticDouble (13474 in chips) 
Seat 6: color_singleton (19346 in chips) 
Seat 9: dhduncan (11897 in chips) 
manon327: posts small blind 50
HighCardJasper: posts big blind 100
color_singleton: posts small & big blinds 150
*** HOLE CARDS ***
Dealt to FantasticDouble [2s 8h]
FantasticDouble: folds 
color_singleton: raises 100 to 200
dhduncan: calls 200
manon327: folds 
HighCardJasper: calls 100
*** FLOP *** [5d 9c Ks]
HighCardJasper: checks 
color_singleton: checks 
dhduncan: checks 
*** TURN *** [5d 9c Ks] [Js]
HighCardJasper: bets 300
color_singleton: folds 
dhduncan: folds 
Uncalled bet (300) returned to HighCardJasper
HighCardJasper collected 661 from pot
HighCardJasper: doesn't show hand 
*** SUMMARY ***
Total pot 700 | Rake 39 
Board [5d 9c Ks Js]
Seat 1: manon327 (small blind) folded before Flop
Seat 2: HighCardJasper (big blind) collected (661)
Seat 3: FantasticDouble folded before Flop (didn't bet)
Seat 6: color_singleton folded on the Turn
Seat 9: dhduncan (button) folded on the Turn



PokerStars Home Game Hand #222897843819: {DaPokaStars}  Hold'em No Limit (50/100) - 2021/01/21 17:59:20 ET
Table 'testnsdfgh' 9-max (Play Money) Seat #1 is the button
Seat 1: manon327 (6475 in chips) 
Seat 2: HighCardJasper (27187 in chips) 
Seat 3: FantasticDouble (13474 in chips) 
Seat 6: color_singleton (19096 in chips) 
Seat 9: dhduncan (11697 in chips) 
HighCardJasper: posts small blind 50
FantasticDouble: posts big blind 100
*** HOLE CARDS ***
Dealt to FantasticDouble [4d 7c]
color_singleton: raises 200 to 300
dhduncan: folds 
manon327: folds 
HighCardJasper: calls 250
FantasticDouble: folds 
*** FLOP *** [Ks 9h Jc]
HighCardJasper: bets 400
color_singleton: calls 400
*** TURN *** [Ks 9h Jc] [Ad]
HighCardJasper: bets 100
color_singleton: raises 700 to 800
HighCardJasper: calls 700
*** RIVER *** [Ks 9h Jc Ad] [7h]
HighCardJasper: checks 
color_singleton: checks 
*** SHOW DOWN ***
HighCardJasper: shows [Jd Qs] (a pair of Jacks)
color_singleton: shows [Qc Ac] (a pair of Aces)
color_singleton collected 2929 from pot
*** SUMMARY ***
Total pot 3100 | Rake 171 
Board [Ks 9h Jc Ad 7h]
Seat 1: manon327 (button) folded before Flop (didn't bet)
Seat 2: HighCardJasper (small blind) showed [Jd Qs] and lost with a pair of Jacks
Seat 3: FantasticDouble (big blind) folded before Flop
Seat 6: color_singleton showed [Qc Ac] and won (2929) with a pair of Aces
Seat 9: dhduncan folded before Flop (didn't bet)



PokerStars Home Game Hand #222897867366: {DaPokaStars}  Hold'em No Limit (50/100) - 2021/01/21 18:00:12 ET
Table 'testnsdfgh' 9-max (Play Money) Seat #2 is the button
Seat 1: manon327 (6475 in chips) 
Seat 2: HighCardJasper (25687 in chips) 
Seat 3: FantasticDouble (13374 in chips) 
Seat 6: color_singleton (20525 in chips) 
Seat 9: dhduncan (11697 in chips) 
FantasticDouble: posts small blind 50
color_singleton: posts big blind 100
*** HOLE CARDS ***
Dealt to FantasticDouble [Th Ad]
dhduncan: folds 
manon327: folds 
HighCardJasper: folds 
FantasticDouble: raises 400 to 500
color_singleton: folds 
Uncalled bet (400) returned to FantasticDouble
FantasticDouble collected 200 from pot
*** SUMMARY ***
Total pot 200 | Rake 0 
Seat 1: manon327 folded before Flop (didn't bet)
Seat 2: HighCardJasper (button) folded before Flop (didn't bet)
Seat 3: FantasticDouble (small blind) collected (200)
Seat 6: color_singleton (big blind) folded before Flop
Seat 9: dhduncan folded before Flop (didn't bet)



PokerStars Home Game Hand #222897875414: {DaPokaStars}  Hold'em No Limit (50/100) - 2021/01/21 18:00:29 ET
Table 'testnsdfgh' 9-max (Play Money) Seat #3 is the button
Seat 1: manon327 (6475 in chips) 
Seat 2: HighCardJasper (25687 in chips) 
Seat 3: FantasticDouble (13474 in chips) 
Seat 6: color_singleton (20425 in chips) 
Seat 9: dhduncan (11697 in chips) 
color_singleton: posts small blind 50
dhduncan: posts big blind 100
*** HOLE CARDS ***
Dealt to FantasticDouble [2s 4s]
manon327: folds 
HighCardJasper: calls 100
FantasticDouble: calls 100
color_singleton: raises 200 to 300
dhduncan: calls 200
HighCardJasper: folds 
FantasticDouble: calls 200
*** FLOP *** [Jc 8d 8s]
color_singleton: checks 
dhduncan: checks 
FantasticDouble: checks 
*** TURN *** [Jc 8d 8s] [4h]
color_singleton: checks 
dhduncan: checks 
FantasticDouble: bets 400
color_singleton: folds 
dhduncan: folds 
Uncalled bet (400) returned to FantasticDouble
FantasticDouble collected 945 from pot
*** SUMMARY ***
Total pot 1000 | Rake 55 
Board [Jc 8d 8s 4h]
Seat 1: manon327 folded before Flop (didn't bet)
Seat 2: HighCardJasper folded before Flop
Seat 3: FantasticDouble (button) collected (945)
Seat 6: color_singleton (small blind) folded on the Turn
Seat 9: dhduncan (big blind) folded on the Turn



PokerStars Home Game Hand #222897898534: {DaPokaStars}  Hold'em No Limit (50/100) - 2021/01/21 18:01:15 ET
Table 'testnsdfgh' 9-max (Play Money) Seat #6 is the button
Seat 1: manon327 (6475 in chips) 
Seat 2: HighCardJasper (25587 in chips) 
Seat 3: FantasticDouble (14119 in chips) 
Seat 6: color_singleton (20125 in chips) 
Seat 9: dhduncan (11397 in chips) 
dhduncan: posts small blind 50
manon327: posts big blind 100
*** HOLE CARDS ***
Dealt to FantasticDouble [5d 9d]
HighCardJasper: calls 100
FantasticDouble: folds 
color_singleton: calls 100
dhduncan: calls 50
manon327: checks 
*** FLOP *** [9s Qh 8h]
dhduncan: bets 100
manon327: folds 
HighCardJasper: calls 100
color_singleton: calls 100
*** TURN *** [9s Qh 8h] [3s]
dhduncan: bets 100
HighCardJasper: calls 100
color_singleton: calls 100
*** RIVER *** [9s Qh 8h 3s] [Td]
dhduncan: bets 100
HighCardJasper: raises 400 to 500
color_singleton: folds 
dhduncan: calls 400
*** SHOW DOWN ***
HighCardJasper: shows [7c Jc] (a straight, Eight to Queen)
dhduncan: mucks hand 
HighCardJasper collected 1890 from pot
*** SUMMARY ***
Total pot 2000 | Rake 110 
Board [9s Qh 8h 3s Td]
Seat 1: manon327 (big blind) folded on the Flop
Seat 2: HighCardJasper showed [7c Jc] and won (1890) with a straight, Eight to Queen
Seat 3: FantasticDouble folded before Flop (didn't bet)
Seat 6: color_singleton (button) folded on the River
Seat 9: dhduncan (small blind) mucked [Qc 7h]



PokerStars Home Game Hand #222897923632: {DaPokaStars}  Hold'em No Limit (50/100) - 2021/01/21 18:02:00 ET
Table 'testnsdfgh' 9-max (Play Money) Seat #9 is the button
Seat 1: manon327 (6375 in chips) 
Seat 2: HighCardJasper (26677 in chips) 
Seat 3: FantasticDouble (14119 in chips) 
Seat 6: color_singleton (19825 in chips) 
Seat 9: dhduncan (10597 in chips) 
manon327: posts small blind 50
HighCardJasper: posts big blind 100
*** HOLE CARDS ***
Dealt to FantasticDouble [7c Ks]
FantasticDouble: raises 200 to 300
color_singleton: folds 
dhduncan: calls 300
manon327: calls 250
HighCardJasper: calls 200
*** FLOP *** [7d 6d 9s]
manon327: checks 
HighCardJasper: checks 
FantasticDouble: bets 500
dhduncan: calls 500
manon327: folds 
HighCardJasper: folds 
*** TURN *** [7d 6d 9s] [2d]
FantasticDouble: checks 
dhduncan: bets 1039
FantasticDouble: folds 
Uncalled bet (1039) returned to dhduncan
dhduncan collected 2079 from pot
dhduncan: doesn't show hand 
*** SUMMARY ***
Total pot 2200 | Rake 121 
Board [7d 6d 9s 2d]
Seat 1: manon327 (small blind) folded on the Flop
Seat 2: HighCardJasper (big blind) folded on the Flop
Seat 3: FantasticDouble folded on the Turn
Seat 6: color_singleton folded before Flop (didn't bet)
Seat 9: dhduncan (button) collected (2079)



PokerStars Home Game Hand #222897948291: {DaPokaStars}  Hold'em No Limit (50/100) - 2021/01/21 18:02:44 ET
Table 'testnsdfgh' 9-max (Play Money) Seat #1 is the button
Seat 1: manon327 (6075 in chips) 
Seat 2: HighCardJasper (26377 in chips) 
Seat 3: FantasticDouble (13319 in chips) 
Seat 6: color_singleton (19825 in chips) 
Seat 9: dhduncan (11876 in chips) 
HighCardJasper: posts small blind 50
FantasticDouble: posts big blind 100
*** HOLE CARDS ***
Dealt to FantasticDouble [Ah 2h]
color_singleton: raises 300 to 400
dhduncan: folds 
manon327: folds 
HighCardJasper: calls 350
FantasticDouble: calls 300
*** FLOP *** [As Td 8h]
HighCardJasper: bets 600
FantasticDouble: calls 600
color_singleton: raises 600 to 1200
HighCardJasper: calls 600
FantasticDouble: calls 600
*** TURN *** [As Td 8h] [3s]
HighCardJasper: checks 
FantasticDouble: checks 
color_singleton: checks 
*** RIVER *** [As Td 8h 3s] [4h]
HighCardJasper: checks 
FantasticDouble: checks 
color_singleton: checks 
*** SHOW DOWN ***
HighCardJasper: shows [9d Ac] (a pair of Aces)
FantasticDouble: mucks hand 
color_singleton: mucks hand 
HighCardJasper collected 4536 from pot
*** SUMMARY ***
Total pot 4800 | Rake 264 
Board [As Td 8h 3s 4h]
Seat 1: manon327 (button) folded before Flop (didn't bet)
Seat 2: HighCardJasper (small blind) showed [9d Ac] and won (4536) with a pair of Aces
Seat 3: FantasticDouble (big blind) mucked [Ah 2h]
Seat 6: color_singleton mucked [7d Ad]
Seat 9: dhduncan folded before Flop (didn't bet)



PokerStars Home Game Hand #222897975905: {DaPokaStars}  Hold'em No Limit (50/100) - 2021/01/21 18:03:32 ET
Table 'testnsdfgh' 9-max (Play Money) Seat #2 is the button
Seat 1: manon327 (6075 in chips) 
Seat 2: HighCardJasper (29313 in chips) 
Seat 3: FantasticDouble (11719 in chips) 
Seat 6: color_singleton (18225 in chips) 
Seat 9: dhduncan (11876 in chips) 
FantasticDouble: posts small blind 50
color_singleton: posts big blind 100
*** HOLE CARDS ***
Dealt to FantasticDouble [Td 5d]
dhduncan: calls 100
manon327: calls 100
HighCardJasper: calls 100
FantasticDouble: calls 50
color_singleton: raises 200 to 300
dhduncan: calls 200
manon327: calls 200
HighCardJasper: folds 
FantasticDouble: calls 200
*** FLOP *** [5c 6s 9c]
FantasticDouble: checks 
color_singleton: bets 614
dhduncan: calls 614
manon327: folds 
FantasticDouble: calls 614
*** TURN *** [5c 6s 9c] [3s]
FantasticDouble: checks 
color_singleton: checks 
dhduncan: bets 100
FantasticDouble: folds 
color_singleton: calls 100
*** RIVER *** [5c 6s 9c 3s] [7d]
color_singleton: checks 
dhduncan: checks 
*** SHOW DOWN ***
color_singleton: shows [6h Ah] (a pair of Sixes)
dhduncan: shows [Jh 9d] (a pair of Nines)
dhduncan collected 3158 from pot
*** SUMMARY ***
Total pot 3342 | Rake 184 
Board [5c 6s 9c 3s 7d]
Seat 1: manon327 folded on the Flop
Seat 2: HighCardJasper (button) folded before Flop
Seat 3: FantasticDouble (small blind) folded on the Turn
Seat 6: color_singleton (big blind) showed [6h Ah] and lost with a pair of Sixes
Seat 9: dhduncan showed [Jh 9d] and won (3158) with a pair of Nines



PokerStars Home Game Hand #222898016861: {DaPokaStars}  Hold'em No Limit (50/100) - 2021/01/21 18:04:44 ET
Table 'testnsdfgh' 9-max (Play Money) Seat #3 is the button
Seat 1: manon327 (5775 in chips) 
Seat 2: HighCardJasper (29213 in chips) 
Seat 3: FantasticDouble (10805 in chips) 
Seat 6: color_singleton (17211 in chips) 
Seat 9: dhduncan (14020 in chips) 
color_singleton: posts small blind 50
dhduncan: posts big blind 100
*** HOLE CARDS ***
Dealt to FantasticDouble [Qh 8s]
manon327: folds 
HighCardJasper: folds 
FantasticDouble: raises 200 to 300
color_singleton: folds 
dhduncan: calls 200
*** FLOP *** [Js 5d 8d]
dhduncan: bets 100
FantasticDouble: calls 100
*** TURN *** [Js 5d 8d] [Kh]
dhduncan: checks 
FantasticDouble: checks 
*** RIVER *** [Js 5d 8d Kh] [Jc]
dhduncan: checks 
FantasticDouble: checks 
*** SHOW DOWN ***
dhduncan: shows [9c 9d] (two pair, Jacks and Nines)
FantasticDouble: mucks hand 
dhduncan collected 803 from pot
*** SUMMARY ***
Total pot 850 | Rake 47 
Board [Js 5d 8d Kh Jc]
Seat 1: manon327 folded before Flop (didn't bet)
Seat 2: HighCardJasper folded before Flop (didn't bet)
Seat 3: FantasticDouble (button) mucked [Qh 8s]
Seat 6: color_singleton (small blind) folded before Flop
Seat 9: dhduncan (big blind) showed [9c 9d] and won (803) with two pair, Jacks and Nines



PokerStars Home Game Hand #222898045676: {DaPokaStars}  Hold'em No Limit (50/100) - 2021/01/21 18:05:35 ET
Table 'testnsdfgh' 9-max (Play Money) Seat #6 is the button
Seat 1: manon327 (5775 in chips) 
Seat 2: HighCardJasper (29213 in chips) 
Seat 3: FantasticDouble (10405 in chips) 
Seat 6: color_singleton (17161 in chips) 
Seat 9: dhduncan (14423 in chips) 
dhduncan: posts small blind 50
manon327: posts big blind 100
*** HOLE CARDS ***
Dealt to FantasticDouble [Qh 8h]
HighCardJasper: folds 
FantasticDouble: folds 
color_singleton: raises 200 to 300
dhduncan: calls 250
manon327: folds 
*** FLOP *** [7c 5h 2s]
dhduncan: checks 
color_singleton: bets 661
dhduncan: folds 
Uncalled bet (661) returned to color_singleton
color_singleton collected 661 from pot
color_singleton: doesn't show hand 
*** SUMMARY ***
Total pot 700 | Rake 39 
Board [7c 5h 2s]
Seat 1: manon327 (big blind) folded before Flop
Seat 2: HighCardJasper folded before Flop (didn't bet)
Seat 3: FantasticDouble folded before Flop (didn't bet)
Seat 6: color_singleton (button) collected (661)
Seat 9: dhduncan (small blind) folded on the Flop



PokerStars Home Game Hand #222898059876: {DaPokaStars}  Hold'em No Limit (50/100) - 2021/01/21 18:06:00 ET
Table 'testnsdfgh' 9-max (Play Money) Seat #9 is the button
Seat 1: manon327 (5675 in chips) 
Seat 2: HighCardJasper (29213 in chips) 
Seat 3: FantasticDouble (10405 in chips) 
Seat 6: color_singleton (17522 in chips) 
Seat 9: dhduncan (14123 in chips) 
manon327: posts small blind 50
HighCardJasper: posts big blind 100
*** HOLE CARDS ***
Dealt to FantasticDouble [7d 7c]
FantasticDouble has timed out
FantasticDouble: folds 
color_singleton: raises 200 to 300
dhduncan: folds 
manon327: calls 250
HighCardJasper: folds 
*** FLOP *** [8d As 2d]
manon327: checks 
color_singleton: bets 330
manon327: folds 
Uncalled bet (330) returned to color_singleton
color_singleton collected 661 from pot
color_singleton: doesn't show hand 
*** SUMMARY ***
Total pot 700 | Rake 39 
Board [8d As 2d]
Seat 1: manon327 (small blind) folded on the Flop
Seat 2: HighCardJasper (big blind) folded before Flop
Seat 3: FantasticDouble folded before Flop (didn't bet)
Seat 6: color_singleton collected (661)
Seat 9: dhduncan (button) folded before Flop (didn't bet)



PokerStars Home Game Hand #222898132750: {DaPokaStars}  Hold'em No Limit (50/100) - 2021/01/21 18:08:09 ET
Table 'testnsdfgh' 9-max (Play Money) Seat #6 is the button
Seat 1: manon327 (5075 in chips) 
Seat 2: HighCardJasper (28713 in chips) 
Seat 3: FantasticDouble (10405 in chips) 
Seat 6: color_singleton (18633 in chips) 
Seat 9: dhduncan (14023 in chips) 
dhduncan: posts small blind 50
manon327: posts big blind 100
FantasticDouble: posts small & big blinds 150
*** HOLE CARDS ***
Dealt to FantasticDouble [Kd 7h]
HighCardJasper: calls 100
FantasticDouble: checks 
color_singleton: calls 100
dhduncan: calls 50
manon327: checks 
*** FLOP *** [Th 3s 6c]
dhduncan: bets 260
manon327: folds 
HighCardJasper: calls 260
FantasticDouble: folds 
color_singleton: folds 
*** TURN *** [Th 3s 6c] [2h]
dhduncan: bets 1011
HighCardJasper: folds 
Uncalled bet (1011) returned to dhduncan
dhduncan collected 1011 from pot
dhduncan: doesn't show hand 
*** SUMMARY ***
Total pot 1070 | Rake 59 
Board [Th 3s 6c 2h]
Seat 1: manon327 (big blind) folded on the Flop
Seat 2: HighCardJasper folded on the Turn
Seat 3: FantasticDouble folded on the Flop (didn't bet)
Seat 6: color_singleton (button) folded on the Flop
Seat 9: dhduncan (small blind) collected (1011)



PokerStars Home Game Hand #222898149365: {DaPokaStars}  Hold'em No Limit (50/100) - 2021/01/21 18:08:39 ET
Table 'testnsdfgh' 9-max (Play Money) Seat #9 is the button
Seat 1: manon327 (4975 in chips) 
Seat 2: HighCardJasper (28353 in chips) 
Seat 3: FantasticDouble (10255 in chips) 
Seat 6: color_singleton (18533 in chips) 
Seat 9: dhduncan (14674 in chips) 
manon327: posts small blind 50
HighCardJasper: posts big blind 100
*** HOLE CARDS ***
Dealt to FantasticDouble [9s Kc]
FantasticDouble: calls 100
color_singleton: calls 100
dhduncan: calls 100
manon327: calls 50
HighCardJasper: checks 
*** FLOP *** [6d Qd Ah]
manon327: checks 
HighCardJasper: checks 
FantasticDouble: checks 
color_singleton: checks 
dhduncan: checks 
*** TURN *** [6d Qd Ah] [Ts]
manon327: checks 
HighCardJasper: checks 
FantasticDouble: checks 
color_singleton: checks 
dhduncan: checks 
*** RIVER *** [6d Qd Ah Ts] [Ad]
manon327: checks 
HighCardJasper: checks 
FantasticDouble: checks 
color_singleton: checks 
dhduncan: checks 
*** SHOW DOWN ***
manon327: shows [7h 4h] (a pair of Aces)
HighCardJasper: shows [8c 3h] (a pair of Aces - Queen+Ten+Eight kicker)
FantasticDouble: shows [9s Kc] (a pair of Aces - King kicker)
color_singleton: mucks hand 
dhduncan: shows [2h Kd] (a pair of Aces)
FantasticDouble collected 236 from pot
dhduncan collected 236 from pot
*** SUMMARY ***
Total pot 500 | Rake 28 
Board [6d Qd Ah Ts Ad]
Seat 1: manon327 (small blind) showed [7h 4h] and lost with a pair of Aces
Seat 2: HighCardJasper (big blind) showed [8c 3h] and lost with a pair of Aces
Seat 3: FantasticDouble showed [9s Kc] and won (236) with a pair of Aces
Seat 6: color_singleton mucked [7s 5s]
Seat 9: dhduncan (button) showed [2h Kd] and won (236) with a pair of Aces



PokerStars Home Game Hand #222898186347: {DaPokaStars}  Hold'em No Limit (50/100) - 2021/01/21 18:09:45 ET
Table 'testnsdfgh' 9-max (Play Money) Seat #1 is the button
Seat 1: manon327 (4875 in chips) 
Seat 2: HighCardJasper (28253 in chips) 
Seat 3: FantasticDouble (10391 in chips) 
Seat 6: color_singleton (18433 in chips) 
Seat 9: dhduncan (14810 in chips) 
HighCardJasper: posts small blind 50
FantasticDouble: posts big blind 100
*** HOLE CARDS ***
Dealt to FantasticDouble [Ad 8c]
color_singleton: raises 200 to 300
dhduncan: folds 
manon327: folds 
HighCardJasper: calls 250
FantasticDouble: calls 200
*** FLOP *** [Js Jd Th]
HighCardJasper: checks 
FantasticDouble: checks 
color_singleton: bets 850
HighCardJasper: folds 
FantasticDouble: folds 
Uncalled bet (850) returned to color_singleton
color_singleton collected 850 from pot
color_singleton: doesn't show hand 
*** SUMMARY ***
Total pot 900 | Rake 50 
Board [Js Jd Th]
Seat 1: manon327 (button) folded before Flop (didn't bet)
Seat 2: HighCardJasper (small blind) folded on the Flop
Seat 3: FantasticDouble (big blind) folded on the Flop
Seat 6: color_singleton collected (850)
Seat 9: dhduncan folded before Flop (didn't bet)



PokerStars Home Game Hand #222898204416: {DaPokaStars}  Hold'em No Limit (50/100) - 2021/01/21 18:10:18 ET
Table 'testnsdfgh' 9-max (Play Money) Seat #2 is the button
Seat 1: manon327 (4875 in chips) 
Seat 2: HighCardJasper (27953 in chips) 
Seat 3: FantasticDouble (10091 in chips) 
Seat 6: color_singleton (18983 in chips) 
Seat 9: dhduncan (14810 in chips) 
FantasticDouble: posts small blind 50
color_singleton: posts big blind 100
*** HOLE CARDS ***
Dealt to FantasticDouble [Qd 3d]
dhduncan: calls 100
manon327: folds 
HighCardJasper: calls 100
FantasticDouble: calls 50
color_singleton: raises 300 to 400
dhduncan: calls 300
HighCardJasper: folds 
FantasticDouble: calls 300
*** FLOP *** [3s Td Jh]
FantasticDouble: checks 
color_singleton: bets 614
dhduncan: folds 
FantasticDouble: folds 
Uncalled bet (614) returned to color_singleton
color_singleton collected 1228 from pot
color_singleton: doesn't show hand 
*** SUMMARY ***
Total pot 1300 | Rake 72 
Board [3s Td Jh]
Seat 1: manon327 folded before Flop (didn't bet)
Seat 2: HighCardJasper (button) folded before Flop
Seat 3: FantasticDouble (small blind) folded on the Flop
Seat 6: color_singleton (big blind) collected (1228)
Seat 9: dhduncan folded on the Flop



PokerStars Home Game Hand #222898219772: {DaPokaStars}  Hold'em No Limit (50/100) - 2021/01/21 18:10:45 ET
Table 'testnsdfgh' 9-max (Play Money) Seat #3 is the button
Seat 1: manon327 (4875 in chips) 
Seat 2: HighCardJasper (27853 in chips) 
Seat 3: FantasticDouble (9691 in chips) 
Seat 6: color_singleton (19811 in chips) 
Seat 9: dhduncan (14410 in chips) 
color_singleton: posts small blind 50
dhduncan: posts big blind 100
*** HOLE CARDS ***
Dealt to FantasticDouble [7h Kh]
manon327: calls 100
HighCardJasper: calls 100
FantasticDouble: calls 100
color_singleton: raises 100 to 200
dhduncan: calls 100
manon327: calls 100
HighCardJasper: calls 100
FantasticDouble: calls 100
*** FLOP *** [Qs 9d Jh]
color_singleton: checks 
dhduncan: checks 
manon327: checks 
HighCardJasper: bets 300
FantasticDouble: folds 
color_singleton: calls 300
dhduncan: folds 
manon327: folds 
*** TURN *** [Qs 9d Jh] [9c]
color_singleton: checks 
HighCardJasper: bets 600
color_singleton: raises 600 to 1200
HighCardJasper: folds 
Uncalled bet (600) returned to color_singleton
color_singleton collected 2646 from pot
color_singleton: doesn't show hand 
*** SUMMARY ***
Total pot 2800 | Rake 154 
Board [Qs 9d Jh 9c]
Seat 1: manon327 folded on the Flop
Seat 2: HighCardJasper folded on the Turn
Seat 3: FantasticDouble (button) folded on the Flop
Seat 6: color_singleton (small blind) collected (2646)
Seat 9: dhduncan (big blind) folded on the Flop



PokerStars Home Game Hand #222898255965: {DaPokaStars}  Hold'em No Limit (50/100) - 2021/01/21 18:11:52 ET
Table 'testnsdfgh' 9-max (Play Money) Seat #6 is the button
Seat 1: manon327 (4675 in chips) 
Seat 2: HighCardJasper (26753 in chips) 
Seat 3: FantasticDouble (9491 in chips) 
Seat 6: color_singleton (21357 in chips) 
Seat 9: dhduncan (14210 in chips) 
dhduncan: posts small blind 50
manon327: posts big blind 100
*** HOLE CARDS ***
Dealt to FantasticDouble [6d Kd]
HighCardJasper: calls 100
FantasticDouble: calls 100
color_singleton: calls 100
dhduncan: folds 
manon327: checks 
*** FLOP *** [Qd 2s 5c]
manon327: checks 
HighCardJasper: bets 200
FantasticDouble: folds 
color_singleton: folds 
manon327: folds 
Uncalled bet (200) returned to HighCardJasper
HighCardJasper collected 425 from pot
HighCardJasper: doesn't show hand 
*** SUMMARY ***
Total pot 450 | Rake 25 
Board [Qd 2s 5c]
Seat 1: manon327 (big blind) folded on the Flop
Seat 2: HighCardJasper collected (425)
Seat 3: FantasticDouble folded on the Flop
Seat 6: color_singleton (button) folded on the Flop
Seat 9: dhduncan (small blind) folded before Flop



PokerStars Home Game Hand #222898270563: {DaPokaStars}  Hold'em No Limit (50/100) - 2021/01/21 18:12:18 ET
Table 'testnsdfgh' 9-max (Play Money) Seat #9 is the button
Seat 1: manon327 (4575 in chips) 
Seat 2: HighCardJasper (27078 in chips) 
Seat 3: FantasticDouble (9391 in chips) 
Seat 6: color_singleton (21257 in chips) 
Seat 9: dhduncan (14160 in chips) 
manon327: posts small blind 50
HighCardJasper: posts big blind 100
*** HOLE CARDS ***
Dealt to FantasticDouble [7d 9h]
FantasticDouble: folds 
color_singleton: raises 200 to 300
dhduncan: calls 300
manon327: calls 250
HighCardJasper: calls 200
*** FLOP *** [Js 8d 7c]
manon327: checks 
HighCardJasper: bets 100
color_singleton: raises 600 to 700
dhduncan: folds 
manon327: folds 
HighCardJasper: folds 
Uncalled bet (600) returned to color_singleton
color_singleton collected 1323 from pot
color_singleton: doesn't show hand 
*** SUMMARY ***
Total pot 1400 | Rake 77 
Board [Js 8d 7c]
Seat 1: manon327 (small blind) folded on the Flop
Seat 2: HighCardJasper (big blind) folded on the Flop
Seat 3: FantasticDouble folded before Flop (didn't bet)
Seat 6: color_singleton collected (1323)
Seat 9: dhduncan (button) folded on the Flop



PokerStars Home Game Hand #222898285084: {DaPokaStars}  Hold'em No Limit (50/100) - 2021/01/21 18:12:45 ET
Table 'testnsdfgh' 9-max (Play Money) Seat #1 is the button
Seat 1: manon327 (4275 in chips) 
Seat 2: HighCardJasper (26678 in chips) 
Seat 3: FantasticDouble (9391 in chips) 
Seat 6: color_singleton (22180 in chips) 
HighCardJasper: posts small blind 50
FantasticDouble: posts big blind 100
*** HOLE CARDS ***
Dealt to FantasticDouble [9d 3h]
color_singleton: folds 
manon327: calls 100
HighCardJasper: raises 100 to 200
FantasticDouble: calls 100
manon327: calls 100
*** FLOP *** [4d Kc 5c]
HighCardJasper: bets 200
FantasticDouble: folds 
manon327: calls 200
*** TURN *** [4d Kc 5c] [6c]
HighCardJasper: checks 
manon327: checks 
*** RIVER *** [4d Kc 5c 6c] [8s]
HighCardJasper: bets 300
manon327: raises 300 to 600
HighCardJasper: calls 300
*** SHOW DOWN ***
manon327: shows [Ac 4s] (a pair of Fours)
HighCardJasper: shows [9h 9s] (a pair of Nines)
HighCardJasper collected 2079 from pot
*** SUMMARY ***
Total pot 2200 | Rake 121 
Board [4d Kc 5c 6c 8s]
Seat 1: manon327 (button) showed [Ac 4s] and lost with a pair of Fours
Seat 2: HighCardJasper (small blind) showed [9h 9s] and won (2079) with a pair of Nines
Seat 3: FantasticDouble (big blind) folded on the Flop
Seat 6: color_singleton folded before Flop (didn't bet)



PokerStars Home Game Hand #222898310640: {DaPokaStars}  Hold'em No Limit (50/100) - 2021/01/21 18:13:32 ET
Table 'testnsdfgh' 9-max (Play Money) Seat #2 is the button
Seat 1: manon327 (3275 in chips) 
Seat 2: HighCardJasper (27757 in chips) 
Seat 3: FantasticDouble (9191 in chips) 
Seat 6: color_singleton (22180 in chips) 
FantasticDouble: posts small blind 50
color_singleton: posts big blind 100
*** HOLE CARDS ***
Dealt to FantasticDouble [6d 7s]
manon327: calls 100
HighCardJasper: calls 100
FantasticDouble: calls 50
color_singleton: checks 
*** FLOP *** [2d 8s 5c]
FantasticDouble: bets 200
color_singleton: calls 200
manon327: folds 
HighCardJasper: calls 200
*** TURN *** [2d 8s 5c] [4h]
FantasticDouble: bets 600
color_singleton: calls 600
HighCardJasper: folds 
*** RIVER *** [2d 8s 5c 4h] [9c]
FantasticDouble: bets 1300
color_singleton: folds 
Uncalled bet (1300) returned to FantasticDouble
FantasticDouble collected 2079 from pot
*** SUMMARY ***
Total pot 2200 | Rake 121 
Board [2d 8s 5c 4h 9c]
Seat 1: manon327 folded on the Flop
Seat 2: HighCardJasper (button) folded on the Turn
Seat 3: FantasticDouble (small blind) collected (2079)
Seat 6: color_singleton (big blind) folded on the River



PokerStars Home Game Hand #222898338140: {DaPokaStars}  Hold'em No Limit (50/100) - 2021/01/21 18:14:23 ET
Table 'testnsdfgh' 9-max (Play Money) Seat #3 is the button
Seat 1: manon327 (3175 in chips) 
Seat 2: HighCardJasper (27457 in chips) 
Seat 3: FantasticDouble (10370 in chips) 
Seat 6: color_singleton (21280 in chips) 
Seat 9: dhduncan (13860 in chips) 
color_singleton: posts small blind 50
dhduncan: posts big blind 100
*** HOLE CARDS ***
Dealt to FantasticDouble [3h Tc]
manon327: calls 100
HighCardJasper: calls 100
FantasticDouble: folds 
color_singleton: calls 50
dhduncan: checks 
*** FLOP *** [Kh 2s 8h]
color_singleton: checks 
dhduncan: checks 
manon327: checks 
HighCardJasper: checks 
*** TURN *** [Kh 2s 8h] [2h]
color_singleton: checks 
dhduncan: checks 
manon327: checks 
HighCardJasper: checks 
*** RIVER *** [Kh 2s 8h 2h] [7c]
color_singleton: checks 
dhduncan: checks 
manon327: checks 
HighCardJasper: checks 
*** SHOW DOWN ***
color_singleton: shows [Js 9s] (a pair of Deuces)
dhduncan: mucks hand 
manon327: shows [4s Ah] (a pair of Deuces - Ace kicker)
HighCardJasper: shows [3d 8c] (two pair, Eights and Deuces)
HighCardJasper collected 378 from pot
*** SUMMARY ***
Total pot 400 | Rake 22 
Board [Kh 2s 8h 2h 7c]
Seat 1: manon327 showed [4s Ah] and lost with a pair of Deuces
Seat 2: HighCardJasper showed [3d 8c] and won (378) with two pair, Eights and Deuces
Seat 3: FantasticDouble (button) folded before Flop (didn't bet)
Seat 6: color_singleton (small blind) showed [Js 9s] and lost with a pair of Deuces
Seat 9: dhduncan (big blind) mucked [4d 6d]



PokerStars Home Game Hand #222898375547: {DaPokaStars}  Hold'em No Limit (50/100) - 2021/01/21 18:15:32 ET
Table 'testnsdfgh' 9-max (Play Money) Seat #6 is the button
Seat 1: manon327 (3075 in chips) 
Seat 2: HighCardJasper (27735 in chips) 
Seat 3: FantasticDouble (10370 in chips) 
Seat 6: color_singleton (21180 in chips) 
Seat 9: dhduncan (13760 in chips) 
dhduncan: posts small blind 50
manon327: posts big blind 100
*** HOLE CARDS ***
Dealt to FantasticDouble [Jd 8h]
HighCardJasper: raises 200 to 300
FantasticDouble: folds 
color_singleton: folds 
dhduncan: calls 250
manon327: folds 
*** FLOP *** [8s Td 6s]
dhduncan: checks 
HighCardJasper: bets 200
dhduncan: folds 
Uncalled bet (200) returned to HighCardJasper
HighCardJasper collected 661 from pot
HighCardJasper: doesn't show hand 
*** SUMMARY ***
Total pot 700 | Rake 39 
Board [8s Td 6s]
Seat 1: manon327 (big blind) folded before Flop
Seat 2: HighCardJasper collected (661)
Seat 3: FantasticDouble folded before Flop (didn't bet)
Seat 6: color_singleton (button) folded before Flop (didn't bet)
Seat 9: dhduncan (small blind) folded on the Flop



PokerStars Home Game Hand #222898390261: {DaPokaStars}  Hold'em No Limit (50/100) - 2021/01/21 18:15:59 ET
Table 'testnsdfgh' 9-max (Play Money) Seat #9 is the button
Seat 1: manon327 (2975 in chips) 
Seat 2: HighCardJasper (28096 in chips) 
Seat 3: FantasticDouble (10370 in chips) 
Seat 6: color_singleton (21180 in chips) 
Seat 9: dhduncan (13460 in chips) 
manon327: posts small blind 50
HighCardJasper: posts big blind 100
*** HOLE CARDS ***
Dealt to FantasticDouble [6d Ah]
FantasticDouble: raises 200 to 300
color_singleton: folds 
dhduncan: folds 
manon327: calls 250
HighCardJasper: calls 200
*** FLOP *** [9s Kc 6c]
manon327: checks 
HighCardJasper: checks 
FantasticDouble: bets 500
manon327: folds 
HighCardJasper: folds 
Uncalled bet (500) returned to FantasticDouble
FantasticDouble collected 850 from pot
*** SUMMARY ***
Total pot 900 | Rake 50 
Board [9s Kc 6c]
Seat 1: manon327 (small blind) folded on the Flop
Seat 2: HighCardJasper (big blind) folded on the Flop
Seat 3: FantasticDouble collected (850)
Seat 6: color_singleton folded before Flop (didn't bet)
Seat 9: dhduncan (button) folded before Flop (didn't bet)



PokerStars Home Game Hand #222898408063: {DaPokaStars}  Hold'em No Limit (50/100) - 2021/01/21 18:16:32 ET
Table 'testnsdfgh' 9-max (Play Money) Seat #1 is the button
Seat 1: manon327 (2675 in chips) 
Seat 2: HighCardJasper (27796 in chips) 
Seat 3: FantasticDouble (10920 in chips) 
Seat 6: color_singleton (21180 in chips) 
Seat 9: dhduncan (13460 in chips) 
HighCardJasper: posts small blind 50
FantasticDouble: posts big blind 100
*** HOLE CARDS ***
Dealt to FantasticDouble [5c Tc]
color_singleton: raises 200 to 300
dhduncan: folds 
manon327: calls 300
HighCardJasper: folds 
FantasticDouble: calls 200
*** FLOP *** [6d Kd Kh]
FantasticDouble: checks 
color_singleton: bets 449
manon327: raises 449 to 898
FantasticDouble: folds 
color_singleton: calls 449
*** TURN *** [6d Kd Kh] [8s]
color_singleton: bets 1297
manon327: raises 180 to 1477 and is all-in
color_singleton: calls 180
*** RIVER *** [6d Kd Kh 8s] [Qh]
*** SHOW DOWN ***
color_singleton: shows [7d 5d] (a pair of Kings)
manon327: shows [Qc Kc] (a full house, Kings full of Queens)
manon327 collected 5386 from pot
*** SUMMARY ***
Total pot 5700 | Rake 314 
Board [6d Kd Kh 8s Qh]
Seat 1: manon327 (button) showed [Qc Kc] and won (5386) with a full house, Kings full of Queens
Seat 2: HighCardJasper (small blind) folded before Flop
Seat 3: FantasticDouble (big blind) folded on the Flop
Seat 6: color_singleton showed [7d 5d] and lost with a pair of Kings
Seat 9: dhduncan folded before Flop (didn't bet)



PokerStars Home Game Hand #222898436533: {DaPokaStars}  Hold'em No Limit (50/100) - 2021/01/21 18:17:25 ET
Table 'testnsdfgh' 9-max (Play Money) Seat #2 is the button
Seat 1: manon327 (5386 in chips) 
Seat 2: HighCardJasper (27746 in chips) 
Seat 3: FantasticDouble (10620 in chips) 
Seat 6: color_singleton (18505 in chips) 
Seat 9: dhduncan (13460 in chips) 
FantasticDouble: posts small blind 50
color_singleton: posts big blind 100
*** HOLE CARDS ***
Dealt to FantasticDouble [6s 9d]
dhduncan: calls 100
manon327: calls 100
HighCardJasper: raises 100 to 200
FantasticDouble: calls 150
color_singleton: calls 100
dhduncan: calls 100
manon327: calls 100
*** FLOP *** [Jd Th 2h]
FantasticDouble: checks 
color_singleton: checks 
dhduncan: bets 100
manon327: calls 100
HighCardJasper: calls 100
FantasticDouble: folds 
color_singleton: calls 100
*** TURN *** [Jd Th 2h] [3h]
color_singleton: checks 
dhduncan: checks 
manon327: checks 
HighCardJasper: bets 200
color_singleton: folds 
dhduncan: folds 
manon327: folds 
Uncalled bet (200) returned to HighCardJasper
HighCardJasper collected 1323 from pot
HighCardJasper: doesn't show hand 
*** SUMMARY ***
Total pot 1400 | Rake 77 
Board [Jd Th 2h 3h]
Seat 1: manon327 folded on the Turn
Seat 2: HighCardJasper (button) collected (1323)
Seat 3: FantasticDouble (small blind) folded on the Flop
Seat 6: color_singleton (big blind) folded on the Turn
Seat 9: dhduncan folded on the Turn



PokerStars Home Game Hand #222898494903: {DaPokaStars}  Hold'em No Limit (50/100) - 2021/01/21 18:19:08 ET
Table 'testnsdfgh' 9-max (Play Money) Seat #3 is the button
Seat 1: manon327 (5086 in chips) 
Seat 2: HighCardJasper (28769 in chips) 
Seat 3: FantasticDouble (10420 in chips) 
Seat 6: color_singleton (18205 in chips) 
Seat 9: dhduncan (13160 in chips) 
color_singleton: posts small blind 50
dhduncan: posts big blind 100
*** HOLE CARDS ***
Dealt to FantasticDouble [3s Ts]
manon327: folds 
HighCardJasper: calls 100
FantasticDouble: calls 100
color_singleton: folds 
dhduncan: checks 
*** FLOP *** [Kc 8c Ad]
dhduncan: bets 100
HighCardJasper: folds 
FantasticDouble: folds 
Uncalled bet (100) returned to dhduncan
dhduncan collected 331 from pot
dhduncan: doesn't show hand 
*** SUMMARY ***
Total pot 350 | Rake 19 
Board [Kc 8c Ad]
Seat 1: manon327 folded before Flop (didn't bet)
Seat 2: HighCardJasper folded on the Flop
Seat 3: FantasticDouble (button) folded on the Flop
Seat 6: color_singleton (small blind) folded before Flop
Seat 9: dhduncan (big blind) collected (331)



PokerStars Home Game Hand #222898513286: {DaPokaStars}  Hold'em No Limit (50/100) - 2021/01/21 18:19:42 ET
Table 'testnsdfgh' 9-max (Play Money) Seat #6 is the button
Seat 1: manon327 (5086 in chips) 
Seat 2: HighCardJasper (28669 in chips) 
Seat 3: FantasticDouble (10320 in chips) 
Seat 6: color_singleton (18155 in chips) 
Seat 9: dhduncan (13391 in chips) 
dhduncan: posts small blind 50
manon327: posts big blind 100
*** HOLE CARDS ***
Dealt to FantasticDouble [Jc 4s]
HighCardJasper: calls 100
FantasticDouble: folds 
color_singleton: folds 
dhduncan: calls 50
manon327: checks 
*** FLOP *** [2d 9d 9s]
dhduncan: bets 100
manon327: folds 
HighCardJasper: calls 100
*** TURN *** [2d 9d 9s] [2c]
dhduncan: bets 100
HighCardJasper: folds 
Uncalled bet (100) returned to dhduncan
dhduncan collected 472 from pot
dhduncan: doesn't show hand 
*** SUMMARY ***
Total pot 500 | Rake 28 
Board [2d 9d 9s 2c]
Seat 1: manon327 (big blind) folded on the Flop
Seat 2: HighCardJasper folded on the Turn
Seat 3: FantasticDouble folded before Flop (didn't bet)
Seat 6: color_singleton (button) folded before Flop (didn't bet)
Seat 9: dhduncan (small blind) collected (472)



PokerStars Home Game Hand #222898528662: {DaPokaStars}  Hold'em No Limit (50/100) - 2021/01/21 18:20:11 ET
Table 'testnsdfgh' 9-max (Play Money) Seat #9 is the button
Seat 1: manon327 (4986 in chips) 
Seat 2: HighCardJasper (28469 in chips) 
Seat 3: FantasticDouble (10320 in chips) 
Seat 6: color_singleton (18155 in chips) 
Seat 9: dhduncan (13663 in chips) 
manon327: posts small blind 50
HighCardJasper: posts big blind 100
*** HOLE CARDS ***
Dealt to FantasticDouble [5s 3c]
FantasticDouble: folds 
color_singleton: folds 
dhduncan: folds 
manon327: calls 50
HighCardJasper: checks 
*** FLOP *** [2c Qd 7c]
manon327: checks 
HighCardJasper: checks 
*** TURN *** [2c Qd 7c] [Td]
manon327: checks 
HighCardJasper: checks 
*** RIVER *** [2c Qd 7c Td] [6s]
manon327: checks 
HighCardJasper: checks 
*** SHOW DOWN ***
manon327: shows [Ah 2s] (a pair of Deuces)
HighCardJasper: mucks hand 
manon327 collected 189 from pot
*** SUMMARY ***
Total pot 200 | Rake 11 
Board [2c Qd 7c Td 6s]
Seat 1: manon327 (small blind) showed [Ah 2s] and won (189) with a pair of Deuces
Seat 2: HighCardJasper (big blind) mucked [9c 4h]
Seat 3: FantasticDouble folded before Flop (didn't bet)
Seat 6: color_singleton folded before Flop (didn't bet)
Seat 9: dhduncan (button) folded before Flop (didn't bet)



PokerStars Home Game Hand #222898543417: {DaPokaStars}  Hold'em No Limit (50/100) - 2021/01/21 18:20:39 ET
Table 'testnsdfgh' 9-max (Play Money) Seat #1 is the button
Seat 1: manon327 (5075 in chips) 
Seat 2: HighCardJasper (28369 in chips) 
Seat 3: FantasticDouble (10320 in chips) 
Seat 6: color_singleton (18155 in chips) 
Seat 9: dhduncan (13663 in chips) 
HighCardJasper: posts small blind 50
FantasticDouble: posts big blind 100
*** HOLE CARDS ***
Dealt to FantasticDouble [Kd Kh]
color_singleton: raises 100 to 200
dhduncan: calls 200
manon327: calls 200
HighCardJasper: folds 
FantasticDouble: raises 400 to 600
color_singleton: calls 400
dhduncan: calls 400
manon327: folds 
*** FLOP *** [3h 5c Ah]
FantasticDouble: checks 
color_singleton: bets 968
dhduncan: calls 968
FantasticDouble: calls 968
*** TURN *** [3h 5c Ah] [Qs]
FantasticDouble: checks 
color_singleton: checks 
dhduncan: bets 4682
FantasticDouble: folds 
color_singleton: folds 
Uncalled bet (4682) returned to dhduncan
dhduncan collected 4682 from pot
dhduncan: doesn't show hand 
*** SUMMARY ***
Total pot 4954 | Rake 272 
Board [3h 5c Ah Qs]
Seat 1: manon327 (button) folded before Flop
Seat 2: HighCardJasper (small blind) folded before Flop
Seat 3: FantasticDouble (big blind) folded on the Turn
Seat 6: color_singleton folded on the Turn
Seat 9: dhduncan collected (4682)



PokerStars Home Game Hand #222898578786: {DaPokaStars}  Hold'em No Limit (50/100) - 2021/01/21 18:21:46 ET
Table 'testnsdfgh' 9-max (Play Money) Seat #2 is the button
Seat 1: manon327 (4875 in chips) 
Seat 2: HighCardJasper (28319 in chips) 
Seat 3: FantasticDouble (8752 in chips) 
Seat 6: color_singleton (16587 in chips) 
Seat 9: dhduncan (16777 in chips) 
FantasticDouble: posts small blind 50
color_singleton: posts big blind 100
*** HOLE CARDS ***
Dealt to FantasticDouble [Ts 5c]
dhduncan: calls 100
manon327: calls 100
HighCardJasper: calls 100
FantasticDouble: calls 50
color_singleton: checks 
*** FLOP *** [6c Ks Kd]
FantasticDouble: checks 
color_singleton: checks 
dhduncan: checks 
manon327: checks 
HighCardJasper: checks 
*** TURN *** [6c Ks Kd] [6d]
FantasticDouble: checks 
color_singleton: checks 
dhduncan: checks 
manon327: checks 
HighCardJasper: checks 
*** RIVER *** [6c Ks Kd 6d] [Ac]
FantasticDouble: checks 
color_singleton: checks 
dhduncan: checks 
manon327: checks 
HighCardJasper: bets 300
FantasticDouble: folds 
color_singleton: folds 
dhduncan: folds 
manon327: folds 
Uncalled bet (300) returned to HighCardJasper
HighCardJasper collected 472 from pot
HighCardJasper: doesn't show hand 
*** SUMMARY ***
Total pot 500 | Rake 28 
Board [6c Ks Kd 6d Ac]
Seat 1: manon327 folded on the River
Seat 2: HighCardJasper (button) collected (472)
Seat 3: FantasticDouble (small blind) folded on the River
Seat 6: color_singleton (big blind) folded on the River
Seat 9: dhduncan folded on the River



PokerStars Home Game Hand #222898614143: {DaPokaStars}  Hold'em No Limit (50/100) - 2021/01/21 18:22:54 ET
Table 'testnsdfgh' 9-max (Play Money) Seat #3 is the button
Seat 1: manon327 (4775 in chips) 
Seat 2: HighCardJasper (28691 in chips) 
Seat 3: FantasticDouble (8652 in chips) 
Seat 6: color_singleton (16487 in chips) 
Seat 9: dhduncan (16677 in chips) 
color_singleton: posts small blind 50
dhduncan: posts big blind 100
*** HOLE CARDS ***
Dealt to FantasticDouble [5c Th]
manon327: calls 100
HighCardJasper: raises 200 to 300
FantasticDouble: folds 
color_singleton: folds 
dhduncan: folds 
manon327: folds 
Uncalled bet (200) returned to HighCardJasper
HighCardJasper collected 350 from pot
HighCardJasper: doesn't show hand 
*** SUMMARY ***
Total pot 350 | Rake 0 
Seat 1: manon327 folded before Flop
Seat 2: HighCardJasper collected (350)
Seat 3: FantasticDouble (button) folded before Flop (didn't bet)
Seat 6: color_singleton (small blind) folded before Flop
Seat 9: dhduncan (big blind) folded before Flop



PokerStars Home Game Hand #222898629384: {DaPokaStars}  Hold'em No Limit (50/100) - 2021/01/21 18:23:23 ET
Table 'testnsdfgh' 9-max (Play Money) Seat #6 is the button
Seat 1: manon327 (4675 in chips) 
Seat 2: HighCardJasper (28941 in chips) 
Seat 3: FantasticDouble (8652 in chips) 
Seat 6: color_singleton (16437 in chips) 
Seat 9: dhduncan (16577 in chips) 
dhduncan: posts small blind 50
manon327: posts big blind 100
*** HOLE CARDS ***
Dealt to FantasticDouble [7c Js]
manon327 is disconnected 
HighCardJasper: raises 200 to 300
FantasticDouble: folds 
color_singleton: folds 
dhduncan: calls 250
manon327 has timed out while disconnected
manon327: folds 
*** FLOP *** [Qh Jc 7s]
dhduncan: bets 100
HighCardJasper: raises 200 to 300
dhduncan: calls 200
*** TURN *** [Qh Jc 7s] [7d]
dhduncan: bets 100
HighCardJasper: calls 100
*** RIVER *** [Qh Jc 7s 7d] [Ts]
dhduncan: checks 
HighCardJasper: bets 700
dhduncan is disconnected 
dhduncan has timed out while being disconnected
dhduncan: folds 
Uncalled bet (700) returned to HighCardJasper
HighCardJasper collected 1417 from pot
HighCardJasper: doesn't show hand 
*** SUMMARY ***
Total pot 1500 | Rake 83 
Board [Qh Jc 7s 7d Ts]
Seat 1: manon327 (big blind) folded before Flop
Seat 2: HighCardJasper collected (1417)
Seat 3: FantasticDouble folded before Flop (didn't bet)
Seat 6: color_singleton (button) folded before Flop (didn't bet)
Seat 9: dhduncan (small blind) folded on the River



PokerStars Home Game Hand #222898689192: {DaPokaStars}  Hold'em No Limit (50/100) - 2021/01/21 18:24:59 ET
Table 'testnsdfgh' 9-max (Play Money) Seat #1 is the button
Seat 1: manon327 (4575 in chips) 
Seat 2: HighCardJasper (29658 in chips) 
Seat 3: FantasticDouble (8652 in chips) 
Seat 6: color_singleton (16437 in chips) 
HighCardJasper: posts small blind 50
FantasticDouble: posts big blind 100
*** HOLE CARDS ***
Dealt to FantasticDouble [6s 2c]
color_singleton: folds 
manon327: calls 100
HighCardJasper: calls 50
FantasticDouble: checks 
*** FLOP *** [Qs 8d 3d]
HighCardJasper: checks 
FantasticDouble: checks 
manon327: checks 
*** TURN *** [Qs 8d 3d] [6d]
HighCardJasper: checks 
FantasticDouble: bets 200
manon327 has timed out
manon327: folds 
HighCardJasper: folds 
Uncalled bet (200) returned to FantasticDouble
FantasticDouble collected 283 from pot
*** SUMMARY ***
Total pot 300 | Rake 17 
Board [Qs 8d 3d 6d]
Seat 1: manon327 (button) folded on the Turn
Seat 2: HighCardJasper (small blind) folded on the Turn
Seat 3: FantasticDouble (big blind) collected (283)
Seat 6: color_singleton folded before Flop (didn't bet)



PokerStars Home Game Hand #222898715325: {DaPokaStars}  Hold'em No Limit (50/100) - 2021/01/21 18:25:49 ET
Table 'testnsdfgh' 9-max (Play Money) Seat #2 is the button
Seat 1: manon327 (4475 in chips) 
Seat 2: HighCardJasper (29558 in chips) 
Seat 3: FantasticDouble (8835 in chips) 
Seat 6: color_singleton (16437 in chips) 
FantasticDouble: posts small blind 50
color_singleton: posts big blind 100
*** HOLE CARDS ***
Dealt to FantasticDouble [Td Kh]
manon327: calls 100
HighCardJasper: calls 100
FantasticDouble: raises 400 to 500
color_singleton: folds 
manon327: folds 
HighCardJasper: folds 
Uncalled bet (400) returned to FantasticDouble
FantasticDouble collected 400 from pot
*** SUMMARY ***
Total pot 400 | Rake 0 
Seat 1: manon327 folded before Flop
Seat 2: HighCardJasper (button) folded before Flop
Seat 3: FantasticDouble (small blind) collected (400)
Seat 6: color_singleton (big blind) folded before Flop



PokerStars Home Game Hand #222898728125: {DaPokaStars}  Hold'em No Limit (50/100) - 2021/01/21 18:26:14 ET
Table 'testnsdfgh' 9-max (Play Money) Seat #3 is the button
Seat 1: manon327 (4375 in chips) 
Seat 2: HighCardJasper (29458 in chips) 
Seat 3: FantasticDouble (9135 in chips) 
Seat 6: color_singleton (16337 in chips) 
color_singleton: posts small blind 50
manon327: posts big blind 100
*** HOLE CARDS ***
Dealt to FantasticDouble [7d 3c]
HighCardJasper: calls 100
FantasticDouble: folds 
color_singleton: raises 200 to 300
manon327: folds 
HighCardJasper: calls 200
*** FLOP *** [Kh 8c Jh]
color_singleton: bets 330
HighCardJasper: raises 470 to 800
color_singleton: folds 
Uncalled bet (470) returned to HighCardJasper
HighCardJasper collected 1285 from pot
HighCardJasper: doesn't show hand 
*** SUMMARY ***
Total pot 1360 | Rake 75 
Board [Kh 8c Jh]
Seat 1: manon327 (big blind) folded before Flop
Seat 2: HighCardJasper collected (1285)
Seat 3: FantasticDouble (button) folded before Flop (didn't bet)
Seat 6: color_singleton (small blind) folded on the Flop



PokerStars Home Game Hand #222898741656: {DaPokaStars}  Hold'em No Limit (50/100) - 2021/01/21 18:26:40 ET
Table 'testnsdfgh' 9-max (Play Money) Seat #6 is the button
Seat 1: manon327 (4275 in chips) 
Seat 2: HighCardJasper (30113 in chips) 
Seat 3: FantasticDouble (9135 in chips) 
Seat 6: color_singleton (15707 in chips) 
manon327: posts small blind 50
HighCardJasper: posts big blind 100
*** HOLE CARDS ***
Dealt to FantasticDouble [4d 9s]
FantasticDouble: folds 
color_singleton: raises 200 to 300
manon327: folds 
HighCardJasper: calls 200
*** FLOP *** [8d 4s 5h]
HighCardJasper: checks 
color_singleton: bets 614
HighCardJasper: folds 
Uncalled bet (614) returned to color_singleton
color_singleton collected 614 from pot
color_singleton: doesn't show hand 
*** SUMMARY ***
Total pot 650 | Rake 36 
Board [8d 4s 5h]
Seat 1: manon327 (small blind) folded before Flop
Seat 2: HighCardJasper (big blind) folded on the Flop
Seat 3: FantasticDouble folded before Flop (didn't bet)
Seat 6: color_singleton (button) collected (614)



PokerStars Home Game Hand #222898758875: {DaPokaStars}  Hold'em No Limit (50/100) - 2021/01/21 18:27:14 ET
Table 'testnsdfgh' 9-max (Play Money) Seat #1 is the button
Seat 1: manon327 (4225 in chips) 
Seat 2: HighCardJasper (29813 in chips) 
Seat 3: FantasticDouble (9135 in chips) 
Seat 6: color_singleton (16021 in chips) 
HighCardJasper: posts small blind 50
FantasticDouble: posts big blind 100
*** HOLE CARDS ***
Dealt to FantasticDouble [5d 3h]
color_singleton: folds 
manon327: folds 
HighCardJasper: calls 50
FantasticDouble: checks 
*** FLOP *** [8s Ks Ah]
HighCardJasper: checks 
FantasticDouble: checks 
*** TURN *** [8s Ks Ah] [8h]
HighCardJasper: bets 300
FantasticDouble: folds 
Uncalled bet (300) returned to HighCardJasper
HighCardJasper collected 189 from pot
HighCardJasper: doesn't show hand 
*** SUMMARY ***
Total pot 200 | Rake 11 
Board [8s Ks Ah 8h]
Seat 1: manon327 (button) folded before Flop (didn't bet)
Seat 2: HighCardJasper (small blind) collected (189)
Seat 3: FantasticDouble (big blind) folded on the Turn
Seat 6: color_singleton folded before Flop (didn't bet)



PokerStars Home Game Hand #222898768171: {DaPokaStars}  Hold'em No Limit (50/100) - 2021/01/21 18:27:32 ET
Table 'testnsdfgh' 9-max (Play Money) Seat #2 is the button
Seat 1: manon327 (4225 in chips) 
Seat 2: HighCardJasper (29902 in chips) 
Seat 3: FantasticDouble (9035 in chips) 
Seat 6: color_singleton (16021 in chips) 
Seat 9: dhduncan (15877 in chips) 
FantasticDouble: posts small blind 50
color_singleton: posts big blind 100
dhduncan: posts small & big blinds 150
*** HOLE CARDS ***
Dealt to FantasticDouble [9c 8s]
dhduncan: raises 100 to 200
manon327: calls 200
HighCardJasper: folds 
FantasticDouble: folds 
color_singleton: calls 100
*** FLOP *** [4s Qs Tc]
color_singleton: bets 330
dhduncan: folds 
manon327: calls 330
*** TURN *** [4s Qs Tc] [7s]
color_singleton: bets 642
manon327: raises 642 to 1284
color_singleton: calls 642
*** RIVER *** [4s Qs Tc 7s] [Qh]
color_singleton: checks 
manon327: bets 2411 and is all-in
color_singleton: folds 
Uncalled bet (2411) returned to manon327
manon327 collected 3712 from pot
*** SUMMARY ***
Total pot 3928 | Rake 216 
Board [4s Qs Tc 7s Qh]
Seat 1: manon327 collected (3712)
Seat 2: HighCardJasper (button) folded before Flop (didn't bet)
Seat 3: FantasticDouble (small blind) folded before Flop
Seat 6: color_singleton (big blind) folded on the River
Seat 9: dhduncan folded on the Flop



PokerStars Home Game Hand #222898800077: {DaPokaStars}  Hold'em No Limit (50/100) - 2021/01/21 18:28:34 ET
Table 'testnsdfgh' 9-max (Play Money) Seat #3 is the button
Seat 1: manon327 (6123 in chips) 
Seat 2: HighCardJasper (29902 in chips) 
Seat 3: FantasticDouble (8985 in chips) 
Seat 6: color_singleton (14207 in chips) 
Seat 9: dhduncan (15627 in chips) 
color_singleton: posts small blind 50
dhduncan: posts big blind 100
*** HOLE CARDS ***
Dealt to FantasticDouble [6s Qd]
manon327: folds 
HighCardJasper: calls 100
FantasticDouble: raises 300 to 400
color_singleton: folds 
dhduncan: folds 
HighCardJasper: calls 300
*** FLOP *** [2c 2h 2s]
HighCardJasper: bets 300
FantasticDouble: calls 300
*** TURN *** [2c 2h 2s] [8c]
HighCardJasper: checks 
FantasticDouble: bets 1000
HighCardJasper: folds 
Uncalled bet (1000) returned to FantasticDouble
FantasticDouble collected 1465 from pot
*** SUMMARY ***
Total pot 1550 | Rake 85 
Board [2c 2h 2s 8c]
Seat 1: manon327 folded before Flop (didn't bet)
Seat 2: HighCardJasper folded on the Turn
Seat 3: FantasticDouble (button) collected (1465)
Seat 6: color_singleton (small blind) folded before Flop
Seat 9: dhduncan (big blind) folded before Flop



PokerStars Home Game Hand #222898819716: {DaPokaStars}  Hold'em No Limit (50/100) - 2021/01/21 18:29:12 ET
Table 'testnsdfgh' 9-max (Play Money) Seat #6 is the button
Seat 1: manon327 (6123 in chips) 
Seat 2: HighCardJasper (29202 in chips) 
Seat 3: FantasticDouble (9750 in chips) 
Seat 6: color_singleton (14157 in chips) 
Seat 9: dhduncan (15527 in chips) 
dhduncan: posts small blind 50
manon327: posts big blind 100
*** HOLE CARDS ***
Dealt to FantasticDouble [6d 9s]
HighCardJasper: calls 100
FantasticDouble: folds 
color_singleton: folds 
dhduncan: folds 
manon327: checks 
*** FLOP *** [7c Th 3d]
manon327: checks 
HighCardJasper: checks 
*** TURN *** [7c Th 3d] [4d]
manon327: checks 
HighCardJasper: checks 
*** RIVER *** [7c Th 3d 4d] [9h]
manon327: checks 
HighCardJasper: checks 
*** SHOW DOWN ***
manon327: shows [Jd 6c] (high card Jack)
HighCardJasper: mucks hand 
manon327 collected 236 from pot
*** SUMMARY ***
Total pot 250 | Rake 14 
Board [7c Th 3d 4d 9h]
Seat 1: manon327 (big blind) showed [Jd 6c] and won (236) with high card Jack
Seat 2: HighCardJasper mucked [5c Jh]
Seat 3: FantasticDouble folded before Flop (didn't bet)
Seat 6: color_singleton (button) folded before Flop (didn't bet)
Seat 9: dhduncan (small blind) folded before Flop



PokerStars Home Game Hand #222898836312: {DaPokaStars}  Hold'em No Limit (50/100) - 2021/01/21 18:29:45 ET
Table 'testnsdfgh' 9-max (Play Money) Seat #9 is the button
Seat 1: manon327 (6259 in chips) 
Seat 2: HighCardJasper (29102 in chips) 
Seat 3: FantasticDouble (9750 in chips) 
Seat 6: color_singleton (14157 in chips) 
Seat 9: dhduncan (15477 in chips) 
manon327: posts small blind 50
HighCardJasper: posts big blind 100
*** HOLE CARDS ***
Dealt to FantasticDouble [Kd Jh]
FantasticDouble: raises 300 to 400
color_singleton: calls 400
dhduncan: folds 
manon327: folds 
HighCardJasper: calls 300
*** FLOP *** [Ad 6s 9d]
HighCardJasper: bets 300
FantasticDouble: folds 
color_singleton: raises 300 to 600
HighCardJasper: calls 300
*** TURN *** [Ad 6s 9d] [5d]
HighCardJasper: bets 700
color_singleton: raises 1200 to 1900
HighCardJasper: calls 1200
*** RIVER *** [Ad 6s 9d 5d] [Ah]
HighCardJasper: checks 
color_singleton: bets 5906
HighCardJasper: calls 5906
*** SHOW DOWN ***
color_singleton: shows [5c As] (a full house, Aces full of Fives)
HighCardJasper: mucks hand 
color_singleton collected 17069 from pot
*** SUMMARY ***
Total pot 18062 | Rake 993 
Board [Ad 6s 9d 5d Ah]
Seat 1: manon327 (small blind) folded before Flop
Seat 2: HighCardJasper (big blind) mucked [7d 4d]
Seat 3: FantasticDouble folded on the Flop
Seat 6: color_singleton showed [5c As] and won (17069) with a full house, Aces full of Fives
Seat 9: dhduncan (button) folded before Flop (didn't bet)



PokerStars Home Game Hand #222898865880: {DaPokaStars}  Hold'em No Limit (50/100) - 2021/01/21 18:30:41 ET
Table 'testnsdfgh' 9-max (Play Money) Seat #1 is the button
Seat 1: manon327 (6209 in chips) 
Seat 2: HighCardJasper (20296 in chips) 
Seat 3: FantasticDouble (9350 in chips) 
Seat 6: color_singleton (22420 in chips) 
Seat 9: dhduncan (15477 in chips) 
HighCardJasper: posts small blind 50
FantasticDouble: posts big blind 100
*** HOLE CARDS ***
Dealt to FantasticDouble [9h 4c]
color_singleton: folds 
dhduncan: calls 100
manon327: folds 
HighCardJasper: calls 50
FantasticDouble: checks 
*** FLOP *** [8s 6d 7h]
HighCardJasper: checks 
FantasticDouble: bets 300
dhduncan: calls 300
HighCardJasper: folds 
*** TURN *** [8s 6d 7h] [As]
FantasticDouble: bets 500
dhduncan: raises 500 to 1000
FantasticDouble: calls 500
*** RIVER *** [8s 6d 7h As] [8d]
FantasticDouble: checks 
dhduncan: bets 3500
FantasticDouble: folds 
Uncalled bet (3500) returned to dhduncan
dhduncan collected 2740 from pot
dhduncan: doesn't show hand 
*** SUMMARY ***
Total pot 2900 | Rake 160 
Board [8s 6d 7h As 8d]
Seat 1: manon327 (button) folded before Flop (didn't bet)
Seat 2: HighCardJasper (small blind) folded on the Flop
Seat 3: FantasticDouble (big blind) folded on the River
Seat 6: color_singleton folded before Flop (didn't bet)
Seat 9: dhduncan collected (2740)



PokerStars Home Game Hand #222898897113: {DaPokaStars}  Hold'em No Limit (50/100) - 2021/01/21 18:31:41 ET
Table 'testnsdfgh' 9-max (Play Money) Seat #2 is the button
Seat 1: manon327 (6209 in chips) 
Seat 2: HighCardJasper (20196 in chips) 
Seat 3: FantasticDouble (7950 in chips) 
Seat 6: color_singleton (22420 in chips) 
Seat 9: dhduncan (16817 in chips) 
FantasticDouble: posts small blind 50
color_singleton: posts big blind 100
*** HOLE CARDS ***
Dealt to FantasticDouble [7h 3h]
dhduncan: raises 100 to 200
manon327: calls 200
HighCardJasper: calls 200
FantasticDouble: calls 150
color_singleton: calls 100
*** FLOP *** [Qh Qd 9h]
FantasticDouble: bets 400
color_singleton: folds 
dhduncan: calls 400
manon327: folds 
HighCardJasper: folds 
*** TURN *** [Qh Qd 9h] [Jh]
FantasticDouble: bets 900
dhduncan: calls 900
*** RIVER *** [Qh Qd 9h Jh] [6s]
FantasticDouble: bets 1900
dhduncan: calls 1900
*** SHOW DOWN ***
FantasticDouble: shows [7h 3h] (a flush, Queen high)
dhduncan: mucks hand 
FantasticDouble collected 6993 from pot
*** SUMMARY ***
Total pot 7400 | Rake 407 
Board [Qh Qd 9h Jh 6s]
Seat 1: manon327 folded on the Flop
Seat 2: HighCardJasper (button) folded on the Flop
Seat 3: FantasticDouble (small blind) showed [7h 3h] and won (6993) with a flush, Queen high
Seat 6: color_singleton (big blind) folded on the Flop
Seat 9: dhduncan mucked [Kc Kh]



PokerStars Home Game Hand #222898911827: {DaPokaStars}  Hold'em No Limit (50/100) - 2021/01/21 18:32:10 ET
Table 'testnsdfgh' 9-max (Play Money) Seat #3 is the button
Seat 1: manon327 (6009 in chips) 
Seat 2: HighCardJasper (19996 in chips) 
Seat 3: FantasticDouble (11543 in chips) 
Seat 6: color_singleton (22220 in chips) 
Seat 9: dhduncan (13417 in chips) 
color_singleton: posts small blind 50
dhduncan: posts big blind 100
*** HOLE CARDS ***
Dealt to FantasticDouble [7d 5h]
manon327: calls 100
HighCardJasper: calls 100
FantasticDouble: folds 
color_singleton: folds 
dhduncan: checks 
*** FLOP *** [6d 6s As]
dhduncan: checks 
manon327: bets 100
HighCardJasper: calls 100
dhduncan: folds 
*** TURN *** [6d 6s As] [Td]
manon327: bets 100
HighCardJasper: folds 
Uncalled bet (100) returned to manon327
manon327 collected 520 from pot
*** SUMMARY ***
Total pot 550 | Rake 30 
Board [6d 6s As Td]
Seat 1: manon327 collected (520)
Seat 2: HighCardJasper folded on the Turn
Seat 3: FantasticDouble (button) folded before Flop (didn't bet)
Seat 6: color_singleton (small blind) folded before Flop
Seat 9: dhduncan (big blind) folded on the Flop



PokerStars Home Game Hand #222898931447: {DaPokaStars}  Hold'em No Limit (50/100) - 2021/01/21 18:32:47 ET
Table 'testnsdfgh' 9-max (Play Money) Seat #6 is the button
Seat 1: manon327 (6329 in chips) 
Seat 2: HighCardJasper (19796 in chips) 
Seat 3: FantasticDouble (11543 in chips) 
Seat 6: color_singleton (22170 in chips) 
Seat 9: dhduncan (13317 in chips) 
dhduncan: posts small blind 50
manon327: posts big blind 100
*** HOLE CARDS ***
Dealt to FantasticDouble [3s Th]
HighCardJasper: calls 100
FantasticDouble: folds 
color_singleton: folds 
dhduncan: folds 
manon327: checks 
*** FLOP *** [2c Td Ah]
manon327: checks 
HighCardJasper: checks 
*** TURN *** [2c Td Ah] [Jh]
manon327: checks 
HighCardJasper: checks 
*** RIVER *** [2c Td Ah Jh] [6h]
manon327: checks 
HighCardJasper: bets 500
manon327: folds 
Uncalled bet (500) returned to HighCardJasper
HighCardJasper collected 236 from pot
HighCardJasper: doesn't show hand 
*** SUMMARY ***
Total pot 250 | Rake 14 
Board [2c Td Ah Jh 6h]
Seat 1: manon327 (big blind) folded on the River
Seat 2: HighCardJasper collected (236)
Seat 3: FantasticDouble folded before Flop (didn't bet)
Seat 6: color_singleton (button) folded before Flop (didn't bet)
Seat 9: dhduncan (small blind) folded before Flop



PokerStars Home Game Hand #222898956064: {DaPokaStars}  Hold'em No Limit (50/100) - 2021/01/21 18:33:34 ET
Table 'testnsdfgh' 9-max (Play Money) Seat #9 is the button
Seat 2: HighCardJasper (19932 in chips) 
Seat 3: FantasticDouble (11543 in chips) 
Seat 6: color_singleton (22170 in chips) 
Seat 9: dhduncan (13267 in chips) 
HighCardJasper: posts small blind 50
FantasticDouble: posts big blind 100
*** HOLE CARDS ***
Dealt to FantasticDouble [Td 3d]
color_singleton: raises 200 to 300
dhduncan: folds 
HighCardJasper: calls 250
FantasticDouble: folds 
*** FLOP *** [2h Qc Kc]
HighCardJasper: checks 
color_singleton: bets 330
HighCardJasper: folds 
Uncalled bet (330) returned to color_singleton
color_singleton collected 661 from pot
color_singleton: doesn't show hand 
*** SUMMARY ***
Total pot 700 | Rake 39 
Board [2h Qc Kc]
Seat 2: HighCardJasper (small blind) folded on the Flop
Seat 3: FantasticDouble (big blind) folded before Flop
Seat 6: color_singleton collected (661)
Seat 9: dhduncan (button) folded before Flop (didn't bet)



PokerStars Home Game Hand #222898973056: {DaPokaStars}  Hold'em No Limit (50/100) - 2021/01/21 18:34:07 ET
Table 'testnsdfgh' 9-max (Play Money) Seat #2 is the button
Seat 2: HighCardJasper (19632 in chips) 
Seat 3: FantasticDouble (11443 in chips) 
Seat 6: color_singleton (22531 in chips) 
Seat 9: dhduncan (13267 in chips) 
FantasticDouble: posts small blind 50
color_singleton: posts big blind 100
*** HOLE CARDS ***
Dealt to FantasticDouble [2c 6s]
dhduncan: folds 
HighCardJasper: calls 100
FantasticDouble: calls 50
color_singleton: checks 
*** FLOP *** [7c 9s 3d]
FantasticDouble: checks 
color_singleton: checks 
HighCardJasper: checks 
*** TURN *** [7c 9s 3d] [Tc]
FantasticDouble: checks 
color_singleton: bets 141
manon327 leaves the table
HighCardJasper: calls 141
FantasticDouble: folds 
*** RIVER *** [7c 9s 3d Tc] [4h]
color_singleton: checks 
HighCardJasper: checks 
*** SHOW DOWN ***
color_singleton: shows [Qd 8d] (high card Queen)
HighCardJasper: shows [4c Ah] (a pair of Fours)
HighCardJasper collected 550 from pot
*** SUMMARY ***
Total pot 582 | Rake 32 
Board [7c 9s 3d Tc 4h]
Seat 2: HighCardJasper (button) showed [4c Ah] and won (550) with a pair of Fours
Seat 3: FantasticDouble (small blind) folded on the Turn
Seat 6: color_singleton (big blind) showed [Qd 8d] and lost with high card Queen
Seat 9: dhduncan folded before Flop (didn't bet)



PokerStars Home Game Hand #222898999096: {DaPokaStars}  Hold'em No Limit (50/100) - 2021/01/21 18:34:57 ET
Table 'testnsdfgh' 9-max (Play Money) Seat #3 is the button
Seat 2: HighCardJasper (19941 in chips) 
Seat 3: FantasticDouble (11343 in chips) 
Seat 6: color_singleton (22290 in chips) 
Seat 9: dhduncan (13267 in chips) 
color_singleton: posts small blind 50
dhduncan: posts big blind 100
*** HOLE CARDS ***
Dealt to FantasticDouble [9h 4d]
HighCardJasper: raises 100 to 200
FantasticDouble: folds 
color_singleton: calls 150
dhduncan: calls 100
*** FLOP *** [5c Ks 4s]
color_singleton: checks 
dhduncan: checks 
HighCardJasper: checks 
*** TURN *** [5c Ks 4s] [8c]
color_singleton: bets 283
dhduncan: folds 
HighCardJasper: folds 
Uncalled bet (283) returned to color_singleton
color_singleton collected 567 from pot
color_singleton: doesn't show hand 
*** SUMMARY ***
Total pot 600 | Rake 33 
Board [5c Ks 4s 8c]
Seat 2: HighCardJasper folded on the Turn
Seat 3: FantasticDouble (button) folded before Flop (didn't bet)
Seat 6: color_singleton (small blind) collected (567)
Seat 9: dhduncan (big blind) folded on the Turn



PokerStars Home Game Hand #222899014792: {DaPokaStars}  Hold'em No Limit (50/100) - 2021/01/21 18:35:27 ET
Table 'testnsdfgh' 9-max (Play Money) Seat #6 is the button
Seat 2: HighCardJasper (19741 in chips) 
Seat 3: FantasticDouble (11343 in chips) 
Seat 6: color_singleton (22657 in chips) 
Seat 9: dhduncan (13067 in chips) 
dhduncan: posts small blind 50
HighCardJasper: posts big blind 100
*** HOLE CARDS ***
Dealt to FantasticDouble [9d 8d]
FantasticDouble: raises 300 to 400
color_singleton: folds 
dhduncan: folds 
HighCardJasper: calls 300
*** FLOP *** [3h As 2h]
HighCardJasper: checks 
FantasticDouble: checks 
*** TURN *** [3h As 2h] [2s]
HighCardJasper: checks 
FantasticDouble: checks 
*** RIVER *** [3h As 2h 2s] [5h]
HighCardJasper: checks 
FantasticDouble: checks 
*** SHOW DOWN ***
HighCardJasper: shows [Jc Th] (a pair of Deuces)
FantasticDouble: mucks hand 
HighCardJasper collected 803 from pot
*** SUMMARY ***
Total pot 850 | Rake 47 
Board [3h As 2h 2s 5h]
Seat 2: HighCardJasper (big blind) showed [Jc Th] and won (803) with a pair of Deuces
Seat 3: FantasticDouble mucked [9d 8d]
Seat 6: color_singleton (button) folded before Flop (didn't bet)
Seat 9: dhduncan (small blind) folded before Flop



PokerStars Home Game Hand #222899026959: {DaPokaStars}  Hold'em No Limit (50/100) - 2021/01/21 18:35:51 ET
Table 'testnsdfgh' 9-max (Play Money) Seat #9 is the button
Seat 2: HighCardJasper (20144 in chips) 
Seat 3: FantasticDouble (10943 in chips) 
Seat 6: color_singleton (22657 in chips) 
Seat 9: dhduncan (13017 in chips) 
HighCardJasper: posts small blind 50
FantasticDouble: posts big blind 100
*** HOLE CARDS ***
Dealt to FantasticDouble [8d 6s]
color_singleton: folds 
dhduncan: folds 
HighCardJasper: calls 50
FantasticDouble: checks 
*** FLOP *** [3s Qc As]
HighCardJasper: bets 300
FantasticDouble: folds 
Uncalled bet (300) returned to HighCardJasper
HighCardJasper collected 189 from pot
HighCardJasper: doesn't show hand 
*** SUMMARY ***
Total pot 200 | Rake 11 
Board [3s Qc As]
Seat 2: HighCardJasper (small blind) collected (189)
Seat 3: FantasticDouble (big blind) folded on the Flop
Seat 6: color_singleton folded before Flop (didn't bet)
Seat 9: dhduncan (button) folded before Flop (didn't bet)



PokerStars Home Game Hand #222899033997: {DaPokaStars}  Hold'em No Limit (50/100) - 2021/01/21 18:36:05 ET
Table 'testnsdfgh' 9-max (Play Money) Seat #2 is the button
Seat 2: HighCardJasper (20233 in chips) 
Seat 3: FantasticDouble (10843 in chips) 
Seat 6: color_singleton (22657 in chips) 
Seat 9: dhduncan (13017 in chips) 
FantasticDouble: posts small blind 50
color_singleton: posts big blind 100
*** HOLE CARDS ***
Dealt to FantasticDouble [2c Td]
dhduncan: calls 100
HighCardJasper: calls 100
FantasticDouble: calls 50
color_singleton: raises 200 to 300
dhduncan: calls 200
HighCardJasper: folds 
FantasticDouble: folds 
*** FLOP *** [Jh 3h 7d]
color_singleton: bets 756
dhduncan: folds 
Uncalled bet (756) returned to color_singleton
color_singleton collected 756 from pot
color_singleton: doesn't show hand 
*** SUMMARY ***
Total pot 800 | Rake 44 
Board [Jh 3h 7d]
Seat 2: HighCardJasper (button) folded before Flop
Seat 3: FantasticDouble (small blind) folded before Flop
Seat 6: color_singleton (big blind) collected (756)
Seat 9: dhduncan folded on the Flop



PokerStars Home Game Hand #222899049061: {DaPokaStars}  Hold'em No Limit (50/100) - 2021/01/21 18:36:34 ET
Table 'testnsdfgh' 9-max (Play Money) Seat #3 is the button
Seat 2: HighCardJasper (20133 in chips) 
Seat 3: FantasticDouble (10743 in chips) 
Seat 6: color_singleton (23113 in chips) 
Seat 9: dhduncan (12717 in chips) 
color_singleton: posts small blind 50
dhduncan: posts big blind 100
*** HOLE CARDS ***
Dealt to FantasticDouble [2h 2c]
HighCardJasper: calls 100
FantasticDouble: raises 400 to 500
color_singleton: folds 
dhduncan: folds 
HighCardJasper: folds 
Uncalled bet (400) returned to FantasticDouble
FantasticDouble collected 350 from pot
*** SUMMARY ***
Total pot 350 | Rake 0 
Seat 2: HighCardJasper folded before Flop
Seat 3: FantasticDouble (button) collected (350)
Seat 6: color_singleton (small blind) folded before Flop
Seat 9: dhduncan (big blind) folded before Flop



PokerStars Home Game Hand #222899055184: {DaPokaStars}  Hold'em No Limit (50/100) - 2021/01/21 18:36:46 ET
Table 'testnsdfgh' 9-max (Play Money) Seat #6 is the button
Seat 2: HighCardJasper (20033 in chips) 
Seat 3: FantasticDouble (10993 in chips) 
Seat 6: color_singleton (23063 in chips) 
Seat 9: dhduncan (12617 in chips) 
dhduncan: posts small blind 50
HighCardJasper: posts big blind 100
*** HOLE CARDS ***
Dealt to FantasticDouble [8d 2h]
FantasticDouble: folds 
color_singleton: raises 100 to 200
dhduncan: folds 
HighCardJasper: calls 100
*** FLOP *** [Qs Ks Ad]
HighCardJasper: bets 200
color_singleton: folds 
Uncalled bet (200) returned to HighCardJasper
HighCardJasper collected 425 from pot
HighCardJasper: doesn't show hand 
*** SUMMARY ***
Total pot 450 | Rake 25 
Board [Qs Ks Ad]
Seat 2: HighCardJasper (big blind) collected (425)
Seat 3: FantasticDouble folded before Flop (didn't bet)
Seat 6: color_singleton (button) folded on the Flop
Seat 9: dhduncan (small blind) folded before Flop



PokerStars Home Game Hand #222899068122: {DaPokaStars}  Hold'em No Limit (50/100) - 2021/01/21 18:37:12 ET
Table 'testnsdfgh' 9-max (Play Money) Seat #9 is the button
Seat 2: HighCardJasper (20258 in chips) 
Seat 3: FantasticDouble (10993 in chips) 
Seat 6: color_singleton (22863 in chips) 
Seat 9: dhduncan (12567 in chips) 
HighCardJasper: posts small blind 50
FantasticDouble: posts big blind 100
*** HOLE CARDS ***
Dealt to FantasticDouble [Ad Ts]
color_singleton: folds 
dhduncan: folds 
HighCardJasper: raises 100 to 200
FantasticDouble: raises 300 to 500
HighCardJasper: calls 300
*** FLOP *** [7c 9d 5h]
HighCardJasper: checks 
FantasticDouble: bets 500
HighCardJasper: folds 
Uncalled bet (500) returned to FantasticDouble
FantasticDouble collected 945 from pot
*** SUMMARY ***
Total pot 1000 | Rake 55 
Board [7c 9d 5h]
Seat 2: HighCardJasper (small blind) folded on the Flop
Seat 3: FantasticDouble (big blind) collected (945)
Seat 6: color_singleton folded before Flop (didn't bet)
Seat 9: dhduncan (button) folded before Flop (didn't bet)



PokerStars Home Game Hand #222899083829: {DaPokaStars}  Hold'em No Limit (50/100) - 2021/01/21 18:37:42 ET
Table 'testnsdfgh' 9-max (Play Money) Seat #2 is the button
Seat 2: HighCardJasper (19758 in chips) 
Seat 3: FantasticDouble (11438 in chips) 
Seat 6: color_singleton (22863 in chips) 
Seat 9: dhduncan (12567 in chips) 
FantasticDouble: posts small blind 50
color_singleton: posts big blind 100
*** HOLE CARDS ***
Dealt to FantasticDouble [Ah Ac]
dhduncan: raises 100 to 200
HighCardJasper: calls 200
FantasticDouble: raises 400 to 600
color_singleton: folds 
dhduncan: calls 400
HighCardJasper: folds 
*** FLOP *** [4c Qc Js]
FantasticDouble: bets 900
dhduncan: raises 900 to 1800
FantasticDouble: calls 900
*** TURN *** [4c Qc Js] [9s]
FantasticDouble: checks 
dhduncan: bets 100
FantasticDouble: raises 1900 to 2000
dhduncan: calls 1900
*** RIVER *** [4c Qc Js 9s] [Th]
FantasticDouble: checks 
dhduncan: bets 8167 and is all-in
FantasticDouble: folds 
Uncalled bet (8167) returned to dhduncan
dhduncan collected 8599 from pot
dhduncan: doesn't show hand 
*** SUMMARY ***
Total pot 9100 | Rake 501 
Board [4c Qc Js 9s Th]
Seat 2: HighCardJasper (button) folded before Flop
Seat 3: FantasticDouble (small blind) folded on the River
Seat 6: color_singleton (big blind) folded before Flop
Seat 9: dhduncan collected (8599)



PokerStars Home Game Hand #222899113335: {DaPokaStars}  Hold'em No Limit (50/100) - 2021/01/21 18:38:40 ET
Table 'testnsdfgh' 9-max (Play Money) Seat #3 is the button
Seat 2: HighCardJasper (19558 in chips) 
Seat 3: FantasticDouble (7038 in chips) 
Seat 6: color_singleton (22763 in chips) 
Seat 9: dhduncan (16766 in chips) 
color_singleton: posts small blind 50
dhduncan: posts big blind 100
*** HOLE CARDS ***
Dealt to FantasticDouble [6s 9c]
HighCardJasper: calls 100
FantasticDouble: folds 
color_singleton: calls 50
dhduncan: checks 
*** FLOP *** [Th 6h Js]
color_singleton: bets 141
dhduncan: folds 
HighCardJasper: raises 141 to 282
color_singleton: calls 141
*** TURN *** [Th 6h Js] [6d]
color_singleton: checks 
HighCardJasper: bets 408
color_singleton: folds 
Uncalled bet (408) returned to HighCardJasper
HighCardJasper collected 816 from pot
HighCardJasper: doesn't show hand 
*** SUMMARY ***
Total pot 864 | Rake 48 
Board [Th 6h Js 6d]
Seat 2: HighCardJasper collected (816)
Seat 3: FantasticDouble (button) folded before Flop (didn't bet)
Seat 6: color_singleton (small blind) folded on the Turn
Seat 9: dhduncan (big blind) folded on the Flop



PokerStars Home Game Hand #222899138801: {DaPokaStars}  Hold'em No Limit (50/100) - 2021/01/21 18:39:30 ET
Table 'testnsdfgh' 9-max (Play Money) Seat #6 is the button
Seat 2: HighCardJasper (19992 in chips) 
Seat 3: FantasticDouble (7038 in chips) 
Seat 6: color_singleton (22381 in chips) 
Seat 9: dhduncan (16666 in chips) 
dhduncan: posts small blind 50
HighCardJasper: posts big blind 100
*** HOLE CARDS ***
Dealt to FantasticDouble [7c Qd]
FantasticDouble: folds 
color_singleton: raises 200 to 300
dhduncan: calls 250
HighCardJasper: folds 
*** FLOP *** [6h 7d 9c]
dhduncan: checks 
color_singleton: checks 
*** TURN *** [6h 7d 9c] [2h]
dhduncan: checks 
color_singleton: checks 
*** RIVER *** [6h 7d 9c 2h] [3c]
dhduncan: checks 
color_singleton: checks 
*** SHOW DOWN ***
dhduncan: shows [Ac 9s] (a pair of Nines)
color_singleton: mucks hand 
dhduncan collected 661 from pot
*** SUMMARY ***
Total pot 700 | Rake 39 
Board [6h 7d 9c 2h 3c]
Seat 2: HighCardJasper (big blind) folded before Flop
Seat 3: FantasticDouble folded before Flop (didn't bet)
Seat 6: color_singleton (button) mucked [5d 3d]
Seat 9: dhduncan (small blind) showed [Ac 9s] and won (661) with a pair of Nines



PokerStars Home Game Hand #222899168299: {DaPokaStars}  Hold'em No Limit (50/100) - 2021/01/21 18:40:18 ET
Table 'testnsdfgh' 9-max (Play Money) Seat #9 is the button
Seat 2: HighCardJasper (19892 in chips) 
Seat 3: FantasticDouble (7038 in chips) 
Seat 6: color_singleton (22081 in chips) 
Seat 9: dhduncan (17027 in chips) 
HighCardJasper: posts small blind 50
FantasticDouble: posts big blind 100
*** HOLE CARDS ***
Dealt to FantasticDouble [Ah 6c]
color_singleton: raises 200 to 300
dhduncan: folds 
HighCardJasper: folds 
FantasticDouble: calls 200
*** FLOP *** [Jd 9s 2s]
FantasticDouble: checks 
color_singleton: bets 614
FantasticDouble: folds 
Uncalled bet (614) returned to color_singleton
color_singleton collected 614 from pot
color_singleton: doesn't show hand 
*** SUMMARY ***
Total pot 650 | Rake 36 
Board [Jd 9s 2s]
Seat 2: HighCardJasper (small blind) folded before Flop
Seat 3: FantasticDouble (big blind) folded on the Flop
Seat 6: color_singleton collected (614)
Seat 9: dhduncan (button) folded before Flop (didn't bet)



PokerStars Home Game Hand #222899178508: {DaPokaStars}  Hold'em No Limit (50/100) - 2021/01/21 18:40:38 ET
Table 'testnsdfgh' 9-max (Play Money) Seat #2 is the button
Seat 2: HighCardJasper (19842 in chips) 
Seat 3: FantasticDouble (6738 in chips) 
Seat 6: color_singleton (22395 in chips) 
Seat 9: dhduncan (17027 in chips) 
FantasticDouble: posts small blind 50
color_singleton: posts big blind 100
*** HOLE CARDS ***
Dealt to FantasticDouble [Ac 6c]
dhduncan: folds 
HighCardJasper: calls 100
FantasticDouble: raises 300 to 400
color_singleton: calls 300
HighCardJasper: folds 
*** FLOP *** [2d 8c 7c]
FantasticDouble: bets 500
color_singleton: calls 500
*** TURN *** [2d 8c 7c] [2s]
FantasticDouble: bets 1200
color_singleton: calls 1200
*** RIVER *** [2d 8c 7c 2s] [Tc]
FantasticDouble: bets 4638 and is all-in
color_singleton: calls 4638
*** SHOW DOWN ***
FantasticDouble: shows [Ac 6c] (a flush, Ace high)
color_singleton: shows [9c Ts] (two pair, Tens and Deuces)
FantasticDouble collected 12829 from pot
*** SUMMARY ***
Total pot 13576 | Rake 747 
Board [2d 8c 7c 2s Tc]
Seat 2: HighCardJasper (button) folded before Flop
Seat 3: FantasticDouble (small blind) showed [Ac 6c] and won (12829) with a flush, Ace high
Seat 6: color_singleton (big blind) showed [9c Ts] and lost with two pair, Tens and Deuces
Seat 9: dhduncan folded before Flop (didn't bet)



PokerStars Home Game Hand #222899197900: {DaPokaStars}  Hold'em No Limit (50/100) - 2021/01/21 18:41:16 ET
Table 'testnsdfgh' 9-max (Play Money) Seat #3 is the button
Seat 2: HighCardJasper (19742 in chips) 
Seat 3: FantasticDouble (12829 in chips) 
Seat 6: color_singleton (15657 in chips) 
Seat 9: dhduncan (17027 in chips) 
color_singleton: posts small blind 50
dhduncan: posts big blind 100
*** HOLE CARDS ***
Dealt to FantasticDouble [8s 7s]
HighCardJasper: calls 100
FantasticDouble: raises 300 to 400
color_singleton: folds 
dhduncan: calls 300
HighCardJasper: folds 
*** FLOP *** [Th Js Ah]
dhduncan: checks 
FantasticDouble: checks 
*** TURN *** [Th Js Ah] [4d]
dhduncan: bets 100
FantasticDouble: folds 
Uncalled bet (100) returned to dhduncan
dhduncan collected 898 from pot
dhduncan: doesn't show hand 
*** SUMMARY ***
Total pot 950 | Rake 52 
Board [Th Js Ah 4d]
Seat 2: HighCardJasper folded before Flop
Seat 3: FantasticDouble (button) folded on the Turn
Seat 6: color_singleton (small blind) folded before Flop
Seat 9: dhduncan (big blind) collected (898)



PokerStars Home Game Hand #222899211407: {DaPokaStars}  Hold'em No Limit (50/100) - 2021/01/21 18:41:43 ET
Table 'testnsdfgh' 9-max (Play Money) Seat #6 is the button
Seat 2: HighCardJasper (19642 in chips) 
Seat 3: FantasticDouble (12429 in chips) 
Seat 6: color_singleton (15607 in chips) 
Seat 9: dhduncan (17525 in chips) 
dhduncan: posts small blind 50
HighCardJasper: posts big blind 100
*** HOLE CARDS ***
Dealt to FantasticDouble [6h 8s]
FantasticDouble: folds 
color_singleton: raises 200 to 300
dhduncan: calls 250
HighCardJasper: calls 200
*** FLOP *** [7s Qh Jc]
dhduncan: bets 100
HighCardJasper: raises 525 to 625
color_singleton: folds 
dhduncan: calls 525
*** TURN *** [7s Qh Jc] [6s]
dhduncan: checks 
HighCardJasper: checks 
*** RIVER *** [7s Qh Jc 6s] [2s]
dhduncan: checks 
HighCardJasper: checks 
*** SHOW DOWN ***
dhduncan: shows [Qs 5h] (a pair of Queens)
HighCardJasper: shows [Qd Tc] (a pair of Queens - Jack+Ten kicker)
HighCardJasper collected 2032 from pot
*** SUMMARY ***
Total pot 2150 | Rake 118 
Board [7s Qh Jc 6s 2s]
Seat 2: HighCardJasper (big blind) showed [Qd Tc] and won (2032) with a pair of Queens
Seat 3: FantasticDouble folded before Flop (didn't bet)
Seat 6: color_singleton (button) folded on the Flop
Seat 9: dhduncan (small blind) showed [Qs 5h] and lost with a pair of Queens



