PokerStars Home Game Hand #220081708067: {Club #3225207}  Hold'em No Limit (50/100) - 2020/11/05 14:45:31 ET
Table 'funzzzzzzzz' 9-max (Play Money) Seat #3 is the button
Seat 1: dddocky (10178 in chips) 
Seat 2: Duke Croix (10000 in chips) 
Seat 3: MnnM150 (9800 in chips) 
dddocky: posts small blind 50
Duke Croix: posts big blind 100
*** HOLE CARDS ***
Dealt to Duke Croix [Qh Kh]
MnnM150: calls 100
dddocky: folds 
Duke Croix: raises 300 to 400
MnnM150: folds 
Uncalled bet (300) returned to Duke Croix
Duke Croix collected 250 from pot
*** SUMMARY ***
Total pot 250 | Rake 0 
Seat 1: dddocky (small blind) folded before Flop
Seat 2: Duke Croix (big blind) collected (250)
Seat 3: MnnM150 (button) folded before Flop



PokerStars Home Game Hand #220081714824: {Club #3225207}  Hold'em No Limit (50/100) - 2020/11/05 14:45:42 ET
Table 'funzzzzzzzz' 9-max (Play Money) Seat #1 is the button
Seat 1: dddocky (10128 in chips) 
Seat 2: Duke Croix (10150 in chips) 
Seat 3: MnnM150 (9700 in chips) 
Seat 4: HighCardJasper (10000 in chips) 
Seat 8: Klemtonius (10000 in chips) 
Seat 9: JeBoyDirk (10000 in chips) 
Duke Croix: posts small blind 50
MnnM150: posts big blind 100
HighCardJasper: posts big blind 100
Klemtonius: posts big blind 100
JeBoyDirk: posts big blind 100
*** HOLE CARDS ***
Dealt to Duke Croix [Jd Kd]
HighCardJasper: checks 
Klemtonius: checks 
JeBoyDirk: checks 
dddocky: calls 100
Duke Croix: calls 50
MnnM150: checks 
*** FLOP *** [2h 9s Qc]
Duke Croix: checks 
MnnM150: checks 
HighCardJasper: checks 
Klemtonius: checks 
JeBoyDirk: checks 
dddocky: checks 
*** TURN *** [2h 9s Qc] [6s]
Duke Croix: checks 
MnnM150: checks 
HighCardJasper: checks 
Klemtonius: checks 
JeBoyDirk: checks 
dddocky: checks 
*** RIVER *** [2h 9s Qc 6s] [Ad]
Duke Croix: checks 
MnnM150: checks 
HighCardJasper: checks 
Klemtonius: checks 
JeBoyDirk: checks 
dddocky: bets 283
Duke Croix: folds 
MnnM150: folds 
HighCardJasper: folds 
Klemtonius: folds 
JeBoyDirk: folds 
Uncalled bet (283) returned to dddocky
dddocky collected 567 from pot
dddocky: doesn't show hand 
*** SUMMARY ***
Total pot 600 | Rake 33 
Board [2h 9s Qc 6s Ad]
Seat 1: dddocky (button) collected (567)
Seat 2: Duke Croix (small blind) folded on the River
Seat 3: MnnM150 (big blind) folded on the River
Seat 4: HighCardJasper folded on the River (didn't bet)
Seat 8: Klemtonius folded on the River (didn't bet)
Seat 9: JeBoyDirk folded on the River (didn't bet)



PokerStars Home Game Hand #220081752133: {Club #3225207}  Hold'em No Limit (50/100) - 2020/11/05 14:46:44 ET
Table 'funzzzzzzzz' 9-max (Play Money) Seat #2 is the button
Seat 1: dddocky (10595 in chips) 
Seat 2: Duke Croix (10050 in chips) 
Seat 3: MnnM150 (9600 in chips) 
Seat 4: HighCardJasper (9900 in chips) 
Seat 8: Klemtonius (9900 in chips) 
Seat 9: JeBoyDirk (9900 in chips) 
MnnM150: posts small blind 50
HighCardJasper: posts big blind 100
*** HOLE CARDS ***
Dealt to Duke Croix [8d 5c]
Klemtonius: raises 240 to 340
JeBoyDirk: calls 340
dddocky: folds 
Duke Croix: folds 
MnnM150: calls 290
HighCardJasper: calls 240
*** FLOP *** [Js 7h Ts]
MnnM150: checks 
HighCardJasper: bets 300
Klemtonius: calls 300
JeBoyDirk: calls 300
MnnM150: folds 
*** TURN *** [Js 7h Ts] [6s]
HighCardJasper: bets 400
Klemtonius: raises 400 to 800
JeBoyDirk: folds 
HighCardJasper: calls 400
*** RIVER *** [Js 7h Ts 6s] [8c]
HighCardJasper: checks 
Klemtonius: bets 1600
HighCardJasper: calls 1600
*** SHOW DOWN ***
Klemtonius: shows [Jh Jd] (three of a kind, Jacks)
HighCardJasper: mucks hand 
Klemtonius collected 6672 from pot
*** SUMMARY ***
Total pot 7060 | Rake 388 
Board [Js 7h Ts 6s 8c]
Seat 1: dddocky folded before Flop (didn't bet)
Seat 2: Duke Croix (button) folded before Flop (didn't bet)
Seat 3: MnnM150 (small blind) folded on the Flop
Seat 4: HighCardJasper (big blind) mucked [Kd Ks]
Seat 8: Klemtonius showed [Jh Jd] and won (6672) with three of a kind, Jacks
Seat 9: JeBoyDirk folded on the Turn



PokerStars Home Game Hand #220081803039: {Club #3225207}  Hold'em No Limit (50/100) - 2020/11/05 14:48:08 ET
Table 'funzzzzzzzz' 9-max (Play Money) Seat #3 is the button
Seat 1: dddocky (10595 in chips) 
Seat 2: Duke Croix (10050 in chips) 
Seat 3: MnnM150 (9260 in chips) 
Seat 4: HighCardJasper (6860 in chips) 
Seat 8: Klemtonius (13532 in chips) 
Seat 9: JeBoyDirk (9260 in chips) 
HighCardJasper: posts small blind 50
Klemtonius: posts big blind 100
*** HOLE CARDS ***
Dealt to Duke Croix [5c 5h]
JeBoyDirk: folds 
dddocky: calls 100
Duke Croix: raises 200 to 300
MnnM150: calls 300
HighCardJasper: calls 250
Klemtonius: raises 200 to 500
dddocky: calls 400
Duke Croix: calls 200
MnnM150: calls 200
HighCardJasper: calls 200
*** FLOP *** [6h Qc 6c]
HighCardJasper: bets 6360 and is all-in
Klemtonius: folds 
dddocky: folds 
Duke Croix: folds 
MnnM150: folds 
Uncalled bet (6360) returned to HighCardJasper
HighCardJasper collected 2362 from pot
HighCardJasper: doesn't show hand 
*** SUMMARY ***
Total pot 2500 | Rake 138 
Board [6h Qc 6c]
Seat 1: dddocky folded on the Flop
Seat 2: Duke Croix folded on the Flop
Seat 3: MnnM150 (button) folded on the Flop
Seat 4: HighCardJasper (small blind) collected (2362)
Seat 8: Klemtonius (big blind) folded on the Flop
Seat 9: JeBoyDirk folded before Flop (didn't bet)



PokerStars Home Game Hand #220081844376: {Club #3225207}  Hold'em No Limit (50/100) - 2020/11/05 14:49:17 ET
Table 'funzzzzzzzz' 9-max (Play Money) Seat #4 is the button
Seat 1: dddocky (10095 in chips) 
Seat 2: Duke Croix (9550 in chips) 
Seat 3: MnnM150 (8760 in chips) 
Seat 4: HighCardJasper (8722 in chips) 
Seat 8: Klemtonius (13032 in chips) 
Seat 9: JeBoyDirk (9260 in chips) 
Klemtonius: posts small blind 50
JeBoyDirk: posts big blind 100
*** HOLE CARDS ***
Dealt to Duke Croix [Td 2h]
dddocky: folds 
Duke Croix: folds 
MnnM150: calls 100
HighCardJasper: calls 100
Klemtonius: calls 50
JeBoyDirk: checks 
*** FLOP *** [2c Ks 9h]
Klemtonius: checks 
JeBoyDirk: checks 
MnnM150: bets 100
HighCardJasper: calls 100
Klemtonius: folds 
JeBoyDirk: folds 
*** TURN *** [2c Ks 9h] [8s]
MnnM150: bets 283
HighCardJasper: calls 283
*** RIVER *** [2c Ks 9h 8s] [6h]
MnnM150: bets 551
HighCardJasper: folds 
Uncalled bet (551) returned to MnnM150
MnnM150 collected 1102 from pot
*** SUMMARY ***
Total pot 1166 | Rake 64 
Board [2c Ks 9h 8s 6h]
Seat 1: dddocky folded before Flop (didn't bet)
Seat 2: Duke Croix folded before Flop (didn't bet)
Seat 3: MnnM150 collected (1102)
Seat 4: HighCardJasper (button) folded on the River
Seat 8: Klemtonius (small blind) folded on the Flop
Seat 9: JeBoyDirk (big blind) folded on the Flop



PokerStars Home Game Hand #220081881009: {Club #3225207}  Hold'em No Limit (50/100) - 2020/11/05 14:50:18 ET
Table 'funzzzzzzzz' 9-max (Play Money) Seat #8 is the button
Seat 1: dddocky (10095 in chips) 
Seat 2: Duke Croix (9550 in chips) 
Seat 3: MnnM150 (9379 in chips) 
Seat 4: HighCardJasper (8239 in chips) 
Seat 8: Klemtonius (12932 in chips) 
Seat 9: JeBoyDirk (9160 in chips) 
JeBoyDirk: posts small blind 50
dddocky: posts big blind 100
*** HOLE CARDS ***
Dealt to Duke Croix [6s Qd]
Duke Croix: folds 
MnnM150: calls 100
HighCardJasper: calls 100
Klemtonius: raises 190 to 290
JeBoyDirk: folds 
dddocky: calls 190
MnnM150: calls 190
HighCardJasper: calls 190
*** FLOP *** [5d Qc 2c]
dddocky: checks 
MnnM150: checks 
HighCardJasper: checks 
Klemtonius: bets 571
dddocky: calls 571
MnnM150: folds 
HighCardJasper: folds 
*** TURN *** [5d Qc 2c] [7s]
dddocky: checks 
Klemtonius: bets 2223
dddocky: folds 
Uncalled bet (2223) returned to Klemtonius
Klemtonius collected 2223 from pot
Klemtonius: doesn't show hand 
*** SUMMARY ***
Total pot 2352 | Rake 129 
Board [5d Qc 2c 7s]
Seat 1: dddocky (big blind) folded on the Turn
Seat 2: Duke Croix folded before Flop (didn't bet)
Seat 3: MnnM150 folded on the Flop
Seat 4: HighCardJasper folded on the Flop
Seat 8: Klemtonius (button) collected (2223)
Seat 9: JeBoyDirk (small blind) folded before Flop



PokerStars Home Game Hand #220081911941: {Club #3225207}  Hold'em No Limit (50/100) - 2020/11/05 14:51:09 ET
Table 'funzzzzzzzz' 9-max (Play Money) Seat #9 is the button
Seat 1: dddocky (9234 in chips) 
Seat 2: Duke Croix (9550 in chips) 
Seat 3: MnnM150 (9089 in chips) 
Seat 4: HighCardJasper (7949 in chips) 
Seat 8: Klemtonius (14294 in chips) 
Seat 9: JeBoyDirk (9110 in chips) 
dddocky: posts small blind 50
Duke Croix: posts big blind 100
*** HOLE CARDS ***
Dealt to Duke Croix [8c 2c]
MnnM150: calls 100
HighCardJasper: raises 100 to 200
Klemtonius: folds 
JeBoyDirk: calls 200
dddocky: calls 150
Duke Croix: calls 100
MnnM150: folds 
*** FLOP *** [Jc Tc 9s]
dddocky has timed out
dddocky: checks 
Duke Croix: bets 500
HighCardJasper: calls 500
JeBoyDirk: raises 500 to 1000
dddocky: folds 
Duke Croix: calls 500
HighCardJasper: calls 500
*** TURN *** [Jc Tc 9s] [2s]
Duke Croix: checks 
HighCardJasper: checks 
JeBoyDirk: bets 1500
Duke Croix: calls 1500
HighCardJasper: folds 
*** RIVER *** [Jc Tc 9s 2s] [Qd]
Duke Croix: checks 
JeBoyDirk: checks 
*** SHOW DOWN ***
Duke Croix: shows [8c 2c] (a straight, Eight to Queen)
JeBoyDirk: shows [Qh 8h] (a straight, Eight to Queen)
Duke Croix collected 3260 from pot
JeBoyDirk collected 3260 from pot
*** SUMMARY ***
Total pot 6900 | Rake 380 
Board [Jc Tc 9s 2s Qd]
Seat 1: dddocky (small blind) folded on the Flop
Seat 2: Duke Croix (big blind) showed [8c 2c] and won (3260) with a straight, Eight to Queen
Seat 3: MnnM150 folded before Flop
Seat 4: HighCardJasper folded on the Turn
Seat 8: Klemtonius folded before Flop (didn't bet)
Seat 9: JeBoyDirk (button) showed [Qh 8h] and won (3260) with a straight, Eight to Queen



PokerStars Home Game Hand #220081973408: {Club #3225207}  Hold'em No Limit (50/100) - 2020/11/05 14:52:50 ET
Table 'funzzzzzzzz' 9-max (Play Money) Seat #1 is the button
Seat 1: dddocky (9034 in chips) 
Seat 2: Duke Croix (10110 in chips) 
Seat 3: MnnM150 (8989 in chips) 
Seat 4: HighCardJasper (6749 in chips) 
Seat 8: Klemtonius (14294 in chips) 
Seat 9: JeBoyDirk (9670 in chips) 
Duke Croix: posts small blind 50
MnnM150: posts big blind 100
*** HOLE CARDS ***
Dealt to Duke Croix [4c Qc]
HighCardJasper: raises 100 to 200
Klemtonius: calls 200
JeBoyDirk: calls 200
dddocky: calls 200
Duke Croix: folds 
MnnM150: folds 
*** FLOP *** [2h 7c 9h]
HighCardJasper: checks 
Klemtonius: bets 449
JeBoyDirk: folds 
dddocky: folds 
HighCardJasper: folds 
Uncalled bet (449) returned to Klemtonius
Klemtonius collected 898 from pot
Klemtonius: doesn't show hand 
*** SUMMARY ***
Total pot 950 | Rake 52 
Board [2h 7c 9h]
Seat 1: dddocky (button) folded on the Flop
Seat 2: Duke Croix (small blind) folded before Flop
Seat 3: MnnM150 (big blind) folded before Flop
Seat 4: HighCardJasper folded on the Flop
Seat 8: Klemtonius collected (898)
Seat 9: JeBoyDirk folded on the Flop



PokerStars Home Game Hand #220081999135: {Club #3225207}  Hold'em No Limit (50/100) - 2020/11/05 14:53:32 ET
Table 'funzzzzzzzz' 9-max (Play Money) Seat #2 is the button
Seat 1: dddocky (8834 in chips) 
Seat 2: Duke Croix (10060 in chips) 
Seat 3: MnnM150 (8889 in chips) 
Seat 4: HighCardJasper (6549 in chips) 
Seat 8: Klemtonius (14992 in chips) 
Seat 9: JeBoyDirk (9470 in chips) 
MnnM150: posts small blind 50
HighCardJasper: posts big blind 100
*** HOLE CARDS ***
Dealt to Duke Croix [8c 6h]
Klemtonius: calls 100
JeBoyDirk: calls 100
dddocky: calls 100
Duke Croix: folds 
MnnM150: folds 
HighCardJasper: checks 
*** FLOP *** [Jh 3d 5h]
HighCardJasper: checks 
Klemtonius: checks 
JeBoyDirk: checks 
dddocky: checks 
*** TURN *** [Jh 3d 5h] [7d]
HighCardJasper: checks 
Klemtonius: checks 
JeBoyDirk: checks 
dddocky: checks 
*** RIVER *** [Jh 3d 5h 7d] [Ad]
HighCardJasper: bets 100
Klemtonius: folds 
JeBoyDirk: raises 100 to 200
dddocky: folds 
HighCardJasper: calls 100
*** SHOW DOWN ***
JeBoyDirk: shows [Kh Qd] (high card Ace)
HighCardJasper: shows [Qh Ac] (a pair of Aces)
HighCardJasper collected 803 from pot
*** SUMMARY ***
Total pot 850 | Rake 47 
Board [Jh 3d 5h 7d Ad]
Seat 1: dddocky folded on the River
Seat 2: Duke Croix (button) folded before Flop (didn't bet)
Seat 3: MnnM150 (small blind) folded before Flop
Seat 4: HighCardJasper (big blind) showed [Qh Ac] and won (803) with a pair of Aces
Seat 8: Klemtonius folded on the River
Seat 9: JeBoyDirk showed [Kh Qd] and lost with high card Ace



PokerStars Home Game Hand #220082020277: {Club #3225207}  Hold'em No Limit (50/100) - 2020/11/05 14:54:08 ET
Table 'funzzzzzzzz' 9-max (Play Money) Seat #3 is the button
Seat 1: dddocky (8734 in chips) 
Seat 2: Duke Croix (10060 in chips) 
Seat 3: MnnM150 (8839 in chips) 
Seat 4: HighCardJasper (7052 in chips) 
Seat 8: Klemtonius (14892 in chips) 
Seat 9: JeBoyDirk (9170 in chips) 
HighCardJasper: posts small blind 50
Klemtonius: posts big blind 100
*** HOLE CARDS ***
Dealt to Duke Croix [6s 3s]
JeBoyDirk: folds 
dddocky: calls 100
Duke Croix: folds 
MnnM150: folds 
HighCardJasper: calls 50
Klemtonius: checks 
*** FLOP *** [6h 7s Jd]
HighCardJasper: bets 100
Klemtonius: calls 100
dddocky: calls 100
*** TURN *** [6h 7s Jd] [2c]
HighCardJasper: checks 
Klemtonius: checks 
dddocky: bets 100
HighCardJasper: calls 100
Klemtonius: calls 100
*** RIVER *** [6h 7s Jd 2c] [9h]
HighCardJasper: bets 200
Klemtonius: folds 
dddocky: calls 200
*** SHOW DOWN ***
HighCardJasper: shows [Js Ah] (a pair of Jacks)
dddocky: mucks hand 
HighCardJasper collected 1228 from pot
*** SUMMARY ***
Total pot 1300 | Rake 72 
Board [6h 7s Jd 2c 9h]
Seat 1: dddocky mucked [Ac 6c]
Seat 2: Duke Croix folded before Flop (didn't bet)
Seat 3: MnnM150 (button) folded before Flop (didn't bet)
Seat 4: HighCardJasper (small blind) showed [Js Ah] and won (1228) with a pair of Jacks
Seat 8: Klemtonius (big blind) folded on the River
Seat 9: JeBoyDirk folded before Flop (didn't bet)



PokerStars Home Game Hand #220082061014: {Club #3225207}  Hold'em No Limit (50/100) - 2020/11/05 14:55:18 ET
Table 'funzzzzzzzz' 9-max (Play Money) Seat #4 is the button
Seat 1: dddocky (8234 in chips) 
Seat 2: Duke Croix (10060 in chips) 
Seat 3: MnnM150 (8839 in chips) 
Seat 4: HighCardJasper (7780 in chips) 
Seat 8: Klemtonius (14592 in chips) 
Seat 9: JeBoyDirk (9170 in chips) 
Klemtonius: posts small blind 50
JeBoyDirk: posts big blind 100
*** HOLE CARDS ***
Dealt to Duke Croix [8s 2d]
dddocky: calls 100
Duke Croix: folds 
MnnM150: folds 
HighCardJasper: calls 100
Klemtonius: calls 50
JeBoyDirk: raises 300 to 400
dddocky: calls 300
HighCardJasper: folds 
Klemtonius: calls 300
*** FLOP *** [7d 3d 6h]
Klemtonius: bets 1228
JeBoyDirk: raises 1228 to 2456
dddocky: folds 
Klemtonius: calls 1228
*** TURN *** [7d 3d 6h] [7c]
Klemtonius: checks 
JeBoyDirk: bets 6314 and is all-in
Klemtonius: calls 6314
*** RIVER *** [7d 3d 6h 7c] [4s]
*** SHOW DOWN ***
Klemtonius: shows [Qd 6c] (two pair, Sevens and Sixes)
JeBoyDirk: shows [Kd Ks] (two pair, Kings and Sevens)
JeBoyDirk collected 17804 from pot
*** SUMMARY ***
Total pot 18840 | Rake 1036 
Board [7d 3d 6h 7c 4s]
Seat 1: dddocky folded on the Flop
Seat 2: Duke Croix folded before Flop (didn't bet)
Seat 3: MnnM150 folded before Flop (didn't bet)
Seat 4: HighCardJasper (button) folded before Flop
Seat 8: Klemtonius (small blind) showed [Qd 6c] and lost with two pair, Sevens and Sixes
Seat 9: JeBoyDirk (big blind) showed [Kd Ks] and won (17804) with two pair, Kings and Sevens



PokerStars Home Game Hand #220082091614: {Club #3225207}  Hold'em No Limit (50/100) - 2020/11/05 14:56:26 ET
Table 'funzzzzzzzz' 9-max (Play Money) Seat #8 is the button
Seat 1: dddocky (7834 in chips) 
Seat 2: Duke Croix (10060 in chips) 
Seat 3: MnnM150 (8839 in chips) 
Seat 4: HighCardJasper (7680 in chips) 
Seat 8: Klemtonius (5422 in chips) 
Seat 9: JeBoyDirk (17804 in chips) 
JeBoyDirk: posts small blind 50
dddocky: posts big blind 100
*** HOLE CARDS ***
Dealt to Duke Croix [2h Qc]
Duke Croix: folds 
MnnM150: folds 
HighCardJasper: calls 100
Klemtonius: raises 100 to 200
JeBoyDirk: folds 
dddocky: calls 100
HighCardJasper: folds 
*** FLOP *** [Ks Ts 5d]
dddocky: checks 
Klemtonius: checks 
*** TURN *** [Ks Ts 5d] [9c]
dddocky: checks 
Klemtonius: checks 
*** RIVER *** [Ks Ts 5d 9c] [6s]
dddocky: checks 
Klemtonius: checks 
*** SHOW DOWN ***
dddocky: shows [7h Ac] (high card Ace)
Klemtonius: shows [Ad Jd] (high card Ace - King+Jack kicker)
Klemtonius collected 520 from pot
*** SUMMARY ***
Total pot 550 | Rake 30 
Board [Ks Ts 5d 9c 6s]
Seat 1: dddocky (big blind) showed [7h Ac] and lost with high card Ace
Seat 2: Duke Croix folded before Flop (didn't bet)
Seat 3: MnnM150 folded before Flop (didn't bet)
Seat 4: HighCardJasper folded before Flop
Seat 8: Klemtonius (button) showed [Ad Jd] and won (520) with high card Ace
Seat 9: JeBoyDirk (small blind) folded before Flop



PokerStars Home Game Hand #220082107119: {Club #3225207}  Hold'em No Limit (50/100) - 2020/11/05 14:56:56 ET
Table 'funzzzzzzzz' 9-max (Play Money) Seat #9 is the button
Seat 1: dddocky (7634 in chips) 
Seat 2: Duke Croix (10060 in chips) 
Seat 3: MnnM150 (8839 in chips) 
Seat 4: HighCardJasper (7580 in chips) 
Seat 8: Klemtonius (5742 in chips) 
Seat 9: JeBoyDirk (17754 in chips) 
dddocky: posts small blind 50
Duke Croix: posts big blind 100
*** HOLE CARDS ***
Dealt to Duke Croix [5d 3d]
MnnM150: calls 100
HighCardJasper: calls 100
Klemtonius: raises 100 to 200
JeBoyDirk: folds 
dddocky: calls 150
Duke Croix: calls 100
MnnM150: calls 100
HighCardJasper: calls 100
*** FLOP *** [6d 7s Jc]
dddocky: checks 
Duke Croix has timed out
Duke Croix: checks 
MnnM150: checks 
HighCardJasper: checks 
Klemtonius: checks 
*** TURN *** [6d 7s Jc] [8c]
dddocky: checks 
Duke Croix: bets 500
MnnM150: folds 
HighCardJasper: folds 
Klemtonius: folds 
dddocky: folds 
Uncalled bet (500) returned to Duke Croix
Duke Croix collected 945 from pot
*** SUMMARY ***
Total pot 1000 | Rake 55 
Board [6d 7s Jc 8c]
Seat 1: dddocky (small blind) folded on the Turn
Seat 2: Duke Croix (big blind) collected (945)
Seat 3: MnnM150 folded on the Turn
Seat 4: HighCardJasper folded on the Turn
Seat 8: Klemtonius folded on the Turn
Seat 9: JeBoyDirk (button) folded before Flop (didn't bet)



PokerStars Home Game Hand #220082141283: {Club #3225207}  Hold'em No Limit (50/100) - 2020/11/05 14:58:11 ET
Table 'funzzzzzzzz' 9-max (Play Money) Seat #1 is the button
Seat 1: dddocky (7434 in chips) 
Seat 2: Duke Croix (10805 in chips) 
Seat 3: MnnM150 (8639 in chips) 
Seat 4: HighCardJasper (7380 in chips) 
Seat 8: Klemtonius (5542 in chips) 
Seat 9: JeBoyDirk (17754 in chips) 
Duke Croix: posts small blind 50
MnnM150: posts big blind 100
*** HOLE CARDS ***
Dealt to Duke Croix [Qs 8d]
HighCardJasper: folds 
Klemtonius: raises 677 to 777
JeBoyDirk: folds 
dddocky: folds 
Duke Croix: folds 
MnnM150: folds 
Uncalled bet (677) returned to Klemtonius
Klemtonius collected 250 from pot
Klemtonius: doesn't show hand 
*** SUMMARY ***
Total pot 250 | Rake 0 
Seat 1: dddocky (button) folded before Flop (didn't bet)
Seat 2: Duke Croix (small blind) folded before Flop
Seat 3: MnnM150 (big blind) folded before Flop
Seat 4: HighCardJasper folded before Flop (didn't bet)
Seat 8: Klemtonius collected (250)
Seat 9: JeBoyDirk folded before Flop (didn't bet)



PokerStars Home Game Hand #220082151922: {Club #3225207}  Hold'em No Limit (50/100) - 2020/11/05 14:58:34 ET
Table 'funzzzzzzzz' 9-max (Play Money) Seat #2 is the button
Seat 1: dddocky (7434 in chips) 
Seat 2: Duke Croix (10755 in chips) 
Seat 3: MnnM150 (8539 in chips) 
Seat 4: HighCardJasper (7380 in chips) 
Seat 8: Klemtonius (5692 in chips) 
Seat 9: JeBoyDirk (17754 in chips) 
MnnM150: posts small blind 50
HighCardJasper: posts big blind 100
*** HOLE CARDS ***
Dealt to Duke Croix [Jh 7s]
Klemtonius: raises 100 to 200
JeBoyDirk: folds 
dddocky: folds 
Duke Croix: folds 
MnnM150: folds 
HighCardJasper: calls 100
*** FLOP *** [Qc 6s Jd]
HighCardJasper: checks 
Klemtonius: bets 425
HighCardJasper: folds 
Uncalled bet (425) returned to Klemtonius
Klemtonius collected 425 from pot
Klemtonius: doesn't show hand 
*** SUMMARY ***
Total pot 450 | Rake 25 
Board [Qc 6s Jd]
Seat 1: dddocky folded before Flop (didn't bet)
Seat 2: Duke Croix (button) folded before Flop (didn't bet)
Seat 3: MnnM150 (small blind) folded before Flop
Seat 4: HighCardJasper (big blind) folded on the Flop
Seat 8: Klemtonius collected (425)
Seat 9: JeBoyDirk folded before Flop (didn't bet)



PokerStars Home Game Hand #220082161810: {Club #3225207}  Hold'em No Limit (50/100) - 2020/11/05 14:58:55 ET
Table 'funzzzzzzzz' 9-max (Play Money) Seat #3 is the button
Seat 1: dddocky (7434 in chips) 
Seat 2: Duke Croix (10755 in chips) 
Seat 3: MnnM150 (8489 in chips) 
Seat 4: HighCardJasper (7180 in chips) 
Seat 8: Klemtonius (5917 in chips) 
Seat 9: JeBoyDirk (17754 in chips) 
HighCardJasper: posts small blind 50
Klemtonius: posts big blind 100
*** HOLE CARDS ***
Dealt to Duke Croix [Th 5c]
JeBoyDirk: folds 
dddocky: calls 100
Duke Croix: folds 
MnnM150: calls 100
HighCardJasper: calls 50
Klemtonius: checks 
*** FLOP *** [Qs 4c 6d]
HighCardJasper: checks 
Klemtonius: checks 
dddocky: bets 100
MnnM150: calls 100
HighCardJasper: calls 100
Klemtonius: calls 100
*** TURN *** [Qs 4c 6d] [Kh]
HighCardJasper: bets 400
Klemtonius: folds 
dddocky: folds 
MnnM150: raises 400 to 800
HighCardJasper: calls 400
*** RIVER *** [Qs 4c 6d Kh] [5h]
HighCardJasper: checks 
MnnM150: bets 1134
HighCardJasper: calls 1134
*** SHOW DOWN ***
MnnM150: shows [Kd 6c] (two pair, Kings and Sixes)
HighCardJasper: mucks hand 
MnnM150 collected 4411 from pot
*** SUMMARY ***
Total pot 4668 | Rake 257 
Board [Qs 4c 6d Kh 5h]
Seat 1: dddocky folded on the Turn
Seat 2: Duke Croix folded before Flop (didn't bet)
Seat 3: MnnM150 (button) showed [Kd 6c] and won (4411) with two pair, Kings and Sixes
Seat 4: HighCardJasper (small blind) mucked [Ks Tc]
Seat 8: Klemtonius (big blind) folded on the Turn
Seat 9: JeBoyDirk folded before Flop (didn't bet)



PokerStars Home Game Hand #220082190462: {Club #3225207}  Hold'em No Limit (50/100) - 2020/11/05 14:59:58 ET
Table 'funzzzzzzzz' 9-max (Play Money) Seat #4 is the button
Seat 1: dddocky (7234 in chips) 
Seat 2: Duke Croix (10755 in chips) 
Seat 3: MnnM150 (10766 in chips) 
Seat 4: HighCardJasper (5046 in chips) 
Seat 8: Klemtonius (5717 in chips) 
Seat 9: JeBoyDirk (17754 in chips) 
Klemtonius: posts small blind 50
JeBoyDirk: posts big blind 100
*** HOLE CARDS ***
Dealt to Duke Croix [4s 4d]
dddocky: folds 
Duke Croix: raises 200 to 300
MnnM150: folds 
HighCardJasper: folds 
Klemtonius: calls 250
JeBoyDirk: folds 
*** FLOP *** [Ks 8h 5d]
Klemtonius: checks 
Duke Croix: bets 400
Klemtonius: calls 400
*** TURN *** [Ks 8h 5d] [2h]
Klemtonius: checks 
Duke Croix: bets 700
Klemtonius: folds 
Uncalled bet (700) returned to Duke Croix
Duke Croix collected 1417 from pot
*** SUMMARY ***
Total pot 1500 | Rake 83 
Board [Ks 8h 5d 2h]
Seat 1: dddocky folded before Flop (didn't bet)
Seat 2: Duke Croix collected (1417)
Seat 3: MnnM150 folded before Flop (didn't bet)
Seat 4: HighCardJasper (button) folded before Flop (didn't bet)
Seat 8: Klemtonius (small blind) folded on the Turn
Seat 9: JeBoyDirk (big blind) folded before Flop



PokerStars Home Game Hand #220082215980: {Club #3225207}  Hold'em No Limit (50/100) - 2020/11/05 15:00:48 ET
Table 'funzzzzzzzz' 9-max (Play Money) Seat #8 is the button
Seat 1: dddocky (7234 in chips) 
Seat 2: Duke Croix (11472 in chips) 
Seat 3: MnnM150 (10766 in chips) 
Seat 4: HighCardJasper (5046 in chips) 
Seat 8: Klemtonius (5017 in chips) 
Seat 9: JeBoyDirk (17654 in chips) 
JeBoyDirk: posts small blind 50
dddocky: posts big blind 100
*** HOLE CARDS ***
Dealt to Duke Croix [2s 6h]
Duke Croix: folds 
MnnM150: calls 100
HighCardJasper: raises 100 to 200
Klemtonius: folds 
JeBoyDirk: folds 
dddocky: calls 100
MnnM150: calls 100
*** FLOP *** [6d Jd 7c]
dddocky: checks 
MnnM150: checks 
HighCardJasper: checks 
*** TURN *** [6d Jd 7c] [Ah]
dddocky: checks 
MnnM150: checks 
HighCardJasper: bets 100
dddocky: calls 100
MnnM150: folds 
*** RIVER *** [6d Jd 7c Ah] [5s]
dddocky: checks 
HighCardJasper: bets 300
dddocky: folds 
Uncalled bet (300) returned to HighCardJasper
HighCardJasper collected 803 from pot
HighCardJasper: doesn't show hand 
*** SUMMARY ***
Total pot 850 | Rake 47 
Board [6d Jd 7c Ah 5s]
Seat 1: dddocky (big blind) folded on the River
Seat 2: Duke Croix folded before Flop (didn't bet)
Seat 3: MnnM150 folded on the Turn
Seat 4: HighCardJasper collected (803)
Seat 8: Klemtonius (button) folded before Flop (didn't bet)
Seat 9: JeBoyDirk (small blind) folded before Flop



PokerStars Home Game Hand #220082240680: {Club #3225207}  Hold'em No Limit (50/100) - 2020/11/05 15:01:33 ET
Table 'funzzzzzzzz' 9-max (Play Money) Seat #9 is the button
Seat 1: dddocky (6934 in chips) 
Seat 2: Duke Croix (11472 in chips) 
Seat 3: MnnM150 (10566 in chips) 
Seat 4: HighCardJasper (5549 in chips) 
Seat 8: Klemtonius (5017 in chips) 
Seat 9: JeBoyDirk (17604 in chips) 
dddocky: posts small blind 50
Duke Croix: posts big blind 100
*** HOLE CARDS ***
Dealt to Duke Croix [6d Td]
MnnM150: folds 
HighCardJasper: calls 100
Klemtonius: calls 100
JeBoyDirk: raises 300 to 400
dddocky: folds 
Duke Croix: calls 300
HighCardJasper: folds 
Klemtonius: calls 300
*** FLOP *** [Ac Jh Qs]
Duke Croix: checks 
Klemtonius: checks 
JeBoyDirk: bets 700
Duke Croix: folds 
Klemtonius: raises 700 to 1400
JeBoyDirk: raises 700 to 2100
Klemtonius: raises 2517 to 4617 and is all-in
JeBoyDirk: calls 2517
*** TURN *** [Ac Jh Qs] [Ad]
*** RIVER *** [Ac Jh Qs Ad] [Jc]
*** SHOW DOWN ***
Klemtonius: shows [As 6s] (a full house, Aces full of Jacks)
JeBoyDirk: shows [Ah Kd] (a full house, Aces full of Jacks)
Klemtonius collected 5001 from pot
JeBoyDirk collected 5001 from pot
*** SUMMARY ***
Total pot 10584 | Rake 582 
Board [Ac Jh Qs Ad Jc]
Seat 1: dddocky (small blind) folded before Flop
Seat 2: Duke Croix (big blind) folded on the Flop
Seat 3: MnnM150 folded before Flop (didn't bet)
Seat 4: HighCardJasper folded before Flop
Seat 8: Klemtonius showed [As 6s] and won (5001) with a full house, Aces full of Jacks
Seat 9: JeBoyDirk (button) showed [Ah Kd] and won (5001) with a full house, Aces full of Jacks



PokerStars Home Game Hand #220082267734: {Club #3225207}  Hold'em No Limit (50/100) - 2020/11/05 15:02:20 ET
Table 'funzzzzzzzz' 9-max (Play Money) Seat #1 is the button
Seat 1: dddocky (6884 in chips) 
Seat 2: Duke Croix (11072 in chips) 
Seat 3: MnnM150 (10566 in chips) 
Seat 4: HighCardJasper (5449 in chips) 
Seat 8: Klemtonius (5001 in chips) 
Seat 9: JeBoyDirk (17588 in chips) 
Duke Croix: posts small blind 50
MnnM150: posts big blind 100
*** HOLE CARDS ***
Dealt to Duke Croix [Ks 5s]
HighCardJasper: calls 100
Klemtonius: calls 100
JeBoyDirk: calls 100
dddocky: folds 
Duke Croix: calls 50
MnnM150: checks 
*** FLOP *** [Qd Qs 9h]
Duke Croix: checks 
MnnM150: checks 
HighCardJasper: checks 
Klemtonius: checks 
JeBoyDirk: checks 
*** TURN *** [Qd Qs 9h] [As]
Duke Croix: bets 300
MnnM150: folds 
HighCardJasper: calls 300
Klemtonius: raises 300 to 600
JeBoyDirk: folds 
Duke Croix: calls 300
HighCardJasper: calls 300
*** RIVER *** [Qd Qs 9h As] [3d]
Duke Croix: checks 
HighCardJasper: checks 
Klemtonius: bets 2173
Duke Croix: folds 
HighCardJasper: folds 
Uncalled bet (2173) returned to Klemtonius
Klemtonius collected 2173 from pot
Klemtonius: doesn't show hand 
*** SUMMARY ***
Total pot 2300 | Rake 127 
Board [Qd Qs 9h As 3d]
Seat 1: dddocky (button) folded before Flop (didn't bet)
Seat 2: Duke Croix (small blind) folded on the River
Seat 3: MnnM150 (big blind) folded on the Turn
Seat 4: HighCardJasper folded on the River
Seat 8: Klemtonius collected (2173)
Seat 9: JeBoyDirk folded on the Turn



PokerStars Home Game Hand #220082306880: {Club #3225207}  Hold'em No Limit (50/100) - 2020/11/05 15:03:23 ET
Table 'funzzzzzzzz' 9-max (Play Money) Seat #2 is the button
Seat 1: dddocky (6884 in chips) 
Seat 2: Duke Croix (10372 in chips) 
Seat 3: MnnM150 (10466 in chips) 
Seat 4: HighCardJasper (4749 in chips) 
Seat 8: Klemtonius (6474 in chips) 
Seat 9: JeBoyDirk (17488 in chips) 
MnnM150: posts small blind 50
HighCardJasper: posts big blind 100
*** HOLE CARDS ***
Dealt to Duke Croix [6s Js]
Klemtonius: calls 100
JeBoyDirk: folds 
dddocky: calls 100
Duke Croix: folds 
MnnM150: calls 50
HighCardJasper: checks 
*** FLOP *** [2h Kh Ac]
MnnM150: checks 
HighCardJasper: checks 
Klemtonius: checks 
dddocky: bets 100
MnnM150: folds 
HighCardJasper: folds 
Klemtonius: folds 
Uncalled bet (100) returned to dddocky
dddocky collected 378 from pot
dddocky: doesn't show hand 
*** SUMMARY ***
Total pot 400 | Rake 22 
Board [2h Kh Ac]
Seat 1: dddocky collected (378)
Seat 2: Duke Croix (button) folded before Flop (didn't bet)
Seat 3: MnnM150 (small blind) folded on the Flop
Seat 4: HighCardJasper (big blind) folded on the Flop
Seat 8: Klemtonius folded on the Flop
Seat 9: JeBoyDirk folded before Flop (didn't bet)



PokerStars Home Game Hand #220082326586: {Club #3225207}  Hold'em No Limit (50/100) - 2020/11/05 15:03:55 ET
Table 'funzzzzzzzz' 9-max (Play Money) Seat #3 is the button
Seat 1: dddocky (7162 in chips) 
Seat 2: Duke Croix (10372 in chips) 
Seat 3: MnnM150 (10366 in chips) 
Seat 4: HighCardJasper (4649 in chips) 
Seat 8: Klemtonius (6374 in chips) 
Seat 9: JeBoyDirk (17488 in chips) 
HighCardJasper: posts small blind 50
Klemtonius: posts big blind 100
*** HOLE CARDS ***
Dealt to Duke Croix [Jd 9s]
JeBoyDirk: calls 100
dddocky: calls 100
Duke Croix: folds 
MnnM150: folds 
HighCardJasper: calls 50
Klemtonius: raises 170 to 270
JeBoyDirk: calls 170
dddocky: calls 170
HighCardJasper: calls 170
*** FLOP *** [8s Ah 3c]
HighCardJasper: checks 
Klemtonius: bets 510
JeBoyDirk: folds 
dddocky: folds 
HighCardJasper: calls 510
*** TURN *** [8s Ah 3c] [Td]
HighCardJasper: checks 
Klemtonius: bets 1984
HighCardJasper: raises 1885 to 3869 and is all-in
Klemtonius: calls 1885
*** RIVER *** [8s Ah 3c Td] [8c]
*** SHOW DOWN ***
HighCardJasper: shows [Tc Ad] (two pair, Aces and Tens)
Klemtonius: shows [Qs Qh] (two pair, Queens and Eights)
HighCardJasper collected 9297 from pot
*** SUMMARY ***
Total pot 9838 | Rake 541 
Board [8s Ah 3c Td 8c]
Seat 1: dddocky folded on the Flop
Seat 2: Duke Croix folded before Flop (didn't bet)
Seat 3: MnnM150 (button) folded before Flop (didn't bet)
Seat 4: HighCardJasper (small blind) showed [Tc Ad] and won (9297) with two pair, Aces and Tens
Seat 8: Klemtonius (big blind) showed [Qs Qh] and lost with two pair, Queens and Eights
Seat 9: JeBoyDirk folded on the Flop



PokerStars Home Game Hand #220082369468: {Club #3225207}  Hold'em No Limit (50/100) - 2020/11/05 15:04:52 ET
Table 'funzzzzzzzz' 9-max (Play Money) Seat #4 is the button
Seat 1: dddocky (6892 in chips) 
Seat 2: Duke Croix (10372 in chips) 
Seat 3: MnnM150 (10366 in chips) 
Seat 4: HighCardJasper (9297 in chips) 
Seat 8: Klemtonius (1725 in chips) 
Seat 9: JeBoyDirk (17218 in chips) 
Klemtonius: posts small blind 50
JeBoyDirk: posts big blind 100
*** HOLE CARDS ***
Dealt to Duke Croix [9h 4s]
dddocky: calls 100
Duke Croix: folds 
MnnM150: calls 100
HighCardJasper: calls 100
Klemtonius: calls 50
JeBoyDirk: checks 
*** FLOP *** [4c 4d 7h]
Klemtonius: checks 
JeBoyDirk: checks 
dddocky: checks 
MnnM150: checks 
HighCardJasper: bets 100
Klemtonius: folds 
JeBoyDirk: folds 
dddocky: calls 100
MnnM150: calls 100
*** TURN *** [4c 4d 7h] [2s]
dddocky: bets 100
MnnM150: calls 100
HighCardJasper: calls 100
*** RIVER *** [4c 4d 7h 2s] [Js]
dddocky: bets 100
MnnM150: calls 100
HighCardJasper: calls 100
*** SHOW DOWN ***
dddocky: shows [2h As] (two pair, Fours and Deuces)
MnnM150: mucks hand 
HighCardJasper: shows [7s Qs] (two pair, Sevens and Fours)
HighCardJasper collected 1323 from pot
*** SUMMARY ***
Total pot 1400 | Rake 77 
Board [4c 4d 7h 2s Js]
Seat 1: dddocky showed [2h As] and lost with two pair, Fours and Deuces
Seat 2: Duke Croix folded before Flop (didn't bet)
Seat 3: MnnM150 mucked [Ah Qh]
Seat 4: HighCardJasper (button) showed [7s Qs] and won (1323) with two pair, Sevens and Fours
Seat 8: Klemtonius (small blind) folded on the Flop
Seat 9: JeBoyDirk (big blind) folded on the Flop



PokerStars Home Game Hand #220082404798: {Club #3225207}  Hold'em No Limit (50/100) - 2020/11/05 15:05:46 ET
Table 'funzzzzzzzz' 9-max (Play Money) Seat #8 is the button
Seat 1: dddocky (6492 in chips) 
Seat 2: Duke Croix (10372 in chips) 
Seat 3: MnnM150 (9966 in chips) 
Seat 4: HighCardJasper (10220 in chips) 
Seat 8: Klemtonius (1625 in chips) 
Seat 9: JeBoyDirk (17118 in chips) 
JeBoyDirk: posts small blind 50
dddocky: posts big blind 100
*** HOLE CARDS ***
Dealt to Duke Croix [3c 2c]
Duke Croix: calls 100
MnnM150: calls 100
HighCardJasper: calls 100
Klemtonius: calls 100
JeBoyDirk: folds 
dddocky: checks 
*** FLOP *** [As Js Td]
dddocky: checks 
Duke Croix: checks 
MnnM150: checks 
HighCardJasper: checks 
Klemtonius: bets 200
dddocky: folds 
Duke Croix: folds 
MnnM150: folds 
HighCardJasper: folds 
Uncalled bet (200) returned to Klemtonius
Klemtonius collected 520 from pot
Klemtonius: doesn't show hand 
*** SUMMARY ***
Total pot 550 | Rake 30 
Board [As Js Td]
Seat 1: dddocky (big blind) folded on the Flop
Seat 2: Duke Croix folded on the Flop
Seat 3: MnnM150 folded on the Flop
Seat 4: HighCardJasper folded on the Flop
Seat 8: Klemtonius (button) collected (520)
Seat 9: JeBoyDirk (small blind) folded before Flop



PokerStars Home Game Hand #220082427185: {Club #3225207}  Hold'em No Limit (50/100) - 2020/11/05 15:06:20 ET
Table 'funzzzzzzzz' 9-max (Play Money) Seat #9 is the button
Seat 1: dddocky (6392 in chips) 
Seat 2: Duke Croix (10272 in chips) 
Seat 3: MnnM150 (9866 in chips) 
Seat 4: HighCardJasper (10120 in chips) 
Seat 8: Klemtonius (2045 in chips) 
Seat 9: JeBoyDirk (17068 in chips) 
dddocky: posts small blind 50
Duke Croix: posts big blind 100
*** HOLE CARDS ***
Dealt to Duke Croix [Qs Tc]
MnnM150: folds 
HighCardJasper: folds 
Klemtonius: calls 100
JeBoyDirk: folds 
dddocky: calls 50
Duke Croix: checks 
*** FLOP *** [4h 2c Jc]
dddocky: bets 100
Duke Croix: folds 
Klemtonius: calls 100
*** TURN *** [4h 2c Jc] [2d]
dddocky: bets 236
Klemtonius: folds 
Uncalled bet (236) returned to dddocky
dddocky collected 472 from pot
dddocky: doesn't show hand 
*** SUMMARY ***
Total pot 500 | Rake 28 
Board [4h 2c Jc 2d]
Seat 1: dddocky (small blind) collected (472)
Seat 2: Duke Croix (big blind) folded on the Flop
Seat 3: MnnM150 folded before Flop (didn't bet)
Seat 4: HighCardJasper folded before Flop (didn't bet)
Seat 8: Klemtonius folded on the Turn
Seat 9: JeBoyDirk (button) folded before Flop (didn't bet)



PokerStars Home Game Hand #220082453495: {Club #3225207}  Hold'em No Limit (50/100) - 2020/11/05 15:06:59 ET
Table 'funzzzzzzzz' 9-max (Play Money) Seat #1 is the button
Seat 1: dddocky (6664 in chips) 
Seat 2: Duke Croix (10172 in chips) 
Seat 3: MnnM150 (9866 in chips) 
Seat 4: HighCardJasper (10120 in chips) 
Seat 8: Klemtonius (1845 in chips) 
Seat 9: JeBoyDirk (17068 in chips) 
Duke Croix: posts small blind 50
MnnM150: posts big blind 100
*** HOLE CARDS ***
Dealt to Duke Croix [Ad 2h]
HighCardJasper: calls 100
Klemtonius: calls 100
JeBoyDirk: folds 
dddocky: calls 100
Duke Croix: calls 50
MnnM150: checks 
*** FLOP *** [5d 3d Ks]
Duke Croix: checks 
MnnM150: checks 
HighCardJasper: checks 
Klemtonius: checks 
dddocky: bets 100
Duke Croix: calls 100
MnnM150: folds 
HighCardJasper: calls 100
Klemtonius: calls 100
*** TURN *** [5d 3d Ks] [4s]
Duke Croix: bets 500
HighCardJasper: folds 
Klemtonius: folds 
dddocky: raises 500 to 1000
Duke Croix: raises 500 to 1500
dddocky: calls 500
*** RIVER *** [5d 3d Ks 4s] [Qs]
Duke Croix: checks 
dddocky: checks 
*** SHOW DOWN ***
Duke Croix: shows [Ad 2h] (a straight, Ace to Five)
dddocky: mucks hand 
Duke Croix collected 3685 from pot
*** SUMMARY ***
Total pot 3900 | Rake 215 
Board [5d 3d Ks 4s Qs]
Seat 1: dddocky (button) mucked [4c Kh]
Seat 2: Duke Croix (small blind) showed [Ad 2h] and won (3685) with a straight, Ace to Five
Seat 3: MnnM150 (big blind) folded on the Flop
Seat 4: HighCardJasper folded on the Turn
Seat 8: Klemtonius folded on the Turn
Seat 9: JeBoyDirk folded before Flop (didn't bet)



PokerStars Home Game Hand #220082486173: {Club #3225207}  Hold'em No Limit (50/100) - 2020/11/05 15:07:49 ET
Table 'funzzzzzzzz' 9-max (Play Money) Seat #2 is the button
Seat 1: dddocky (4964 in chips) 
Seat 2: Duke Croix (12157 in chips) 
Seat 3: MnnM150 (9766 in chips) 
Seat 4: HighCardJasper (9920 in chips) 
Seat 8: Klemtonius (1645 in chips) 
Seat 9: JeBoyDirk (17068 in chips) 
MnnM150: posts small blind 50
HighCardJasper: posts big blind 100
*** HOLE CARDS ***
Dealt to Duke Croix [5c Ts]
Klemtonius: raises 100 to 200
JeBoyDirk: folds 
dddocky: folds 
Duke Croix: folds 
MnnM150: folds 
HighCardJasper: raises 100 to 300
Klemtonius: calls 100
*** FLOP *** [2s Ac 2c]
HighCardJasper: checks 
Klemtonius: checks 
*** TURN *** [2s Ac 2c] [9d]
HighCardJasper: bets 200
Klemtonius: calls 200
*** RIVER *** [2s Ac 2c 9d] [Ks]
HighCardJasper: bets 1000
Klemtonius: folds 
Uncalled bet (1000) returned to HighCardJasper
HighCardJasper collected 992 from pot
HighCardJasper: doesn't show hand 
*** SUMMARY ***
Total pot 1050 | Rake 58 
Board [2s Ac 2c 9d Ks]
Seat 1: dddocky folded before Flop (didn't bet)
Seat 2: Duke Croix (button) folded before Flop (didn't bet)
Seat 3: MnnM150 (small blind) folded before Flop
Seat 4: HighCardJasper (big blind) collected (992)
Seat 8: Klemtonius folded on the River
Seat 9: JeBoyDirk folded before Flop (didn't bet)



PokerStars Home Game Hand #220082508941: {Club #3225207}  Hold'em No Limit (50/100) - 2020/11/05 15:08:24 ET
Table 'funzzzzzzzz' 9-max (Play Money) Seat #3 is the button
Seat 1: dddocky (4964 in chips) 
Seat 2: Duke Croix (12157 in chips) 
Seat 3: MnnM150 (9716 in chips) 
Seat 4: HighCardJasper (10412 in chips) 
Seat 8: Klemtonius (1145 in chips) 
Seat 9: JeBoyDirk (17068 in chips) 
HighCardJasper: posts small blind 50
Klemtonius: posts big blind 100
*** HOLE CARDS ***
Dealt to Duke Croix [Ts 5s]
JeBoyDirk: folds 
dddocky: calls 100
Duke Croix: folds 
MnnM150: calls 100
HighCardJasper: folds 
Klemtonius: raises 1045 to 1145 and is all-in
dddocky: folds 
MnnM150: folds 
Uncalled bet (1045) returned to Klemtonius
Klemtonius collected 350 from pot
Klemtonius: doesn't show hand 
*** SUMMARY ***
Total pot 350 | Rake 0 
Seat 1: dddocky folded before Flop
Seat 2: Duke Croix folded before Flop (didn't bet)
Seat 3: MnnM150 (button) folded before Flop
Seat 4: HighCardJasper (small blind) folded before Flop
Seat 8: Klemtonius (big blind) collected (350)
Seat 9: JeBoyDirk folded before Flop (didn't bet)



PokerStars Home Game Hand #220082519214: {Club #3225207}  Hold'em No Limit (50/100) - 2020/11/05 15:08:39 ET
Table 'funzzzzzzzz' 9-max (Play Money) Seat #4 is the button
Seat 1: dddocky (4864 in chips) 
Seat 2: Duke Croix (12157 in chips) 
Seat 3: MnnM150 (9616 in chips) 
Seat 4: HighCardJasper (10362 in chips) 
Seat 8: Klemtonius (1395 in chips) 
Seat 9: JeBoyDirk (17068 in chips) 
Klemtonius: posts small blind 50
JeBoyDirk: posts big blind 100
*** HOLE CARDS ***
Dealt to Duke Croix [8s 6s]
dddocky: calls 100
Duke Croix: folds 
MnnM150: calls 100
HighCardJasper: calls 100
Klemtonius: raises 1295 to 1395 and is all-in
JeBoyDirk: folds 
dddocky: folds 
MnnM150: folds 
HighCardJasper: calls 1295
*** FLOP *** [Kc 4s Qs]
*** TURN *** [Kc 4s Qs] [Qd]
*** RIVER *** [Kc 4s Qs Qd] [Ac]
*** SHOW DOWN ***
Klemtonius: shows [8c Ad] (two pair, Aces and Queens)
HighCardJasper: shows [As 7c] (two pair, Aces and Queens)
Klemtonius collected 1460 from pot
HighCardJasper collected 1460 from pot
*** SUMMARY ***
Total pot 3090 | Rake 170 
Board [Kc 4s Qs Qd Ac]
Seat 1: dddocky folded before Flop
Seat 2: Duke Croix folded before Flop (didn't bet)
Seat 3: MnnM150 folded before Flop
Seat 4: HighCardJasper (button) showed [As 7c] and won (1460) with two pair, Aces and Queens
Seat 8: Klemtonius (small blind) showed [8c Ad] and won (1460) with two pair, Aces and Queens
Seat 9: JeBoyDirk (big blind) folded before Flop



PokerStars Home Game Hand #220082539597: {Club #3225207}  Hold'em No Limit (50/100) - 2020/11/05 15:09:10 ET
Table 'funzzzzzzzz' 9-max (Play Money) Seat #8 is the button
Seat 1: dddocky (4764 in chips) 
Seat 2: Duke Croix (12157 in chips) 
Seat 3: MnnM150 (9516 in chips) 
Seat 4: HighCardJasper (10427 in chips) 
Seat 8: Klemtonius (1460 in chips) 
Seat 9: JeBoyDirk (16968 in chips) 
JeBoyDirk: posts small blind 50
dddocky: posts big blind 100
*** HOLE CARDS ***
Dealt to Duke Croix [7c 9h]
Duke Croix: folds 
MnnM150 has timed out
MnnM150: folds 
HighCardJasper: calls 100
Klemtonius: folds 
JeBoyDirk: raises 300 to 400
dddocky: folds 
HighCardJasper: folds 
Uncalled bet (300) returned to JeBoyDirk
JeBoyDirk collected 300 from pot
*** SUMMARY ***
Total pot 300 | Rake 0 
Seat 1: dddocky (big blind) folded before Flop
Seat 2: Duke Croix folded before Flop (didn't bet)
Seat 3: MnnM150 folded before Flop (didn't bet)
Seat 4: HighCardJasper folded before Flop
Seat 8: Klemtonius (button) folded before Flop (didn't bet)
Seat 9: JeBoyDirk (small blind) collected (300)



PokerStars Home Game Hand #220082560877: {Club #3225207}  Hold'em No Limit (50/100) - 2020/11/05 15:09:42 ET
Table 'funzzzzzzzz' 9-max (Play Money) Seat #9 is the button
Seat 1: dddocky (4664 in chips) 
Seat 2: Duke Croix (12157 in chips) 
Seat 3: MnnM150 (9516 in chips) 
Seat 4: HighCardJasper (10327 in chips) 
Seat 8: Klemtonius (1460 in chips) 
Seat 9: JeBoyDirk (17168 in chips) 
dddocky: posts small blind 50
Duke Croix: posts big blind 100
*** HOLE CARDS ***
Dealt to Duke Croix [2s 5c]
MnnM150: calls 100
HighCardJasper: raises 100 to 200
Klemtonius: raises 1260 to 1460 and is all-in
JeBoyDirk: folds 
dddocky: folds 
Duke Croix: folds 
MnnM150: folds 
HighCardJasper: folds 
Uncalled bet (1260) returned to Klemtonius
Klemtonius collected 650 from pot
Klemtonius: doesn't show hand 
*** SUMMARY ***
Total pot 650 | Rake 0 
Seat 1: dddocky (small blind) folded before Flop
Seat 2: Duke Croix (big blind) folded before Flop
Seat 3: MnnM150 folded before Flop
Seat 4: HighCardJasper folded before Flop
Seat 8: Klemtonius collected (650)
Seat 9: JeBoyDirk (button) folded before Flop (didn't bet)



PokerStars Home Game Hand #220082583188: {Club #3225207}  Hold'em No Limit (50/100) - 2020/11/05 15:10:16 ET
Table 'funzzzzzzzz' 9-max (Play Money) Seat #1 is the button
Seat 1: dddocky (4614 in chips) 
Seat 2: Duke Croix (12057 in chips) 
Seat 3: MnnM150 (9416 in chips) 
Seat 4: HighCardJasper (10127 in chips) 
Seat 8: Klemtonius (1910 in chips) 
Seat 9: JeBoyDirk (17168 in chips) 
Duke Croix: posts small blind 50
MnnM150: posts big blind 100
*** HOLE CARDS ***
Dealt to Duke Croix [7d 9h]
HighCardJasper: calls 100
Klemtonius: calls 100
JeBoyDirk: calls 100
dddocky: folds 
Duke Croix: calls 50
MnnM150: checks 
*** FLOP *** [Qs 2d Js]
Duke Croix: checks 
MnnM150: checks 
HighCardJasper: checks 
Klemtonius: checks 
JeBoyDirk: checks 
*** TURN *** [Qs 2d Js] [5d]
Duke Croix: checks 
MnnM150: checks 
HighCardJasper: checks 
Klemtonius: bets 236
JeBoyDirk: folds 
Duke Croix: folds 
MnnM150: calls 236
HighCardJasper: calls 236
*** RIVER *** [Qs 2d Js 5d] [As]
MnnM150: checks 
HighCardJasper: bets 300
Klemtonius: folds 
MnnM150: calls 300
*** SHOW DOWN ***
HighCardJasper: shows [Kh Ts] (a straight, Ten to Ace)
MnnM150: mucks hand 
HighCardJasper collected 1709 from pot
*** SUMMARY ***
Total pot 1808 | Rake 99 
Board [Qs 2d Js 5d As]
Seat 1: dddocky (button) folded before Flop (didn't bet)
Seat 2: Duke Croix (small blind) folded on the Turn
Seat 3: MnnM150 (big blind) mucked [4c Jd]
Seat 4: HighCardJasper showed [Kh Ts] and won (1709) with a straight, Ten to Ace
Seat 8: Klemtonius folded on the River
Seat 9: JeBoyDirk folded on the Turn



PokerStars Home Game Hand #220082628969: {Club #3225207}  Hold'em No Limit (50/100) - 2020/11/05 15:11:26 ET
Table 'funzzzzzzzz' 9-max (Play Money) Seat #2 is the button
Seat 1: dddocky (4614 in chips) 
Seat 2: Duke Croix (11957 in chips) 
Seat 3: MnnM150 (8780 in chips) 
Seat 4: HighCardJasper (11200 in chips) 
Seat 8: Klemtonius (1574 in chips) 
Seat 9: JeBoyDirk (17068 in chips) 
MnnM150: posts small blind 50
HighCardJasper: posts big blind 100
*** HOLE CARDS ***
Dealt to Duke Croix [Ks 5h]
appositive joins the table at seat #7 
Klemtonius: raises 200 to 300
JeBoyDirk: folds 
dddocky: folds 
Duke Croix: folds 
MnnM150: calls 250
HighCardJasper: folds 
*** FLOP *** [Ac Js Qc]
MnnM150: bets 330
Klemtonius: calls 330
*** TURN *** [Ac Js Qc] [5s]
MnnM150: bets 642
Klemtonius: raises 302 to 944 and is all-in
MnnM150: calls 302
*** RIVER *** [Ac Js Qc 5s] [2c]
*** SHOW DOWN ***
MnnM150: shows [Jh Qh] (two pair, Queens and Jacks)
Klemtonius: shows [Qd Qs] (three of a kind, Queens)
Klemtonius collected 3069 from pot
*** SUMMARY ***
Total pot 3248 | Rake 179 
Board [Ac Js Qc 5s 2c]
Seat 1: dddocky folded before Flop (didn't bet)
Seat 2: Duke Croix (button) folded before Flop (didn't bet)
Seat 3: MnnM150 (small blind) showed [Jh Qh] and lost with two pair, Queens and Jacks
Seat 4: HighCardJasper (big blind) folded before Flop
Seat 8: Klemtonius showed [Qd Qs] and won (3069) with three of a kind, Queens
Seat 9: JeBoyDirk folded before Flop (didn't bet)



PokerStars Home Game Hand #220082656326: {Club #3225207}  Hold'em No Limit (50/100) - 2020/11/05 15:12:07 ET
Table 'funzzzzzzzz' 9-max (Play Money) Seat #3 is the button
Seat 1: dddocky (4614 in chips) 
Seat 2: Duke Croix (11957 in chips) 
Seat 3: MnnM150 (7206 in chips) 
Seat 4: HighCardJasper (11100 in chips) 
Seat 7: appositive (10000 in chips) 
Seat 8: Klemtonius (3069 in chips) 
Seat 9: JeBoyDirk (17068 in chips) 
HighCardJasper: posts small blind 50
appositive: posts big blind 100
*** HOLE CARDS ***
Dealt to Duke Croix [Qh 4c]
Klemtonius: calls 100
JeBoyDirk: folds 
dddocky: calls 100
Duke Croix: folds 
MnnM150: calls 100
HighCardJasper: calls 50
appositive: checks 
*** FLOP *** [Td 7h Kc]
HighCardJasper: checks 
appositive: checks 
Klemtonius: checks 
dddocky: bets 100
MnnM150: calls 100
HighCardJasper: calls 100
appositive: folds 
Klemtonius: calls 100
*** TURN *** [Td 7h Kc] [Tc]
HighCardJasper: bets 200
Klemtonius: folds 
dddocky: calls 200
MnnM150: calls 200
*** RIVER *** [Td 7h Kc Tc] [Kd]
HighCardJasper: bets 500
dddocky: raises 500 to 1000
MnnM150: folds 
HighCardJasper: calls 500
*** SHOW DOWN ***
dddocky: shows [Ad Ks] (a full house, Kings full of Tens)
HighCardJasper: mucks hand 
dddocky collected 3307 from pot
*** SUMMARY ***
Total pot 3500 | Rake 193 
Board [Td 7h Kc Tc Kd]
Seat 1: dddocky showed [Ad Ks] and won (3307) with a full house, Kings full of Tens
Seat 2: Duke Croix folded before Flop (didn't bet)
Seat 3: MnnM150 (button) folded on the River
Seat 4: HighCardJasper (small blind) mucked [9h Th]
Seat 7: appositive (big blind) folded on the Flop
Seat 8: Klemtonius folded on the Turn
Seat 9: JeBoyDirk folded before Flop (didn't bet)



PokerStars Home Game Hand #220082707431: {Club #3225207}  Hold'em No Limit (50/100) - 2020/11/05 15:13:25 ET
Table 'funzzzzzzzz' 9-max (Play Money) Seat #4 is the button
Seat 1: dddocky (6521 in chips) 
Seat 2: Duke Croix (11957 in chips) 
Seat 3: MnnM150 (6806 in chips) 
Seat 4: HighCardJasper (9700 in chips) 
Seat 7: appositive (9900 in chips) 
Seat 8: Klemtonius (2869 in chips) 
Seat 9: JeBoyDirk (17068 in chips) 
appositive: posts small blind 50
Klemtonius: posts big blind 100
*** HOLE CARDS ***
Dealt to Duke Croix [8s 9c]
JeBoyDirk: folds 
dddocky: calls 100
Duke Croix: calls 100
MnnM150: calls 100
HighCardJasper: calls 100
appositive: folds 
Klemtonius: checks 
*** FLOP *** [3h 7d 9h]
Klemtonius: checks 
dddocky: bets 200
Duke Croix: calls 200
MnnM150: calls 200
HighCardJasper: folds 
Klemtonius: folds 
*** TURN *** [3h 7d 9h] [6h]
dddocky: bets 1087
Duke Croix: folds 
MnnM150: folds 
Uncalled bet (1087) returned to dddocky
dddocky collected 1087 from pot
dddocky: doesn't show hand 
*** SUMMARY ***
Total pot 1150 | Rake 63 
Board [3h 7d 9h 6h]
Seat 1: dddocky collected (1087)
Seat 2: Duke Croix folded on the Turn
Seat 3: MnnM150 folded on the Turn
Seat 4: HighCardJasper (button) folded on the Flop
Seat 7: appositive (small blind) folded before Flop
Seat 8: Klemtonius (big blind) folded on the Flop
Seat 9: JeBoyDirk folded before Flop (didn't bet)



PokerStars Home Game Hand #220082755597: {Club #3225207}  Hold'em No Limit (50/100) - 2020/11/05 15:14:24 ET
Table 'funzzzzzzzz' 9-max (Play Money) Seat #7 is the button
Seat 1: dddocky (7308 in chips) 
Seat 2: Duke Croix (11657 in chips) 
Seat 3: MnnM150 (6506 in chips) 
Seat 4: HighCardJasper (9600 in chips) 
Seat 7: appositive (9850 in chips) 
Seat 8: Klemtonius (2769 in chips) 
Seat 9: JeBoyDirk (17068 in chips) 
Klemtonius: posts small blind 50
JeBoyDirk: posts big blind 100
*** HOLE CARDS ***
Dealt to Duke Croix [5h 6c]
dddocky: calls 100
Duke Croix: folds 
MnnM150: raises 100 to 200
HighCardJasper: folds 
appositive: folds 
Klemtonius: calls 150
JeBoyDirk: folds 
dddocky: calls 100
*** FLOP *** [7c Tc 5d]
Klemtonius: bets 661
dddocky: folds 
MnnM150: calls 661
*** TURN *** [7c Tc 5d] [Jh]
Klemtonius: bets 1908 and is all-in
MnnM150: calls 1908
*** RIVER *** [7c Tc 5d Jh] [6s]
*** SHOW DOWN ***
Klemtonius: shows [5c 9c] (a pair of Fives)
MnnM150: shows [Qd Qs] (a pair of Queens)
MnnM150 collected 5517 from pot
*** SUMMARY ***
Total pot 5838 | Rake 321 
Board [7c Tc 5d Jh 6s]
Seat 1: dddocky folded on the Flop
Seat 2: Duke Croix folded before Flop (didn't bet)
Seat 3: MnnM150 showed [Qd Qs] and won (5517) with a pair of Queens
Seat 4: HighCardJasper folded before Flop (didn't bet)
Seat 7: appositive (button) folded before Flop (didn't bet)
Seat 8: Klemtonius (small blind) showed [5c 9c] and lost with a pair of Fives
Seat 9: JeBoyDirk (big blind) folded before Flop



PokerStars Home Game Hand #220082788771: {Club #3225207}  Hold'em No Limit (50/100) - 2020/11/05 15:15:13 ET
Table 'funzzzzzzzz' 9-max (Play Money) Seat #9 is the button
Seat 1: dddocky (7108 in chips) 
Seat 2: Duke Croix (11657 in chips) 
Seat 3: MnnM150 (9254 in chips) 
Seat 4: HighCardJasper (9600 in chips) 
Seat 7: appositive (9850 in chips) 
Seat 9: JeBoyDirk (16968 in chips) 
dddocky: posts small blind 50
Duke Croix: posts big blind 100
*** HOLE CARDS ***
Dealt to Duke Croix [8d 3s]
MnnM150: calls 100
HighCardJasper: folds 
appositive: folds 
JeBoyDirk: raises 200 to 300
dddocky: calls 250
Duke Croix: folds 
MnnM150: calls 200
*** FLOP *** [Ac Qd 7d]
dddocky: checks 
MnnM150: checks 
JeBoyDirk: bets 600
dddocky: calls 600
MnnM150: folds 
*** TURN *** [Ac Qd 7d] [Jh]
dddocky: checks 
JeBoyDirk: checks 
*** RIVER *** [Ac Qd 7d Jh] [Ad]
dddocky: bets 2079
JeBoyDirk: folds 
Uncalled bet (2079) returned to dddocky
dddocky collected 2079 from pot
dddocky: doesn't show hand 
*** SUMMARY ***
Total pot 2200 | Rake 121 
Board [Ac Qd 7d Jh Ad]
Seat 1: dddocky (small blind) collected (2079)
Seat 2: Duke Croix (big blind) folded before Flop
Seat 3: MnnM150 folded on the Flop
Seat 4: HighCardJasper folded before Flop (didn't bet)
Seat 7: appositive folded before Flop (didn't bet)
Seat 9: JeBoyDirk (button) folded on the River



PokerStars Home Game Hand #220082818758: {Club #3225207}  Hold'em No Limit (50/100) - 2020/11/05 15:15:59 ET
Table 'funzzzzzzzz' 9-max (Play Money) Seat #1 is the button
Seat 1: dddocky (8287 in chips) 
Seat 2: Duke Croix (11557 in chips) 
Seat 3: MnnM150 (8954 in chips) 
Seat 4: HighCardJasper (9600 in chips) 
Seat 7: appositive (9850 in chips) 
Seat 8: Klemtonius (10000 in chips) 
Seat 9: JeBoyDirk (16068 in chips) 
Duke Croix: posts small blind 50
MnnM150: posts big blind 100
*** HOLE CARDS ***
Dealt to Duke Croix [Ts 7d]
HighCardJasper: folds 
appositive: calls 100
Klemtonius: calls 100
JeBoyDirk: folds 
dddocky: raises 100 to 200
Duke Croix: folds 
MnnM150: calls 100
appositive: calls 100
Klemtonius: calls 100
*** FLOP *** [Qs Qh 8s]
MnnM150: checks 
appositive: checks 
Klemtonius: checks 
dddocky: checks 
*** TURN *** [Qs Qh 8s] [5s]
MnnM150: checks 
appositive: checks 
Klemtonius: checks 
dddocky: checks 
*** RIVER *** [Qs Qh 8s 5s] [8h]
MnnM150: checks 
appositive: checks 
Klemtonius: checks 
dddocky: checks 
*** SHOW DOWN ***
MnnM150: shows [Ks 5c] (two pair, Queens and Eights)
appositive: shows [Ac 2s] (two pair, Queens and Eights - Ace kicker)
Klemtonius: mucks hand 
dddocky: shows [Kd Ah] (two pair, Queens and Eights)
appositive collected 402 from pot
dddocky collected 401 from pot
*** SUMMARY ***
Total pot 850 | Rake 47 
Board [Qs Qh 8s 5s 8h]
Seat 1: dddocky (button) showed [Kd Ah] and won (401) with two pair, Queens and Eights
Seat 2: Duke Croix (small blind) folded before Flop
Seat 3: MnnM150 (big blind) showed [Ks 5c] and lost with two pair, Queens and Eights
Seat 4: HighCardJasper folded before Flop (didn't bet)
Seat 7: appositive showed [Ac 2s] and won (402) with two pair, Queens and Eights
Seat 8: Klemtonius mucked [2c 4h]
Seat 9: JeBoyDirk folded before Flop (didn't bet)



PokerStars Home Game Hand #220082850902: {Club #3225207}  Hold'em No Limit (50/100) - 2020/11/05 15:16:47 ET
Table 'funzzzzzzzz' 9-max (Play Money) Seat #2 is the button
Seat 1: dddocky (8488 in chips) 
Seat 2: Duke Croix (11507 in chips) 
Seat 3: MnnM150 (8754 in chips) 
Seat 4: HighCardJasper (9600 in chips) 
Seat 7: appositive (10052 in chips) 
Seat 8: Klemtonius (9800 in chips) 
Seat 9: JeBoyDirk (16068 in chips) 
MnnM150: posts small blind 50
HighCardJasper: posts big blind 100
*** HOLE CARDS ***
Dealt to Duke Croix [Jd Kc]
appositive: folds 
Klemtonius: calls 100
JeBoyDirk: folds 
dddocky: folds 
Duke Croix: raises 400 to 500
MnnM150: calls 450
HighCardJasper: folds 
Klemtonius: folds 
*** FLOP *** [5s As 3d]
MnnM150: bets 567
Duke Croix: folds 
Uncalled bet (567) returned to MnnM150
MnnM150 collected 1134 from pot
*** SUMMARY ***
Total pot 1200 | Rake 66 
Board [5s As 3d]
Seat 1: dddocky folded before Flop (didn't bet)
Seat 2: Duke Croix (button) folded on the Flop
Seat 3: MnnM150 (small blind) collected (1134)
Seat 4: HighCardJasper (big blind) folded before Flop
Seat 7: appositive folded before Flop (didn't bet)
Seat 8: Klemtonius folded before Flop
Seat 9: JeBoyDirk folded before Flop (didn't bet)



PokerStars Home Game Hand #220082872072: {Club #3225207}  Hold'em No Limit (50/100) - 2020/11/05 15:17:18 ET
Table 'funzzzzzzzz' 9-max (Play Money) Seat #3 is the button
Seat 1: dddocky (8488 in chips) 
Seat 2: Duke Croix (11007 in chips) 
Seat 3: MnnM150 (9388 in chips) 
Seat 4: HighCardJasper (9500 in chips) 
Seat 7: appositive (10052 in chips) 
Seat 8: Klemtonius (9700 in chips) 
Seat 9: JeBoyDirk (16068 in chips) 
HighCardJasper: posts small blind 50
appositive: posts big blind 100
*** HOLE CARDS ***
Dealt to Duke Croix [2h 9c]
Klemtonius: raises 100 to 200
JeBoyDirk: folds 
dddocky: calls 200
Duke Croix: folds 
MnnM150: folds 
HighCardJasper: calls 150
appositive: folds 
*** FLOP *** [4d Th Qc]
HighCardJasper: checks 
Klemtonius: checks 
dddocky: checks 
*** TURN *** [4d Th Qc] [Ks]
HighCardJasper: checks 
Klemtonius: bets 661
dddocky: calls 661
HighCardJasper: folds 
*** RIVER *** [4d Th Qc Ks] [2d]
Klemtonius: checks 
dddocky: bets 1911
Klemtonius: folds 
Uncalled bet (1911) returned to dddocky
dddocky collected 1911 from pot
dddocky: doesn't show hand 
*** SUMMARY ***
Total pot 2022 | Rake 111 
Board [4d Th Qc Ks 2d]
Seat 1: dddocky collected (1911)
Seat 2: Duke Croix folded before Flop (didn't bet)
Seat 3: MnnM150 (button) folded before Flop (didn't bet)
Seat 4: HighCardJasper (small blind) folded on the Turn
Seat 7: appositive (big blind) folded before Flop
Seat 8: Klemtonius folded on the River
Seat 9: JeBoyDirk folded before Flop (didn't bet)



PokerStars Home Game Hand #220082894830: {Club #3225207}  Hold'em No Limit (50/100) - 2020/11/05 15:17:53 ET
Table 'funzzzzzzzz' 9-max (Play Money) Seat #4 is the button
Seat 1: dddocky (9538 in chips) 
Seat 2: Duke Croix (11007 in chips) 
Seat 3: MnnM150 (9388 in chips) 
Seat 4: HighCardJasper (9300 in chips) 
Seat 7: appositive (9952 in chips) 
Seat 8: Klemtonius (8839 in chips) 
Seat 9: JeBoyDirk (16068 in chips) 
appositive: posts small blind 50
Klemtonius: posts big blind 100
*** HOLE CARDS ***
Dealt to Duke Croix [9h 8c]
JeBoyDirk: folds 
dddocky: calls 100
Duke Croix: folds 
MnnM150: folds 
HighCardJasper: calls 100
appositive: folds 
Klemtonius: checks 
*** FLOP *** [Ts Qd 2d]
Klemtonius: bets 331
dddocky: folds 
HighCardJasper: folds 
Uncalled bet (331) returned to Klemtonius
Klemtonius collected 331 from pot
Klemtonius: doesn't show hand 
*** SUMMARY ***
Total pot 350 | Rake 19 
Board [Ts Qd 2d]
Seat 1: dddocky folded on the Flop
Seat 2: Duke Croix folded before Flop (didn't bet)
Seat 3: MnnM150 folded before Flop (didn't bet)
Seat 4: HighCardJasper (button) folded on the Flop
Seat 7: appositive (small blind) folded before Flop
Seat 8: Klemtonius (big blind) collected (331)
Seat 9: JeBoyDirk folded before Flop (didn't bet)



PokerStars Home Game Hand #220082907492: {Club #3225207}  Hold'em No Limit (50/100) - 2020/11/05 15:18:11 ET
Table 'funzzzzzzzz' 9-max (Play Money) Seat #7 is the button
Seat 1: dddocky (9438 in chips) 
Seat 2: Duke Croix (11007 in chips) 
Seat 3: MnnM150 (9388 in chips) 
Seat 4: HighCardJasper (9200 in chips) 
Seat 7: appositive (9902 in chips) 
Seat 8: Klemtonius (9070 in chips) 
Seat 9: JeBoyDirk (16068 in chips) 
Klemtonius: posts small blind 50
JeBoyDirk: posts big blind 100
*** HOLE CARDS ***
Dealt to Duke Croix [7s 5d]
dddocky: folds 
Duke Croix: folds 
MnnM150: folds 
HighCardJasper: raises 100 to 200
appositive: folds 
Klemtonius: calls 150
JeBoyDirk: calls 100
*** FLOP *** [As Ts Jh]
Klemtonius: checks 
JeBoyDirk: bets 400
HighCardJasper: calls 400
Klemtonius: calls 400
*** TURN *** [As Ts Jh] [5s]
Klemtonius: checks 
JeBoyDirk: checks 
HighCardJasper: bets 1000
Klemtonius: folds 
JeBoyDirk: calls 1000
*** RIVER *** [As Ts Jh 5s] [8s]
JeBoyDirk: checks 
HighCardJasper: checks 
*** SHOW DOWN ***
JeBoyDirk: shows [Js Ad] (a flush, Ace high)
HighCardJasper: mucks hand 
JeBoyDirk collected 3591 from pot
*** SUMMARY ***
Total pot 3800 | Rake 209 
Board [As Ts Jh 5s 8s]
Seat 1: dddocky folded before Flop (didn't bet)
Seat 2: Duke Croix folded before Flop (didn't bet)
Seat 3: MnnM150 folded before Flop (didn't bet)
Seat 4: HighCardJasper mucked [Ah 5h]
Seat 7: appositive (button) folded before Flop (didn't bet)
Seat 8: Klemtonius (small blind) folded on the Turn
Seat 9: JeBoyDirk (big blind) showed [Js Ad] and won (3591) with a flush, Ace high



PokerStars Home Game Hand #220082942362: {Club #3225207}  Hold'em No Limit (50/100) - 2020/11/05 15:19:04 ET
Table 'funzzzzzzzz' 9-max (Play Money) Seat #8 is the button
Seat 1: dddocky (9438 in chips) 
Seat 2: Duke Croix (11007 in chips) 
Seat 3: MnnM150 (9388 in chips) 
Seat 4: HighCardJasper (7600 in chips) 
Seat 7: appositive (9902 in chips) 
Seat 8: Klemtonius (8470 in chips) 
Seat 9: JeBoyDirk (18059 in chips) 
JeBoyDirk: posts small blind 50
dddocky: posts big blind 100
*** HOLE CARDS ***
Dealt to Duke Croix [Js Qh]
Duke Croix: raises 300 to 400
MnnM150: folds 
HighCardJasper: folds 
appositive: folds 
Klemtonius: calls 400
JeBoyDirk: folds 
dddocky: folds 
*** FLOP *** [6h 3s 9c]
Duke Croix: checks 
Klemtonius: bets 898
Duke Croix: folds 
Uncalled bet (898) returned to Klemtonius
Klemtonius collected 898 from pot
Klemtonius: doesn't show hand 
*** SUMMARY ***
Total pot 950 | Rake 52 
Board [6h 3s 9c]
Seat 1: dddocky (big blind) folded before Flop
Seat 2: Duke Croix folded on the Flop
Seat 3: MnnM150 folded before Flop (didn't bet)
Seat 4: HighCardJasper folded before Flop (didn't bet)
Seat 7: appositive folded before Flop (didn't bet)
Seat 8: Klemtonius (button) collected (898)
Seat 9: JeBoyDirk (small blind) folded before Flop



PokerStars Home Game Hand #220082973186: {Club #3225207}  Hold'em No Limit (50/100) - 2020/11/05 15:19:50 ET
Table 'funzzzzzzzz' 9-max (Play Money) Seat #9 is the button
Seat 1: dddocky (9338 in chips) 
Seat 2: Duke Croix (10607 in chips) 
Seat 3: MnnM150 (9388 in chips) 
Seat 4: HighCardJasper (7600 in chips) 
Seat 7: appositive (9902 in chips) 
Seat 8: Klemtonius (8968 in chips) 
Seat 9: JeBoyDirk (18009 in chips) 
dddocky: posts small blind 50
Duke Croix: posts big blind 100
*** HOLE CARDS ***
Dealt to Duke Croix [Qd 8s]
MnnM150: calls 100
HighCardJasper: folds 
appositive: folds 
Klemtonius: folds 
JeBoyDirk: folds 
dddocky: calls 50
Duke Croix: checks 
*** FLOP *** [2h 5d 9s]
dddocky: checks 
Duke Croix: checks 
MnnM150: checks 
*** TURN *** [2h 5d 9s] [8c]
dddocky: bets 100
Duke Croix: calls 100
MnnM150: folds 
*** RIVER *** [2h 5d 9s 8c] [Qh]
dddocky: bets 472
Duke Croix: calls 472
*** SHOW DOWN ***
dddocky: shows [Qc 2s] (two pair, Queens and Deuces)
Duke Croix: shows [Qd 8s] (two pair, Queens and Eights)
Duke Croix collected 1365 from pot
*** SUMMARY ***
Total pot 1444 | Rake 79 
Board [2h 5d 9s 8c Qh]
Seat 1: dddocky (small blind) showed [Qc 2s] and lost with two pair, Queens and Deuces
Seat 2: Duke Croix (big blind) showed [Qd 8s] and won (1365) with two pair, Queens and Eights
Seat 3: MnnM150 folded on the Turn
Seat 4: HighCardJasper folded before Flop (didn't bet)
Seat 7: appositive folded before Flop (didn't bet)
Seat 8: Klemtonius folded before Flop (didn't bet)
Seat 9: JeBoyDirk (button) folded before Flop (didn't bet)



PokerStars Home Game Hand #220083005201: {Club #3225207}  Hold'em No Limit (50/100) - 2020/11/05 15:20:38 ET
Table 'funzzzzzzzz' 9-max (Play Money) Seat #1 is the button
Seat 1: dddocky (8666 in chips) 
Seat 2: Duke Croix (11300 in chips) 
Seat 3: MnnM150 (9288 in chips) 
Seat 4: HighCardJasper (7600 in chips) 
Seat 7: appositive (9902 in chips) 
Seat 9: JeBoyDirk (18009 in chips) 
Duke Croix: posts small blind 50
MnnM150: posts big blind 100
*** HOLE CARDS ***
Dealt to Duke Croix [7s Qh]
HighCardJasper: calls 100
appositive: calls 100
JeBoyDirk: folds 
dddocky: calls 100
Duke Croix: calls 50
MnnM150: checks 
*** FLOP *** [8s Ts 6c]
Duke Croix: checks 
MnnM150: checks 
HighCardJasper: checks 
appositive: checks 
dddocky: checks 
*** TURN *** [8s Ts 6c] [2s]
Duke Croix: checks 
MnnM150: checks 
HighCardJasper: checks 
appositive: checks 
dddocky: checks 
*** RIVER *** [8s Ts 6c 2s] [8d]
Duke Croix: checks 
MnnM150: bets 100
HighCardJasper: folds 
appositive: folds 
dddocky: calls 100
Duke Croix: folds 
*** SHOW DOWN ***
MnnM150: shows [7h Tc] (two pair, Tens and Eights)
dddocky: mucks hand 
MnnM150 collected 661 from pot
*** SUMMARY ***
Total pot 700 | Rake 39 
Board [8s Ts 6c 2s 8d]
Seat 1: dddocky (button) mucked [Jd Ad]
Seat 2: Duke Croix (small blind) folded on the River
Seat 3: MnnM150 (big blind) showed [7h Tc] and won (661) with two pair, Tens and Eights
Seat 4: HighCardJasper folded on the River
Seat 7: appositive folded on the River
Seat 9: JeBoyDirk folded before Flop (didn't bet)



PokerStars Home Game Hand #220083054369: {Club #3225207}  Hold'em No Limit (50/100) - 2020/11/05 15:21:52 ET
Table 'funzzzzzzzz' 9-max (Play Money) Seat #2 is the button
Seat 1: dddocky (8466 in chips) 
Seat 2: Duke Croix (11200 in chips) 
Seat 3: MnnM150 (9749 in chips) 
Seat 4: HighCardJasper (7500 in chips) 
Seat 7: appositive (9802 in chips) 
Seat 9: JeBoyDirk (18009 in chips) 
MnnM150: posts small blind 50
HighCardJasper: posts big blind 100
*** HOLE CARDS ***
Dealt to Duke Croix [8s 9s]
appositive: calls 100
JeBoyDirk: folds 
dddocky: calls 100
Duke Croix: calls 100
MnnM150: calls 50
HighCardJasper: checks 
*** FLOP *** [Ts 5h 2c]
MnnM150: checks 
HighCardJasper: checks 
appositive: bets 100
dddocky: calls 100
Duke Croix: folds 
MnnM150: folds 
HighCardJasper: calls 100
*** TURN *** [Ts 5h 2c] [7h]
HighCardJasper: checks 
appositive: bets 378
dddocky: folds 
HighCardJasper: calls 378
*** RIVER *** [Ts 5h 2c 7h] [Ad]
HighCardJasper: checks 
appositive: bets 1470
HighCardJasper: folds 
Uncalled bet (1470) returned to appositive
appositive collected 1470 from pot
appositive: doesn't show hand 
*** SUMMARY ***
Total pot 1556 | Rake 86 
Board [Ts 5h 2c 7h Ad]
Seat 1: dddocky folded on the Turn
Seat 2: Duke Croix (button) folded on the Flop
Seat 3: MnnM150 (small blind) folded on the Flop
Seat 4: HighCardJasper (big blind) folded on the River
Seat 7: appositive collected (1470)
Seat 9: JeBoyDirk folded before Flop (didn't bet)



PokerStars Home Game Hand #220083102085: {Club #3225207}  Hold'em No Limit (50/100) - 2020/11/05 15:23:05 ET
Table 'funzzzzzzzz' 9-max (Play Money) Seat #3 is the button
Seat 1: dddocky (8266 in chips) 
Seat 2: Duke Croix (11100 in chips) 
Seat 3: MnnM150 (9649 in chips) 
Seat 4: HighCardJasper (6922 in chips) 
Seat 7: appositive (10694 in chips) 
Seat 9: JeBoyDirk (18009 in chips) 
HighCardJasper: posts small blind 50
appositive: posts big blind 100
*** HOLE CARDS ***
Dealt to Duke Croix [Tc 8d]
JeBoyDirk: folds 
dddocky: folds 
Duke Croix: folds 
MnnM150: calls 100
HighCardJasper: calls 50
appositive: checks 
*** FLOP *** [7d Jd 6h]
HighCardJasper: checks 
appositive: checks 
MnnM150: bets 141
HighCardJasper: folds 
appositive: calls 141
*** TURN *** [7d Jd 6h] [4d]
appositive: bets 100
MnnM150: raises 100 to 200
appositive: raises 100 to 300
MnnM150: calls 100
*** RIVER *** [7d Jd 6h 4d] [9c]
appositive: bets 558
MnnM150: folds 
Uncalled bet (558) returned to appositive
appositive collected 1117 from pot
appositive: doesn't show hand 
*** SUMMARY ***
Total pot 1182 | Rake 65 
Board [7d Jd 6h 4d 9c]
Seat 1: dddocky folded before Flop (didn't bet)
Seat 2: Duke Croix folded before Flop (didn't bet)
Seat 3: MnnM150 (button) folded on the River
Seat 4: HighCardJasper (small blind) folded on the Flop
Seat 7: appositive (big blind) collected (1117)
Seat 9: JeBoyDirk folded before Flop (didn't bet)



PokerStars Home Game Hand #220083146101: {Club #3225207}  Hold'em No Limit (50/100) - 2020/11/05 15:24:12 ET
Table 'funzzzzzzzz' 9-max (Play Money) Seat #4 is the button
Seat 1: dddocky (8266 in chips) 
Seat 2: Duke Croix (11100 in chips) 
Seat 3: MnnM150 (9108 in chips) 
Seat 4: HighCardJasper (6822 in chips) 
Seat 7: appositive (11270 in chips) 
Seat 8: Klemtonius (8968 in chips) 
Seat 9: JeBoyDirk (18009 in chips) 
appositive: posts small blind 50
Klemtonius: posts big blind 100
*** HOLE CARDS ***
Dealt to Duke Croix [Qs 7s]
JeBoyDirk: folds 
dddocky: calls 100
Duke Croix: calls 100
MnnM150: calls 100
HighCardJasper: calls 100
appositive: calls 50
Klemtonius: checks 
*** FLOP *** [Jc Ad Qc]
appositive: checks 
Klemtonius: checks 
dddocky: checks 
Duke Croix: checks 
MnnM150: bets 283
HighCardJasper: calls 283
appositive: calls 283
Klemtonius: folds 
dddocky: calls 283
Duke Croix: calls 283
*** TURN *** [Jc Ad Qc] [Jh]
appositive: bets 500
dddocky: folds 
Duke Croix: folds 
MnnM150: calls 500
HighCardJasper: calls 500
*** RIVER *** [Jc Ad Qc Jh] [7h]
appositive: bets 1661
MnnM150: folds 
HighCardJasper: folds 
Uncalled bet (1661) returned to appositive
appositive collected 3322 from pot
appositive: doesn't show hand 
*** SUMMARY ***
Total pot 3515 | Rake 193 
Board [Jc Ad Qc Jh 7h]
Seat 1: dddocky folded on the Turn
Seat 2: Duke Croix folded on the Turn
Seat 3: MnnM150 folded on the River
Seat 4: HighCardJasper (button) folded on the River
Seat 7: appositive (small blind) collected (3322)
Seat 8: Klemtonius (big blind) folded on the Flop
Seat 9: JeBoyDirk folded before Flop (didn't bet)



PokerStars Home Game Hand #220083199509: {Club #3225207}  Hold'em No Limit (50/100) - 2020/11/05 15:25:34 ET
Table 'funzzzzzzzz' 9-max (Play Money) Seat #7 is the button
Seat 1: dddocky (7883 in chips) 
Seat 2: Duke Croix (10717 in chips) 
Seat 3: MnnM150 (8225 in chips) 
Seat 4: HighCardJasper (5939 in chips) 
Seat 7: appositive (13709 in chips) 
Seat 8: Klemtonius (8868 in chips) 
Seat 9: JeBoyDirk (18009 in chips) 
Klemtonius: posts small blind 50
JeBoyDirk: posts big blind 100
*** HOLE CARDS ***
Dealt to Duke Croix [8d Qd]
dddocky: folds 
Duke Croix: calls 100
MnnM150: folds 
HighCardJasper: calls 100
appositive: calls 100
Klemtonius: raises 100 to 200
JeBoyDirk: folds 
Duke Croix: calls 100
HighCardJasper: calls 100
appositive: calls 100
*** FLOP *** [Kh 2h 4h]
Klemtonius: bets 850
Duke Croix: folds 
HighCardJasper: folds 
appositive: calls 850
*** TURN *** [Kh 2h 4h] [Ts]
Klemtonius: checks 
appositive: bets 1000
Klemtonius: calls 1000
*** RIVER *** [Kh 2h 4h Ts] [5c]
Klemtonius: checks 
appositive: bets 2173
Klemtonius: folds 
Uncalled bet (2173) returned to appositive
appositive collected 4347 from pot
appositive: doesn't show hand 
*** SUMMARY ***
Total pot 4600 | Rake 253 
Board [Kh 2h 4h Ts 5c]
Seat 1: dddocky folded before Flop (didn't bet)
Seat 2: Duke Croix folded on the Flop
Seat 3: MnnM150 folded before Flop (didn't bet)
Seat 4: HighCardJasper folded on the Flop
Seat 7: appositive (button) collected (4347)
Seat 8: Klemtonius (small blind) folded on the River
Seat 9: JeBoyDirk (big blind) folded before Flop



PokerStars Home Game Hand #220083255484: {Club #3225207}  Hold'em No Limit (50/100) - 2020/11/05 15:27:00 ET
Table 'funzzzzzzzz' 9-max (Play Money) Seat #8 is the button
Seat 1: dddocky (7883 in chips) 
Seat 2: Duke Croix (10517 in chips) 
Seat 3: MnnM150 (8225 in chips) 
Seat 4: HighCardJasper (5739 in chips) 
Seat 7: appositive (16006 in chips) 
Seat 8: Klemtonius (6818 in chips) 
Seat 9: JeBoyDirk (17909 in chips) 
JeBoyDirk: posts small blind 50
dddocky: posts big blind 100
*** HOLE CARDS ***
Dealt to Duke Croix [5h 9c]
Duke Croix: folds 
MnnM150: calls 100
HighCardJasper: folds 
appositive: folds 
Klemtonius: calls 100
JeBoyDirk: calls 50
dddocky: checks 
*** FLOP *** [Qd Js 7s]
JeBoyDirk: checks 
dddocky: checks 
MnnM150: checks 
Klemtonius: checks 
*** TURN *** [Qd Js 7s] [Jh]
JeBoyDirk: checks 
dddocky: checks 
MnnM150: bets 189
Klemtonius: calls 189
JeBoyDirk: folds 
dddocky: folds 
*** RIVER *** [Qd Js 7s Jh] [6c]
MnnM150: bets 367
Klemtonius: folds 
Uncalled bet (367) returned to MnnM150
MnnM150 collected 735 from pot
*** SUMMARY ***
Total pot 778 | Rake 43 
Board [Qd Js 7s Jh 6c]
Seat 1: dddocky (big blind) folded on the Turn
Seat 2: Duke Croix folded before Flop (didn't bet)
Seat 3: MnnM150 collected (735)
Seat 4: HighCardJasper folded before Flop (didn't bet)
Seat 7: appositive folded before Flop (didn't bet)
Seat 8: Klemtonius (button) folded on the River
Seat 9: JeBoyDirk (small blind) folded on the Turn



PokerStars Home Game Hand #220083287718: {Club #3225207}  Hold'em No Limit (50/100) - 2020/11/05 15:27:49 ET
Table 'funzzzzzzzz' 9-max (Play Money) Seat #9 is the button
Seat 1: dddocky (7783 in chips) 
Seat 2: Duke Croix (10517 in chips) 
Seat 3: MnnM150 (8671 in chips) 
Seat 4: HighCardJasper (5739 in chips) 
Seat 7: appositive (16006 in chips) 
Seat 8: Klemtonius (6529 in chips) 
Seat 9: JeBoyDirk (17809 in chips) 
dddocky: posts small blind 50
Duke Croix: posts big blind 100
*** HOLE CARDS ***
Dealt to Duke Croix [5s 4d]
MnnM150: calls 100
HighCardJasper: calls 100
appositive: calls 100
Klemtonius: calls 100
JeBoyDirk: raises 200 to 300
dddocky: folds 
Duke Croix: calls 200
MnnM150: calls 200
HighCardJasper: folds 
appositive: calls 200
Klemtonius: folds 
*** FLOP *** [5h Qc Js]
Duke Croix: checks 
MnnM150: bets 685
appositive: calls 685
JeBoyDirk: calls 685
Duke Croix: folds 
*** TURN *** [5h Qc Js] [3d]
MnnM150: checks 
appositive: bets 1656
JeBoyDirk: folds 
MnnM150: calls 1656
*** RIVER *** [5h Qc Js 3d] [Kd]
MnnM150: checks 
appositive: bets 3221
MnnM150: folds 
Uncalled bet (3221) returned to appositive
appositive collected 6442 from pot
appositive: doesn't show hand 
*** SUMMARY ***
Total pot 6817 | Rake 375 
Board [5h Qc Js 3d Kd]
Seat 1: dddocky (small blind) folded before Flop
Seat 2: Duke Croix (big blind) folded on the Flop
Seat 3: MnnM150 folded on the River
Seat 4: HighCardJasper folded before Flop
Seat 7: appositive collected (6442)
Seat 8: Klemtonius folded before Flop
Seat 9: JeBoyDirk (button) folded on the Turn



PokerStars Home Game Hand #220083344560: {Club #3225207}  Hold'em No Limit (50/100) - 2020/11/05 15:29:17 ET
Table 'funzzzzzzzz' 9-max (Play Money) Seat #1 is the button
Seat 1: dddocky (7733 in chips) 
Seat 2: Duke Croix (10217 in chips) 
Seat 3: MnnM150 (6030 in chips) 
Seat 4: HighCardJasper (5639 in chips) 
Seat 7: appositive (19807 in chips) 
Seat 8: Klemtonius (6429 in chips) 
Seat 9: JeBoyDirk (16824 in chips) 
Duke Croix: posts small blind 50
MnnM150: posts big blind 100
*** HOLE CARDS ***
Dealt to Duke Croix [8s Jh]
HighCardJasper: calls 100
appositive: calls 100
Klemtonius: calls 100
JeBoyDirk: folds 
dddocky: folds 
Duke Croix: calls 50
MnnM150: checks 
*** FLOP *** [5d 4s 3s]
Duke Croix: checks 
MnnM150: checks 
HighCardJasper: checks 
appositive: checks 
Klemtonius: checks 
*** TURN *** [5d 4s 3s] [4c]
Duke Croix: checks 
MnnM150: checks 
HighCardJasper: checks 
appositive: checks 
Klemtonius: checks 
*** RIVER *** [5d 4s 3s 4c] [3c]
Duke Croix: checks 
MnnM150: checks 
HighCardJasper: checks 
appositive: checks 
Klemtonius: checks 
*** SHOW DOWN ***
Duke Croix: shows [8s Jh] (two pair, Fours and Threes)
MnnM150: shows [7s Qd] (two pair, Fours and Threes - Queen kicker)
HighCardJasper: shows [2h Qs] (two pair, Fours and Threes)
appositive: shows [Th Qc] (two pair, Fours and Threes)
Klemtonius: mucks hand 
MnnM150 collected 158 from pot
HighCardJasper collected 157 from pot
appositive collected 157 from pot
*** SUMMARY ***
Total pot 500 | Rake 28 
Board [5d 4s 3s 4c 3c]
Seat 1: dddocky (button) folded before Flop (didn't bet)
Seat 2: Duke Croix (small blind) showed [8s Jh] and lost with two pair, Fours and Threes
Seat 3: MnnM150 (big blind) showed [7s Qd] and won (158) with two pair, Fours and Threes
Seat 4: HighCardJasper showed [2h Qs] and won (157) with two pair, Fours and Threes
Seat 7: appositive showed [Th Qc] and won (157) with two pair, Fours and Threes
Seat 8: Klemtonius mucked [8d Td]
Seat 9: JeBoyDirk folded before Flop (didn't bet)



PokerStars Home Game Hand #220083381155: {Club #3225207}  Hold'em No Limit (50/100) - 2020/11/05 15:30:13 ET
Table 'funzzzzzzzz' 9-max (Play Money) Seat #2 is the button
Seat 1: dddocky (7733 in chips) 
Seat 2: Duke Croix (10117 in chips) 
Seat 3: MnnM150 (6088 in chips) 
Seat 4: HighCardJasper (5696 in chips) 
Seat 7: appositive (19864 in chips) 
Seat 8: Klemtonius (6329 in chips) 
Seat 9: JeBoyDirk (16824 in chips) 
MnnM150: posts small blind 50
HighCardJasper: posts big blind 100
*** HOLE CARDS ***
Dealt to Duke Croix [9c 5s]
appositive: folds 
Klemtonius: calls 100
JeBoyDirk: folds 
dddocky: calls 100
Duke Croix: folds 
MnnM150: calls 50
HighCardJasper: checks 
*** FLOP *** [Jc Qs Ac]
MnnM150: bets 189
HighCardJasper: folds 
Klemtonius: folds 
dddocky: calls 189
*** TURN *** [Jc Qs Ac] [Kc]
MnnM150: bets 367
dddocky: calls 367
*** RIVER *** [Jc Qs Ac Kc] [5c]
MnnM150: bets 1429
dddocky: folds 
Uncalled bet (1429) returned to MnnM150
MnnM150 collected 1429 from pot
*** SUMMARY ***
Total pot 1512 | Rake 83 
Board [Jc Qs Ac Kc 5c]
Seat 1: dddocky folded on the River
Seat 2: Duke Croix (button) folded before Flop (didn't bet)
Seat 3: MnnM150 (small blind) collected (1429)
Seat 4: HighCardJasper (big blind) folded on the Flop
Seat 7: appositive folded before Flop (didn't bet)
Seat 8: Klemtonius folded on the Flop
Seat 9: JeBoyDirk folded before Flop (didn't bet)



PokerStars Home Game Hand #220083421285: {Club #3225207}  Hold'em No Limit (50/100) - 2020/11/05 15:31:05 ET
Table 'funzzzzzzzz' 9-max (Play Money) Seat #3 is the button
Seat 1: dddocky (7077 in chips) 
Seat 2: Duke Croix (10117 in chips) 
Seat 3: MnnM150 (6861 in chips) 
Seat 4: HighCardJasper (5596 in chips) 
Seat 7: appositive (19864 in chips) 
Seat 8: Klemtonius (6229 in chips) 
Seat 9: JeBoyDirk (16824 in chips) 
HighCardJasper: posts small blind 50
appositive: posts big blind 100
*** HOLE CARDS ***
Dealt to Duke Croix [6s 5d]
Klemtonius: calls 100
JeBoyDirk: folds 
dddocky: folds 
Duke Croix: folds 
MnnM150: calls 100
HighCardJasper: calls 50
appositive: checks 
*** FLOP *** [8c 9d 7c]
HighCardJasper: checks 
appositive: bets 100
Klemtonius: folds 
MnnM150: calls 100
HighCardJasper: calls 100
*** TURN *** [8c 9d 7c] [9c]
HighCardJasper: checks 
appositive: bets 300
MnnM150: calls 300
HighCardJasper: folds 
*** RIVER *** [8c 9d 7c 9c] [4h]
appositive: checks 
MnnM150: checks 
*** SHOW DOWN ***
appositive: shows [2s Th] (a pair of Nines)
MnnM150: shows [8h Qs] (two pair, Nines and Eights)
MnnM150 collected 1228 from pot
*** SUMMARY ***
Total pot 1300 | Rake 72 
Board [8c 9d 7c 9c 4h]
Seat 1: dddocky folded before Flop (didn't bet)
Seat 2: Duke Croix folded before Flop (didn't bet)
Seat 3: MnnM150 (button) showed [8h Qs] and won (1228) with two pair, Nines and Eights
Seat 4: HighCardJasper (small blind) folded on the Turn
Seat 7: appositive (big blind) showed [2s Th] and lost with a pair of Nines
Seat 8: Klemtonius folded on the Flop
Seat 9: JeBoyDirk folded before Flop (didn't bet)



PokerStars Home Game Hand #220083488100: {Club #3225207}  Hold'em No Limit (50/100) - 2020/11/05 15:32:48 ET
Table 'funzzzzzzzz' 9-max (Play Money) Seat #4 is the button
Seat 1: dddocky (7077 in chips) 
Seat 2: Duke Croix (10117 in chips) 
Seat 3: MnnM150 (7589 in chips) 
Seat 4: HighCardJasper (5396 in chips) 
Seat 7: appositive (19364 in chips) 
Seat 8: Klemtonius (6129 in chips) 
Seat 9: JeBoyDirk (16824 in chips) 
appositive: posts small blind 50
Klemtonius: posts big blind 100
*** HOLE CARDS ***
Dealt to Duke Croix [9s 5h]
JeBoyDirk: folds 
dddocky: folds 
Duke Croix: folds 
MnnM150: calls 100
HighCardJasper: calls 100
appositive: folds 
Klemtonius: checks 
*** FLOP *** [9c 4c 3h]
Klemtonius: checks 
MnnM150: checks 
HighCardJasper: checks 
*** TURN *** [9c 4c 3h] [Td]
Klemtonius: checks 
MnnM150: bets 165
HighCardJasper: calls 165
Klemtonius: folds 
*** RIVER *** [9c 4c 3h Td] [Qd]
MnnM150: checks 
HighCardJasper: checks 
*** SHOW DOWN ***
MnnM150: shows [9h Jd] (a pair of Nines)
HighCardJasper: shows [Js Tc] (a pair of Tens)
HighCardJasper collected 643 from pot
*** SUMMARY ***
Total pot 680 | Rake 37 
Board [9c 4c 3h Td Qd]
Seat 1: dddocky folded before Flop (didn't bet)
Seat 2: Duke Croix folded before Flop (didn't bet)
Seat 3: MnnM150 showed [9h Jd] and lost with a pair of Nines
Seat 4: HighCardJasper (button) showed [Js Tc] and won (643) with a pair of Tens
Seat 7: appositive (small blind) folded before Flop
Seat 8: Klemtonius (big blind) folded on the Turn
Seat 9: JeBoyDirk folded before Flop (didn't bet)



PokerStars Home Game Hand #220083530351: {Club #3225207}  Hold'em No Limit (50/100) - 2020/11/05 15:33:54 ET
Table 'funzzzzzzzz' 9-max (Play Money) Seat #7 is the button
Seat 1: dddocky (7077 in chips) 
Seat 2: Duke Croix (10117 in chips) 
Seat 3: MnnM150 (7324 in chips) 
Seat 4: HighCardJasper (5774 in chips) 
Seat 7: appositive (19314 in chips) 
Seat 8: Klemtonius (6029 in chips) 
Seat 9: JeBoyDirk (16824 in chips) 
Klemtonius: posts small blind 50
JeBoyDirk: posts big blind 100
*** HOLE CARDS ***
Dealt to Duke Croix [7h 5h]
dddocky: folds 
Duke Croix: folds 
MnnM150: folds 
HighCardJasper: calls 100
appositive: calls 100
Klemtonius: raises 100 to 200
JeBoyDirk: folds 
HighCardJasper: calls 100
appositive: calls 100
*** FLOP *** [Qd Qc Kd]
Klemtonius: bets 100
HighCardJasper: calls 100
appositive: raises 480 to 580
Klemtonius: folds 
HighCardJasper: calls 480
*** TURN *** [Qd Qc Kd] [8h]
HighCardJasper: checks 
appositive: bets 926
HighCardJasper: calls 926
*** RIVER *** [Qd Qc Kd 8h] [Ad]
HighCardJasper: bets 4068 and is all-in
appositive: folds 
Uncalled bet (4068) returned to HighCardJasper
HighCardJasper collected 3602 from pot
HighCardJasper: doesn't show hand 
*** SUMMARY ***
Total pot 3812 | Rake 210 
Board [Qd Qc Kd 8h Ad]
Seat 1: dddocky folded before Flop (didn't bet)
Seat 2: Duke Croix folded before Flop (didn't bet)
Seat 3: MnnM150 folded before Flop (didn't bet)
Seat 4: HighCardJasper collected (3602)
Seat 7: appositive (button) folded on the River
Seat 8: Klemtonius (small blind) folded on the Flop
Seat 9: JeBoyDirk (big blind) folded before Flop



PokerStars Home Game Hand #220083575016: {Club #3225207}  Hold'em No Limit (50/100) - 2020/11/05 15:35:02 ET
Table 'funzzzzzzzz' 9-max (Play Money) Seat #8 is the button
Seat 1: dddocky (7077 in chips) 
Seat 2: Duke Croix (10117 in chips) 
Seat 3: MnnM150 (7324 in chips) 
Seat 4: HighCardJasper (7670 in chips) 
Seat 7: appositive (17608 in chips) 
Seat 8: Klemtonius (5729 in chips) 
Seat 9: JeBoyDirk (16724 in chips) 
JeBoyDirk: posts small blind 50
dddocky: posts big blind 100
*** HOLE CARDS ***
Dealt to Duke Croix [7s Ad]
Duke Croix: raises 300 to 400
MnnM150: folds 
HighCardJasper: calls 400
appositive: folds 
Klemtonius: folds 
JeBoyDirk: calls 350
dddocky: folds 
*** FLOP *** [3h 4s 3d]
JeBoyDirk: bets 500
Duke Croix: folds 
HighCardJasper: folds 
Uncalled bet (500) returned to JeBoyDirk
JeBoyDirk collected 1228 from pot
*** SUMMARY ***
Total pot 1300 | Rake 72 
Board [3h 4s 3d]
Seat 1: dddocky (big blind) folded before Flop
Seat 2: Duke Croix folded on the Flop
Seat 3: MnnM150 folded before Flop (didn't bet)
Seat 4: HighCardJasper folded on the Flop
Seat 7: appositive folded before Flop (didn't bet)
Seat 8: Klemtonius (button) folded before Flop (didn't bet)
Seat 9: JeBoyDirk (small blind) collected (1228)



PokerStars Home Game Hand #220083606981: {Club #3225207}  Hold'em No Limit (50/100) - 2020/11/05 15:35:52 ET
Table 'funzzzzzzzz' 9-max (Play Money) Seat #9 is the button
Seat 1: dddocky (6977 in chips) 
Seat 2: Duke Croix (9717 in chips) 
Seat 3: MnnM150 (7324 in chips) 
Seat 4: HighCardJasper (7270 in chips) 
Seat 7: appositive (17608 in chips) 
Seat 8: Klemtonius (5729 in chips) 
Seat 9: JeBoyDirk (17552 in chips) 
dddocky: posts small blind 50
Duke Croix: posts big blind 100
*** HOLE CARDS ***
Dealt to Duke Croix [5c 5s]
MnnM150: calls 100
HighCardJasper: calls 100
appositive: calls 100
Klemtonius: calls 100
JeBoyDirk: calls 100
dddocky: raises 100 to 200
Duke Croix: calls 100
MnnM150: calls 100
HighCardJasper: calls 100
appositive: calls 100
Klemtonius: calls 100
JeBoyDirk: calls 100
*** FLOP *** [7h 3c 6c]
dddocky: bets 1323
Duke Croix: folds 
MnnM150: folds 
HighCardJasper: folds 
appositive: folds 
Klemtonius: folds 
JeBoyDirk: folds 
Uncalled bet (1323) returned to dddocky
dddocky collected 1323 from pot
dddocky: doesn't show hand 
*** SUMMARY ***
Total pot 1400 | Rake 77 
Board [7h 3c 6c]
Seat 1: dddocky (small blind) collected (1323)
Seat 2: Duke Croix (big blind) folded on the Flop
Seat 3: MnnM150 folded on the Flop
Seat 4: HighCardJasper folded on the Flop
Seat 7: appositive folded on the Flop
Seat 8: Klemtonius folded on the Flop
Seat 9: JeBoyDirk (button) folded on the Flop



PokerStars Home Game Hand #220083645907: {Club #3225207}  Hold'em No Limit (50/100) - 2020/11/05 15:36:52 ET
Table 'funzzzzzzzz' 9-max (Play Money) Seat #1 is the button
Seat 1: dddocky (8100 in chips) 
Seat 2: Duke Croix (9517 in chips) 
Seat 3: MnnM150 (7124 in chips) 
Seat 4: HighCardJasper (7070 in chips) 
Seat 7: appositive (17408 in chips) 
Seat 8: Klemtonius (5529 in chips) 
Seat 9: JeBoyDirk (17352 in chips) 
Duke Croix: posts small blind 50
MnnM150: posts big blind 100
*** HOLE CARDS ***
Dealt to Duke Croix [Jh 4h]
HighCardJasper: calls 100
appositive: folds 
Klemtonius: folds 
JeBoyDirk: folds 
dddocky: folds 
Duke Croix: calls 50
MnnM150: checks 
*** FLOP *** [Qd 8c 2d]
Duke Croix: checks 
MnnM150: bets 141
HighCardJasper: calls 141
Duke Croix: folds 
*** TURN *** [Qd 8c 2d] [9c]
MnnM150: checks 
HighCardJasper: bets 200
MnnM150: calls 200
*** RIVER *** [Qd 8c 2d 9c] [3c]
MnnM150: checks 
HighCardJasper: bets 500
MnnM150: calls 500
*** SHOW DOWN ***
HighCardJasper: shows [8h 9h] (two pair, Nines and Eights)
MnnM150: mucks hand 
HighCardJasper collected 1873 from pot
*** SUMMARY ***
Total pot 1982 | Rake 109 
Board [Qd 8c 2d 9c 3c]
Seat 1: dddocky (button) folded before Flop (didn't bet)
Seat 2: Duke Croix (small blind) folded on the Flop
Seat 3: MnnM150 (big blind) mucked [5c Qh]
Seat 4: HighCardJasper showed [8h 9h] and won (1873) with two pair, Nines and Eights
Seat 7: appositive folded before Flop (didn't bet)
Seat 8: Klemtonius folded before Flop (didn't bet)
Seat 9: JeBoyDirk folded before Flop (didn't bet)



PokerStars Home Game Hand #220083696696: {Club #3225207}  Hold'em No Limit (50/100) - 2020/11/05 15:38:11 ET
Table 'funzzzzzzzz' 9-max (Play Money) Seat #2 is the button
Seat 1: dddocky (8100 in chips) 
Seat 2: Duke Croix (9417 in chips) 
Seat 3: MnnM150 (6183 in chips) 
Seat 4: HighCardJasper (8002 in chips) 
Seat 7: appositive (17408 in chips) 
Seat 8: Klemtonius (5529 in chips) 
Seat 9: JeBoyDirk (17352 in chips) 
MnnM150: posts small blind 50
HighCardJasper: posts big blind 100
*** HOLE CARDS ***
Dealt to Duke Croix [5c Jh]
appositive: calls 100
Klemtonius: calls 100
JeBoyDirk: folds 
dddocky: raises 100 to 200
Duke Croix: folds 
MnnM150: folds 
HighCardJasper: calls 100
appositive: calls 100
Klemtonius: calls 100
*** FLOP *** [5h Kc Jd]
HighCardJasper: checks 
appositive: checks 
Klemtonius: checks 
dddocky: bets 401
HighCardJasper: calls 401
appositive: folds 
Klemtonius: folds 
*** TURN *** [5h Kc Jd] [Qh]
HighCardJasper: checks 
dddocky: bets 1561
HighCardJasper: folds 
Uncalled bet (1561) returned to dddocky
dddocky collected 1561 from pot
dddocky: doesn't show hand 
*** SUMMARY ***
Total pot 1652 | Rake 91 
Board [5h Kc Jd Qh]
Seat 1: dddocky collected (1561)
Seat 2: Duke Croix (button) folded before Flop (didn't bet)
Seat 3: MnnM150 (small blind) folded before Flop
Seat 4: HighCardJasper (big blind) folded on the Turn
Seat 7: appositive folded on the Flop
Seat 8: Klemtonius folded on the Flop
Seat 9: JeBoyDirk folded before Flop (didn't bet)



PokerStars Home Game Hand #220083731035: {Club #3225207}  Hold'em No Limit (50/100) - 2020/11/05 15:39:04 ET
Table 'funzzzzzzzz' 9-max (Play Money) Seat #3 is the button
Seat 1: dddocky (9060 in chips) 
Seat 2: Duke Croix (9417 in chips) 
Seat 3: MnnM150 (6133 in chips) 
Seat 4: HighCardJasper (7401 in chips) 
Seat 7: appositive (17208 in chips) 
Seat 8: Klemtonius (5329 in chips) 
Seat 9: JeBoyDirk (17352 in chips) 
HighCardJasper: posts small blind 50
appositive: posts big blind 100
*** HOLE CARDS ***
Dealt to Duke Croix [6s Ah]
Klemtonius: calls 100
JeBoyDirk: folds 
dddocky: calls 100
Duke Croix: calls 100
MnnM150: calls 100
HighCardJasper: calls 50
appositive: checks 
*** FLOP *** [6c 8s 2c]
HighCardJasper: checks 
appositive: bets 283
Klemtonius: folds 
dddocky: calls 283
Duke Croix: folds 
MnnM150: calls 283
HighCardJasper: folds 
*** TURN *** [6c 8s 2c] [Tc]
appositive: checks 
dddocky: checks 
MnnM150: checks 
*** RIVER *** [6c 8s 2c Tc] [Kc]
appositive: bets 684
dddocky: folds 
MnnM150: raises 684 to 1368
appositive: calls 684
*** SHOW DOWN ***
MnnM150: shows [9h 9c] (a flush, King high)
appositive: mucks hand 
MnnM150 collected 3955 from pot
*** SUMMARY ***
Total pot 4185 | Rake 230 
Board [6c 8s 2c Tc Kc]
Seat 1: dddocky folded on the River
Seat 2: Duke Croix folded on the Flop
Seat 3: MnnM150 (button) showed [9h 9c] and won (3955) with a flush, King high
Seat 4: HighCardJasper (small blind) folded on the Flop
Seat 7: appositive (big blind) mucked [8c 7d]
Seat 8: Klemtonius folded on the Flop
Seat 9: JeBoyDirk folded before Flop (didn't bet)



PokerStars Home Game Hand #220083788456: {Club #3225207}  Hold'em No Limit (50/100) - 2020/11/05 15:40:33 ET
Table 'funzzzzzzzz' 9-max (Play Money) Seat #4 is the button
Seat 1: dddocky (8677 in chips) 
Seat 2: Duke Croix (9317 in chips) 
Seat 3: MnnM150 (8337 in chips) 
Seat 4: HighCardJasper (7301 in chips) 
Seat 7: appositive (15457 in chips) 
Seat 8: Klemtonius (5229 in chips) 
Seat 9: JeBoyDirk (17352 in chips) 
appositive: posts small blind 50
Klemtonius: posts big blind 100
*** HOLE CARDS ***
Dealt to Duke Croix [7s 9s]
JeBoyDirk: folds 
dddocky: calls 100
Duke Croix: calls 100
MnnM150: folds 
HighCardJasper: calls 100
appositive: calls 50
Klemtonius: checks 
*** FLOP *** [Jd 2s 8d]
appositive: checks 
Klemtonius: checks 
dddocky: checks 
Duke Croix: bets 300
HighCardJasper: folds 
appositive: folds 
Klemtonius: folds 
dddocky: folds 
Uncalled bet (300) returned to Duke Croix
Duke Croix collected 472 from pot
*** SUMMARY ***
Total pot 500 | Rake 28 
Board [Jd 2s 8d]
Seat 1: dddocky folded on the Flop
Seat 2: Duke Croix collected (472)
Seat 3: MnnM150 folded before Flop (didn't bet)
Seat 4: HighCardJasper (button) folded on the Flop
Seat 7: appositive (small blind) folded on the Flop
Seat 8: Klemtonius (big blind) folded on the Flop
Seat 9: JeBoyDirk folded before Flop (didn't bet)



PokerStars Home Game Hand #220083813230: {Club #3225207}  Hold'em No Limit (50/100) - 2020/11/05 15:41:12 ET
Table 'funzzzzzzzz' 9-max (Play Money) Seat #7 is the button
Seat 1: dddocky (8577 in chips) 
Seat 2: Duke Croix (9689 in chips) 
Seat 3: MnnM150 (8337 in chips) 
Seat 4: HighCardJasper (7201 in chips) 
Seat 7: appositive (15357 in chips) 
Seat 8: Klemtonius (5129 in chips) 
Seat 9: JeBoyDirk (17352 in chips) 
Klemtonius: posts small blind 50
JeBoyDirk: posts big blind 100
*** HOLE CARDS ***
Dealt to Duke Croix [Kc 4c]
dddocky: folds 
Duke Croix: folds 
MnnM150: folds 
HighCardJasper: folds 
appositive: folds 
Klemtonius: calls 50
JeBoyDirk: checks 
*** FLOP *** [3c 9s 8h]
Klemtonius: checks 
JeBoyDirk: checks 
*** TURN *** [3c 9s 8h] [7c]
Klemtonius: bets 100
JeBoyDirk: calls 100
*** RIVER *** [3c 9s 8h 7c] [6c]
Klemtonius: bets 100
JeBoyDirk: calls 100
*** SHOW DOWN ***
Klemtonius: shows [5s 7d] (a straight, Five to Nine)
JeBoyDirk: mucks hand 
Klemtonius collected 567 from pot
*** SUMMARY ***
Total pot 600 | Rake 33 
Board [3c 9s 8h 7c 6c]
Seat 1: dddocky folded before Flop (didn't bet)
Seat 2: Duke Croix folded before Flop (didn't bet)
Seat 3: MnnM150 folded before Flop (didn't bet)
Seat 4: HighCardJasper folded before Flop (didn't bet)
Seat 7: appositive (button) folded before Flop (didn't bet)
Seat 8: Klemtonius (small blind) showed [5s 7d] and won (567) with a straight, Five to Nine
Seat 9: JeBoyDirk (big blind) mucked [8c 6d]



PokerStars Home Game Hand #220083839220: {Club #3225207}  Hold'em No Limit (50/100) - 2020/11/05 15:41:53 ET
Table 'funzzzzzzzz' 9-max (Play Money) Seat #8 is the button
Seat 1: dddocky (8577 in chips) 
Seat 2: Duke Croix (9689 in chips) 
Seat 3: MnnM150 (8337 in chips) 
Seat 4: HighCardJasper (7201 in chips) 
Seat 7: appositive (15357 in chips) 
Seat 8: Klemtonius (5396 in chips) 
Seat 9: JeBoyDirk (17052 in chips) 
JeBoyDirk: posts small blind 50
dddocky: posts big blind 100
*** HOLE CARDS ***
Dealt to Duke Croix [6s 3d]
Duke Croix: folds 
MnnM150: folds 
HighCardJasper: calls 100
appositive: folds 
Klemtonius: calls 100
JeBoyDirk: folds 
dddocky: checks 
*** FLOP *** [Qs 9s Kc]
dddocky: checks 
HighCardJasper: checks 
Klemtonius: checks 
*** TURN *** [Qs 9s Kc] [2d]
dddocky: bets 100
HighCardJasper: calls 100
Klemtonius: raises 100 to 200
dddocky: calls 100
HighCardJasper: calls 100
*** RIVER *** [Qs 9s Kc 2d] [9d]
dddocky: checks 
HighCardJasper: checks 
Klemtonius: bets 898
dddocky: folds 
HighCardJasper: folds 
Uncalled bet (898) returned to Klemtonius
Klemtonius collected 898 from pot
Klemtonius: doesn't show hand 
*** SUMMARY ***
Total pot 950 | Rake 52 
Board [Qs 9s Kc 2d 9d]
Seat 1: dddocky (big blind) folded on the River
Seat 2: Duke Croix folded before Flop (didn't bet)
Seat 3: MnnM150 folded before Flop (didn't bet)
Seat 4: HighCardJasper folded on the River
Seat 7: appositive folded before Flop (didn't bet)
Seat 8: Klemtonius (button) collected (898)
Seat 9: JeBoyDirk (small blind) folded before Flop



PokerStars Home Game Hand #220083870448: {Club #3225207}  Hold'em No Limit (50/100) - 2020/11/05 15:42:42 ET
Table 'funzzzzzzzz' 9-max (Play Money) Seat #9 is the button
Seat 1: dddocky (8277 in chips) 
Seat 2: Duke Croix (9689 in chips) 
Seat 3: MnnM150 (8337 in chips) 
Seat 4: HighCardJasper (6901 in chips) 
Seat 7: appositive (15357 in chips) 
Seat 8: Klemtonius (5994 in chips) 
Seat 9: JeBoyDirk (17002 in chips) 
dddocky: posts small blind 50
Duke Croix: posts big blind 100
*** HOLE CARDS ***
Dealt to Duke Croix [Js Kc]
MnnM150: calls 100
HighCardJasper: folds 
appositive: raises 100 to 200
Klemtonius: folds 
JeBoyDirk: folds 
dddocky: calls 150
Duke Croix: calls 100
MnnM150: calls 100
*** FLOP *** [5s 6c Ad]
dddocky: checks 
Duke Croix: checks 
MnnM150: bets 100
appositive: folds 
dddocky: calls 100
Duke Croix: folds 
*** TURN *** [5s 6c Ad] [Ah]
dddocky: checks 
MnnM150: bets 472
dddocky: folds 
Uncalled bet (472) returned to MnnM150
MnnM150 collected 945 from pot
*** SUMMARY ***
Total pot 1000 | Rake 55 
Board [5s 6c Ad Ah]
Seat 1: dddocky (small blind) folded on the Turn
Seat 2: Duke Croix (big blind) folded on the Flop
Seat 3: MnnM150 collected (945)
Seat 4: HighCardJasper folded before Flop (didn't bet)
Seat 7: appositive folded on the Flop
Seat 8: Klemtonius folded before Flop (didn't bet)
Seat 9: JeBoyDirk (button) folded before Flop (didn't bet)



PokerStars Home Game Hand #220083908066: {Club #3225207}  Hold'em No Limit (50/100) - 2020/11/05 15:43:40 ET
Table 'funzzzzzzzz' 9-max (Play Money) Seat #1 is the button
Seat 1: dddocky (7977 in chips) 
Seat 2: Duke Croix (9489 in chips) 
Seat 3: MnnM150 (8982 in chips) 
Seat 4: HighCardJasper (6901 in chips) 
Seat 7: appositive (15157 in chips) 
Seat 8: Klemtonius (5994 in chips) 
Seat 9: JeBoyDirk (17002 in chips) 
Duke Croix: posts small blind 50
MnnM150: posts big blind 100
*** HOLE CARDS ***
Dealt to Duke Croix [Kh 9d]
HighCardJasper: calls 100
appositive: folds 
Klemtonius: raises 100 to 200
JeBoyDirk: folds 
dddocky: calls 200
Duke Croix: calls 150
MnnM150: calls 100
HighCardJasper: calls 100
*** FLOP *** [3h Js 2h]
Duke Croix: checks 
MnnM150: bets 100
HighCardJasper: calls 100
Klemtonius: calls 100
dddocky: calls 100
Duke Croix: folds 
*** TURN *** [3h Js 2h] [Qs]
MnnM150: bets 661
HighCardJasper: folds 
Klemtonius: folds 
dddocky: calls 661
*** RIVER *** [3h Js 2h Qs] [Ac]
MnnM150: bets 1286
dddocky: folds 
Uncalled bet (1286) returned to MnnM150
MnnM150 collected 2572 from pot
*** SUMMARY ***
Total pot 2722 | Rake 150 
Board [3h Js 2h Qs Ac]
Seat 1: dddocky (button) folded on the River
Seat 2: Duke Croix (small blind) folded on the Flop
Seat 3: MnnM150 (big blind) collected (2572)
Seat 4: HighCardJasper folded on the Turn
Seat 7: appositive folded before Flop (didn't bet)
Seat 8: Klemtonius folded on the Turn
Seat 9: JeBoyDirk folded before Flop (didn't bet)



PokerStars Home Game Hand #220083961436: {Club #3225207}  Hold'em No Limit (50/100) - 2020/11/05 15:45:04 ET
Table 'funzzzzzzzz' 9-max (Play Money) Seat #2 is the button
Seat 1: dddocky (7016 in chips) 
Seat 2: Duke Croix (9289 in chips) 
Seat 3: MnnM150 (10593 in chips) 
Seat 4: HighCardJasper (6601 in chips) 
Seat 7: appositive (15157 in chips) 
Seat 8: Klemtonius (5694 in chips) 
Seat 9: JeBoyDirk (17002 in chips) 
MnnM150: posts small blind 50
HighCardJasper: posts big blind 100
*** HOLE CARDS ***
Dealt to Duke Croix [Qd 2c]
appositive: calls 100
Klemtonius: raises 100 to 200
JeBoyDirk: folds 
dddocky: folds 
Duke Croix: folds 
MnnM150: folds 
HighCardJasper: calls 100
appositive: calls 100
*** FLOP *** [4s Kh 4c]
HighCardJasper: checks 
appositive: checks 
Klemtonius: bets 614
HighCardJasper: folds 
appositive: folds 
Uncalled bet (614) returned to Klemtonius
Klemtonius collected 614 from pot
Klemtonius: doesn't show hand 
*** SUMMARY ***
Total pot 650 | Rake 36 
Board [4s Kh 4c]
Seat 1: dddocky folded before Flop (didn't bet)
Seat 2: Duke Croix (button) folded before Flop (didn't bet)
Seat 3: MnnM150 (small blind) folded before Flop
Seat 4: HighCardJasper (big blind) folded on the Flop
Seat 7: appositive folded on the Flop
Seat 8: Klemtonius collected (614)
Seat 9: JeBoyDirk folded before Flop (didn't bet)



PokerStars Home Game Hand #220083982138: {Club #3225207}  Hold'em No Limit (50/100) - 2020/11/05 15:45:37 ET
Table 'funzzzzzzzz' 9-max (Play Money) Seat #3 is the button
Seat 1: dddocky (7016 in chips) 
Seat 2: Duke Croix (9289 in chips) 
Seat 3: MnnM150 (10543 in chips) 
Seat 4: HighCardJasper (6401 in chips) 
Seat 7: appositive (14957 in chips) 
Seat 8: Klemtonius (6108 in chips) 
Seat 9: JeBoyDirk (17002 in chips) 
HighCardJasper: posts small blind 50
appositive: posts big blind 100
*** HOLE CARDS ***
Dealt to Duke Croix [2h 3c]
Klemtonius: folds 
JeBoyDirk: raises 100 to 200
dddocky: folds 
Duke Croix: folds 
MnnM150: calls 200
HighCardJasper: calls 150
appositive: calls 100
*** FLOP *** [Ad 8d 9s]
HighCardJasper: checks 
appositive: checks 
JeBoyDirk: bets 400
MnnM150: calls 400
HighCardJasper: folds 
appositive: folds 
*** TURN *** [Ad 8d 9s] [6c]
JeBoyDirk: bets 1000
MnnM150: folds 
Uncalled bet (1000) returned to JeBoyDirk
JeBoyDirk collected 1512 from pot
*** SUMMARY ***
Total pot 1600 | Rake 88 
Board [Ad 8d 9s 6c]
Seat 1: dddocky folded before Flop (didn't bet)
Seat 2: Duke Croix folded before Flop (didn't bet)
Seat 3: MnnM150 (button) folded on the Turn
Seat 4: HighCardJasper (small blind) folded on the Flop
Seat 7: appositive (big blind) folded on the Flop
Seat 8: Klemtonius folded before Flop (didn't bet)
Seat 9: JeBoyDirk collected (1512)



PokerStars Home Game Hand #220084015587: {Club #3225207}  Hold'em No Limit (50/100) - 2020/11/05 15:46:29 ET
Table 'funzzzzzzzz' 9-max (Play Money) Seat #4 is the button
Seat 1: dddocky (7016 in chips) 
Seat 2: Duke Croix (9289 in chips) 
Seat 3: MnnM150 (9943 in chips) 
Seat 4: HighCardJasper (6201 in chips) 
Seat 7: appositive (14757 in chips) 
Seat 8: Klemtonius (6108 in chips) 
Seat 9: JeBoyDirk (17914 in chips) 
appositive: posts small blind 50
Klemtonius: posts big blind 100
*** HOLE CARDS ***
Dealt to Duke Croix [As 8h]
JeBoyDirk: folds 
dddocky: folds 
Duke Croix: raises 200 to 300
MnnM150: calls 300
HighCardJasper: calls 300
appositive: folds 
Klemtonius: folds 
*** FLOP *** [Ts Td Kh]
Duke Croix: checks 
MnnM150: checks 
HighCardJasper has timed out
HighCardJasper: checks 
*** TURN *** [Ts Td Kh] [7s]
Duke Croix: checks 
MnnM150: checks 
HighCardJasper: checks 
*** RIVER *** [Ts Td Kh 7s] [3d]
Duke Croix: checks 
MnnM150: checks 
HighCardJasper: checks 
*** SHOW DOWN ***
Duke Croix: shows [As 8h] (a pair of Tens)
MnnM150: mucks hand 
HighCardJasper: shows [7h Ah] (two pair, Tens and Sevens)
HighCardJasper collected 992 from pot
*** SUMMARY ***
Total pot 1050 | Rake 58 
Board [Ts Td Kh 7s 3d]
Seat 1: dddocky folded before Flop (didn't bet)
Seat 2: Duke Croix showed [As 8h] and lost with a pair of Tens
Seat 3: MnnM150 mucked [Jh 2h]
Seat 4: HighCardJasper (button) showed [7h Ah] and won (992) with two pair, Tens and Sevens
Seat 7: appositive (small blind) folded before Flop
Seat 8: Klemtonius (big blind) folded before Flop
Seat 9: JeBoyDirk folded before Flop (didn't bet)



PokerStars Home Game Hand #220084070481: {Club #3225207}  Hold'em No Limit (50/100) - 2020/11/05 15:47:56 ET
Table 'funzzzzzzzz' 9-max (Play Money) Seat #7 is the button
Seat 1: dddocky (7016 in chips) 
Seat 2: Duke Croix (8989 in chips) 
Seat 3: MnnM150 (9643 in chips) 
Seat 4: HighCardJasper (6893 in chips) 
Seat 7: appositive (14707 in chips) 
Seat 8: Klemtonius (6008 in chips) 
Seat 9: JeBoyDirk (17914 in chips) 
Klemtonius: posts small blind 50
JeBoyDirk: posts big blind 100
*** HOLE CARDS ***
Dealt to Duke Croix [6s 5c]
dddocky: calls 100
Duke Croix: folds 
MnnM150: calls 100
HighCardJasper: calls 100
appositive: folds 
Klemtonius: calls 50
JeBoyDirk: checks 
*** FLOP *** [Jd 3s 5s]
Klemtonius: checks 
JeBoyDirk: checks 
dddocky: checks 
MnnM150: checks 
HighCardJasper: bets 100
Klemtonius: folds 
JeBoyDirk: folds 
dddocky: folds 
MnnM150: folds 
Uncalled bet (100) returned to HighCardJasper
HighCardJasper collected 472 from pot
HighCardJasper: doesn't show hand 
*** SUMMARY ***
Total pot 500 | Rake 28 
Board [Jd 3s 5s]
Seat 1: dddocky folded on the Flop
Seat 2: Duke Croix folded before Flop (didn't bet)
Seat 3: MnnM150 folded on the Flop
Seat 4: HighCardJasper collected (472)
Seat 7: appositive (button) folded before Flop (didn't bet)
Seat 8: Klemtonius (small blind) folded on the Flop
Seat 9: JeBoyDirk (big blind) folded on the Flop



PokerStars Home Game Hand #220084103690: {Club #3225207}  Hold'em No Limit (50/100) - 2020/11/05 15:48:48 ET
Table 'funzzzzzzzz' 9-max (Play Money) Seat #8 is the button
Seat 1: dddocky (6916 in chips) 
Seat 2: Duke Croix (8989 in chips) 
Seat 3: MnnM150 (9543 in chips) 
Seat 4: HighCardJasper (7265 in chips) 
Seat 7: appositive (14707 in chips) 
Seat 8: Klemtonius (5908 in chips) 
Seat 9: JeBoyDirk (17814 in chips) 
JeBoyDirk: posts small blind 50
dddocky: posts big blind 100
*** HOLE CARDS ***
Dealt to Duke Croix [Qc 9s]
Duke Croix: folds 
MnnM150: folds 
HighCardJasper: calls 100
appositive: folds 
Klemtonius: folds 
JeBoyDirk: folds 
dddocky: checks 
*** FLOP *** [8c 4c Qd]
dddocky: checks 
HighCardJasper: checks 
*** TURN *** [8c 4c Qd] [Kc]
dddocky: bets 118
HighCardJasper: folds 
Uncalled bet (118) returned to dddocky
dddocky collected 236 from pot
dddocky: doesn't show hand 
*** SUMMARY ***
Total pot 250 | Rake 14 
Board [8c 4c Qd Kc]
Seat 1: dddocky (big blind) collected (236)
Seat 2: Duke Croix folded before Flop (didn't bet)
Seat 3: MnnM150 folded before Flop (didn't bet)
Seat 4: HighCardJasper folded on the Turn
Seat 7: appositive folded before Flop (didn't bet)
Seat 8: Klemtonius (button) folded before Flop (didn't bet)
Seat 9: JeBoyDirk (small blind) folded before Flop



PokerStars Home Game Hand #220084130786: {Club #3225207}  Hold'em No Limit (50/100) - 2020/11/05 15:49:31 ET
Table 'funzzzzzzzz' 9-max (Play Money) Seat #9 is the button
Seat 1: dddocky (7052 in chips) 
Seat 2: Duke Croix (8989 in chips) 
Seat 3: MnnM150 (9543 in chips) 
Seat 4: HighCardJasper (7165 in chips) 
Seat 7: appositive (14707 in chips) 
Seat 8: Klemtonius (5908 in chips) 
Seat 9: JeBoyDirk (17764 in chips) 
dddocky: posts small blind 50
Duke Croix: posts big blind 100
*** HOLE CARDS ***
Dealt to Duke Croix [4h Qh]
MnnM150: folds 
HighCardJasper: calls 100
appositive: folds 
Klemtonius: calls 100
JeBoyDirk: folds 
dddocky: calls 50
Duke Croix: checks 
*** FLOP *** [9h 7d Js]
dddocky: checks 
Duke Croix: checks 
HighCardJasper: checks 
Klemtonius: bets 100
dddocky: calls 100
Duke Croix: folds 
HighCardJasper: folds 
*** TURN *** [9h 7d Js] [Jh]
dddocky: bets 200
Klemtonius: calls 200
*** RIVER *** [9h 7d Js Jh] [Qs]
dddocky: bets 945
Klemtonius: folds 
Uncalled bet (945) returned to dddocky
dddocky collected 945 from pot
dddocky: doesn't show hand 
*** SUMMARY ***
Total pot 1000 | Rake 55 
Board [9h 7d Js Jh Qs]
Seat 1: dddocky (small blind) collected (945)
Seat 2: Duke Croix (big blind) folded on the Flop
Seat 3: MnnM150 folded before Flop (didn't bet)
Seat 4: HighCardJasper folded on the Flop
Seat 7: appositive folded before Flop (didn't bet)
Seat 8: Klemtonius folded on the River
Seat 9: JeBoyDirk (button) folded before Flop (didn't bet)



PokerStars Home Game Hand #220084156195: {Club #3225207}  Hold'em No Limit (50/100) - 2020/11/05 15:50:11 ET
Table 'funzzzzzzzz' 9-max (Play Money) Seat #1 is the button
Seat 1: dddocky (7597 in chips) 
Seat 2: Duke Croix (8889 in chips) 
Seat 3: MnnM150 (9543 in chips) 
Seat 4: HighCardJasper (7065 in chips) 
Seat 7: appositive (14707 in chips) 
Seat 8: Klemtonius (5508 in chips) 
Seat 9: JeBoyDirk (17764 in chips) 
Duke Croix: posts small blind 50
MnnM150: posts big blind 100
*** HOLE CARDS ***
Dealt to Duke Croix [Ks 7d]
HighCardJasper: calls 100
appositive: calls 100
Klemtonius: calls 100
JeBoyDirk: folds 
dddocky: folds 
Duke Croix: calls 50
MnnM150: checks 
*** FLOP *** [Ad 9s 6c]
Duke Croix: checks 
MnnM150: checks 
HighCardJasper: checks 
appositive: checks 
Klemtonius: bets 472
Duke Croix: folds 
MnnM150: folds 
HighCardJasper: folds 
appositive: folds 
Uncalled bet (472) returned to Klemtonius
Klemtonius collected 472 from pot
Klemtonius: doesn't show hand 
*** SUMMARY ***
Total pot 500 | Rake 28 
Board [Ad 9s 6c]
Seat 1: dddocky (button) folded before Flop (didn't bet)
Seat 2: Duke Croix (small blind) folded on the Flop
Seat 3: MnnM150 (big blind) folded on the Flop
Seat 4: HighCardJasper folded on the Flop
Seat 7: appositive folded on the Flop
Seat 8: Klemtonius collected (472)
Seat 9: JeBoyDirk folded before Flop (didn't bet)



PokerStars Home Game Hand #220084180843: {Club #3225207}  Hold'em No Limit (50/100) - 2020/11/05 15:50:49 ET
Table 'funzzzzzzzz' 9-max (Play Money) Seat #2 is the button
Seat 1: dddocky (7597 in chips) 
Seat 2: Duke Croix (8789 in chips) 
Seat 3: MnnM150 (9443 in chips) 
Seat 4: HighCardJasper (6965 in chips) 
Seat 7: appositive (14607 in chips) 
Seat 8: Klemtonius (5880 in chips) 
Seat 9: JeBoyDirk (17764 in chips) 
MnnM150: posts small blind 50
HighCardJasper: posts big blind 100
*** HOLE CARDS ***
Dealt to Duke Croix [Ts Td]
appositive: calls 100
Klemtonius: raises 100 to 200
JeBoyDirk: folds 
dddocky: calls 200
Duke Croix: raises 300 to 500
MnnM150: calls 450
HighCardJasper: folds 
appositive: folds 
Klemtonius: calls 300
dddocky: calls 300
*** FLOP *** [4s 4c 9c]
MnnM150: bets 700
Klemtonius: folds 
dddocky: folds 
Duke Croix: calls 700
*** TURN *** [4s 4c 9c] [2h]
MnnM150: checks 
Duke Croix: bets 1400
MnnM150: calls 1400
*** RIVER *** [4s 4c 9c 2h] [Qs]
MnnM150: checks 
Duke Croix: checks 
*** SHOW DOWN ***
MnnM150: shows [Ac 9s] (two pair, Nines and Fours)
Duke Croix: shows [Ts Td] (two pair, Tens and Fours)
Duke Croix collected 6048 from pot
*** SUMMARY ***
Total pot 6400 | Rake 352 
Board [4s 4c 9c 2h Qs]
Seat 1: dddocky folded on the Flop
Seat 2: Duke Croix (button) showed [Ts Td] and won (6048) with two pair, Tens and Fours
Seat 3: MnnM150 (small blind) showed [Ac 9s] and lost with two pair, Nines and Fours
Seat 4: HighCardJasper (big blind) folded before Flop
Seat 7: appositive folded before Flop
Seat 8: Klemtonius folded on the Flop
Seat 9: JeBoyDirk folded before Flop (didn't bet)



PokerStars Home Game Hand #220084226736: {Club #3225207}  Hold'em No Limit (50/100) - 2020/11/05 15:52:01 ET
Table 'funzzzzzzzz' 9-max (Play Money) Seat #3 is the button
Seat 1: dddocky (7097 in chips) 
Seat 2: Duke Croix (12237 in chips) 
Seat 3: MnnM150 (6843 in chips) 
Seat 4: HighCardJasper (6865 in chips) 
Seat 7: appositive (14507 in chips) 
Seat 8: Klemtonius (5380 in chips) 
Seat 9: JeBoyDirk (17764 in chips) 
HighCardJasper: posts small blind 50
appositive: posts big blind 100
*** HOLE CARDS ***
Dealt to Duke Croix [As 7s]
Klemtonius: calls 100
JeBoyDirk: folds 
dddocky: calls 100
Duke Croix: raises 400 to 500
MnnM150: folds 
HighCardJasper has timed out
HighCardJasper: folds 
appositive: calls 400
Klemtonius: folds 
dddocky: folds 
*** FLOP *** [4h 9c Qd]
appositive: checks 
Duke Croix: checks 
*** TURN *** [4h 9c Qd] [8h]
appositive: bets 590
Duke Croix: folds 
Uncalled bet (590) returned to appositive
appositive collected 1181 from pot
appositive: doesn't show hand 
*** SUMMARY ***
Total pot 1250 | Rake 69 
Board [4h 9c Qd 8h]
Seat 1: dddocky folded before Flop
Seat 2: Duke Croix folded on the Turn
Seat 3: MnnM150 (button) folded before Flop (didn't bet)
Seat 4: HighCardJasper (small blind) folded before Flop
Seat 7: appositive (big blind) collected (1181)
Seat 8: Klemtonius folded before Flop
Seat 9: JeBoyDirk folded before Flop (didn't bet)



PokerStars Home Game Hand #220084263975: {Club #3225207}  Hold'em No Limit (50/100) - 2020/11/05 15:52:58 ET
Table 'funzzzzzzzz' 9-max (Play Money) Seat #7 is the button
Seat 2: Duke Croix (11737 in chips) 
Seat 3: MnnM150 (6843 in chips) 
Seat 7: appositive (15188 in chips) 
Seat 8: Klemtonius (5280 in chips) 
Seat 9: JeBoyDirk (17764 in chips) 
Klemtonius: posts small blind 50
JeBoyDirk: posts big blind 100
*** HOLE CARDS ***
Dealt to Duke Croix [2c Ts]
Duke Croix: folds 
MnnM150: calls 100
appositive: calls 100
Klemtonius: calls 50
JeBoyDirk: checks 
*** FLOP *** [5c 9d 5h]
Klemtonius: checks 
JeBoyDirk: checks 
MnnM150: checks 
appositive: checks 
*** TURN *** [5c 9d 5h] [8h]
Klemtonius: checks 
JeBoyDirk: bets 200
MnnM150: folds 
appositive: raises 200 to 400
Klemtonius: folds 
JeBoyDirk: calls 200
*** RIVER *** [5c 9d 5h 8h] [Ac]
JeBoyDirk: bets 1200
appositive: folds 
Uncalled bet (1200) returned to JeBoyDirk
JeBoyDirk collected 1134 from pot
*** SUMMARY ***
Total pot 1200 | Rake 66 
Board [5c 9d 5h 8h Ac]
Seat 2: Duke Croix folded before Flop (didn't bet)
Seat 3: MnnM150 folded on the Turn
Seat 7: appositive (button) folded on the River
Seat 8: Klemtonius (small blind) folded on the Turn
Seat 9: JeBoyDirk (big blind) collected (1134)



PokerStars Home Game Hand #220084299479: {Club #3225207}  Hold'em No Limit (50/100) - 2020/11/05 15:53:54 ET
Table 'funzzzzzzzz' 9-max (Play Money) Seat #8 is the button
Seat 2: Duke Croix (11737 in chips) 
Seat 3: MnnM150 (6743 in chips) 
Seat 4: HighCardJasper (6815 in chips) 
Seat 7: appositive (14688 in chips) 
Seat 8: Klemtonius (5180 in chips) 
Seat 9: JeBoyDirk (18398 in chips) 
JeBoyDirk: posts small blind 50
Duke Croix: posts big blind 100
*** HOLE CARDS ***
Dealt to Duke Croix [9d 7d]
MnnM150: calls 100
HighCardJasper: calls 100
appositive: folds 
Klemtonius: calls 100
JeBoyDirk: folds 
Duke Croix: checks 
*** FLOP *** [4c 6c Qh]
Duke Croix: checks 
MnnM150: bets 212
HighCardJasper: calls 212
Klemtonius: folds 
Duke Croix: folds 
*** TURN *** [4c 6c Qh] [8h]
MnnM150: bets 413
HighCardJasper: calls 413
*** RIVER *** [4c 6c Qh 8h] [Tc]
MnnM150: bets 803
HighCardJasper: folds 
Uncalled bet (803) returned to MnnM150
MnnM150 collected 1606 from pot
*** SUMMARY ***
Total pot 1700 | Rake 94 
Board [4c 6c Qh 8h Tc]
Seat 2: Duke Croix (big blind) folded on the Flop
Seat 3: MnnM150 collected (1606)
Seat 4: HighCardJasper folded on the River
Seat 7: appositive folded before Flop (didn't bet)
Seat 8: Klemtonius (button) folded on the Flop
Seat 9: JeBoyDirk (small blind) folded before Flop



PokerStars Home Game Hand #220084332014: {Club #3225207}  Hold'em No Limit (50/100) - 2020/11/05 15:54:44 ET
Table 'funzzzzzzzz' 9-max (Play Money) Seat #9 is the button
Seat 2: Duke Croix (11637 in chips) 
Seat 3: MnnM150 (7624 in chips) 
Seat 4: HighCardJasper (6090 in chips) 
Seat 7: appositive (14688 in chips) 
Seat 8: Klemtonius (5080 in chips) 
Seat 9: JeBoyDirk (18348 in chips) 
Duke Croix: posts small blind 50
MnnM150: posts big blind 100
*** HOLE CARDS ***
Dealt to Duke Croix [Jc Qs]
HighCardJasper: raises 100 to 200
appositive: folds 
Klemtonius: calls 200
JeBoyDirk has timed out
JeBoyDirk: folds 
Duke Croix: calls 150
MnnM150: folds 
*** FLOP *** [8c Qh 7s]
Duke Croix: bets 400
HighCardJasper: calls 400
Klemtonius: folds 
*** TURN *** [8c Qh 7s] [4c]
Duke Croix: bets 800
HighCardJasper: calls 800
*** RIVER *** [8c Qh 7s 4c] [6s]
Duke Croix: bets 1500
HighCardJasper: folds 
Uncalled bet (1500) returned to Duke Croix
Duke Croix collected 2929 from pot
*** SUMMARY ***
Total pot 3100 | Rake 171 
Board [8c Qh 7s 4c 6s]
Seat 2: Duke Croix (small blind) collected (2929)
Seat 3: MnnM150 (big blind) folded before Flop
Seat 4: HighCardJasper folded on the River
Seat 7: appositive folded before Flop (didn't bet)
Seat 8: Klemtonius folded on the Flop
Seat 9: JeBoyDirk (button) folded before Flop (didn't bet)



PokerStars Home Game Hand #220084370987: {Club #3225207}  Hold'em No Limit (50/100) - 2020/11/05 15:56:01 ET
Table 'funzzzzzzzz' 9-max (Play Money) Seat #2 is the button
Seat 1: dddocky (6997 in chips) 
Seat 2: Duke Croix (13166 in chips) 
Seat 3: MnnM150 (7524 in chips) 
Seat 4: HighCardJasper (4690 in chips) 
Seat 7: appositive (14688 in chips) 
Seat 8: Klemtonius (4880 in chips) 
Seat 9: JeBoyDirk (18348 in chips) 
MnnM150: posts small blind 50
HighCardJasper: posts big blind 100
dddocky: posts small & big blinds 150
*** HOLE CARDS ***
Dealt to Duke Croix [2c Th]
appositive: folds 
Klemtonius: folds 
JeBoyDirk: folds 
dddocky: checks 
Duke Croix: folds 
MnnM150: calls 50
HighCardJasper: raises 100 to 200
dddocky: calls 100
MnnM150: calls 100
*** FLOP *** [7c 7h 6d]
MnnM150: checks 
HighCardJasper: checks 
dddocky: checks 
*** TURN *** [7c 7h 6d] [4d]
MnnM150: checks 
HighCardJasper: checks 
dddocky: checks 
*** RIVER *** [7c 7h 6d 4d] [9s]
MnnM150: bets 307
HighCardJasper: folds 
dddocky: folds 
Uncalled bet (307) returned to MnnM150
MnnM150 collected 614 from pot
*** SUMMARY ***
Total pot 650 | Rake 36 
Board [7c 7h 6d 4d 9s]
Seat 1: dddocky folded on the River
Seat 2: Duke Croix (button) folded before Flop (didn't bet)
Seat 3: MnnM150 (small blind) collected (614)
Seat 4: HighCardJasper (big blind) folded on the River
Seat 7: appositive folded before Flop (didn't bet)
Seat 8: Klemtonius folded before Flop (didn't bet)
Seat 9: JeBoyDirk folded before Flop (didn't bet)



PokerStars Home Game Hand #220084398784: {Club #3225207}  Hold'em No Limit (50/100) - 2020/11/05 15:56:52 ET
Table 'funzzzzzzzz' 9-max (Play Money) Seat #3 is the button
Seat 1: dddocky (6747 in chips) 
Seat 2: Duke Croix (13166 in chips) 
Seat 3: MnnM150 (7938 in chips) 
Seat 4: HighCardJasper (4490 in chips) 
Seat 7: appositive (14688 in chips) 
Seat 8: Klemtonius (4880 in chips) 
Seat 9: JeBoyDirk (18348 in chips) 
HighCardJasper: posts small blind 50
appositive: posts big blind 100
*** HOLE CARDS ***
Dealt to Duke Croix [Ks 2s]
Klemtonius: calls 100
JeBoyDirk: folds 
dddocky: folds 
Duke Croix: folds 
MnnM150: folds 
HighCardJasper: calls 50
appositive: checks 
*** FLOP *** [7c 2d 2h]
HighCardJasper: checks 
appositive: checks 
Klemtonius: checks 
*** TURN *** [7c 2d 2h] [As]
HighCardJasper: checks 
appositive: bets 141
Klemtonius: folds 
HighCardJasper: folds 
Uncalled bet (141) returned to appositive
appositive collected 283 from pot
appositive: doesn't show hand 
*** SUMMARY ***
Total pot 300 | Rake 17 
Board [7c 2d 2h As]
Seat 1: dddocky folded before Flop (didn't bet)
Seat 2: Duke Croix folded before Flop (didn't bet)
Seat 3: MnnM150 (button) folded before Flop (didn't bet)
Seat 4: HighCardJasper (small blind) folded on the Turn
Seat 7: appositive (big blind) collected (283)
Seat 8: Klemtonius folded on the Turn
Seat 9: JeBoyDirk folded before Flop (didn't bet)



PokerStars Home Game Hand #220084419741: {Club #3225207}  Hold'em No Limit (50/100) - 2020/11/05 15:57:36 ET
Table 'funzzzzzzzz' 9-max (Play Money) Seat #4 is the button
Seat 1: dddocky (6747 in chips) 
Seat 2: Duke Croix (13166 in chips) 
Seat 4: HighCardJasper (4390 in chips) 
Seat 7: appositive (14871 in chips) 
Seat 8: Klemtonius (4780 in chips) 
Seat 9: JeBoyDirk (18348 in chips) 
appositive: posts small blind 50
Klemtonius: posts big blind 100
*** HOLE CARDS ***
Dealt to Duke Croix [Ks 8h]
JeBoyDirk: calls 100
dddocky: folds 
Duke Croix: folds 
HighCardJasper: folds 
appositive: calls 50
Klemtonius: checks 
*** FLOP *** [Tc Jh 7d]
appositive: bets 141
Klemtonius: folds 
JeBoyDirk: calls 141
*** TURN *** [Tc Jh 7d] [8c]
appositive: bets 550
JeBoyDirk: calls 550
*** RIVER *** [Tc Jh 7d 8c] [4d]
appositive: bets 1589
JeBoyDirk: folds 
Uncalled bet (1589) returned to appositive
appositive collected 1589 from pot
appositive: doesn't show hand 
*** SUMMARY ***
Total pot 1682 | Rake 93 
Board [Tc Jh 7d 8c 4d]
Seat 1: dddocky folded before Flop (didn't bet)
Seat 2: Duke Croix folded before Flop (didn't bet)
Seat 4: HighCardJasper (button) folded before Flop (didn't bet)
Seat 7: appositive (small blind) collected (1589)
Seat 8: Klemtonius (big blind) folded on the Flop
Seat 9: JeBoyDirk folded on the River



PokerStars Home Game Hand #220084445111: {Club #3225207}  Hold'em No Limit (50/100) - 2020/11/05 15:58:29 ET
Table 'funzzzzzzzz' 9-max (Play Money) Seat #7 is the button
Seat 1: dddocky (6747 in chips) 
Seat 2: Duke Croix (13166 in chips) 
Seat 4: HighCardJasper (4390 in chips) 
Seat 7: appositive (15669 in chips) 
Seat 8: Klemtonius (4680 in chips) 
Seat 9: JeBoyDirk (17557 in chips) 
Klemtonius: posts small blind 50
JeBoyDirk: posts big blind 100
*** HOLE CARDS ***
Dealt to Duke Croix [8d 3d]
dddocky: calls 100
Duke Croix: folds 
HighCardJasper: calls 100
appositive: calls 100
Klemtonius: calls 50
JeBoyDirk: checks 
*** FLOP *** [7c 6h 6d]
Klemtonius: checks 
JeBoyDirk: checks 
dddocky: bets 236
HighCardJasper: calls 236
appositive: folds 
Klemtonius: folds 
JeBoyDirk: folds 
*** TURN *** [7c 6h 6d] [3s]
dddocky: bets 459
HighCardJasper: calls 459
*** RIVER *** [7c 6h 6d 3s] [Ah]
dddocky: bets 1786
HighCardJasper: calls 1786
*** SHOW DOWN ***
dddocky: shows [As 7d] (two pair, Aces and Sevens)
HighCardJasper: shows [6s 8s] (three of a kind, Sixes)
HighCardJasper collected 5162 from pot
*** SUMMARY ***
Total pot 5462 | Rake 300 
Board [7c 6h 6d 3s Ah]
Seat 1: dddocky showed [As 7d] and lost with two pair, Aces and Sevens
Seat 2: Duke Croix folded before Flop (didn't bet)
Seat 4: HighCardJasper showed [6s 8s] and won (5162) with three of a kind, Sixes
Seat 7: appositive (button) folded on the Flop
Seat 8: Klemtonius (small blind) folded on the Flop
Seat 9: JeBoyDirk (big blind) folded on the Flop



PokerStars Home Game Hand #220084477488: {Club #3225207}  Hold'em No Limit (50/100) - 2020/11/05 15:59:38 ET
Table 'funzzzzzzzz' 9-max (Play Money) Seat #8 is the button
Seat 1: dddocky (4166 in chips) 
Seat 2: Duke Croix (13166 in chips) 
Seat 4: HighCardJasper (6971 in chips) 
Seat 7: appositive (15569 in chips) 
Seat 8: Klemtonius (4580 in chips) 
Seat 9: JeBoyDirk (17457 in chips) 
JeBoyDirk: posts small blind 50
dddocky: posts big blind 100
*** HOLE CARDS ***
Dealt to Duke Croix [8s Ks]
Duke Croix: raises 200 to 300
HighCardJasper: calls 300
appositive: folds 
Klemtonius: calls 300
JeBoyDirk: calls 250
dddocky: folds 
*** FLOP *** [9d 9h Ah]
JeBoyDirk: checks 
Duke Croix: checks 
HighCardJasper: checks 
Klemtonius: checks 
*** TURN *** [9d 9h Ah] [2d]
JeBoyDirk: checks 
Duke Croix has timed out
Duke Croix: checks 
HighCardJasper: checks 
Klemtonius: bets 300
JeBoyDirk: calls 300
Duke Croix: folds 
HighCardJasper: folds 
*** RIVER *** [9d 9h Ah 2d] [Qd]
JeBoyDirk: checks 
Klemtonius: bets 897
JeBoyDirk: folds 
Uncalled bet (897) returned to Klemtonius
Klemtonius collected 1795 from pot
Klemtonius: doesn't show hand 
*** SUMMARY ***
Total pot 1900 | Rake 105 
Board [9d 9h Ah 2d Qd]
Seat 1: dddocky (big blind) folded before Flop
Seat 2: Duke Croix folded on the Turn
Seat 4: HighCardJasper folded on the Turn
Seat 7: appositive folded before Flop (didn't bet)
Seat 8: Klemtonius (button) collected (1795)
Seat 9: JeBoyDirk (small blind) folded on the River



PokerStars Home Game Hand #220084519199: {Club #3225207}  Hold'em No Limit (50/100) - 2020/11/05 16:01:01 ET
Table 'funzzzzzzzz' 9-max (Play Money) Seat #9 is the button
Seat 1: dddocky (4066 in chips) 
Seat 2: Duke Croix (12866 in chips) 
Seat 3: MnnM150 (7938 in chips) 
Seat 4: HighCardJasper (6671 in chips) 
Seat 7: appositive (15569 in chips) 
Seat 8: Klemtonius (5775 in chips) 
Seat 9: JeBoyDirk (16857 in chips) 
dddocky: posts small blind 50
Duke Croix: posts big blind 100
*** HOLE CARDS ***
Dealt to Duke Croix [Ac As]
MnnM150: calls 100
HighCardJasper: calls 100
appositive: calls 100
Klemtonius: calls 100
JeBoyDirk: calls 100
dddocky: folds 
Duke Croix: raises 400 to 500
MnnM150: folds 
HighCardJasper: folds 
appositive: calls 400
Klemtonius: folds 
JeBoyDirk: calls 400
*** FLOP *** [6h 3h Js]
Duke Croix: bets 1000
appositive: folds 
JeBoyDirk: folds 
Uncalled bet (1000) returned to Duke Croix
Duke Croix collected 1748 from pot
*** SUMMARY ***
Total pot 1850 | Rake 102 
Board [6h 3h Js]
Seat 1: dddocky (small blind) folded before Flop
Seat 2: Duke Croix (big blind) collected (1748)
Seat 3: MnnM150 folded before Flop
Seat 4: HighCardJasper folded before Flop
Seat 7: appositive folded on the Flop
Seat 8: Klemtonius folded before Flop
Seat 9: JeBoyDirk (button) folded on the Flop



PokerStars Home Game Hand #220084545435: {Club #3225207}  Hold'em No Limit (50/100) - 2020/11/05 16:01:46 ET
Table 'funzzzzzzzz' 9-max (Play Money) Seat #1 is the button
Seat 1: dddocky (4016 in chips) 
Seat 2: Duke Croix (14114 in chips) 
Seat 3: MnnM150 (7838 in chips) 
Seat 4: HighCardJasper (6571 in chips) 
Seat 7: appositive (15069 in chips) 
Seat 8: Klemtonius (5675 in chips) 
Seat 9: JeBoyDirk (16357 in chips) 
Duke Croix: posts small blind 50
MnnM150: posts big blind 100
*** HOLE CARDS ***
Dealt to Duke Croix [4s 2s]
HighCardJasper: calls 100
appositive: folds 
Klemtonius: calls 100
JeBoyDirk: folds 
dddocky: calls 100
Duke Croix: calls 50
MnnM150: checks 
*** FLOP *** [4c 4h 2d]
Duke Croix: checks 
MnnM150: checks 
HighCardJasper: checks 
Klemtonius: bets 100
dddocky: calls 100
Duke Croix: calls 100
MnnM150: calls 100
HighCardJasper: folds 
*** TURN *** [4c 4h 2d] [8c]
Duke Croix: checks 
MnnM150: checks 
Klemtonius: bets 100
dddocky: calls 100
Duke Croix: raises 400 to 500
MnnM150: folds 
Klemtonius: calls 400
dddocky: folds 
*** RIVER *** [4c 4h 2d 8c] [As]
Duke Croix: checks 
Klemtonius: bets 2400
Duke Croix: raises 2400 to 4800
Klemtonius: folds 
Uncalled bet (2400) returned to Duke Croix
Duke Croix collected 6426 from pot
*** SUMMARY ***
Total pot 6800 | Rake 374 
Board [4c 4h 2d 8c As]
Seat 1: dddocky (button) folded on the Turn
Seat 2: Duke Croix (small blind) collected (6426)
Seat 3: MnnM150 (big blind) folded on the Turn
Seat 4: HighCardJasper folded on the Flop
Seat 7: appositive folded before Flop (didn't bet)
Seat 8: Klemtonius folded on the River
Seat 9: JeBoyDirk folded before Flop (didn't bet)



PokerStars Home Game Hand #220084600661: {Club #3225207}  Hold'em No Limit (50/100) - 2020/11/05 16:03:15 ET
Table 'funzzzzzzzz' 9-max (Play Money) Seat #2 is the button
Seat 1: dddocky (3716 in chips) 
Seat 2: Duke Croix (17440 in chips) 
Seat 3: MnnM150 (7638 in chips) 
Seat 4: HighCardJasper (6471 in chips) 
Seat 7: appositive (15069 in chips) 
Seat 8: Klemtonius (2575 in chips) 
Seat 9: JeBoyDirk (16357 in chips) 
MnnM150: posts small blind 50
HighCardJasper: posts big blind 100
*** HOLE CARDS ***
Dealt to Duke Croix [7c 6h]
appositive: calls 100
Klemtonius: folds 
JeBoyDirk: folds 
dddocky: calls 100
Duke Croix: folds 
MnnM150: calls 50
HighCardJasper: checks 
*** FLOP *** [Qs 5s 6d]
MnnM150: checks 
HighCardJasper: checks 
appositive: bets 189
dddocky: folds 
MnnM150: folds 
HighCardJasper: calls 189
*** TURN *** [Qs 5s 6d] [9h]
HighCardJasper: checks 
appositive: bets 735
HighCardJasper: calls 735
*** RIVER *** [Qs 5s 6d 9h] [8d]
HighCardJasper: checks 
appositive: bets 2124
HighCardJasper: calls 2124
*** SHOW DOWN ***
appositive: shows [Ad Qd] (a pair of Queens)
HighCardJasper: shows [6c 9c] (two pair, Nines and Sixes)
HighCardJasper collected 6139 from pot
*** SUMMARY ***
Total pot 6496 | Rake 357 
Board [Qs 5s 6d 9h 8d]
Seat 1: dddocky folded on the Flop
Seat 2: Duke Croix (button) folded before Flop (didn't bet)
Seat 3: MnnM150 (small blind) folded on the Flop
Seat 4: HighCardJasper (big blind) showed [6c 9c] and won (6139) with two pair, Nines and Sixes
Seat 7: appositive showed [Ad Qd] and lost with a pair of Queens
Seat 8: Klemtonius folded before Flop (didn't bet)
Seat 9: JeBoyDirk folded before Flop (didn't bet)



PokerStars Home Game Hand #220084646457: {Club #3225207}  Hold'em No Limit (50/100) - 2020/11/05 16:04:28 ET
Table 'funzzzzzzzz' 9-max (Play Money) Seat #3 is the button
Seat 1: dddocky (3616 in chips) 
Seat 2: Duke Croix (17440 in chips) 
Seat 3: MnnM150 (7538 in chips) 
Seat 4: HighCardJasper (9462 in chips) 
Seat 7: appositive (11921 in chips) 
Seat 9: JeBoyDirk (16357 in chips) 
HighCardJasper: posts small blind 50
appositive: posts big blind 100
*** HOLE CARDS ***
Dealt to Duke Croix [Kd 2c]
JeBoyDirk: folds 
dddocky: calls 100
Duke Croix: folds 
MnnM150: calls 100
HighCardJasper: calls 50
appositive: checks 
*** FLOP *** [5d Ts 7c]
HighCardJasper: checks 
appositive: checks 
dddocky: checks 
MnnM150: checks 
*** TURN *** [5d Ts 7c] [4c]
HighCardJasper: checks 
appositive: checks 
dddocky: checks 
MnnM150: checks 
*** RIVER *** [5d Ts 7c 4c] [6c]
HighCardJasper: bets 400
appositive: folds 
dddocky: raises 400 to 800
MnnM150: calls 800
HighCardJasper: calls 400
*** SHOW DOWN ***
dddocky: shows [3d Kh] (a straight, Three to Seven)
MnnM150: shows [8h Jd] (a straight, Four to Eight)
HighCardJasper: mucks hand 
MnnM150 collected 2646 from pot
*** SUMMARY ***
Total pot 2800 | Rake 154 
Board [5d Ts 7c 4c 6c]
Seat 1: dddocky showed [3d Kh] and lost with a straight, Three to Seven
Seat 2: Duke Croix folded before Flop (didn't bet)
Seat 3: MnnM150 (button) showed [8h Jd] and won (2646) with a straight, Four to Eight
Seat 4: HighCardJasper (small blind) mucked [2h 3s]
Seat 7: appositive (big blind) folded on the River
Seat 9: JeBoyDirk folded before Flop (didn't bet)



PokerStars Home Game Hand #220084691004: {Club #3225207}  Hold'em No Limit (50/100) - 2020/11/05 16:05:37 ET
Table 'funzzzzzzzz' 9-max (Play Money) Seat #4 is the button
Seat 1: dddocky (2716 in chips) 
Seat 2: Duke Croix (17440 in chips) 
Seat 3: MnnM150 (9284 in chips) 
Seat 4: HighCardJasper (8562 in chips) 
Seat 7: appositive (11821 in chips) 
Seat 9: JeBoyDirk (16357 in chips) 
appositive: posts small blind 50
JeBoyDirk: posts big blind 100
*** HOLE CARDS ***
Dealt to Duke Croix [2d Qd]
dddocky: folds 
Duke Croix: folds 
MnnM150: calls 100
HighCardJasper: calls 100
appositive: calls 50
JeBoyDirk: checks 
*** FLOP *** [Qs 4h 9d]
appositive: checks 
JeBoyDirk: checks 
MnnM150: checks 
HighCardJasper: checks 
*** TURN *** [Qs 4h 9d] [Jh]
appositive: bets 189
JeBoyDirk: folds 
MnnM150: calls 189
HighCardJasper: calls 189
*** RIVER *** [Qs 4h 9d Jh] [4s]
appositive: checks 
MnnM150: checks 
HighCardJasper: checks 
*** SHOW DOWN ***
appositive: shows [7h Js] (two pair, Jacks and Fours)
MnnM150: mucks hand 
HighCardJasper: mucks hand 
appositive collected 914 from pot
*** SUMMARY ***
Total pot 967 | Rake 53 
Board [Qs 4h 9d Jh 4s]
Seat 1: dddocky folded before Flop (didn't bet)
Seat 2: Duke Croix folded before Flop (didn't bet)
Seat 3: MnnM150 mucked [As 3c]
Seat 4: HighCardJasper (button) mucked [7c 9h]
Seat 7: appositive (small blind) showed [7h Js] and won (914) with two pair, Jacks and Fours
Seat 9: JeBoyDirk (big blind) folded on the Turn



PokerStars Home Game Hand #220084721298: {Club #3225207}  Hold'em No Limit (50/100) - 2020/11/05 16:06:24 ET
Table 'funzzzzzzzz' 9-max (Play Money) Seat #7 is the button
Seat 1: dddocky (2716 in chips) 
Seat 2: Duke Croix (17440 in chips) 
Seat 3: MnnM150 (8995 in chips) 
Seat 4: HighCardJasper (8273 in chips) 
Seat 7: appositive (12446 in chips) 
Seat 9: JeBoyDirk (16257 in chips) 
JeBoyDirk: posts small blind 50
dddocky: posts big blind 100
*** HOLE CARDS ***
Dealt to Duke Croix [Jh 4d]
Duke Croix: folds 
MnnM150: folds 
HighCardJasper: calls 100
appositive: calls 100
JeBoyDirk: folds 
dddocky: checks 
*** FLOP *** [Kc 2s Qc]
dddocky: checks 
HighCardJasper: checks 
appositive: checks 
*** TURN *** [Kc 2s Qc] [Jd]
dddocky: checks 
HighCardJasper: bets 200
appositive: raises 200 to 400
dddocky: folds 
HighCardJasper: raises 200 to 600
appositive: calls 200
*** RIVER *** [Kc 2s Qc Jd] [9s]
HighCardJasper: bets 1000
appositive: folds 
Uncalled bet (1000) returned to HighCardJasper
HighCardJasper collected 1465 from pot
HighCardJasper: doesn't show hand 
*** SUMMARY ***
Total pot 1550 | Rake 85 
Board [Kc 2s Qc Jd 9s]
Seat 1: dddocky (big blind) folded on the Turn
Seat 2: Duke Croix folded before Flop (didn't bet)
Seat 3: MnnM150 folded before Flop (didn't bet)
Seat 4: HighCardJasper collected (1465)
Seat 7: appositive (button) folded on the River
Seat 9: JeBoyDirk (small blind) folded before Flop



PokerStars Home Game Hand #220084760667: {Club #3225207}  Hold'em No Limit (50/100) - 2020/11/05 16:07:26 ET
Table 'funzzzzzzzz' 9-max (Play Money) Seat #9 is the button
Seat 1: dddocky (2616 in chips) 
Seat 2: Duke Croix (17440 in chips) 
Seat 3: MnnM150 (8995 in chips) 
Seat 4: HighCardJasper (9038 in chips) 
Seat 7: appositive (11746 in chips) 
Seat 9: JeBoyDirk (16207 in chips) 
dddocky: posts small blind 50
Duke Croix: posts big blind 100
*** HOLE CARDS ***
Dealt to Duke Croix [9d Ac]
MnnM150: calls 100
HighCardJasper: calls 100
appositive: calls 100
JeBoyDirk: folds 
dddocky: folds 
Duke Croix: raises 400 to 500
MnnM150: calls 400
HighCardJasper: calls 400
appositive: calls 400
*** FLOP *** [Th Qc 8c]
Duke Croix: bets 700
MnnM150: raises 700 to 1400
HighCardJasper: folds 
appositive: folds 
Duke Croix: folds 
Uncalled bet (700) returned to MnnM150
MnnM150 collected 3260 from pot
*** SUMMARY ***
Total pot 3450 | Rake 190 
Board [Th Qc 8c]
Seat 1: dddocky (small blind) folded before Flop
Seat 2: Duke Croix (big blind) folded on the Flop
Seat 3: MnnM150 collected (3260)
Seat 4: HighCardJasper folded on the Flop
Seat 7: appositive folded on the Flop
Seat 9: JeBoyDirk (button) folded before Flop (didn't bet)



PokerStars Home Game Hand #220084798805: {Club #3225207}  Hold'em No Limit (50/100) - 2020/11/05 16:08:26 ET
Table 'funzzzzzzzz' 9-max (Play Money) Seat #1 is the button
Seat 1: dddocky (2566 in chips) 
Seat 2: Duke Croix (16240 in chips) 
Seat 3: MnnM150 (11055 in chips) 
Seat 4: HighCardJasper (8538 in chips) 
Seat 7: appositive (11246 in chips) 
Seat 9: JeBoyDirk (16207 in chips) 
Duke Croix: posts small blind 50
MnnM150: posts big blind 100
*** HOLE CARDS ***
Dealt to Duke Croix [Kd Jh]
HighCardJasper: folds 
appositive: folds 
JeBoyDirk: calls 100
dddocky: folds 
Duke Croix: calls 50
MnnM150: checks 
*** FLOP *** [7c 3h 8c]
Duke Croix: bets 200
MnnM150: folds 
JeBoyDirk: calls 200
*** TURN *** [7c 3h 8c] [7s]
Duke Croix: checks 
JeBoyDirk: checks 
*** RIVER *** [7c 3h 8c 7s] [Js]
Duke Croix: bets 400
JeBoyDirk: raises 600 to 1000
Duke Croix: calls 600
*** SHOW DOWN ***
JeBoyDirk: shows [Jd Qc] (two pair, Jacks and Sevens)
Duke Croix: shows [Kd Jh] (two pair, Jacks and Sevens - King kicker)
Duke Croix collected 2551 from pot
*** SUMMARY ***
Total pot 2700 | Rake 149 
Board [7c 3h 8c 7s Js]
Seat 1: dddocky (button) folded before Flop (didn't bet)
Seat 2: Duke Croix (small blind) showed [Kd Jh] and won (2551) with two pair, Jacks and Sevens
Seat 3: MnnM150 (big blind) folded on the Flop
Seat 4: HighCardJasper folded before Flop (didn't bet)
Seat 7: appositive folded before Flop (didn't bet)
Seat 9: JeBoyDirk showed [Jd Qc] and lost with two pair, Jacks and Sevens



PokerStars Home Game Hand #220084827283: {Club #3225207}  Hold'em No Limit (50/100) - 2020/11/05 16:09:11 ET
Table 'funzzzzzzzz' 9-max (Play Money) Seat #2 is the button
Seat 1: dddocky (2566 in chips) 
Seat 2: Duke Croix (17491 in chips) 
Seat 3: MnnM150 (10955 in chips) 
Seat 4: HighCardJasper (8538 in chips) 
Seat 7: appositive (11246 in chips) 
Seat 8: Klemtonius (2575 in chips) 
Seat 9: JeBoyDirk (14907 in chips) 
MnnM150: posts small blind 50
HighCardJasper: posts big blind 100
Klemtonius: posts small & big blinds 150
*** HOLE CARDS ***
Dealt to Duke Croix [Ts Qs]
appositive: calls 100
Klemtonius: checks 
JeBoyDirk: folds 
dddocky: calls 100
Duke Croix: raises 300 to 400
MnnM150: calls 350
HighCardJasper: folds 
appositive: calls 300
Klemtonius: calls 300
dddocky: calls 300
*** FLOP *** [Kd 7d Tc]
MnnM150: bets 500
appositive: folds 
Klemtonius: folds 
dddocky: raises 1000 to 1500
Duke Croix: folds 
MnnM150: calls 1000
*** TURN *** [Kd 7d Tc] [8d]
MnnM150: checks 
dddocky: bets 666 and is all-in
MnnM150: calls 666
*** RIVER *** [Kd 7d Tc 8d] [Td]
*** SHOW DOWN ***
MnnM150: shows [Jd Js] (a flush, King high)
dddocky: shows [Ks Ac] (two pair, Kings and Tens)
MnnM150 collected 6125 from pot
*** SUMMARY ***
Total pot 6482 | Rake 357 
Board [Kd 7d Tc 8d Td]
Seat 1: dddocky showed [Ks Ac] and lost with two pair, Kings and Tens
Seat 2: Duke Croix (button) folded on the Flop
Seat 3: MnnM150 (small blind) showed [Jd Js] and won (6125) with a flush, King high
Seat 4: HighCardJasper (big blind) folded before Flop
Seat 7: appositive folded on the Flop
Seat 8: Klemtonius folded on the Flop
Seat 9: JeBoyDirk folded before Flop (didn't bet)



PokerStars Home Game Hand #220084875750: {Club #3225207}  Hold'em No Limit (50/100) - 2020/11/05 16:10:28 ET
Table 'funzzzzzzzz' 9-max (Play Money) Seat #3 is the button
Seat 2: Duke Croix (17091 in chips) 
Seat 3: MnnM150 (14514 in chips) 
Seat 4: HighCardJasper (8438 in chips) 
Seat 8: Klemtonius (2125 in chips) 
Seat 9: JeBoyDirk (14907 in chips) 
HighCardJasper: posts small blind 50
Klemtonius: posts big blind 100
*** HOLE CARDS ***
Dealt to Duke Croix [9s 2d]
JeBoyDirk: folds 
Duke Croix: folds 
MnnM150: calls 100
HighCardJasper: calls 50
Klemtonius: checks 
*** FLOP *** [8c As Jh]
HighCardJasper: checks 
Klemtonius: bets 283
MnnM150: calls 283
HighCardJasper: calls 283
*** TURN *** [8c As Jh] [8s]
HighCardJasper: checks 
Klemtonius: checks 
MnnM150: checks 
*** RIVER *** [8c As Jh 8s] [9c]
HighCardJasper: checks 
Klemtonius: checks 
MnnM150: checks 
*** SHOW DOWN ***
HighCardJasper: shows [5s Jc] (two pair, Jacks and Eights)
Klemtonius: mucks hand 
MnnM150: mucks hand 
HighCardJasper collected 1086 from pot
*** SUMMARY ***
Total pot 1149 | Rake 63 
Board [8c As Jh 8s 9c]
Seat 2: Duke Croix folded before Flop (didn't bet)
Seat 3: MnnM150 (button) mucked [Kc 5c]
Seat 4: HighCardJasper (small blind) showed [5s Jc] and won (1086) with two pair, Jacks and Eights
Seat 8: Klemtonius (big blind) mucked [Kd Ts]
Seat 9: JeBoyDirk folded before Flop (didn't bet)



PokerStars Home Game Hand #220084907673: {Club #3225207}  Hold'em No Limit (50/100) - 2020/11/05 16:11:14 ET
Table 'funzzzzzzzz' 9-max (Play Money) Seat #4 is the button
Seat 1: dddocky (10000 in chips) 
Seat 2: Duke Croix (17091 in chips) 
Seat 3: MnnM150 (14131 in chips) 
Seat 4: HighCardJasper (9141 in chips) 
Seat 8: Klemtonius (1742 in chips) 
Seat 9: JeBoyDirk (14907 in chips) 
Klemtonius: posts small blind 50
JeBoyDirk: posts big blind 100
*** HOLE CARDS ***
Dealt to Duke Croix [2h 8s]
dddocky: folds 
Duke Croix: raises 200 to 300
MnnM150: calls 300
HighCardJasper: folds 
Klemtonius: folds 
JeBoyDirk: folds 
*** FLOP *** [9d Kc 7c]
Duke Croix: checks 
MnnM150: bets 354
Duke Croix: folds 
Uncalled bet (354) returned to MnnM150
MnnM150 collected 709 from pot
*** SUMMARY ***
Total pot 750 | Rake 41 
Board [9d Kc 7c]
Seat 1: dddocky folded before Flop (didn't bet)
Seat 2: Duke Croix folded on the Flop
Seat 3: MnnM150 collected (709)
Seat 4: HighCardJasper (button) folded before Flop (didn't bet)
Seat 8: Klemtonius (small blind) folded before Flop
Seat 9: JeBoyDirk (big blind) folded before Flop



PokerStars Home Game Hand #220084926839: {Club #3225207}  Hold'em No Limit (50/100) - 2020/11/05 16:11:44 ET
Table 'funzzzzzzzz' 9-max (Play Money) Seat #8 is the button
Seat 1: dddocky (10000 in chips) 
Seat 2: Duke Croix (16791 in chips) 
Seat 3: MnnM150 (14540 in chips) 
Seat 4: HighCardJasper (9141 in chips) 
Seat 8: Klemtonius (1692 in chips) 
Seat 9: JeBoyDirk (14807 in chips) 
JeBoyDirk: posts small blind 50
dddocky: posts big blind 100
*** HOLE CARDS ***
Dealt to Duke Croix [4d 2d]
Duke Croix: calls 100
MnnM150: calls 100
HighCardJasper: calls 100
Klemtonius: folds 
JeBoyDirk: calls 50
dddocky: checks 
*** FLOP *** [Th 8s Ah]
JeBoyDirk: checks 
dddocky: checks 
Duke Croix: checks 
MnnM150: bets 100
HighCardJasper: folds 
JeBoyDirk: calls 100
dddocky: calls 100
Duke Croix: folds 
*** TURN *** [Th 8s Ah] [As]
JeBoyDirk: checks 
dddocky: checks 
MnnM150: bets 756
JeBoyDirk: calls 756
dddocky: folds 
*** RIVER *** [Th 8s Ah As] [8d]
JeBoyDirk: checks 
MnnM150: bets 2185
JeBoyDirk: folds 
Uncalled bet (2185) returned to MnnM150
MnnM150 collected 2185 from pot
*** SUMMARY ***
Total pot 2312 | Rake 127 
Board [Th 8s Ah As 8d]
Seat 1: dddocky (big blind) folded on the Turn
Seat 2: Duke Croix folded on the Flop
Seat 3: MnnM150 collected (2185)
Seat 4: HighCardJasper folded on the Flop
Seat 8: Klemtonius (button) folded before Flop (didn't bet)
Seat 9: JeBoyDirk (small blind) folded on the River



PokerStars Home Game Hand #220084966567: {Club #3225207}  Hold'em No Limit (50/100) - 2020/11/05 16:12:48 ET
Table 'funzzzzzzzz' 9-max (Play Money) Seat #9 is the button
Seat 1: dddocky (9800 in chips) 
Seat 2: Duke Croix (16691 in chips) 
Seat 3: MnnM150 (15769 in chips) 
Seat 4: HighCardJasper (9041 in chips) 
Seat 7: appositive (10846 in chips) 
Seat 8: Klemtonius (1692 in chips) 
Seat 9: JeBoyDirk (13851 in chips) 
dddocky: posts small blind 50
Duke Croix: posts big blind 100
appositive: posts small & big blinds 150
*** HOLE CARDS ***
Dealt to Duke Croix [Jh 2d]
MnnM150: folds 
HighCardJasper: calls 100
appositive: checks 
Klemtonius: calls 100
JeBoyDirk: folds 
dddocky: calls 50
Duke Croix: checks 
*** FLOP *** [3s Tc Js]
dddocky: checks 
Duke Croix: bets 400
HighCardJasper: folds 
appositive: folds 
Klemtonius: folds 
dddocky: folds 
Uncalled bet (400) returned to Duke Croix
Duke Croix collected 520 from pot
*** SUMMARY ***
Total pot 550 | Rake 30 
Board [3s Tc Js]
Seat 1: dddocky (small blind) folded on the Flop
Seat 2: Duke Croix (big blind) collected (520)
Seat 3: MnnM150 folded before Flop (didn't bet)
Seat 4: HighCardJasper folded on the Flop
Seat 7: appositive folded on the Flop (didn't bet)
Seat 8: Klemtonius folded on the Flop
Seat 9: JeBoyDirk (button) folded before Flop (didn't bet)



PokerStars Home Game Hand #220084992058: {Club #3225207}  Hold'em No Limit (50/100) - 2020/11/05 16:13:28 ET
Table 'funzzzzzzzz' 9-max (Play Money) Seat #1 is the button
Seat 1: dddocky (9700 in chips) 
Seat 2: Duke Croix (17111 in chips) 
Seat 3: MnnM150 (15769 in chips) 
Seat 4: HighCardJasper (8941 in chips) 
Seat 7: appositive (10696 in chips) 
Seat 8: Klemtonius (1592 in chips) 
Seat 9: JeBoyDirk (13851 in chips) 
Duke Croix: posts small blind 50
MnnM150: posts big blind 100
*** HOLE CARDS ***
Dealt to Duke Croix [9h 9s]
HighCardJasper: raises 100 to 200
appositive: calls 200
Klemtonius: raises 300 to 500
JeBoyDirk: calls 500
dddocky: folds 
Duke Croix: calls 450
MnnM150: folds 
HighCardJasper: raises 8441 to 8941 and is all-in
appositive: folds 
Klemtonius: calls 1092 and is all-in
JeBoyDirk: folds 
Duke Croix: folds 
Uncalled bet (7349) returned to HighCardJasper
*** FLOP *** [Qd 7d 3s]
*** TURN *** [Qd 7d 3s] [7h]
*** RIVER *** [Qd 7d 3s 7h] [Qh]
*** SHOW DOWN ***
HighCardJasper: shows [Qc Qs] (four of a kind, Queens)
Klemtonius: shows [Td Ts] (two pair, Queens and Tens)
HighCardJasper collected 4237 from pot
*** SUMMARY ***
Total pot 4484 | Rake 247 
Board [Qd 7d 3s 7h Qh]
Seat 1: dddocky (button) folded before Flop (didn't bet)
Seat 2: Duke Croix (small blind) folded before Flop
Seat 3: MnnM150 (big blind) folded before Flop
Seat 4: HighCardJasper showed [Qc Qs] and won (4237) with four of a kind, Queens
Seat 7: appositive folded before Flop
Seat 8: Klemtonius showed [Td Ts] and lost with two pair, Queens and Tens
Seat 9: JeBoyDirk folded before Flop



PokerStars Home Game Hand #220085030193: {Club #3225207}  Hold'em No Limit (50/100) - 2020/11/05 16:14:30 ET
Table 'funzzzzzzzz' 9-max (Play Money) Seat #2 is the button
Seat 1: dddocky (9700 in chips) 
Seat 2: Duke Croix (16611 in chips) 
Seat 3: MnnM150 (15669 in chips) 
Seat 4: HighCardJasper (11586 in chips) 
Seat 7: appositive (10496 in chips) 
Seat 9: JeBoyDirk (13351 in chips) 
MnnM150: posts small blind 50
HighCardJasper: posts big blind 100
*** HOLE CARDS ***
Dealt to Duke Croix [Qs Ad]
appositive: folds 
JeBoyDirk: calls 100
dddocky: calls 100
Duke Croix: raises 400 to 500
MnnM150: folds 
HighCardJasper: folds 
JeBoyDirk: calls 400
dddocky: calls 400
*** FLOP *** [5h 3d 9c]
JeBoyDirk: checks 
dddocky: bets 779
Duke Croix: calls 779
JeBoyDirk: folds 
*** TURN *** [5h 3d 9c] [5s]
dddocky: bets 100
Duke Croix: calls 100
*** RIVER *** [5h 3d 9c 5s] [6h]
dddocky: checks 
Duke Croix: checks 
*** SHOW DOWN ***
dddocky: shows [9s As] (two pair, Nines and Fives)
Duke Croix: mucks hand 
dddocky collected 3221 from pot
*** SUMMARY ***
Total pot 3408 | Rake 187 
Board [5h 3d 9c 5s 6h]
Seat 1: dddocky showed [9s As] and won (3221) with two pair, Nines and Fives
Seat 2: Duke Croix (button) mucked [Qs Ad]
Seat 3: MnnM150 (small blind) folded before Flop
Seat 4: HighCardJasper (big blind) folded before Flop
Seat 7: appositive folded before Flop (didn't bet)
Seat 9: JeBoyDirk folded on the Flop



PokerStars Home Game Hand #220085069032: {Club #3225207}  Hold'em No Limit (50/100) - 2020/11/05 16:15:31 ET
Table 'funzzzzzzzz' 9-max (Play Money) Seat #3 is the button
Seat 1: dddocky (11542 in chips) 
Seat 2: Duke Croix (15232 in chips) 
Seat 3: MnnM150 (15619 in chips) 
Seat 4: HighCardJasper (11486 in chips) 
Seat 7: appositive (10496 in chips) 
Seat 9: JeBoyDirk (12851 in chips) 
HighCardJasper: posts small blind 50
appositive: posts big blind 100
*** HOLE CARDS ***
Dealt to Duke Croix [Qc Qs]
JeBoyDirk: folds 
dddocky: folds 
Duke Croix: raises 300 to 400
Klemtonius leaves the table
MnnM150: folds 
HighCardJasper: calls 350
appositive: folds 
*** FLOP *** [7d Jd 2c]
HighCardJasper: checks 
Duke Croix: bets 500
HighCardJasper: calls 500
*** TURN *** [7d Jd 2c] [4d]
HighCardJasper: checks 
Duke Croix: bets 1000
HighCardJasper: raises 1000 to 2000
Duke Croix: calls 1000
*** RIVER *** [7d Jd 2c 4d] [9d]
HighCardJasper: checks 
Duke Croix: checks 
*** SHOW DOWN ***
HighCardJasper: shows [7c Jc] (two pair, Jacks and Sevens)
Duke Croix: mucks hand 
HighCardJasper collected 5575 from pot
*** SUMMARY ***
Total pot 5900 | Rake 325 
Board [7d Jd 2c 4d 9d]
Seat 1: dddocky folded before Flop (didn't bet)
Seat 2: Duke Croix mucked [Qc Qs]
Seat 3: MnnM150 (button) folded before Flop (didn't bet)
Seat 4: HighCardJasper (small blind) showed [7c Jc] and won (5575) with two pair, Jacks and Sevens
Seat 7: appositive (big blind) folded before Flop
Seat 9: JeBoyDirk folded before Flop (didn't bet)



PokerStars Home Game Hand #220085103859: {Club #3225207}  Hold'em No Limit (50/100) - 2020/11/05 16:16:25 ET
Table 'funzzzzzzzz' 9-max (Play Money) Seat #4 is the button
Seat 1: dddocky (11542 in chips) 
Seat 2: Duke Croix (12332 in chips) 
Seat 3: MnnM150 (15619 in chips) 
Seat 4: HighCardJasper (14161 in chips) 
Seat 7: appositive (10396 in chips) 
Seat 9: JeBoyDirk (12851 in chips) 
appositive: posts small blind 50
JeBoyDirk: posts big blind 100
*** HOLE CARDS ***
Dealt to Duke Croix [Ac Kd]
dddocky: calls 100
Duke Croix: raises 300 to 400
MnnM150: folds 
HighCardJasper: folds 
appositive: calls 350
JeBoyDirk: folds 
dddocky: calls 300
*** FLOP *** [Jc 5s Qs]
MrOB1reader joins the table at seat #5 
appositive: bets 614
dddocky: calls 614
Duke Croix: calls 614
*** TURN *** [Jc 5s Qs] [Kh]
appositive: bets 2969
dddocky: calls 2969
Duke Croix: calls 2969
*** RIVER *** [Jc 5s Qs Kh] [9c]
appositive: bets 6413 and is all-in
dddocky: calls 6413
Duke Croix: folds 
*** SHOW DOWN ***
appositive: shows [Td Tc] (a straight, Nine to King)
dddocky: shows [Ks Qh] (two pair, Kings and Queens)
appositive collected 23507 from pot
*** SUMMARY ***
Total pot 24875 | Rake 1368 
Board [Jc 5s Qs Kh 9c]
Seat 1: dddocky showed [Ks Qh] and lost with two pair, Kings and Queens
Seat 2: Duke Croix folded on the River
Seat 3: MnnM150 folded before Flop (didn't bet)
Seat 4: HighCardJasper (button) folded before Flop (didn't bet)
Seat 7: appositive (small blind) showed [Td Tc] and won (23507) with a straight, Nine to King
Seat 9: JeBoyDirk (big blind) folded before Flop



PokerStars Home Game Hand #220085148557: {Club #3225207}  Hold'em No Limit (50/100) - 2020/11/05 16:17:35 ET
Table 'funzzzzzzzz' 9-max (Play Money) Seat #7 is the button
Seat 1: dddocky (1146 in chips) 
Seat 2: Duke Croix (8349 in chips) 
Seat 3: MnnM150 (15619 in chips) 
Seat 4: HighCardJasper (14161 in chips) 
Seat 5: MrOB1reader (10000 in chips) 
Seat 7: appositive (23507 in chips) 
Seat 9: JeBoyDirk (12751 in chips) 
JeBoyDirk: posts small blind 50
dddocky: posts big blind 100
MrOB1reader: posts big blind 100
*** HOLE CARDS ***
Dealt to Duke Croix [Kd Jd]
Duke Croix: raises 300 to 400
MnnM150: folds 
HighCardJasper: calls 400
MrOB1reader: calls 300
appositive: folds 
JeBoyDirk: folds 
dddocky: folds 
*** FLOP *** [Ad Ts 8s]
Duke Croix: bets 600
HighCardJasper: calls 600
MrOB1reader: raises 900 to 1500
Duke Croix: folds 
HighCardJasper: calls 900
*** TURN *** [Ad Ts 8s] [3c]
HighCardJasper: checks 
MrOB1reader: checks 
*** RIVER *** [Ad Ts 8s 3c] [2d]
HighCardJasper: checks 
MrOB1reader: bets 3000
HighCardJasper: calls 3000
*** SHOW DOWN ***
MrOB1reader: shows [7d 9d] (high card Ace)
HighCardJasper: shows [Ac 6c] (a pair of Aces)
HighCardJasper collected 10348 from pot
*** SUMMARY ***
Total pot 10950 | Rake 602 
Board [Ad Ts 8s 3c 2d]
Seat 1: dddocky (big blind) folded before Flop
Seat 2: Duke Croix folded on the Flop
Seat 3: MnnM150 folded before Flop (didn't bet)
Seat 4: HighCardJasper showed [Ac 6c] and won (10348) with a pair of Aces
Seat 5: MrOB1reader showed [7d 9d] and lost with high card Ace
Seat 7: appositive (button) folded before Flop (didn't bet)
Seat 9: JeBoyDirk (small blind) folded before Flop



PokerStars Home Game Hand #220085192247: {Club #3225207}  Hold'em No Limit (50/100) - 2020/11/05 16:18:43 ET
Table 'funzzzzzzzz' 9-max (Play Money) Seat #9 is the button
Seat 1: dddocky (1046 in chips) 
Seat 2: Duke Croix (7349 in chips) 
Seat 3: MnnM150 (15619 in chips) 
Seat 4: HighCardJasper (19609 in chips) 
Seat 5: MrOB1reader (5100 in chips) 
Seat 7: appositive (23507 in chips) 
Seat 9: JeBoyDirk (12701 in chips) 
dddocky: posts small blind 50
Duke Croix: posts big blind 100
*** HOLE CARDS ***
Dealt to Duke Croix [4h 4c]
MnnM150: calls 100
HighCardJasper: calls 100
MrOB1reader: calls 100
appositive: calls 100
JeBoyDirk: folds 
dddocky: folds 
Duke Croix: checks 
*** FLOP *** [Ac 2h Tc]
Duke Croix: checks 
MnnM150: checks 
HighCardJasper: checks 
MrOB1reader: checks 
appositive: bets 520
Duke Croix: folds 
MnnM150: folds 
HighCardJasper: calls 520
MrOB1reader: folds 
*** TURN *** [Ac 2h Tc] [Ah]
HighCardJasper: checks 
appositive: bets 1503
HighCardJasper: folds 
Uncalled bet (1503) returned to appositive
appositive collected 1503 from pot
appositive: doesn't show hand 
*** SUMMARY ***
Total pot 1590 | Rake 87 
Board [Ac 2h Tc Ah]
Seat 1: dddocky (small blind) folded before Flop
Seat 2: Duke Croix (big blind) folded on the Flop
Seat 3: MnnM150 folded on the Flop
Seat 4: HighCardJasper folded on the Turn
Seat 5: MrOB1reader folded on the Flop
Seat 7: appositive collected (1503)
Seat 9: JeBoyDirk (button) folded before Flop (didn't bet)



PokerStars Home Game Hand #220085221763: {Club #3225207}  Hold'em No Limit (50/100) - 2020/11/05 16:19:29 ET
Table 'funzzzzzzzz' 9-max (Play Money) Seat #1 is the button
Seat 1: dddocky (996 in chips) 
Seat 2: Duke Croix (7249 in chips) 
Seat 3: MnnM150 (15519 in chips) 
Seat 4: HighCardJasper (18989 in chips) 
Seat 5: MrOB1reader (5000 in chips) 
Seat 7: appositive (24390 in chips) 
Seat 9: JeBoyDirk (12701 in chips) 
Duke Croix: posts small blind 50
MnnM150: posts big blind 100
*** HOLE CARDS ***
Dealt to Duke Croix [6d 4h]
HighCardJasper: calls 100
MrOB1reader: folds 
appositive: calls 100
JeBoyDirk: folds 
dddocky: folds 
Duke Croix: calls 50
MnnM150: checks 
*** FLOP *** [4d 3d Qs]
Duke Croix: bets 200
MnnM150: calls 200
HighCardJasper: folds 
appositive: folds 
*** TURN *** [4d 3d Qs] [Tc]
Duke Croix: bets 400
MnnM150: calls 400
*** RIVER *** [4d 3d Qs Tc] [Td]
Duke Croix: checks 
MnnM150: bets 756
Duke Croix: folds 
Uncalled bet (756) returned to MnnM150
MnnM150 collected 1512 from pot
*** SUMMARY ***
Total pot 1600 | Rake 88 
Board [4d 3d Qs Tc Td]
Seat 1: dddocky (button) folded before Flop (didn't bet)
Seat 2: Duke Croix (small blind) folded on the River
Seat 3: MnnM150 (big blind) collected (1512)
Seat 4: HighCardJasper folded on the Flop
Seat 5: MrOB1reader folded before Flop (didn't bet)
Seat 7: appositive folded on the Flop
Seat 9: JeBoyDirk folded before Flop (didn't bet)



PokerStars Home Game Hand #220085265203: {Club #3225207}  Hold'em No Limit (50/100) - 2020/11/05 16:20:37 ET
Table 'funzzzzzzzz' 9-max (Play Money) Seat #2 is the button
Seat 1: dddocky (996 in chips) 
Seat 2: Duke Croix (6549 in chips) 
Seat 3: MnnM150 (16331 in chips) 
Seat 4: HighCardJasper (18889 in chips) 
Seat 5: MrOB1reader (5000 in chips) 
Seat 7: appositive (24290 in chips) 
Seat 9: JeBoyDirk (12701 in chips) 
MnnM150: posts small blind 50
HighCardJasper: posts big blind 100
*** HOLE CARDS ***
Dealt to Duke Croix [6d Kc]
MrOB1reader: calls 100
appositive: calls 100
JeBoyDirk: folds 
dddocky: folds 
Duke Croix: folds 
MnnM150: calls 50
HighCardJasper: checks 
*** FLOP *** [Qc 7h 9d]
MnnM150: checks 
HighCardJasper: checks 
MrOB1reader: checks 
appositive: bets 378
MnnM150: calls 378
HighCardJasper: folds 
MrOB1reader: folds 
*** TURN *** [Qc 7h 9d] [Ks]
MnnM150: checks 
appositive: bets 1092
MnnM150: folds 
Uncalled bet (1092) returned to appositive
appositive collected 1092 from pot
appositive: doesn't show hand 
*** SUMMARY ***
Total pot 1156 | Rake 64 
Board [Qc 7h 9d Ks]
Seat 1: dddocky folded before Flop (didn't bet)
Seat 2: Duke Croix (button) folded before Flop (didn't bet)
Seat 3: MnnM150 (small blind) folded on the Turn
Seat 4: HighCardJasper (big blind) folded on the Flop
Seat 5: MrOB1reader folded on the Flop
Seat 7: appositive collected (1092)
Seat 9: JeBoyDirk folded before Flop (didn't bet)



PokerStars Home Game Hand #220085296074: {Club #3225207}  Hold'em No Limit (50/100) - 2020/11/05 16:21:25 ET
Table 'funzzzzzzzz' 9-max (Play Money) Seat #3 is the button
Seat 1: dddocky (996 in chips) 
Seat 2: Duke Croix (6549 in chips) 
Seat 3: MnnM150 (15853 in chips) 
Seat 4: HighCardJasper (18789 in chips) 
Seat 5: MrOB1reader (4900 in chips) 
Seat 7: appositive (24904 in chips) 
Seat 9: JeBoyDirk (12701 in chips) 
HighCardJasper: posts small blind 50
MrOB1reader: posts big blind 100
*** HOLE CARDS ***
Dealt to Duke Croix [4d 9h]
appositive: folds 
JeBoyDirk: folds 
dddocky: calls 100
Duke Croix: folds 
MnnM150: folds 
HighCardJasper: calls 50
MrOB1reader: checks 
*** FLOP *** [4h 2s 6c]
HighCardJasper: checks 
MrOB1reader: checks 
dddocky: checks 
*** TURN *** [4h 2s 6c] [Jc]
HighCardJasper: checks 
MrOB1reader: checks 
dddocky: checks 
*** RIVER *** [4h 2s 6c Jc] [7s]
HighCardJasper: checks 
MrOB1reader: checks 
dddocky: checks 
*** SHOW DOWN ***
HighCardJasper: shows [3c 3d] (a pair of Threes)
MrOB1reader: mucks hand 
dddocky: mucks hand 
HighCardJasper collected 283 from pot
*** SUMMARY ***
Total pot 300 | Rake 17 
Board [4h 2s 6c Jc 7s]
Seat 1: dddocky mucked [Kd 8s]
Seat 2: Duke Croix folded before Flop (didn't bet)
Seat 3: MnnM150 (button) folded before Flop (didn't bet)
Seat 4: HighCardJasper (small blind) showed [3c 3d] and won (283) with a pair of Threes
Seat 5: MrOB1reader (big blind) mucked [2d 5h]
Seat 7: appositive folded before Flop (didn't bet)
Seat 9: JeBoyDirk folded before Flop (didn't bet)



PokerStars Home Game Hand #220085335731: {Club #3225207}  Hold'em No Limit (50/100) - 2020/11/05 16:22:27 ET
Table 'funzzzzzzzz' 9-max (Play Money) Seat #4 is the button
Seat 1: dddocky (896 in chips) 
Seat 2: Duke Croix (6549 in chips) 
Seat 3: MnnM150 (15853 in chips) 
Seat 4: HighCardJasper (18972 in chips) 
Seat 5: MrOB1reader (4800 in chips) 
Seat 7: appositive (24904 in chips) 
Seat 9: JeBoyDirk (12701 in chips) 
MrOB1reader: posts small blind 50
appositive: posts big blind 100
*** HOLE CARDS ***
Dealt to Duke Croix [Td 5d]
JeBoyDirk: folds 
dddocky: calls 100
Duke Croix: folds 
MnnM150: folds 
HighCardJasper: calls 100
MrOB1reader: raises 100 to 200
appositive: calls 100
dddocky: raises 696 to 896 and is all-in
HighCardJasper: folds 
MrOB1reader is disconnected 
MrOB1reader has timed out while being disconnected
MrOB1reader: folds 
appositive: calls 696
*** FLOP *** [8c 5h Ad]
*** TURN *** [8c 5h Ad] [5c]
*** RIVER *** [8c 5h Ad 5c] [Kc]
*** SHOW DOWN ***
appositive: shows [9s 7s] (a pair of Fives)
dddocky: shows [As 4d] (two pair, Aces and Fives)
dddocky collected 1977 from pot
*** SUMMARY ***
Total pot 2092 | Rake 115 
Board [8c 5h Ad 5c Kc]
Seat 1: dddocky showed [As 4d] and won (1977) with two pair, Aces and Fives
Seat 2: Duke Croix folded before Flop (didn't bet)
Seat 3: MnnM150 folded before Flop (didn't bet)
Seat 4: HighCardJasper (button) folded before Flop
Seat 5: MrOB1reader (small blind) folded before Flop
Seat 7: appositive (big blind) showed [9s 7s] and lost with a pair of Fives
Seat 9: JeBoyDirk folded before Flop (didn't bet)



PokerStars Home Game Hand #220085381340: {Club #3225207}  Hold'em No Limit (50/100) - 2020/11/05 16:23:33 ET
Table 'funzzzzzzzz' 9-max (Play Money) Seat #7 is the button
Seat 1: dddocky (1977 in chips) 
Seat 2: Duke Croix (6549 in chips) 
Seat 3: MnnM150 (15853 in chips) 
Seat 4: HighCardJasper (18872 in chips) 
Seat 7: appositive (24008 in chips) 
Seat 9: JeBoyDirk (12701 in chips) 
JeBoyDirk: posts small blind 50
dddocky: posts big blind 100
*** HOLE CARDS ***
Dealt to Duke Croix [Ac Qs]
Duke Croix: raises 300 to 400
MnnM150: folds 
HighCardJasper: folds 
appositive: calls 400
JeBoyDirk: calls 350
dddocky: folds 
*** FLOP *** [9c 8d 4c]
JeBoyDirk: checks 
Duke Croix: bets 600
appositive: folds 
JeBoyDirk: folds 
Uncalled bet (600) returned to Duke Croix
Duke Croix collected 1228 from pot
*** SUMMARY ***
Total pot 1300 | Rake 72 
Board [9c 8d 4c]
Seat 1: dddocky (big blind) folded before Flop
Seat 2: Duke Croix collected (1228)
Seat 3: MnnM150 folded before Flop (didn't bet)
Seat 4: HighCardJasper folded before Flop (didn't bet)
Seat 7: appositive (button) folded on the Flop
Seat 9: JeBoyDirk (small blind) folded on the Flop



PokerStars Home Game Hand #220085402998: {Club #3225207}  Hold'em No Limit (50/100) - 2020/11/05 16:24:07 ET
Table 'funzzzzzzzz' 9-max (Play Money) Seat #9 is the button
Seat 1: dddocky (1877 in chips) 
Seat 2: Duke Croix (7377 in chips) 
Seat 3: MnnM150 (15853 in chips) 
Seat 4: HighCardJasper (18872 in chips) 
Seat 7: appositive (23608 in chips) 
Seat 9: JeBoyDirk (12301 in chips) 
dddocky: posts small blind 50
Duke Croix: posts big blind 100
*** HOLE CARDS ***
Dealt to Duke Croix [3h 6s]
MnnM150: folds 
HighCardJasper: calls 100
appositive: calls 100
JeBoyDirk: raises 300 to 400
dddocky: folds 
Duke Croix: folds 
HighCardJasper: calls 300
appositive: folds 
*** FLOP *** [2s 4d Td]
HighCardJasper: bets 500
JeBoyDirk: raises 600 to 1100
MrOB1reader is disconnected 
HighCardJasper: calls 600
*** TURN *** [2s 4d Td] [Js]
HighCardJasper: checks 
JeBoyDirk: bets 1700
HighCardJasper: folds 
Uncalled bet (1700) returned to JeBoyDirk
JeBoyDirk collected 3071 from pot
*** SUMMARY ***
Total pot 3250 | Rake 179 
Board [2s 4d Td Js]
Seat 1: dddocky (small blind) folded before Flop
Seat 2: Duke Croix (big blind) folded before Flop
Seat 3: MnnM150 folded before Flop (didn't bet)
Seat 4: HighCardJasper folded on the Turn
Seat 7: appositive folded before Flop
Seat 9: JeBoyDirk (button) collected (3071)



PokerStars Home Game Hand #220085438238: {Club #3225207}  Hold'em No Limit (50/100) - 2020/11/05 16:25:01 ET
Table 'funzzzzzzzz' 9-max (Play Money) Seat #1 is the button
Seat 1: dddocky (1827 in chips) 
Seat 2: Duke Croix (7277 in chips) 
Seat 3: MnnM150 (15853 in chips) 
Seat 4: HighCardJasper (17372 in chips) 
Seat 7: appositive (23508 in chips) 
Seat 9: JeBoyDirk (13872 in chips) 
Duke Croix: posts small blind 50
MnnM150: posts big blind 100
*** HOLE CARDS ***
Dealt to Duke Croix [8s 3h]
HighCardJasper: calls 100
appositive: folds 
JeBoyDirk: folds 
dddocky: folds 
Duke Croix: folds 
MnnM150: checks 
*** FLOP *** [6s 4d 4s]
MaFak2019 joins the table at seat #8 
MnnM150: checks 
HighCardJasper: checks 
*** TURN *** [6s 4d 4s] [Jd]
MnnM150: checks 
HighCardJasper: bets 200
MnnM150: calls 200
*** RIVER *** [6s 4d 4s Jd] [Jc]
MnnM150: bets 307
HighCardJasper: raises 307 to 614
MnnM150: raises 307 to 921
HighCardJasper: raises 307 to 1228
MnnM150: raises 307 to 1535
HighCardJasper: calls 307
*** SHOW DOWN ***
MnnM150: shows [Js 7s] (a full house, Jacks full of Fours)
HighCardJasper: mucks hand 
MnnM150 collected 3515 from pot
*** SUMMARY ***
Total pot 3720 | Rake 205 
Board [6s 4d 4s Jd Jc]
Seat 1: dddocky (button) folded before Flop (didn't bet)
Seat 2: Duke Croix (small blind) folded before Flop
Seat 3: MnnM150 (big blind) showed [Js 7s] and won (3515) with a full house, Jacks full of Fours
Seat 4: HighCardJasper mucked [5c 4c]
Seat 7: appositive folded before Flop (didn't bet)
Seat 9: JeBoyDirk folded before Flop (didn't bet)



PokerStars Home Game Hand #220085474487: {Club #3225207}  Hold'em No Limit (50/100) - 2020/11/05 16:25:58 ET
Table 'funzzzzzzzz' 9-max (Play Money) Seat #2 is the button
Seat 1: dddocky (1827 in chips) 
Seat 2: Duke Croix (7227 in chips) 
Seat 3: MnnM150 (17533 in chips) 
Seat 4: HighCardJasper (15537 in chips) 
Seat 5: MrOB1reader (4600 in chips) 
Seat 7: appositive (23508 in chips) 
Seat 8: MaFak2019 (10000 in chips) 
Seat 9: JeBoyDirk (13872 in chips) 
MnnM150: posts small blind 50
HighCardJasper: posts big blind 100
MaFak2019: posts big blind 100
*** HOLE CARDS ***
Dealt to Duke Croix [Td 4c]
MrOB1reader: calls 100
appositive: folds 
MaFak2019: checks 
JeBoyDirk: calls 100
dddocky: folds 
Duke Croix: folds 
MnnM150: calls 50
HighCardJasper: checks 
*** FLOP *** [7s Kc 6d]
MnnM150: bets 236
HighCardJasper: folds 
MrOB1reader: calls 236
MaFak2019 has timed out
MaFak2019: folds 
JeBoyDirk: folds 
*** TURN *** [7s Kc 6d] [Ad]
MnnM150: checks 
MrOB1reader: checks 
*** RIVER *** [7s Kc 6d Ad] [9h]
MnnM150: bets 459
MrOB1reader: raises 459 to 918
MnnM150: calls 459
*** SHOW DOWN ***
MrOB1reader: shows [As 6h] (two pair, Aces and Sixes)
MnnM150: mucks hand 
MrOB1reader collected 2654 from pot
*** SUMMARY ***
Total pot 2808 | Rake 154 
Board [7s Kc 6d Ad 9h]
Seat 1: dddocky folded before Flop (didn't bet)
Seat 2: Duke Croix (button) folded before Flop (didn't bet)
Seat 3: MnnM150 (small blind) mucked [Kh 3c]
Seat 4: HighCardJasper (big blind) folded on the Flop
Seat 5: MrOB1reader showed [As 6h] and won (2654) with two pair, Aces and Sixes
Seat 7: appositive folded before Flop (didn't bet)
Seat 8: MaFak2019 folded on the Flop (didn't bet)
Seat 9: JeBoyDirk folded on the Flop



PokerStars Home Game Hand #220085521101: {Club #3225207}  Hold'em No Limit (50/100) - 2020/11/05 16:27:10 ET
Table 'funzzzzzzzz' 9-max (Play Money) Seat #3 is the button
Seat 1: dddocky (1827 in chips) 
Seat 2: Duke Croix (7227 in chips) 
Seat 3: MnnM150 (16279 in chips) 
Seat 4: HighCardJasper (15437 in chips) 
Seat 5: MrOB1reader (6000 in chips) 
Seat 7: appositive (23508 in chips) 
Seat 8: MaFak2019 (9900 in chips) 
Seat 9: JeBoyDirk (13772 in chips) 
HighCardJasper: posts small blind 50
MrOB1reader: posts big blind 100
*** HOLE CARDS ***
Dealt to Duke Croix [8h 3h]
appositive: folds 
MaFak2019: raises 100 to 200
JeBoyDirk: folds 
dddocky: calls 200
Duke Croix: folds 
MnnM150: calls 200
HighCardJasper: calls 150
MrOB1reader: calls 100
*** FLOP *** [Ac Qs 2d]
HighCardJasper: checks 
MrOB1reader: checks 
MaFak2019: bets 600
dddocky: folds 
MnnM150: calls 600
HighCardJasper: folds 
MrOB1reader: folds 
*** TURN *** [Ac Qs 2d] [2s]
MaFak2019: bets 600
MnnM150: raises 600 to 1200
MaFak2019: calls 600
*** RIVER *** [Ac Qs 2d 2s] [7d]
MaFak2019: checks 
MnnM150: bets 4347
MaFak2019: calls 4347
*** SHOW DOWN ***
MnnM150: shows [2h 2c] (four of a kind, Deuces)
MaFak2019: mucks hand 
MnnM150 collected 12563 from pot
*** SUMMARY ***
Total pot 13294 | Rake 731 
Board [Ac Qs 2d 2s 7d]
Seat 1: dddocky folded on the Flop
Seat 2: Duke Croix folded before Flop (didn't bet)
Seat 3: MnnM150 (button) showed [2h 2c] and won (12563) with four of a kind, Deuces
Seat 4: HighCardJasper (small blind) folded on the Flop
Seat 5: MrOB1reader (big blind) folded on the Flop
Seat 7: appositive folded before Flop (didn't bet)
Seat 8: MaFak2019 mucked [Ad Ks]
Seat 9: JeBoyDirk folded before Flop (didn't bet)



PokerStars Home Game Hand #220085575391: {Club #3225207}  Hold'em No Limit (50/100) - 2020/11/05 16:28:35 ET
Table 'funzzzzzzzz' 9-max (Play Money) Seat #4 is the button
Seat 1: dddocky (1627 in chips) 
Seat 2: Duke Croix (7227 in chips) 
Seat 3: MnnM150 (22495 in chips) 
Seat 4: HighCardJasper (15237 in chips) 
Seat 5: MrOB1reader (5800 in chips) 
Seat 7: appositive (23508 in chips) 
Seat 8: MaFak2019 (3553 in chips) 
Seat 9: JeBoyDirk (13772 in chips) 
MrOB1reader: posts small blind 50
appositive: posts big blind 100
*** HOLE CARDS ***
Dealt to Duke Croix [4h 6d]
MaFak2019: calls 100
JeBoyDirk: folds 
dddocky: folds 
Duke Croix: folds 
MnnM150: calls 100
HighCardJasper: calls 100
MrOB1reader: calls 50
appositive: checks 
*** FLOP *** [Kh Ah 2h]
MrOB1reader: bets 472
appositive: calls 472
MaFak2019: calls 472
MnnM150: folds 
HighCardJasper: folds 
*** TURN *** [Kh Ah 2h] [Th]
MrOB1reader: bets 1811
appositive: folds 
MaFak2019: folds 
Uncalled bet (1811) returned to MrOB1reader
MrOB1reader collected 1811 from pot
MrOB1reader: doesn't show hand 
*** SUMMARY ***
Total pot 1916 | Rake 105 
Board [Kh Ah 2h Th]
Seat 1: dddocky folded before Flop (didn't bet)
Seat 2: Duke Croix folded before Flop (didn't bet)
Seat 3: MnnM150 folded on the Flop
Seat 4: HighCardJasper (button) folded on the Flop
Seat 5: MrOB1reader (small blind) collected (1811)
Seat 7: appositive (big blind) folded on the Turn
Seat 8: MaFak2019 folded on the Turn
Seat 9: JeBoyDirk folded before Flop (didn't bet)



PokerStars Home Game Hand #220085606011: {Club #3225207}  Hold'em No Limit (50/100) - 2020/11/05 16:29:23 ET
Table 'funzzzzzzzz' 9-max (Play Money) Seat #5 is the button
Seat 1: dddocky (1627 in chips) 
Seat 2: Duke Croix (7227 in chips) 
Seat 3: MnnM150 (22395 in chips) 
Seat 4: HighCardJasper (15137 in chips) 
Seat 5: MrOB1reader (7039 in chips) 
Seat 7: appositive (22936 in chips) 
Seat 8: MaFak2019 (2981 in chips) 
Seat 9: JeBoyDirk (13772 in chips) 
appositive: posts small blind 50
MaFak2019: posts big blind 100
*** HOLE CARDS ***
Dealt to Duke Croix [6h Qh]
JeBoyDirk: folds 
dddocky: calls 100
Duke Croix: folds 
MnnM150: calls 100
HighCardJasper: calls 100
MrOB1reader: calls 100
appositive: calls 50
MaFak2019: checks 
*** FLOP *** [2c 3s 2h]
appositive: checks 
MaFak2019: checks 
dddocky: bets 100
MnnM150: folds 
HighCardJasper: calls 100
MrOB1reader: folds 
appositive: folds 
MaFak2019: calls 100
*** TURN *** [2c 3s 2h] [Jc]
MaFak2019: checks 
dddocky: bets 100
HighCardJasper: calls 100
MaFak2019: folds 
*** RIVER *** [2c 3s 2h Jc] [Ks]
dddocky: bets 1039
HighCardJasper: folds 
Uncalled bet (1039) returned to dddocky
dddocky collected 1039 from pot
dddocky: doesn't show hand 
*** SUMMARY ***
Total pot 1100 | Rake 61 
Board [2c 3s 2h Jc Ks]
Seat 1: dddocky collected (1039)
Seat 2: Duke Croix folded before Flop (didn't bet)
Seat 3: MnnM150 folded on the Flop
Seat 4: HighCardJasper folded on the River
Seat 5: MrOB1reader (button) folded on the Flop
Seat 7: appositive (small blind) folded on the Flop
Seat 8: MaFak2019 (big blind) folded on the Turn
Seat 9: JeBoyDirk folded before Flop (didn't bet)



PokerStars Home Game Hand #220085670175: {Club #3225207}  Hold'em No Limit (50/100) - 2020/11/05 16:31:04 ET
Table 'funzzzzzzzz' 9-max (Play Money) Seat #7 is the button
Seat 1: dddocky (2366 in chips) 
Seat 2: Duke Croix (7227 in chips) 
Seat 3: MnnM150 (22295 in chips) 
Seat 4: HighCardJasper (14837 in chips) 
Seat 5: MrOB1reader (6939 in chips) 
Seat 7: appositive (22836 in chips) 
Seat 8: MaFak2019 (2781 in chips) 
Seat 9: JeBoyDirk (13772 in chips) 
MaFak2019: posts small blind 50
JeBoyDirk: posts big blind 100
*** HOLE CARDS ***
Dealt to Duke Croix [9d Td]
dddocky: folds 
Duke Croix: raises 200 to 300
MnnM150: folds 
HighCardJasper: folds 
MrOB1reader: folds 
appositive: folds 
MaFak2019: folds 
JeBoyDirk: folds 
Uncalled bet (200) returned to Duke Croix
Duke Croix collected 250 from pot
*** SUMMARY ***
Total pot 250 | Rake 0 
Seat 1: dddocky folded before Flop (didn't bet)
Seat 2: Duke Croix collected (250)
Seat 3: MnnM150 folded before Flop (didn't bet)
Seat 4: HighCardJasper folded before Flop (didn't bet)
Seat 5: MrOB1reader folded before Flop (didn't bet)
Seat 7: appositive (button) folded before Flop (didn't bet)
Seat 8: MaFak2019 (small blind) folded before Flop
Seat 9: JeBoyDirk (big blind) folded before Flop



PokerStars Home Game Hand #220085689297: {Club #3225207}  Hold'em No Limit (50/100) - 2020/11/05 16:31:34 ET
Table 'funzzzzzzzz' 9-max (Play Money) Seat #8 is the button
Seat 1: dddocky (2366 in chips) 
Seat 2: Duke Croix (7377 in chips) 
Seat 3: MnnM150 (22295 in chips) 
Seat 4: HighCardJasper (14837 in chips) 
Seat 5: MrOB1reader (6939 in chips) 
Seat 7: appositive (22836 in chips) 
Seat 8: MaFak2019 (2731 in chips) 
Seat 9: JeBoyDirk (13672 in chips) 
JeBoyDirk: posts small blind 50
dddocky: posts big blind 100
*** HOLE CARDS ***
Dealt to Duke Croix [Kd 2c]
Duke Croix: folds 
MnnM150: calls 100
HighCardJasper: calls 100
MrOB1reader: folds 
appositive: calls 100
MaFak2019: folds 
JeBoyDirk: calls 50
dddocky: checks 
*** FLOP *** [Td 3h Qc]
JeBoyDirk: checks 
dddocky: checks 
MnnM150: checks 
HighCardJasper: checks 
appositive: checks 
*** TURN *** [Td 3h Qc] [Ks]
JeBoyDirk: checks 
dddocky: checks 
MnnM150: checks 
HighCardJasper: checks 
appositive: checks 
*** RIVER *** [Td 3h Qc Ks] [Ts]
JeBoyDirk: bets 200
dddocky: folds 
MnnM150: raises 200 to 400
HighCardJasper: folds 
appositive: folds 
JeBoyDirk: calls 200
*** SHOW DOWN ***
MnnM150: shows [Jh Th] (three of a kind, Tens)
JeBoyDirk: mucks hand 
MnnM150 collected 1228 from pot
*** SUMMARY ***
Total pot 1300 | Rake 72 
Board [Td 3h Qc Ks Ts]
Seat 1: dddocky (big blind) folded on the River
Seat 2: Duke Croix folded before Flop (didn't bet)
Seat 3: MnnM150 showed [Jh Th] and won (1228) with three of a kind, Tens
Seat 4: HighCardJasper folded on the River
Seat 5: MrOB1reader folded before Flop (didn't bet)
Seat 7: appositive folded on the River
Seat 8: MaFak2019 (button) folded before Flop (didn't bet)
Seat 9: JeBoyDirk (small blind) mucked [9h Qd]



PokerStars Home Game Hand #220085727303: {Club #3225207}  Hold'em No Limit (50/100) - 2020/11/05 16:32:34 ET
Table 'funzzzzzzzz' 9-max (Play Money) Seat #9 is the button
Seat 1: dddocky (2266 in chips) 
Seat 2: Duke Croix (7377 in chips) 
Seat 3: MnnM150 (23023 in chips) 
Seat 4: HighCardJasper (14737 in chips) 
Seat 5: MrOB1reader (6939 in chips) 
Seat 7: appositive (22736 in chips) 
Seat 8: MaFak2019 (2731 in chips) 
Seat 9: JeBoyDirk (13172 in chips) 
dddocky: posts small blind 50
Duke Croix: posts big blind 100
*** HOLE CARDS ***
Dealt to Duke Croix [Ks Qc]
MnnM150: calls 100
HighCardJasper: calls 100
MrOB1reader: folds 
appositive: folds 
MaFak2019: folds 
JeBoyDirk: folds 
dddocky: folds 
Duke Croix: raises 300 to 400
MnnM150: calls 300
HighCardJasper: folds 
*** FLOP *** [Jd 7h 4h]
Duke Croix: checks 
MnnM150: checks 
*** TURN *** [Jd 7h 4h] [Th]
Duke Croix: bets 400
MnnM150: folds 
Uncalled bet (400) returned to Duke Croix
Duke Croix collected 898 from pot
*** SUMMARY ***
Total pot 950 | Rake 52 
Board [Jd 7h 4h Th]
Seat 1: dddocky (small blind) folded before Flop
Seat 2: Duke Croix (big blind) collected (898)
Seat 3: MnnM150 folded on the Turn
Seat 4: HighCardJasper folded before Flop
Seat 5: MrOB1reader folded before Flop (didn't bet)
Seat 7: appositive folded before Flop (didn't bet)
Seat 8: MaFak2019 folded before Flop (didn't bet)
Seat 9: JeBoyDirk (button) folded before Flop (didn't bet)



PokerStars Home Game Hand #220085764656: {Club #3225207}  Hold'em No Limit (50/100) - 2020/11/05 16:33:32 ET
Table 'funzzzzzzzz' 9-max (Play Money) Seat #1 is the button
Seat 1: dddocky (2216 in chips) 
Seat 2: Duke Croix (7875 in chips) 
Seat 3: MnnM150 (22623 in chips) 
Seat 4: HighCardJasper (14637 in chips) 
Seat 5: MrOB1reader (6939 in chips) 
Seat 7: appositive (22736 in chips) 
Seat 8: MaFak2019 (2731 in chips) 
Seat 9: JeBoyDirk (13172 in chips) 
Duke Croix: posts small blind 50
MnnM150: posts big blind 100
*** HOLE CARDS ***
Dealt to Duke Croix [9d 7h]
HighCardJasper: calls 100
MrOB1reader: folds 
appositive: calls 100
MaFak2019: raises 100 to 200
JeBoyDirk: folds 
dddocky: raises 100 to 300
Duke Croix: folds 
MnnM150: folds 
HighCardJasper: folds 
appositive: raises 100 to 400
MaFak2019: calls 200
dddocky: raises 100 to 500
appositive: calls 100
MaFak2019: calls 100
*** FLOP *** [7d 8c 5c]
appositive: bets 827
MaFak2019: calls 827
dddocky: raises 889 to 1716 and is all-in
appositive: folds 
MaFak2019: calls 889
*** TURN *** [7d 8c 5c] [3h]
*** RIVER *** [7d 8c 5c 3h] [3c]
*** SHOW DOWN ***
MaFak2019: shows [4h 5h] (two pair, Fives and Threes)
dddocky: shows [Qc Qs] (two pair, Queens and Threes)
dddocky collected 5678 from pot
*** SUMMARY ***
Total pot 6009 | Rake 331 
Board [7d 8c 5c 3h 3c]
Seat 1: dddocky (button) showed [Qc Qs] and won (5678) with two pair, Queens and Threes
Seat 2: Duke Croix (small blind) folded before Flop
Seat 3: MnnM150 (big blind) folded before Flop
Seat 4: HighCardJasper folded before Flop
Seat 5: MrOB1reader folded before Flop (didn't bet)
Seat 7: appositive folded on the Flop
Seat 8: MaFak2019 showed [4h 5h] and lost with two pair, Fives and Threes
Seat 9: JeBoyDirk folded before Flop (didn't bet)



PokerStars Home Game Hand #220085810733: {Club #3225207}  Hold'em No Limit (50/100) - 2020/11/05 16:34:45 ET
Table 'funzzzzzzzz' 9-max (Play Money) Seat #2 is the button
Seat 1: dddocky (5678 in chips) 
Seat 2: Duke Croix (7825 in chips) 
Seat 3: MnnM150 (22523 in chips) 
Seat 4: HighCardJasper (14537 in chips) 
Seat 5: MrOB1reader (6939 in chips) 
Seat 7: appositive (21409 in chips) 
Seat 8: MaFak2019 (515 in chips) 
Seat 9: JeBoyDirk (13172 in chips) 
MnnM150: posts small blind 50
HighCardJasper: posts big blind 100
*** HOLE CARDS ***
Dealt to Duke Croix [8d Kd]
MrOB1reader: folds 
appositive: folds 
MaFak2019: calls 100
JeBoyDirk: calls 100
dddocky: calls 100
Duke Croix: calls 100
MnnM150: calls 50
HighCardJasper: checks 
*** FLOP *** [7d Ac Ad]
MnnM150: checks 
HighCardJasper: checks 
MaFak2019: checks 
JeBoyDirk: checks 
dddocky: checks 
Duke Croix: bets 400
MnnM150: calls 400
HighCardJasper: folds 
MaFak2019: folds 
JeBoyDirk: folds 
dddocky: folds 
*** TURN *** [7d Ac Ad] [Kc]
MnnM150: checks 
Duke Croix: bets 1100
MnnM150: folds 
Uncalled bet (1100) returned to Duke Croix
Duke Croix collected 1323 from pot
*** SUMMARY ***
Total pot 1400 | Rake 77 
Board [7d Ac Ad Kc]
Seat 1: dddocky folded on the Flop
Seat 2: Duke Croix (button) collected (1323)
Seat 3: MnnM150 (small blind) folded on the Turn
Seat 4: HighCardJasper (big blind) folded on the Flop
Seat 5: MrOB1reader folded before Flop (didn't bet)
Seat 7: appositive folded before Flop (didn't bet)
Seat 8: MaFak2019 folded on the Flop
Seat 9: JeBoyDirk folded on the Flop



PokerStars Home Game Hand #220085853597: {Club #3225207}  Hold'em No Limit (50/100) - 2020/11/05 16:35:49 ET
Table 'funzzzzzzzz' 9-max (Play Money) Seat #3 is the button
Seat 1: dddocky (5578 in chips) 
Seat 2: Duke Croix (8648 in chips) 
Seat 3: MnnM150 (22023 in chips) 
Seat 4: HighCardJasper (14437 in chips) 
Seat 5: MrOB1reader (6939 in chips) 
Seat 7: appositive (21409 in chips) 
Seat 8: MaFak2019 (415 in chips) 
Seat 9: JeBoyDirk (13072 in chips) 
HighCardJasper: posts small blind 50
MrOB1reader: posts big blind 100
*** HOLE CARDS ***
Dealt to Duke Croix [Ad 9h]
appositive: calls 100
MaFak2019: folds 
JeBoyDirk: folds 
dddocky: folds 
Duke Croix: raises 200 to 300
MnnM150: folds 
HighCardJasper: calls 250
MrOB1reader: calls 200
appositive: calls 200
*** FLOP *** [Ah 2c Th]
HighCardJasper: checks 
MrOB1reader: checks 
appositive: checks 
Duke Croix: bets 800
HighCardJasper: folds 
MrOB1reader: folds 
appositive: folds 
Uncalled bet (800) returned to Duke Croix
Duke Croix collected 1134 from pot
*** SUMMARY ***
Total pot 1200 | Rake 66 
Board [Ah 2c Th]
Seat 1: dddocky folded before Flop (didn't bet)
Seat 2: Duke Croix collected (1134)
Seat 3: MnnM150 (button) folded before Flop (didn't bet)
Seat 4: HighCardJasper (small blind) folded on the Flop
Seat 5: MrOB1reader (big blind) folded on the Flop
Seat 7: appositive folded on the Flop
Seat 8: MaFak2019 folded before Flop (didn't bet)
Seat 9: JeBoyDirk folded before Flop (didn't bet)



PokerStars Home Game Hand #220085900649: {Club #3225207}  Hold'em No Limit (50/100) - 2020/11/05 16:37:03 ET
Table 'funzzzzzzzz' 9-max (Play Money) Seat #4 is the button
Seat 1: dddocky (5578 in chips) 
Seat 2: Duke Croix (9482 in chips) 
Seat 3: MnnM150 (22023 in chips) 
Seat 4: HighCardJasper (14137 in chips) 
Seat 5: MrOB1reader (6639 in chips) 
Seat 7: appositive (21109 in chips) 
Seat 8: MaFak2019 (415 in chips) 
Seat 9: JeBoyDirk (13072 in chips) 
MrOB1reader: posts small blind 50
appositive: posts big blind 100
*** HOLE CARDS ***
Dealt to Duke Croix [8s 9d]
MaFak2019: calls 100
JeBoyDirk: calls 100
dddocky: folds 
Duke Croix: calls 100
MnnM150: calls 100
HighCardJasper: calls 100
MrOB1reader: calls 50
appositive: checks 
*** FLOP *** [2h 7c Kh]
MrOB1reader: checks 
appositive: checks 
MaFak2019: checks 
JeBoyDirk: bets 300
Duke Croix: folds 
MnnM150: folds 
HighCardJasper: calls 300
MrOB1reader: folds 
appositive: folds 
MaFak2019: folds 
*** TURN *** [2h 7c Kh] [Qc]
JeBoyDirk: bets 800
HighCardJasper: calls 800
*** RIVER *** [2h 7c Kh Qc] [8c]
JeBoyDirk: checks 
HighCardJasper: bets 500
JeBoyDirk: calls 500
*** SHOW DOWN ***
HighCardJasper: shows [3c Kc] (a flush, King high)
JeBoyDirk: mucks hand 
HighCardJasper collected 3685 from pot
*** SUMMARY ***
Total pot 3900 | Rake 215 
Board [2h 7c Kh Qc 8c]
Seat 1: dddocky folded before Flop (didn't bet)
Seat 2: Duke Croix folded on the Flop
Seat 3: MnnM150 folded on the Flop
Seat 4: HighCardJasper (button) showed [3c Kc] and won (3685) with a flush, King high
Seat 5: MrOB1reader (small blind) folded on the Flop
Seat 7: appositive (big blind) folded on the Flop
Seat 8: MaFak2019 folded on the Flop
Seat 9: JeBoyDirk mucked [Ks Ts]



PokerStars Home Game Hand #220085944246: {Club #3225207}  Hold'em No Limit (50/100) - 2020/11/05 16:38:12 ET
Table 'funzzzzzzzz' 9-max (Play Money) Seat #5 is the button
Seat 1: dddocky (5578 in chips) 
Seat 2: Duke Croix (9382 in chips) 
Seat 3: MnnM150 (21923 in chips) 
Seat 4: HighCardJasper (16122 in chips) 
Seat 5: MrOB1reader (6539 in chips) 
Seat 7: appositive (21009 in chips) 
Seat 8: MaFak2019 (315 in chips) 
Seat 9: JeBoyDirk (11372 in chips) 
appositive: posts small blind 50
MaFak2019: posts big blind 100
*** HOLE CARDS ***
Dealt to Duke Croix [Qd 9h]
JeBoyDirk: calls 100
dddocky: raises 100 to 200
Duke Croix: folds 
MnnM150: calls 200
HighCardJasper: folds 
MrOB1reader: calls 200
appositive: folds 
MaFak2019: raises 100 to 300
JeBoyDirk: calls 200
dddocky: calls 100
MnnM150: calls 100
MrOB1reader: calls 100
*** FLOP *** [7c Th Kd]
MaFak2019: bets 15 and is all-in
JeBoyDirk: folds 
dddocky: calls 15
MnnM150: calls 15
MrOB1reader: raises 1525 to 1540
dddocky: folds 
MnnM150: folds 
Uncalled bet (1525) returned to MrOB1reader
*** TURN *** [7c Th Kd] [6h]
*** RIVER *** [7c Th Kd 6h] [Ts]
*** SHOW DOWN ***
MaFak2019: shows [8d Js] (a pair of Tens)
MrOB1reader: shows [6c Ks] (two pair, Kings and Tens)
MrOB1reader collected 1521 from pot
*** SUMMARY ***
Total pot 1610 | Rake 89 
Board [7c Th Kd 6h Ts]
Seat 1: dddocky folded on the Flop
Seat 2: Duke Croix folded before Flop (didn't bet)
Seat 3: MnnM150 folded on the Flop
Seat 4: HighCardJasper folded before Flop (didn't bet)
Seat 5: MrOB1reader (button) showed [6c Ks] and won (1521) with two pair, Kings and Tens
Seat 7: appositive (small blind) folded before Flop
Seat 8: MaFak2019 (big blind) showed [8d Js] and lost with a pair of Tens
Seat 9: JeBoyDirk folded on the Flop



PokerStars Home Game Hand #220085990376: {Club #3225207}  Hold'em No Limit (50/100) - 2020/11/05 16:39:26 ET
Table 'funzzzzzzzz' 9-max (Play Money) Seat #7 is the button
Seat 1: dddocky (5263 in chips) 
Seat 2: Duke Croix (9382 in chips) 
Seat 3: MnnM150 (21608 in chips) 
Seat 4: HighCardJasper (16122 in chips) 
Seat 5: MrOB1reader (7745 in chips) 
Seat 7: appositive (20959 in chips) 
Seat 9: JeBoyDirk (11072 in chips) 
JeBoyDirk: posts small blind 50
dddocky: posts big blind 100
*** HOLE CARDS ***
Dealt to Duke Croix [8h 2h]
Duke Croix: folds 
MnnM150: calls 100
HighCardJasper: calls 100
MrOB1reader: calls 100
appositive: folds 
JeBoyDirk: folds 
dddocky: raises 100 to 200
MnnM150: calls 100
HighCardJasper: calls 100
MrOB1reader: calls 100
*** FLOP *** [Jd 9s Qc]
dddocky: bets 100
MnnM150: calls 100
HighCardJasper: calls 100
MrOB1reader: calls 100
*** TURN *** [Jd 9s Qc] [3s]
dddocky: checks 
MnnM150: checks 
HighCardJasper: checks 
MrOB1reader: bets 333
dddocky: calls 333
MnnM150: calls 333
HighCardJasper: folds 
*** RIVER *** [Jd 9s Qc 3s] [4s]
dddocky: checks 
MnnM150: checks 
MrOB1reader: bets 444
dddocky: calls 444
MnnM150: folds 
*** SHOW DOWN ***
MrOB1reader: shows [Jh Qs] (two pair, Queens and Jacks)
dddocky: mucks hand 
MrOB1reader collected 2964 from pot
*** SUMMARY ***
Total pot 3137 | Rake 173 
Board [Jd 9s Qc 3s 4s]
Seat 1: dddocky (big blind) mucked [Ts Tc]
Seat 2: Duke Croix folded before Flop (didn't bet)
Seat 3: MnnM150 folded on the River
Seat 4: HighCardJasper folded on the Turn
Seat 5: MrOB1reader showed [Jh Qs] and won (2964) with two pair, Queens and Jacks
Seat 7: appositive (button) folded before Flop (didn't bet)
Seat 9: JeBoyDirk (small blind) folded before Flop



PokerStars Home Game Hand #220086053044: {Club #3225207}  Hold'em No Limit (50/100) - 2020/11/05 16:41:01 ET
Table 'funzzzzzzzz' 9-max (Play Money) Seat #9 is the button
Seat 1: dddocky (4186 in chips) 
Seat 2: Duke Croix (9382 in chips) 
Seat 3: MnnM150 (20975 in chips) 
Seat 4: HighCardJasper (15822 in chips) 
Seat 5: MrOB1reader (9632 in chips) 
Seat 7: appositive (20959 in chips) 
Seat 8: MaFak2019 (10000 in chips) 
Seat 9: JeBoyDirk (11022 in chips) 
dddocky: posts small blind 50
Duke Croix: posts big blind 100
MaFak2019: posts small blind 50
*** HOLE CARDS ***
Dealt to Duke Croix [9c Td]
MnnM150: calls 100
HighCardJasper: calls 100
MrOB1reader: calls 100
appositive: folds 
MaFak2019: calls 100
JeBoyDirk: folds 
dddocky: calls 50
Duke Croix: checks 
*** FLOP *** [6c Ac 8d]
dddocky: checks 
Duke Croix: checks 
MnnM150: checks 
HighCardJasper: checks 
MrOB1reader: checks 
MaFak2019: checks 
*** TURN *** [6c Ac 8d] [Qh]
dddocky: checks 
Duke Croix: checks 
MnnM150: bets 307
HighCardJasper: calls 307
MrOB1reader: folds 
MaFak2019: folds 
dddocky: folds 
Duke Croix: calls 307
*** RIVER *** [6c Ac 8d Qh] [6s]
Duke Croix: checks 
MnnM150: bets 742
HighCardJasper: raises 742 to 1484
Duke Croix: folds 
MnnM150: calls 742
*** SHOW DOWN ***
HighCardJasper: shows [6d Qd] (a full house, Sixes full of Queens)
MnnM150: mucks hand 
HighCardJasper collected 4289 from pot
*** SUMMARY ***
Total pot 4539 | Rake 250 
Board [6c Ac 8d Qh 6s]
Seat 1: dddocky (small blind) folded on the Turn
Seat 2: Duke Croix (big blind) folded on the River
Seat 3: MnnM150 mucked [Qc 9d]
Seat 4: HighCardJasper showed [6d Qd] and won (4289) with a full house, Sixes full of Queens
Seat 5: MrOB1reader folded on the Turn
Seat 7: appositive folded before Flop (didn't bet)
Seat 8: MaFak2019 folded on the Turn
Seat 9: JeBoyDirk (button) folded before Flop (didn't bet)



PokerStars Home Game Hand #220086111470: {Club #3225207}  Hold'em No Limit (50/100) - 2020/11/05 16:42:36 ET
Table 'funzzzzzzzz' 9-max (Play Money) Seat #1 is the button
Seat 1: dddocky (4086 in chips) 
Seat 2: Duke Croix (8975 in chips) 
Seat 3: MnnM150 (19084 in chips) 
Seat 4: HighCardJasper (18220 in chips) 
Seat 5: MrOB1reader (9532 in chips) 
Seat 7: appositive (20959 in chips) 
Seat 8: MaFak2019 (9850 in chips) 
Seat 9: JeBoyDirk (11022 in chips) 
Duke Croix: posts small blind 50
MnnM150: posts big blind 100
*** HOLE CARDS ***
Dealt to Duke Croix [2d Jd]
HighCardJasper: calls 100
MrOB1reader: raises 100 to 200
appositive: folds 
MaFak2019: calls 200
JeBoyDirk: folds 
dddocky: folds 
Duke Croix: folds 
MnnM150: folds 
HighCardJasper: calls 100
*** FLOP *** [Ac Tc Ts]
HighCardJasper: checks 
MrOB1reader: checks 
MaFak2019: checks 
*** TURN *** [Ac Tc Ts] [2s]
HighCardJasper: checks 
MrOB1reader: bets 709
MaFak2019: folds 
HighCardJasper: folds 
Uncalled bet (709) returned to MrOB1reader
MrOB1reader collected 709 from pot
MrOB1reader: doesn't show hand 
*** SUMMARY ***
Total pot 750 | Rake 41 
Board [Ac Tc Ts 2s]
Seat 1: dddocky (button) folded before Flop (didn't bet)
Seat 2: Duke Croix (small blind) folded before Flop
Seat 3: MnnM150 (big blind) folded before Flop
Seat 4: HighCardJasper folded on the Turn
Seat 5: MrOB1reader collected (709)
Seat 7: appositive folded before Flop (didn't bet)
Seat 8: MaFak2019 folded on the Turn
Seat 9: JeBoyDirk folded before Flop (didn't bet)



PokerStars Home Game Hand #220086145877: {Club #3225207}  Hold'em No Limit (50/100) - 2020/11/05 16:43:31 ET
Table 'funzzzzzzzz' 9-max (Play Money) Seat #2 is the button
Seat 1: dddocky (4086 in chips) 
Seat 2: Duke Croix (8925 in chips) 
Seat 3: MnnM150 (18984 in chips) 
Seat 4: HighCardJasper (18020 in chips) 
Seat 5: MrOB1reader (10041 in chips) 
Seat 7: appositive (20959 in chips) 
Seat 8: MaFak2019 (9650 in chips) 
Seat 9: JeBoyDirk (11022 in chips) 
MnnM150: posts small blind 50
HighCardJasper: posts big blind 100
*** HOLE CARDS ***
Dealt to Duke Croix [8d 7c]
MrOB1reader: raises 100 to 200
appositive: folds 
MaFak2019: calls 200
JeBoyDirk: folds 
dddocky: raises 100 to 300
Duke Croix: calls 300
MnnM150: calls 250
HighCardJasper has timed out
HighCardJasper: folds 
MrOB1reader: calls 100
MaFak2019: calls 100
*** FLOP *** [8h 5d Jh]
MnnM150: checks 
MrOB1reader: bets 100
MaFak2019: folds 
dddocky: raises 1712 to 1812
Duke Croix: folds 
MnnM150: folds 
MrOB1reader is disconnected 
MrOB1reader has timed out while being disconnected
MrOB1reader: folds 
Uncalled bet (1712) returned to dddocky
dddocky collected 1701 from pot
dddocky: doesn't show hand 
*** SUMMARY ***
Total pot 1800 | Rake 99 
Board [8h 5d Jh]
Seat 1: dddocky collected (1701)
Seat 2: Duke Croix (button) folded on the Flop
Seat 3: MnnM150 (small blind) folded on the Flop
Seat 4: HighCardJasper (big blind) folded before Flop
Seat 5: MrOB1reader folded on the Flop
Seat 7: appositive folded before Flop (didn't bet)
Seat 8: MaFak2019 folded on the Flop
Seat 9: JeBoyDirk folded before Flop (didn't bet)



PokerStars Home Game Hand #220086214387: {Club #3225207}  Hold'em No Limit (50/100) - 2020/11/05 16:45:21 ET
Table 'funzzzzzzzz' 9-max (Play Money) Seat #3 is the button
Seat 1: dddocky (5387 in chips) 
Seat 2: Duke Croix (8625 in chips) 
Seat 3: MnnM150 (18684 in chips) 
Seat 7: appositive (20959 in chips) 
Seat 8: MaFak2019 (9350 in chips) 
Seat 9: JeBoyDirk (11022 in chips) 
appositive: posts small blind 50
MaFak2019: posts big blind 100
*** HOLE CARDS ***
Dealt to Duke Croix [2h 9h]
JeBoyDirk: folds 
dddocky: folds 
Duke Croix: folds 
MnnM150: calls 100
appositive: calls 50
MaFak2019: raises 100 to 200
MnnM150: calls 100
appositive: calls 100
*** FLOP *** [2s 6s 3s]
appositive: checks 
MaFak2019: checks 
MnnM150: bets 283
appositive: folds 
MaFak2019: folds 
Uncalled bet (283) returned to MnnM150
MnnM150 collected 567 from pot
*** SUMMARY ***
Total pot 600 | Rake 33 
Board [2s 6s 3s]
Seat 1: dddocky folded before Flop (didn't bet)
Seat 2: Duke Croix folded before Flop (didn't bet)
Seat 3: MnnM150 (button) collected (567)
Seat 7: appositive (small blind) folded on the Flop
Seat 8: MaFak2019 (big blind) folded on the Flop
Seat 9: JeBoyDirk folded before Flop (didn't bet)



PokerStars Home Game Hand #220086244251: {Club #3225207}  Hold'em No Limit (50/100) - 2020/11/05 16:46:08 ET
Table 'funzzzzzzzz' 9-max (Play Money) Seat #7 is the button
Seat 1: dddocky (5387 in chips) 
Seat 2: Duke Croix (8625 in chips) 
Seat 3: MnnM150 (19051 in chips) 
Seat 7: appositive (20759 in chips) 
Seat 8: MaFak2019 (9150 in chips) 
Seat 9: JeBoyDirk (11022 in chips) 
MaFak2019: posts small blind 50
JeBoyDirk: posts big blind 100
*** HOLE CARDS ***
Dealt to Duke Croix [7c Ac]
dddocky: calls 100
Duke Croix: raises 300 to 400
MnnM150: folds 
appositive: calls 400
MaFak2019: folds 
JeBoyDirk: raises 400 to 800
dddocky: folds 
Duke Croix: calls 400
appositive: calls 400
*** FLOP *** [7s 9c 9d]
JeBoyDirk: bets 1600
Duke Croix: folds 
appositive: folds 
Uncalled bet (1600) returned to JeBoyDirk
JeBoyDirk collected 2410 from pot
*** SUMMARY ***
Total pot 2550 | Rake 140 
Board [7s 9c 9d]
Seat 1: dddocky folded before Flop
Seat 2: Duke Croix folded on the Flop
Seat 3: MnnM150 folded before Flop (didn't bet)
Seat 7: appositive (button) folded on the Flop
Seat 8: MaFak2019 (small blind) folded before Flop
Seat 9: JeBoyDirk (big blind) collected (2410)



PokerStars Home Game Hand #220086271635: {Club #3225207}  Hold'em No Limit (50/100) - 2020/11/05 16:46:52 ET
Table 'funzzzzzzzz' 9-max (Play Money) Seat #8 is the button
Seat 1: dddocky (5287 in chips) 
Seat 2: Duke Croix (7825 in chips) 
Seat 3: MnnM150 (19051 in chips) 
Seat 4: HighCardJasper (17920 in chips) 
Seat 5: MrOB1reader (9641 in chips) 
Seat 7: appositive (19959 in chips) 
Seat 8: MaFak2019 (9100 in chips) 
Seat 9: JeBoyDirk (12632 in chips) 
JeBoyDirk: posts small blind 50
dddocky: posts big blind 100
HighCardJasper: posts small blind 50
MrOB1reader: posts small blind 50
*** HOLE CARDS ***
Dealt to Duke Croix [2d 7h]
Duke Croix: folds 
MnnM150: folds 
HighCardJasper: calls 100
MrOB1reader: folds 
appositive: calls 100
MaFak2019: calls 100
JeBoyDirk: calls 50
dddocky: raises 150 to 250
HighCardJasper: calls 150
appositive: calls 150
MaFak2019: calls 150
JeBoyDirk: calls 150
*** FLOP *** [3s As 8c]
JeBoyDirk: checks 
dddocky: bets 1276
HighCardJasper: folds 
appositive: calls 1276
MaFak2019: folds 
JeBoyDirk: folds 
*** TURN *** [3s As 8c] [Jd]
dddocky: bets 3687
appositive: folds 
Uncalled bet (3687) returned to dddocky
dddocky collected 3687 from pot
dddocky: doesn't show hand 
*** SUMMARY ***
Total pot 3902 | Rake 215 
Board [3s As 8c Jd]
Seat 1: dddocky (big blind) collected (3687)
Seat 2: Duke Croix folded before Flop (didn't bet)
Seat 3: MnnM150 folded before Flop (didn't bet)
Seat 4: HighCardJasper folded on the Flop
Seat 5: MrOB1reader folded before Flop (didn't bet)
Seat 7: appositive folded on the Turn
Seat 8: MaFak2019 (button) folded on the Flop
Seat 9: JeBoyDirk (small blind) folded on the Flop



PokerStars Home Game Hand #220086324283: {Club #3225207}  Hold'em No Limit (50/100) - 2020/11/05 16:48:03 ET
Table 'funzzzzzzzz' 9-max (Play Money) Seat #9 is the button
Seat 1: dddocky (7448 in chips) 
Seat 2: Duke Croix (7825 in chips) 
Seat 3: MnnM150 (19051 in chips) 
Seat 4: HighCardJasper (17620 in chips) 
Seat 5: MrOB1reader (9591 in chips) 
Seat 7: appositive (18433 in chips) 
Seat 8: MaFak2019 (8850 in chips) 
Seat 9: JeBoyDirk (12382 in chips) 
dddocky: posts small blind 50
Duke Croix: posts big blind 100
*** HOLE CARDS ***
Dealt to Duke Croix [5d 9d]
MnnM150: folds 
HighCardJasper: raises 100 to 200
MrOB1reader: raises 100 to 300
appositive: raises 300 to 600
MaFak2019: calls 600
JeBoyDirk: folds 
dddocky: folds 
Duke Croix: folds 
HighCardJasper: calls 400
MrOB1reader: calls 300
*** FLOP *** [2s 5h As]
HighCardJasper: checks 
MrOB1reader: checks 
appositive: bets 2410
MaFak2019: folds 
HighCardJasper: folds 
MrOB1reader: folds 
Uncalled bet (2410) returned to appositive
appositive collected 2410 from pot
appositive: doesn't show hand 
*** SUMMARY ***
Total pot 2550 | Rake 140 
Board [2s 5h As]
Seat 1: dddocky (small blind) folded before Flop
Seat 2: Duke Croix (big blind) folded before Flop
Seat 3: MnnM150 folded before Flop (didn't bet)
Seat 4: HighCardJasper folded on the Flop
Seat 5: MrOB1reader folded on the Flop
Seat 7: appositive collected (2410)
Seat 8: MaFak2019 folded on the Flop
Seat 9: JeBoyDirk (button) folded before Flop (didn't bet)



PokerStars Home Game Hand #220086384775: {Club #3225207}  Hold'em No Limit (50/100) - 2020/11/05 16:49:41 ET
Table 'funzzzzzzzz' 9-max (Play Money) Seat #1 is the button
Seat 1: dddocky (7398 in chips) 
Seat 2: Duke Croix (7725 in chips) 
Seat 3: MnnM150 (19051 in chips) 
Seat 4: HighCardJasper (17020 in chips) 
Seat 5: MrOB1reader (8991 in chips) 
Seat 7: appositive (20243 in chips) 
Seat 8: MaFak2019 (8250 in chips) 
Seat 9: JeBoyDirk (12382 in chips) 
Duke Croix: posts small blind 50
MnnM150: posts big blind 100
*** HOLE CARDS ***
Dealt to Duke Croix [4c 4h]
HighCardJasper: calls 100
MrOB1reader: raises 100 to 200
appositive: folds 
MaFak2019: calls 200
JeBoyDirk: calls 200
dddocky: folds 
Duke Croix: calls 150
MnnM150: folds 
HighCardJasper: calls 100
*** FLOP *** [Kc 7h Tc]
Duke Croix: checks 
HighCardJasper: checks 
MrOB1reader: checks 
MaFak2019: checks 
JeBoyDirk: checks 
*** TURN *** [Kc 7h Tc] [Ac]
Duke Croix: bets 600
HighCardJasper: folds 
MrOB1reader: calls 600
MaFak2019: calls 600
JeBoyDirk: folds 
*** RIVER *** [Kc 7h Tc Ac] [Jc]
Duke Croix: checks 
MrOB1reader: bets 2740
MaFak2019: folds 
Duke Croix: folds 
Uncalled bet (2740) returned to MrOB1reader
MrOB1reader collected 2740 from pot
MrOB1reader: doesn't show hand 
*** SUMMARY ***
Total pot 2900 | Rake 160 
Board [Kc 7h Tc Ac Jc]
Seat 1: dddocky (button) folded before Flop (didn't bet)
Seat 2: Duke Croix (small blind) folded on the River
Seat 3: MnnM150 (big blind) folded before Flop
Seat 4: HighCardJasper folded on the Turn
Seat 5: MrOB1reader collected (2740)
Seat 7: appositive folded before Flop (didn't bet)
Seat 8: MaFak2019 folded on the River
Seat 9: JeBoyDirk folded on the Turn



PokerStars Home Game Hand #220086441277: {Club #3225207}  Hold'em No Limit (50/100) - 2020/11/05 16:51:12 ET
Table 'funzzzzzzzz' 9-max (Play Money) Seat #2 is the button
Seat 1: dddocky (7398 in chips) 
Seat 2: Duke Croix (6925 in chips) 
Seat 3: MnnM150 (18951 in chips) 
Seat 4: HighCardJasper (16820 in chips) 
Seat 5: MrOB1reader (10931 in chips) 
Seat 7: appositive (20243 in chips) 
Seat 8: MaFak2019 (7450 in chips) 
Seat 9: JeBoyDirk (12182 in chips) 
MnnM150: posts small blind 50
HighCardJasper: posts big blind 100
*** HOLE CARDS ***
Dealt to Duke Croix [2c 7h]
MrOB1reader: calls 100
appositive: calls 100
MaFak2019: calls 100
JeBoyDirk: folds 
dddocky: folds 
Duke Croix: folds 
MnnM150: folds 
HighCardJasper: checks 
*** FLOP *** [5s 6c 9c]
HighCardJasper: checks 
MrOB1reader: bets 425
appositive: folds 
MaFak2019: folds 
HighCardJasper: calls 425
*** TURN *** [5s 6c 9c] [Ac]
HighCardJasper: checks 
MrOB1reader: bets 100
HighCardJasper: calls 100
*** RIVER *** [5s 6c 9c Ac] [Ah]
HighCardJasper: bets 500
MrOB1reader: raises 500 to 1000
HighCardJasper: folds 
Uncalled bet (500) returned to MrOB1reader
MrOB1reader collected 2362 from pot
MrOB1reader: doesn't show hand 
*** SUMMARY ***
Total pot 2500 | Rake 138 
Board [5s 6c 9c Ac Ah]
Seat 1: dddocky folded before Flop (didn't bet)
Seat 2: Duke Croix (button) folded before Flop (didn't bet)
Seat 3: MnnM150 (small blind) folded before Flop
Seat 4: HighCardJasper (big blind) folded on the River
Seat 5: MrOB1reader collected (2362)
Seat 7: appositive folded on the Flop
Seat 8: MaFak2019 folded on the Flop
Seat 9: JeBoyDirk folded before Flop (didn't bet)



PokerStars Home Game Hand #220086490227: {Club #3225207}  Hold'em No Limit (50/100) - 2020/11/05 16:52:31 ET
Table 'funzzzzzzzz' 9-max (Play Money) Seat #3 is the button
Seat 2: Duke Croix (6925 in chips) 
Seat 3: MnnM150 (18901 in chips) 
Seat 4: HighCardJasper (15695 in chips) 
Seat 5: MrOB1reader (12168 in chips) 
Seat 7: appositive (20143 in chips) 
Seat 8: MaFak2019 (7350 in chips) 
Seat 9: JeBoyDirk (12182 in chips) 
HighCardJasper: posts small blind 50
MrOB1reader: posts big blind 100
*** HOLE CARDS ***
Dealt to Duke Croix [9d 4s]
appositive: calls 100
MaFak2019: calls 100
JeBoyDirk: folds 
Duke Croix: folds 
MnnM150: calls 100
HighCardJasper: calls 50
MrOB1reader: checks 
*** FLOP *** [9c Th Td]
HighCardJasper: checks 
MrOB1reader: checks 
appositive: checks 
MaFak2019: checks 
MnnM150: checks 
*** TURN *** [9c Th Td] [3h]
HighCardJasper: checks 
MrOB1reader: checks 
appositive: checks 
MaFak2019: checks 
MnnM150: checks 
*** RIVER *** [9c Th Td 3h] [Ah]
HighCardJasper: checks 
MrOB1reader: checks 
appositive: bets 236
MaFak2019: folds 
MnnM150: folds 
HighCardJasper: folds 
MrOB1reader: folds 
Uncalled bet (236) returned to appositive
appositive collected 472 from pot
appositive: doesn't show hand 
*** SUMMARY ***
Total pot 500 | Rake 28 
Board [9c Th Td 3h Ah]
Seat 2: Duke Croix folded before Flop (didn't bet)
Seat 3: MnnM150 (button) folded on the River
Seat 4: HighCardJasper (small blind) folded on the River
Seat 5: MrOB1reader (big blind) folded on the River
Seat 7: appositive collected (472)
Seat 8: MaFak2019 folded on the River
Seat 9: JeBoyDirk folded before Flop (didn't bet)



PokerStars Home Game Hand #220086543958: {Club #3225207}  Hold'em No Limit (50/100) - 2020/11/05 16:53:58 ET
Table 'funzzzzzzzz' 9-max (Play Money) Seat #4 is the button
Seat 1: dddocky (7398 in chips) 
Seat 2: Duke Croix (6925 in chips) 
Seat 3: MnnM150 (18801 in chips) 
Seat 4: HighCardJasper (15595 in chips) 
Seat 5: MrOB1reader (12068 in chips) 
Seat 7: appositive (20515 in chips) 
Seat 8: MaFak2019 (7250 in chips) 
Seat 9: JeBoyDirk (12182 in chips) 
MrOB1reader: posts small blind 50
appositive: posts big blind 100
*** HOLE CARDS ***
Dealt to Duke Croix [2s 2h]
MaFak2019: folds 
JeBoyDirk: folds 
dddocky: calls 100
Duke Croix: calls 100
MnnM150: calls 100
HighCardJasper: calls 100
MrOB1reader: calls 50
appositive: checks 
*** FLOP *** [8s 7c 3d]
MrOB1reader: checks 
appositive: checks 
dddocky: checks 
Duke Croix: checks 
MnnM150: checks 
HighCardJasper: bets 100
MrOB1reader: calls 100
appositive: calls 100
dddocky: calls 100
Duke Croix: calls 100
MnnM150: folds 
*** TURN *** [8s 7c 3d] [5c]
MrOB1reader: checks 
appositive: checks 
dddocky: checks 
Duke Croix: checks 
HighCardJasper: bets 500
MrOB1reader: calls 500
appositive: folds 
dddocky: folds 
Duke Croix: folds 
*** RIVER *** [8s 7c 3d 5c] [Qd]
MrOB1reader: checks 
HighCardJasper: checks 
*** SHOW DOWN ***
MrOB1reader: shows [2c Qc] (a pair of Queens)
HighCardJasper: shows [7h 8c] (two pair, Eights and Sevens)
HighCardJasper collected 1984 from pot
*** SUMMARY ***
Total pot 2100 | Rake 116 
Board [8s 7c 3d 5c Qd]
Seat 1: dddocky folded on the Turn
Seat 2: Duke Croix folded on the Turn
Seat 3: MnnM150 folded on the Flop
Seat 4: HighCardJasper (button) showed [7h 8c] and won (1984) with two pair, Eights and Sevens
Seat 5: MrOB1reader (small blind) showed [2c Qc] and lost with a pair of Queens
Seat 7: appositive (big blind) folded on the Turn
Seat 8: MaFak2019 folded before Flop (didn't bet)
Seat 9: JeBoyDirk folded before Flop (didn't bet)



PokerStars Home Game Hand #220086602142: {Club #3225207}  Hold'em No Limit (50/100) - 2020/11/05 16:55:44 ET
Table 'funzzzzzzzz' 9-max (Play Money) Seat #5 is the button
Seat 1: dddocky (7198 in chips) 
Seat 2: Duke Croix (6725 in chips) 
Seat 3: MnnM150 (18701 in chips) 
Seat 4: HighCardJasper (16879 in chips) 
Seat 5: MrOB1reader (11368 in chips) 
Seat 7: appositive (20315 in chips) 
Seat 8: MaFak2019 (7250 in chips) 
Seat 9: JeBoyDirk (12182 in chips) 
appositive: posts small blind 50
MaFak2019: posts big blind 100
*** HOLE CARDS ***
Dealt to Duke Croix [7h 8d]
JeBoyDirk: folds 
dddocky: folds 
Duke Croix: calls 100
MnnM150: folds 
HighCardJasper: calls 100
MrOB1reader: calls 100
appositive: calls 50
MaFak2019: raises 200 to 300
Duke Croix: calls 200
HighCardJasper: calls 200
MrOB1reader: calls 200
appositive: folds 
*** FLOP *** [Ac Kc Ad]
MaFak2019: checks 
Duke Croix: checks 
HighCardJasper: checks 
MrOB1reader: bets 100
MaFak2019: calls 100
Duke Croix: folds 
HighCardJasper: calls 100
*** TURN *** [Ac Kc Ad] [Qs]
MaFak2019: checks 
HighCardJasper: checks 
MrOB1reader: bets 756
MaFak2019: calls 756
HighCardJasper: folds 
*** RIVER *** [Ac Kc Ad Qs] [Qd]
MaFak2019: checks 
MrOB1reader: bets 3700
MaFak2019: folds 
Uncalled bet (3700) returned to MrOB1reader
MrOB1reader collected 2941 from pot
MrOB1reader: doesn't show hand 
*** SUMMARY ***
Total pot 3112 | Rake 171 
Board [Ac Kc Ad Qs Qd]
Seat 1: dddocky folded before Flop (didn't bet)
Seat 2: Duke Croix folded on the Flop
Seat 3: MnnM150 folded before Flop (didn't bet)
Seat 4: HighCardJasper folded on the Turn
Seat 5: MrOB1reader (button) collected (2941)
Seat 7: appositive (small blind) folded before Flop
Seat 8: MaFak2019 (big blind) folded on the River
Seat 9: JeBoyDirk folded before Flop (didn't bet)



PokerStars Home Game Hand #220086652177: {Club #3225207}  Hold'em No Limit (50/100) - 2020/11/05 16:57:36 ET
Table 'funzzzzzzzz' 9-max (Play Money) Seat #7 is the button
Seat 1: dddocky (7198 in chips) 
Seat 2: Duke Croix (6425 in chips) 
Seat 3: MnnM150 (18701 in chips) 
Seat 4: HighCardJasper (16479 in chips) 
Seat 5: MrOB1reader (13153 in chips) 
Seat 7: appositive (20215 in chips) 
Seat 8: MaFak2019 (6094 in chips) 
Seat 9: JeBoyDirk (12182 in chips) 
MaFak2019: posts small blind 50
JeBoyDirk: posts big blind 100
*** HOLE CARDS ***
Dealt to Duke Croix [4h 5c]
dddocky: folds 
Duke Croix: calls 100
MnnM150: folds 
HighCardJasper: raises 100 to 200
MrOB1reader: raises 800 to 1000
appositive: folds 
MaFak2019: folds 
JeBoyDirk: folds 
Duke Croix: folds 
HighCardJasper: folds 
Uncalled bet (800) returned to MrOB1reader
MrOB1reader collected 650 from pot
MrOB1reader: doesn't show hand 
*** SUMMARY ***
Total pot 650 | Rake 0 
Seat 1: dddocky folded before Flop (didn't bet)
Seat 2: Duke Croix folded before Flop
Seat 3: MnnM150 folded before Flop (didn't bet)
Seat 4: HighCardJasper folded before Flop
Seat 5: MrOB1reader collected (650)
Seat 7: appositive (button) folded before Flop (didn't bet)
Seat 8: MaFak2019 (small blind) folded before Flop
Seat 9: JeBoyDirk (big blind) folded before Flop



PokerStars Home Game Hand #220086667804: {Club #3225207}  Hold'em No Limit (50/100) - 2020/11/05 16:58:10 ET
Table 'funzzzzzzzz' 9-max (Play Money) Seat #8 is the button
Seat 1: dddocky (7198 in chips) 
Seat 2: Duke Croix (6325 in chips) 
Seat 3: MnnM150 (18701 in chips) 
Seat 4: HighCardJasper (16279 in chips) 
Seat 5: MrOB1reader (13603 in chips) 
Seat 7: appositive (20215 in chips) 
Seat 8: MaFak2019 (6044 in chips) 
Seat 9: JeBoyDirk (12082 in chips) 
JeBoyDirk: posts small blind 50
dddocky: posts big blind 100
*** HOLE CARDS ***
Dealt to Duke Croix [3c 4d]
Duke Croix: folds 
MnnM150: calls 100
HighCardJasper: calls 100
MrOB1reader: calls 100
appositive: folds 
MaFak2019: folds 
JeBoyDirk: calls 50
dddocky: checks 
*** FLOP *** [2s 3h Js]
JeBoyDirk: checks 
dddocky: checks 
MnnM150: bets 100
HighCardJasper: calls 100
MrOB1reader: calls 100
JeBoyDirk: folds 
dddocky: folds 
*** TURN *** [2s 3h Js] [2c]
MnnM150: bets 378
HighCardJasper: folds 
MrOB1reader: folds 
Uncalled bet (378) returned to MnnM150
MnnM150 collected 756 from pot
*** SUMMARY ***
Total pot 800 | Rake 44 
Board [2s 3h Js 2c]
Seat 1: dddocky (big blind) folded on the Flop
Seat 2: Duke Croix folded before Flop (didn't bet)
Seat 3: MnnM150 collected (756)
Seat 4: HighCardJasper folded on the Turn
Seat 5: MrOB1reader folded on the Turn
Seat 7: appositive folded before Flop (didn't bet)
Seat 8: MaFak2019 (button) folded before Flop (didn't bet)
Seat 9: JeBoyDirk (small blind) folded on the Flop



PokerStars Home Game Hand #220086695348: {Club #3225207}  Hold'em No Limit (50/100) - 2020/11/05 16:59:10 ET
Table 'funzzzzzzzz' 9-max (Play Money) Seat #9 is the button
Seat 1: dddocky (7098 in chips) 
Seat 2: Duke Croix (6325 in chips) 
Seat 3: MnnM150 (19257 in chips) 
Seat 4: HighCardJasper (16079 in chips) 
Seat 5: MrOB1reader (13403 in chips) 
Seat 7: appositive (20215 in chips) 
Seat 8: MaFak2019 (6044 in chips) 
Seat 9: JeBoyDirk (11982 in chips) 
dddocky: posts small blind 50
Duke Croix: posts big blind 100
*** HOLE CARDS ***
Dealt to Duke Croix [Ah 9h]
MnnM150: folds 
HighCardJasper: calls 100
MrOB1reader: calls 100
appositive: calls 100
MaFak2019: calls 100
JeBoyDirk: calls 100
dddocky: calls 50
Duke Croix: raises 600 to 700
HighCardJasper: folds 
MrOB1reader: folds 
appositive: calls 600
MaFak2019: calls 600
JeBoyDirk: calls 600
dddocky: folds 
*** FLOP *** [9d Tc Td]
Duke Croix: bets 1700
appositive: folds 
MaFak2019: folds 
JeBoyDirk: calls 1700
*** TURN *** [9d Tc Td] [4d]
Duke Croix: bets 3925 and is all-in
JeBoyDirk: calls 3925
*** RIVER *** [9d Tc Td 4d] [Ad]
*** SHOW DOWN ***
Duke Croix: shows [Ah 9h] (two pair, Aces and Tens)
JeBoyDirk: shows [9s Ts] (a full house, Tens full of Nines)
JeBoyDirk collected 13561 from pot
*** SUMMARY ***
Total pot 14350 | Rake 789 
Board [9d Tc Td 4d Ad]
Seat 1: dddocky (small blind) folded before Flop
Seat 2: Duke Croix (big blind) showed [Ah 9h] and lost with two pair, Aces and Tens
Seat 3: MnnM150 folded before Flop (didn't bet)
Seat 4: HighCardJasper folded before Flop
Seat 5: MrOB1reader folded before Flop
Seat 7: appositive folded on the Flop
Seat 8: MaFak2019 folded on the Flop
Seat 9: JeBoyDirk (button) showed [9s Ts] and won (13561) with a full house, Tens full of Nines



PokerStars Home Game Hand #220086796139: {Club #3225207}  Hold'em No Limit (50/100) - 2020/11/05 17:02:26 ET
Table 'funzzzzzzzz' 9-max (Play Money) Seat #3 is the button
Seat 1: dddocky (6998 in chips) 
Seat 2: Duke Croix (10000 in chips) 
Seat 3: MnnM150 (19057 in chips) 
Seat 4: HighCardJasper (14434 in chips) 
Seat 5: MrOB1reader (12703 in chips) 
Seat 7: appositive (21646 in chips) 
Seat 8: MaFak2019 (5344 in chips) 
Seat 9: JeBoyDirk (19218 in chips) 
HighCardJasper: posts small blind 50
MrOB1reader: posts big blind 100
Duke Croix: posts small blind 50
*** HOLE CARDS ***
Dealt to Duke Croix [5d 8h]
appositive: calls 100
MaFak2019: calls 100
JeBoyDirk: calls 100
dddocky: folds 
Duke Croix: folds 
MnnM150: folds 
HighCardJasper: calls 50
MrOB1reader: checks 
*** FLOP *** [3h Jd 5c]
HighCardJasper: checks 
MrOB1reader: checks 
appositive: bets 200
MaFak2019: folds 
JeBoyDirk: folds 
HighCardJasper: calls 200
MrOB1reader: folds 
*** TURN *** [3h Jd 5c] [Kh]
HighCardJasper: checks 
appositive: bets 449
HighCardJasper: folds 
Uncalled bet (449) returned to appositive
appositive collected 898 from pot
appositive: doesn't show hand 
*** SUMMARY ***
Total pot 950 | Rake 52 
Board [3h Jd 5c Kh]
Seat 1: dddocky folded before Flop (didn't bet)
Seat 2: Duke Croix folded before Flop (didn't bet)
Seat 3: MnnM150 (button) folded before Flop (didn't bet)
Seat 4: HighCardJasper (small blind) folded on the Turn
Seat 5: MrOB1reader (big blind) folded on the Flop
Seat 7: appositive collected (898)
Seat 8: MaFak2019 folded on the Flop
Seat 9: JeBoyDirk folded on the Flop



PokerStars Home Game Hand #220086834967: {Club #3225207}  Hold'em No Limit (50/100) - 2020/11/05 17:03:31 ET
Table 'funzzzzzzzz' 9-max (Play Money) Seat #4 is the button
Seat 1: dddocky (6998 in chips) 
Seat 2: Duke Croix (9950 in chips) 
Seat 3: MnnM150 (19057 in chips) 
Seat 4: HighCardJasper (14134 in chips) 
Seat 5: MrOB1reader (12603 in chips) 
Seat 7: appositive (22244 in chips) 
Seat 8: MaFak2019 (5244 in chips) 
Seat 9: JeBoyDirk (19118 in chips) 
MrOB1reader: posts small blind 50
appositive: posts big blind 100
*** HOLE CARDS ***
Dealt to Duke Croix [Jh Tc]
MaFak2019: folds 
JeBoyDirk: folds 
dddocky: calls 100
Duke Croix: calls 100
MnnM150: folds 
HighCardJasper: calls 100
MrOB1reader: calls 50
appositive: checks 
*** FLOP *** [3s Td Ac]
MrOB1reader: checks 
appositive: bets 236
dddocky: raises 236 to 472
Duke Croix: calls 472
HighCardJasper: folds 
MrOB1reader: folds 
appositive: calls 236
*** TURN *** [3s Td Ac] [7h]
appositive: checks 
dddocky: bets 905
Duke Croix: folds 
appositive: folds 
Uncalled bet (905) returned to dddocky
dddocky collected 1811 from pot
dddocky: doesn't show hand 
*** SUMMARY ***
Total pot 1916 | Rake 105 
Board [3s Td Ac 7h]
Seat 1: dddocky collected (1811)
Seat 2: Duke Croix folded on the Turn
Seat 3: MnnM150 folded before Flop (didn't bet)
Seat 4: HighCardJasper (button) folded on the Flop
Seat 5: MrOB1reader (small blind) folded on the Flop
Seat 7: appositive (big blind) folded on the Turn
Seat 8: MaFak2019 folded before Flop (didn't bet)
Seat 9: JeBoyDirk folded before Flop (didn't bet)



PokerStars Home Game Hand #220086881214: {Club #3225207}  Hold'em No Limit (50/100) - 2020/11/05 17:04:47 ET
Table 'funzzzzzzzz' 9-max (Play Money) Seat #5 is the button
Seat 1: dddocky (8237 in chips) 
Seat 2: Duke Croix (9378 in chips) 
Seat 3: MnnM150 (19057 in chips) 
Seat 4: HighCardJasper (14034 in chips) 
Seat 5: MrOB1reader (12503 in chips) 
Seat 7: appositive (21672 in chips) 
Seat 8: MaFak2019 (5244 in chips) 
Seat 9: JeBoyDirk (19118 in chips) 
appositive: posts small blind 50
MaFak2019: posts big blind 100
*** HOLE CARDS ***
Dealt to Duke Croix [Ad Qh]
JeBoyDirk: calls 100
dddocky: folds 
Duke Croix: raises 300 to 400
MnnM150: folds 
HighCardJasper: folds 
MrOB1reader: folds 
appositive: folds 
MaFak2019: calls 300
JeBoyDirk: calls 300
*** FLOP *** [8s 3s 7d]
MaFak2019: checks 
JeBoyDirk: checks 
Duke Croix: checks 
*** TURN *** [8s 3s 7d] [6d]
MaFak2019: checks 
JeBoyDirk: checks 
Duke Croix: checks 
*** RIVER *** [8s 3s 7d 6d] [6s]
MaFak2019: checks 
JeBoyDirk: bets 600
Duke Croix: calls 600
MaFak2019: folds 
*** SHOW DOWN ***
JeBoyDirk: shows [4s As] (a flush, Ace high)
Duke Croix: mucks hand 
JeBoyDirk collected 2315 from pot
*** SUMMARY ***
Total pot 2450 | Rake 135 
Board [8s 3s 7d 6d 6s]
Seat 1: dddocky folded before Flop (didn't bet)
Seat 2: Duke Croix mucked [Ad Qh]
Seat 3: MnnM150 folded before Flop (didn't bet)
Seat 4: HighCardJasper folded before Flop (didn't bet)
Seat 5: MrOB1reader (button) folded before Flop (didn't bet)
Seat 7: appositive (small blind) folded before Flop
Seat 8: MaFak2019 (big blind) folded on the River
Seat 9: JeBoyDirk showed [4s As] and won (2315) with a flush, Ace high



PokerStars Home Game Hand #220086914961: {Club #3225207}  Hold'em No Limit (50/100) - 2020/11/05 17:05:42 ET
Table 'funzzzzzzzz' 9-max (Play Money) Seat #7 is the button
Seat 1: dddocky (8237 in chips) 
Seat 2: Duke Croix (8378 in chips) 
Seat 3: MnnM150 (19057 in chips) 
Seat 4: HighCardJasper (14034 in chips) 
Seat 5: MrOB1reader (12503 in chips) 
Seat 7: appositive (21622 in chips) 
Seat 8: MaFak2019 (4844 in chips) 
Seat 9: JeBoyDirk (20433 in chips) 
MaFak2019: posts small blind 50
JeBoyDirk: posts big blind 100
*** HOLE CARDS ***
Dealt to Duke Croix [Qh As]
dddocky: folds 
Duke Croix: raises 300 to 400
MnnM150: folds 
HighCardJasper: folds 
MrOB1reader: calls 400
appositive: calls 400
MaFak2019: calls 350
JeBoyDirk: calls 300
*** FLOP *** [Tc 2c Ad]
MaFak2019: checks 
JeBoyDirk: checks 
Duke Croix: bets 1000
MrOB1reader: folds 
appositive: calls 1000
MaFak2019: folds 
JeBoyDirk: folds 
*** TURN *** [Tc 2c Ad] [6s]
Duke Croix: bets 1900
appositive: folds 
Uncalled bet (1900) returned to Duke Croix
Duke Croix collected 3780 from pot
*** SUMMARY ***
Total pot 4000 | Rake 220 
Board [Tc 2c Ad 6s]
Seat 1: dddocky folded before Flop (didn't bet)
Seat 2: Duke Croix collected (3780)
Seat 3: MnnM150 folded before Flop (didn't bet)
Seat 4: HighCardJasper folded before Flop (didn't bet)
Seat 5: MrOB1reader folded on the Flop
Seat 7: appositive (button) folded on the Turn
Seat 8: MaFak2019 (small blind) folded on the Flop
Seat 9: JeBoyDirk (big blind) folded on the Flop



PokerStars Home Game Hand #220086967955: {Club #3225207}  Hold'em No Limit (50/100) - 2020/11/05 17:07:04 ET
Table 'funzzzzzzzz' 9-max (Play Money) Seat #8 is the button
Seat 1: dddocky (8237 in chips) 
Seat 2: Duke Croix (10758 in chips) 
Seat 3: MnnM150 (19057 in chips) 
Seat 4: HighCardJasper (14034 in chips) 
Seat 5: MrOB1reader (12103 in chips) 
Seat 7: appositive (20222 in chips) 
Seat 8: MaFak2019 (4444 in chips) 
Seat 9: JeBoyDirk (20033 in chips) 
JeBoyDirk: posts small blind 50
dddocky: posts big blind 100
*** HOLE CARDS ***
Dealt to Duke Croix [9d 8h]
Duke Croix: calls 100
MnnM150: folds 
HighCardJasper: calls 100
MrOB1reader: folds 
appositive: folds 
MaFak2019: calls 100
JeBoyDirk: folds 
dddocky: checks 
*** FLOP *** [4c 6d 8d]
dddocky: checks 
Duke Croix: bets 300
HighCardJasper: folds 
MaFak2019: raises 300 to 600
dddocky: folds 
Duke Croix: calls 300
*** TURN *** [4c 6d 8d] [3s]
Duke Croix: bets 900
MaFak2019: raises 900 to 1800
Duke Croix: calls 900
*** RIVER *** [4c 6d 8d 3s] [Qs]
Duke Croix: checks 
MaFak2019: bets 1944 and is all-in
Duke Croix: calls 1944
*** SHOW DOWN ***
MaFak2019: shows [Qd Qc] (three of a kind, Queens)
Duke Croix: shows [9d 8h] (a pair of Eights)
MaFak2019 collected 8635 from pot
*** SUMMARY ***
Total pot 9138 | Rake 503 
Board [4c 6d 8d 3s Qs]
Seat 1: dddocky (big blind) folded on the Flop
Seat 2: Duke Croix showed [9d 8h] and lost with a pair of Eights
Seat 3: MnnM150 folded before Flop (didn't bet)
Seat 4: HighCardJasper folded on the Flop
Seat 5: MrOB1reader folded before Flop (didn't bet)
Seat 7: appositive folded before Flop (didn't bet)
Seat 8: MaFak2019 (button) showed [Qd Qc] and won (8635) with three of a kind, Queens
Seat 9: JeBoyDirk (small blind) folded before Flop



PokerStars Home Game Hand #220087010152: {Club #3225207}  Hold'em No Limit (50/100) - 2020/11/05 17:08:13 ET
Table 'funzzzzzzzz' 9-max (Play Money) Seat #9 is the button
Seat 1: dddocky (8137 in chips) 
Seat 2: Duke Croix (6314 in chips) 
Seat 3: MnnM150 (19057 in chips) 
Seat 4: HighCardJasper (13934 in chips) 
Seat 5: MrOB1reader (12103 in chips) 
Seat 7: appositive (20222 in chips) 
Seat 8: MaFak2019 (8635 in chips) 
Seat 9: JeBoyDirk (19983 in chips) 
dddocky: posts small blind 50
Duke Croix: posts big blind 100
*** HOLE CARDS ***
Dealt to Duke Croix [Kd 3c]
MnnM150: calls 100
HighCardJasper: calls 100
MrOB1reader: calls 100
appositive: calls 100
MaFak2019: calls 100
JeBoyDirk: calls 100
dddocky: calls 50
Duke Croix: checks 
*** FLOP *** [Td 4s 5c]
dddocky: checks 
Duke Croix: checks 
MnnM150: checks 
HighCardJasper: checks 
MrOB1reader: bets 756
appositive: folds 
MaFak2019: folds 
JeBoyDirk: folds 
dddocky: folds 
Duke Croix: folds 
MnnM150: folds 
HighCardJasper: folds 
Uncalled bet (756) returned to MrOB1reader
MrOB1reader collected 756 from pot
MrOB1reader: doesn't show hand 
*** SUMMARY ***
Total pot 800 | Rake 44 
Board [Td 4s 5c]
Seat 1: dddocky (small blind) folded on the Flop
Seat 2: Duke Croix (big blind) folded on the Flop
Seat 3: MnnM150 folded on the Flop
Seat 4: HighCardJasper folded on the Flop
Seat 5: MrOB1reader collected (756)
Seat 7: appositive folded on the Flop
Seat 8: MaFak2019 folded on the Flop
Seat 9: JeBoyDirk (button) folded on the Flop



PokerStars Home Game Hand #220087048738: {Club #3225207}  Hold'em No Limit (50/100) - 2020/11/05 17:09:16 ET
Table 'funzzzzzzzz' 9-max (Play Money) Seat #1 is the button
Seat 1: dddocky (8037 in chips) 
Seat 2: Duke Croix (6214 in chips) 
Seat 3: MnnM150 (18957 in chips) 
Seat 4: HighCardJasper (13834 in chips) 
Seat 5: MrOB1reader (12759 in chips) 
Seat 7: appositive (20122 in chips) 
Seat 8: MaFak2019 (8535 in chips) 
Seat 9: JeBoyDirk (19883 in chips) 
Duke Croix: posts small blind 50
MnnM150: posts big blind 100
*** HOLE CARDS ***
Dealt to Duke Croix [2s Ad]
HighCardJasper: calls 100
MrOB1reader: calls 100
appositive: calls 100
MaFak2019: calls 100
JeBoyDirk: folds 
dddocky: folds 
Duke Croix: calls 50
MnnM150: checks 
*** FLOP *** [Td 6s 2d]
Duke Croix: checks 
MnnM150: checks 
HighCardJasper: checks 
MrOB1reader: checks 
appositive: checks 
MaFak2019: checks 
*** TURN *** [Td 6s 2d] [Th]
Duke Croix: checks 
MnnM150: checks 
HighCardJasper: checks 
MrOB1reader: checks 
appositive: bets 283
MaFak2019: calls 283
Duke Croix: folds 
MnnM150: folds 
HighCardJasper: folds 
MrOB1reader: folds 
*** RIVER *** [Td 6s 2d Th] [2h]
appositive: checks 
MaFak2019: checks 
*** SHOW DOWN ***
appositive: shows [Ac 9s] (two pair, Tens and Deuces)
MaFak2019: mucks hand 
appositive collected 1102 from pot
*** SUMMARY ***
Total pot 1166 | Rake 64 
Board [Td 6s 2d Th 2h]
Seat 1: dddocky (button) folded before Flop (didn't bet)
Seat 2: Duke Croix (small blind) folded on the Turn
Seat 3: MnnM150 (big blind) folded on the Turn
Seat 4: HighCardJasper folded on the Turn
Seat 5: MrOB1reader folded on the Turn
Seat 7: appositive showed [Ac 9s] and won (1102) with two pair, Tens and Deuces
Seat 8: MaFak2019 mucked [8s Js]
Seat 9: JeBoyDirk folded before Flop (didn't bet)



PokerStars Home Game Hand #220087103927: {Club #3225207}  Hold'em No Limit (50/100) - 2020/11/05 17:10:47 ET
Table 'funzzzzzzzz' 9-max (Play Money) Seat #2 is the button
Seat 1: dddocky (8037 in chips) 
Seat 2: Duke Croix (6114 in chips) 
Seat 3: MnnM150 (18857 in chips) 
Seat 4: HighCardJasper (13734 in chips) 
Seat 5: MrOB1reader (12659 in chips) 
Seat 7: appositive (20841 in chips) 
Seat 8: MaFak2019 (8152 in chips) 
Seat 9: JeBoyDirk (19883 in chips) 
MnnM150: posts small blind 50
HighCardJasper: posts big blind 100
*** HOLE CARDS ***
Dealt to Duke Croix [8s Jc]
MrOB1reader: raises 100 to 200
appositive: folds 
MaFak2019: folds 
JeBoyDirk: folds 
dddocky: folds 
Duke Croix: calls 200
MnnM150: calls 150
HighCardJasper: calls 100
*** FLOP *** [4s Ac 3c]
MnnM150: bets 378
HighCardJasper: calls 378
MrOB1reader: folds 
Duke Croix: folds 
*** TURN *** [4s Ac 3c] [Ts]
MnnM150: bets 1470
HighCardJasper: calls 1470
*** RIVER *** [4s Ac 3c Ts] [Kh]
MnnM150: bets 2124
HighCardJasper: calls 2124
*** SHOW DOWN ***
MnnM150: shows [As Qc] (a pair of Aces)
HighCardJasper: shows [4c Td] (two pair, Tens and Fours)
HighCardJasper collected 8263 from pot
*** SUMMARY ***
Total pot 8744 | Rake 481 
Board [4s Ac 3c Ts Kh]
Seat 1: dddocky folded before Flop (didn't bet)
Seat 2: Duke Croix (button) folded on the Flop
Seat 3: MnnM150 (small blind) showed [As Qc] and lost with a pair of Aces
Seat 4: HighCardJasper (big blind) showed [4c Td] and won (8263) with two pair, Tens and Fours
Seat 5: MrOB1reader folded on the Flop
Seat 7: appositive folded before Flop (didn't bet)
Seat 8: MaFak2019 folded before Flop (didn't bet)
Seat 9: JeBoyDirk folded before Flop (didn't bet)



PokerStars Home Game Hand #220087145621: {Club #3225207}  Hold'em No Limit (50/100) - 2020/11/05 17:11:56 ET
Table 'funzzzzzzzz' 9-max (Play Money) Seat #3 is the button
Seat 1: dddocky (8037 in chips) 
Seat 2: Duke Croix (5914 in chips) 
Seat 3: MnnM150 (14685 in chips) 
Seat 4: HighCardJasper (17825 in chips) 
Seat 5: MrOB1reader (12459 in chips) 
Seat 7: appositive (20841 in chips) 
Seat 8: MaFak2019 (8152 in chips) 
Seat 9: JeBoyDirk (19883 in chips) 
HighCardJasper: posts small blind 50
MrOB1reader: posts big blind 100
*** HOLE CARDS ***
Dealt to Duke Croix [9c 5s]
appositive: folds 
MaFak2019: calls 100
JeBoyDirk: folds 
dddocky: folds 
Duke Croix: folds 
MnnM150: calls 100
HighCardJasper: calls 50
MrOB1reader: checks 
*** FLOP *** [4h 6s Ac]
HighCardJasper: checks 
MrOB1reader: checks 
MaFak2019: checks 
MnnM150: checks 
*** TURN *** [4h 6s Ac] [Qh]
HighCardJasper: bets 200
MrOB1reader: folds 
MaFak2019: calls 200
MnnM150: folds 
*** RIVER *** [4h 6s Ac Qh] [3c]
HighCardJasper: bets 500
MaFak2019: raises 500 to 1000
HighCardJasper: calls 500
*** SHOW DOWN ***
MaFak2019: shows [Qs 3d] (two pair, Queens and Threes)
HighCardJasper: shows [6h Qd] (two pair, Queens and Sixes)
HighCardJasper collected 2646 from pot
*** SUMMARY ***
Total pot 2800 | Rake 154 
Board [4h 6s Ac Qh 3c]
Seat 1: dddocky folded before Flop (didn't bet)
Seat 2: Duke Croix folded before Flop (didn't bet)
Seat 3: MnnM150 (button) folded on the Turn
Seat 4: HighCardJasper (small blind) showed [6h Qd] and won (2646) with two pair, Queens and Sixes
Seat 5: MrOB1reader (big blind) folded on the Turn
Seat 7: appositive folded before Flop (didn't bet)
Seat 8: MaFak2019 showed [Qs 3d] and lost with two pair, Queens and Threes
Seat 9: JeBoyDirk folded before Flop (didn't bet)



PokerStars Home Game Hand #220087180401: {Club #3225207}  Hold'em No Limit (50/100) - 2020/11/05 17:12:54 ET
Table 'funzzzzzzzz' 9-max (Play Money) Seat #4 is the button
Seat 1: dddocky (8037 in chips) 
Seat 2: Duke Croix (5914 in chips) 
Seat 3: MnnM150 (14585 in chips) 
Seat 4: HighCardJasper (19171 in chips) 
Seat 5: MrOB1reader (12359 in chips) 
Seat 7: appositive (20841 in chips) 
Seat 8: MaFak2019 (6852 in chips) 
Seat 9: JeBoyDirk (19883 in chips) 
MrOB1reader: posts small blind 50
appositive: posts big blind 100
*** HOLE CARDS ***
Dealt to Duke Croix [9d Jd]
MaFak2019: calls 100
JeBoyDirk: raises 200 to 300
dddocky: calls 300
Duke Croix: calls 300
MnnM150: folds 
HighCardJasper: folds 
MrOB1reader: folds 
appositive: calls 200
MaFak2019: calls 200
*** FLOP *** [4c 3h Ts]
appositive: checks 
MaFak2019: checks 
JeBoyDirk: checks 
dddocky: checks 
Duke Croix: checks 
*** TURN *** [4c 3h Ts] [8h]
appositive: checks 
MaFak2019: checks 
JeBoyDirk: checks 
dddocky: checks 
Duke Croix: bets 700
appositive: calls 700
MaFak2019: folds 
JeBoyDirk: folds 
dddocky: folds 
*** RIVER *** [4c 3h Ts 8h] [3d]
appositive: checks 
Duke Croix: checks 
*** SHOW DOWN ***
appositive: shows [7h Ah] (a pair of Threes)
Duke Croix: mucks hand 
appositive collected 2788 from pot
*** SUMMARY ***
Total pot 2950 | Rake 162 
Board [4c 3h Ts 8h 3d]
Seat 1: dddocky folded on the Turn
Seat 2: Duke Croix mucked [9d Jd]
Seat 3: MnnM150 folded before Flop (didn't bet)
Seat 4: HighCardJasper (button) folded before Flop (didn't bet)
Seat 5: MrOB1reader (small blind) folded before Flop
Seat 7: appositive (big blind) showed [7h Ah] and won (2788) with a pair of Threes
Seat 8: MaFak2019 folded on the Turn
Seat 9: JeBoyDirk folded on the Turn



PokerStars Home Game Hand #220087243717: {Club #3225207}  Hold'em No Limit (50/100) - 2020/11/05 17:14:40 ET
Table 'funzzzzzzzz' 9-max (Play Money) Seat #5 is the button
Seat 1: dddocky (7737 in chips) 
Seat 2: Duke Croix (4914 in chips) 
Seat 3: MnnM150 (14585 in chips) 
Seat 4: HighCardJasper (19171 in chips) 
Seat 5: MrOB1reader (12309 in chips) 
Seat 7: appositive (22629 in chips) 
Seat 8: MaFak2019 (6552 in chips) 
Seat 9: JeBoyDirk (19583 in chips) 
appositive: posts small blind 50
MaFak2019: posts big blind 100
*** HOLE CARDS ***
Dealt to Duke Croix [6s 7c]
JeBoyDirk: folds 
dddocky: calls 100
Duke Croix: calls 100
MnnM150: calls 100
HighCardJasper: calls 100
MrOB1reader: calls 100
appositive: calls 50
MaFak2019: checks 
*** FLOP *** [3h 3d Ad]
appositive: checks 
MaFak2019: bets 400
dddocky: calls 400
Duke Croix: folds 
MnnM150: folds 
HighCardJasper: calls 400
MrOB1reader: folds 
appositive: folds 
*** TURN *** [3h 3d Ad] [8s]
MaFak2019: bets 800
dddocky: calls 800
HighCardJasper: calls 800
*** RIVER *** [3h 3d Ad 8s] [Ks]
MaFak2019: bets 1500
dddocky: folds 
HighCardJasper: calls 1500
*** SHOW DOWN ***
MaFak2019: shows [3c 2d] (three of a kind, Threes)
HighCardJasper: shows [3s Jc] (three of a kind, Threes)
MaFak2019 collected 3449 from pot
HighCardJasper collected 3449 from pot
*** SUMMARY ***
Total pot 7300 | Rake 402 
Board [3h 3d Ad 8s Ks]
Seat 1: dddocky folded on the River
Seat 2: Duke Croix folded on the Flop
Seat 3: MnnM150 folded on the Flop
Seat 4: HighCardJasper showed [3s Jc] and won (3449) with three of a kind, Threes
Seat 5: MrOB1reader (button) folded on the Flop
Seat 7: appositive (small blind) folded on the Flop
Seat 8: MaFak2019 (big blind) showed [3c 2d] and won (3449) with three of a kind, Threes
Seat 9: JeBoyDirk folded before Flop (didn't bet)



PokerStars Home Game Hand #220087290369: {Club #3225207}  Hold'em No Limit (50/100) - 2020/11/05 17:15:57 ET
Table 'funzzzzzzzz' 9-max (Play Money) Seat #7 is the button
Seat 1: dddocky (6437 in chips) 
Seat 2: Duke Croix (4814 in chips) 
Seat 3: MnnM150 (14485 in chips) 
Seat 4: HighCardJasper (19820 in chips) 
Seat 5: MrOB1reader (12209 in chips) 
Seat 7: appositive (22529 in chips) 
Seat 8: MaFak2019 (7201 in chips) 
Seat 9: JeBoyDirk (19583 in chips) 
MaFak2019: posts small blind 50
JeBoyDirk: posts big blind 100
*** HOLE CARDS ***
Dealt to Duke Croix [2c 2d]
dddocky: folds 
Duke Croix: calls 100
MnnM150: calls 100
HighCardJasper: calls 100
MrOB1reader: calls 100
appositive: folds 
MaFak2019: raises 100 to 200
JeBoyDirk: folds 
Duke Croix: calls 100
MnnM150: calls 100
HighCardJasper: calls 100
MrOB1reader: calls 100
*** FLOP *** [Jc Kh 6c]
MaFak2019: checks 
Duke Croix: checks 
MnnM150: checks 
HighCardJasper: bets 100
MrOB1reader: calls 100
MaFak2019: folds 
Duke Croix: folds 
MnnM150: calls 100
*** TURN *** [Jc Kh 6c] [5d]
MnnM150: checks 
HighCardJasper: checks 
MrOB1reader: bets 1323
MnnM150: folds 
HighCardJasper: folds 
Uncalled bet (1323) returned to MrOB1reader
MrOB1reader collected 1323 from pot
MrOB1reader: doesn't show hand 
*** SUMMARY ***
Total pot 1400 | Rake 77 
Board [Jc Kh 6c 5d]
Seat 1: dddocky folded before Flop (didn't bet)
Seat 2: Duke Croix folded on the Flop
Seat 3: MnnM150 folded on the Turn
Seat 4: HighCardJasper folded on the Turn
Seat 5: MrOB1reader collected (1323)
Seat 7: appositive (button) folded before Flop (didn't bet)
Seat 8: MaFak2019 (small blind) folded on the Flop
Seat 9: JeBoyDirk (big blind) folded before Flop



PokerStars Home Game Hand #220087340404: {Club #3225207}  Hold'em No Limit (50/100) - 2020/11/05 17:17:21 ET
Table 'funzzzzzzzz' 9-max (Play Money) Seat #8 is the button
Seat 1: dddocky (6437 in chips) 
Seat 2: Duke Croix (4614 in chips) 
Seat 3: MnnM150 (14185 in chips) 
Seat 4: HighCardJasper (19520 in chips) 
Seat 5: MrOB1reader (13232 in chips) 
Seat 7: appositive (22529 in chips) 
Seat 8: MaFak2019 (7001 in chips) 
Seat 9: JeBoyDirk (19483 in chips) 
JeBoyDirk: posts small blind 50
dddocky: posts big blind 100
*** HOLE CARDS ***
Dealt to Duke Croix [9s 5c]
Duke Croix: folds 
MnnM150: folds 
HighCardJasper: calls 100
MrOB1reader: raises 100 to 200
appositive: calls 200
MaFak2019: calls 200
JeBoyDirk: folds 
dddocky: folds 
HighCardJasper: calls 100
*** FLOP *** [4h Qs 7h]
HighCardJasper: checks 
MrOB1reader: checks 
appositive: bets 449
MaFak2019: folds 
HighCardJasper: folds 
MrOB1reader: folds 
Uncalled bet (449) returned to appositive
appositive collected 898 from pot
appositive: doesn't show hand 
*** SUMMARY ***
Total pot 950 | Rake 52 
Board [4h Qs 7h]
Seat 1: dddocky (big blind) folded before Flop
Seat 2: Duke Croix folded before Flop (didn't bet)
Seat 3: MnnM150 folded before Flop (didn't bet)
Seat 4: HighCardJasper folded on the Flop
Seat 5: MrOB1reader folded on the Flop
Seat 7: appositive collected (898)
Seat 8: MaFak2019 (button) folded on the Flop
Seat 9: JeBoyDirk (small blind) folded before Flop



PokerStars Home Game Hand #220087383055: {Club #3225207}  Hold'em No Limit (50/100) - 2020/11/05 17:18:34 ET
Table 'funzzzzzzzz' 9-max (Play Money) Seat #9 is the button
Seat 1: dddocky (6337 in chips) 
Seat 2: Duke Croix (4614 in chips) 
Seat 3: MnnM150 (14185 in chips) 
Seat 4: HighCardJasper (19320 in chips) 
Seat 5: MrOB1reader (13032 in chips) 
Seat 7: appositive (23227 in chips) 
Seat 8: MaFak2019 (6801 in chips) 
Seat 9: JeBoyDirk (19433 in chips) 
dddocky: posts small blind 50
Duke Croix: posts big blind 100
*** HOLE CARDS ***
Dealt to Duke Croix [Ac 3d]
MnnM150: folds 
HighCardJasper: calls 100
MrOB1reader: calls 100
appositive: folds 
MaFak2019: folds 
JeBoyDirk: folds 
dddocky: folds 
Duke Croix: checks 
*** FLOP *** [Th 9s Js]
Duke Croix: checks 
HighCardJasper: checks 
MrOB1reader: checks 
*** TURN *** [Th 9s Js] [5d]
Duke Croix: checks 
HighCardJasper: bets 200
MrOB1reader: calls 200
Duke Croix: folds 
*** RIVER *** [Th 9s Js 5d] [3h]
HighCardJasper: checks 
MrOB1reader: checks 
*** SHOW DOWN ***
HighCardJasper: shows [5h 9c] (two pair, Nines and Fives)
MrOB1reader: mucks hand 
HighCardJasper collected 709 from pot
*** SUMMARY ***
Total pot 750 | Rake 41 
Board [Th 9s Js 5d 3h]
Seat 1: dddocky (small blind) folded before Flop
Seat 2: Duke Croix (big blind) folded on the Turn
Seat 3: MnnM150 folded before Flop (didn't bet)
Seat 4: HighCardJasper showed [5h 9c] and won (709) with two pair, Nines and Fives
Seat 5: MrOB1reader mucked [Jh 6c]
Seat 7: appositive folded before Flop (didn't bet)
Seat 8: MaFak2019 folded before Flop (didn't bet)
Seat 9: JeBoyDirk (button) folded before Flop (didn't bet)



PokerStars Home Game Hand #220087421167: {Club #3225207}  Hold'em No Limit (50/100) - 2020/11/05 17:19:38 ET
Table 'funzzzzzzzz' 9-max (Play Money) Seat #1 is the button
Seat 1: dddocky (6287 in chips) 
Seat 2: Duke Croix (4514 in chips) 
Seat 3: MnnM150 (14185 in chips) 
Seat 4: HighCardJasper (19729 in chips) 
Seat 5: MrOB1reader (12732 in chips) 
Seat 7: appositive (23227 in chips) 
Seat 8: MaFak2019 (6801 in chips) 
Seat 9: JeBoyDirk (19433 in chips) 
Duke Croix: posts small blind 50
MnnM150: posts big blind 100
*** HOLE CARDS ***
Dealt to Duke Croix [9d 6s]
HighCardJasper: raises 100 to 200
MrOB1reader: calls 200
appositive: calls 200
MaFak2019: calls 200
JeBoyDirk: folds 
dddocky: folds 
Duke Croix: folds 
MnnM150: calls 100
*** FLOP *** [2c Kh 9s]
MnnM150: checks 
HighCardJasper: checks 
MrOB1reader: checks 
appositive: bets 496
MaFak2019: folds 
MnnM150: folds 
HighCardJasper: folds 
MrOB1reader: calls 496
*** TURN *** [2c Kh 9s] [Qs]
MrOB1reader: bets 1930
appositive: folds 
Uncalled bet (1930) returned to MrOB1reader
MrOB1reader collected 1930 from pot
MrOB1reader: doesn't show hand 
*** SUMMARY ***
Total pot 2042 | Rake 112 
Board [2c Kh 9s Qs]
Seat 1: dddocky (button) folded before Flop (didn't bet)
Seat 2: Duke Croix (small blind) folded before Flop
Seat 3: MnnM150 (big blind) folded on the Flop
Seat 4: HighCardJasper folded on the Flop
Seat 5: MrOB1reader collected (1930)
Seat 7: appositive folded on the Turn
Seat 8: MaFak2019 folded on the Flop
Seat 9: JeBoyDirk folded before Flop (didn't bet)



PokerStars Home Game Hand #220087460190: {Club #3225207}  Hold'em No Limit (50/100) - 2020/11/05 17:20:44 ET
Table 'funzzzzzzzz' 9-max (Play Money) Seat #2 is the button
Seat 1: dddocky (6287 in chips) 
Seat 2: Duke Croix (4464 in chips) 
Seat 3: MnnM150 (13985 in chips) 
Seat 4: HighCardJasper (19529 in chips) 
Seat 5: MrOB1reader (13966 in chips) 
Seat 7: appositive (22531 in chips) 
Seat 8: MaFak2019 (6601 in chips) 
Seat 9: JeBoyDirk (19433 in chips) 
MnnM150: posts small blind 50
HighCardJasper: posts big blind 100
*** HOLE CARDS ***
Dealt to Duke Croix [9h 9s]
MrOB1reader: folds 
appositive: calls 100
MaFak2019: raises 100 to 200
JeBoyDirk: folds 
dddocky: folds 
Duke Croix: raises 400 to 600
MnnM150: calls 550
HighCardJasper: calls 500
appositive: calls 500
MaFak2019: calls 400
*** FLOP *** [Qh 9d Js]
MnnM150: checks 
HighCardJasper: checks 
appositive: checks 
MaFak2019: bets 500
Duke Croix: raises 900 to 1400
MnnM150: folds 
HighCardJasper has timed out
HighCardJasper: folds 
appositive: folds 
MaFak2019: calls 900
*** TURN *** [Qh 9d Js] [3s]
MaFak2019: checks 
Duke Croix: bets 2464 and is all-in
MaFak2019: calls 2464
*** RIVER *** [Qh 9d Js 3s] [5s]
*** SHOW DOWN ***
MaFak2019: shows [Jh Th] (a pair of Jacks)
Duke Croix: shows [9h 9s] (three of a kind, Nines)
Duke Croix collected 10138 from pot
*** SUMMARY ***
Total pot 10728 | Rake 590 
Board [Qh 9d Js 3s 5s]
Seat 1: dddocky folded before Flop (didn't bet)
Seat 2: Duke Croix (button) showed [9h 9s] and won (10138) with three of a kind, Nines
Seat 3: MnnM150 (small blind) folded on the Flop
Seat 4: HighCardJasper (big blind) folded on the Flop
Seat 5: MrOB1reader folded before Flop (didn't bet)
Seat 7: appositive folded on the Flop
Seat 8: MaFak2019 showed [Jh Th] and lost with a pair of Jacks
Seat 9: JeBoyDirk folded before Flop (didn't bet)



PokerStars Home Game Hand #220087531922: {Club #3225207}  Hold'em No Limit (50/100) - 2020/11/05 17:22:30 ET
Table 'funzzzzzzzz' 9-max (Play Money) Seat #3 is the button
Seat 1: dddocky (6287 in chips) 
Seat 2: Duke Croix (10138 in chips) 
Seat 3: MnnM150 (13385 in chips) 
Seat 4: HighCardJasper (18929 in chips) 
Seat 5: MrOB1reader (13966 in chips) 
Seat 7: appositive (21931 in chips) 
Seat 8: MaFak2019 (2137 in chips) 
Seat 9: JeBoyDirk (19433 in chips) 
HighCardJasper: posts small blind 50
MrOB1reader: posts big blind 100
*** HOLE CARDS ***
Dealt to Duke Croix [Ad 6h]
appositive: folds 
MaFak2019: calls 100
JeBoyDirk: folds 
dddocky: calls 100
Duke Croix: calls 100
MnnM150: folds 
HighCardJasper: calls 50
MrOB1reader: checks 
*** FLOP *** [8s Js Td]
HighCardJasper: checks 
MrOB1reader: checks 
MaFak2019: checks 
dddocky: checks 
Duke Croix: checks 
*** TURN *** [8s Js Td] [5d]
HighCardJasper: checks 
MrOB1reader: checks 
MaFak2019: checks 
dddocky: bets 200
Duke Croix: folds 
HighCardJasper: folds 
MrOB1reader: folds 
MaFak2019: folds 
Uncalled bet (200) returned to dddocky
dddocky collected 472 from pot
dddocky: doesn't show hand 
*** SUMMARY ***
Total pot 500 | Rake 28 
Board [8s Js Td 5d]
Seat 1: dddocky collected (472)
Seat 2: Duke Croix folded on the Turn
Seat 3: MnnM150 (button) folded before Flop (didn't bet)
Seat 4: HighCardJasper (small blind) folded on the Turn
Seat 5: MrOB1reader (big blind) folded on the Turn
Seat 7: appositive folded before Flop (didn't bet)
Seat 8: MaFak2019 folded on the Turn
Seat 9: JeBoyDirk folded before Flop (didn't bet)



PokerStars Home Game Hand #220087569668: {Club #3225207}  Hold'em No Limit (50/100) - 2020/11/05 17:23:34 ET
Table 'funzzzzzzzz' 9-max (Play Money) Seat #4 is the button
Seat 1: dddocky (6659 in chips) 
Seat 2: Duke Croix (10038 in chips) 
Seat 3: MnnM150 (13385 in chips) 
Seat 4: HighCardJasper (18829 in chips) 
Seat 5: MrOB1reader (13866 in chips) 
Seat 8: MaFak2019 (2037 in chips) 
Seat 9: JeBoyDirk (19433 in chips) 
MrOB1reader: posts small blind 50
MaFak2019: posts big blind 100
*** HOLE CARDS ***
Dealt to Duke Croix [6c 9d]
JeBoyDirk: calls 100
dddocky: calls 100
Duke Croix: folds 
MnnM150: folds 
HighCardJasper: calls 100
MrOB1reader: calls 50
MaFak2019: checks 
*** FLOP *** [Kc Qd 2s]
MrOB1reader: checks 
MaFak2019: bets 300
JeBoyDirk: calls 300
dddocky: calls 300
HighCardJasper: calls 300
MrOB1reader: folds 
*** TURN *** [Kc Qd 2s] [3s]
MaFak2019: checks 
JeBoyDirk: bets 700
dddocky: calls 700
HighCardJasper: folds 
MaFak2019: calls 700
*** RIVER *** [Kc Qd 2s 3s] [Ac]
MaFak2019: checks 
JeBoyDirk: checks 
dddocky: checks 
*** SHOW DOWN ***
MaFak2019: shows [5s Qs] (a pair of Queens)
JeBoyDirk: shows [Kd Tc] (a pair of Kings)
dddocky: shows [Kh Td] (a pair of Kings)
JeBoyDirk collected 1796 from pot
dddocky collected 1795 from pot
*** SUMMARY ***
Total pot 3800 | Rake 209 
Board [Kc Qd 2s 3s Ac]
Seat 1: dddocky showed [Kh Td] and won (1795) with a pair of Kings
Seat 2: Duke Croix folded before Flop (didn't bet)
Seat 3: MnnM150 folded before Flop (didn't bet)
Seat 4: HighCardJasper (button) folded on the Turn
Seat 5: MrOB1reader (small blind) folded on the Flop
Seat 8: MaFak2019 (big blind) showed [5s Qs] and lost with a pair of Queens
Seat 9: JeBoyDirk showed [Kd Tc] and won (1796) with a pair of Kings



PokerStars Home Game Hand #220087624179: {Club #3225207}  Hold'em No Limit (50/100) - 2020/11/05 17:25:07 ET
Table 'funzzzzzzzz' 9-max (Play Money) Seat #5 is the button
Seat 1: dddocky (7354 in chips) 
Seat 2: Duke Croix (10038 in chips) 
Seat 3: MnnM150 (13385 in chips) 
Seat 4: HighCardJasper (18429 in chips) 
Seat 5: MrOB1reader (13766 in chips) 
Seat 8: MaFak2019 (937 in chips) 
Seat 9: JeBoyDirk (20129 in chips) 
MaFak2019: posts small blind 50
JeBoyDirk: posts big blind 100
*** HOLE CARDS ***
Dealt to Duke Croix [9s 6c]
dddocky: calls 100
Duke Croix: folds 
MnnM150: calls 100
HighCardJasper: calls 100
MrOB1reader: folds 
MaFak2019: folds 
JeBoyDirk: checks 
*** FLOP *** [8d Jh Tc]
JeBoyDirk: checks 
dddocky: checks 
MnnM150: checks 
HighCardJasper: checks 
*** TURN *** [8d Jh Tc] [9c]
JeBoyDirk: checks 
dddocky: checks 
MnnM150: bets 212
HighCardJasper: calls 212
JeBoyDirk: folds 
dddocky: folds 
*** RIVER *** [8d Jh Tc 9c] [Th]
MnnM150: bets 413
HighCardJasper: calls 413
*** SHOW DOWN ***
MnnM150: shows [Ah 7h] (a straight, Seven to Jack)
HighCardJasper: shows [7s 8c] (a straight, Seven to Jack)
MnnM150 collected 803 from pot
HighCardJasper collected 803 from pot
*** SUMMARY ***
Total pot 1700 | Rake 94 
Board [8d Jh Tc 9c Th]
Seat 1: dddocky folded on the Turn
Seat 2: Duke Croix folded before Flop (didn't bet)
Seat 3: MnnM150 showed [Ah 7h] and won (803) with a straight, Seven to Jack
Seat 4: HighCardJasper showed [7s 8c] and won (803) with a straight, Seven to Jack
Seat 5: MrOB1reader (button) folded before Flop (didn't bet)
Seat 8: MaFak2019 (small blind) folded before Flop
Seat 9: JeBoyDirk (big blind) folded on the Turn



PokerStars Home Game Hand #220087661240: {Club #3225207}  Hold'em No Limit (50/100) - 2020/11/05 17:26:10 ET
Table 'funzzzzzzzz' 9-max (Play Money) Seat #8 is the button
Seat 1: dddocky (7254 in chips) 
Seat 2: Duke Croix (10038 in chips) 
Seat 3: MnnM150 (13463 in chips) 
Seat 4: HighCardJasper (18507 in chips) 
Seat 5: MrOB1reader (13766 in chips) 
Seat 7: appositive (21931 in chips) 
Seat 8: MaFak2019 (887 in chips) 
Seat 9: JeBoyDirk (20029 in chips) 
JeBoyDirk: posts small blind 50
dddocky: posts big blind 100
appositive: posts small & big blinds 150
*** HOLE CARDS ***
Dealt to Duke Croix [5d Qc]
Duke Croix: folds 
MnnM150: calls 100
HighCardJasper: calls 100
MrOB1reader: calls 100
appositive: raises 100 to 200
MaFak2019: folds 
JeBoyDirk: calls 150
dddocky: calls 100
MnnM150: calls 100
HighCardJasper: calls 100
MrOB1reader: calls 100
*** FLOP *** [9s 2d Ad]
JeBoyDirk: checks 
dddocky: checks 
MnnM150: checks 
HighCardJasper: checks 
MrOB1reader: checks 
appositive: bets 590
JeBoyDirk: folds 
dddocky: folds 
MnnM150: calls 590
HighCardJasper: folds 
MrOB1reader: folds 
*** TURN *** [9s 2d Ad] [5s]
MnnM150: checks 
appositive: bets 2296
MnnM150: folds 
Uncalled bet (2296) returned to appositive
appositive collected 2296 from pot
appositive: doesn't show hand 
*** SUMMARY ***
Total pot 2430 | Rake 134 
Board [9s 2d Ad 5s]
Seat 1: dddocky (big blind) folded on the Flop
Seat 2: Duke Croix folded before Flop (didn't bet)
Seat 3: MnnM150 folded on the Turn
Seat 4: HighCardJasper folded on the Flop
Seat 5: MrOB1reader folded on the Flop
Seat 7: appositive collected (2296)
Seat 8: MaFak2019 (button) folded before Flop (didn't bet)
Seat 9: JeBoyDirk (small blind) folded on the Flop



PokerStars Home Game Hand #220087711545: {Club #3225207}  Hold'em No Limit (50/100) - 2020/11/05 17:27:37 ET
Table 'funzzzzzzzz' 9-max (Play Money) Seat #9 is the button
Seat 1: dddocky (7054 in chips) 
Seat 2: Duke Croix (10038 in chips) 
Seat 3: MnnM150 (12673 in chips) 
Seat 4: HighCardJasper (18307 in chips) 
Seat 5: MrOB1reader (13566 in chips) 
Seat 7: appositive (23387 in chips) 
Seat 8: MaFak2019 (887 in chips) 
Seat 9: JeBoyDirk (19829 in chips) 
dddocky: posts small blind 50
Duke Croix: posts big blind 100
*** HOLE CARDS ***
Dealt to Duke Croix [8c 7s]
MnnM150: folds 
HighCardJasper: calls 100
MrOB1reader: calls 100
appositive: calls 100
MaFak2019: folds 
JeBoyDirk: calls 100
dddocky: calls 50
Duke Croix: checks 
*** FLOP *** [Th Jc 7d]
dddocky: bets 300
Duke Croix: folds 
HighCardJasper: calls 300
MrOB1reader: folds 
appositive: folds 
JeBoyDirk: calls 300
*** TURN *** [Th Jc 7d] [3h]
dddocky: bets 708
HighCardJasper: folds 
JeBoyDirk: folds 
Uncalled bet (708) returned to dddocky
dddocky collected 1417 from pot
dddocky: doesn't show hand 
*** SUMMARY ***
Total pot 1500 | Rake 83 
Board [Th Jc 7d 3h]
Seat 1: dddocky (small blind) collected (1417)
Seat 2: Duke Croix (big blind) folded on the Flop
Seat 3: MnnM150 folded before Flop (didn't bet)
Seat 4: HighCardJasper folded on the Turn
Seat 5: MrOB1reader folded on the Flop
Seat 7: appositive folded on the Flop
Seat 8: MaFak2019 folded before Flop (didn't bet)
Seat 9: JeBoyDirk (button) folded on the Turn



PokerStars Home Game Hand #220087754963: {Club #3225207}  Hold'em No Limit (50/100) - 2020/11/05 17:28:52 ET
Table 'funzzzzzzzz' 9-max (Play Money) Seat #1 is the button
Seat 1: dddocky (8071 in chips) 
Seat 2: Duke Croix (9938 in chips) 
Seat 3: MnnM150 (12673 in chips) 
Seat 4: HighCardJasper (17907 in chips) 
Seat 5: MrOB1reader (13466 in chips) 
Seat 7: appositive (23287 in chips) 
Seat 8: MaFak2019 (887 in chips) 
Seat 9: JeBoyDirk (19429 in chips) 
Duke Croix: posts small blind 50
MnnM150: posts big blind 100
*** HOLE CARDS ***
Dealt to Duke Croix [6d 2s]
HighCardJasper: calls 100
MrOB1reader: folds 
appositive: folds 
MaFak2019: calls 100
JeBoyDirk: folds 
dddocky: folds 
Duke Croix: folds 
MnnM150: checks 
*** FLOP *** [Qc Jd Ks]
MnnM150: bets 331
HighCardJasper: calls 331
MaFak2019: raises 456 to 787 and is all-in
MnnM150: calls 456
HighCardJasper: calls 456
*** TURN *** [Qc Jd Ks] [4h]
MnnM150: checks 
HighCardJasper: checks 
*** RIVER *** [Qc Jd Ks 4h] [Th]
MnnM150: checks 
HighCardJasper: bets 2562
MnnM150: folds 
Uncalled bet (2562) returned to HighCardJasper
*** SHOW DOWN ***
HighCardJasper: shows [Qd Kh] (two pair, Kings and Queens)
MaFak2019: shows [Jh 9c] (a straight, Nine to King)
MaFak2019 collected 2562 from pot
*** SUMMARY ***
Total pot 2711 | Rake 149 
Board [Qc Jd Ks 4h Th]
Seat 1: dddocky (button) folded before Flop (didn't bet)
Seat 2: Duke Croix (small blind) folded before Flop
Seat 3: MnnM150 (big blind) folded on the River
Seat 4: HighCardJasper showed [Qd Kh] and lost with two pair, Kings and Queens
Seat 5: MrOB1reader folded before Flop (didn't bet)
Seat 7: appositive folded before Flop (didn't bet)
Seat 8: MaFak2019 showed [Jh 9c] and won (2562) with a straight, Nine to King
Seat 9: JeBoyDirk folded before Flop (didn't bet)



PokerStars Home Game Hand #220087783845: {Club #3225207}  Hold'em No Limit (50/100) - 2020/11/05 17:29:41 ET
Table 'funzzzzzzzz' 9-max (Play Money) Seat #2 is the button
Seat 1: dddocky (8071 in chips) 
Seat 2: Duke Croix (9888 in chips) 
Seat 3: MnnM150 (11786 in chips) 
Seat 4: HighCardJasper (17020 in chips) 
Seat 5: MrOB1reader (13466 in chips) 
Seat 7: appositive (23287 in chips) 
Seat 8: MaFak2019 (2562 in chips) 
Seat 9: JeBoyDirk (19429 in chips) 
MnnM150: posts small blind 50
HighCardJasper: posts big blind 100
*** HOLE CARDS ***
Dealt to Duke Croix [9d Jd]
MrOB1reader: folds 
appositive: folds 
MaFak2019: calls 100
JeBoyDirk has timed out
JeBoyDirk: folds 
dddocky: calls 100
Duke Croix: calls 100
MnnM150: calls 50
HighCardJasper: checks 
*** FLOP *** [8c 6h 7d]
MnnM150: checks 
HighCardJasper: bets 100
MaFak2019: calls 100
dddocky: folds 
Duke Croix: calls 100
MnnM150: folds 
*** TURN *** [8c 6h 7d] [Th]
HighCardJasper: bets 200
MaFak2019: raises 200 to 400
Duke Croix: raises 300 to 700
HighCardJasper: calls 500
MaFak2019: raises 1662 to 2362 and is all-in
Duke Croix: calls 1662
HighCardJasper: folds 
*** RIVER *** [8c 6h 7d Th] [Ks]
*** SHOW DOWN ***
MaFak2019: shows [As 9h] (a straight, Six to Ten)
Duke Croix: shows [9d Jd] (a straight, Seven to Jack)
Duke Croix collected 5882 from pot
*** SUMMARY ***
Total pot 6224 | Rake 342 
Board [8c 6h 7d Th Ks]
Seat 1: dddocky folded on the Flop
Seat 2: Duke Croix (button) showed [9d Jd] and won (5882) with a straight, Seven to Jack
Seat 3: MnnM150 (small blind) folded on the Flop
Seat 4: HighCardJasper (big blind) folded on the Turn
Seat 5: MrOB1reader folded before Flop (didn't bet)
Seat 7: appositive folded before Flop (didn't bet)
Seat 8: MaFak2019 showed [As 9h] and lost with a straight, Six to Ten
Seat 9: JeBoyDirk folded before Flop (didn't bet)



PokerStars Home Game Hand #220087827471: {Club #3225207}  Hold'em No Limit (50/100) - 2020/11/05 17:30:56 ET
Table 'funzzzzzzzz' 9-max (Play Money) Seat #3 is the button
Seat 1: dddocky (7971 in chips) 
Seat 2: Duke Croix (13208 in chips) 
Seat 3: MnnM150 (11686 in chips) 
Seat 4: HighCardJasper (16120 in chips) 
Seat 5: MrOB1reader (13466 in chips) 
Seat 7: appositive (23287 in chips) 
Seat 9: JeBoyDirk (19429 in chips) 
HighCardJasper: posts small blind 50
MrOB1reader: posts big blind 100
*** HOLE CARDS ***
Dealt to Duke Croix [Ad Ts]
appositive: folds 
JeBoyDirk: folds 
dddocky: folds 
Duke Croix: raises 300 to 400
MnnM150: calls 400
HighCardJasper: calls 350
MrOB1reader: calls 300
*** FLOP *** [5d 7c 4d]
HighCardJasper: checks 
MrOB1reader: checks 
Duke Croix: bets 900
MnnM150: folds 
HighCardJasper: folds 
MrOB1reader: folds 
Uncalled bet (900) returned to Duke Croix
Duke Croix collected 1512 from pot
*** SUMMARY ***
Total pot 1600 | Rake 88 
Board [5d 7c 4d]
Seat 1: dddocky folded before Flop (didn't bet)
Seat 2: Duke Croix collected (1512)
Seat 3: MnnM150 (button) folded on the Flop
Seat 4: HighCardJasper (small blind) folded on the Flop
Seat 5: MrOB1reader (big blind) folded on the Flop
Seat 7: appositive folded before Flop (didn't bet)
Seat 9: JeBoyDirk folded before Flop (didn't bet)



PokerStars Home Game Hand #220087857684: {Club #3225207}  Hold'em No Limit (50/100) - 2020/11/05 17:31:49 ET
Table 'funzzzzzzzz' 9-max (Play Money) Seat #4 is the button
Seat 1: dddocky (7971 in chips) 
Seat 2: Duke Croix (14320 in chips) 
Seat 3: MnnM150 (11286 in chips) 
Seat 4: HighCardJasper (15720 in chips) 
Seat 5: MrOB1reader (13066 in chips) 
Seat 7: appositive (23287 in chips) 
Seat 9: JeBoyDirk (19429 in chips) 
MrOB1reader: posts small blind 50
appositive: posts big blind 100
*** HOLE CARDS ***
Dealt to Duke Croix [5d 4c]
JeBoyDirk: folds 
MaFak2019 is disconnected 
dddocky: folds 
Duke Croix: calls 100
MnnM150: folds 
HighCardJasper: calls 100
MrOB1reader: calls 50
appositive: raises 100 to 200
Duke Croix: calls 100
HighCardJasper: calls 100
MrOB1reader: calls 100
*** FLOP *** [9d Ts Tc]
MrOB1reader: checks 
appositive: checks 
Duke Croix: checks 
HighCardJasper: checks 
*** TURN *** [9d Ts Tc] [Kd]
MrOB1reader: bets 756
appositive: folds 
Duke Croix: folds 
HighCardJasper: folds 
Uncalled bet (756) returned to MrOB1reader
MrOB1reader collected 756 from pot
MrOB1reader: doesn't show hand 
*** SUMMARY ***
Total pot 800 | Rake 44 
Board [9d Ts Tc Kd]
Seat 1: dddocky folded before Flop (didn't bet)
Seat 2: Duke Croix folded on the Turn
Seat 3: MnnM150 folded before Flop (didn't bet)
Seat 4: HighCardJasper (button) folded on the Turn
Seat 5: MrOB1reader (small blind) collected (756)
Seat 7: appositive (big blind) folded on the Turn
Seat 9: JeBoyDirk folded before Flop (didn't bet)



PokerStars Home Game Hand #220087897093: {Club #3225207}  Hold'em No Limit (50/100) - 2020/11/05 17:32:43 ET
Table 'funzzzzzzzz' 9-max (Play Money) Seat #5 is the button
Seat 1: dddocky (7971 in chips) 
Seat 2: Duke Croix (14120 in chips) 
Seat 3: MnnM150 (11286 in chips) 
Seat 4: HighCardJasper (15520 in chips) 
Seat 5: MrOB1reader (13622 in chips) 
Seat 7: appositive (23087 in chips) 
Seat 9: JeBoyDirk (19429 in chips) 
appositive: posts small blind 50
JeBoyDirk: posts big blind 100
*** HOLE CARDS ***
Dealt to Duke Croix [Ac Ah]
dddocky: calls 100
Duke Croix: raises 400 to 500
MnnM150: folds 
HighCardJasper: folds 
MrOB1reader: folds 
appositive: folds 
JeBoyDirk: folds 
dddocky: folds 
Uncalled bet (400) returned to Duke Croix
Duke Croix collected 350 from pot
*** SUMMARY ***
Total pot 350 | Rake 0 
Seat 1: dddocky folded before Flop
Seat 2: Duke Croix collected (350)
Seat 3: MnnM150 folded before Flop (didn't bet)
Seat 4: HighCardJasper folded before Flop (didn't bet)
Seat 5: MrOB1reader (button) folded before Flop (didn't bet)
Seat 7: appositive (small blind) folded before Flop
Seat 9: JeBoyDirk (big blind) folded before Flop



PokerStars Home Game Hand #220087911984: {Club #3225207}  Hold'em No Limit (50/100) - 2020/11/05 17:33:09 ET
Table 'funzzzzzzzz' 9-max (Play Money) Seat #7 is the button
Seat 1: dddocky (7871 in chips) 
Seat 2: Duke Croix (14370 in chips) 
Seat 3: MnnM150 (11286 in chips) 
Seat 4: HighCardJasper (15520 in chips) 
Seat 5: MrOB1reader (13622 in chips) 
Seat 7: appositive (23037 in chips) 
Seat 9: JeBoyDirk (19329 in chips) 
JeBoyDirk: posts small blind 50
dddocky: posts big blind 100
*** HOLE CARDS ***
Dealt to Duke Croix [Ad 8c]
Duke Croix: calls 100
MnnM150: folds 
HighCardJasper: raises 100 to 200
MrOB1reader: raises 100 to 300
appositive: folds 
JeBoyDirk: folds 
dddocky: folds 
Duke Croix: calls 200
HighCardJasper: calls 100
*** FLOP *** [Qd 6h Ts]
Duke Croix: checks 
HighCardJasper: checks 
MrOB1reader: checks 
*** TURN *** [Qd 6h Ts] [Kd]
Duke Croix: checks 
HighCardJasper: checks 
MrOB1reader: bets 496
Duke Croix: folds 
HighCardJasper: folds 
Uncalled bet (496) returned to MrOB1reader
MrOB1reader collected 992 from pot
MrOB1reader: doesn't show hand 
*** SUMMARY ***
Total pot 1050 | Rake 58 
Board [Qd 6h Ts Kd]
Seat 1: dddocky (big blind) folded before Flop
Seat 2: Duke Croix folded on the Turn
Seat 3: MnnM150 folded before Flop (didn't bet)
Seat 4: HighCardJasper folded on the Turn
Seat 5: MrOB1reader collected (992)
Seat 7: appositive (button) folded before Flop (didn't bet)
Seat 9: JeBoyDirk (small blind) folded before Flop



PokerStars Home Game Hand #220087943137: {Club #3225207}  Hold'em No Limit (50/100) - 2020/11/05 17:34:04 ET
Table 'funzzzzzzzz' 9-max (Play Money) Seat #9 is the button
Seat 1: dddocky (7771 in chips) 
Seat 2: Duke Croix (14070 in chips) 
Seat 3: MnnM150 (11286 in chips) 
Seat 4: HighCardJasper (15220 in chips) 
Seat 5: MrOB1reader (14314 in chips) 
Seat 7: appositive (23037 in chips) 
Seat 9: JeBoyDirk (19279 in chips) 
dddocky: posts small blind 50
Duke Croix: posts big blind 100
*** HOLE CARDS ***
Dealt to Duke Croix [2h 4s]
MnnM150: folds 
HighCardJasper: calls 100
MrOB1reader: calls 100
appositive: calls 100
JeBoyDirk: calls 100
dddocky: folds 
Duke Croix: checks 
*** FLOP *** [Ad Qh Js]
Duke Croix: checks 
HighCardJasper: checks 
MrOB1reader: checks 
appositive: bets 520
JeBoyDirk: raises 520 to 1040
Duke Croix: folds 
HighCardJasper: folds 
MrOB1reader: folds 
appositive: calls 520
*** TURN *** [Ad Qh Js] [8c]
appositive: bets 1242
JeBoyDirk: raises 1242 to 2484
appositive: folds 
Uncalled bet (1242) returned to JeBoyDirk
JeBoyDirk collected 4833 from pot
*** SUMMARY ***
Total pot 5114 | Rake 281 
Board [Ad Qh Js 8c]
Seat 1: dddocky (small blind) folded before Flop
Seat 2: Duke Croix (big blind) folded on the Flop
Seat 3: MnnM150 folded before Flop (didn't bet)
Seat 4: HighCardJasper folded on the Flop
Seat 5: MrOB1reader folded on the Flop
Seat 7: appositive folded on the Turn
Seat 9: JeBoyDirk (button) collected (4833)



PokerStars Home Game Hand #220087990960: {Club #3225207}  Hold'em No Limit (50/100) - 2020/11/05 17:35:28 ET
Table 'funzzzzzzzz' 9-max (Play Money) Seat #1 is the button
Seat 1: dddocky (7721 in chips) 
Seat 2: Duke Croix (13970 in chips) 
Seat 3: MnnM150 (11286 in chips) 
Seat 4: HighCardJasper (15120 in chips) 
Seat 5: MrOB1reader (14214 in chips) 
Seat 7: appositive (20655 in chips) 
Seat 9: JeBoyDirk (21730 in chips) 
Duke Croix: posts small blind 50
MnnM150: posts big blind 100
*** HOLE CARDS ***
Dealt to Duke Croix [3c Kh]
HighCardJasper: calls 100
MrOB1reader: folds 
appositive: folds 
JeBoyDirk: folds 
dddocky: folds 
Duke Croix: calls 50
MnnM150: checks 
*** FLOP *** [Td 2c Kd]
Duke Croix: bets 200
MnnM150: folds 
HighCardJasper: calls 200
*** TURN *** [Td 2c Kd] [Ad]
Duke Croix: checks 
HighCardJasper: bets 400
Duke Croix: calls 400
*** RIVER *** [Td 2c Kd Ad] [5h]
Duke Croix: checks 
HighCardJasper: checks 
*** SHOW DOWN ***
Duke Croix: shows [3c Kh] (a pair of Kings)
HighCardJasper: shows [7d Ah] (a pair of Aces)
HighCardJasper collected 1417 from pot
*** SUMMARY ***
Total pot 1500 | Rake 83 
Board [Td 2c Kd Ad 5h]
Seat 1: dddocky (button) folded before Flop (didn't bet)
Seat 2: Duke Croix (small blind) showed [3c Kh] and lost with a pair of Kings
Seat 3: MnnM150 (big blind) folded on the Flop
Seat 4: HighCardJasper showed [7d Ah] and won (1417) with a pair of Aces
Seat 5: MrOB1reader folded before Flop (didn't bet)
Seat 7: appositive folded before Flop (didn't bet)
Seat 9: JeBoyDirk folded before Flop (didn't bet)



PokerStars Home Game Hand #220088017893: {Club #3225207}  Hold'em No Limit (50/100) - 2020/11/05 17:36:16 ET
Table 'funzzzzzzzz' 9-max (Play Money) Seat #2 is the button
Seat 1: dddocky (7721 in chips) 
Seat 2: Duke Croix (13270 in chips) 
Seat 3: MnnM150 (11186 in chips) 
Seat 4: HighCardJasper (15837 in chips) 
Seat 5: MrOB1reader (14214 in chips) 
Seat 7: appositive (20655 in chips) 
Seat 9: JeBoyDirk (21730 in chips) 
MnnM150: posts small blind 50
HighCardJasper: posts big blind 100
*** HOLE CARDS ***
Dealt to Duke Croix [3c Ah]
MrOB1reader: folds 
appositive has timed out
appositive: folds 
JeBoyDirk: folds 
dddocky: raises 100 to 200
Duke Croix: calls 200
MnnM150: calls 150
HighCardJasper: calls 100
*** FLOP *** [9d Th Ad]
MnnM150: checks 
HighCardJasper: checks 
dddocky: bets 200
Duke Croix: raises 400 to 600
MnnM150: folds 
HighCardJasper: folds 
dddocky: calls 400
*** TURN *** [9d Th Ad] [9s]
dddocky: bets 100
Duke Croix: raises 1100 to 1200
dddocky: folds 
Uncalled bet (1100) returned to Duke Croix
Duke Croix collected 2079 from pot
*** SUMMARY ***
Total pot 2200 | Rake 121 
Board [9d Th Ad 9s]
Seat 1: dddocky folded on the Turn
Seat 2: Duke Croix (button) collected (2079)
Seat 3: MnnM150 (small blind) folded on the Flop
Seat 4: HighCardJasper (big blind) folded on the Flop
Seat 5: MrOB1reader folded before Flop (didn't bet)
Seat 7: appositive folded before Flop (didn't bet)
Seat 9: JeBoyDirk folded before Flop (didn't bet)



PokerStars Home Game Hand #220088057827: {Club #3225207}  Hold'em No Limit (50/100) - 2020/11/05 17:37:27 ET
Table 'funzzzzzzzz' 9-max (Play Money) Seat #3 is the button
Seat 1: dddocky (6821 in chips) 
Seat 2: Duke Croix (14449 in chips) 
Seat 3: MnnM150 (10986 in chips) 
Seat 4: HighCardJasper (15637 in chips) 
Seat 5: MrOB1reader (14214 in chips) 
Seat 7: appositive (20655 in chips) 
Seat 9: JeBoyDirk (21730 in chips) 
HighCardJasper: posts small blind 50
MrOB1reader: posts big blind 100
*** HOLE CARDS ***
Dealt to Duke Croix [4h Ad]
appositive: calls 100
JeBoyDirk: folds 
dddocky: calls 100
Duke Croix: calls 100
MnnM150: calls 100
HighCardJasper: calls 50
MrOB1reader: checks 
*** FLOP *** [5h Th Kd]
HighCardJasper: bets 200
MrOB1reader: raises 500 to 700
appositive: folds 
dddocky: folds 
Duke Croix: folds 
MnnM150: calls 700
HighCardJasper: folds 
*** TURN *** [5h Th Kd] [Td]
MrOB1reader: checks 
MnnM150: checks 
*** RIVER *** [5h Th Kd Td] [Kh]
MrOB1reader: checks 
MnnM150: bets 2079
MrOB1reader: folds 
Uncalled bet (2079) returned to MnnM150
MnnM150 collected 2079 from pot
*** SUMMARY ***
Total pot 2200 | Rake 121 
Board [5h Th Kd Td Kh]
Seat 1: dddocky folded on the Flop
Seat 2: Duke Croix folded on the Flop
Seat 3: MnnM150 (button) collected (2079)
Seat 4: HighCardJasper (small blind) folded on the Flop
Seat 5: MrOB1reader (big blind) folded on the River
Seat 7: appositive folded on the Flop
Seat 9: JeBoyDirk folded before Flop (didn't bet)



PokerStars Home Game Hand #220088103213: {Club #3225207}  Hold'em No Limit (50/100) - 2020/11/05 17:38:47 ET
Table 'funzzzzzzzz' 9-max (Play Money) Seat #4 is the button
Seat 1: dddocky (6721 in chips) 
Seat 2: Duke Croix (14349 in chips) 
Seat 3: MnnM150 (12265 in chips) 
Seat 4: HighCardJasper (15337 in chips) 
Seat 5: MrOB1reader (13414 in chips) 
Seat 7: appositive (20555 in chips) 
Seat 9: JeBoyDirk (21730 in chips) 
MrOB1reader: posts small blind 50
appositive: posts big blind 100
*** HOLE CARDS ***
Dealt to Duke Croix [8c 6d]
JeBoyDirk: raises 400 to 500
dddocky: folds 
Duke Croix: folds 
MnnM150: calls 500
HighCardJasper: calls 500
MrOB1reader: raises 400 to 900
appositive: folds 
JeBoyDirk: calls 400
MnnM150: calls 400
HighCardJasper: calls 400
*** FLOP *** [4s 9s 4h]
MrOB1reader: bets 1748
JeBoyDirk: folds 
MnnM150: folds 
HighCardJasper: folds 
Uncalled bet (1748) returned to MrOB1reader
MrOB1reader collected 3496 from pot
MrOB1reader: doesn't show hand 
*** SUMMARY ***
Total pot 3700 | Rake 204 
Board [4s 9s 4h]
Seat 1: dddocky folded before Flop (didn't bet)
Seat 2: Duke Croix folded before Flop (didn't bet)
Seat 3: MnnM150 folded on the Flop
Seat 4: HighCardJasper (button) folded on the Flop
Seat 5: MrOB1reader (small blind) collected (3496)
Seat 7: appositive (big blind) folded before Flop
Seat 9: JeBoyDirk folded on the Flop



PokerStars Home Game Hand #220088126131: {Club #3225207}  Hold'em No Limit (50/100) - 2020/11/05 17:39:28 ET
Table 'funzzzzzzzz' 9-max (Play Money) Seat #5 is the button
Seat 1: dddocky (6721 in chips) 
Seat 2: Duke Croix (14349 in chips) 
Seat 3: MnnM150 (11365 in chips) 
Seat 4: HighCardJasper (14437 in chips) 
Seat 5: MrOB1reader (16010 in chips) 
Seat 7: appositive (20455 in chips) 
Seat 9: JeBoyDirk (20830 in chips) 
appositive: posts small blind 50
JeBoyDirk: posts big blind 100
*** HOLE CARDS ***
Dealt to Duke Croix [9d 6c]
dddocky: folds 
Duke Croix has timed out
Duke Croix: folds 
MnnM150: calls 100
HighCardJasper: raises 100 to 200
MrOB1reader: folds 
appositive: calls 150
JeBoyDirk: calls 100
MnnM150: calls 100
*** FLOP *** [Qd Th 2c]
appositive: checks 
JeBoyDirk: checks 
MnnM150: checks 
HighCardJasper: checks 
*** TURN *** [Qd Th 2c] [4h]
appositive: bets 756
JeBoyDirk: calls 756
MnnM150: folds 
HighCardJasper: folds 
*** RIVER *** [Qd Th 2c 4h] [8h]
appositive: bets 19499 and is all-in
JeBoyDirk has timed out
JeBoyDirk: folds 
Uncalled bet (19499) returned to appositive
appositive collected 2185 from pot
appositive: doesn't show hand 
*** SUMMARY ***
Total pot 2312 | Rake 127 
Board [Qd Th 2c 4h 8h]
Seat 1: dddocky folded before Flop (didn't bet)
Seat 2: Duke Croix folded before Flop (didn't bet)
Seat 3: MnnM150 folded on the Turn
Seat 4: HighCardJasper folded on the Turn
Seat 5: MrOB1reader (button) folded before Flop (didn't bet)
Seat 7: appositive (small blind) collected (2185)
Seat 9: JeBoyDirk (big blind) folded on the River



PokerStars Home Game Hand #220088167846: {Club #3225207}  Hold'em No Limit (50/100) - 2020/11/05 17:40:43 ET
Table 'funzzzzzzzz' 9-max (Play Money) Seat #7 is the button
Seat 1: dddocky (6721 in chips) 
Seat 2: Duke Croix (14349 in chips) 
Seat 3: MnnM150 (11165 in chips) 
Seat 4: HighCardJasper (14237 in chips) 
Seat 5: MrOB1reader (16010 in chips) 
Seat 7: appositive (21684 in chips) 
dddocky: posts small blind 50
Duke Croix: posts big blind 100
*** HOLE CARDS ***
Dealt to Duke Croix [Ad Jd]
MnnM150: folds 
HighCardJasper: calls 100
MrOB1reader: folds 
appositive: folds 
dddocky: folds 
Duke Croix: raises 300 to 400
HighCardJasper: calls 300
*** FLOP *** [4h Kh Ts]
Duke Croix: checks 
HighCardJasper: checks 
*** TURN *** [4h Kh Ts] [As]
Duke Croix: bets 500
HighCardJasper: calls 500
*** RIVER *** [4h Kh Ts As] [9d]
Duke Croix: checks 
HighCardJasper: bets 1000
Duke Croix: folds 
Uncalled bet (1000) returned to HighCardJasper
HighCardJasper collected 1748 from pot
HighCardJasper: doesn't show hand 
*** SUMMARY ***
Total pot 1850 | Rake 102 
Board [4h Kh Ts As 9d]
Seat 1: dddocky (small blind) folded before Flop
Seat 2: Duke Croix (big blind) folded on the River
Seat 3: MnnM150 folded before Flop (didn't bet)
Seat 4: HighCardJasper collected (1748)
Seat 5: MrOB1reader folded before Flop (didn't bet)
Seat 7: appositive (button) folded before Flop (didn't bet)



PokerStars Home Game Hand #220088201848: {Club #3225207}  Hold'em No Limit (50/100) - 2020/11/05 17:41:45 ET
Table 'funzzzzzzzz' 9-max (Play Money) Seat #1 is the button
Seat 1: dddocky (6671 in chips) 
Seat 2: Duke Croix (13449 in chips) 
Seat 3: MnnM150 (11165 in chips) 
Seat 4: HighCardJasper (15085 in chips) 
Seat 5: MrOB1reader (16010 in chips) 
Seat 7: appositive (21684 in chips) 
Seat 9: JeBoyDirk (19874 in chips) 
Duke Croix: posts small blind 50
MnnM150: posts big blind 100
JeBoyDirk: posts small blind 50
*** HOLE CARDS ***
Dealt to Duke Croix [Th Kh]
MaFak2019 was removed from the table for failing to post
MaFak2019 leaves the table
HighCardJasper: calls 100
MrOB1reader: calls 100
appositive: folds 
JeBoyDirk: calls 100
dddocky: calls 100
Duke Croix: calls 50
MnnM150: checks 
*** FLOP *** [Td 8s Ah]
Duke Croix: checks 
MnnM150: checks 
HighCardJasper: checks 
MrOB1reader: bets 307
JeBoyDirk: folds 
dddocky: folds 
Duke Croix: calls 307
MnnM150: folds 
HighCardJasper: calls 307
*** TURN *** [Td 8s Ah] [Qc]
Duke Croix: checks 
HighCardJasper: checks 
MrOB1reader: checks 
*** RIVER *** [Td 8s Ah Qc] [3c]
Duke Croix: checks 
HighCardJasper: checks 
MrOB1reader: checks 
*** SHOW DOWN ***
Duke Croix: shows [Th Kh] (a pair of Tens)
HighCardJasper: mucks hand 
MrOB1reader: mucks hand 
Duke Croix collected 1485 from pot
*** SUMMARY ***
Total pot 1571 | Rake 86 
Board [Td 8s Ah Qc 3c]
Seat 1: dddocky (button) folded on the Flop
Seat 2: Duke Croix (small blind) showed [Th Kh] and won (1485) with a pair of Tens
Seat 3: MnnM150 (big blind) folded on the Flop
Seat 4: HighCardJasper mucked [Ts Jd]
Seat 5: MrOB1reader mucked [9s 6h]
Seat 7: appositive folded before Flop (didn't bet)
Seat 9: JeBoyDirk folded on the Flop



PokerStars Home Game Hand #220088242092: {Club #3225207}  Hold'em No Limit (50/100) - 2020/11/05 17:42:58 ET
Table 'funzzzzzzzz' 9-max (Play Money) Seat #2 is the button
Seat 1: dddocky (6571 in chips) 
Seat 2: Duke Croix (14527 in chips) 
Seat 3: MnnM150 (11065 in chips) 
Seat 4: HighCardJasper (14678 in chips) 
Seat 5: MrOB1reader (15603 in chips) 
Seat 7: appositive (21684 in chips) 
Seat 9: JeBoyDirk (19724 in chips) 
MnnM150: posts small blind 50
HighCardJasper: posts big blind 100
*** HOLE CARDS ***
Dealt to Duke Croix [2h 9h]
MrOB1reader: calls 100
appositive: calls 100
JeBoyDirk: calls 100
dddocky: calls 100
Duke Croix: calls 100
MnnM150: calls 50
HighCardJasper: checks 
*** FLOP *** [2c 6c 3c]
MnnM150: checks 
HighCardJasper: checks 
MrOB1reader: bets 661
appositive: folds 
JeBoyDirk: folds 
dddocky: folds 
Duke Croix: folds 
MnnM150: folds 
HighCardJasper: folds 
Uncalled bet (661) returned to MrOB1reader
MrOB1reader collected 661 from pot
MrOB1reader: doesn't show hand 
*** SUMMARY ***
Total pot 700 | Rake 39 
Board [2c 6c 3c]
Seat 1: dddocky folded on the Flop
Seat 2: Duke Croix (button) folded on the Flop
Seat 3: MnnM150 (small blind) folded on the Flop
Seat 4: HighCardJasper (big blind) folded on the Flop
Seat 5: MrOB1reader collected (661)
Seat 7: appositive folded on the Flop
Seat 9: JeBoyDirk folded on the Flop



PokerStars Home Game Hand #220088261267: {Club #3225207}  Hold'em No Limit (50/100) - 2020/11/05 17:43:33 ET
Table 'funzzzzzzzz' 9-max (Play Money) Seat #3 is the button
Seat 1: dddocky (6471 in chips) 
Seat 2: Duke Croix (14427 in chips) 
Seat 3: MnnM150 (10965 in chips) 
Seat 4: HighCardJasper (14578 in chips) 
Seat 5: MrOB1reader (16164 in chips) 
Seat 7: appositive (21584 in chips) 
Seat 9: JeBoyDirk (19624 in chips) 
HighCardJasper: posts small blind 50
MrOB1reader: posts big blind 100
*** HOLE CARDS ***
Dealt to Duke Croix [Ac 7c]
appositive: calls 100
JeBoyDirk: folds 
dddocky: calls 100
JeBoyDirk leaves the table
Duke Croix: raises 300 to 400
MnnM150: folds 
HighCardJasper: calls 350
MrOB1reader: raises 300 to 700
appositive: folds 
dddocky: calls 600
Duke Croix: calls 300
HighCardJasper: calls 300
*** FLOP *** [4h 7h 4s]
HighCardJasper: checks 
MrOB1reader: bets 2740
dddocky: folds 
Duke Croix: folds 
HighCardJasper: folds 
Uncalled bet (2740) returned to MrOB1reader
MrOB1reader collected 2740 from pot
MrOB1reader: doesn't show hand 
*** SUMMARY ***
Total pot 2900 | Rake 160 
Board [4h 7h 4s]
Seat 1: dddocky folded on the Flop
Seat 2: Duke Croix folded on the Flop
Seat 3: MnnM150 (button) folded before Flop (didn't bet)
Seat 4: HighCardJasper (small blind) folded on the Flop
Seat 5: MrOB1reader (big blind) collected (2740)
Seat 7: appositive folded before Flop
Seat 9: JeBoyDirk folded before Flop (didn't bet)



PokerStars Home Game Hand #220088290462: {Club #3225207}  Hold'em No Limit (50/100) - 2020/11/05 17:44:26 ET
Table 'funzzzzzzzz' 9-max (Play Money) Seat #4 is the button
Seat 1: dddocky (5771 in chips) 
Seat 2: Duke Croix (13727 in chips) 
Seat 3: MnnM150 (10965 in chips) 
Seat 4: HighCardJasper (13878 in chips) 
Seat 7: appositive (21484 in chips) 
appositive: posts small blind 50
dddocky: posts big blind 100
*** HOLE CARDS ***
Dealt to Duke Croix [7d Ts]
Duke Croix: folds 
MnnM150: folds 
HighCardJasper: calls 100
MrOB1reader leaves the table
appositive has timed out
appositive: folds 
dddocky: checks 
*** FLOP *** [Tc Jc Jh]
dddocky: checks 
HighCardJasper: checks 
*** TURN *** [Tc Jc Jh] [3c]
dddocky: checks 
HighCardJasper: checks 
*** RIVER *** [Tc Jc Jh 3c] [9s]
dddocky: checks 
HighCardJasper: checks 
*** SHOW DOWN ***
dddocky: shows [3s 2h] (two pair, Jacks and Threes)
HighCardJasper: mucks hand 
dddocky collected 236 from pot
*** SUMMARY ***
Total pot 250 | Rake 14 
Board [Tc Jc Jh 3c 9s]
Seat 1: dddocky (big blind) showed [3s 2h] and won (236) with two pair, Jacks and Threes
Seat 2: Duke Croix folded before Flop (didn't bet)
Seat 3: MnnM150 folded before Flop (didn't bet)
Seat 4: HighCardJasper (button) mucked [Qh 2s]
Seat 7: appositive (small blind) folded before Flop



PokerStars Home Game Hand #220088329053: {Club #3225207}  Hold'em No Limit (50/100) - 2020/11/05 17:45:36 ET
Table 'funzzzzzzzz' 9-max (Play Money) Seat #7 is the button
Seat 1: dddocky (5907 in chips) 
Seat 2: Duke Croix (13727 in chips) 
Seat 3: MnnM150 (10965 in chips) 
Seat 4: HighCardJasper (13778 in chips) 
Seat 7: appositive (21434 in chips) 
dddocky: posts small blind 50
Duke Croix: posts big blind 100
*** HOLE CARDS ***
Dealt to Duke Croix [4s 5c]
MnnM150: folds 
HighCardJasper: calls 100
appositive: calls 100
dddocky: folds 
Duke Croix: checks 
*** FLOP *** [4c Jh Ac]
Duke Croix: checks 
HighCardJasper: checks 
appositive: bets 165
Duke Croix: calls 165
HighCardJasper: calls 165
*** TURN *** [4c Jh Ac] [3s]
Duke Croix: checks 
HighCardJasper: checks 
appositive: checks 
*** RIVER *** [4c Jh Ac 3s] [Kc]
Duke Croix: checks 
HighCardJasper: checks 
appositive: bets 799
Duke Croix: folds 
HighCardJasper: folds 
Uncalled bet (799) returned to appositive
appositive collected 799 from pot
appositive: doesn't show hand 
*** SUMMARY ***
Total pot 845 | Rake 46 
Board [4c Jh Ac 3s Kc]
Seat 1: dddocky (small blind) folded before Flop
Seat 2: Duke Croix (big blind) folded on the River
Seat 3: MnnM150 folded before Flop (didn't bet)
Seat 4: HighCardJasper folded on the River
Seat 7: appositive (button) collected (799)



PokerStars Home Game Hand #220088355343: {Club #3225207}  Hold'em No Limit (50/100) - 2020/11/05 17:46:25 ET
Table 'funzzzzzzzz' 9-max (Play Money) Seat #1 is the button
Seat 1: dddocky (5857 in chips) 
Seat 2: Duke Croix (13462 in chips) 
Seat 3: MnnM150 (10965 in chips) 
Seat 4: HighCardJasper (13513 in chips) 
Seat 7: appositive (21968 in chips) 
Duke Croix: posts small blind 50
MnnM150: posts big blind 100
*** HOLE CARDS ***
Dealt to Duke Croix [Ah 7s]
HighCardJasper: calls 100
appositive: calls 100
dddocky: calls 100
Duke Croix: raises 400 to 500
MnnM150: folds 
HighCardJasper: folds 
appositive: calls 400
dddocky: calls 400
*** FLOP *** [Td 4c 6s]
Duke Croix: checks 
appositive: bets 803
dddocky: folds 
Duke Croix: folds 
Uncalled bet (803) returned to appositive
appositive collected 1606 from pot
appositive: doesn't show hand 
*** SUMMARY ***
Total pot 1700 | Rake 94 
Board [Td 4c 6s]
Seat 1: dddocky (button) folded on the Flop
Seat 2: Duke Croix (small blind) folded on the Flop
Seat 3: MnnM150 (big blind) folded before Flop
Seat 4: HighCardJasper folded before Flop
Seat 7: appositive collected (1606)



PokerStars Home Game Hand #220088373896: {Club #3225207}  Hold'em No Limit (50/100) - 2020/11/05 17:46:59 ET
Table 'funzzzzzzzz' 9-max (Play Money) Seat #2 is the button
Seat 1: dddocky (5357 in chips) 
Seat 2: Duke Croix (12962 in chips) 
Seat 3: MnnM150 (10865 in chips) 
Seat 4: HighCardJasper (13413 in chips) 
Seat 7: appositive (23074 in chips) 
MnnM150: posts small blind 50
HighCardJasper: posts big blind 100
*** HOLE CARDS ***
Dealt to Duke Croix [2h 4d]
appositive: folds 
dddocky: calls 100
Duke Croix: folds 
MnnM150: calls 50
HighCardJasper: raises 200 to 300
dddocky: calls 200
MnnM150: calls 200
*** FLOP *** [4h 9c 6h]
MnnM150: checks 
HighCardJasper: checks 
dddocky: bets 200
MnnM150: calls 200
HighCardJasper: calls 200
*** TURN *** [4h 9c 6h] [Ts]
MnnM150: checks 
HighCardJasper: checks 
dddocky: bets 100
MnnM150: folds 
HighCardJasper: calls 100
*** RIVER *** [4h 9c 6h Ts] [Js]
HighCardJasper: checks 
dddocky: checks 
*** SHOW DOWN ***
HighCardJasper: shows [Kc Jc] (a pair of Jacks)
dddocky: mucks hand 
HighCardJasper collected 1606 from pot
*** SUMMARY ***
Total pot 1700 | Rake 94 
Board [4h 9c 6h Ts Js]
Seat 1: dddocky mucked [Ah 8h]
Seat 2: Duke Croix (button) folded before Flop (didn't bet)
Seat 3: MnnM150 (small blind) folded on the Turn
Seat 4: HighCardJasper (big blind) showed [Kc Jc] and won (1606) with a pair of Jacks
Seat 7: appositive folded before Flop (didn't bet)



PokerStars Home Game Hand #220088400785: {Club #3225207}  Hold'em No Limit (50/100) - 2020/11/05 17:47:48 ET
Table 'funzzzzzzzz' 9-max (Play Money) Seat #3 is the button
Seat 1: dddocky (4757 in chips) 
Seat 2: Duke Croix (12962 in chips) 
Seat 3: MnnM150 (10365 in chips) 
Seat 4: HighCardJasper (14419 in chips) 
Seat 7: appositive (23074 in chips) 
HighCardJasper: posts small blind 50
appositive: posts big blind 100
*** HOLE CARDS ***
Dealt to Duke Croix [6c 5d]
dddocky: calls 100
Duke Croix: calls 100
MnnM150: folds 
HighCardJasper: calls 50
appositive: checks 
*** FLOP *** [7s 7d Qc]
HighCardJasper: checks 
appositive: checks 
dddocky: checks 
Duke Croix: checks 
*** TURN *** [7s 7d Qc] [9d]
HighCardJasper: checks 
appositive: bets 189
dddocky: calls 189
Duke Croix: calls 189
HighCardJasper: folds 
*** RIVER *** [7s 7d Qc 9d] [Ts]
appositive: bets 457
dddocky: folds 
Duke Croix: folds 
Uncalled bet (457) returned to appositive
appositive collected 914 from pot
appositive: doesn't show hand 
*** SUMMARY ***
Total pot 967 | Rake 53 
Board [7s 7d Qc 9d Ts]
Seat 1: dddocky folded on the River
Seat 2: Duke Croix folded on the River
Seat 3: MnnM150 (button) folded before Flop (didn't bet)
Seat 4: HighCardJasper (small blind) folded on the Turn
Seat 7: appositive (big blind) collected (914)



PokerStars Home Game Hand #220088435111: {Club #3225207}  Hold'em No Limit (50/100) - 2020/11/05 17:48:52 ET
Table 'funzzzzzzzz' 9-max (Play Money) Seat #4 is the button
Seat 1: dddocky (4468 in chips) 
Seat 2: Duke Croix (12673 in chips) 
Seat 3: MnnM150 (10365 in chips) 
Seat 4: HighCardJasper (14319 in chips) 
Seat 7: appositive (23699 in chips) 
appositive: posts small blind 50
dddocky: posts big blind 100
*** HOLE CARDS ***
Dealt to Duke Croix [7s Qc]
Duke Croix: calls 100
MnnM150: folds 
HighCardJasper: calls 100
appositive: raises 100 to 200
dddocky: calls 100
Duke Croix: calls 100
HighCardJasper: calls 100
*** FLOP *** [Qh 5s 7d]
appositive: checks 
dddocky: checks 
Duke Croix: checks 
HighCardJasper: checks 
*** TURN *** [Qh 5s 7d] [3d]
appositive: checks 
dddocky: checks 
Duke Croix: bets 500
HighCardJasper: folds 
appositive: folds 
dddocky: folds 
Uncalled bet (500) returned to Duke Croix
Duke Croix collected 756 from pot
*** SUMMARY ***
Total pot 800 | Rake 44 
Board [Qh 5s 7d 3d]
Seat 1: dddocky (big blind) folded on the Turn
Seat 2: Duke Croix collected (756)
Seat 3: MnnM150 folded before Flop (didn't bet)
Seat 4: HighCardJasper (button) folded on the Turn
Seat 7: appositive (small blind) folded on the Turn



PokerStars Home Game Hand #220088462469: {Club #3225207}  Hold'em No Limit (50/100) - 2020/11/05 17:49:43 ET
Table 'funzzzzzzzz' 9-max (Play Money) Seat #7 is the button
Seat 1: dddocky (4268 in chips) 
Seat 2: Duke Croix (13229 in chips) 
Seat 3: MnnM150 (10365 in chips) 
Seat 4: HighCardJasper (14119 in chips) 
Seat 7: appositive (23499 in chips) 
dddocky: posts small blind 50
Duke Croix: posts big blind 100
*** HOLE CARDS ***
Dealt to Duke Croix [9d 6c]
MnnM150: calls 100
HighCardJasper: calls 100
appositive: folds 
dddocky: calls 50
Duke Croix: checks 
*** FLOP *** [Qd 7s Tc]
dddocky: checks 
Duke Croix: checks 
MnnM150: checks 
HighCardJasper: checks 
*** TURN *** [Qd 7s Tc] [6h]
dddocky: checks 
Duke Croix: bets 200
MnnM150: folds 
HighCardJasper: calls 200
dddocky: folds 
*** RIVER *** [Qd 7s Tc 6h] [2d]
Duke Croix: bets 500
HighCardJasper: calls 500
*** SHOW DOWN ***
Duke Croix: shows [9d 6c] (a pair of Sixes)
HighCardJasper: shows [Qh 4s] (a pair of Queens)
HighCardJasper collected 1701 from pot
*** SUMMARY ***
Total pot 1800 | Rake 99 
Board [Qd 7s Tc 6h 2d]
Seat 1: dddocky (small blind) folded on the Turn
Seat 2: Duke Croix (big blind) showed [9d 6c] and lost with a pair of Sixes
Seat 3: MnnM150 folded on the Turn
Seat 4: HighCardJasper showed [Qh 4s] and won (1701) with a pair of Queens
Seat 7: appositive (button) folded before Flop (didn't bet)



PokerStars Home Game Hand #220088478617: {Club #3225207}  Hold'em No Limit (50/100) - 2020/11/05 17:50:13 ET
Table 'funzzzzzzzz' 9-max (Play Money) Seat #1 is the button
Seat 1: dddocky (4168 in chips) 
Seat 2: Duke Croix (12429 in chips) 
Seat 3: MnnM150 (10265 in chips) 
Seat 4: HighCardJasper (15020 in chips) 
Seat 7: appositive (23499 in chips) 
Duke Croix: posts small blind 50
MnnM150: posts big blind 100
*** HOLE CARDS ***
Dealt to Duke Croix [Td Qd]
HighCardJasper: calls 100
appositive: calls 100
dddocky: calls 100
Duke Croix: raises 300 to 400
MnnM150: calls 300
HighCardJasper: folds 
appositive: calls 300
dddocky: calls 300
*** FLOP *** [2d 8d 5s]
Duke Croix: bets 700
MnnM150: folds 
appositive: calls 700
dddocky: raises 700 to 1400
Duke Croix: calls 700
appositive: folds 
*** TURN *** [2d 8d 5s] [Ts]
Duke Croix: checks 
dddocky: bets 2368 and is all-in
Duke Croix: calls 2368
*** RIVER *** [2d 8d 5s Ts] [9s]
*** SHOW DOWN ***
Duke Croix: shows [Td Qd] (a pair of Tens)
dddocky: shows [Ks Kc] (a pair of Kings)
dddocky collected 9390 from pot
*** SUMMARY ***
Total pot 9936 | Rake 546 
Board [2d 8d 5s Ts 9s]
Seat 1: dddocky (button) showed [Ks Kc] and won (9390) with a pair of Kings
Seat 2: Duke Croix (small blind) showed [Td Qd] and lost with a pair of Tens
Seat 3: MnnM150 (big blind) folded on the Flop
Seat 4: HighCardJasper folded before Flop
Seat 7: appositive folded on the Flop



PokerStars Home Game Hand #220088512055: {Club #3225207}  Hold'em No Limit (50/100) - 2020/11/05 17:51:16 ET
Table 'funzzzzzzzz' 9-max (Play Money) Seat #2 is the button
Seat 1: dddocky (9390 in chips) 
Seat 2: Duke Croix (8261 in chips) 
Seat 3: MnnM150 (9865 in chips) 
Seat 4: HighCardJasper (14920 in chips) 
Seat 7: appositive (22399 in chips) 
MnnM150: posts small blind 50
HighCardJasper: posts big blind 100
*** HOLE CARDS ***
Dealt to Duke Croix [3c Tc]
appositive: calls 100
dddocky: folds 
Duke Croix: folds 
MnnM150: calls 50
HighCardJasper: checks 
*** FLOP *** [8h Qd 6s]
MnnM150: bets 141
HighCardJasper: calls 141
appositive: folds 
*** TURN *** [8h Qd 6s] [6d]
MnnM150: bets 275
HighCardJasper: folds 
Uncalled bet (275) returned to MnnM150
MnnM150 collected 550 from pot
*** SUMMARY ***
Total pot 582 | Rake 32 
Board [8h Qd 6s 6d]
Seat 1: dddocky folded before Flop (didn't bet)
Seat 2: Duke Croix (button) folded before Flop (didn't bet)
Seat 3: MnnM150 (small blind) collected (550)
Seat 4: HighCardJasper (big blind) folded on the Turn
Seat 7: appositive folded on the Flop



PokerStars Home Game Hand #220088529912: {Club #3225207}  Hold'em No Limit (50/100) - 2020/11/05 17:51:49 ET
Table 'funzzzzzzzz' 9-max (Play Money) Seat #3 is the button
Seat 1: dddocky (9390 in chips) 
Seat 2: Duke Croix (8261 in chips) 
Seat 3: MnnM150 (10174 in chips) 
Seat 4: HighCardJasper (14679 in chips) 
Seat 7: appositive (22299 in chips) 
HighCardJasper: posts small blind 50
appositive: posts big blind 100
*** HOLE CARDS ***
Dealt to Duke Croix [6c 4s]
dddocky: raises 100 to 200
Duke Croix: folds 
MnnM150: calls 200
HighCardJasper: calls 150
appositive: calls 100
*** FLOP *** [Ts 6d 3d]
HighCardJasper: checks 
appositive: checks 
dddocky: checks 
MnnM150: checks 
*** TURN *** [Ts 6d 3d] [Js]
HighCardJasper: checks 
appositive: checks 
dddocky: checks 
MnnM150: checks 
*** RIVER *** [Ts 6d 3d Js] [5c]
HighCardJasper: bets 100
appositive: raises 956 to 1056
dddocky: folds 
MnnM150: folds 
HighCardJasper: folds 
Uncalled bet (956) returned to appositive
appositive collected 945 from pot
appositive: doesn't show hand 
*** SUMMARY ***
Total pot 1000 | Rake 55 
Board [Ts 6d 3d Js 5c]
Seat 1: dddocky folded on the River
Seat 2: Duke Croix folded before Flop (didn't bet)
Seat 3: MnnM150 (button) folded on the River
Seat 4: HighCardJasper (small blind) folded on the River
Seat 7: appositive (big blind) collected (945)



PokerStars Home Game Hand #220088561218: {Club #3225207}  Hold'em No Limit (50/100) - 2020/11/05 17:52:48 ET
Table 'funzzzzzzzz' 9-max (Play Money) Seat #4 is the button
Seat 1: dddocky (9190 in chips) 
Seat 2: Duke Croix (8261 in chips) 
Seat 3: MnnM150 (9974 in chips) 
Seat 4: HighCardJasper (14379 in chips) 
Seat 7: appositive (22944 in chips) 
appositive: posts small blind 50
dddocky: posts big blind 100
*** HOLE CARDS ***
Dealt to Duke Croix [8d Qd]
Duke Croix: calls 100
MnnM150: calls 100
HighCardJasper: calls 100
appositive: calls 50
dddocky: checks 
*** FLOP *** [8s 3d 2c]
appositive: checks 
dddocky: checks 
Duke Croix: bets 300
MnnM150: folds 
HighCardJasper: folds 
appositive: calls 300
dddocky: folds 
*** TURN *** [8s 3d 2c] [8c]
appositive: checks 
Duke Croix: checks 
*** RIVER *** [8s 3d 2c 8c] [9c]
appositive: checks 
Duke Croix: bets 900
appositive: folds 
Uncalled bet (900) returned to Duke Croix
Duke Croix collected 1039 from pot
*** SUMMARY ***
Total pot 1100 | Rake 61 
Board [8s 3d 2c 8c 9c]
Seat 1: dddocky (big blind) folded on the Flop
Seat 2: Duke Croix collected (1039)
Seat 3: MnnM150 folded on the Flop
Seat 4: HighCardJasper (button) folded on the Flop
Seat 7: appositive (small blind) folded on the River



PokerStars Home Game Hand #220088585063: {Club #3225207}  Hold'em No Limit (50/100) - 2020/11/05 17:53:33 ET
Table 'funzzzzzzzz' 9-max (Play Money) Seat #7 is the button
Seat 1: dddocky (9090 in chips) 
Seat 2: Duke Croix (8900 in chips) 
Seat 3: MnnM150 (9874 in chips) 
Seat 4: HighCardJasper (14279 in chips) 
Seat 7: appositive (22544 in chips) 
dddocky: posts small blind 50
Duke Croix: posts big blind 100
*** HOLE CARDS ***
Dealt to Duke Croix [7h 8s]
MnnM150: folds 
HighCardJasper: calls 100
appositive: folds 
dddocky: calls 50
Duke Croix: checks 
*** FLOP *** [5d 9s 7s]
dddocky: checks 
Duke Croix: bets 200
HighCardJasper: calls 200
dddocky: folds 
*** TURN *** [5d 9s 7s] [Jc]
Duke Croix: checks 
HighCardJasper: bets 300
Duke Croix: calls 300
*** RIVER *** [5d 9s 7s Jc] [3d]
Duke Croix: checks 
HighCardJasper: bets 400
Duke Croix: folds 
Uncalled bet (400) returned to HighCardJasper
HighCardJasper collected 1228 from pot
HighCardJasper: doesn't show hand 
*** SUMMARY ***
Total pot 1300 | Rake 72 
Board [5d 9s 7s Jc 3d]
Seat 1: dddocky (small blind) folded on the Flop
Seat 2: Duke Croix (big blind) folded on the River
Seat 3: MnnM150 folded before Flop (didn't bet)
Seat 4: HighCardJasper collected (1228)
Seat 7: appositive (button) folded before Flop (didn't bet)



PokerStars Home Game Hand #220088622671: {Club #3225207}  Hold'em No Limit (50/100) - 2020/11/05 17:54:27 ET
Table 'funzzzzzzzz' 9-max (Play Money) Seat #1 is the button
Seat 1: dddocky (8990 in chips) 
Seat 2: Duke Croix (8300 in chips) 
Seat 3: MnnM150 (9874 in chips) 
Seat 4: HighCardJasper (14907 in chips) 
Seat 7: appositive (22544 in chips) 
Duke Croix: posts small blind 50
MnnM150: posts big blind 100
*** HOLE CARDS ***
Dealt to Duke Croix [Td 3c]
HighCardJasper: raises 100 to 200
appositive: calls 200
dddocky: calls 200
Duke Croix: folds 
MnnM150: calls 100
*** FLOP *** [9s Ac 7d]
MnnM150: checks 
HighCardJasper: checks 
appositive: bets 401
dddocky: calls 401
MnnM150: folds 
HighCardJasper: calls 401
*** TURN *** [9s Ac 7d] [6h]
HighCardJasper: checks 
appositive: bets 1940
dddocky: folds 
HighCardJasper: folds 
Uncalled bet (1940) returned to appositive
appositive collected 1940 from pot
appositive: doesn't show hand 
*** SUMMARY ***
Total pot 2053 | Rake 113 
Board [9s Ac 7d 6h]
Seat 1: dddocky (button) folded on the Turn
Seat 2: Duke Croix (small blind) folded before Flop
Seat 3: MnnM150 (big blind) folded on the Flop
Seat 4: HighCardJasper folded on the Turn
Seat 7: appositive collected (1940)



PokerStars Home Game Hand #220088645034: {Club #3225207}  Hold'em No Limit (50/100) - 2020/11/05 17:55:10 ET
Table 'funzzzzzzzz' 9-max (Play Money) Seat #2 is the button
Seat 1: dddocky (8389 in chips) 
Seat 2: Duke Croix (8250 in chips) 
Seat 3: MnnM150 (9674 in chips) 
Seat 4: HighCardJasper (14306 in chips) 
Seat 7: appositive (23883 in chips) 
MnnM150: posts small blind 50
HighCardJasper: posts big blind 100
*** HOLE CARDS ***
Dealt to Duke Croix [Qd Ah]
appositive: raises 100 to 200
dddocky: folds 
Duke Croix: raises 300 to 500
MnnM150: folds 
HighCardJasper: folds 
appositive: calls 300
*** FLOP *** [Ks Ac 5c]
appositive: bets 1087
Duke Croix: calls 1087
*** TURN *** [Ks Ac 5c] [9h]
appositive: bets 3141
Duke Croix: raises 3522 to 6663 and is all-in
appositive: folds 
Uncalled bet (3522) returned to Duke Croix
Duke Croix collected 9078 from pot
*** SUMMARY ***
Total pot 9606 | Rake 528 
Board [Ks Ac 5c 9h]
Seat 1: dddocky folded before Flop (didn't bet)
Seat 2: Duke Croix (button) collected (9078)
Seat 3: MnnM150 (small blind) folded before Flop
Seat 4: HighCardJasper (big blind) folded before Flop
Seat 7: appositive folded on the Turn



PokerStars Home Game Hand #220088664133: {Club #3225207}  Hold'em No Limit (50/100) - 2020/11/05 17:55:57 ET
Table 'funzzzzzzzz' 9-max (Play Money) Seat #3 is the button
Seat 1: dddocky (8389 in chips) 
Seat 2: Duke Croix (12600 in chips) 
Seat 3: MnnM150 (9624 in chips) 
Seat 4: HighCardJasper (14206 in chips) 
Seat 7: appositive (19155 in chips) 
HighCardJasper: posts small blind 50
appositive: posts big blind 100
*** HOLE CARDS ***
Dealt to Duke Croix [7d Jh]
dddocky: calls 100
Duke Croix: folds 
MnnM150: calls 100
HighCardJasper: calls 50
appositive: checks 
*** FLOP *** [5s Qs 7s]
HighCardJasper: checks 
appositive: checks 
dddocky: bets 100
MnnM150: calls 100
HighCardJasper: calls 100
appositive: calls 100
*** TURN *** [5s Qs 7s] [6d]
HighCardJasper: checks 
appositive: checks 
dddocky: bets 200
MnnM150: folds 
HighCardJasper: calls 200
appositive: calls 200
*** RIVER *** [5s Qs 7s 6d] [2d]
HighCardJasper: checks 
appositive: checks 
dddocky: bets 1323
HighCardJasper: folds 
appositive: folds 
Uncalled bet (1323) returned to dddocky
dddocky collected 1323 from pot
dddocky: doesn't show hand 
*** SUMMARY ***
Total pot 1400 | Rake 77 
Board [5s Qs 7s 6d 2d]
Seat 1: dddocky collected (1323)
Seat 2: Duke Croix folded before Flop (didn't bet)
Seat 3: MnnM150 (button) folded on the Turn
Seat 4: HighCardJasper (small blind) folded on the River
Seat 7: appositive (big blind) folded on the River



PokerStars Home Game Hand #220088701412: {Club #3225207}  Hold'em No Limit (50/100) - 2020/11/05 17:57:27 ET
Table 'funzzzzzzzz' 9-max (Play Money) Seat #4 is the button
Seat 1: dddocky (9312 in chips) 
Seat 2: Duke Croix (12600 in chips) 
Seat 3: MnnM150 (9424 in chips) 
Seat 4: HighCardJasper (13806 in chips) 
Seat 7: appositive (18755 in chips) 
appositive: posts small blind 50
dddocky: posts big blind 100
*** HOLE CARDS ***
Dealt to Duke Croix [Th 7d]
Duke Croix: folds 
MnnM150: calls 100
HighCardJasper: calls 100
appositive: calls 50
dddocky: checks 
*** FLOP *** [8s Jd Ac]
appositive: checks 
dddocky: checks 
MnnM150: checks 
HighCardJasper: checks 
*** TURN *** [8s Jd Ac] [5d]
appositive: checks 
dddocky: checks 
MnnM150: checks 
HighCardJasper: bets 200
appositive: folds 
dddocky: folds 
MnnM150: folds 
Uncalled bet (200) returned to HighCardJasper
HighCardJasper collected 378 from pot
HighCardJasper: doesn't show hand 
*** SUMMARY ***
Total pot 400 | Rake 22 
Board [8s Jd Ac 5d]
Seat 1: dddocky (big blind) folded on the Turn
Seat 2: Duke Croix folded before Flop (didn't bet)
Seat 3: MnnM150 folded on the Turn
Seat 4: HighCardJasper (button) collected (378)
Seat 7: appositive (small blind) folded on the Turn



PokerStars Home Game Hand #220088717152: {Club #3225207}  Hold'em No Limit (50/100) - 2020/11/05 17:58:06 ET
Table 'funzzzzzzzz' 9-max (Play Money) Seat #7 is the button
Seat 1: dddocky (9212 in chips) 
Seat 2: Duke Croix (12600 in chips) 
Seat 3: MnnM150 (9324 in chips) 
Seat 4: HighCardJasper (14084 in chips) 
Seat 7: appositive (18655 in chips) 
dddocky: posts small blind 50
Duke Croix: posts big blind 100
*** HOLE CARDS ***
Dealt to Duke Croix [7c 9d]
MnnM150: folds 
HighCardJasper: calls 100
appositive: calls 100
dddocky: folds 
Duke Croix: checks 
*** FLOP *** [Ah 6c 5s]
Duke Croix: checks 
HighCardJasper: checks 
appositive: checks 
*** TURN *** [Ah 6c 5s] [6d]
Duke Croix: checks 
HighCardJasper: checks 
appositive: bets 100
Duke Croix: calls 100
HighCardJasper: calls 100
*** RIVER *** [Ah 6c 5s 6d] [Qh]
Duke Croix: checks 
HighCardJasper: checks 
appositive: bets 614
Duke Croix: folds 
HighCardJasper: folds 
Uncalled bet (614) returned to appositive
appositive collected 614 from pot
appositive: doesn't show hand 
*** SUMMARY ***
Total pot 650 | Rake 36 
Board [Ah 6c 5s 6d Qh]
Seat 1: dddocky (small blind) folded before Flop
Seat 2: Duke Croix (big blind) folded on the River
Seat 3: MnnM150 folded before Flop (didn't bet)
Seat 4: HighCardJasper folded on the River
Seat 7: appositive (button) collected (614)



PokerStars Home Game Hand #220088738362: {Club #3225207}  Hold'em No Limit (50/100) - 2020/11/05 17:58:58 ET
Table 'funzzzzzzzz' 9-max (Play Money) Seat #1 is the button
Seat 1: dddocky (9162 in chips) 
Seat 2: Duke Croix (12400 in chips) 
Seat 3: MnnM150 (9324 in chips) 
Seat 4: HighCardJasper (13884 in chips) 
Seat 7: appositive (19069 in chips) 
Duke Croix: posts small blind 50
MnnM150: posts big blind 100
*** HOLE CARDS ***
Dealt to Duke Croix [Jh Ks]
HighCardJasper: calls 100
appositive: calls 100
dddocky: folds 
Duke Croix: raises 300 to 400
MnnM150: folds 
HighCardJasper: calls 300
appositive: folds 
*** FLOP *** [9h 9s Kd]
Duke Croix: bets 500
HighCardJasper: folds 
Uncalled bet (500) returned to Duke Croix
Duke Croix collected 945 from pot
*** SUMMARY ***
Total pot 1000 | Rake 55 
Board [9h 9s Kd]
Seat 1: dddocky (button) folded before Flop (didn't bet)
Seat 2: Duke Croix (small blind) collected (945)
Seat 3: MnnM150 (big blind) folded before Flop
Seat 4: HighCardJasper folded on the Flop
Seat 7: appositive folded before Flop



PokerStars Home Game Hand #220088753808: {Club #3225207}  Hold'em No Limit (50/100) - 2020/11/05 17:59:36 ET
Table 'funzzzzzzzz' 9-max (Play Money) Seat #2 is the button
Seat 1: dddocky (9162 in chips) 
Seat 2: Duke Croix (12945 in chips) 
Seat 3: MnnM150 (9224 in chips) 
Seat 4: HighCardJasper (13484 in chips) 
Seat 7: appositive (18969 in chips) 
MnnM150: posts small blind 50
HighCardJasper: posts big blind 100
*** HOLE CARDS ***
Dealt to Duke Croix [5s Ts]
appositive: folds 
dddocky: calls 100
Duke Croix: folds 
MnnM150: calls 50
HighCardJasper: checks 
*** FLOP *** [4h Qd Jd]
MnnM150: checks 
HighCardJasper: checks 
dddocky: checks 
*** TURN *** [4h Qd Jd] [Kc]
MnnM150: checks 
HighCardJasper: checks 
dddocky: bets 100
MnnM150: calls 100
HighCardJasper: calls 100
*** RIVER *** [4h Qd Jd Kc] [5c]
MnnM150: checks 
HighCardJasper: checks 
dddocky: bets 100
MnnM150: calls 100
HighCardJasper: folds 
*** SHOW DOWN ***
dddocky: shows [7s Js] (a pair of Jacks)
MnnM150: mucks hand 
dddocky collected 756 from pot
*** SUMMARY ***
Total pot 800 | Rake 44 
Board [4h Qd Jd Kc 5c]
Seat 1: dddocky showed [7s Js] and won (756) with a pair of Jacks
Seat 2: Duke Croix (button) folded before Flop (didn't bet)
Seat 3: MnnM150 (small blind) mucked [Ad 6d]
Seat 4: HighCardJasper (big blind) folded on the River
Seat 7: appositive folded before Flop (didn't bet)



PokerStars Home Game Hand #220088767995: {Club #3225207}  Hold'em No Limit (50/100) - 2020/11/05 18:00:10 ET
Table 'funzzzzzzzz' 9-max (Play Money) Seat #3 is the button
Seat 1: dddocky (9618 in chips) 
Seat 2: Duke Croix (12945 in chips) 
Seat 3: MnnM150 (8924 in chips) 
Seat 4: HighCardJasper (13284 in chips) 
Seat 7: appositive (18969 in chips) 
HighCardJasper: posts small blind 50
appositive: posts big blind 100
*** HOLE CARDS ***
Dealt to Duke Croix [Td 7s]
dddocky: calls 100
Duke Croix: folds 
MnnM150: calls 100
HighCardJasper: calls 50
appositive: raises 100 to 200
dddocky: folds 
MnnM150: calls 100
HighCardJasper: calls 100
*** FLOP *** [3s Ad 9d]
HighCardJasper: checks 
appositive: bets 661
MnnM150: folds 
HighCardJasper: folds 
Uncalled bet (661) returned to appositive
appositive collected 661 from pot
appositive: doesn't show hand 
*** SUMMARY ***
Total pot 700 | Rake 39 
Board [3s Ad 9d]
Seat 1: dddocky folded before Flop
Seat 2: Duke Croix folded before Flop (didn't bet)
Seat 3: MnnM150 (button) folded on the Flop
Seat 4: HighCardJasper (small blind) folded on the Flop
Seat 7: appositive (big blind) collected (661)



PokerStars Home Game Hand #220088782982: {Club #3225207}  Hold'em No Limit (50/100) - 2020/11/05 18:00:45 ET
Table 'funzzzzzzzz' 9-max (Play Money) Seat #4 is the button
Seat 1: dddocky (9518 in chips) 
Seat 2: Duke Croix (12945 in chips) 
Seat 3: MnnM150 (8724 in chips) 
Seat 4: HighCardJasper (13084 in chips) 
Seat 7: appositive (19430 in chips) 
appositive: posts small blind 50
dddocky: posts big blind 100
*** HOLE CARDS ***
Dealt to Duke Croix [8d Ad]
Duke Croix: raises 300 to 400
MnnM150: folds 
HighCardJasper: folds 
appositive: folds 
dddocky: calls 300
*** FLOP *** [4c Ks Tc]
dddocky: checks 
Duke Croix: checks 
*** TURN *** [4c Ks Tc] [Ac]
dddocky: bets 200
Duke Croix: raises 400 to 600
dddocky: calls 400
*** RIVER *** [4c Ks Tc Ac] [Qh]
dddocky: bets 100
Duke Croix: calls 100
*** SHOW DOWN ***
dddocky: shows [7c As] (a pair of Aces)
Duke Croix: shows [8d Ad] (a pair of Aces)
dddocky collected 1063 from pot
Duke Croix collected 1063 from pot
*** SUMMARY ***
Total pot 2250 | Rake 124 
Board [4c Ks Tc Ac Qh]
Seat 1: dddocky (big blind) showed [7c As] and won (1063) with a pair of Aces
Seat 2: Duke Croix showed [8d Ad] and won (1063) with a pair of Aces
Seat 3: MnnM150 folded before Flop (didn't bet)
Seat 4: HighCardJasper (button) folded before Flop (didn't bet)
Seat 7: appositive (small blind) folded before Flop



PokerStars Home Game Hand #220088802521: {Club #3225207}  Hold'em No Limit (50/100) - 2020/11/05 18:01:27 ET
Table 'funzzzzzzzz' 9-max (Play Money) Seat #7 is the button
Seat 1: dddocky (9481 in chips) 
Seat 2: Duke Croix (12908 in chips) 
Seat 3: MnnM150 (8724 in chips) 
Seat 4: HighCardJasper (13084 in chips) 
Seat 7: appositive (19380 in chips) 
dddocky: posts small blind 50
Duke Croix: posts big blind 100
*** HOLE CARDS ***
Dealt to Duke Croix [5d 2c]
MnnM150: folds 
HighCardJasper: calls 100
appositive: raises 100 to 200
dddocky: calls 150
Duke Croix: calls 100
HighCardJasper: calls 100
*** FLOP *** [3s 4c 7d]
dddocky: checks 
Duke Croix: bets 400
HighCardJasper: folds 
appositive: folds 
dddocky: folds 
Uncalled bet (400) returned to Duke Croix
Duke Croix collected 756 from pot
*** SUMMARY ***
Total pot 800 | Rake 44 
Board [3s 4c 7d]
Seat 1: dddocky (small blind) folded on the Flop
Seat 2: Duke Croix (big blind) collected (756)
Seat 3: MnnM150 folded before Flop (didn't bet)
Seat 4: HighCardJasper folded on the Flop
Seat 7: appositive (button) folded on the Flop



PokerStars Home Game Hand #220088817433: {Club #3225207}  Hold'em No Limit (50/100) - 2020/11/05 18:01:57 ET
Table 'funzzzzzzzz' 9-max (Play Money) Seat #1 is the button
Seat 1: dddocky (9281 in chips) 
Seat 2: Duke Croix (13464 in chips) 
Seat 3: MnnM150 (8724 in chips) 
Seat 4: HighCardJasper (12884 in chips) 
Seat 7: appositive (19180 in chips) 
Duke Croix: posts small blind 50
MnnM150: posts big blind 100
*** HOLE CARDS ***
Dealt to Duke Croix [9c 8c]
HighCardJasper: calls 100
appositive: folds 
dddocky: calls 100
Duke Croix: calls 50
MnnM150: checks 
*** FLOP *** [Th 8s Qh]
Duke Croix: bets 200
MnnM150: calls 200
HighCardJasper: calls 200
dddocky: raises 200 to 400
Duke Croix: calls 200
MnnM150: calls 200
HighCardJasper: calls 200
*** TURN *** [Th 8s Qh] [5h]
Duke Croix: checks 
MnnM150: checks 
HighCardJasper: checks 
dddocky: bets 1890
Duke Croix: folds 
MnnM150: folds 
HighCardJasper: folds 
Uncalled bet (1890) returned to dddocky
dddocky collected 1890 from pot
dddocky: doesn't show hand 
*** SUMMARY ***
Total pot 2000 | Rake 110 
Board [Th 8s Qh 5h]
Seat 1: dddocky (button) collected (1890)
Seat 2: Duke Croix (small blind) folded on the Turn
Seat 3: MnnM150 (big blind) folded on the Turn
Seat 4: HighCardJasper folded on the Turn
Seat 7: appositive folded before Flop (didn't bet)



PokerStars Home Game Hand #220088847811: {Club #3225207}  Hold'em No Limit (50/100) - 2020/11/05 18:02:56 ET
Table 'funzzzzzzzz' 9-max (Play Money) Seat #2 is the button
Seat 1: dddocky (10671 in chips) 
Seat 2: Duke Croix (12964 in chips) 
Seat 3: MnnM150 (8224 in chips) 
Seat 4: HighCardJasper (12384 in chips) 
Seat 7: appositive (19180 in chips) 
MnnM150: posts small blind 50
HighCardJasper: posts big blind 100
*** HOLE CARDS ***
Dealt to Duke Croix [4d Jh]
appositive: calls 100
dddocky: calls 100
Duke Croix: calls 100
MnnM150: calls 50
HighCardJasper: checks 
*** FLOP *** [9s 8h 3s]
MnnM150: checks 
HighCardJasper: bets 100
appositive: calls 100
dddocky: folds 
Duke Croix: folds 
MnnM150: calls 100
*** TURN *** [9s 8h 3s] [6h]
MnnM150: checks 
HighCardJasper: checks 
appositive: bets 378
MnnM150: calls 378
HighCardJasper: folds 
*** RIVER *** [9s 8h 3s 6h] [5c]
MnnM150: checks 
appositive: bets 1470
MnnM150: folds 
Uncalled bet (1470) returned to appositive
appositive collected 1470 from pot
appositive: doesn't show hand 
*** SUMMARY ***
Total pot 1556 | Rake 86 
Board [9s 8h 3s 6h 5c]
Seat 1: dddocky folded on the Flop
Seat 2: Duke Croix (button) folded on the Flop
Seat 3: MnnM150 (small blind) folded on the River
Seat 4: HighCardJasper (big blind) folded on the Turn
Seat 7: appositive collected (1470)



PokerStars Home Game Hand #220088873852: {Club #3225207}  Hold'em No Limit (50/100) - 2020/11/05 18:03:48 ET
Table 'funzzzzzzzz' 9-max (Play Money) Seat #3 is the button
Seat 1: dddocky (10571 in chips) 
Seat 2: Duke Croix (12864 in chips) 
Seat 3: MnnM150 (7646 in chips) 
Seat 4: HighCardJasper (12184 in chips) 
Seat 7: appositive (20072 in chips) 
HighCardJasper: posts small blind 50
appositive: posts big blind 100
*** HOLE CARDS ***
Dealt to Duke Croix [3c 5c]
dddocky: calls 100
Duke Croix: calls 100
MnnM150: folds 
HighCardJasper: raises 200 to 300
appositive: raises 200 to 500
dddocky: folds 
Duke Croix: folds 
HighCardJasper: calls 200
*** FLOP *** [9h 9d Ts]
HighCardJasper: checks 
appositive: bets 1134
HighCardJasper: folds 
Uncalled bet (1134) returned to appositive
appositive collected 1134 from pot
appositive: doesn't show hand 
*** SUMMARY ***
Total pot 1200 | Rake 66 
Board [9h 9d Ts]
Seat 1: dddocky folded before Flop
Seat 2: Duke Croix folded before Flop
Seat 3: MnnM150 (button) folded before Flop (didn't bet)
Seat 4: HighCardJasper (small blind) folded on the Flop
Seat 7: appositive (big blind) collected (1134)



PokerStars Home Game Hand #220088890803: {Club #3225207}  Hold'em No Limit (50/100) - 2020/11/05 18:04:21 ET
Table 'funzzzzzzzz' 9-max (Play Money) Seat #4 is the button
Seat 1: dddocky (10471 in chips) 
Seat 2: Duke Croix (12764 in chips) 
Seat 3: MnnM150 (7646 in chips) 
Seat 4: HighCardJasper (11684 in chips) 
Seat 7: appositive (20706 in chips) 
appositive: posts small blind 50
dddocky: posts big blind 100
*** HOLE CARDS ***
Dealt to Duke Croix [7d Kc]
Duke Croix: calls 100
MnnM150: calls 100
HighCardJasper: calls 100
appositive: calls 50
dddocky: checks 
*** FLOP *** [6s 3d 8s]
appositive: checks 
dddocky: checks 
Duke Croix: checks 
MnnM150: checks 
HighCardJasper: checks 
*** TURN *** [6s 3d 8s] [Ad]
appositive: checks 
dddocky: checks 
Duke Croix: checks 
MnnM150: bets 100
HighCardJasper: calls 100
appositive: folds 
dddocky: calls 100
Duke Croix: folds 
*** RIVER *** [6s 3d 8s Ad] [4d]
dddocky: checks 
MnnM150: bets 100
HighCardJasper: raises 100 to 200
dddocky: folds 
MnnM150: calls 100
*** SHOW DOWN ***
HighCardJasper: shows [6h 4s] (two pair, Sixes and Fours)
MnnM150: mucks hand 
HighCardJasper collected 1134 from pot
*** SUMMARY ***
Total pot 1200 | Rake 66 
Board [6s 3d 8s Ad 4d]
Seat 1: dddocky (big blind) folded on the River
Seat 2: Duke Croix folded on the Turn
Seat 3: MnnM150 mucked [8d Js]
Seat 4: HighCardJasper (button) showed [6h 4s] and won (1134) with two pair, Sixes and Fours
Seat 7: appositive (small blind) folded on the Turn



PokerStars Home Game Hand #220088909156: {Club #3225207}  Hold'em No Limit (50/100) - 2020/11/05 18:04:57 ET
Table 'funzzzzzzzz' 9-max (Play Money) Seat #7 is the button
Seat 1: dddocky (10271 in chips) 
Seat 2: Duke Croix (12664 in chips) 
Seat 3: MnnM150 (7246 in chips) 
Seat 4: HighCardJasper (12418 in chips) 
Seat 7: appositive (20606 in chips) 
dddocky: posts small blind 50
Duke Croix: posts big blind 100
*** HOLE CARDS ***
Dealt to Duke Croix [Ah 4h]
MnnM150: folds 
HighCardJasper: calls 100
appositive: folds 
dddocky: folds 
Duke Croix: raises 300 to 400
HighCardJasper: calls 300
*** FLOP *** [Ac 7h 7c]
Duke Croix: bets 500
HighCardJasper: folds 
Uncalled bet (500) returned to Duke Croix
Duke Croix collected 803 from pot
*** SUMMARY ***
Total pot 850 | Rake 47 
Board [Ac 7h 7c]
Seat 1: dddocky (small blind) folded before Flop
Seat 2: Duke Croix (big blind) collected (803)
Seat 3: MnnM150 folded before Flop (didn't bet)
Seat 4: HighCardJasper folded on the Flop
Seat 7: appositive (button) folded before Flop (didn't bet)



PokerStars Home Game Hand #220088922875: {Club #3225207}  Hold'em No Limit (50/100) - 2020/11/05 18:05:23 ET
Table 'funzzzzzzzz' 9-max (Play Money) Seat #1 is the button
Seat 1: dddocky (10221 in chips) 
Seat 2: Duke Croix (13067 in chips) 
Seat 3: MnnM150 (7246 in chips) 
Seat 4: HighCardJasper (12018 in chips) 
Seat 7: appositive (20606 in chips) 
Duke Croix: posts small blind 50
MnnM150: posts big blind 100
*** HOLE CARDS ***
Dealt to Duke Croix [9c Jh]
HighCardJasper: raises 100 to 200
appositive: raises 100 to 300
dddocky: calls 300
Duke Croix: folds 
MnnM150: calls 200
HighCardJasper: calls 100
*** FLOP *** [Kc 7c 8h]
MnnM150: checks 
HighCardJasper: checks 
appositive: bets 590
dddocky: calls 590
MnnM150: folds 
HighCardJasper: folds 
*** TURN *** [Kc 7c 8h] [Tc]
appositive: bets 1148
dddocky: calls 1148
*** RIVER *** [Kc 7c 8h Tc] [2s]
appositive: bets 18568 and is all-in
dddocky: calls 8183 and is all-in
Uncalled bet (10385) returned to appositive
*** SHOW DOWN ***
appositive: shows [2d 2h] (three of a kind, Deuces)
dddocky: shows [Ac 4c] (a flush, Ace high)
dddocky collected 19932 from pot
*** SUMMARY ***
Total pot 21092 | Rake 1160 
Board [Kc 7c 8h Tc 2s]
Seat 1: dddocky (button) showed [Ac 4c] and won (19932) with a flush, Ace high
Seat 2: Duke Croix (small blind) folded before Flop
Seat 3: MnnM150 (big blind) folded on the Flop
Seat 4: HighCardJasper folded on the Flop
Seat 7: appositive showed [2d 2h] and lost with three of a kind, Deuces



PokerStars Home Game Hand #220088943263: {Club #3225207}  Hold'em No Limit (50/100) - 2020/11/05 18:06:04 ET
Table 'funzzzzzzzz' 9-max (Play Money) Seat #2 is the button
Seat 1: dddocky (19932 in chips) 
Seat 2: Duke Croix (13017 in chips) 
Seat 3: MnnM150 (6946 in chips) 
Seat 4: HighCardJasper (11718 in chips) 
Seat 7: appositive (10385 in chips) 
MnnM150: posts small blind 50
HighCardJasper: posts big blind 100
*** HOLE CARDS ***
Dealt to Duke Croix [6h 9c]
appositive: calls 100
dddocky: calls 100
Duke Croix: folds 
MnnM150: raises 100 to 200
HighCardJasper: calls 100
appositive: calls 100
dddocky: calls 100
*** FLOP *** [5s 8h 9h]
MnnM150: checks 
HighCardJasper: checks 
appositive: checks 
dddocky: checks 
*** TURN *** [5s 8h 9h] [2d]
MnnM150: checks 
HighCardJasper: checks 
appositive: checks 
dddocky: checks 
*** RIVER *** [5s 8h 9h 2d] [6d]
MnnM150: checks 
HighCardJasper: bets 100
appositive: calls 100
dddocky: calls 100
MnnM150: calls 100
*** SHOW DOWN ***
HighCardJasper: shows [Jd 3c] (high card Jack)
appositive: shows [Qc As] (high card Ace)
dddocky: mucks hand 
MnnM150: mucks hand 
appositive collected 1134 from pot
*** SUMMARY ***
Total pot 1200 | Rake 66 
Board [5s 8h 9h 2d 6d]
Seat 1: dddocky mucked [3s Ah]
Seat 2: Duke Croix (button) folded before Flop (didn't bet)
Seat 3: MnnM150 (small blind) mucked [Ac Jc]
Seat 4: HighCardJasper (big blind) showed [Jd 3c] and lost with high card Jack
Seat 7: appositive showed [Qc As] and won (1134) with high card Ace



PokerStars Home Game Hand #220088967819: {Club #3225207}  Hold'em No Limit (50/100) - 2020/11/05 18:06:52 ET
Table 'funzzzzzzzz' 9-max (Play Money) Seat #3 is the button
Seat 1: dddocky (19632 in chips) 
Seat 2: Duke Croix (13017 in chips) 
Seat 3: MnnM150 (6646 in chips) 
Seat 4: HighCardJasper (11418 in chips) 
Seat 7: appositive (11219 in chips) 
HighCardJasper: posts small blind 50
appositive: posts big blind 100
*** HOLE CARDS ***
Dealt to Duke Croix [Ks 3c]
dddocky: calls 100
Duke Croix: folds 
MnnM150: calls 100
HighCardJasper: calls 50
appositive: checks 
*** FLOP *** [Ad Js Kh]
HighCardJasper: checks 
appositive: bets 189
dddocky: folds 
MnnM150: calls 189
HighCardJasper: folds 
*** TURN *** [Ad Js Kh] [9d]
appositive: bets 735
MnnM150: folds 
Uncalled bet (735) returned to appositive
appositive collected 735 from pot
appositive: doesn't show hand 
*** SUMMARY ***
Total pot 778 | Rake 43 
Board [Ad Js Kh 9d]
Seat 1: dddocky folded on the Flop
Seat 2: Duke Croix folded before Flop (didn't bet)
Seat 3: MnnM150 (button) folded on the Turn
Seat 4: HighCardJasper (small blind) folded on the Flop
Seat 7: appositive (big blind) collected (735)



PokerStars Home Game Hand #220088982303: {Club #3225207}  Hold'em No Limit (50/100) - 2020/11/05 18:07:21 ET
Table 'funzzzzzzzz' 9-max (Play Money) Seat #4 is the button
Seat 1: dddocky (19532 in chips) 
Seat 2: Duke Croix (13017 in chips) 
Seat 3: MnnM150 (6357 in chips) 
Seat 4: HighCardJasper (11318 in chips) 
Seat 7: appositive (11665 in chips) 
appositive: posts small blind 50
dddocky: posts big blind 100
*** HOLE CARDS ***
Dealt to Duke Croix [4c 9s]
Duke Croix: folds 
MnnM150: folds 
HighCardJasper: calls 100
appositive: calls 50
dddocky: checks 
*** FLOP *** [3d Td Qh]
appositive: checks 
dddocky: checks 
HighCardJasper: checks 
*** TURN *** [3d Td Qh] [5c]
appositive: checks 
dddocky: checks 
HighCardJasper: checks 
*** RIVER *** [3d Td Qh 5c] [2h]
appositive: checks 
dddocky: checks 
HighCardJasper: bets 100
appositive: calls 100
dddocky: calls 100
*** SHOW DOWN ***
HighCardJasper: shows [4h Ks] (high card King)
appositive: shows [Ad 6s] (high card Ace)
dddocky: mucks hand 
appositive collected 567 from pot
*** SUMMARY ***
Total pot 600 | Rake 33 
Board [3d Td Qh 5c 2h]
Seat 1: dddocky (big blind) mucked [Jh 6h]
Seat 2: Duke Croix folded before Flop (didn't bet)
Seat 3: MnnM150 folded before Flop (didn't bet)
Seat 4: HighCardJasper (button) showed [4h Ks] and lost with high card King
Seat 7: appositive (small blind) showed [Ad 6s] and won (567) with high card Ace



PokerStars Home Game Hand #220089002071: {Club #3225207}  Hold'em No Limit (50/100) - 2020/11/05 18:08:01 ET
Table 'funzzzzzzzz' 9-max (Play Money) Seat #7 is the button
Seat 1: dddocky (19332 in chips) 
Seat 2: Duke Croix (13017 in chips) 
Seat 3: MnnM150 (6357 in chips) 
Seat 4: HighCardJasper (11118 in chips) 
Seat 7: appositive (12032 in chips) 
dddocky: posts small blind 50
Duke Croix: posts big blind 100
*** HOLE CARDS ***
Dealt to Duke Croix [3s 8h]
MnnM150: calls 100
HighCardJasper: calls 100
appositive: folds 
dddocky: folds 
Duke Croix: checks 
*** FLOP *** [7d 7h Jd]
Duke Croix: checks 
MnnM150: checks 
HighCardJasper: checks 
*** TURN *** [7d 7h Jd] [6d]
Duke Croix: checks 
MnnM150: checks 
HighCardJasper: checks 
*** RIVER *** [7d 7h Jd 6d] [7c]
Duke Croix: checks 
MnnM150: checks 
HighCardJasper: checks 
*** SHOW DOWN ***
Duke Croix: shows [3s 8h] (three of a kind, Sevens)
MnnM150: shows [Th 5h] (three of a kind, Sevens - Jack+Ten kicker)
HighCardJasper: shows [5s Ah] (three of a kind, Sevens - Ace kicker)
HighCardJasper collected 331 from pot
*** SUMMARY ***
Total pot 350 | Rake 19 
Board [7d 7h Jd 6d 7c]
Seat 1: dddocky (small blind) folded before Flop
Seat 2: Duke Croix (big blind) showed [3s 8h] and lost with three of a kind, Sevens
Seat 3: MnnM150 showed [Th 5h] and lost with three of a kind, Sevens
Seat 4: HighCardJasper showed [5s Ah] and won (331) with three of a kind, Sevens
Seat 7: appositive (button) folded before Flop (didn't bet)



PokerStars Home Game Hand #220089015997: {Club #3225207}  Hold'em No Limit (50/100) - 2020/11/05 18:08:28 ET
Table 'funzzzzzzzz' 9-max (Play Money) Seat #1 is the button
Seat 1: dddocky (19282 in chips) 
Seat 2: Duke Croix (12917 in chips) 
Seat 3: MnnM150 (6257 in chips) 
Seat 4: HighCardJasper (11349 in chips) 
Seat 7: appositive (12032 in chips) 
Duke Croix: posts small blind 50
MnnM150: posts big blind 100
*** HOLE CARDS ***
Dealt to Duke Croix [Ac 6h]
HighCardJasper: calls 100
appositive: folds 
dddocky: folds 
Duke Croix: raises 300 to 400
MnnM150: folds 
HighCardJasper: folds 
Uncalled bet (300) returned to Duke Croix
Duke Croix collected 300 from pot
*** SUMMARY ***
Total pot 300 | Rake 0 
Seat 1: dddocky (button) folded before Flop (didn't bet)
Seat 2: Duke Croix (small blind) collected (300)
Seat 3: MnnM150 (big blind) folded before Flop
Seat 4: HighCardJasper folded before Flop
Seat 7: appositive folded before Flop (didn't bet)



PokerStars Home Game Hand #220089022252: {Club #3225207}  Hold'em No Limit (50/100) - 2020/11/05 18:08:41 ET
Table 'funzzzzzzzz' 9-max (Play Money) Seat #2 is the button
Seat 1: dddocky (19282 in chips) 
Seat 2: Duke Croix (13117 in chips) 
Seat 3: MnnM150 (6157 in chips) 
Seat 4: HighCardJasper (11249 in chips) 
Seat 7: appositive (12032 in chips) 
MnnM150: posts small blind 50
HighCardJasper: posts big blind 100
*** HOLE CARDS ***
Dealt to Duke Croix [Ah 6d]
appositive: folds 
dddocky: calls 100
Duke Croix: raises 300 to 400
MnnM150: folds 
HighCardJasper: folds 
dddocky: folds 
Uncalled bet (300) returned to Duke Croix
Duke Croix collected 350 from pot
*** SUMMARY ***
Total pot 350 | Rake 0 
Seat 1: dddocky folded before Flop
Seat 2: Duke Croix (button) collected (350)
Seat 3: MnnM150 (small blind) folded before Flop
Seat 4: HighCardJasper (big blind) folded before Flop
Seat 7: appositive folded before Flop (didn't bet)



PokerStars Home Game Hand #220089027661: {Club #3225207}  Hold'em No Limit (50/100) - 2020/11/05 18:08:51 ET
Table 'funzzzzzzzz' 9-max (Play Money) Seat #3 is the button
Seat 1: dddocky (19182 in chips) 
Seat 2: Duke Croix (13367 in chips) 
Seat 3: MnnM150 (6107 in chips) 
Seat 4: HighCardJasper (11149 in chips) 
Seat 7: appositive (12032 in chips) 
HighCardJasper: posts small blind 50
appositive: posts big blind 100
*** HOLE CARDS ***
Dealt to Duke Croix [9s Kc]
dddocky: folds 
Duke Croix: raises 300 to 400
MnnM150: folds 
HighCardJasper: folds 
appositive: raises 300 to 700
Duke Croix: calls 300
*** FLOP *** [Ad 9c 6h]
appositive: bets 685
Duke Croix: calls 685
*** TURN *** [Ad 9c 6h] [7c]
appositive: bets 2665
Duke Croix: folds 
Uncalled bet (2665) returned to appositive
appositive collected 2665 from pot
appositive: doesn't show hand 
*** SUMMARY ***
Total pot 2820 | Rake 155 
Board [Ad 9c 6h 7c]
Seat 1: dddocky folded before Flop (didn't bet)
Seat 2: Duke Croix folded on the Turn
Seat 3: MnnM150 (button) folded before Flop (didn't bet)
Seat 4: HighCardJasper (small blind) folded before Flop
Seat 7: appositive (big blind) collected (2665)



PokerStars Home Game Hand #220089042482: {Club #3225207}  Hold'em No Limit (50/100) - 2020/11/05 18:09:20 ET
Table 'funzzzzzzzz' 9-max (Play Money) Seat #4 is the button
Seat 1: dddocky (19182 in chips) 
Seat 2: Duke Croix (11982 in chips) 
Seat 3: MnnM150 (6107 in chips) 
Seat 4: HighCardJasper (11099 in chips) 
Seat 7: appositive (13312 in chips) 
appositive: posts small blind 50
dddocky: posts big blind 100
*** HOLE CARDS ***
Dealt to Duke Croix [7h Jc]
Duke Croix: calls 100
MnnM150: folds 
HighCardJasper: folds 
appositive: calls 50
dddocky: checks 
*** FLOP *** [3s 9c 3d]
appositive: checks 
dddocky: checks 
Duke Croix: checks 
*** TURN *** [3s 9c 3d] [Ks]
appositive: checks 
dddocky: checks 
Duke Croix: checks 
*** RIVER *** [3s 9c 3d Ks] [3h]
appositive: checks 
dddocky: checks 
Duke Croix: checks 
*** SHOW DOWN ***
appositive: shows [2h Qc] (three of a kind, Threes)
dddocky: mucks hand 
Duke Croix: mucks hand 
appositive collected 283 from pot
*** SUMMARY ***
Total pot 300 | Rake 17 
Board [3s 9c 3d Ks 3h]
Seat 1: dddocky (big blind) mucked [Jd 5s]
Seat 2: Duke Croix mucked [7h Jc]
Seat 3: MnnM150 folded before Flop (didn't bet)
Seat 4: HighCardJasper (button) folded before Flop (didn't bet)
Seat 7: appositive (small blind) showed [2h Qc] and won (283) with three of a kind, Threes



PokerStars Home Game Hand #220089055489: {Club #3225207}  Hold'em No Limit (50/100) - 2020/11/05 18:09:46 ET
Table 'funzzzzzzzz' 9-max (Play Money) Seat #7 is the button
Seat 1: dddocky (19082 in chips) 
Seat 2: Duke Croix (11882 in chips) 
Seat 3: MnnM150 (6107 in chips) 
Seat 4: HighCardJasper (11099 in chips) 
Seat 7: appositive (13495 in chips) 
dddocky: posts small blind 50
Duke Croix: posts big blind 100
*** HOLE CARDS ***
Dealt to Duke Croix [Kd Qh]
MnnM150: calls 100
HighCardJasper: calls 100
appositive: folds 
dddocky: calls 50
Duke Croix: raises 400 to 500
MnnM150: folds 
HighCardJasper: folds 
dddocky: folds 
Uncalled bet (400) returned to Duke Croix
Duke Croix collected 400 from pot
*** SUMMARY ***
Total pot 400 | Rake 0 
Seat 1: dddocky (small blind) folded before Flop
Seat 2: Duke Croix (big blind) collected (400)
Seat 3: MnnM150 folded before Flop
Seat 4: HighCardJasper folded before Flop
Seat 7: appositive (button) folded before Flop (didn't bet)



PokerStars Home Game Hand #220089064465: {Club #3225207}  Hold'em No Limit (50/100) - 2020/11/05 18:10:04 ET
Table 'funzzzzzzzz' 9-max (Play Money) Seat #1 is the button
Seat 1: dddocky (18982 in chips) 
Seat 2: Duke Croix (12182 in chips) 
Seat 3: MnnM150 (6007 in chips) 
Seat 4: HighCardJasper (10999 in chips) 
Seat 7: appositive (13495 in chips) 
Duke Croix: posts small blind 50
MnnM150: posts big blind 100
*** HOLE CARDS ***
Dealt to Duke Croix [3d Jd]
HighCardJasper: calls 100
appositive: calls 100
dddocky: folds 
Duke Croix: calls 50
MnnM150: checks 
*** FLOP *** [6s 8s Jc]
Duke Croix: bets 300
MnnM150: folds 
HighCardJasper: calls 300
appositive: folds 
*** TURN *** [6s 8s Jc] [6d]
Duke Croix: checks 
HighCardJasper: checks 
*** RIVER *** [6s 8s Jc 6d] [8h]
Duke Croix: checks 
HighCardJasper: checks 
*** SHOW DOWN ***
Duke Croix: shows [3d Jd] (two pair, Jacks and Eights)
HighCardJasper: mucks hand 
Duke Croix collected 945 from pot
*** SUMMARY ***
Total pot 1000 | Rake 55 
Board [6s 8s Jc 6d 8h]
Seat 1: dddocky (button) folded before Flop (didn't bet)
Seat 2: Duke Croix (small blind) showed [3d Jd] and won (945) with two pair, Jacks and Eights
Seat 3: MnnM150 (big blind) folded on the Flop
Seat 4: HighCardJasper mucked [9s 7h]
Seat 7: appositive folded on the Flop



PokerStars Home Game Hand #220089083518: {Club #3225207}  Hold'em No Limit (50/100) - 2020/11/05 18:10:42 ET
Table 'funzzzzzzzz' 9-max (Play Money) Seat #2 is the button
Seat 1: dddocky (18982 in chips) 
Seat 2: Duke Croix (12727 in chips) 
Seat 3: MnnM150 (5907 in chips) 
Seat 4: HighCardJasper (10599 in chips) 
Seat 7: appositive (13395 in chips) 
MnnM150: posts small blind 50
HighCardJasper: posts big blind 100
*** HOLE CARDS ***
Dealt to Duke Croix [Js Ad]
appositive: calls 100
dddocky: calls 100
Duke Croix: raises 300 to 400
MnnM150: folds 
HighCardJasper: folds 
appositive: calls 300
dddocky: calls 300
*** FLOP *** [7c 7h 8h]
appositive: bets 1276
dddocky: folds 
Duke Croix: folds 
Uncalled bet (1276) returned to appositive
appositive collected 1276 from pot
appositive: doesn't show hand 
*** SUMMARY ***
Total pot 1350 | Rake 74 
Board [7c 7h 8h]
Seat 1: dddocky folded on the Flop
Seat 2: Duke Croix (button) folded on the Flop
Seat 3: MnnM150 (small blind) folded before Flop
Seat 4: HighCardJasper (big blind) folded before Flop
Seat 7: appositive collected (1276)



PokerStars Home Game Hand #220089096791: {Club #3225207}  Hold'em No Limit (50/100) - 2020/11/05 18:11:09 ET
Table 'funzzzzzzzz' 9-max (Play Money) Seat #3 is the button
Seat 1: dddocky (18582 in chips) 
Seat 2: Duke Croix (12327 in chips) 
Seat 3: MnnM150 (5857 in chips) 
Seat 4: HighCardJasper (10499 in chips) 
Seat 7: appositive (14271 in chips) 
HighCardJasper: posts small blind 50
appositive: posts big blind 100
*** HOLE CARDS ***
Dealt to Duke Croix [3c 6d]
dddocky: calls 100
Duke Croix: folds 
MnnM150: folds 
HighCardJasper: calls 50
appositive: checks 
*** FLOP *** [2d Kh 5c]
HighCardJasper: bets 100
appositive: calls 100
dddocky: raises 100 to 200
HighCardJasper: raises 100 to 300
appositive: folds 
dddocky: calls 100
*** TURN *** [2d Kh 5c] [8d]
HighCardJasper: bets 300
dddocky: calls 300
*** RIVER *** [2d Kh 5c 8d] [Ks]
HighCardJasper: bets 600
dddocky: calls 600
*** SHOW DOWN ***
HighCardJasper: shows [2h Kc] (a full house, Kings full of Deuces)
dddocky: mucks hand 
HighCardJasper collected 2646 from pot
*** SUMMARY ***
Total pot 2800 | Rake 154 
Board [2d Kh 5c 8d Ks]
Seat 1: dddocky mucked [Qh Kd]
Seat 2: Duke Croix folded before Flop (didn't bet)
Seat 3: MnnM150 (button) folded before Flop (didn't bet)
Seat 4: HighCardJasper (small blind) showed [2h Kc] and won (2646) with a full house, Kings full of Deuces
Seat 7: appositive (big blind) folded on the Flop



PokerStars Home Game Hand #220089121868: {Club #3225207}  Hold'em No Limit (50/100) - 2020/11/05 18:11:59 ET
Table 'funzzzzzzzz' 9-max (Play Money) Seat #4 is the button
Seat 1: dddocky (17282 in chips) 
Seat 2: Duke Croix (12327 in chips) 
Seat 3: MnnM150 (5857 in chips) 
Seat 4: HighCardJasper (11845 in chips) 
Seat 7: appositive (14071 in chips) 
appositive: posts small blind 50
dddocky: posts big blind 100
*** HOLE CARDS ***
Dealt to Duke Croix [5h Ah]
Duke Croix: raises 300 to 400
MnnM150: folds 
HighCardJasper: folds 
appositive: calls 350
dddocky: folds 
*** FLOP *** [Kh 7h Ts]
appositive: checks 
Duke Croix: bets 500
appositive: folds 
Uncalled bet (500) returned to Duke Croix
Duke Croix collected 850 from pot
*** SUMMARY ***
Total pot 900 | Rake 50 
Board [Kh 7h Ts]
Seat 1: dddocky (big blind) folded before Flop
Seat 2: Duke Croix collected (850)
Seat 3: MnnM150 folded before Flop (didn't bet)
Seat 4: HighCardJasper (button) folded before Flop (didn't bet)
Seat 7: appositive (small blind) folded on the Flop



PokerStars Home Game Hand #220089133499: {Club #3225207}  Hold'em No Limit (50/100) - 2020/11/05 18:12:23 ET
Table 'funzzzzzzzz' 9-max (Play Money) Seat #7 is the button
Seat 1: dddocky (17182 in chips) 
Seat 2: Duke Croix (12777 in chips) 
Seat 3: MnnM150 (5857 in chips) 
Seat 4: HighCardJasper (11845 in chips) 
Seat 7: appositive (13671 in chips) 
dddocky: posts small blind 50
Duke Croix: posts big blind 100
*** HOLE CARDS ***
Dealt to Duke Croix [4h 6h]
MnnM150: folds 
HighCardJasper: calls 100
appositive: calls 100
dddocky: calls 50
Duke Croix: checks 
*** FLOP *** [Ad 5c 3h]
dddocky: bets 100
Duke Croix: raises 100 to 200
HighCardJasper: calls 200
appositive: folds 
dddocky: calls 100
*** TURN *** [Ad 5c 3h] [Jc]
dddocky: bets 100
Duke Croix: raises 300 to 400
HighCardJasper: calls 400
dddocky: calls 300
*** RIVER *** [Ad 5c 3h Jc] [3s]
dddocky: bets 100
Duke Croix: folds 
HighCardJasper: raises 400 to 500
dddocky: calls 400
*** SHOW DOWN ***
HighCardJasper: shows [Ah 8c] (two pair, Aces and Threes)
dddocky: shows [9c Ac] (two pair, Aces and Threes)
dddocky collected 1512 from pot
HighCardJasper collected 1512 from pot
*** SUMMARY ***
Total pot 3200 | Rake 176 
Board [Ad 5c 3h Jc 3s]
Seat 1: dddocky (small blind) showed [9c Ac] and won (1512) with two pair, Aces and Threes
Seat 2: Duke Croix (big blind) folded on the River
Seat 3: MnnM150 folded before Flop (didn't bet)
Seat 4: HighCardJasper showed [Ah 8c] and won (1512) with two pair, Aces and Threes
Seat 7: appositive (button) folded on the Flop



PokerStars Home Game Hand #220089154676: {Club #3225207}  Hold'em No Limit (50/100) - 2020/11/05 18:13:05 ET
Table 'funzzzzzzzz' 9-max (Play Money) Seat #1 is the button
Seat 1: dddocky (17494 in chips) 
Seat 2: Duke Croix (12077 in chips) 
Seat 3: MnnM150 (5857 in chips) 
Seat 4: HighCardJasper (12157 in chips) 
Seat 7: appositive (13571 in chips) 
Duke Croix: posts small blind 50
MnnM150: posts big blind 100
*** HOLE CARDS ***
Dealt to Duke Croix [6s Kh]
HighCardJasper: calls 100
appositive: raises 100 to 200
dddocky: calls 200
Duke Croix: calls 150
MnnM150: folds 
HighCardJasper: calls 100
*** FLOP *** [Th Qd 5s]
Duke Croix: checks 
HighCardJasper: checks 
appositive: checks 
dddocky: bets 100
Duke Croix: folds 
HighCardJasper: calls 100
appositive: calls 100
*** TURN *** [Th Qd 5s] [Ac]
HighCardJasper: checks 
appositive: checks 
dddocky: checks 
*** RIVER *** [Th Qd 5s Ac] [7h]
HighCardJasper: checks 
appositive: checks 
dddocky: checks 
*** SHOW DOWN ***
HighCardJasper: shows [3c 3s] (a pair of Threes)
appositive: mucks hand 
dddocky: shows [Qh Js] (a pair of Queens)
dddocky collected 1134 from pot
*** SUMMARY ***
Total pot 1200 | Rake 66 
Board [Th Qd 5s Ac 7h]
Seat 1: dddocky (button) showed [Qh Js] and won (1134) with a pair of Queens
Seat 2: Duke Croix (small blind) folded on the Flop
Seat 3: MnnM150 (big blind) folded before Flop
Seat 4: HighCardJasper showed [3c 3s] and lost with a pair of Threes
Seat 7: appositive mucked [6h 2h]



PokerStars Home Game Hand #220089174341: {Club #3225207}  Hold'em No Limit (50/100) - 2020/11/05 18:13:45 ET
Table 'funzzzzzzzz' 9-max (Play Money) Seat #2 is the button
Seat 1: dddocky (18328 in chips) 
Seat 2: Duke Croix (11877 in chips) 
Seat 3: MnnM150 (5757 in chips) 
Seat 4: HighCardJasper (11857 in chips) 
Seat 7: appositive (13271 in chips) 
MnnM150: posts small blind 50
HighCardJasper: posts big blind 100
*** HOLE CARDS ***
Dealt to Duke Croix [Jc 9d]
appositive: calls 100
dddocky: calls 100
Duke Croix: calls 100
MnnM150: folds 
HighCardJasper: raises 100 to 200
appositive: calls 100
dddocky: calls 100
Duke Croix: calls 100
*** FLOP *** [Td 7d Ts]
HighCardJasper: checks 
appositive: checks 
dddocky: checks 
Duke Croix: checks 
*** TURN *** [Td 7d Ts] [Th]
HighCardJasper: checks 
appositive: checks 
dddocky: checks 
Duke Croix: checks 
*** RIVER *** [Td 7d Ts Th] [6s]
HighCardJasper: checks 
appositive: checks 
dddocky: checks 
Duke Croix: checks 
*** SHOW DOWN ***
HighCardJasper: shows [2h Qh] (three of a kind, Tens)
appositive: mucks hand 
dddocky: mucks hand 
Duke Croix: mucks hand 
HighCardJasper collected 803 from pot
*** SUMMARY ***
Total pot 850 | Rake 47 
Board [Td 7d Ts Th 6s]
Seat 1: dddocky mucked [Jh 4s]
Seat 2: Duke Croix (button) mucked [Jc 9d]
Seat 3: MnnM150 (small blind) folded before Flop
Seat 4: HighCardJasper (big blind) showed [2h Qh] and won (803) with three of a kind, Tens
Seat 7: appositive mucked [9c 3c]



PokerStars Home Game Hand #220089196428: {Club #3225207}  Hold'em No Limit (50/100) - 2020/11/05 18:14:30 ET
Table 'funzzzzzzzz' 9-max (Play Money) Seat #3 is the button
Seat 1: dddocky (18128 in chips) 
Seat 2: Duke Croix (11677 in chips) 
Seat 3: MnnM150 (5707 in chips) 
Seat 4: HighCardJasper (12460 in chips) 
Seat 7: appositive (13071 in chips) 
HighCardJasper: posts small blind 50
appositive: posts big blind 100
*** HOLE CARDS ***
Dealt to Duke Croix [2s 7d]
dddocky: folds 
Duke Croix: folds 
MnnM150: folds 
HighCardJasper: calls 50
appositive: raises 100 to 200
HighCardJasper: calls 100
*** FLOP *** [Td 3s As]
HighCardJasper: bets 100
appositive: raises 578 to 678
HighCardJasper: folds 
Uncalled bet (578) returned to appositive
appositive collected 567 from pot
appositive: doesn't show hand 
*** SUMMARY ***
Total pot 600 | Rake 33 
Board [Td 3s As]
Seat 1: dddocky folded before Flop (didn't bet)
Seat 2: Duke Croix folded before Flop (didn't bet)
Seat 3: MnnM150 (button) folded before Flop (didn't bet)
Seat 4: HighCardJasper (small blind) folded on the Flop
Seat 7: appositive (big blind) collected (567)



PokerStars Home Game Hand #220089206400: {Club #3225207}  Hold'em No Limit (50/100) - 2020/11/05 18:14:50 ET
Table 'funzzzzzzzz' 9-max (Play Money) Seat #4 is the button
Seat 1: dddocky (18128 in chips) 
Seat 2: Duke Croix (11677 in chips) 
Seat 3: MnnM150 (5707 in chips) 
Seat 4: HighCardJasper (12160 in chips) 
Seat 7: appositive (13338 in chips) 
appositive: posts small blind 50
dddocky: posts big blind 100
*** HOLE CARDS ***
Dealt to Duke Croix [Th 5d]
Duke Croix: folds 
MnnM150: calls 100
HighCardJasper: calls 100
appositive: folds 
dddocky: checks 
*** FLOP *** [3h 5c 8d]
dddocky: bets 165
MnnM150: calls 165
HighCardJasper: calls 165
*** TURN *** [3h 5c 8d] [9d]
dddocky: checks 
MnnM150: checks 
HighCardJasper: checks 
*** RIVER *** [3h 5c 8d 9d] [7h]
dddocky: bets 799
MnnM150: folds 
HighCardJasper: folds 
Uncalled bet (799) returned to dddocky
dddocky collected 799 from pot
dddocky: doesn't show hand 
*** SUMMARY ***
Total pot 845 | Rake 46 
Board [3h 5c 8d 9d 7h]
Seat 1: dddocky (big blind) collected (799)
Seat 2: Duke Croix folded before Flop (didn't bet)
Seat 3: MnnM150 folded on the River
Seat 4: HighCardJasper (button) folded on the River
Seat 7: appositive (small blind) folded before Flop



PokerStars Home Game Hand #220089224328: {Club #3225207}  Hold'em No Limit (50/100) - 2020/11/05 18:15:26 ET
Table 'funzzzzzzzz' 9-max (Play Money) Seat #7 is the button
Seat 1: dddocky (18662 in chips) 
Seat 2: Duke Croix (11677 in chips) 
Seat 3: MnnM150 (5442 in chips) 
Seat 4: HighCardJasper (11895 in chips) 
Seat 7: appositive (13288 in chips) 
dddocky: posts small blind 50
Duke Croix: posts big blind 100
*** HOLE CARDS ***
Dealt to Duke Croix [7s Ah]
MnnM150: calls 100
HighCardJasper: calls 100
appositive: calls 100
dddocky: folds 
Duke Croix: raises 300 to 400
MnnM150: folds 
HighCardJasper: folds 
appositive: calls 300
*** FLOP *** [5c Jc Jd]
Duke Croix: checks 
appositive: bets 496
Duke Croix: calls 496
*** TURN *** [5c Jc Jd] [7c]
Duke Croix: checks 
appositive: bets 965
Duke Croix: calls 965
*** RIVER *** [5c Jc Jd 7c] [2s]
Duke Croix: checks 
appositive: checks 
*** SHOW DOWN ***
Duke Croix: shows [7s Ah] (two pair, Jacks and Sevens)
appositive: mucks hand 
Duke Croix collected 3754 from pot
*** SUMMARY ***
Total pot 3972 | Rake 218 
Board [5c Jc Jd 7c 2s]
Seat 1: dddocky (small blind) folded before Flop
Seat 2: Duke Croix (big blind) showed [7s Ah] and won (3754) with two pair, Jacks and Sevens
Seat 3: MnnM150 folded before Flop
Seat 4: HighCardJasper folded before Flop
Seat 7: appositive (button) mucked [Kd 4d]



PokerStars Home Game Hand #220089250406: {Club #3225207}  Hold'em No Limit (50/100) - 2020/11/05 18:16:19 ET
Table 'funzzzzzzzz' 9-max (Play Money) Seat #1 is the button
Seat 1: dddocky (18612 in chips) 
Seat 2: Duke Croix (13570 in chips) 
Seat 3: MnnM150 (5342 in chips) 
Seat 4: HighCardJasper (11795 in chips) 
Seat 7: appositive (11427 in chips) 
Duke Croix: posts small blind 50
MnnM150: posts big blind 100
*** HOLE CARDS ***
Dealt to Duke Croix [Tc 7d]
HighCardJasper: calls 100
appositive: folds 
dddocky: calls 100
Duke Croix: calls 50
MnnM150: checks 
*** FLOP *** [Ah Jc Ac]
Duke Croix: checks 
MnnM150: checks 
HighCardJasper: checks 
dddocky: checks 
*** TURN *** [Ah Jc Ac] [Kd]
Duke Croix: checks 
MnnM150: bets 378
HighCardJasper: folds 
dddocky: folds 
Duke Croix: folds 
Uncalled bet (378) returned to MnnM150
MnnM150 collected 378 from pot
*** SUMMARY ***
Total pot 400 | Rake 22 
Board [Ah Jc Ac Kd]
Seat 1: dddocky (button) folded on the Turn
Seat 2: Duke Croix (small blind) folded on the Turn
Seat 3: MnnM150 (big blind) collected (378)
Seat 4: HighCardJasper folded on the Turn
Seat 7: appositive folded before Flop (didn't bet)



PokerStars Home Game Hand #220089267816: {Club #3225207}  Hold'em No Limit (50/100) - 2020/11/05 18:16:55 ET
Table 'funzzzzzzzz' 9-max (Play Money) Seat #2 is the button
Seat 1: dddocky (18512 in chips) 
Seat 2: Duke Croix (13470 in chips) 
Seat 3: MnnM150 (5620 in chips) 
Seat 4: HighCardJasper (11695 in chips) 
Seat 7: appositive (11427 in chips) 
MnnM150: posts small blind 50
HighCardJasper: posts big blind 100
*** HOLE CARDS ***
Dealt to Duke Croix [9h Kh]
appositive: calls 100
dddocky: calls 100
Duke Croix: raises 300 to 400
MnnM150: calls 350
HighCardJasper: calls 300
appositive: raises 300 to 700
dddocky: folds 
Duke Croix: calls 300
MnnM150: calls 300
HighCardJasper: calls 300
*** FLOP *** [5s 6s 8c]
MnnM150: checks 
HighCardJasper: checks 
appositive: bets 1370
Duke Croix: folds 
MnnM150: calls 1370
HighCardJasper: folds 
*** TURN *** [5s 6s 8c] [5c]
MnnM150: checks 
appositive: bets 5330
MnnM150: calls 3550 and is all-in
Uncalled bet (1780) returned to appositive
*** RIVER *** [5s 6s 8c 5c] [3d]
*** SHOW DOWN ***
MnnM150: shows [Js Jc] (two pair, Jacks and Fives)
appositive: shows [4d Ah] (a pair of Fives)
MnnM150 collected 12039 from pot
*** SUMMARY ***
Total pot 12740 | Rake 701 
Board [5s 6s 8c 5c 3d]
Seat 1: dddocky folded before Flop
Seat 2: Duke Croix (button) folded on the Flop
Seat 3: MnnM150 (small blind) showed [Js Jc] and won (12039) with two pair, Jacks and Fives
Seat 4: HighCardJasper (big blind) folded on the Flop
Seat 7: appositive showed [4d Ah] and lost with a pair of Fives



PokerStars Home Game Hand #220089299014: {Club #3225207}  Hold'em No Limit (50/100) - 2020/11/05 18:17:59 ET
Table 'funzzzzzzzz' 9-max (Play Money) Seat #3 is the button
Seat 1: dddocky (18412 in chips) 
Seat 2: Duke Croix (12770 in chips) 
Seat 3: MnnM150 (12039 in chips) 
Seat 4: HighCardJasper (10995 in chips) 
Seat 7: appositive (5807 in chips) 
HighCardJasper: posts small blind 50
appositive: posts big blind 100
*** HOLE CARDS ***
Dealt to Duke Croix [7c 7s]
dddocky: calls 100
Duke Croix: raises 300 to 400
MnnM150: calls 400
HighCardJasper: folds 
appositive: calls 300
dddocky: calls 300
*** FLOP *** [3s 2c Tc]
appositive: checks 
dddocky: checks 
Duke Croix: bets 800
MnnM150: folds 
appositive: calls 800
dddocky: calls 800
*** TURN *** [3s 2c Tc] [9h]
appositive: checks 
dddocky: bets 100
Duke Croix: raises 900 to 1000
appositive: folds 
dddocky: folds 
Uncalled bet (900) returned to Duke Croix
Duke Croix collected 4016 from pot
*** SUMMARY ***
Total pot 4250 | Rake 234 
Board [3s 2c Tc 9h]
Seat 1: dddocky folded on the Turn
Seat 2: Duke Croix collected (4016)
Seat 3: MnnM150 (button) folded on the Flop
Seat 4: HighCardJasper (small blind) folded before Flop
Seat 7: appositive (big blind) folded on the Turn



PokerStars Home Game Hand #220089325209: {Club #3225207}  Hold'em No Limit (50/100) - 2020/11/05 18:18:53 ET
Table 'funzzzzzzzz' 9-max (Play Money) Seat #4 is the button
Seat 1: dddocky (17112 in chips) 
Seat 2: Duke Croix (15486 in chips) 
Seat 3: MnnM150 (11639 in chips) 
Seat 4: HighCardJasper (10945 in chips) 
Seat 7: appositive (4607 in chips) 
appositive: posts small blind 50
dddocky: posts big blind 100
*** HOLE CARDS ***
Dealt to Duke Croix [4h 9c]
Duke Croix: folds 
MnnM150: calls 100
HighCardJasper: calls 100
appositive: folds 
dddocky: checks 
*** FLOP *** [5d 4d 4c]
dddocky: checks 
MnnM150: checks 
HighCardJasper: bets 100
dddocky: calls 100
MnnM150: calls 100
*** TURN *** [5d 4d 4c] [3c]
dddocky: bets 100
MnnM150: calls 100
HighCardJasper: raises 100 to 200
dddocky: calls 100
MnnM150: calls 100
*** RIVER *** [5d 4d 4c 3c] [Ts]
dddocky: checks 
MnnM150: checks 
HighCardJasper: bets 400
dddocky: calls 400
MnnM150: folds 
*** SHOW DOWN ***
HighCardJasper: shows [As 2d] (a straight, Ace to Five)
dddocky: mucks hand 
HighCardJasper collected 1937 from pot
*** SUMMARY ***
Total pot 2050 | Rake 113 
Board [5d 4d 4c 3c Ts]
Seat 1: dddocky (big blind) mucked [5c Js]
Seat 2: Duke Croix folded before Flop (didn't bet)
Seat 3: MnnM150 folded on the River
Seat 4: HighCardJasper (button) showed [As 2d] and won (1937) with a straight, Ace to Five
Seat 7: appositive (small blind) folded before Flop



PokerStars Home Game Hand #220089351930: {Club #3225207}  Hold'em No Limit (50/100) - 2020/11/05 18:19:49 ET
Table 'funzzzzzzzz' 9-max (Play Money) Seat #7 is the button
Seat 1: dddocky (16312 in chips) 
Seat 2: Duke Croix (15486 in chips) 
Seat 3: MnnM150 (11239 in chips) 
Seat 4: HighCardJasper (12082 in chips) 
Seat 7: appositive (4557 in chips) 
dddocky: posts small blind 50
Duke Croix: posts big blind 100
*** HOLE CARDS ***
Dealt to Duke Croix [8c 3c]
MnnM150: calls 100
HighCardJasper: calls 100
appositive: calls 100
dddocky: calls 50
Duke Croix: checks 
*** FLOP *** [As 6s 2c]
dddocky: checks 
Duke Croix: checks 
MnnM150: checks 
HighCardJasper: checks 
appositive: bets 236
dddocky: folds 
Duke Croix: folds 
MnnM150: calls 236
HighCardJasper: folds 
*** TURN *** [As 6s 2c] [8h]
MnnM150: checks 
appositive: bets 919
MnnM150: folds 
Uncalled bet (919) returned to appositive
appositive collected 919 from pot
appositive: doesn't show hand 
*** SUMMARY ***
Total pot 972 | Rake 53 
Board [As 6s 2c 8h]
Seat 1: dddocky (small blind) folded on the Flop
Seat 2: Duke Croix (big blind) folded on the Flop
Seat 3: MnnM150 folded on the Turn
Seat 4: HighCardJasper folded on the Flop
Seat 7: appositive (button) collected (919)



PokerStars Home Game Hand #220089367565: {Club #3225207}  Hold'em No Limit (50/100) - 2020/11/05 18:20:21 ET
Table 'funzzzzzzzz' 9-max (Play Money) Seat #1 is the button
Seat 1: dddocky (16212 in chips) 
Seat 2: Duke Croix (15386 in chips) 
Seat 3: MnnM150 (10903 in chips) 
Seat 4: HighCardJasper (11982 in chips) 
Seat 7: appositive (5140 in chips) 
Duke Croix: posts small blind 50
MnnM150: posts big blind 100
*** HOLE CARDS ***
Dealt to Duke Croix [Qd 4h]
HighCardJasper: raises 100 to 200
appositive: calls 200
dddocky: folds 
Duke Croix: folds 
MnnM150: folds 
*** FLOP *** [4d Kh 3s]
HighCardJasper: checks 
appositive: bets 260
HighCardJasper: folds 
Uncalled bet (260) returned to appositive
appositive collected 520 from pot
appositive: doesn't show hand 
*** SUMMARY ***
Total pot 550 | Rake 30 
Board [4d Kh 3s]
Seat 1: dddocky (button) folded before Flop (didn't bet)
Seat 2: Duke Croix (small blind) folded before Flop
Seat 3: MnnM150 (big blind) folded before Flop
Seat 4: HighCardJasper folded on the Flop
Seat 7: appositive collected (520)



PokerStars Home Game Hand #220089378679: {Club #3225207}  Hold'em No Limit (50/100) - 2020/11/05 18:20:44 ET
Table 'funzzzzzzzz' 9-max (Play Money) Seat #2 is the button
Seat 1: dddocky (16212 in chips) 
Seat 2: Duke Croix (15336 in chips) 
Seat 3: MnnM150 (10803 in chips) 
Seat 4: HighCardJasper (11782 in chips) 
Seat 7: appositive (5460 in chips) 
MnnM150: posts small blind 50
HighCardJasper: posts big blind 100
*** HOLE CARDS ***
Dealt to Duke Croix [5d 2s]
appositive: folds 
dddocky: calls 100
Duke Croix: folds 
MnnM150: calls 50
HighCardJasper: checks 
*** FLOP *** [Qh 7h 2h]
MnnM150: bets 141
HighCardJasper: folds 
dddocky: calls 141
*** TURN *** [Qh 7h 2h] [Kh]
MnnM150: checks 
dddocky: checks 
*** RIVER *** [Qh 7h 2h Kh] [5h]
MnnM150: bets 275
dddocky: calls 275
*** SHOW DOWN ***
MnnM150: shows [Ts Tc] (a flush, King high)
dddocky: shows [Js As] (a flush, King high)
MnnM150 collected 535 from pot
dddocky collected 535 from pot
*** SUMMARY ***
Total pot 1132 | Rake 62 
Board [Qh 7h 2h Kh 5h]
Seat 1: dddocky showed [Js As] and won (535) with a flush, King high
Seat 2: Duke Croix (button) folded before Flop (didn't bet)
Seat 3: MnnM150 (small blind) showed [Ts Tc] and won (535) with a flush, King high
Seat 4: HighCardJasper (big blind) folded on the Flop
Seat 7: appositive folded before Flop (didn't bet)



PokerStars Home Game Hand #220089396364: {Club #3225207}  Hold'em No Limit (50/100) - 2020/11/05 18:21:21 ET
Table 'funzzzzzzzz' 9-max (Play Money) Seat #3 is the button
Seat 1: dddocky (16231 in chips) 
Seat 2: Duke Croix (15336 in chips) 
Seat 3: MnnM150 (10822 in chips) 
Seat 4: HighCardJasper (11682 in chips) 
Seat 7: appositive (5460 in chips) 
HighCardJasper: posts small blind 50
appositive: posts big blind 100
*** HOLE CARDS ***
Dealt to Duke Croix [7d 3h]
dddocky: folds 
Duke Croix: folds 
MnnM150: calls 100
HighCardJasper: calls 50
appositive: checks 
*** FLOP *** [2c 2d 8h]
HighCardJasper: checks 
appositive: checks 
MnnM150: checks 
*** TURN *** [2c 2d 8h] [3s]
HighCardJasper: checks 
appositive: bets 141
MnnM150: calls 141
HighCardJasper: folds 
*** RIVER *** [2c 2d 8h 3s] [Ts]
appositive: checks 
MnnM150: checks 
*** SHOW DOWN ***
appositive: shows [6s Ks] (a pair of Deuces)
MnnM150: shows [Kd Jd] (a pair of Deuces - King+Jack kicker)
MnnM150 collected 550 from pot
*** SUMMARY ***
Total pot 582 | Rake 32 
Board [2c 2d 8h 3s Ts]
Seat 1: dddocky folded before Flop (didn't bet)
Seat 2: Duke Croix folded before Flop (didn't bet)
Seat 3: MnnM150 (button) showed [Kd Jd] and won (550) with a pair of Deuces
Seat 4: HighCardJasper (small blind) folded on the Turn
Seat 7: appositive (big blind) showed [6s Ks] and lost with a pair of Deuces



PokerStars Home Game Hand #220089415289: {Club #3225207}  Hold'em No Limit (50/100) - 2020/11/05 18:22:01 ET
Table 'funzzzzzzzz' 9-max (Play Money) Seat #4 is the button
Seat 1: dddocky (16231 in chips) 
Seat 2: Duke Croix (15336 in chips) 
Seat 3: MnnM150 (11131 in chips) 
Seat 4: HighCardJasper (11582 in chips) 
Seat 7: appositive (5219 in chips) 
appositive: posts small blind 50
dddocky: posts big blind 100
*** HOLE CARDS ***
Dealt to Duke Croix [Kh Qd]
Duke Croix: raises 300 to 400
MnnM150: folds 
HighCardJasper: folds 
appositive: calls 350
dddocky: calls 300
*** FLOP *** [2c 9h 3h]
appositive: checks 
dddocky: bets 567
Duke Croix: calls 567
appositive: folds 
*** TURN *** [2c 9h 3h] [Kc]
dddocky: bets 100
Duke Croix: raises 1000 to 1100
dddocky: calls 1000
*** RIVER *** [2c 9h 3h Kc] [Th]
dddocky: checks 
Duke Croix: bets 100
dddocky: calls 100
*** SHOW DOWN ***
Duke Croix: shows [Kh Qd] (a pair of Kings)
dddocky: mucks hand 
Duke Croix collected 4474 from pot
*** SUMMARY ***
Total pot 4734 | Rake 260 
Board [2c 9h 3h Kc Th]
Seat 1: dddocky (big blind) mucked [9c Jc]
Seat 2: Duke Croix showed [Kh Qd] and won (4474) with a pair of Kings
Seat 3: MnnM150 folded before Flop (didn't bet)
Seat 4: HighCardJasper (button) folded before Flop (didn't bet)
Seat 7: appositive (small blind) folded on the Flop



PokerStars Home Game Hand #220089439630: {Club #3225207}  Hold'em No Limit (50/100) - 2020/11/05 18:22:52 ET
Table 'funzzzzzzzz' 9-max (Play Money) Seat #7 is the button
Seat 1: dddocky (14064 in chips) 
Seat 2: Duke Croix (17643 in chips) 
Seat 3: MnnM150 (11131 in chips) 
Seat 4: HighCardJasper (11582 in chips) 
Seat 7: appositive (4819 in chips) 
dddocky: posts small blind 50
Duke Croix: posts big blind 100
*** HOLE CARDS ***
Dealt to Duke Croix [Qs Jh]
MnnM150: folds 
HighCardJasper: calls 100
appositive: raises 200 to 300
dddocky: calls 250
Duke Croix: calls 200
HighCardJasper: calls 200
*** FLOP *** [3s 2d Ad]
dddocky: checks 
Duke Croix: checks 
HighCardJasper: checks 
appositive: bets 567
dddocky: calls 567
Duke Croix: folds 
HighCardJasper: folds 
*** TURN *** [3s 2d Ad] [6h]
dddocky: bets 2200
appositive: raises 1752 to 3952 and is all-in
dddocky: calls 1752
*** RIVER *** [3s 2d Ad 6h] [Ah]
*** SHOW DOWN ***
dddocky: shows [As 8s] (three of a kind, Aces)
appositive: shows [Jc Js] (two pair, Aces and Jacks)
dddocky collected 9675 from pot
*** SUMMARY ***
Total pot 10238 | Rake 563 
Board [3s 2d Ad 6h Ah]
Seat 1: dddocky (small blind) showed [As 8s] and won (9675) with three of a kind, Aces
Seat 2: Duke Croix (big blind) folded on the Flop
Seat 3: MnnM150 folded before Flop (didn't bet)
Seat 4: HighCardJasper folded on the Flop
Seat 7: appositive (button) showed [Jc Js] and lost with two pair, Aces and Jacks



PokerStars Home Game Hand #220089464688: {Club #3225207}  Hold'em No Limit (50/100) - 2020/11/05 18:23:36 ET
Table 'funzzzzzzzz' 9-max (Play Money) Seat #1 is the button
Seat 1: dddocky (18920 in chips) 
Seat 2: Duke Croix (17343 in chips) 
Seat 3: MnnM150 (11131 in chips) 
Seat 4: HighCardJasper (11282 in chips) 
Duke Croix: posts small blind 50
MnnM150: posts big blind 100
*** HOLE CARDS ***
Dealt to Duke Croix [Qd 3h]
HighCardJasper: calls 100
dddocky: calls 100
Duke Croix: folds 
MnnM150: checks 
*** FLOP *** [9h 6s 4h]
MnnM150: checks 
HighCardJasper: checks 
dddocky: checks 
*** TURN *** [9h 6s 4h] [As]
MnnM150: bets 331
HighCardJasper: folds 
appositive leaves the table
dddocky: folds 
Uncalled bet (331) returned to MnnM150
MnnM150 collected 331 from pot
*** SUMMARY ***
Total pot 350 | Rake 19 
Board [9h 6s 4h As]
Seat 1: dddocky (button) folded on the Turn
Seat 2: Duke Croix (small blind) folded before Flop
Seat 3: MnnM150 (big blind) collected (331)
Seat 4: HighCardJasper folded on the Turn



PokerStars Home Game Hand #220089485934: {Club #3225207}  Hold'em No Limit (50/100) - 2020/11/05 18:24:21 ET
Table 'funzzzzzzzz' 9-max (Play Money) Seat #2 is the button
Seat 1: dddocky (18820 in chips) 
Seat 2: Duke Croix (17293 in chips) 
Seat 3: MnnM150 (11362 in chips) 
Seat 4: HighCardJasper (11182 in chips) 
MnnM150: posts small blind 50
HighCardJasper: posts big blind 100
*** HOLE CARDS ***
Dealt to Duke Croix [9c 4d]
dddocky: folds 
Duke Croix: folds 
MnnM150: calls 50
HighCardJasper: checks 
*** FLOP *** [Qd 3h Kh]
MnnM150: bets 100
HighCardJasper: calls 100
*** TURN *** [Qd 3h Kh] [7h]
MnnM150: bets 100
HighCardJasper: calls 100
*** RIVER *** [Qd 3h Kh 7h] [Ks]
MnnM150: bets 100
HighCardJasper: calls 100
*** SHOW DOWN ***
MnnM150: shows [Tc Th] (two pair, Kings and Tens)
HighCardJasper: mucks hand 
MnnM150 collected 756 from pot
*** SUMMARY ***
Total pot 800 | Rake 44 
Board [Qd 3h Kh 7h Ks]
Seat 1: dddocky folded before Flop (didn't bet)
Seat 2: Duke Croix (button) folded before Flop (didn't bet)
Seat 3: MnnM150 (small blind) showed [Tc Th] and won (756) with two pair, Kings and Tens
Seat 4: HighCardJasper (big blind) mucked [Ad 6h]



PokerStars Home Game Hand #220089503521: {Club #3225207}  Hold'em No Limit (50/100) - 2020/11/05 18:24:58 ET
Table 'funzzzzzzzz' 9-max (Play Money) Seat #3 is the button
Seat 1: dddocky (18820 in chips) 
Seat 2: Duke Croix (17293 in chips) 
Seat 3: MnnM150 (11718 in chips) 
Seat 4: HighCardJasper (10782 in chips) 
HighCardJasper: posts small blind 50
dddocky: posts big blind 100
*** HOLE CARDS ***
Dealt to Duke Croix [Td Tc]
Duke Croix: raises 300 to 400
MnnM150: folds 
HighCardJasper: calls 350
dddocky: folds 
*** FLOP *** [Qs 8d Qd]
HighCardJasper: checks 
Duke Croix: bets 500
HighCardJasper: folds 
Uncalled bet (500) returned to Duke Croix
Duke Croix collected 850 from pot
*** SUMMARY ***
Total pot 900 | Rake 50 
Board [Qs 8d Qd]
Seat 1: dddocky (big blind) folded before Flop
Seat 2: Duke Croix collected (850)
Seat 3: MnnM150 (button) folded before Flop (didn't bet)
Seat 4: HighCardJasper (small blind) folded on the Flop



PokerStars Home Game Hand #220089518130: {Club #3225207}  Hold'em No Limit (50/100) - 2020/11/05 18:25:29 ET
Table 'funzzzzzzzz' 9-max (Play Money) Seat #4 is the button
Seat 1: dddocky (18720 in chips) 
Seat 2: Duke Croix (17743 in chips) 
Seat 3: MnnM150 (11718 in chips) 
Seat 4: HighCardJasper (10382 in chips) 
dddocky: posts small blind 50
Duke Croix: posts big blind 100
*** HOLE CARDS ***
Dealt to Duke Croix [4s 2h]
MnnM150: raises 100 to 200
HighCardJasper: calls 200
dddocky: calls 150
Duke Croix: folds 
*** FLOP *** [Ah 2s As]
dddocky: checks 
MnnM150: bets 330
HighCardJasper: folds 
dddocky: folds 
Uncalled bet (330) returned to MnnM150
MnnM150 collected 661 from pot
*** SUMMARY ***
Total pot 700 | Rake 39 
Board [Ah 2s As]
Seat 1: dddocky (small blind) folded on the Flop
Seat 2: Duke Croix (big blind) folded before Flop
Seat 3: MnnM150 collected (661)
Seat 4: HighCardJasper (button) folded on the Flop



