PokerStars Home Game Hand #216950930780: {Club #3225207}  Hold'em No Limit (50/100) - 2020/07/30 14:55:39 ET
Table 'JansPokergame' 9-max (Play Money) Seat #9 is the button
Seat 1: color_singleton (7982 in chips) 
Seat 2: yairpinto (12529 in chips) 
Seat 3: Duke Croix (10000 in chips) 
Seat 9: dddocky (8419 in chips) 
color_singleton: posts small blind 50
yairpinto: posts big blind 100
Duke Croix: posts big blind 100
*** HOLE CARDS ***
Dealt to Duke Croix [Qs 4c]
Duke Croix: checks 
dddocky: folds 
color_singleton: raises 100 to 200
yairpinto: calls 100
Duke Croix: calls 100
*** FLOP *** [As 3d 2s]
color_singleton: checks 
yairpinto: checks 
Duke Croix: checks 
*** TURN *** [As 3d 2s] [9h]
color_singleton: checks 
yairpinto: bets 283
Duke Croix: folds 
color_singleton: folds 
Uncalled bet (283) returned to yairpinto
yairpinto collected 567 from pot
yairpinto: doesn't show hand 
*** SUMMARY ***
Total pot 600 | Rake 33 
Board [As 3d 2s 9h]
Seat 1: color_singleton (small blind) folded on the Turn
Seat 2: yairpinto (big blind) collected (567)
Seat 3: Duke Croix folded on the Turn
Seat 9: dddocky (button) folded before Flop (didn't bet)



PokerStars Home Game Hand #216950950058: {Club #3225207}  Hold'em No Limit (50/100) - 2020/07/30 14:56:25 ET
Table 'JansPokergame' 9-max (Play Money) Seat #1 is the button
Seat 1: color_singleton (7782 in chips) 
Seat 2: yairpinto (12896 in chips) 
Seat 3: Duke Croix (9800 in chips) 
Seat 9: dddocky (8419 in chips) 
yairpinto: posts small blind 50
Duke Croix: posts big blind 100
*** HOLE CARDS ***
Dealt to Duke Croix [Kc Tc]
dddocky: folds 
color_singleton: raises 200 to 300
yairpinto: folds 
Duke Croix: calls 200
*** FLOP *** [7s 4c 9c]
Duke Croix: bets 300
color_singleton: raises 607 to 907
Duke Croix: calls 607
*** TURN *** [7s 4c 9c] [2c]
Duke Croix: checks 
color_singleton: bets 1164
Duke Croix: calls 1164
*** RIVER *** [7s 4c 9c 2c] [Ts]
Duke Croix: bets 3000
color_singleton: folds 
Uncalled bet (3000) returned to Duke Croix
Duke Croix collected 4528 from pot
*** SUMMARY ***
Total pot 4792 | Rake 264 
Board [7s 4c 9c 2c Ts]
Seat 1: color_singleton (button) folded on the River
Seat 2: yairpinto (small blind) folded before Flop
Seat 3: Duke Croix (big blind) collected (4528)
Seat 9: dddocky folded before Flop (didn't bet)



PokerStars Home Game Hand #216950976280: {Club #3225207}  Hold'em No Limit (50/100) - 2020/07/30 14:57:28 ET
Table 'JansPokergame' 9-max (Play Money) Seat #2 is the button
Seat 1: color_singleton (5411 in chips) 
Seat 2: yairpinto (12846 in chips) 
Seat 3: Duke Croix (11957 in chips) 
Duke Croix: posts small blind 50
color_singleton: posts big blind 100
*** HOLE CARDS ***
Dealt to Duke Croix [8c 6c]
yairpinto: raises 200 to 300
Duke Croix: folds 
color_singleton: folds 
Uncalled bet (200) returned to yairpinto
yairpinto collected 250 from pot
yairpinto: doesn't show hand 
*** SUMMARY ***
Total pot 250 | Rake 0 
Seat 1: color_singleton (big blind) folded before Flop
Seat 2: yairpinto (button) collected (250)
Seat 3: Duke Croix (small blind) folded before Flop



PokerStars Home Game Hand #216950982104: {Club #3225207}  Hold'em No Limit (50/100) - 2020/07/30 14:57:41 ET
Table 'JansPokergame' 9-max (Play Money) Seat #3 is the button
Seat 1: color_singleton (5311 in chips) 
Seat 2: yairpinto (12996 in chips) 
Seat 3: Duke Croix (11907 in chips) 
color_singleton: posts small blind 50
yairpinto: posts big blind 100
*** HOLE CARDS ***
Dealt to Duke Croix [9d 3d]
Duke Croix: folds 
color_singleton: raises 200 to 300
yairpinto: folds 
Uncalled bet (200) returned to color_singleton
color_singleton collected 200 from pot
color_singleton: doesn't show hand 
*** SUMMARY ***
Total pot 200 | Rake 0 
Seat 1: color_singleton (small blind) collected (200)
Seat 2: yairpinto (big blind) folded before Flop
Seat 3: Duke Croix (button) folded before Flop (didn't bet)



PokerStars Home Game Hand #216950989071: {Club #3225207}  Hold'em No Limit (50/100) - 2020/07/30 14:57:58 ET
Table 'JansPokergame' 9-max (Play Money) Seat #1 is the button
Seat 1: color_singleton (5411 in chips) 
Seat 2: yairpinto (12896 in chips) 
Seat 3: Duke Croix (11907 in chips) 
yairpinto: posts small blind 50
Duke Croix: posts big blind 100
*** HOLE CARDS ***
Dealt to Duke Croix [Kc 4h]
color_singleton has timed out
color_singleton: folds 
yairpinto: folds 
Uncalled bet (50) returned to Duke Croix
Duke Croix collected 100 from pot
*** SUMMARY ***
Total pot 100 | Rake 0 
Seat 1: color_singleton (button) folded before Flop (didn't bet)
Seat 2: yairpinto (small blind) folded before Flop
Seat 3: Duke Croix (big blind) collected (100)



PokerStars Home Game Hand #216950998731: {Club #3225207}  Hold'em No Limit (50/100) - 2020/07/30 14:58:21 ET
Table 'JansPokergame' 9-max (Play Money) Seat #3 is the button
Seat 2: yairpinto (12846 in chips) 
Seat 3: Duke Croix (11957 in chips) 
Duke Croix: posts small blind 50
yairpinto: posts big blind 100
*** HOLE CARDS ***
Dealt to Duke Croix [7d 7c]
Duke Croix: raises 200 to 300
yairpinto: calls 200
*** FLOP *** [Tc 5s Ks]
yairpinto: checks 
Duke Croix: bets 300
yairpinto: raises 500 to 800
Duke Croix: folds 
Uncalled bet (500) returned to yairpinto
yairpinto collected 1134 from pot
yairpinto: doesn't show hand 
*** SUMMARY ***
Total pot 1200 | Rake 66 
Board [Tc 5s Ks]
Seat 2: yairpinto (big blind) collected (1134)
Seat 3: Duke Croix (button) (small blind) folded on the Flop



PokerStars Home Game Hand #216951016695: {Club #3225207}  Hold'em No Limit (50/100) - 2020/07/30 14:59:04 ET
Table 'JansPokergame' 9-max (Play Money) Seat #2 is the button
Seat 2: yairpinto (13380 in chips) 
Seat 3: Duke Croix (11357 in chips) 
yairpinto: posts small blind 50
Duke Croix: posts big blind 100
*** HOLE CARDS ***
Dealt to Duke Croix [9c 8c]
yairpinto: raises 200 to 300
Duke Croix: calls 200
*** FLOP *** [Ad 9h Ts]
Duke Croix: checks 
yairpinto: bets 283
Duke Croix: calls 283
*** TURN *** [Ad 9h Ts] [4d]
Duke Croix: checks 
yairpinto: checks 
*** RIVER *** [Ad 9h Ts 4d] [Tc]
Duke Croix: bets 700
yairpinto: folds 
Uncalled bet (700) returned to Duke Croix
Duke Croix collected 1102 from pot
*** SUMMARY ***
Total pot 1166 | Rake 64 
Board [Ad 9h Ts 4d Tc]
Seat 2: yairpinto (button) (small blind) folded on the River
Seat 3: Duke Croix (big blind) collected (1102)



PokerStars Home Game Hand #216951028319: {Club #3225207}  Hold'em No Limit (50/100) - 2020/07/30 14:59:31 ET
Table 'JansPokergame' 9-max (Play Money) Seat #3 is the button
Seat 2: yairpinto (12797 in chips) 
Seat 3: Duke Croix (11876 in chips) 
Duke Croix: posts small blind 50
yairpinto: posts big blind 100
*** HOLE CARDS ***
Dealt to Duke Croix [4h 7h]
Duke Croix: calls 50
yairpinto: raises 200 to 300
Duke Croix: calls 200
*** FLOP *** [3c Qc Kh]
yairpinto: bets 283
Duke Croix: folds 
Uncalled bet (283) returned to yairpinto
yairpinto collected 567 from pot
yairpinto: doesn't show hand 
*** SUMMARY ***
Total pot 600 | Rake 33 
Board [3c Qc Kh]
Seat 2: yairpinto (big blind) collected (567)
Seat 3: Duke Croix (button) (small blind) folded on the Flop



PokerStars Home Game Hand #216951035702: {Club #3225207}  Hold'em No Limit (50/100) - 2020/07/30 14:59:49 ET
Table 'JansPokergame' 9-max (Play Money) Seat #2 is the button
Seat 2: yairpinto (13064 in chips) 
Seat 3: Duke Croix (11576 in chips) 
yairpinto: posts small blind 50
Duke Croix: posts big blind 100
*** HOLE CARDS ***
Dealt to Duke Croix [8d 9c]
yairpinto: calls 50
Duke Croix: checks 
*** FLOP *** [3d Qd 8h]
Duke Croix: bets 100
yairpinto: folds 
Uncalled bet (100) returned to Duke Croix
Duke Croix collected 189 from pot
*** SUMMARY ***
Total pot 200 | Rake 11 
Board [3d Qd 8h]
Seat 2: yairpinto (button) (small blind) folded on the Flop
Seat 3: Duke Croix (big blind) collected (189)



PokerStars Home Game Hand #216951045463: {Club #3225207}  Hold'em No Limit (50/100) - 2020/07/30 15:00:10 ET
Table 'JansPokergame' 9-max (Play Money) Seat #2 is the button
Seat 1: color_singleton (5411 in chips) 
Seat 2: yairpinto (12964 in chips) 
Seat 3: Duke Croix (11665 in chips) 
Duke Croix: posts small blind 50
color_singleton: posts big blind 100
*** HOLE CARDS ***
Dealt to Duke Croix [Qc Tc]
yairpinto: folds 
Duke Croix: raises 300 to 400
color_singleton: folds 
Uncalled bet (300) returned to Duke Croix
Duke Croix collected 200 from pot
*** SUMMARY ***
Total pot 200 | Rake 0 
Seat 1: color_singleton (big blind) folded before Flop
Seat 2: yairpinto (button) folded before Flop (didn't bet)
Seat 3: Duke Croix (small blind) collected (200)



PokerStars Home Game Hand #216951051945: {Club #3225207}  Hold'em No Limit (50/100) - 2020/07/30 15:00:24 ET
Table 'JansPokergame' 9-max (Play Money) Seat #3 is the button
Seat 1: color_singleton (5311 in chips) 
Seat 2: yairpinto (12964 in chips) 
Seat 3: Duke Croix (11765 in chips) 
color_singleton: posts small blind 50
yairpinto: posts big blind 100
*** HOLE CARDS ***
Dealt to Duke Croix [Ac 2d]
Duke Croix: raises 300 to 400
color_singleton: folds 
yairpinto: folds 
Uncalled bet (300) returned to Duke Croix
Duke Croix collected 250 from pot
*** SUMMARY ***
Total pot 250 | Rake 0 
Seat 1: color_singleton (small blind) folded before Flop
Seat 2: yairpinto (big blind) folded before Flop
Seat 3: Duke Croix (button) collected (250)



PokerStars Home Game Hand #216951886623: {Club #3225207}  Hold'em No Limit (50/100) - 2020/07/30 15:23:06 ET
Table 'JansPokergame' 9-max (Play Money) Seat #1 is the button
Seat 1: color_singleton (3397 in chips) 
Seat 2: yairpinto (21554 in chips) 
Seat 3: Duke Croix (10000 in chips) 
Seat 4: rogierk449 (11817 in chips) 
Seat 9: dddocky (6996 in chips) 
yairpinto: posts small blind 50
Duke Croix: posts big blind 100
*** HOLE CARDS ***
Dealt to Duke Croix [5c 6s]
rogierk449: folds 
dddocky: folds 
color_singleton: folds 
yairpinto: calls 50
Duke Croix: checks 
*** FLOP *** [Th 4d 6d]
yairpinto: checks 
Duke Croix: bets 200
yairpinto: folds 
Uncalled bet (200) returned to Duke Croix
Duke Croix collected 189 from pot
*** SUMMARY ***
Total pot 200 | Rake 11 
Board [Th 4d 6d]
Seat 1: color_singleton (button) folded before Flop (didn't bet)
Seat 2: yairpinto (small blind) folded on the Flop
Seat 3: Duke Croix (big blind) collected (189)
Seat 4: rogierk449 folded before Flop (didn't bet)
Seat 9: dddocky folded before Flop (didn't bet)



PokerStars Home Game Hand #216951908859: {Club #3225207}  Hold'em No Limit (50/100) - 2020/07/30 15:23:42 ET
Table 'JansPokergame' 9-max (Play Money) Seat #2 is the button
Seat 1: color_singleton (3397 in chips) 
Seat 2: yairpinto (21454 in chips) 
Seat 3: Duke Croix (10089 in chips) 
Seat 4: rogierk449 (11817 in chips) 
Seat 9: dddocky (6996 in chips) 
Duke Croix: posts small blind 50
rogierk449: posts big blind 100
*** HOLE CARDS ***
Dealt to Duke Croix [Qh 8h]
dddocky: raises 100 to 200
color_singleton: calls 200
yairpinto: folds 
Duke Croix: calls 150
rogierk449: folds 
*** FLOP *** [Jc Js 9s]
Duke Croix: checks 
dddocky: checks 
color_singleton: bets 330
Duke Croix: folds 
dddocky: folds 
Uncalled bet (330) returned to color_singleton
color_singleton collected 661 from pot
color_singleton: doesn't show hand 
*** SUMMARY ***
Total pot 700 | Rake 39 
Board [Jc Js 9s]
Seat 1: color_singleton collected (661)
Seat 2: yairpinto (button) folded before Flop (didn't bet)
Seat 3: Duke Croix (small blind) folded on the Flop
Seat 4: rogierk449 (big blind) folded before Flop
Seat 9: dddocky folded on the Flop



PokerStars Home Game Hand #216951933655: {Club #3225207}  Hold'em No Limit (50/100) - 2020/07/30 15:24:23 ET
Table 'JansPokergame' 9-max (Play Money) Seat #3 is the button
Seat 1: color_singleton (3858 in chips) 
Seat 2: yairpinto (21454 in chips) 
Seat 3: Duke Croix (9889 in chips) 
Seat 4: rogierk449 (11717 in chips) 
rogierk449: posts small blind 50
color_singleton: posts big blind 100
*** HOLE CARDS ***
Dealt to Duke Croix [Ac 9h]
yairpinto: raises 200 to 300
Duke Croix: calls 300
rogierk449: folds 
color_singleton: folds 
*** FLOP *** [5h Kh 5c]
yairpinto: bets 354
Duke Croix: folds 
Uncalled bet (354) returned to yairpinto
yairpinto collected 709 from pot
yairpinto: doesn't show hand 
*** SUMMARY ***
Total pot 750 | Rake 41 
Board [5h Kh 5c]
Seat 1: color_singleton (big blind) folded before Flop
Seat 2: yairpinto collected (709)
Seat 3: Duke Croix (button) folded on the Flop
Seat 4: rogierk449 (small blind) folded before Flop



PokerStars Home Game Hand #216951962623: {Club #3225207}  Hold'em No Limit (50/100) - 2020/07/30 15:24:55 ET
Table 'JansPokergame' 9-max (Play Money) Seat #4 is the button
Seat 1: color_singleton (3758 in chips) 
Seat 2: yairpinto (21863 in chips) 
Seat 3: Duke Croix (9589 in chips) 
Seat 4: rogierk449 (11667 in chips) 
color_singleton: posts small blind 50
yairpinto: posts big blind 100
*** HOLE CARDS ***
Dealt to Duke Croix [8d 3d]
Duke Croix: folds 
rogierk449: folds 
color_singleton: raises 100 to 200
yairpinto: folds 
Uncalled bet (100) returned to color_singleton
color_singleton collected 200 from pot
color_singleton: doesn't show hand 
*** SUMMARY ***
Total pot 200 | Rake 0 
Seat 1: color_singleton (small blind) collected (200)
Seat 2: yairpinto (big blind) folded before Flop
Seat 3: Duke Croix folded before Flop (didn't bet)
Seat 4: rogierk449 (button) folded before Flop (didn't bet)



PokerStars Home Game Hand #216951971498: {Club #3225207}  Hold'em No Limit (50/100) - 2020/07/30 15:25:09 ET
Table 'JansPokergame' 9-max (Play Money) Seat #1 is the button
Seat 1: color_singleton (3858 in chips) 
Seat 2: yairpinto (21763 in chips) 
Seat 3: Duke Croix (9589 in chips) 
Seat 4: rogierk449 (11667 in chips) 
Seat 9: dddocky (6796 in chips) 
yairpinto: posts small blind 50
Duke Croix: posts big blind 100
dddocky: posts small & big blinds 150
*** HOLE CARDS ***
Dealt to Duke Croix [Kc 7s]
rogierk449: folds 
dddocky: checks 
color_singleton: folds 
yairpinto: calls 50
Duke Croix: checks 
*** FLOP *** [3h Ts Th]
yairpinto: checks 
Duke Croix: checks 
dddocky: checks 
*** TURN *** [3h Ts Th] [Kd]
yairpinto: bets 165
Duke Croix: raises 235 to 400
dddocky: folds 
yairpinto: folds 
Uncalled bet (235) returned to Duke Croix
Duke Croix collected 643 from pot
*** SUMMARY ***
Total pot 680 | Rake 37 
Board [3h Ts Th Kd]
Seat 1: color_singleton (button) folded before Flop (didn't bet)
Seat 2: yairpinto (small blind) folded on the Turn
Seat 3: Duke Croix (big blind) collected (643)
Seat 4: rogierk449 folded before Flop (didn't bet)
Seat 9: dddocky folded on the Turn (didn't bet)



PokerStars Home Game Hand #216952005297: {Club #3225207}  Hold'em No Limit (50/100) - 2020/07/30 15:26:04 ET
Table 'JansPokergame' 9-max (Play Money) Seat #2 is the button
Seat 1: color_singleton (3858 in chips) 
Seat 2: yairpinto (21498 in chips) 
Seat 3: Duke Croix (9967 in chips) 
Seat 4: rogierk449 (11667 in chips) 
Seat 9: dddocky (6646 in chips) 
Duke Croix: posts small blind 50
rogierk449: posts big blind 100
*** HOLE CARDS ***
Dealt to Duke Croix [3h 8d]
dddocky: calls 100
color_singleton: folds 
yairpinto: folds 
Duke Croix: folds 
rogierk449: checks 
*** FLOP *** [8c 8s 6c]
rogierk449: checks 
dddocky: checks 
*** TURN *** [8c 8s 6c] [Ks]
rogierk449: bets 100
dddocky: folds 
Uncalled bet (100) returned to rogierk449
rogierk449 collected 236 from pot
rogierk449: doesn't show hand 
*** SUMMARY ***
Total pot 250 | Rake 14 
Board [8c 8s 6c Ks]
Seat 1: color_singleton folded before Flop (didn't bet)
Seat 2: yairpinto (button) folded before Flop (didn't bet)
Seat 3: Duke Croix (small blind) folded before Flop
Seat 4: rogierk449 (big blind) collected (236)
Seat 9: dddocky folded on the Turn



PokerStars Home Game Hand #216952025388: {Club #3225207}  Hold'em No Limit (50/100) - 2020/07/30 15:26:37 ET
Table 'JansPokergame' 9-max (Play Money) Seat #3 is the button
Seat 1: color_singleton (3858 in chips) 
Seat 2: yairpinto (21498 in chips) 
Seat 3: Duke Croix (9917 in chips) 
Seat 4: rogierk449 (11803 in chips) 
Seat 9: dddocky (6546 in chips) 
rogierk449: posts small blind 50
dddocky: posts big blind 100
*** HOLE CARDS ***
Dealt to Duke Croix [9s 6c]
color_singleton: folds 
yairpinto: raises 200 to 300
Duke Croix: folds 
rogierk449: calls 250
dddocky: calls 200
*** FLOP *** [2h Kh 3d]
rogierk449: checks 
dddocky: checks 
yairpinto: bets 425
rogierk449: folds 
dddocky: folds 
Uncalled bet (425) returned to yairpinto
yairpinto collected 850 from pot
yairpinto: doesn't show hand 
*** SUMMARY ***
Total pot 900 | Rake 50 
Board [2h Kh 3d]
Seat 1: color_singleton folded before Flop (didn't bet)
Seat 2: yairpinto collected (850)
Seat 3: Duke Croix (button) folded before Flop (didn't bet)
Seat 4: rogierk449 (small blind) folded on the Flop
Seat 9: dddocky (big blind) folded on the Flop



PokerStars Home Game Hand #216952047017: {Club #3225207}  Hold'em No Limit (50/100) - 2020/07/30 15:27:12 ET
Table 'JansPokergame' 9-max (Play Money) Seat #4 is the button
Seat 1: color_singleton (3858 in chips) 
Seat 2: yairpinto (22048 in chips) 
Seat 3: Duke Croix (9917 in chips) 
Seat 4: rogierk449 (11503 in chips) 
Seat 9: dddocky (6246 in chips) 
dddocky: posts small blind 50
color_singleton: posts big blind 100
*** HOLE CARDS ***
Dealt to Duke Croix [2h Kc]
yairpinto: folds 
Duke Croix: folds 
rogierk449: calls 100
dddocky: calls 50
color_singleton: checks 
*** FLOP *** [Ac 6s Th]
dddocky: checks 
color_singleton: checks 
rogierk449: checks 
*** TURN *** [Ac 6s Th] [6d]
dddocky: checks 
color_singleton: checks 
rogierk449: checks 
*** RIVER *** [Ac 6s Th 6d] [As]
dddocky: checks 
color_singleton: checks 
rogierk449: checks 
*** SHOW DOWN ***
dddocky: shows [3d 5c] (two pair, Aces and Sixes)
color_singleton: shows [7c Jh] (two pair, Aces and Sixes - Jack kicker)
rogierk449: shows [Jd 9h] (two pair, Aces and Sixes)
color_singleton collected 142 from pot
rogierk449 collected 141 from pot
*** SUMMARY ***
Total pot 300 | Rake 17 
Board [Ac 6s Th 6d As]
Seat 1: color_singleton (big blind) showed [7c Jh] and won (142) with two pair, Aces and Sixes
Seat 2: yairpinto folded before Flop (didn't bet)
Seat 3: Duke Croix folded before Flop (didn't bet)
Seat 4: rogierk449 (button) showed [Jd 9h] and won (141) with two pair, Aces and Sixes
Seat 9: dddocky (small blind) showed [3d 5c] and lost with two pair, Aces and Sixes



PokerStars Home Game Hand #216952068011: {Club #3225207}  Hold'em No Limit (50/100) - 2020/07/30 15:27:46 ET
Table 'JansPokergame' 9-max (Play Money) Seat #9 is the button
Seat 1: color_singleton (3900 in chips) 
Seat 2: yairpinto (22048 in chips) 
Seat 3: Duke Croix (9917 in chips) 
Seat 4: rogierk449 (11544 in chips) 
Seat 9: dddocky (6146 in chips) 
color_singleton: posts small blind 50
yairpinto: posts big blind 100
*** HOLE CARDS ***
Dealt to Duke Croix [8d Jh]
Duke Croix: folds 
rogierk449: raises 200 to 300
dddocky: calls 300
color_singleton: folds 
yairpinto: calls 200
*** FLOP *** [Qd 7d 5c]
yairpinto: bets 449
rogierk449: calls 449
dddocky: raises 449 to 898
yairpinto: calls 449
rogierk449: raises 10346 to 11244 and is all-in
dddocky: folds 
yairpinto: folds 
Uncalled bet (10346) returned to rogierk449
rogierk449 collected 3444 from pot
rogierk449: doesn't show hand 
*** SUMMARY ***
Total pot 3644 | Rake 200 
Board [Qd 7d 5c]
Seat 1: color_singleton (small blind) folded before Flop
Seat 2: yairpinto (big blind) folded on the Flop
Seat 3: Duke Croix folded before Flop (didn't bet)
Seat 4: rogierk449 collected (3444)
Seat 9: dddocky (button) folded on the Flop



PokerStars Home Game Hand #216952108607: {Club #3225207}  Hold'em No Limit (50/100) - 2020/07/30 15:28:52 ET
Table 'JansPokergame' 9-max (Play Money) Seat #1 is the button
Seat 1: color_singleton (3850 in chips) 
Seat 2: yairpinto (20850 in chips) 
Seat 3: Duke Croix (9917 in chips) 
Seat 4: rogierk449 (13790 in chips) 
Seat 9: dddocky (4948 in chips) 
yairpinto: posts small blind 50
Duke Croix: posts big blind 100
*** HOLE CARDS ***
Dealt to Duke Croix [3s 2d]
rogierk449: folds 
dddocky: folds 
color_singleton: folds 
yairpinto: calls 50
Duke Croix: checks 
*** FLOP *** [9d 3d 8d]
yairpinto: checks 
Duke Croix: checks 
*** TURN *** [9d 3d 8d] [9h]
yairpinto: bets 189
Duke Croix: folds 
Uncalled bet (189) returned to yairpinto
yairpinto collected 189 from pot
yairpinto: doesn't show hand 
*** SUMMARY ***
Total pot 200 | Rake 11 
Board [9d 3d 8d 9h]
Seat 1: color_singleton (button) folded before Flop (didn't bet)
Seat 2: yairpinto (small blind) collected (189)
Seat 3: Duke Croix (big blind) folded on the Turn
Seat 4: rogierk449 folded before Flop (didn't bet)
Seat 9: dddocky folded before Flop (didn't bet)



PokerStars Home Game Hand #216952132936: {Club #3225207}  Hold'em No Limit (50/100) - 2020/07/30 15:29:32 ET
Table 'JansPokergame' 9-max (Play Money) Seat #2 is the button
Seat 1: color_singleton (3850 in chips) 
Seat 2: yairpinto (20939 in chips) 
Seat 3: Duke Croix (9817 in chips) 
Seat 4: rogierk449 (13790 in chips) 
Seat 9: dddocky (4948 in chips) 
Duke Croix: posts small blind 50
rogierk449: posts big blind 100
*** HOLE CARDS ***
Dealt to Duke Croix [7d 7s]
dddocky: folds 
color_singleton: raises 200 to 300
yairpinto: calls 300
Duke Croix: calls 250
rogierk449: folds 
*** FLOP *** [2d 3d Ad]
Duke Croix: bets 500
color_singleton: calls 500
yairpinto: folds 
*** TURN *** [2d 3d Ad] [6d]
Duke Croix: checks 
color_singleton: checks 
*** RIVER *** [2d 3d Ad 6d] [Qd]
Duke Croix: bets 1000
color_singleton: folds 
Uncalled bet (1000) returned to Duke Croix
Duke Croix collected 1890 from pot
*** SUMMARY ***
Total pot 2000 | Rake 110 
Board [2d 3d Ad 6d Qd]
Seat 1: color_singleton folded on the River
Seat 2: yairpinto (button) folded on the Flop
Seat 3: Duke Croix (small blind) collected (1890)
Seat 4: rogierk449 (big blind) folded before Flop
Seat 9: dddocky folded before Flop (didn't bet)



PokerStars Home Game Hand #216952169268: {Club #3225207}  Hold'em No Limit (50/100) - 2020/07/30 15:30:30 ET
Table 'JansPokergame' 9-max (Play Money) Seat #3 is the button
Seat 1: color_singleton (3050 in chips) 
Seat 2: yairpinto (20639 in chips) 
Seat 3: Duke Croix (10907 in chips) 
Seat 4: rogierk449 (13690 in chips) 
Seat 9: dddocky (4948 in chips) 
rogierk449: posts small blind 50
dddocky: posts big blind 100
*** HOLE CARDS ***
Dealt to Duke Croix [Tc 8d]
color_singleton: folds 
yairpinto: folds 
Duke Croix: folds 
rogierk449: calls 50
dddocky: checks 
*** FLOP *** [Ad 4c 7s]
rogierk449: checks 
dddocky: bets 100
rogierk449: folds 
Uncalled bet (100) returned to dddocky
dddocky collected 189 from pot
dddocky: doesn't show hand 
*** SUMMARY ***
Total pot 200 | Rake 11 
Board [Ad 4c 7s]
Seat 1: color_singleton folded before Flop (didn't bet)
Seat 2: yairpinto folded before Flop (didn't bet)
Seat 3: Duke Croix (button) folded before Flop (didn't bet)
Seat 4: rogierk449 (small blind) folded on the Flop
Seat 9: dddocky (big blind) collected (189)



PokerStars Home Game Hand #216952187215: {Club #3225207}  Hold'em No Limit (50/100) - 2020/07/30 15:31:00 ET
Table 'JansPokergame' 9-max (Play Money) Seat #4 is the button
Seat 1: color_singleton (3050 in chips) 
Seat 2: yairpinto (20639 in chips) 
Seat 3: Duke Croix (10907 in chips) 
Seat 4: rogierk449 (13590 in chips) 
Seat 9: dddocky (5037 in chips) 
dddocky: posts small blind 50
color_singleton: posts big blind 100
*** HOLE CARDS ***
Dealt to Duke Croix [7s 3d]
yairpinto: raises 200 to 300
Duke Croix: folds 
rogierk449: folds 
dddocky: folds 
color_singleton: folds 
Uncalled bet (200) returned to yairpinto
yairpinto collected 250 from pot
yairpinto: doesn't show hand 
*** SUMMARY ***
Total pot 250 | Rake 0 
Seat 1: color_singleton (big blind) folded before Flop
Seat 2: yairpinto collected (250)
Seat 3: Duke Croix folded before Flop (didn't bet)
Seat 4: rogierk449 (button) folded before Flop (didn't bet)
Seat 9: dddocky (small blind) folded before Flop



PokerStars Home Game Hand #216952196218: {Club #3225207}  Hold'em No Limit (50/100) - 2020/07/30 15:31:14 ET
Table 'JansPokergame' 9-max (Play Money) Seat #9 is the button
Seat 1: color_singleton (2950 in chips) 
Seat 2: yairpinto (20789 in chips) 
Seat 3: Duke Croix (10907 in chips) 
Seat 4: rogierk449 (13590 in chips) 
Seat 9: dddocky (4987 in chips) 
color_singleton: posts small blind 50
yairpinto: posts big blind 100
*** HOLE CARDS ***
Dealt to Duke Croix [Kd 6c]
Duke Croix: folds 
rogierk449: folds 
dddocky: folds 
color_singleton: folds 
Uncalled bet (50) returned to yairpinto
yairpinto collected 100 from pot
yairpinto: doesn't show hand 
*** SUMMARY ***
Total pot 100 | Rake 0 
Seat 1: color_singleton (small blind) folded before Flop
Seat 2: yairpinto (big blind) collected (100)
Seat 3: Duke Croix folded before Flop (didn't bet)
Seat 4: rogierk449 folded before Flop (didn't bet)
Seat 9: dddocky (button) folded before Flop (didn't bet)



PokerStars Home Game Hand #216952211796: {Club #3225207}  Hold'em No Limit (50/100) - 2020/07/30 15:31:40 ET
Table 'JansPokergame' 9-max (Play Money) Seat #1 is the button
Seat 1: color_singleton (2900 in chips) 
Seat 2: yairpinto (20839 in chips) 
Seat 3: Duke Croix (10907 in chips) 
Seat 4: rogierk449 (13590 in chips) 
Seat 9: dddocky (4987 in chips) 
yairpinto: posts small blind 50
Duke Croix: posts big blind 100
*** HOLE CARDS ***
Dealt to Duke Croix [9d 3h]
rogierk449: raises 200 to 300
dddocky: folds 
color_singleton: folds 
yairpinto: raises 700 to 1000
Duke Croix: folds 
rogierk449 has timed out
rogierk449: folds 
Uncalled bet (700) returned to yairpinto
yairpinto collected 700 from pot
yairpinto: doesn't show hand 
*** SUMMARY ***
Total pot 700 | Rake 0 
Seat 1: color_singleton (button) folded before Flop (didn't bet)
Seat 2: yairpinto (small blind) collected (700)
Seat 3: Duke Croix (big blind) folded before Flop
Seat 4: rogierk449 folded before Flop
Seat 9: dddocky folded before Flop (didn't bet)



PokerStars Home Game Hand #216952232026: {Club #3225207}  Hold'em No Limit (50/100) - 2020/07/30 15:32:13 ET
Table 'JansPokergame' 9-max (Play Money) Seat #2 is the button
Seat 1: color_singleton (2900 in chips) 
Seat 2: yairpinto (21239 in chips) 
Seat 3: Duke Croix (10807 in chips) 
Seat 9: dddocky (4987 in chips) 
Duke Croix: posts small blind 50
dddocky: posts big blind 100
*** HOLE CARDS ***
Dealt to Duke Croix [4s Qc]
color_singleton: folds 
yairpinto: folds 
Duke Croix: calls 50
dddocky: checks 
*** FLOP *** [5s Ah 3c]
Duke Croix: checks 
dddocky: checks 
*** TURN *** [5s Ah 3c] [Ac]
Duke Croix: bets 200
dddocky: folds 
Uncalled bet (200) returned to Duke Croix
Duke Croix collected 189 from pot
*** SUMMARY ***
Total pot 200 | Rake 11 
Board [5s Ah 3c Ac]
Seat 1: color_singleton folded before Flop (didn't bet)
Seat 2: yairpinto (button) folded before Flop (didn't bet)
Seat 3: Duke Croix (small blind) collected (189)
Seat 9: dddocky (big blind) folded on the Turn



PokerStars Home Game Hand #216952248460: {Club #3225207}  Hold'em No Limit (50/100) - 2020/07/30 15:32:39 ET
Table 'JansPokergame' 9-max (Play Money) Seat #3 is the button
Seat 1: color_singleton (2900 in chips) 
Seat 2: yairpinto (21239 in chips) 
Seat 3: Duke Croix (10896 in chips) 
Seat 9: dddocky (4887 in chips) 
dddocky: posts small blind 50
color_singleton: posts big blind 100
*** HOLE CARDS ***
Dealt to Duke Croix [8h 5c]
yairpinto: folds 
Duke Croix: folds 
dddocky: calls 50
color_singleton: checks 
*** FLOP *** [Qc 9d 6h]
dddocky: checks 
color_singleton: checks 
*** TURN *** [Qc 9d 6h] [Jd]
dddocky: checks 
color_singleton: checks 
*** RIVER *** [Qc 9d 6h Jd] [9c]
dddocky: checks 
color_singleton: checks 
*** SHOW DOWN ***
dddocky: shows [Ts Th] (two pair, Tens and Nines)
color_singleton: mucks hand 
dddocky collected 189 from pot
*** SUMMARY ***
Total pot 200 | Rake 11 
Board [Qc 9d 6h Jd 9c]
Seat 1: color_singleton (big blind) mucked [7s 2h]
Seat 2: yairpinto folded before Flop (didn't bet)
Seat 3: Duke Croix (button) folded before Flop (didn't bet)
Seat 9: dddocky (small blind) showed [Ts Th] and won (189) with two pair, Tens and Nines



PokerStars Home Game Hand #216952266724: {Club #3225207}  Hold'em No Limit (50/100) - 2020/07/30 15:33:09 ET
Table 'JansPokergame' 9-max (Play Money) Seat #9 is the button
Seat 1: color_singleton (2800 in chips) 
Seat 2: yairpinto (21239 in chips) 
Seat 3: Duke Croix (10896 in chips) 
Seat 4: rogierk449 (13290 in chips) 
Seat 9: dddocky (4976 in chips) 
color_singleton: posts small blind 50
yairpinto: posts big blind 100
rogierk449: posts small & big blinds 150
*** HOLE CARDS ***
Dealt to Duke Croix [9h 4s]
Duke Croix: folds 
rogierk449: raises 300 to 400
dddocky: folds 
color_singleton: folds 
yairpinto: folds 
Uncalled bet (300) returned to rogierk449
rogierk449 collected 300 from pot
rogierk449: doesn't show hand 
*** SUMMARY ***
Total pot 300 | Rake 0 
Seat 1: color_singleton (small blind) folded before Flop
Seat 2: yairpinto (big blind) folded before Flop
Seat 3: Duke Croix folded before Flop (didn't bet)
Seat 4: rogierk449 collected (300)
Seat 9: dddocky (button) folded before Flop (didn't bet)



PokerStars Home Game Hand #216952278606: {Club #3225207}  Hold'em No Limit (50/100) - 2020/07/30 15:33:29 ET
Table 'JansPokergame' 9-max (Play Money) Seat #1 is the button
Seat 1: color_singleton (2750 in chips) 
Seat 2: yairpinto (21139 in chips) 
Seat 3: Duke Croix (10896 in chips) 
Seat 4: rogierk449 (13440 in chips) 
Seat 9: dddocky (4976 in chips) 
yairpinto: posts small blind 50
Duke Croix: posts big blind 100
*** HOLE CARDS ***
Dealt to Duke Croix [2c 9s]
rogierk449: calls 100
dddocky: calls 100
color_singleton: calls 100
yairpinto: calls 50
Duke Croix: checks 
*** FLOP *** [7d 4h 2s]
yairpinto: checks 
Duke Croix: checks 
rogierk449: checks 
dddocky: bets 100
color_singleton: calls 100
yairpinto: folds 
Duke Croix: folds 
rogierk449: calls 100
*** TURN *** [7d 4h 2s] [Ac]
rogierk449: checks 
dddocky: checks 
color_singleton: checks 
*** RIVER *** [7d 4h 2s Ac] [Jd]
rogierk449: bets 200
dddocky: folds 
color_singleton: folds 
Uncalled bet (200) returned to rogierk449
rogierk449 collected 756 from pot
rogierk449: doesn't show hand 
*** SUMMARY ***
Total pot 800 | Rake 44 
Board [7d 4h 2s Ac Jd]
Seat 1: color_singleton (button) folded on the River
Seat 2: yairpinto (small blind) folded on the Flop
Seat 3: Duke Croix (big blind) folded on the Flop
Seat 4: rogierk449 collected (756)
Seat 9: dddocky folded on the River



PokerStars Home Game Hand #216952317724: {Club #3225207}  Hold'em No Limit (50/100) - 2020/07/30 15:34:33 ET
Table 'JansPokergame' 9-max (Play Money) Seat #2 is the button
Seat 1: color_singleton (2550 in chips) 
Seat 2: yairpinto (21039 in chips) 
Seat 3: Duke Croix (10796 in chips) 
Seat 4: rogierk449 (13996 in chips) 
Seat 9: dddocky (4776 in chips) 
Duke Croix: posts small blind 50
rogierk449: posts big blind 100
*** HOLE CARDS ***
Dealt to Duke Croix [3d 2s]
dddocky: calls 100
color_singleton: folds 
yairpinto: raises 200 to 300
Duke Croix: folds 
rogierk449: calls 200
dddocky: calls 200
*** FLOP *** [Qd 2d 2c]
rogierk449: checks 
dddocky: bets 898
yairpinto: folds 
rogierk449: folds 
Uncalled bet (898) returned to dddocky
dddocky collected 898 from pot
dddocky: doesn't show hand 
*** SUMMARY ***
Total pot 950 | Rake 52 
Board [Qd 2d 2c]
Seat 1: color_singleton folded before Flop (didn't bet)
Seat 2: yairpinto (button) folded on the Flop
Seat 3: Duke Croix (small blind) folded before Flop
Seat 4: rogierk449 (big blind) folded on the Flop
Seat 9: dddocky collected (898)



PokerStars Home Game Hand #216952346107: {Club #3225207}  Hold'em No Limit (50/100) - 2020/07/30 15:35:19 ET
Table 'JansPokergame' 9-max (Play Money) Seat #3 is the button
Seat 1: color_singleton (2550 in chips) 
Seat 2: yairpinto (20739 in chips) 
Seat 3: Duke Croix (10746 in chips) 
Seat 4: rogierk449 (13696 in chips) 
Seat 9: dddocky (5374 in chips) 
rogierk449: posts small blind 50
dddocky: posts big blind 100
*** HOLE CARDS ***
Dealt to Duke Croix [Ts Ah]
color_singleton: raises 200 to 300
yairpinto: calls 300
Duke Croix: calls 300
rogierk449: calls 250
dddocky: folds 
*** FLOP *** [Qd Ad Th]
rogierk449: bets 200
color_singleton: calls 200
yairpinto: calls 200
Duke Croix: raises 1000 to 1200
rogierk449: raises 2200 to 3400
color_singleton: calls 2050 and is all-in
yairpinto: folds 
Duke Croix: calls 2200
*** TURN *** [Qd Ad Th] [Qc]
rogierk449: bets 9996 and is all-in
Duke Croix: calls 7046 and is all-in
Uncalled bet (2950) returned to rogierk449
*** RIVER *** [Qd Ad Th Qc] [8s]
*** SHOW DOWN ***
rogierk449: shows [Kc Jd] (a straight, Ten to Ace)
Duke Croix: shows [Ts Ah] (two pair, Aces and Queens)
rogierk449 collected 15491 from side pot
color_singleton: shows [Jh Kh] (a straight, Ten to Ace)
rogierk449 collected 3898 from main pot
color_singleton collected 3898 from main pot
*** SUMMARY ***
Total pot 24642 Main pot 7796. Side pot 15491. | Rake 1355 
Board [Qd Ad Th Qc 8s]
Seat 1: color_singleton showed [Jh Kh] and won (3898) with a straight, Ten to Ace
Seat 2: yairpinto folded on the Flop
Seat 3: Duke Croix (button) showed [Ts Ah] and lost with two pair, Aces and Queens
Seat 4: rogierk449 (small blind) showed [Kc Jd] and won (19389) with a straight, Ten to Ace
Seat 9: dddocky (big blind) folded before Flop



PokerStars Home Game Hand #216952428460: {Club #3225207}  Hold'em No Limit (50/100) - 2020/07/30 15:37:34 ET
Table 'JansPokergame' 9-max (Play Money) Seat #1 is the button
Seat 1: color_singleton (3984 in chips) 
Seat 2: yairpinto (20289 in chips) 
Seat 3: Duke Croix (10000 in chips) 
Seat 4: rogierk449 (22239 in chips) 
Seat 9: dddocky (5224 in chips) 
yairpinto: posts small blind 50
Duke Croix: posts big blind 100
*** HOLE CARDS ***
Dealt to Duke Croix [8d 6h]
Manon947 joins the table at seat #8 
rogierk449: calls 100
dddocky: folds 
color_singleton: raises 200 to 300
yairpinto: folds 
Duke Croix: folds 
rogierk449: calls 200
*** FLOP *** [5s Ad Jh]
rogierk449: checks 
color_singleton: bets 354
rogierk449: folds 
Uncalled bet (354) returned to color_singleton
color_singleton collected 709 from pot
color_singleton: doesn't show hand 
*** SUMMARY ***
Total pot 750 | Rake 41 
Board [5s Ad Jh]
Seat 1: color_singleton (button) collected (709)
Seat 2: yairpinto (small blind) folded before Flop
Seat 3: Duke Croix (big blind) folded before Flop
Seat 4: rogierk449 folded on the Flop
Seat 9: dddocky folded before Flop (didn't bet)



PokerStars Home Game Hand #216952454731: {Club #3225207}  Hold'em No Limit (50/100) - 2020/07/30 15:38:08 ET
Table 'JansPokergame' 9-max (Play Money) Seat #2 is the button
Seat 1: color_singleton (4393 in chips) 
Seat 2: yairpinto (20239 in chips) 
Seat 3: Duke Croix (9900 in chips) 
Seat 4: rogierk449 (21939 in chips) 
Seat 8: Manon947 (10000 in chips) 
Seat 9: dddocky (5224 in chips) 
Duke Croix: posts small blind 50
rogierk449: posts big blind 100
Manon947: posts big blind 100
*** HOLE CARDS ***
Dealt to Duke Croix [Jd 8s]
Manon947: checks 
dddocky: calls 100
color_singleton: calls 100
yairpinto: raises 200 to 300
Duke Croix: folds 
rogierk449: folds 
Manon947: folds 
dddocky: calls 200
color_singleton: calls 200
*** FLOP *** [9d 6h Jc]
dddocky: checks 
color_singleton: checks 
yairpinto: bets 543
dddocky: folds 
color_singleton: folds 
Uncalled bet (543) returned to yairpinto
yairpinto collected 1087 from pot
yairpinto: doesn't show hand 
*** SUMMARY ***
Total pot 1150 | Rake 63 
Board [9d 6h Jc]
Seat 1: color_singleton folded on the Flop
Seat 2: yairpinto (button) collected (1087)
Seat 3: Duke Croix (small blind) folded before Flop
Seat 4: rogierk449 (big blind) folded before Flop
Seat 8: Manon947 folded before Flop (didn't bet)
Seat 9: dddocky folded on the Flop



PokerStars Home Game Hand #216952493137: {Club #3225207}  Hold'em No Limit (50/100) - 2020/07/30 15:39:11 ET
Table 'JansPokergame' 9-max (Play Money) Seat #3 is the button
Seat 1: color_singleton (4093 in chips) 
Seat 2: yairpinto (21026 in chips) 
Seat 3: Duke Croix (9850 in chips) 
Seat 4: rogierk449 (21839 in chips) 
Seat 8: Manon947 (9900 in chips) 
Seat 9: dddocky (4924 in chips) 
rogierk449: posts small blind 50
Manon947: posts big blind 100
*** HOLE CARDS ***
Dealt to Duke Croix [Qd 4h]
dddocky: calls 100
color_singleton: folds 
yairpinto: folds 
Duke Croix: folds 
rogierk449: folds 
Manon947: checks 
*** FLOP *** [Jd Qc 2d]
Manon947: checks 
dddocky: checks 
*** TURN *** [Jd Qc 2d] [9d]
Manon947: checks 
dddocky: checks 
*** RIVER *** [Jd Qc 2d 9d] [9h]
Manon947: bets 100
dddocky: folds 
Uncalled bet (100) returned to Manon947
Manon947 collected 236 from pot
*** SUMMARY ***
Total pot 250 | Rake 14 
Board [Jd Qc 2d 9d 9h]
Seat 1: color_singleton folded before Flop (didn't bet)
Seat 2: yairpinto folded before Flop (didn't bet)
Seat 3: Duke Croix (button) folded before Flop (didn't bet)
Seat 4: rogierk449 (small blind) folded before Flop
Seat 8: Manon947 (big blind) collected (236)
Seat 9: dddocky folded on the River



PokerStars Home Game Hand #216952516221: {Club #3225207}  Hold'em No Limit (50/100) - 2020/07/30 15:39:48 ET
Table 'JansPokergame' 9-max (Play Money) Seat #4 is the button
Seat 1: color_singleton (4093 in chips) 
Seat 2: yairpinto (21026 in chips) 
Seat 3: Duke Croix (9850 in chips) 
Seat 4: rogierk449 (21789 in chips) 
Seat 8: Manon947 (10036 in chips) 
Seat 9: dddocky (4824 in chips) 
Manon947: posts small blind 50
dddocky: posts big blind 100
*** HOLE CARDS ***
Dealt to Duke Croix [Qs 5c]
color_singleton: raises 200 to 300
yairpinto: calls 300
Duke Croix: folds 
rogierk449: folds 
Manon947: calls 250
dddocky: calls 200
*** FLOP *** [4h 6c Kd]
Manon947: checks 
dddocky: checks 
color_singleton: bets 1134
yairpinto: folds 
Manon947: folds 
dddocky: folds 
Uncalled bet (1134) returned to color_singleton
color_singleton collected 1134 from pot
color_singleton: doesn't show hand 
*** SUMMARY ***
Total pot 1200 | Rake 66 
Board [4h 6c Kd]
Seat 1: color_singleton collected (1134)
Seat 2: yairpinto folded on the Flop
Seat 3: Duke Croix folded before Flop (didn't bet)
Seat 4: rogierk449 (button) folded before Flop (didn't bet)
Seat 8: Manon947 (small blind) folded on the Flop
Seat 9: dddocky (big blind) folded on the Flop



PokerStars Home Game Hand #216952538866: {Club #3225207}  Hold'em No Limit (50/100) - 2020/07/30 15:40:26 ET
Table 'JansPokergame' 9-max (Play Money) Seat #8 is the button
Seat 1: color_singleton (4927 in chips) 
Seat 2: yairpinto (20726 in chips) 
Seat 3: Duke Croix (9850 in chips) 
Seat 4: rogierk449 (21789 in chips) 
Seat 8: Manon947 (9736 in chips) 
Seat 9: dddocky (4524 in chips) 
dddocky: posts small blind 50
color_singleton: posts big blind 100
*** HOLE CARDS ***
Dealt to Duke Croix [Kh Ts]
yairpinto: raises 200 to 300
Duke Croix: calls 300
rogierk449: calls 300
Manon947: folds 
dddocky: folds 
color_singleton: calls 200
*** FLOP *** [Kc 2s Ac]
color_singleton: checks 
yairpinto: bets 590
Duke Croix: calls 590
rogierk449: folds 
color_singleton: folds 
*** TURN *** [Kc 2s Ac] [Jd]
yairpinto: checks 
Duke Croix: checks 
*** RIVER *** [Kc 2s Ac Jd] [2h]
yairpinto: checks 
Duke Croix: checks 
*** SHOW DOWN ***
yairpinto: shows [As Qd] (two pair, Aces and Deuces)
Duke Croix: mucks hand 
yairpinto collected 2296 from pot
*** SUMMARY ***
Total pot 2430 | Rake 134 
Board [Kc 2s Ac Jd 2h]
Seat 1: color_singleton (big blind) folded on the Flop
Seat 2: yairpinto showed [As Qd] and won (2296) with two pair, Aces and Deuces
Seat 3: Duke Croix mucked [Kh Ts]
Seat 4: rogierk449 folded on the Flop
Seat 8: Manon947 (button) folded before Flop (didn't bet)
Seat 9: dddocky (small blind) folded before Flop



PokerStars Home Game Hand #216952569391: {Club #3225207}  Hold'em No Limit (50/100) - 2020/07/30 15:41:16 ET
Table 'JansPokergame' 9-max (Play Money) Seat #9 is the button
Seat 1: color_singleton (4627 in chips) 
Seat 2: yairpinto (22132 in chips) 
Seat 3: Duke Croix (8960 in chips) 
Seat 4: rogierk449 (21489 in chips) 
Seat 8: Manon947 (9736 in chips) 
Seat 9: dddocky (4474 in chips) 
color_singleton: posts small blind 50
yairpinto: posts big blind 100
*** HOLE CARDS ***
Dealt to Duke Croix [9s Ac]
Duke Croix: calls 100
rogierk449: raises 200 to 300
Manon947: folds 
dddocky: folds 
color_singleton: folds 
yairpinto: folds 
Duke Croix: calls 200
*** FLOP *** [Jd 5h 2h]
Duke Croix: checks 
rogierk449: bets 709
Duke Croix: folds 
Uncalled bet (709) returned to rogierk449
rogierk449 collected 709 from pot
rogierk449: doesn't show hand 
*** SUMMARY ***
Total pot 750 | Rake 41 
Board [Jd 5h 2h]
Seat 1: color_singleton (small blind) folded before Flop
Seat 2: yairpinto (big blind) folded before Flop
Seat 3: Duke Croix folded on the Flop
Seat 4: rogierk449 collected (709)
Seat 8: Manon947 folded before Flop (didn't bet)
Seat 9: dddocky (button) folded before Flop (didn't bet)



PokerStars Home Game Hand #216952599630: {Club #3225207}  Hold'em No Limit (50/100) - 2020/07/30 15:42:05 ET
Table 'JansPokergame' 9-max (Play Money) Seat #1 is the button
Seat 1: color_singleton (4577 in chips) 
Seat 2: yairpinto (22032 in chips) 
Seat 3: Duke Croix (8660 in chips) 
Seat 4: rogierk449 (21898 in chips) 
Seat 8: Manon947 (9736 in chips) 
Seat 9: dddocky (4474 in chips) 
yairpinto: posts small blind 50
Duke Croix: posts big blind 100
*** HOLE CARDS ***
Dealt to Duke Croix [6d 3h]
rogierk449: folds 
Manon947: folds 
dddocky: folds 
color_singleton: folds 
yairpinto: raises 200 to 300
Duke Croix: folds 
Uncalled bet (200) returned to yairpinto
yairpinto collected 200 from pot
yairpinto: doesn't show hand 
*** SUMMARY ***
Total pot 200 | Rake 0 
Seat 1: color_singleton (button) folded before Flop (didn't bet)
Seat 2: yairpinto (small blind) collected (200)
Seat 3: Duke Croix (big blind) folded before Flop
Seat 4: rogierk449 folded before Flop (didn't bet)
Seat 8: Manon947 folded before Flop (didn't bet)
Seat 9: dddocky folded before Flop (didn't bet)



PokerStars Home Game Hand #216952615265: {Club #3225207}  Hold'em No Limit (50/100) - 2020/07/30 15:42:31 ET
Table 'JansPokergame' 9-max (Play Money) Seat #2 is the button
Seat 1: color_singleton (4577 in chips) 
Seat 2: yairpinto (22132 in chips) 
Seat 3: Duke Croix (8560 in chips) 
Seat 4: rogierk449 (21898 in chips) 
Seat 8: Manon947 (9736 in chips) 
Seat 9: dddocky (4474 in chips) 
Duke Croix: posts small blind 50
rogierk449: posts big blind 100
*** HOLE CARDS ***
Dealt to Duke Croix [Kd Jh]
Manon947: calls 100
dddocky: folds 
color_singleton: folds 
yairpinto: folds 
Duke Croix: raises 300 to 400
rogierk449: folds 
Manon947: calls 300
*** FLOP *** [9s 3d Qc]
Duke Croix: checks 
Manon947: checks 
*** TURN *** [9s 3d Qc] [Jd]
Duke Croix: bets 400
Manon947: folds 
Uncalled bet (400) returned to Duke Croix
Duke Croix collected 850 from pot
*** SUMMARY ***
Total pot 900 | Rake 50 
Board [9s 3d Qc Jd]
Seat 1: color_singleton folded before Flop (didn't bet)
Seat 2: yairpinto (button) folded before Flop (didn't bet)
Seat 3: Duke Croix (small blind) collected (850)
Seat 4: rogierk449 (big blind) folded before Flop
Seat 8: Manon947 folded on the Turn
Seat 9: dddocky folded before Flop (didn't bet)



PokerStars Home Game Hand #216952637230: {Club #3225207}  Hold'em No Limit (50/100) - 2020/07/30 15:43:07 ET
Table 'JansPokergame' 9-max (Play Money) Seat #3 is the button
Seat 1: color_singleton (4577 in chips) 
Seat 2: yairpinto (22132 in chips) 
Seat 3: Duke Croix (9010 in chips) 
Seat 4: rogierk449 (21798 in chips) 
Seat 8: Manon947 (9336 in chips) 
Seat 9: dddocky (4474 in chips) 
rogierk449: posts small blind 50
Manon947: posts big blind 100
*** HOLE CARDS ***
Dealt to Duke Croix [7c 9h]
dddocky: folds 
color_singleton has timed out
color_singleton: folds 
yairpinto: folds 
Duke Croix: folds 
rogierk449: folds 
Uncalled bet (50) returned to Manon947
Manon947 collected 100 from pot
*** SUMMARY ***
Total pot 100 | Rake 0 
Seat 1: color_singleton folded before Flop (didn't bet)
Seat 2: yairpinto folded before Flop (didn't bet)
Seat 3: Duke Croix (button) folded before Flop (didn't bet)
Seat 4: rogierk449 (small blind) folded before Flop
Seat 8: Manon947 (big blind) collected (100)
Seat 9: dddocky folded before Flop (didn't bet)



PokerStars Home Game Hand #216952652973: {Club #3225207}  Hold'em No Limit (50/100) - 2020/07/30 15:43:33 ET
Table 'JansPokergame' 9-max (Play Money) Seat #4 is the button
Seat 2: yairpinto (22132 in chips) 
Seat 3: Duke Croix (9010 in chips) 
Seat 4: rogierk449 (21748 in chips) 
Seat 8: Manon947 (9386 in chips) 
Seat 9: dddocky (4474 in chips) 
Manon947: posts small blind 50
dddocky: posts big blind 100
*** HOLE CARDS ***
Dealt to Duke Croix [5h 9h]
yairpinto: raises 200 to 300
Duke Croix: folds 
rogierk449: folds 
Manon947: folds 
dddocky: folds 
Uncalled bet (200) returned to yairpinto
yairpinto collected 250 from pot
yairpinto: doesn't show hand 
*** SUMMARY ***
Total pot 250 | Rake 0 
Seat 2: yairpinto collected (250)
Seat 3: Duke Croix folded before Flop (didn't bet)
Seat 4: rogierk449 (button) folded before Flop (didn't bet)
Seat 8: Manon947 (small blind) folded before Flop
Seat 9: dddocky (big blind) folded before Flop



PokerStars Home Game Hand #216952665205: {Club #3225207}  Hold'em No Limit (50/100) - 2020/07/30 15:43:53 ET
Table 'JansPokergame' 9-max (Play Money) Seat #8 is the button
Seat 2: yairpinto (22282 in chips) 
Seat 3: Duke Croix (9010 in chips) 
Seat 4: rogierk449 (21748 in chips) 
Seat 8: Manon947 (9336 in chips) 
Seat 9: dddocky (4374 in chips) 
dddocky: posts small blind 50
yairpinto: posts big blind 100
*** HOLE CARDS ***
Dealt to Duke Croix [Qc 8s]
Duke Croix: calls 100
rogierk449: folds 
Manon947: calls 100
dddocky: calls 50
yairpinto: checks 
*** FLOP *** [9d 3d 2h]
dddocky: checks 
yairpinto: checks 
Duke Croix: checks 
Manon947: checks 
*** TURN *** [9d 3d 2h] [2c]
dddocky: checks 
yairpinto: checks 
Duke Croix: checks 
Manon947: checks 
*** RIVER *** [9d 3d 2h 2c] [6c]
dddocky: checks 
yairpinto: checks 
Duke Croix: checks 
Manon947: bets 378
dddocky: folds 
yairpinto: folds 
Duke Croix: folds 
Uncalled bet (378) returned to Manon947
Manon947 collected 378 from pot
*** SUMMARY ***
Total pot 400 | Rake 22 
Board [9d 3d 2h 2c 6c]
Seat 2: yairpinto (big blind) folded on the River
Seat 3: Duke Croix folded on the River
Seat 4: rogierk449 folded before Flop (didn't bet)
Seat 8: Manon947 (button) collected (378)
Seat 9: dddocky (small blind) folded on the River



PokerStars Home Game Hand #216952698218: {Club #3225207}  Hold'em No Limit (50/100) - 2020/07/30 15:44:47 ET
Table 'JansPokergame' 9-max (Play Money) Seat #9 is the button
Seat 2: yairpinto (22182 in chips) 
Seat 3: Duke Croix (8910 in chips) 
Seat 4: rogierk449 (21748 in chips) 
Seat 8: Manon947 (9614 in chips) 
Seat 9: dddocky (4274 in chips) 
yairpinto: posts small blind 50
Duke Croix: posts big blind 100
*** HOLE CARDS ***
Dealt to Duke Croix [As 2c]
rogierk449: folds 
Manon947: calls 100
dddocky: calls 100
yairpinto: calls 50
Duke Croix: checks 
*** FLOP *** [5d 7s Jd]
yairpinto: checks 
Duke Croix: checks 
Manon947: checks 
dddocky: checks 
*** TURN *** [5d 7s Jd] [Qc]
yairpinto: bets 189
Duke Croix: folds 
Manon947: folds 
dddocky: folds 
Uncalled bet (189) returned to yairpinto
yairpinto collected 378 from pot
yairpinto: doesn't show hand 
*** SUMMARY ***
Total pot 400 | Rake 22 
Board [5d 7s Jd Qc]
Seat 2: yairpinto (small blind) collected (378)
Seat 3: Duke Croix (big blind) folded on the Turn
Seat 4: rogierk449 folded before Flop (didn't bet)
Seat 8: Manon947 folded on the Turn
Seat 9: dddocky (button) folded on the Turn



PokerStars Home Game Hand #216952726472: {Club #3225207}  Hold'em No Limit (50/100) - 2020/07/30 15:45:32 ET
Table 'JansPokergame' 9-max (Play Money) Seat #2 is the button
Seat 1: color_singleton (4577 in chips) 
Seat 2: yairpinto (22460 in chips) 
Seat 3: Duke Croix (8810 in chips) 
Seat 4: rogierk449 (21748 in chips) 
Seat 8: Manon947 (9514 in chips) 
Seat 9: dddocky (4174 in chips) 
Duke Croix: posts small blind 50
rogierk449: posts big blind 100
color_singleton: posts small & big blinds 150
*** HOLE CARDS ***
Dealt to Duke Croix [5s Th]
Manon947: calls 100
dddocky: calls 100
color_singleton: checks 
yairpinto: folds 
Duke Croix: calls 50
rogierk449: raises 400 to 500
Manon947: folds 
dddocky: calls 400
color_singleton: folds 
Duke Croix: folds 
*** FLOP *** [Ts 6h Qc]
rogierk449: checks 
dddocky: checks 
*** TURN *** [Ts 6h Qc] [Jd]
rogierk449: bets 638
dddocky: folds 
Uncalled bet (638) returned to rogierk449
rogierk449 collected 1276 from pot
rogierk449: doesn't show hand 
*** SUMMARY ***
Total pot 1350 | Rake 74 
Board [Ts 6h Qc Jd]
Seat 1: color_singleton folded before Flop (didn't bet)
Seat 2: yairpinto (button) folded before Flop (didn't bet)
Seat 3: Duke Croix (small blind) folded before Flop
Seat 4: rogierk449 (big blind) collected (1276)
Seat 8: Manon947 folded before Flop
Seat 9: dddocky folded on the Turn



PokerStars Home Game Hand #216952749913: {Club #3225207}  Hold'em No Limit (50/100) - 2020/07/30 15:46:11 ET
Table 'JansPokergame' 9-max (Play Money) Seat #3 is the button
Seat 1: color_singleton (4427 in chips) 
Seat 2: yairpinto (22460 in chips) 
Seat 3: Duke Croix (8710 in chips) 
Seat 4: rogierk449 (22524 in chips) 
Seat 8: Manon947 (9414 in chips) 
Seat 9: dddocky (3674 in chips) 
rogierk449: posts small blind 50
Manon947: posts big blind 100
*** HOLE CARDS ***
Dealt to Duke Croix [7d 5d]
dddocky: calls 100
color_singleton: calls 100
yairpinto: raises 200 to 300
Duke Croix has timed out
Duke Croix: folds 
rogierk449: folds 
Manon947: calls 200
dddocky: calls 200
color_singleton: calls 200
*** FLOP *** [Ks 9h 6d]
Manon947: bets 590
dddocky: folds 
color_singleton: folds 
yairpinto: folds 
Uncalled bet (590) returned to Manon947
Manon947 collected 1181 from pot
*** SUMMARY ***
Total pot 1250 | Rake 69 
Board [Ks 9h 6d]
Seat 1: color_singleton folded on the Flop
Seat 2: yairpinto folded on the Flop
Seat 3: Duke Croix (button) folded before Flop (didn't bet)
Seat 4: rogierk449 (small blind) folded before Flop
Seat 8: Manon947 (big blind) collected (1181)
Seat 9: dddocky folded on the Flop



PokerStars Home Game Hand #216952787973: {Club #3225207}  Hold'em No Limit (50/100) - 2020/07/30 15:47:14 ET
Table 'JansPokergame' 9-max (Play Money) Seat #4 is the button
Seat 1: color_singleton (4127 in chips) 
Seat 2: yairpinto (22160 in chips) 
Seat 3: Duke Croix (8710 in chips) 
Seat 4: rogierk449 (22474 in chips) 
Seat 8: Manon947 (10295 in chips) 
Seat 9: dddocky (3374 in chips) 
Manon947: posts small blind 50
dddocky: posts big blind 100
*** HOLE CARDS ***
Dealt to Duke Croix [Th 2h]
color_singleton: folds 
yairpinto: folds 
Duke Croix: calls 100
rogierk449: folds 
Manon947: calls 50
dddocky: checks 
*** FLOP *** [Kh Qh Ah]
Manon947: bets 141
dddocky: folds 
Duke Croix: calls 141
*** TURN *** [Kh Qh Ah] [4s]
Manon947: checks 
Duke Croix: bets 400
Manon947: raises 400 to 800
Duke Croix: raises 400 to 1200
Manon947: calls 400
*** RIVER *** [Kh Qh Ah 4s] [2d]
Manon947: checks 
Duke Croix: bets 1300
Manon947: folds 
Uncalled bet (1300) returned to Duke Croix
Duke Croix collected 2818 from pot
*** SUMMARY ***
Total pot 2982 | Rake 164 
Board [Kh Qh Ah 4s 2d]
Seat 1: color_singleton folded before Flop (didn't bet)
Seat 2: yairpinto folded before Flop (didn't bet)
Seat 3: Duke Croix collected (2818)
Seat 4: rogierk449 (button) folded before Flop (didn't bet)
Seat 8: Manon947 (small blind) folded on the River
Seat 9: dddocky (big blind) folded on the Flop



PokerStars Home Game Hand #216952832859: {Club #3225207}  Hold'em No Limit (50/100) - 2020/07/30 15:48:28 ET
Table 'JansPokergame' 9-max (Play Money) Seat #8 is the button
Seat 1: color_singleton (4127 in chips) 
Seat 2: yairpinto (22160 in chips) 
Seat 3: Duke Croix (10087 in chips) 
Seat 4: rogierk449 (22474 in chips) 
Seat 8: Manon947 (8854 in chips) 
Seat 9: dddocky (3274 in chips) 
dddocky: posts small blind 50
color_singleton: posts big blind 100
*** HOLE CARDS ***
Dealt to Duke Croix [5s 5c]
yairpinto: folds 
Duke Croix: raises 300 to 400
rogierk449: folds 
Manon947: folds 
dddocky: folds 
color_singleton: folds 
Uncalled bet (300) returned to Duke Croix
Duke Croix collected 250 from pot
*** SUMMARY ***
Total pot 250 | Rake 0 
Seat 1: color_singleton (big blind) folded before Flop
Seat 2: yairpinto folded before Flop (didn't bet)
Seat 3: Duke Croix collected (250)
Seat 4: rogierk449 folded before Flop (didn't bet)
Seat 8: Manon947 (button) folded before Flop (didn't bet)
Seat 9: dddocky (small blind) folded before Flop



PokerStars Home Game Hand #216952843202: {Club #3225207}  Hold'em No Limit (50/100) - 2020/07/30 15:48:46 ET
Table 'JansPokergame' 9-max (Play Money) Seat #9 is the button
Seat 1: color_singleton (4027 in chips) 
Seat 2: yairpinto (22160 in chips) 
Seat 3: Duke Croix (10237 in chips) 
Seat 4: rogierk449 (22474 in chips) 
Seat 8: Manon947 (8854 in chips) 
Seat 9: dddocky (3224 in chips) 
color_singleton: posts small blind 50
yairpinto: posts big blind 100
*** HOLE CARDS ***
Dealt to Duke Croix [Ad Ah]
Duke Croix: raises 300 to 400
rogierk449: folds 
Manon947: calls 400
dddocky: folds 
color_singleton: folds 
yairpinto: folds 
*** FLOP *** [7h 9c 4d]
Duke Croix: checks 
Manon947: checks 
*** TURN *** [7h 9c 4d] [Qh]
Duke Croix: bets 700
Manon947: folds 
Uncalled bet (700) returned to Duke Croix
Duke Croix collected 898 from pot
*** SUMMARY ***
Total pot 950 | Rake 52 
Board [7h 9c 4d Qh]
Seat 1: color_singleton (small blind) folded before Flop
Seat 2: yairpinto (big blind) folded before Flop
Seat 3: Duke Croix collected (898)
Seat 4: rogierk449 folded before Flop (didn't bet)
Seat 8: Manon947 folded on the Turn
Seat 9: dddocky (button) folded before Flop (didn't bet)



PokerStars Home Game Hand #216952862652: {Club #3225207}  Hold'em No Limit (50/100) - 2020/07/30 15:49:18 ET
Table 'JansPokergame' 9-max (Play Money) Seat #1 is the button
Seat 1: color_singleton (3977 in chips) 
Seat 2: yairpinto (22060 in chips) 
Seat 3: Duke Croix (10735 in chips) 
Seat 4: rogierk449 (22474 in chips) 
Seat 8: Manon947 (8454 in chips) 
Seat 9: dddocky (3224 in chips) 
yairpinto: posts small blind 50
Duke Croix: posts big blind 100
*** HOLE CARDS ***
Dealt to Duke Croix [Th 4h]
rogierk449: folds 
Manon947: calls 100
dddocky: calls 100
color_singleton: calls 100
yairpinto: calls 50
Duke Croix: checks 
*** FLOP *** [3d Kd Qd]
yairpinto: checks 
Duke Croix: checks 
Manon947: checks 
dddocky: checks 
color_singleton: bets 236
yairpinto: folds 
Duke Croix: folds 
Manon947: folds 
dddocky: folds 
Uncalled bet (236) returned to color_singleton
color_singleton collected 472 from pot
color_singleton: doesn't show hand 
*** SUMMARY ***
Total pot 500 | Rake 28 
Board [3d Kd Qd]
Seat 1: color_singleton (button) collected (472)
Seat 2: yairpinto (small blind) folded on the Flop
Seat 3: Duke Croix (big blind) folded on the Flop
Seat 4: rogierk449 folded before Flop (didn't bet)
Seat 8: Manon947 folded on the Flop
Seat 9: dddocky folded on the Flop



PokerStars Home Game Hand #216952884660: {Club #3225207}  Hold'em No Limit (50/100) - 2020/07/30 15:49:54 ET
Table 'JansPokergame' 9-max (Play Money) Seat #2 is the button
Seat 1: color_singleton (4349 in chips) 
Seat 2: yairpinto (21960 in chips) 
Seat 3: Duke Croix (10635 in chips) 
Seat 4: rogierk449 (22474 in chips) 
Seat 8: Manon947 (8354 in chips) 
Seat 9: dddocky (3124 in chips) 
Duke Croix: posts small blind 50
rogierk449: posts big blind 100
*** HOLE CARDS ***
Dealt to Duke Croix [5h 4h]
Manon947: folds 
dddocky: folds 
color_singleton: folds 
yairpinto: folds 
Duke Croix: raises 300 to 400
rogierk449 has timed out
rogierk449: folds 
Uncalled bet (300) returned to Duke Croix
Duke Croix collected 200 from pot
*** SUMMARY ***
Total pot 200 | Rake 0 
Seat 1: color_singleton folded before Flop (didn't bet)
Seat 2: yairpinto (button) folded before Flop (didn't bet)
Seat 3: Duke Croix (small blind) collected (200)
Seat 4: rogierk449 (big blind) folded before Flop
Seat 8: Manon947 folded before Flop (didn't bet)
Seat 9: dddocky folded before Flop (didn't bet)



PokerStars Home Game Hand #216952905799: {Club #3225207}  Hold'em No Limit (50/100) - 2020/07/30 15:50:30 ET
Table 'JansPokergame' 9-max (Play Money) Seat #3 is the button
Seat 1: color_singleton (4349 in chips) 
Seat 2: yairpinto (21960 in chips) 
Seat 3: Duke Croix (10735 in chips) 
Seat 8: Manon947 (8354 in chips) 
Seat 9: dddocky (3124 in chips) 
Manon947: posts small blind 50
dddocky: posts big blind 100
*** HOLE CARDS ***
Dealt to Duke Croix [5h 5d]
color_singleton: folds 
yairpinto: folds 
Duke Croix: raises 300 to 400
Manon947: calls 350
dddocky: folds 
*** FLOP *** [Ad Qs 9h]
Manon947: checks 
Duke Croix: bets 500
Manon947: calls 500
*** TURN *** [Ad Qs 9h] [8c]
Manon947: bets 897
Duke Croix: folds 
Uncalled bet (897) returned to Manon947
Manon947 collected 1795 from pot
*** SUMMARY ***
Total pot 1900 | Rake 105 
Board [Ad Qs 9h 8c]
Seat 1: color_singleton folded before Flop (didn't bet)
Seat 2: yairpinto folded before Flop (didn't bet)
Seat 3: Duke Croix (button) folded on the Turn
Seat 8: Manon947 (small blind) collected (1795)
Seat 9: dddocky (big blind) folded before Flop



PokerStars Home Game Hand #216952929308: {Club #3225207}  Hold'em No Limit (50/100) - 2020/07/30 15:51:08 ET
Table 'JansPokergame' 9-max (Play Money) Seat #8 is the button
Seat 1: color_singleton (4349 in chips) 
Seat 2: yairpinto (21960 in chips) 
Seat 3: Duke Croix (9835 in chips) 
Seat 8: Manon947 (9249 in chips) 
Seat 9: dddocky (3024 in chips) 
dddocky: posts small blind 50
color_singleton: posts big blind 100
*** HOLE CARDS ***
Dealt to Duke Croix [9s 4s]
yairpinto: folds 
Duke Croix: folds 
Manon947: folds 
dddocky: calls 50
color_singleton: checks 
*** FLOP *** [Jc Jh Kh]
dddocky: checks 
color_singleton: checks 
*** TURN *** [Jc Jh Kh] [Td]
dddocky: checks 
color_singleton: bets 189
dddocky: folds 
Uncalled bet (189) returned to color_singleton
color_singleton collected 189 from pot
color_singleton: doesn't show hand 
*** SUMMARY ***
Total pot 200 | Rake 11 
Board [Jc Jh Kh Td]
Seat 1: color_singleton (big blind) collected (189)
Seat 2: yairpinto folded before Flop (didn't bet)
Seat 3: Duke Croix folded before Flop (didn't bet)
Seat 8: Manon947 (button) folded before Flop (didn't bet)
Seat 9: dddocky (small blind) folded on the Turn



PokerStars Home Game Hand #216952945569: {Club #3225207}  Hold'em No Limit (50/100) - 2020/07/30 15:51:35 ET
Table 'JansPokergame' 9-max (Play Money) Seat #9 is the button
Seat 1: color_singleton (4438 in chips) 
Seat 2: yairpinto (21960 in chips) 
Seat 3: Duke Croix (9835 in chips) 
Seat 8: Manon947 (9249 in chips) 
Seat 9: dddocky (2924 in chips) 
color_singleton: posts small blind 50
yairpinto: posts big blind 100
*** HOLE CARDS ***
Dealt to Duke Croix [Jh 3s]
Duke Croix: folds 
Manon947: folds 
dddocky: folds 
color_singleton: calls 50
yairpinto: checks 
*** FLOP *** [7d 4h 5d]
color_singleton: checks 
yairpinto: bets 189
color_singleton: calls 189
*** TURN *** [7d 4h 5d] [Jc]
color_singleton: checks 
yairpinto: bets 273
color_singleton: calls 273
*** RIVER *** [7d 4h 5d Jc] [Qs]
color_singleton: checks 
yairpinto: bets 531
color_singleton: folds 
Uncalled bet (531) returned to yairpinto
yairpinto collected 1062 from pot
yairpinto: doesn't show hand 
*** SUMMARY ***
Total pot 1124 | Rake 62 
Board [7d 4h 5d Jc Qs]
Seat 1: color_singleton (small blind) folded on the River
Seat 2: yairpinto (big blind) collected (1062)
Seat 3: Duke Croix folded before Flop (didn't bet)
Seat 8: Manon947 folded before Flop (didn't bet)
Seat 9: dddocky (button) folded before Flop (didn't bet)



PokerStars Home Game Hand #216952969432: {Club #3225207}  Hold'em No Limit (50/100) - 2020/07/30 15:52:15 ET
Table 'JansPokergame' 9-max (Play Money) Seat #1 is the button
Seat 1: color_singleton (3876 in chips) 
Seat 2: yairpinto (22460 in chips) 
Seat 3: Duke Croix (9835 in chips) 
Seat 8: Manon947 (9249 in chips) 
Seat 9: dddocky (2924 in chips) 
yairpinto: posts small blind 50
Duke Croix: posts big blind 100
*** HOLE CARDS ***
Dealt to Duke Croix [7h Qd]
Manon947: calls 100
dddocky: folds 
color_singleton: calls 100
yairpinto: calls 50
Duke Croix: checks 
*** FLOP *** [Ad 9s Js]
yairpinto: checks 
Duke Croix: checks 
Manon947: checks 
color_singleton: bets 189
yairpinto: calls 189
Duke Croix: folds 
Manon947: calls 189
*** TURN *** [Ad 9s Js] [4d]
yairpinto: checks 
Manon947: checks 
color_singleton: checks 
*** RIVER *** [Ad 9s Js 4d] [4h]
yairpinto: checks 
Manon947: checks 
color_singleton: checks 
*** SHOW DOWN ***
yairpinto: shows [Qs 9c] (two pair, Nines and Fours)
Manon947: mucks hand 
color_singleton: shows [9d Ts] (two pair, Nines and Fours)
yairpinto collected 457 from pot
color_singleton collected 457 from pot
*** SUMMARY ***
Total pot 967 | Rake 53 
Board [Ad 9s Js 4d 4h]
Seat 1: color_singleton (button) showed [9d Ts] and won (457) with two pair, Nines and Fours
Seat 2: yairpinto (small blind) showed [Qs 9c] and won (457) with two pair, Nines and Fours
Seat 3: Duke Croix (big blind) folded on the Flop
Seat 8: Manon947 mucked [3h Kd]
Seat 9: dddocky folded before Flop (didn't bet)



PokerStars Home Game Hand #216953006219: {Club #3225207}  Hold'em No Limit (50/100) - 2020/07/30 15:53:16 ET
Table 'JansPokergame' 9-max (Play Money) Seat #2 is the button
Seat 1: color_singleton (4044 in chips) 
Seat 2: yairpinto (22628 in chips) 
Seat 3: Duke Croix (9735 in chips) 
Seat 8: Manon947 (8960 in chips) 
Seat 9: dddocky (2924 in chips) 
Duke Croix: posts small blind 50
Manon947: posts big blind 100
*** HOLE CARDS ***
Dealt to Duke Croix [7c 4c]
dddocky: calls 100
color_singleton: folds 
yairpinto: folds 
Duke Croix: calls 50
Manon947: checks 
*** FLOP *** [7s Ts 8c]
Duke Croix: checks 
Manon947: checks 
dddocky: checks 
*** TURN *** [7s Ts 8c] [Qc]
Duke Croix: bets 200
Manon947: folds 
dddocky: folds 
Uncalled bet (200) returned to Duke Croix
Duke Croix collected 283 from pot
*** SUMMARY ***
Total pot 300 | Rake 17 
Board [7s Ts 8c Qc]
Seat 1: color_singleton folded before Flop (didn't bet)
Seat 2: yairpinto (button) folded before Flop (didn't bet)
Seat 3: Duke Croix (small blind) collected (283)
Seat 8: Manon947 (big blind) folded on the Turn
Seat 9: dddocky folded on the Turn



PokerStars Home Game Hand #216953023437: {Club #3225207}  Hold'em No Limit (50/100) - 2020/07/30 15:53:45 ET
Table 'JansPokergame' 9-max (Play Money) Seat #3 is the button
Seat 1: color_singleton (4044 in chips) 
Seat 2: yairpinto (22628 in chips) 
Seat 3: Duke Croix (9918 in chips) 
Seat 8: Manon947 (8860 in chips) 
Manon947: posts small blind 50
dddocky: is sitting out 
color_singleton: posts big blind 100
*** HOLE CARDS ***
Dealt to Duke Croix [7s Th]
yairpinto: folds 
Duke Croix: folds 
Manon947: calls 50
color_singleton: raises 200 to 300
Manon947: calls 200
*** FLOP *** [5c Td 9d]
Manon947: checks 
color_singleton: bets 283
Manon947: folds 
Uncalled bet (283) returned to color_singleton
color_singleton collected 567 from pot
color_singleton: doesn't show hand 
*** SUMMARY ***
Total pot 600 | Rake 33 
Board [5c Td 9d]
Seat 1: color_singleton (big blind) collected (567)
Seat 2: yairpinto folded before Flop (didn't bet)
Seat 3: Duke Croix (button) folded before Flop (didn't bet)
Seat 8: Manon947 (small blind) folded on the Flop



PokerStars Home Game Hand #216953037188: {Club #3225207}  Hold'em No Limit (50/100) - 2020/07/30 15:54:08 ET
Table 'JansPokergame' 9-max (Play Money) Seat #8 is the button
Seat 1: color_singleton (4311 in chips) 
Seat 2: yairpinto (22628 in chips) 
Seat 3: Duke Croix (9918 in chips) 
Seat 4: rogierk449 (22374 in chips) 
Seat 8: Manon947 (8560 in chips) 
color_singleton: posts small blind 50
yairpinto: posts big blind 100
rogierk449: posts small & big blinds 150
*** HOLE CARDS ***
Dealt to Duke Croix [Ac Qc]
Duke Croix: raises 300 to 400
rogierk449: calls 300
Manon947: calls 400
color_singleton: folds 
yairpinto: calls 300
*** FLOP *** [Qh Qd 8h]
yairpinto: checks 
Duke Croix: checks 
rogierk449: checks 
Manon947: checks 
*** TURN *** [Qh Qd 8h] [8d]
yairpinto: checks 
Duke Croix: bets 500
rogierk449: folds 
Manon947: folds 
yairpinto: folds 
Uncalled bet (500) returned to Duke Croix
Duke Croix collected 1606 from pot
*** SUMMARY ***
Total pot 1700 | Rake 94 
Board [Qh Qd 8h 8d]
Seat 1: color_singleton (small blind) folded before Flop
Seat 2: yairpinto (big blind) folded on the Turn
Seat 3: Duke Croix collected (1606)
Seat 4: rogierk449 folded on the Turn
Seat 8: Manon947 (button) folded on the Turn



PokerStars Home Game Hand #216953067481: {Club #3225207}  Hold'em No Limit (50/100) - 2020/07/30 15:54:50 ET
Table 'JansPokergame' 9-max (Play Money) Seat #1 is the button
Seat 1: color_singleton (4261 in chips) 
Seat 2: yairpinto (22228 in chips) 
Seat 3: Duke Croix (11124 in chips) 
Seat 4: rogierk449 (21924 in chips) 
Seat 8: Manon947 (8160 in chips) 
Seat 9: dddocky (2824 in chips) 
yairpinto: posts small blind 50
Duke Croix: posts big blind 100
dddocky: posts small & big blinds 150
*** HOLE CARDS ***
Dealt to Duke Croix [Td 8c]
rogierk449: folds 
Manon947: calls 100
dddocky: checks 
color_singleton: raises 200 to 300
yairpinto: folds 
Duke Croix: calls 200
Manon947: calls 200
dddocky: calls 200
*** FLOP *** [7h Qc Jc]
Duke Croix: checks 
Manon947: checks 
dddocky: bets 1228
color_singleton: folds 
Duke Croix: folds 
Manon947: folds 
Uncalled bet (1228) returned to dddocky
dddocky collected 1228 from pot
dddocky: doesn't show hand 
*** SUMMARY ***
Total pot 1300 | Rake 72 
Board [7h Qc Jc]
Seat 1: color_singleton (button) folded on the Flop
Seat 2: yairpinto (small blind) folded before Flop
Seat 3: Duke Croix (big blind) folded on the Flop
Seat 4: rogierk449 folded before Flop (didn't bet)
Seat 8: Manon947 folded on the Flop
Seat 9: dddocky collected (1228)



PokerStars Home Game Hand #216953090361: {Club #3225207}  Hold'em No Limit (50/100) - 2020/07/30 15:55:40 ET
Table 'JansPokergame' 9-max (Play Money) Seat #2 is the button
Seat 1: color_singleton (3961 in chips) 
Seat 2: yairpinto (22178 in chips) 
Seat 3: Duke Croix (10824 in chips) 
Seat 4: rogierk449 (21924 in chips) 
Seat 8: Manon947 (7860 in chips) 
Seat 9: dddocky (3702 in chips) 
Duke Croix: posts small blind 50
rogierk449: posts big blind 100
*** HOLE CARDS ***
Dealt to Duke Croix [Kc Kh]
Manon947: calls 100
dddocky: folds 
color_singleton: folds 
yairpinto: raises 200 to 300
Duke Croix: raises 400 to 700
rogierk449: folds 
Manon947: folds 
yairpinto: calls 400
*** FLOP *** [9h Ac Jd]
Duke Croix: bets 800
yairpinto: calls 800
*** TURN *** [9h Ac Jd] [Kd]
Duke Croix: bets 1900
yairpinto: calls 1900
*** RIVER *** [9h Ac Jd Kd] [8s]
Duke Croix: checks 
yairpinto: checks 
*** SHOW DOWN ***
Duke Croix: shows [Kc Kh] (three of a kind, Kings)
yairpinto: mucks hand 
Duke Croix collected 6615 from pot
*** SUMMARY ***
Total pot 7000 | Rake 385 
Board [9h Ac Jd Kd 8s]
Seat 1: color_singleton folded before Flop (didn't bet)
Seat 2: yairpinto (button) mucked [Ah Qs]
Seat 3: Duke Croix (small blind) showed [Kc Kh] and won (6615) with three of a kind, Kings
Seat 4: rogierk449 (big blind) folded before Flop
Seat 8: Manon947 folded before Flop
Seat 9: dddocky folded before Flop (didn't bet)



PokerStars Home Game Hand #216953111219: {Club #3225207}  Hold'em No Limit (50/100) - 2020/07/30 15:56:27 ET
Table 'JansPokergame' 9-max (Play Money) Seat #3 is the button
Seat 1: color_singleton (3961 in chips) 
Seat 2: yairpinto (18778 in chips) 
Seat 3: Duke Croix (14039 in chips) 
Seat 4: rogierk449 (21824 in chips) 
Seat 8: Manon947 (7760 in chips) 
Seat 9: dddocky (3702 in chips) 
rogierk449: posts small blind 50
Manon947: posts big blind 100
*** HOLE CARDS ***
Dealt to Duke Croix [8h 2s]
dddocky: calls 100
color_singleton: folds 
yairpinto: folds 
Duke Croix: folds 
rogierk449: folds 
Manon947: checks 
*** FLOP *** [Tc Ac 8d]
Manon947: bets 100
dddocky: raises 100 to 200
Manon947: calls 100
*** TURN *** [Tc Ac 8d] [7d]
Manon947: checks 
dddocky: checks 
*** RIVER *** [Tc Ac 8d 7d] [5s]
Manon947: checks 
dddocky: checks 
*** SHOW DOWN ***
Manon947: shows [8c Kh] (a pair of Eights)
dddocky: shows [2d Ad] (a pair of Aces)
dddocky collected 614 from pot
*** SUMMARY ***
Total pot 650 | Rake 36 
Board [Tc Ac 8d 7d 5s]
Seat 1: color_singleton folded before Flop (didn't bet)
Seat 2: yairpinto folded before Flop (didn't bet)
Seat 3: Duke Croix (button) folded before Flop (didn't bet)
Seat 4: rogierk449 (small blind) folded before Flop
Seat 8: Manon947 (big blind) showed [8c Kh] and lost with a pair of Eights
Seat 9: dddocky showed [2d Ad] and won (614) with a pair of Aces



PokerStars Home Game Hand #216953129355: {Club #3225207}  Hold'em No Limit (50/100) - 2020/07/30 15:57:07 ET
Table 'JansPokergame' 9-max (Play Money) Seat #4 is the button
Seat 1: color_singleton (3961 in chips) 
Seat 2: yairpinto (18778 in chips) 
Seat 3: Duke Croix (14039 in chips) 
Seat 4: rogierk449 (21774 in chips) 
Seat 8: Manon947 (7460 in chips) 
Seat 9: dddocky (4016 in chips) 
Manon947: posts small blind 50
dddocky: posts big blind 100
*** HOLE CARDS ***
Dealt to Duke Croix [2h Qs]
color_singleton: folds 
yairpinto: folds 
Duke Croix: folds 
rogierk449: raises 200 to 300
Manon947: calls 250
dddocky: calls 200
*** FLOP *** [Ah Td Jc]
Manon947: checks 
dddocky: checks 
rogierk449: bets 500
Manon947: folds 
dddocky: folds 
Uncalled bet (500) returned to rogierk449
rogierk449 collected 850 from pot
rogierk449: doesn't show hand 
*** SUMMARY ***
Total pot 900 | Rake 50 
Board [Ah Td Jc]
Seat 1: color_singleton folded before Flop (didn't bet)
Seat 2: yairpinto folded before Flop (didn't bet)
Seat 3: Duke Croix folded before Flop (didn't bet)
Seat 4: rogierk449 (button) collected (850)
Seat 8: Manon947 (small blind) folded on the Flop
Seat 9: dddocky (big blind) folded on the Flop



PokerStars Home Game Hand #216953146090: {Club #3225207}  Hold'em No Limit (50/100) - 2020/07/30 15:57:45 ET
Table 'JansPokergame' 9-max (Play Money) Seat #9 is the button
Seat 1: color_singleton (3961 in chips) 
Seat 2: yairpinto (18778 in chips) 
Seat 3: Duke Croix (14039 in chips) 
Seat 4: rogierk449 (22324 in chips) 
Seat 9: dddocky (3716 in chips) 
color_singleton: posts small blind 50
yairpinto: posts big blind 100
*** HOLE CARDS ***
Dealt to Duke Croix [Ks 2s]
Duke Croix: folds 
rogierk449: calls 100
dddocky: calls 100
color_singleton: raises 200 to 300
yairpinto: folds 
rogierk449: calls 200
dddocky: calls 200
*** FLOP *** [Kd 7h 8c]
color_singleton: bets 472
rogierk449: folds 
dddocky: folds 
Uncalled bet (472) returned to color_singleton
color_singleton collected 945 from pot
color_singleton: doesn't show hand 
*** SUMMARY ***
Total pot 1000 | Rake 55 
Board [Kd 7h 8c]
Seat 1: color_singleton (small blind) collected (945)
Seat 2: yairpinto (big blind) folded before Flop
Seat 3: Duke Croix folded before Flop (didn't bet)
Seat 4: rogierk449 folded on the Flop
Seat 9: dddocky (button) folded on the Flop



PokerStars Home Game Hand #216953161094: {Club #3225207}  Hold'em No Limit (50/100) - 2020/07/30 15:58:18 ET
Table 'JansPokergame' 9-max (Play Money) Seat #1 is the button
Seat 1: color_singleton (4606 in chips) 
Seat 2: yairpinto (18678 in chips) 
Seat 3: Duke Croix (14039 in chips) 
Seat 4: rogierk449 (22024 in chips) 
Seat 9: dddocky (3416 in chips) 
yairpinto: posts small blind 50
Duke Croix: posts big blind 100
*** HOLE CARDS ***
Dealt to Duke Croix [Kh 3d]
rogierk449: folds 
dddocky: folds 
color_singleton: folds 
yairpinto: raises 200 to 300
Duke Croix: folds 
Uncalled bet (200) returned to yairpinto
yairpinto collected 200 from pot
yairpinto: doesn't show hand 
*** SUMMARY ***
Total pot 200 | Rake 0 
Seat 1: color_singleton (button) folded before Flop (didn't bet)
Seat 2: yairpinto (small blind) collected (200)
Seat 3: Duke Croix (big blind) folded before Flop
Seat 4: rogierk449 folded before Flop (didn't bet)
Seat 9: dddocky folded before Flop (didn't bet)



PokerStars Home Game Hand #216953168383: {Club #3225207}  Hold'em No Limit (50/100) - 2020/07/30 15:58:35 ET
Table 'JansPokergame' 9-max (Play Money) Seat #2 is the button
Seat 1: color_singleton (4606 in chips) 
Seat 2: yairpinto (18778 in chips) 
Seat 3: Duke Croix (13939 in chips) 
Seat 4: rogierk449 (22024 in chips) 
Seat 9: dddocky (3416 in chips) 
Duke Croix: posts small blind 50
rogierk449: posts big blind 100
*** HOLE CARDS ***
Dealt to Duke Croix [4s 9c]
dddocky: calls 100
color_singleton: calls 100
yairpinto: folds 
Duke Croix: calls 50
rogierk449: checks 
*** FLOP *** [Kh Ks Ah]
Duke Croix: checks 
rogierk449: checks 
dddocky: checks 
color_singleton: bets 189
Duke Croix: folds 
rogierk449: folds 
dddocky: calls 189
*** TURN *** [Kh Ks Ah] [Qd]
dddocky: checks 
color_singleton: checks 
*** RIVER *** [Kh Ks Ah Qd] [3d]
dddocky: checks 
color_singleton: checks 
*** SHOW DOWN ***
dddocky: shows [Js Tc] (a straight, Ten to Ace)
color_singleton: mucks hand 
dddocky collected 735 from pot
*** SUMMARY ***
Total pot 778 | Rake 43 
Board [Kh Ks Ah Qd 3d]
Seat 1: color_singleton mucked [6h 4h]
Seat 2: yairpinto (button) folded before Flop (didn't bet)
Seat 3: Duke Croix (small blind) folded on the Flop
Seat 4: rogierk449 (big blind) folded on the Flop
Seat 9: dddocky showed [Js Tc] and won (735) with a straight, Ten to Ace



PokerStars Home Game Hand #216953189314: {Club #3225207}  Hold'em No Limit (50/100) - 2020/07/30 15:59:21 ET
Table 'JansPokergame' 9-max (Play Money) Seat #3 is the button
Seat 1: color_singleton (4317 in chips) 
Seat 2: yairpinto (18778 in chips) 
Seat 3: Duke Croix (13839 in chips) 
Seat 4: rogierk449 (21924 in chips) 
Seat 9: dddocky (3862 in chips) 
rogierk449: posts small blind 50
dddocky: posts big blind 100
*** HOLE CARDS ***
Dealt to Duke Croix [8d 6s]
color_singleton: folds 
yairpinto: folds 
Duke Croix: folds 
rogierk449: folds 
Uncalled bet (50) returned to dddocky
dddocky collected 100 from pot
dddocky: doesn't show hand 
*** SUMMARY ***
Total pot 100 | Rake 0 
Seat 1: color_singleton folded before Flop (didn't bet)
Seat 2: yairpinto folded before Flop (didn't bet)
Seat 3: Duke Croix (button) folded before Flop (didn't bet)
Seat 4: rogierk449 (small blind) folded before Flop
Seat 9: dddocky (big blind) collected (100)



PokerStars Home Game Hand #216953198044: {Club #3225207}  Hold'em No Limit (50/100) - 2020/07/30 15:59:40 ET
Table 'JansPokergame' 9-max (Play Money) Seat #4 is the button
Seat 1: color_singleton (4317 in chips) 
Seat 2: yairpinto (18778 in chips) 
Seat 3: Duke Croix (13839 in chips) 
Seat 4: rogierk449 (21874 in chips) 
Seat 9: dddocky (3912 in chips) 
dddocky: posts small blind 50
color_singleton: posts big blind 100
*** HOLE CARDS ***
Dealt to Duke Croix [3c 7h]
yairpinto has timed out
yairpinto: folds 
Duke Croix: folds 
rogierk449: folds 
dddocky: calls 50
color_singleton: checks 
*** FLOP *** [8d 6c Qc]
dddocky: checks 
color_singleton: checks 
*** TURN *** [8d 6c Qc] [8h]
dddocky: checks 
color_singleton: checks 
*** RIVER *** [8d 6c Qc 8h] [Jd]
dddocky: checks 
color_singleton: checks 
*** SHOW DOWN ***
dddocky: shows [8c As] (three of a kind, Eights)
color_singleton: mucks hand 
dddocky collected 189 from pot
*** SUMMARY ***
Total pot 200 | Rake 11 
Board [8d 6c Qc 8h Jd]
Seat 1: color_singleton (big blind) mucked [5d Jh]
Seat 2: yairpinto folded before Flop (didn't bet)
Seat 3: Duke Croix folded before Flop (didn't bet)
Seat 4: rogierk449 (button) folded before Flop (didn't bet)
Seat 9: dddocky (small blind) showed [8c As] and won (189) with three of a kind, Eights



PokerStars Home Game Hand #216953213925: {Club #3225207}  Hold'em No Limit (50/100) - 2020/07/30 16:00:15 ET
Table 'JansPokergame' 9-max (Play Money) Seat #9 is the button
Seat 1: color_singleton (4217 in chips) 
Seat 2: yairpinto (18778 in chips) 
Seat 3: Duke Croix (13839 in chips) 
Seat 4: rogierk449 (21874 in chips) 
Seat 9: dddocky (4001 in chips) 
color_singleton: posts small blind 50
yairpinto: posts big blind 100
*** HOLE CARDS ***
Dealt to Duke Croix [6c Js]
Duke Croix: folds 
rogierk449: folds 
dddocky: calls 100
color_singleton: folds 
yairpinto: checks 
*** FLOP *** [9h 9d 8h]
yairpinto: checks 
dddocky: checks 
*** TURN *** [9h 9d 8h] [Jc]
yairpinto: bets 100
dddocky: calls 100
*** RIVER *** [9h 9d 8h Jc] [Th]
yairpinto: bets 425
dddocky: raises 425 to 850
yairpinto: calls 425
*** SHOW DOWN ***
dddocky: shows [Tc Jd] (two pair, Jacks and Tens)
yairpinto: shows [5c Qs] (a straight, Eight to Queen)
yairpinto collected 2032 from pot
*** SUMMARY ***
Total pot 2150 | Rake 118 
Board [9h 9d 8h Jc Th]
Seat 1: color_singleton (small blind) folded before Flop
Seat 2: yairpinto (big blind) showed [5c Qs] and won (2032) with a straight, Eight to Queen
Seat 3: Duke Croix folded before Flop (didn't bet)
Seat 4: rogierk449 folded before Flop (didn't bet)
Seat 9: dddocky (button) showed [Tc Jd] and lost with two pair, Jacks and Tens



PokerStars Home Game Hand #216953235635: {Club #3225207}  Hold'em No Limit (50/100) - 2020/07/30 16:00:57 ET
Table 'JansPokergame' 9-max (Play Money) Seat #1 is the button
Seat 1: color_singleton (4167 in chips) 
Seat 2: yairpinto (19760 in chips) 
Seat 3: Duke Croix (13839 in chips) 
Seat 4: rogierk449 (21874 in chips) 
Seat 9: dddocky (2951 in chips) 
yairpinto: posts small blind 50
Duke Croix: posts big blind 100
*** HOLE CARDS ***
Dealt to Duke Croix [3h 2h]
rogierk449: folds 
dddocky: calls 100
color_singleton: raises 200 to 300
yairpinto: folds 
Duke Croix: calls 200
dddocky: calls 200
*** FLOP *** [Tc 6d 8h]
Duke Croix: checks 
dddocky: checks 
color_singleton: checks 
*** TURN *** [Tc 6d 8h] [3d]
Duke Croix: bets 400
dddocky: calls 400
color_singleton: calls 400
*** RIVER *** [Tc 6d 8h 3d] [5s]
Duke Croix: checks 
dddocky: checks 
color_singleton: checks 
*** SHOW DOWN ***
Duke Croix: shows [3h 2h] (a pair of Threes)
dddocky: shows [Kd Ts] (a pair of Tens)
color_singleton: mucks hand 
dddocky collected 2032 from pot
*** SUMMARY ***
Total pot 2150 | Rake 118 
Board [Tc 6d 8h 3d 5s]
Seat 1: color_singleton (button) mucked [4d Ad]
Seat 2: yairpinto (small blind) folded before Flop
Seat 3: Duke Croix (big blind) showed [3h 2h] and lost with a pair of Threes
Seat 4: rogierk449 folded before Flop (didn't bet)
Seat 9: dddocky showed [Kd Ts] and won (2032) with a pair of Tens



PokerStars Home Game Hand #216953276595: {Club #3225207}  Hold'em No Limit (50/100) - 2020/07/30 16:02:10 ET
Table 'JansPokergame' 9-max (Play Money) Seat #2 is the button
Seat 1: color_singleton (3467 in chips) 
Seat 2: yairpinto (19710 in chips) 
Seat 3: Duke Croix (13139 in chips) 
Seat 4: rogierk449 (21874 in chips) 
Seat 9: dddocky (4283 in chips) 
Duke Croix: posts small blind 50
rogierk449: posts big blind 100
*** HOLE CARDS ***
Dealt to Duke Croix [4s Kh]
dddocky: calls 100
color_singleton: folds 
yairpinto: raises 200 to 300
Duke Croix: folds 
rogierk449: raises 200 to 500
dddocky: calls 400
yairpinto: calls 200
*** FLOP *** [Td Qs 5d]
rogierk449: checks 
dddocky: bets 100
yairpinto: calls 100
rogierk449: calls 100
*** TURN *** [Td Qs 5d] [3c]
rogierk449: bets 300
dddocky: calls 300
yairpinto: folds 
*** RIVER *** [Td Qs 5d 3c] [4c]
rogierk449: checks 
dddocky: checks 
*** SHOW DOWN ***
rogierk449: shows [8s 8c] (a pair of Eights)
dddocky: shows [Qc 7c] (a pair of Queens)
dddocky collected 2315 from pot
*** SUMMARY ***
Total pot 2450 | Rake 135 
Board [Td Qs 5d 3c 4c]
Seat 1: color_singleton folded before Flop (didn't bet)
Seat 2: yairpinto (button) folded on the Turn
Seat 3: Duke Croix (small blind) folded before Flop
Seat 4: rogierk449 (big blind) showed [8s 8c] and lost with a pair of Eights
Seat 9: dddocky showed [Qc 7c] and won (2315) with a pair of Queens



PokerStars Home Game Hand #216953312211: {Club #3225207}  Hold'em No Limit (50/100) - 2020/07/30 16:03:10 ET
Table 'JansPokergame' 9-max (Play Money) Seat #3 is the button
Seat 1: color_singleton (3467 in chips) 
Seat 2: yairpinto (19110 in chips) 
Seat 3: Duke Croix (13089 in chips) 
Seat 4: rogierk449 (20974 in chips) 
Seat 9: dddocky (5698 in chips) 
rogierk449: posts small blind 50
dddocky: posts big blind 100
*** HOLE CARDS ***
Dealt to Duke Croix [5h 9c]
color_singleton: raises 100 to 200
yairpinto: folds 
Duke Croix: folds 
rogierk449: folds 
dddocky: calls 100
*** FLOP *** [Kd Qd 2c]
dddocky: checks 
color_singleton: bets 212
dddocky: calls 212
*** TURN *** [Kd Qd 2c] [As]
dddocky: checks 
color_singleton: checks 
*** RIVER *** [Kd Qd 2c As] [9s]
dddocky: checks 
color_singleton: checks 
*** SHOW DOWN ***
dddocky: shows [Qs Jh] (a pair of Queens)
color_singleton: shows [9d Qh] (two pair, Queens and Nines)
color_singleton collected 826 from pot
*** SUMMARY ***
Total pot 874 | Rake 48 
Board [Kd Qd 2c As 9s]
Seat 1: color_singleton showed [9d Qh] and won (826) with two pair, Queens and Nines
Seat 2: yairpinto folded before Flop (didn't bet)
Seat 3: Duke Croix (button) folded before Flop (didn't bet)
Seat 4: rogierk449 (small blind) folded before Flop
Seat 9: dddocky (big blind) showed [Qs Jh] and lost with a pair of Queens



PokerStars Home Game Hand #216953331635: {Club #3225207}  Hold'em No Limit (50/100) - 2020/07/30 16:03:43 ET
Table 'JansPokergame' 9-max (Play Money) Seat #4 is the button
Seat 1: color_singleton (3881 in chips) 
Seat 2: yairpinto (19110 in chips) 
Seat 3: Duke Croix (13089 in chips) 
Seat 4: rogierk449 (20924 in chips) 
Seat 9: dddocky (5286 in chips) 
dddocky: posts small blind 50
color_singleton: posts big blind 100
*** HOLE CARDS ***
Dealt to Duke Croix [Ts Jd]
yairpinto: folds 
Duke Croix: calls 100
rogierk449: folds 
dddocky: folds 
color_singleton: checks 
*** FLOP *** [4c As 9h]
color_singleton: bets 118
Duke Croix: folds 
Uncalled bet (118) returned to color_singleton
color_singleton collected 236 from pot
color_singleton: doesn't show hand 
*** SUMMARY ***
Total pot 250 | Rake 14 
Board [4c As 9h]
Seat 1: color_singleton (big blind) collected (236)
Seat 2: yairpinto folded before Flop (didn't bet)
Seat 3: Duke Croix folded on the Flop
Seat 4: rogierk449 (button) folded before Flop (didn't bet)
Seat 9: dddocky (small blind) folded before Flop



PokerStars Home Game Hand #216953352059: {Club #3225207}  Hold'em No Limit (50/100) - 2020/07/30 16:04:17 ET
Table 'JansPokergame' 9-max (Play Money) Seat #9 is the button
Seat 1: color_singleton (4017 in chips) 
Seat 2: yairpinto (19110 in chips) 
Seat 3: Duke Croix (12989 in chips) 
Seat 4: rogierk449 (20924 in chips) 
Seat 9: dddocky (5236 in chips) 
color_singleton: posts small blind 50
yairpinto: posts big blind 100
*** HOLE CARDS ***
Dealt to Duke Croix [5c 8s]
Duke Croix: folds 
rogierk449 has timed out
rogierk449: folds 
dddocky: folds 
color_singleton: raises 200 to 300
yairpinto: calls 200
*** FLOP *** [6s Ks Jh]
color_singleton: bets 283
yairpinto: calls 283
*** TURN *** [6s Ks Jh] [Qc]
color_singleton: bets 551
yairpinto: calls 551
*** RIVER *** [6s Ks Jh Qc] [4c]
color_singleton: checks 
yairpinto: checks 
*** SHOW DOWN ***
color_singleton: shows [9c Qd] (a pair of Queens)
yairpinto: shows [Th Kc] (a pair of Kings)
yairpinto collected 2143 from pot
*** SUMMARY ***
Total pot 2268 | Rake 125 
Board [6s Ks Jh Qc 4c]
Seat 1: color_singleton (small blind) showed [9c Qd] and lost with a pair of Queens
Seat 2: yairpinto (big blind) showed [Th Kc] and won (2143) with a pair of Kings
Seat 3: Duke Croix folded before Flop (didn't bet)
Seat 4: rogierk449 folded before Flop (didn't bet)
Seat 9: dddocky (button) folded before Flop (didn't bet)



PokerStars Home Game Hand #216953386192: {Club #3225207}  Hold'em No Limit (50/100) - 2020/07/30 16:05:14 ET
Table 'JansPokergame' 9-max (Play Money) Seat #1 is the button
Seat 1: color_singleton (2883 in chips) 
Seat 2: yairpinto (20119 in chips) 
Seat 3: Duke Croix (12989 in chips) 
Seat 4: rogierk449 (20924 in chips) 
Seat 9: dddocky (5236 in chips) 
yairpinto: posts small blind 50
Duke Croix: posts big blind 100
*** HOLE CARDS ***
Dealt to Duke Croix [8s 2d]
rogierk449: calls 100
dddocky: calls 100
color_singleton: raises 200 to 300
yairpinto: folds 
Duke Croix: folds 
rogierk449: calls 200
dddocky: calls 200
*** FLOP *** [Qs Jh 7h]
rogierk449: bets 496
dddocky: folds 
color_singleton: raises 496 to 992
rogierk449: raises 19632 to 20624 and is all-in
color_singleton: calls 1591 and is all-in
Uncalled bet (18041) returned to rogierk449
*** TURN *** [Qs Jh 7h] [7s]
*** RIVER *** [Qs Jh 7h 7s] [Ad]
*** SHOW DOWN ***
rogierk449: shows [6c Qc] (two pair, Queens and Sevens)
color_singleton: shows [Qd Js] (two pair, Queens and Jacks)
color_singleton collected 5874 from pot
*** SUMMARY ***
Total pot 6216 | Rake 342 
Board [Qs Jh 7h 7s Ad]
Seat 1: color_singleton (button) showed [Qd Js] and won (5874) with two pair, Queens and Jacks
Seat 2: yairpinto (small blind) folded before Flop
Seat 3: Duke Croix (big blind) folded before Flop
Seat 4: rogierk449 showed [6c Qc] and lost with two pair, Queens and Sevens
Seat 9: dddocky folded on the Flop



PokerStars Home Game Hand #216953409894: {Club #3225207}  Hold'em No Limit (50/100) - 2020/07/30 16:05:53 ET
Table 'JansPokergame' 9-max (Play Money) Seat #2 is the button
Seat 1: color_singleton (5874 in chips) 
Seat 2: yairpinto (20069 in chips) 
Seat 3: Duke Croix (12889 in chips) 
Seat 4: rogierk449 (18041 in chips) 
Seat 9: dddocky (4936 in chips) 
Duke Croix: posts small blind 50
rogierk449: posts big blind 100
*** HOLE CARDS ***
Dealt to Duke Croix [7d 9s]
dddocky: calls 100
color_singleton: folds 
yairpinto: raises 200 to 300
Duke Croix: folds 
rogierk449: folds 
dddocky: calls 200
*** FLOP *** [Kh 3s 3c]
dddocky: checks 
yairpinto: bets 354
dddocky: folds 
Uncalled bet (354) returned to yairpinto
yairpinto collected 709 from pot
yairpinto: doesn't show hand 
*** SUMMARY ***
Total pot 750 | Rake 41 
Board [Kh 3s 3c]
Seat 1: color_singleton folded before Flop (didn't bet)
Seat 2: yairpinto (button) collected (709)
Seat 3: Duke Croix (small blind) folded before Flop
Seat 4: rogierk449 (big blind) folded before Flop
Seat 9: dddocky folded on the Flop



PokerStars Home Game Hand #216953425923: {Club #3225207}  Hold'em No Limit (50/100) - 2020/07/30 16:06:20 ET
Table 'JansPokergame' 9-max (Play Money) Seat #3 is the button
Seat 1: color_singleton (5874 in chips) 
Seat 2: yairpinto (20478 in chips) 
Seat 3: Duke Croix (12839 in chips) 
Seat 4: rogierk449 (17941 in chips) 
Seat 9: dddocky (4636 in chips) 
rogierk449: posts small blind 50
dddocky: posts big blind 100
*** HOLE CARDS ***
Dealt to Duke Croix [6c 6s]
color_singleton: raises 100 to 200
yairpinto: calls 200
Duke Croix: calls 200
rogierk449: calls 150
dddocky: calls 100
*** FLOP *** [4h As Kd]
rogierk449: checks 
dddocky: checks 
color_singleton: checks 
yairpinto: checks 
Duke Croix: checks 
*** TURN *** [4h As Kd] [3c]
rogierk449: checks 
dddocky: checks 
color_singleton: checks 
yairpinto: bets 472
Duke Croix: folds 
rogierk449: folds 
dddocky: folds 
color_singleton: calls 472
*** RIVER *** [4h As Kd 3c] [9c]
color_singleton: checks 
yairpinto: bets 918
color_singleton: folds 
Uncalled bet (918) returned to yairpinto
yairpinto collected 1837 from pot
yairpinto: doesn't show hand 
*** SUMMARY ***
Total pot 1944 | Rake 107 
Board [4h As Kd 3c 9c]
Seat 1: color_singleton folded on the River
Seat 2: yairpinto collected (1837)
Seat 3: Duke Croix (button) folded on the Turn
Seat 4: rogierk449 (small blind) folded on the Turn
Seat 9: dddocky (big blind) folded on the Turn



PokerStars Home Game Hand #216953458063: {Club #3225207}  Hold'em No Limit (50/100) - 2020/07/30 16:07:14 ET
Table 'JansPokergame' 9-max (Play Money) Seat #4 is the button
Seat 1: color_singleton (5202 in chips) 
Seat 2: yairpinto (21643 in chips) 
Seat 3: Duke Croix (12639 in chips) 
Seat 4: rogierk449 (17741 in chips) 
Seat 9: dddocky (4436 in chips) 
dddocky: posts small blind 50
color_singleton: posts big blind 100
*** HOLE CARDS ***
Dealt to Duke Croix [5h 6h]
yairpinto: raises 200 to 300
Duke Croix: calls 300
rogierk449: folds 
dddocky: calls 250
color_singleton: folds 
*** FLOP *** [Qh 3h 5d]
dddocky: checks 
yairpinto: bets 472
Duke Croix: calls 472
dddocky: folds 
*** TURN *** [Qh 3h 5d] [Qs]
yairpinto: checks 
Duke Croix: bets 900
yairpinto: calls 900
*** RIVER *** [Qh 3h 5d Qs] [8h]
yairpinto: checks 
Duke Croix: bets 2000
yairpinto: folds 
Uncalled bet (2000) returned to Duke Croix
Duke Croix collected 3538 from pot
*** SUMMARY ***
Total pot 3744 | Rake 206 
Board [Qh 3h 5d Qs 8h]
Seat 1: color_singleton (big blind) folded before Flop
Seat 2: yairpinto folded on the River
Seat 3: Duke Croix collected (3538)
Seat 4: rogierk449 (button) folded before Flop (didn't bet)
Seat 9: dddocky (small blind) folded on the Flop



PokerStars Home Game Hand #216953483919: {Club #3225207}  Hold'em No Limit (50/100) - 2020/07/30 16:07:57 ET
Table 'JansPokergame' 9-max (Play Money) Seat #9 is the button
Seat 1: color_singleton (5102 in chips) 
Seat 2: yairpinto (19971 in chips) 
Seat 3: Duke Croix (14505 in chips) 
Seat 4: rogierk449 (17741 in chips) 
Seat 9: dddocky (4136 in chips) 
color_singleton: posts small blind 50
yairpinto: posts big blind 100
*** HOLE CARDS ***
Dealt to Duke Croix [3h 4c]
Duke Croix: folds 
rogierk449: folds 
dddocky: calls 100
color_singleton: calls 50
yairpinto: checks 
*** FLOP *** [Jc Ks 8d]
color_singleton: checks 
yairpinto: checks 
dddocky: checks 
*** TURN *** [Jc Ks 8d] [9h]
color_singleton: checks 
yairpinto: bets 141
dddocky: calls 141
color_singleton: calls 141
*** RIVER *** [Jc Ks 8d 9h] [2c]
color_singleton: checks 
yairpinto: bets 341
dddocky: folds 
color_singleton: folds 
Uncalled bet (341) returned to yairpinto
yairpinto collected 683 from pot
yairpinto: doesn't show hand 
*** SUMMARY ***
Total pot 723 | Rake 40 
Board [Jc Ks 8d 9h 2c]
Seat 1: color_singleton (small blind) folded on the River
Seat 2: yairpinto (big blind) collected (683)
Seat 3: Duke Croix folded before Flop (didn't bet)
Seat 4: rogierk449 folded before Flop (didn't bet)
Seat 9: dddocky (button) folded on the River



PokerStars Home Game Hand #216953506679: {Club #3225207}  Hold'em No Limit (50/100) - 2020/07/30 16:08:35 ET
Table 'JansPokergame' 9-max (Play Money) Seat #1 is the button
Seat 1: color_singleton (4861 in chips) 
Seat 2: yairpinto (20413 in chips) 
Seat 3: Duke Croix (14505 in chips) 
Seat 4: rogierk449 (17741 in chips) 
Seat 8: Manon947 (7160 in chips) 
Seat 9: dddocky (3895 in chips) 
yairpinto: posts small blind 50
Duke Croix: posts big blind 100
Manon947: posts small & big blinds 150
*** HOLE CARDS ***
Dealt to Duke Croix [4h 7s]
rogierk449: folds 
Manon947: checks 
dddocky: calls 100
color_singleton: raises 100 to 200
yairpinto: folds 
Duke Croix: calls 100
Manon947: calls 100
dddocky: calls 100
*** FLOP *** [7h Ad 9d]
Duke Croix: checks 
Manon947: checks 
dddocky: checks 
color_singleton: bets 500
Duke Croix: folds 
Manon947: folds 
dddocky: folds 
Uncalled bet (500) returned to color_singleton
color_singleton collected 850 from pot
color_singleton: doesn't show hand 
*** SUMMARY ***
Total pot 900 | Rake 50 
Board [7h Ad 9d]
Seat 1: color_singleton (button) collected (850)
Seat 2: yairpinto (small blind) folded before Flop
Seat 3: Duke Croix (big blind) folded on the Flop
Seat 4: rogierk449 folded before Flop (didn't bet)
Seat 8: Manon947 folded on the Flop
Seat 9: dddocky folded on the Flop



PokerStars Home Game Hand #216953536587: {Club #3225207}  Hold'em No Limit (50/100) - 2020/07/30 16:09:26 ET
Table 'JansPokergame' 9-max (Play Money) Seat #2 is the button
Seat 1: color_singleton (5511 in chips) 
Seat 2: yairpinto (20363 in chips) 
Seat 3: Duke Croix (14305 in chips) 
Seat 4: rogierk449 (17741 in chips) 
Seat 8: Manon947 (6910 in chips) 
Seat 9: dddocky (3695 in chips) 
Duke Croix: posts small blind 50
rogierk449: posts big blind 100
*** HOLE CARDS ***
Dealt to Duke Croix [Qh 5h]
Manon947: calls 100
dddocky: calls 100
color_singleton: folds 
yairpinto: calls 100
Duke Croix: calls 50
rogierk449: checks 
*** FLOP *** [8h 2c 7s]
Duke Croix: checks 
rogierk449: checks 
Manon947: checks 
dddocky: checks 
yairpinto: bets 236
Duke Croix: folds 
rogierk449: calls 236
Manon947: folds 
dddocky: folds 
*** TURN *** [8h 2c 7s] [Th]
rogierk449: checks 
yairpinto: bets 459
rogierk449: calls 459
*** RIVER *** [8h 2c 7s Th] [8s]
rogierk449: checks 
yairpinto: bets 893
rogierk449: calls 893
*** SHOW DOWN ***
yairpinto: shows [9h Tc] (two pair, Tens and Eights)
rogierk449: mucks hand 
yairpinto collected 3474 from pot
*** SUMMARY ***
Total pot 3676 | Rake 202 
Board [8h 2c 7s Th 8s]
Seat 1: color_singleton folded before Flop (didn't bet)
Seat 2: yairpinto (button) showed [9h Tc] and won (3474) with two pair, Tens and Eights
Seat 3: Duke Croix (small blind) folded on the Flop
Seat 4: rogierk449 (big blind) mucked [6d Ts]
Seat 8: Manon947 folded on the Flop
Seat 9: dddocky folded on the Flop



PokerStars Home Game Hand #216953579190: {Club #3225207}  Hold'em No Limit (50/100) - 2020/07/30 16:10:37 ET
Table 'JansPokergame' 9-max (Play Money) Seat #3 is the button
Seat 1: color_singleton (5511 in chips) 
Seat 2: yairpinto (22149 in chips) 
Seat 3: Duke Croix (14205 in chips) 
Seat 4: rogierk449 (16053 in chips) 
Seat 8: Manon947 (6810 in chips) 
Seat 9: dddocky (3595 in chips) 
rogierk449: posts small blind 50
Manon947: posts big blind 100
*** HOLE CARDS ***
Dealt to Duke Croix [Jd Tc]
dddocky: folds 
color_singleton: raises 100 to 200
yairpinto: folds 
Duke Croix: calls 200
rogierk449: calls 150
Manon947: folds 
*** FLOP *** [Ac 3s Ts]
rogierk449: checks 
color_singleton: bets 330
Duke Croix: calls 330
rogierk449: folds 
*** TURN *** [Ac 3s Ts] [9c]
color_singleton: bets 642
Duke Croix: calls 642
*** RIVER *** [Ac 3s Ts 9c] [4h]
color_singleton: checks 
Duke Croix: checks 
*** SHOW DOWN ***
color_singleton: shows [As 8c] (a pair of Aces)
Duke Croix: mucks hand 
color_singleton collected 2499 from pot
*** SUMMARY ***
Total pot 2644 | Rake 145 
Board [Ac 3s Ts 9c 4h]
Seat 1: color_singleton showed [As 8c] and won (2499) with a pair of Aces
Seat 2: yairpinto folded before Flop (didn't bet)
Seat 3: Duke Croix (button) mucked [Jd Tc]
Seat 4: rogierk449 (small blind) folded on the Flop
Seat 8: Manon947 (big blind) folded before Flop
Seat 9: dddocky folded before Flop (didn't bet)



PokerStars Home Game Hand #216953628911: {Club #3225207}  Hold'em No Limit (50/100) - 2020/07/30 16:11:49 ET
Table 'JansPokergame' 9-max (Play Money) Seat #4 is the button
Seat 1: color_singleton (6838 in chips) 
Seat 2: yairpinto (22149 in chips) 
Seat 3: Duke Croix (13033 in chips) 
Seat 4: rogierk449 (15853 in chips) 
Seat 8: Manon947 (6710 in chips) 
Seat 9: dddocky (3595 in chips) 
Manon947: posts small blind 50
dddocky: posts big blind 100
*** HOLE CARDS ***
Dealt to Duke Croix [8s Td]
color_singleton: folds 
yairpinto: folds 
Duke Croix: folds 
rogierk449: folds 
Manon947: calls 50
dddocky: checks 
*** FLOP *** [Ks 8h 7s]
Manon947: checks 
dddocky: checks 
*** TURN *** [Ks 8h 7s] [8c]
Manon947: checks 
dddocky: checks 
*** RIVER *** [Ks 8h 7s 8c] [Th]
Manon947: checks 
dddocky: checks 
*** SHOW DOWN ***
Manon947: shows [9c 3s] (a pair of Eights)
dddocky: shows [Qh 5s] (a pair of Eights - King+Queen kicker)
dddocky collected 189 from pot
*** SUMMARY ***
Total pot 200 | Rake 11 
Board [Ks 8h 7s 8c Th]
Seat 1: color_singleton folded before Flop (didn't bet)
Seat 2: yairpinto folded before Flop (didn't bet)
Seat 3: Duke Croix folded before Flop (didn't bet)
Seat 4: rogierk449 (button) folded before Flop (didn't bet)
Seat 8: Manon947 (small blind) showed [9c 3s] and lost with a pair of Eights
Seat 9: dddocky (big blind) showed [Qh 5s] and won (189) with a pair of Eights



PokerStars Home Game Hand #216953653219: {Club #3225207}  Hold'em No Limit (50/100) - 2020/07/30 16:12:30 ET
Table 'JansPokergame' 9-max (Play Money) Seat #8 is the button
Seat 1: color_singleton (6838 in chips) 
Seat 2: yairpinto (22149 in chips) 
Seat 3: Duke Croix (13033 in chips) 
Seat 4: rogierk449 (15853 in chips) 
Seat 8: Manon947 (6610 in chips) 
Seat 9: dddocky (3684 in chips) 
dddocky: posts small blind 50
color_singleton: posts big blind 100
*** HOLE CARDS ***
Dealt to Duke Croix [6h 7s]
yairpinto: folds 
Duke Croix: raises 200 to 300
rogierk449: folds 
Manon947: calls 300
dddocky: folds 
color_singleton: calls 200
*** FLOP *** [Jd 5d 2c]
color_singleton: checks 
Duke Croix: checks 
Manon947: checks 
*** TURN *** [Jd 5d 2c] [Qd]
color_singleton: bets 449
Duke Croix: folds 
Manon947: folds 
Uncalled bet (449) returned to color_singleton
color_singleton collected 898 from pot
color_singleton: doesn't show hand 
*** SUMMARY ***
Total pot 950 | Rake 52 
Board [Jd 5d 2c Qd]
Seat 1: color_singleton (big blind) collected (898)
Seat 2: yairpinto folded before Flop (didn't bet)
Seat 3: Duke Croix folded on the Turn
Seat 4: rogierk449 folded before Flop (didn't bet)
Seat 8: Manon947 (button) folded on the Turn
Seat 9: dddocky (small blind) folded before Flop



PokerStars Home Game Hand #216953676581: {Club #3225207}  Hold'em No Limit (50/100) - 2020/07/30 16:13:09 ET
Table 'JansPokergame' 9-max (Play Money) Seat #9 is the button
Seat 1: color_singleton (7436 in chips) 
Seat 2: yairpinto (22149 in chips) 
Seat 3: Duke Croix (12733 in chips) 
Seat 4: rogierk449 (15853 in chips) 
Seat 8: Manon947 (6310 in chips) 
Seat 9: dddocky (3634 in chips) 
color_singleton: posts small blind 50
yairpinto: posts big blind 100
*** HOLE CARDS ***
Dealt to Duke Croix [4s Ts]
Duke Croix: folds 
rogierk449: raises 100 to 200
Manon947: calls 200
dddocky: raises 100 to 300
color_singleton: folds 
yairpinto: folds 
rogierk449: calls 100
Manon947: calls 100
*** FLOP *** [Qc 5h Jc]
rogierk449: checks 
Manon947: bets 496
dddocky: calls 496
rogierk449: folds 
*** TURN *** [Qc 5h Jc] [Kc]
Manon947: bets 965
dddocky: calls 965
*** RIVER *** [Qc 5h Jc Kc] [Ks]
Manon947: checks 
dddocky: bets 1873 and is all-in
Manon947: calls 1873
*** SHOW DOWN ***
dddocky: shows [Ad Ac] (two pair, Aces and Kings)
Manon947: shows [Js Qs] (two pair, Kings and Queens)
dddocky collected 7294 from pot
*** SUMMARY ***
Total pot 7718 | Rake 424 
Board [Qc 5h Jc Kc Ks]
Seat 1: color_singleton (small blind) folded before Flop
Seat 2: yairpinto (big blind) folded before Flop
Seat 3: Duke Croix folded before Flop (didn't bet)
Seat 4: rogierk449 folded on the Flop
Seat 8: Manon947 showed [Js Qs] and lost with two pair, Kings and Queens
Seat 9: dddocky (button) showed [Ad Ac] and won (7294) with two pair, Aces and Kings



PokerStars Home Game Hand #216953711339: {Club #3225207}  Hold'em No Limit (50/100) - 2020/07/30 16:14:07 ET
Table 'JansPokergame' 9-max (Play Money) Seat #1 is the button
Seat 1: color_singleton (7386 in chips) 
Seat 2: yairpinto (22049 in chips) 
Seat 3: Duke Croix (12733 in chips) 
Seat 4: rogierk449 (15553 in chips) 
Seat 8: Manon947 (2676 in chips) 
Seat 9: dddocky (7294 in chips) 
yairpinto: posts small blind 50
Duke Croix: posts big blind 100
*** HOLE CARDS ***
Dealt to Duke Croix [Qd 2s]
rogierk449: folds 
Manon947: folds 
dddocky: folds 
color_singleton: raises 200 to 300
yairpinto: folds 
Duke Croix: calls 200
*** FLOP *** [Qs Ad 2c]
Duke Croix: bets 400
color_singleton: calls 400
*** TURN *** [Qs Ad 2c] [3c]
Duke Croix: bets 800
color_singleton: calls 800
*** RIVER *** [Qs Ad 2c 3c] [Jd]
Duke Croix: bets 1600
color_singleton: folds 
Uncalled bet (1600) returned to Duke Croix
Duke Croix collected 2882 from pot
*** SUMMARY ***
Total pot 3050 | Rake 168 
Board [Qs Ad 2c 3c Jd]
Seat 1: color_singleton (button) folded on the River
Seat 2: yairpinto (small blind) folded before Flop
Seat 3: Duke Croix (big blind) collected (2882)
Seat 4: rogierk449 folded before Flop (didn't bet)
Seat 8: Manon947 folded before Flop (didn't bet)
Seat 9: dddocky folded before Flop (didn't bet)



PokerStars Home Game Hand #216953745205: {Club #3225207}  Hold'em No Limit (50/100) - 2020/07/30 16:15:03 ET
Table 'JansPokergame' 9-max (Play Money) Seat #2 is the button
Seat 1: color_singleton (5886 in chips) 
Seat 2: yairpinto (21999 in chips) 
Seat 3: Duke Croix (14115 in chips) 
Seat 4: rogierk449 (15553 in chips) 
Seat 8: Manon947 (2676 in chips) 
Seat 9: dddocky (7294 in chips) 
Duke Croix: posts small blind 50
rogierk449: posts big blind 100
*** HOLE CARDS ***
Dealt to Duke Croix [8d Jc]
Manon947: calls 100
dddocky: calls 100
color_singleton: calls 100
yairpinto: calls 100
Duke Croix: calls 50
rogierk449: checks 
*** FLOP *** [6s 4d Js]
Duke Croix: bets 300
rogierk449: calls 300
Manon947: calls 300
dddocky: folds 
color_singleton: folds 
yairpinto: calls 300
*** TURN *** [6s 4d Js] [4c]
Duke Croix: bets 700
rogierk449: folds 
Manon947: folds 
yairpinto: folds 
Uncalled bet (700) returned to Duke Croix
Duke Croix collected 1701 from pot
*** SUMMARY ***
Total pot 1800 | Rake 99 
Board [6s 4d Js 4c]
Seat 1: color_singleton folded on the Flop
Seat 2: yairpinto (button) folded on the Turn
Seat 3: Duke Croix (small blind) collected (1701)
Seat 4: rogierk449 (big blind) folded on the Turn
Seat 8: Manon947 folded on the Turn
Seat 9: dddocky folded on the Flop



PokerStars Home Game Hand #216953772468: {Club #3225207}  Hold'em No Limit (50/100) - 2020/07/30 16:15:47 ET
Table 'JansPokergame' 9-max (Play Money) Seat #3 is the button
Seat 1: color_singleton (5786 in chips) 
Seat 2: yairpinto (21599 in chips) 
Seat 3: Duke Croix (15416 in chips) 
Seat 4: rogierk449 (15153 in chips) 
Seat 8: Manon947 (2276 in chips) 
Seat 9: dddocky (7194 in chips) 
rogierk449: posts small blind 50
Manon947: posts big blind 100
*** HOLE CARDS ***
Dealt to Duke Croix [Tc 5d]
dddocky: folds 
color_singleton: folds 
yairpinto: raises 200 to 300
Duke Croix: folds 
rogierk449: folds 
Manon947: folds 
Uncalled bet (200) returned to yairpinto
yairpinto collected 250 from pot
yairpinto: doesn't show hand 
*** SUMMARY ***
Total pot 250 | Rake 0 
Seat 1: color_singleton folded before Flop (didn't bet)
Seat 2: yairpinto collected (250)
Seat 3: Duke Croix (button) folded before Flop (didn't bet)
Seat 4: rogierk449 (small blind) folded before Flop
Seat 8: Manon947 (big blind) folded before Flop
Seat 9: dddocky folded before Flop (didn't bet)



PokerStars Home Game Hand #216953779340: {Club #3225207}  Hold'em No Limit (50/100) - 2020/07/30 16:15:58 ET
Table 'JansPokergame' 9-max (Play Money) Seat #4 is the button
Seat 1: color_singleton (5786 in chips) 
Seat 2: yairpinto (21749 in chips) 
Seat 3: Duke Croix (15416 in chips) 
Seat 4: rogierk449 (15103 in chips) 
Seat 8: Manon947 (2176 in chips) 
Seat 9: dddocky (7194 in chips) 
Manon947: posts small blind 50
dddocky: posts big blind 100
*** HOLE CARDS ***
Dealt to Duke Croix [Jh 9d]
color_singleton: folds 
yairpinto: calls 100
Duke Croix: folds 
rogierk449: folds 
Manon947: calls 50
dddocky: checks 
*** FLOP *** [3d 2c 4c]
Manon947: checks 
dddocky: checks 
yairpinto: bets 141
Manon947: calls 141
dddocky: calls 141
*** TURN *** [3d 2c 4c] [8d]
Manon947: checks 
dddocky: checks 
yairpinto: checks 
*** RIVER *** [3d 2c 4c 8d] [3h]
Manon947: checks 
dddocky: checks 
yairpinto: checks 
*** SHOW DOWN ***
Manon947: shows [5h 7h] (a pair of Threes)
dddocky: shows [Ad 2s] (two pair, Threes and Deuces)
yairpinto: mucks hand 
dddocky collected 683 from pot
*** SUMMARY ***
Total pot 723 | Rake 40 
Board [3d 2c 4c 8d 3h]
Seat 1: color_singleton folded before Flop (didn't bet)
Seat 2: yairpinto mucked [Jc Qc]
Seat 3: Duke Croix folded before Flop (didn't bet)
Seat 4: rogierk449 (button) folded before Flop (didn't bet)
Seat 8: Manon947 (small blind) showed [5h 7h] and lost with a pair of Threes
Seat 9: dddocky (big blind) showed [Ad 2s] and won (683) with two pair, Threes and Deuces



PokerStars Home Game Hand #216953804547: {Club #3225207}  Hold'em No Limit (50/100) - 2020/07/30 16:16:39 ET
Table 'JansPokergame' 9-max (Play Money) Seat #8 is the button
Seat 1: color_singleton (5786 in chips) 
Seat 2: yairpinto (21508 in chips) 
Seat 3: Duke Croix (15416 in chips) 
Seat 4: rogierk449 (15103 in chips) 
Seat 8: Manon947 (1935 in chips) 
Seat 9: dddocky (7636 in chips) 
dddocky: posts small blind 50
color_singleton: posts big blind 100
*** HOLE CARDS ***
Dealt to Duke Croix [8d 7c]
yairpinto: folds 
Duke Croix: calls 100
rogierk449: folds 
Manon947: calls 100
dddocky: calls 50
color_singleton: raises 200 to 300
Duke Croix: calls 200
Manon947: folds 
dddocky: calls 200
*** FLOP *** [Ks 4d 7h]
dddocky: checks 
color_singleton: bets 472
Duke Croix: calls 472
dddocky: folds 
*** TURN *** [Ks 4d 7h] [Kd]
color_singleton: bets 918
Duke Croix: folds 
Uncalled bet (918) returned to color_singleton
color_singleton collected 1837 from pot
color_singleton: doesn't show hand 
*** SUMMARY ***
Total pot 1944 | Rake 107 
Board [Ks 4d 7h Kd]
Seat 1: color_singleton (big blind) collected (1837)
Seat 2: yairpinto folded before Flop (didn't bet)
Seat 3: Duke Croix folded on the Turn
Seat 4: rogierk449 folded before Flop (didn't bet)
Seat 8: Manon947 (button) folded before Flop
Seat 9: dddocky (small blind) folded on the Flop



PokerStars Home Game Hand #216953829922: {Club #3225207}  Hold'em No Limit (50/100) - 2020/07/30 16:17:20 ET
Table 'JansPokergame' 9-max (Play Money) Seat #9 is the button
Seat 1: color_singleton (6851 in chips) 
Seat 2: yairpinto (21508 in chips) 
Seat 3: Duke Croix (14644 in chips) 
Seat 4: rogierk449 (15103 in chips) 
Seat 8: Manon947 (1835 in chips) 
Seat 9: dddocky (7336 in chips) 
color_singleton: posts small blind 50
yairpinto: posts big blind 100
*** HOLE CARDS ***
Dealt to Duke Croix [2d 9c]
Duke Croix: folds 
rogierk449: calls 100
Manon947: folds 
dddocky: calls 100
color_singleton: raises 100 to 200
yairpinto: calls 100
rogierk449: calls 100
dddocky: calls 100
*** FLOP *** [Qh Kc 5s]
color_singleton: checks 
yairpinto: checks 
rogierk449: checks 
dddocky: bets 756
color_singleton: folds 
yairpinto: folds 
rogierk449: folds 
Uncalled bet (756) returned to dddocky
dddocky collected 756 from pot
dddocky: doesn't show hand 
*** SUMMARY ***
Total pot 800 | Rake 44 
Board [Qh Kc 5s]
Seat 1: color_singleton (small blind) folded on the Flop
Seat 2: yairpinto (big blind) folded on the Flop
Seat 3: Duke Croix folded before Flop (didn't bet)
Seat 4: rogierk449 folded on the Flop
Seat 8: Manon947 folded before Flop (didn't bet)
Seat 9: dddocky (button) collected (756)



PokerStars Home Game Hand #216953868605: {Club #3225207}  Hold'em No Limit (50/100) - 2020/07/30 16:18:22 ET
Table 'JansPokergame' 9-max (Play Money) Seat #1 is the button
Seat 1: color_singleton (6651 in chips) 
Seat 2: yairpinto (21308 in chips) 
Seat 3: Duke Croix (14644 in chips) 
Seat 4: rogierk449 (14903 in chips) 
Seat 8: Manon947 (1835 in chips) 
Seat 9: dddocky (7892 in chips) 
yairpinto: posts small blind 50
Duke Croix: posts big blind 100
*** HOLE CARDS ***
Dealt to Duke Croix [4h 2d]
rogierk449: folds 
Manon947: calls 100
dddocky: folds 
color_singleton: folds 
yairpinto: calls 50
Duke Croix: checks 
*** FLOP *** [3c 4c 9s]
yairpinto: checks 
Duke Croix: checks 
Manon947: checks 
*** TURN *** [3c 4c 9s] [Kd]
yairpinto: bets 141
Duke Croix: folds 
Manon947: calls 141
*** RIVER *** [3c 4c 9s Kd] [8d]
yairpinto: bets 275
Manon947: folds 
Uncalled bet (275) returned to yairpinto
yairpinto collected 550 from pot
yairpinto: doesn't show hand 
*** SUMMARY ***
Total pot 582 | Rake 32 
Board [3c 4c 9s Kd 8d]
Seat 1: color_singleton (button) folded before Flop (didn't bet)
Seat 2: yairpinto (small blind) collected (550)
Seat 3: Duke Croix (big blind) folded on the Turn
Seat 4: rogierk449 folded before Flop (didn't bet)
Seat 8: Manon947 folded on the River
Seat 9: dddocky folded before Flop (didn't bet)



PokerStars Home Game Hand #216953895497: {Club #3225207}  Hold'em No Limit (50/100) - 2020/07/30 16:19:05 ET
Table 'JansPokergame' 9-max (Play Money) Seat #2 is the button
Seat 1: color_singleton (6651 in chips) 
Seat 2: yairpinto (21617 in chips) 
Seat 3: Duke Croix (14544 in chips) 
Seat 4: rogierk449 (14903 in chips) 
Seat 8: Manon947 (1594 in chips) 
Seat 9: dddocky (7892 in chips) 
Duke Croix: posts small blind 50
rogierk449: posts big blind 100
*** HOLE CARDS ***
Dealt to Duke Croix [4c Qs]
Manon947: calls 100
dddocky: calls 100
color_singleton: raises 200 to 300
yairpinto: folds 
Duke Croix: folds 
rogierk449: calls 200
Manon947: calls 200
dddocky: calls 200
*** FLOP *** [6d Td 2s]
rogierk449: checks 
Manon947: checks 
dddocky: checks 
color_singleton: checks 
*** TURN *** [6d Td 2s] [Ah]
rogierk449: checks 
Manon947: checks 
dddocky: checks 
color_singleton: checks 
*** RIVER *** [6d Td 2s Ah] [7d]
rogierk449: bets 590
Manon947: folds 
dddocky: folds 
color_singleton: folds 
Uncalled bet (590) returned to rogierk449
rogierk449 collected 1181 from pot
rogierk449: doesn't show hand 
*** SUMMARY ***
Total pot 1250 | Rake 69 
Board [6d Td 2s Ah 7d]
Seat 1: color_singleton folded on the River
Seat 2: yairpinto (button) folded before Flop (didn't bet)
Seat 3: Duke Croix (small blind) folded before Flop
Seat 4: rogierk449 (big blind) collected (1181)
Seat 8: Manon947 folded on the River
Seat 9: dddocky folded on the River



PokerStars Home Game Hand #216953937452: {Club #3225207}  Hold'em No Limit (50/100) - 2020/07/30 16:20:12 ET
Table 'JansPokergame' 9-max (Play Money) Seat #3 is the button
Seat 1: color_singleton (6351 in chips) 
Seat 2: yairpinto (21617 in chips) 
Seat 3: Duke Croix (14494 in chips) 
Seat 4: rogierk449 (15784 in chips) 
Seat 8: Manon947 (1294 in chips) 
Seat 9: dddocky (7592 in chips) 
rogierk449: posts small blind 50
Manon947: posts big blind 100
*** HOLE CARDS ***
Dealt to Duke Croix [Ts Th]
dddocky: calls 100
color_singleton: folds 
yairpinto: raises 200 to 300
Duke Croix: raises 400 to 700
rogierk449: folds 
Manon947: folds 
dddocky: folds 
yairpinto: folds 
Uncalled bet (400) returned to Duke Croix
Duke Croix collected 850 from pot
*** SUMMARY ***
Total pot 850 | Rake 0 
Seat 1: color_singleton folded before Flop (didn't bet)
Seat 2: yairpinto folded before Flop
Seat 3: Duke Croix (button) collected (850)
Seat 4: rogierk449 (small blind) folded before Flop
Seat 8: Manon947 (big blind) folded before Flop
Seat 9: dddocky folded before Flop



PokerStars Home Game Hand #216953949216: {Club #3225207}  Hold'em No Limit (50/100) - 2020/07/30 16:20:31 ET
Table 'JansPokergame' 9-max (Play Money) Seat #4 is the button
Seat 1: color_singleton (6351 in chips) 
Seat 2: yairpinto (21317 in chips) 
Seat 3: Duke Croix (15044 in chips) 
Seat 4: rogierk449 (15734 in chips) 
Seat 8: Manon947 (1194 in chips) 
Seat 9: dddocky (7492 in chips) 
Manon947: posts small blind 50
dddocky: posts big blind 100
*** HOLE CARDS ***
Dealt to Duke Croix [9s 6c]
color_singleton: raises 100 to 200
yairpinto: calls 200
Duke Croix: folds 
rogierk449: calls 200
Manon947: folds 
dddocky: calls 100
*** FLOP *** [7h Qh 5h]
dddocky: checks 
color_singleton: checks 
yairpinto: bets 401
rogierk449: folds 
dddocky: folds 
color_singleton: folds 
Uncalled bet (401) returned to yairpinto
yairpinto collected 803 from pot
yairpinto: doesn't show hand 
*** SUMMARY ***
Total pot 850 | Rake 47 
Board [7h Qh 5h]
Seat 1: color_singleton folded on the Flop
Seat 2: yairpinto collected (803)
Seat 3: Duke Croix folded before Flop (didn't bet)
Seat 4: rogierk449 (button) folded on the Flop
Seat 8: Manon947 (small blind) folded before Flop
Seat 9: dddocky (big blind) folded on the Flop



PokerStars Home Game Hand #216953974016: {Club #3225207}  Hold'em No Limit (50/100) - 2020/07/30 16:21:11 ET
Table 'JansPokergame' 9-max (Play Money) Seat #8 is the button
Seat 1: color_singleton (6151 in chips) 
Seat 2: yairpinto (21920 in chips) 
Seat 3: Duke Croix (15044 in chips) 
Seat 4: rogierk449 (15534 in chips) 
Seat 8: Manon947 (1144 in chips) 
Seat 9: dddocky (7292 in chips) 
dddocky: posts small blind 50
color_singleton: posts big blind 100
*** HOLE CARDS ***
Dealt to Duke Croix [Qh Th]
yairpinto: folds 
Duke Croix: raises 200 to 300
rogierk449: folds 
Manon947: folds 
dddocky: calls 250
color_singleton: calls 200
*** FLOP *** [Jd Kh 6s]
dddocky: bets 100
color_singleton: calls 100
Duke Croix: raises 400 to 500
dddocky: raises 400 to 900
color_singleton: folds 
Duke Croix: calls 400
*** TURN *** [Jd Kh 6s] [Kd]
dddocky: bets 100
Duke Croix: calls 100
*** RIVER *** [Jd Kh 6s Kd] [4d]
dddocky: bets 5992 and is all-in
Duke Croix: folds 
Uncalled bet (5992) returned to dddocky
dddocky collected 2835 from pot
dddocky: doesn't show hand 
*** SUMMARY ***
Total pot 3000 | Rake 165 
Board [Jd Kh 6s Kd 4d]
Seat 1: color_singleton (big blind) folded on the Flop
Seat 2: yairpinto folded before Flop (didn't bet)
Seat 3: Duke Croix folded on the River
Seat 4: rogierk449 folded before Flop (didn't bet)
Seat 8: Manon947 (button) folded before Flop (didn't bet)
Seat 9: dddocky (small blind) collected (2835)



PokerStars Home Game Hand #216954020386: {Club #3225207}  Hold'em No Limit (50/100) - 2020/07/30 16:22:21 ET
Table 'JansPokergame' 9-max (Play Money) Seat #9 is the button
Seat 1: color_singleton (5751 in chips) 
Seat 2: yairpinto (21920 in chips) 
Seat 3: Duke Croix (13744 in chips) 
Seat 4: rogierk449 (15534 in chips) 
Seat 8: Manon947 (1144 in chips) 
Seat 9: dddocky (8827 in chips) 
color_singleton: posts small blind 50
yairpinto: posts big blind 100
*** HOLE CARDS ***
Dealt to Duke Croix [4s 5s]
Duke Croix: folds 
rogierk449: raises 200 to 300
Manon947: calls 300
dddocky: folds 
color_singleton: folds 
yairpinto: calls 200
*** FLOP *** [4d Js 9h]
yairpinto: checks 
rogierk449: bets 200
Manon947: calls 200
yairpinto: folds 
*** TURN *** [4d Js 9h] [6d]
rogierk449: checks 
Manon947: checks 
*** RIVER *** [4d Js 9h 6d] [5c]
rogierk449: checks 
Manon947: checks 
*** SHOW DOWN ***
rogierk449: shows [Kh Qs] (high card King)
Manon947: mucks hand 
rogierk449 collected 1276 from pot
*** SUMMARY ***
Total pot 1350 | Rake 74 
Board [4d Js 9h 6d 5c]
Seat 1: color_singleton (small blind) folded before Flop
Seat 2: yairpinto (big blind) folded on the Flop
Seat 3: Duke Croix folded before Flop (didn't bet)
Seat 4: rogierk449 showed [Kh Qs] and won (1276) with high card King
Seat 8: Manon947 mucked [Td Qd]
Seat 9: dddocky (button) folded before Flop (didn't bet)



PokerStars Home Game Hand #216954062290: {Club #3225207}  Hold'em No Limit (50/100) - 2020/07/30 16:23:28 ET
Table 'JansPokergame' 9-max (Play Money) Seat #1 is the button
Seat 1: color_singleton (5701 in chips) 
Seat 2: yairpinto (21620 in chips) 
Seat 3: Duke Croix (13744 in chips) 
Seat 4: rogierk449 (16310 in chips) 
Seat 8: Manon947 (644 in chips) 
Seat 9: dddocky (8827 in chips) 
yairpinto: posts small blind 50
Duke Croix: posts big blind 100
*** HOLE CARDS ***
Dealt to Duke Croix [9h 9d]
rogierk449: calls 100
Manon947: calls 100
dddocky: calls 100
color_singleton: calls 100
yairpinto: calls 50
Duke Croix: raises 600 to 700
rogierk449: folds 
Manon947: folds 
dddocky: folds 
color_singleton: folds 
yairpinto: folds 
Uncalled bet (600) returned to Duke Croix
Duke Croix collected 600 from pot
*** SUMMARY ***
Total pot 600 | Rake 0 
Seat 1: color_singleton (button) folded before Flop
Seat 2: yairpinto (small blind) folded before Flop
Seat 3: Duke Croix (big blind) collected (600)
Seat 4: rogierk449 folded before Flop
Seat 8: Manon947 folded before Flop
Seat 9: dddocky folded before Flop



PokerStars Home Game Hand #216954079256: {Club #3225207}  Hold'em No Limit (50/100) - 2020/07/30 16:23:56 ET
Table 'JansPokergame' 9-max (Play Money) Seat #2 is the button
Seat 1: color_singleton (5601 in chips) 
Seat 2: yairpinto (21520 in chips) 
Seat 3: Duke Croix (14244 in chips) 
Seat 4: rogierk449 (16210 in chips) 
Seat 8: Manon947 (544 in chips) 
Seat 9: dddocky (8727 in chips) 
Duke Croix: posts small blind 50
rogierk449: posts big blind 100
*** HOLE CARDS ***
Dealt to Duke Croix [8h 3h]
Manon947: folds 
dddocky: folds 
color_singleton: raises 200 to 300
yairpinto: folds 
Duke Croix: folds 
rogierk449: calls 200
*** FLOP *** [9d 2s 9c]
rogierk449: checks 
color_singleton: bets 307
rogierk449: folds 
Uncalled bet (307) returned to color_singleton
color_singleton collected 614 from pot
color_singleton: doesn't show hand 
*** SUMMARY ***
Total pot 650 | Rake 36 
Board [9d 2s 9c]
Seat 1: color_singleton collected (614)
Seat 2: yairpinto (button) folded before Flop (didn't bet)
Seat 3: Duke Croix (small blind) folded before Flop
Seat 4: rogierk449 (big blind) folded on the Flop
Seat 8: Manon947 folded before Flop (didn't bet)
Seat 9: dddocky folded before Flop (didn't bet)



PokerStars Home Game Hand #216954092395: {Club #3225207}  Hold'em No Limit (50/100) - 2020/07/30 16:24:17 ET
Table 'JansPokergame' 9-max (Play Money) Seat #3 is the button
Seat 1: color_singleton (5915 in chips) 
Seat 2: yairpinto (21520 in chips) 
Seat 3: Duke Croix (14194 in chips) 
Seat 4: rogierk449 (15910 in chips) 
Seat 8: Manon947 (544 in chips) 
Seat 9: dddocky (8727 in chips) 
rogierk449: posts small blind 50
Manon947: posts big blind 100
*** HOLE CARDS ***
Dealt to Duke Croix [Th 7h]
dddocky: folds 
color_singleton: folds 
yairpinto: raises 200 to 300
Duke Croix: folds 
rogierk449: folds 
Manon947: folds 
Uncalled bet (200) returned to yairpinto
yairpinto collected 250 from pot
yairpinto: doesn't show hand 
*** SUMMARY ***
Total pot 250 | Rake 0 
Seat 1: color_singleton folded before Flop (didn't bet)
Seat 2: yairpinto collected (250)
Seat 3: Duke Croix (button) folded before Flop (didn't bet)
Seat 4: rogierk449 (small blind) folded before Flop
Seat 8: Manon947 (big blind) folded before Flop
Seat 9: dddocky folded before Flop (didn't bet)



PokerStars Home Game Hand #216954102180: {Club #3225207}  Hold'em No Limit (50/100) - 2020/07/30 16:24:33 ET
Table 'JansPokergame' 9-max (Play Money) Seat #4 is the button
Seat 1: color_singleton (5915 in chips) 
Seat 2: yairpinto (21670 in chips) 
Seat 3: Duke Croix (14194 in chips) 
Seat 4: rogierk449 (15860 in chips) 
Seat 8: Manon947 (444 in chips) 
Seat 9: dddocky (8727 in chips) 
Manon947: posts small blind 50
dddocky: posts big blind 100
*** HOLE CARDS ***
Dealt to Duke Croix [As Ad]
color_singleton: folds 
yairpinto: calls 100
Duke Croix: raises 400 to 500
rogierk449: calls 500
Manon947: calls 394 and is all-in
dddocky: folds 
yairpinto: folds 
*** FLOP *** [9d 6d 8d]
Duke Croix: checks 
rogierk449: bets 777
Duke Croix: calls 777
*** TURN *** [9d 6d 8d] [6c]
Duke Croix: bets 900
rogierk449: calls 900
*** RIVER *** [9d 6d 8d 6c] [Kh]
Duke Croix: bets 1900
rogierk449: folds 
Uncalled bet (1900) returned to Duke Croix
*** SHOW DOWN ***
Duke Croix: shows [As Ad] (two pair, Aces and Sixes)
Duke Croix collected 3275 from side pot
Manon947: shows [6h Ac] (three of a kind, Sixes)
Manon947 collected 1448 from main pot
*** SUMMARY ***
Total pot 4998 Main pot 1448. Side pot 3275. | Rake 275 
Board [9d 6d 8d 6c Kh]
Seat 1: color_singleton folded before Flop (didn't bet)
Seat 2: yairpinto folded before Flop
Seat 3: Duke Croix showed [As Ad] and won (3275) with two pair, Aces and Sixes
Seat 4: rogierk449 (button) folded on the River
Seat 8: Manon947 (small blind) showed [6h Ac] and won (1448) with three of a kind, Sixes
Seat 9: dddocky (big blind) folded before Flop



PokerStars Home Game Hand #216954134610: {Club #3225207}  Hold'em No Limit (50/100) - 2020/07/30 16:25:25 ET
Table 'JansPokergame' 9-max (Play Money) Seat #8 is the button
Seat 1: color_singleton (5915 in chips) 
Seat 2: yairpinto (21570 in chips) 
Seat 3: Duke Croix (15292 in chips) 
Seat 4: rogierk449 (13683 in chips) 
Seat 8: Manon947 (1448 in chips) 
color_singleton: posts small blind 50
yairpinto: posts big blind 100
*** HOLE CARDS ***
Dealt to Duke Croix [9c Ah]
Duke Croix: raises 300 to 400
rogierk449: calls 400
Manon947: calls 400
color_singleton: folds 
yairpinto: folds 
*** FLOP *** [7c 5d Qh]
Duke Croix: checks 
rogierk449: checks 
Manon947: bets 638
Duke Croix: folds 
rogierk449: folds 
Uncalled bet (638) returned to Manon947
Manon947 collected 1276 from pot
*** SUMMARY ***
Total pot 1350 | Rake 74 
Board [7c 5d Qh]
Seat 1: color_singleton (small blind) folded before Flop
Seat 2: yairpinto (big blind) folded before Flop
Seat 3: Duke Croix folded on the Flop
Seat 4: rogierk449 folded on the Flop
Seat 8: Manon947 (button) collected (1276)



PokerStars Home Game Hand #216954173600: {Club #3225207}  Hold'em No Limit (50/100) - 2020/07/30 16:26:28 ET
Table 'JansPokergame' 9-max (Play Money) Seat #1 is the button
Seat 1: color_singleton (5865 in chips) 
Seat 2: yairpinto (21470 in chips) 
Seat 3: Duke Croix (14892 in chips) 
Seat 4: rogierk449 (13283 in chips) 
Seat 8: Manon947 (2324 in chips) 
yairpinto: posts small blind 50
Duke Croix: posts big blind 100
*** HOLE CARDS ***
Dealt to Duke Croix [Ah Qs]
rogierk449: calls 100
Manon947: folds 
color_singleton: folds 
yairpinto: calls 50
Duke Croix: raises 400 to 500
rogierk449: folds 
yairpinto: folds 
Uncalled bet (400) returned to Duke Croix
Duke Croix collected 300 from pot
*** SUMMARY ***
Total pot 300 | Rake 0 
Seat 1: color_singleton (button) folded before Flop (didn't bet)
Seat 2: yairpinto (small blind) folded before Flop
Seat 3: Duke Croix (big blind) collected (300)
Seat 4: rogierk449 folded before Flop
Seat 8: Manon947 folded before Flop (didn't bet)



PokerStars Home Game Hand #216954187769: {Club #3225207}  Hold'em No Limit (50/100) - 2020/07/30 16:26:51 ET
Table 'JansPokergame' 9-max (Play Money) Seat #2 is the button
Seat 1: color_singleton (5865 in chips) 
Seat 2: yairpinto (21370 in chips) 
Seat 3: Duke Croix (15092 in chips) 
Seat 4: rogierk449 (13183 in chips) 
Seat 8: Manon947 (2324 in chips) 
Duke Croix: posts small blind 50
rogierk449: posts big blind 100
*** HOLE CARDS ***
Dealt to Duke Croix [7h Kc]
Manon947: calls 100
color_singleton: raises 200 to 300
yairpinto: folds 
Duke Croix: folds 
rogierk449: folds 
Manon947: calls 200
*** FLOP *** [8h 3c Jh]
Manon947: checks 
color_singleton: checks 
*** TURN *** [8h 3c Jh] [4d]
Manon947: checks 
color_singleton: checks 
*** RIVER *** [8h 3c Jh 4d] [Kd]
Manon947: bets 354
color_singleton: folds 
Uncalled bet (354) returned to Manon947
Manon947 collected 709 from pot
*** SUMMARY ***
Total pot 750 | Rake 41 
Board [8h 3c Jh 4d Kd]
Seat 1: color_singleton folded on the River
Seat 2: yairpinto (button) folded before Flop (didn't bet)
Seat 3: Duke Croix (small blind) folded before Flop
Seat 4: rogierk449 (big blind) folded before Flop
Seat 8: Manon947 collected (709)



PokerStars Home Game Hand #216954213465: {Club #3225207}  Hold'em No Limit (50/100) - 2020/07/30 16:27:33 ET
Table 'JansPokergame' 9-max (Play Money) Seat #3 is the button
Seat 1: color_singleton (5565 in chips) 
Seat 2: yairpinto (21370 in chips) 
Seat 3: Duke Croix (15042 in chips) 
Seat 4: rogierk449 (13083 in chips) 
Seat 8: Manon947 (2733 in chips) 
rogierk449: posts small blind 50
Manon947: posts big blind 100
*** HOLE CARDS ***
Dealt to Duke Croix [Td 6d]
color_singleton: folds 
yairpinto: raises 200 to 300
Duke Croix: folds 
rogierk449: calls 250
Manon947: folds 
*** FLOP *** [Ad Tc 9h]
rogierk449: checks 
yairpinto: bets 330
rogierk449: folds 
Uncalled bet (330) returned to yairpinto
yairpinto collected 661 from pot
yairpinto: doesn't show hand 
*** SUMMARY ***
Total pot 700 | Rake 39 
Board [Ad Tc 9h]
Seat 1: color_singleton folded before Flop (didn't bet)
Seat 2: yairpinto collected (661)
Seat 3: Duke Croix (button) folded before Flop (didn't bet)
Seat 4: rogierk449 (small blind) folded on the Flop
Seat 8: Manon947 (big blind) folded before Flop



PokerStars Home Game Hand #216954226890: {Club #3225207}  Hold'em No Limit (50/100) - 2020/07/30 16:27:54 ET
Table 'JansPokergame' 9-max (Play Money) Seat #4 is the button
Seat 1: color_singleton (5565 in chips) 
Seat 2: yairpinto (21731 in chips) 
Seat 3: Duke Croix (15042 in chips) 
Seat 4: rogierk449 (12783 in chips) 
Seat 8: Manon947 (2633 in chips) 
Manon947: posts small blind 50
color_singleton: posts big blind 100
*** HOLE CARDS ***
Dealt to Duke Croix [Ac As]
yairpinto: folds 
Duke Croix: raises 300 to 400
rogierk449: folds 
Manon947: folds 
color_singleton: folds 
Uncalled bet (300) returned to Duke Croix
Duke Croix collected 250 from pot
*** SUMMARY ***
Total pot 250 | Rake 0 
Seat 1: color_singleton (big blind) folded before Flop
Seat 2: yairpinto folded before Flop (didn't bet)
Seat 3: Duke Croix collected (250)
Seat 4: rogierk449 (button) folded before Flop (didn't bet)
Seat 8: Manon947 (small blind) folded before Flop



PokerStars Home Game Hand #216954234143: {Club #3225207}  Hold'em No Limit (50/100) - 2020/07/30 16:28:06 ET
Table 'JansPokergame' 9-max (Play Money) Seat #8 is the button
Seat 1: color_singleton (5465 in chips) 
Seat 2: yairpinto (21731 in chips) 
Seat 3: Duke Croix (15192 in chips) 
Seat 4: rogierk449 (12783 in chips) 
Seat 8: Manon947 (2583 in chips) 
color_singleton: posts small blind 50
yairpinto: posts big blind 100
*** HOLE CARDS ***
Dealt to Duke Croix [4d 3c]
Duke Croix: folds 
rogierk449: folds 
Manon947: calls 100
color_singleton: raises 200 to 300
yairpinto: folds 
Manon947: folds 
Uncalled bet (200) returned to color_singleton
color_singleton collected 300 from pot
color_singleton: doesn't show hand 
*** SUMMARY ***
Total pot 300 | Rake 0 
Seat 1: color_singleton (small blind) collected (300)
Seat 2: yairpinto (big blind) folded before Flop
Seat 3: Duke Croix folded before Flop (didn't bet)
Seat 4: rogierk449 folded before Flop (didn't bet)
Seat 8: Manon947 (button) folded before Flop



PokerStars Home Game Hand #216954247166: {Club #3225207}  Hold'em No Limit (50/100) - 2020/07/30 16:28:27 ET
Table 'JansPokergame' 9-max (Play Money) Seat #1 is the button
Seat 1: color_singleton (5665 in chips) 
Seat 2: yairpinto (21631 in chips) 
Seat 3: Duke Croix (15192 in chips) 
Seat 4: rogierk449 (12783 in chips) 
Seat 8: Manon947 (2483 in chips) 
yairpinto: posts small blind 50
Duke Croix: posts big blind 100
*** HOLE CARDS ***
Dealt to Duke Croix [Jc Kh]
rogierk449: calls 100
Manon947: folds 
color_singleton: folds 
yairpinto: calls 50
Duke Croix: raises 300 to 400
rogierk449: folds 
yairpinto: folds 
Uncalled bet (300) returned to Duke Croix
Duke Croix collected 300 from pot
*** SUMMARY ***
Total pot 300 | Rake 0 
Seat 1: color_singleton (button) folded before Flop (didn't bet)
Seat 2: yairpinto (small blind) folded before Flop
Seat 3: Duke Croix (big blind) collected (300)
Seat 4: rogierk449 folded before Flop
Seat 8: Manon947 folded before Flop (didn't bet)



PokerStars Home Game Hand #216954266742: {Club #3225207}  Hold'em No Limit (50/100) - 2020/07/30 16:28:59 ET
Table 'JansPokergame' 9-max (Play Money) Seat #2 is the button
Seat 1: color_singleton (5665 in chips) 
Seat 2: yairpinto (21531 in chips) 
Seat 3: Duke Croix (15392 in chips) 
Seat 4: rogierk449 (12683 in chips) 
Seat 8: Manon947 (2483 in chips) 
Seat 9: dddocky (8627 in chips) 
Duke Croix: posts small blind 50
rogierk449: posts big blind 100
dddocky: posts small & big blinds 150
*** HOLE CARDS ***
Dealt to Duke Croix [4c 8d]
Manon947: calls 100
dddocky: checks 
color_singleton: folds 
yairpinto: raises 200 to 300
Duke Croix: folds 
rogierk449: calls 200
Manon947: calls 200
dddocky: calls 200
*** FLOP *** [Td 4h 7h]
rogierk449: bets 614
Manon947: calls 614
dddocky: folds 
yairpinto: raises 3070 to 3684
rogierk449: raises 8699 to 12383 and is all-in
Manon947: folds 
yairpinto: calls 8699
*** TURN *** [Td 4h 7h] [3d]
*** RIVER *** [Td 4h 7h 3d] [Jh]
*** SHOW DOWN ***
rogierk449: shows [Th 9h] (a flush, Jack high)
yairpinto: shows [Tc Ts] (three of a kind, Tens)
rogierk449 collected 25213 from pot
*** SUMMARY ***
Total pot 26680 | Rake 1467 
Board [Td 4h 7h 3d Jh]
Seat 1: color_singleton folded before Flop (didn't bet)
Seat 2: yairpinto (button) showed [Tc Ts] and lost with three of a kind, Tens
Seat 3: Duke Croix (small blind) folded before Flop
Seat 4: rogierk449 (big blind) showed [Th 9h] and won (25213) with a flush, Jack high
Seat 8: Manon947 folded on the Flop
Seat 9: dddocky folded on the Flop



PokerStars Home Game Hand #216954299394: {Club #3225207}  Hold'em No Limit (50/100) - 2020/07/30 16:29:51 ET
Table 'JansPokergame' 9-max (Play Money) Seat #3 is the button
Seat 1: color_singleton (5665 in chips) 
Seat 2: yairpinto (8848 in chips) 
Seat 3: Duke Croix (15342 in chips) 
Seat 4: rogierk449 (25213 in chips) 
Seat 8: Manon947 (1569 in chips) 
Seat 9: dddocky (8277 in chips) 
rogierk449: posts small blind 50
Manon947: posts big blind 100
*** HOLE CARDS ***
Dealt to Duke Croix [5h 9c]
dddocky: calls 100
color_singleton: folds 
yairpinto: folds 
Duke Croix: folds 
rogierk449: folds 
Manon947: checks 
*** FLOP *** [5s As Kd]
Manon947: checks 
dddocky: checks 
*** TURN *** [5s As Kd] [Jh]
Manon947: checks 
dddocky: bets 100
Manon947: folds 
Uncalled bet (100) returned to dddocky
dddocky collected 236 from pot
dddocky: doesn't show hand 
*** SUMMARY ***
Total pot 250 | Rake 14 
Board [5s As Kd Jh]
Seat 1: color_singleton folded before Flop (didn't bet)
Seat 2: yairpinto folded before Flop (didn't bet)
Seat 3: Duke Croix (button) folded before Flop (didn't bet)
Seat 4: rogierk449 (small blind) folded before Flop
Seat 8: Manon947 (big blind) folded on the Turn
Seat 9: dddocky collected (236)



PokerStars Home Game Hand #216954326545: {Club #3225207}  Hold'em No Limit (50/100) - 2020/07/30 16:30:35 ET
Table 'JansPokergame' 9-max (Play Money) Seat #4 is the button
Seat 1: color_singleton (5665 in chips) 
Seat 2: yairpinto (8848 in chips) 
Seat 3: Duke Croix (15342 in chips) 
Seat 4: rogierk449 (25163 in chips) 
Seat 8: Manon947 (1469 in chips) 
Seat 9: dddocky (8413 in chips) 
Manon947: posts small blind 50
dddocky: posts big blind 100
*** HOLE CARDS ***
Dealt to Duke Croix [8h 3h]
color_singleton: raises 100 to 200
yairpinto: calls 200
Duke Croix: folds 
rogierk449: folds 
Manon947: folds 
dddocky: calls 100
*** FLOP *** [5s Qc 5h]
dddocky: checks 
color_singleton: bets 307
yairpinto: folds 
dddocky: calls 307
*** TURN *** [5s Qc 5h] [Ah]
dddocky: checks 
color_singleton: bets 597
dddocky: folds 
Uncalled bet (597) returned to color_singleton
color_singleton collected 1194 from pot
color_singleton: doesn't show hand 
*** SUMMARY ***
Total pot 1264 | Rake 70 
Board [5s Qc 5h Ah]
Seat 1: color_singleton collected (1194)
Seat 2: yairpinto folded on the Flop
Seat 3: Duke Croix folded before Flop (didn't bet)
Seat 4: rogierk449 (button) folded before Flop (didn't bet)
Seat 8: Manon947 (small blind) folded before Flop
Seat 9: dddocky (big blind) folded on the Turn



PokerStars Home Game Hand #216954353942: {Club #3225207}  Hold'em No Limit (50/100) - 2020/07/30 16:31:09 ET
Table 'JansPokergame' 9-max (Play Money) Seat #8 is the button
Seat 1: color_singleton (6352 in chips) 
Seat 2: yairpinto (8648 in chips) 
Seat 3: Duke Croix (15342 in chips) 
Seat 4: rogierk449 (25163 in chips) 
Seat 8: Manon947 (1419 in chips) 
Seat 9: dddocky (7906 in chips) 
dddocky: posts small blind 50
color_singleton: posts big blind 100
*** HOLE CARDS ***
Dealt to Duke Croix [Qs 5s]
yairpinto: folds 
Duke Croix: folds 
rogierk449: folds 
Manon947: calls 100
dddocky: folds 
color_singleton: checks 
*** FLOP *** [Js 7h Ks]
color_singleton: checks 
Manon947: bets 118
color_singleton: folds 
Uncalled bet (118) returned to Manon947
Manon947 collected 236 from pot
*** SUMMARY ***
Total pot 250 | Rake 14 
Board [Js 7h Ks]
Seat 1: color_singleton (big blind) folded on the Flop
Seat 2: yairpinto folded before Flop (didn't bet)
Seat 3: Duke Croix folded before Flop (didn't bet)
Seat 4: rogierk449 folded before Flop (didn't bet)
Seat 8: Manon947 (button) collected (236)
Seat 9: dddocky (small blind) folded before Flop



PokerStars Home Game Hand #216954367882: {Club #3225207}  Hold'em No Limit (50/100) - 2020/07/30 16:31:31 ET
Table 'JansPokergame' 9-max (Play Money) Seat #9 is the button
Seat 1: color_singleton (6252 in chips) 
Seat 2: yairpinto (8648 in chips) 
Seat 3: Duke Croix (15342 in chips) 
Seat 4: rogierk449 (25163 in chips) 
Seat 8: Manon947 (1555 in chips) 
Seat 9: dddocky (7856 in chips) 
color_singleton: posts small blind 50
yairpinto: posts big blind 100
*** HOLE CARDS ***
Dealt to Duke Croix [7s Ac]
Duke Croix: raises 200 to 300
rogierk449: calls 300
Manon947: folds 
dddocky: folds 
color_singleton: folds 
yairpinto: folds 
*** FLOP *** [4c Qh Ad]
Duke Croix: checks 
rogierk449: checks 
*** TURN *** [4c Qh Ad] [6d]
Duke Croix: bets 400
rogierk449: calls 400
*** RIVER *** [4c Qh Ad 6d] [8d]
Duke Croix: bets 700
rogierk449: folds 
Uncalled bet (700) returned to Duke Croix
Duke Croix collected 1465 from pot
*** SUMMARY ***
Total pot 1550 | Rake 85 
Board [4c Qh Ad 6d 8d]
Seat 1: color_singleton (small blind) folded before Flop
Seat 2: yairpinto (big blind) folded before Flop
Seat 3: Duke Croix collected (1465)
Seat 4: rogierk449 folded on the River
Seat 8: Manon947 folded before Flop (didn't bet)
Seat 9: dddocky (button) folded before Flop (didn't bet)



PokerStars Home Game Hand #216954395378: {Club #3225207}  Hold'em No Limit (50/100) - 2020/07/30 16:32:16 ET
Table 'JansPokergame' 9-max (Play Money) Seat #1 is the button
Seat 1: color_singleton (6202 in chips) 
Seat 2: yairpinto (8548 in chips) 
Seat 3: Duke Croix (16107 in chips) 
Seat 4: rogierk449 (24463 in chips) 
Seat 8: Manon947 (1555 in chips) 
Seat 9: dddocky (7856 in chips) 
yairpinto: posts small blind 50
Duke Croix: posts big blind 100
*** HOLE CARDS ***
Dealt to Duke Croix [4c 2s]
rogierk449: folds 
Manon947: calls 100
dddocky: calls 100
color_singleton: folds 
yairpinto: calls 50
Duke Croix: checks 
*** FLOP *** [9d 2h 9c]
yairpinto: checks 
Duke Croix: checks 
Manon947: checks 
dddocky: checks 
*** TURN *** [9d 2h 9c] [Kh]
yairpinto: checks 
Duke Croix: checks 
Manon947: checks 
dddocky: checks 
*** RIVER *** [9d 2h 9c Kh] [Kd]
yairpinto: checks 
Duke Croix: checks 
Manon947: bets 378
dddocky: calls 378
yairpinto: folds 
Duke Croix: folds 
*** SHOW DOWN ***
Manon947: shows [Ks Qh] (a full house, Kings full of Nines)
dddocky: mucks hand 
Manon947 collected 1092 from pot
*** SUMMARY ***
Total pot 1156 | Rake 64 
Board [9d 2h 9c Kh Kd]
Seat 1: color_singleton (button) folded before Flop (didn't bet)
Seat 2: yairpinto (small blind) folded on the River
Seat 3: Duke Croix (big blind) folded on the River
Seat 4: rogierk449 folded before Flop (didn't bet)
Seat 8: Manon947 showed [Ks Qh] and won (1092) with a full house, Kings full of Nines
Seat 9: dddocky mucked [Ac Js]



PokerStars Home Game Hand #216954432501: {Club #3225207}  Hold'em No Limit (50/100) - 2020/07/30 16:33:17 ET
Table 'JansPokergame' 9-max (Play Money) Seat #2 is the button
Seat 1: color_singleton (6202 in chips) 
Seat 2: yairpinto (8448 in chips) 
Seat 3: Duke Croix (16007 in chips) 
Seat 4: rogierk449 (24463 in chips) 
Seat 8: Manon947 (2169 in chips) 
Seat 9: dddocky (7378 in chips) 
Duke Croix: posts small blind 50
rogierk449: posts big blind 100
*** HOLE CARDS ***
Dealt to Duke Croix [3d Ad]
Manon947: folds 
dddocky: folds 
color_singleton: folds 
yairpinto: raises 200 to 300
Duke Croix: calls 250
rogierk449: folds 
*** FLOP *** [Tc Th Kd]
Duke Croix: checks 
yairpinto: bets 330
Duke Croix: folds 
Uncalled bet (330) returned to yairpinto
yairpinto collected 661 from pot
yairpinto: doesn't show hand 
*** SUMMARY ***
Total pot 700 | Rake 39 
Board [Tc Th Kd]
Seat 1: color_singleton folded before Flop (didn't bet)
Seat 2: yairpinto (button) collected (661)
Seat 3: Duke Croix (small blind) folded on the Flop
Seat 4: rogierk449 (big blind) folded before Flop
Seat 8: Manon947 folded before Flop (didn't bet)
Seat 9: dddocky folded before Flop (didn't bet)



PokerStars Home Game Hand #216954447829: {Club #3225207}  Hold'em No Limit (50/100) - 2020/07/30 16:33:42 ET
Table 'JansPokergame' 9-max (Play Money) Seat #3 is the button
Seat 1: color_singleton (6202 in chips) 
Seat 2: yairpinto (8809 in chips) 
Seat 3: Duke Croix (15707 in chips) 
Seat 4: rogierk449 (24363 in chips) 
Seat 8: Manon947 (2169 in chips) 
Seat 9: dddocky (7378 in chips) 
rogierk449: posts small blind 50
Manon947: posts big blind 100
*** HOLE CARDS ***
Dealt to Duke Croix [Kh 4h]
dddocky: folds 
color_singleton: folds 
yairpinto: folds 
Duke Croix: folds 
rogierk449: raises 300 to 400
Manon947: folds 
Uncalled bet (300) returned to rogierk449
rogierk449 collected 200 from pot
rogierk449: doesn't show hand 
*** SUMMARY ***
Total pot 200 | Rake 0 
Seat 1: color_singleton folded before Flop (didn't bet)
Seat 2: yairpinto folded before Flop (didn't bet)
Seat 3: Duke Croix (button) folded before Flop (didn't bet)
Seat 4: rogierk449 (small blind) collected (200)
Seat 8: Manon947 (big blind) folded before Flop
Seat 9: dddocky folded before Flop (didn't bet)



PokerStars Home Game Hand #216954457782: {Club #3225207}  Hold'em No Limit (50/100) - 2020/07/30 16:33:59 ET
Table 'JansPokergame' 9-max (Play Money) Seat #4 is the button
Seat 1: color_singleton (6202 in chips) 
Seat 2: yairpinto (8809 in chips) 
Seat 3: Duke Croix (15707 in chips) 
Seat 4: rogierk449 (24463 in chips) 
Seat 8: Manon947 (2069 in chips) 
Seat 9: dddocky (7378 in chips) 
Manon947: posts small blind 50
dddocky: posts big blind 100
*** HOLE CARDS ***
Dealt to Duke Croix [3h 5s]
color_singleton: raises 100 to 200
yairpinto: folds 
Duke Croix: folds 
rogierk449: folds 
Manon947: folds 
dddocky: folds 
Uncalled bet (100) returned to color_singleton
color_singleton collected 250 from pot
color_singleton: doesn't show hand 
*** SUMMARY ***
Total pot 250 | Rake 0 
Seat 1: color_singleton collected (250)
Seat 2: yairpinto folded before Flop (didn't bet)
Seat 3: Duke Croix folded before Flop (didn't bet)
Seat 4: rogierk449 (button) folded before Flop (didn't bet)
Seat 8: Manon947 (small blind) folded before Flop
Seat 9: dddocky (big blind) folded before Flop



PokerStars Home Game Hand #216954464140: {Club #3225207}  Hold'em No Limit (50/100) - 2020/07/30 16:34:09 ET
Table 'JansPokergame' 9-max (Play Money) Seat #8 is the button
Seat 1: color_singleton (6352 in chips) 
Seat 2: yairpinto (8809 in chips) 
Seat 3: Duke Croix (15707 in chips) 
Seat 4: rogierk449 (24463 in chips) 
Seat 8: Manon947 (2019 in chips) 
Seat 9: dddocky (7278 in chips) 
dddocky: posts small blind 50
color_singleton: posts big blind 100
*** HOLE CARDS ***
Dealt to Duke Croix [8h 4h]
yairpinto: raises 200 to 300
Duke Croix: folds 
rogierk449: folds 
Manon947: folds 
dddocky: folds 
color_singleton: folds 
Uncalled bet (200) returned to yairpinto
yairpinto collected 250 from pot
yairpinto: doesn't show hand 
*** SUMMARY ***
Total pot 250 | Rake 0 
Seat 1: color_singleton (big blind) folded before Flop
Seat 2: yairpinto collected (250)
Seat 3: Duke Croix folded before Flop (didn't bet)
Seat 4: rogierk449 folded before Flop (didn't bet)
Seat 8: Manon947 (button) folded before Flop (didn't bet)
Seat 9: dddocky (small blind) folded before Flop



PokerStars Home Game Hand #216954473890: {Club #3225207}  Hold'em No Limit (50/100) - 2020/07/30 16:34:25 ET
Table 'JansPokergame' 9-max (Play Money) Seat #9 is the button
Seat 1: color_singleton (6252 in chips) 
Seat 2: yairpinto (8959 in chips) 
Seat 3: Duke Croix (15707 in chips) 
Seat 4: rogierk449 (24463 in chips) 
Seat 8: Manon947 (2019 in chips) 
Seat 9: dddocky (7228 in chips) 
color_singleton: posts small blind 50
yairpinto: posts big blind 100
*** HOLE CARDS ***
Dealt to Duke Croix [Jd Qd]
Duke Croix: raises 300 to 400
rogierk449: folds 
Manon947: folds 
dddocky: folds 
color_singleton: folds 
yairpinto: folds 
Uncalled bet (300) returned to Duke Croix
Duke Croix collected 250 from pot
*** SUMMARY ***
Total pot 250 | Rake 0 
Seat 1: color_singleton (small blind) folded before Flop
Seat 2: yairpinto (big blind) folded before Flop
Seat 3: Duke Croix collected (250)
Seat 4: rogierk449 folded before Flop (didn't bet)
Seat 8: Manon947 folded before Flop (didn't bet)
Seat 9: dddocky (button) folded before Flop (didn't bet)



PokerStars Home Game Hand #216954484506: {Club #3225207}  Hold'em No Limit (50/100) - 2020/07/30 16:34:43 ET
Table 'JansPokergame' 9-max (Play Money) Seat #1 is the button
Seat 1: color_singleton (6202 in chips) 
Seat 2: yairpinto (8859 in chips) 
Seat 3: Duke Croix (15857 in chips) 
Seat 4: rogierk449 (24463 in chips) 
Seat 8: Manon947 (2019 in chips) 
Seat 9: dddocky (7228 in chips) 
yairpinto: posts small blind 50
Duke Croix: posts big blind 100
*** HOLE CARDS ***
Dealt to Duke Croix [As Qc]
rogierk449: folds 
Manon947: calls 100
dddocky: calls 100
color_singleton: folds 
yairpinto: calls 50
Duke Croix: raises 500 to 600
Manon947: folds 
dddocky: folds 
yairpinto: folds 
Uncalled bet (500) returned to Duke Croix
Duke Croix collected 400 from pot
*** SUMMARY ***
Total pot 400 | Rake 0 
Seat 1: color_singleton (button) folded before Flop (didn't bet)
Seat 2: yairpinto (small blind) folded before Flop
Seat 3: Duke Croix (big blind) collected (400)
Seat 4: rogierk449 folded before Flop (didn't bet)
Seat 8: Manon947 folded before Flop
Seat 9: dddocky folded before Flop



PokerStars Home Game Hand #216954497283: {Club #3225207}  Hold'em No Limit (50/100) - 2020/07/30 16:35:03 ET
Table 'JansPokergame' 9-max (Play Money) Seat #2 is the button
Seat 1: color_singleton (6202 in chips) 
Seat 2: yairpinto (8759 in chips) 
Seat 3: Duke Croix (16157 in chips) 
Seat 4: rogierk449 (24463 in chips) 
Seat 8: Manon947 (1919 in chips) 
Seat 9: dddocky (7128 in chips) 
Duke Croix: posts small blind 50
rogierk449: posts big blind 100
*** HOLE CARDS ***
Dealt to Duke Croix [Qc 7s]
Manon947: folds 
dddocky: folds 
color_singleton: folds 
yairpinto: raises 200 to 300
Duke Croix: folds 
rogierk449: calls 200
*** FLOP *** [Qh 8h 3s]
rogierk449: checks 
yairpinto: bets 307
rogierk449: folds 
Uncalled bet (307) returned to yairpinto
yairpinto collected 614 from pot
yairpinto: doesn't show hand 
*** SUMMARY ***
Total pot 650 | Rake 36 
Board [Qh 8h 3s]
Seat 1: color_singleton folded before Flop (didn't bet)
Seat 2: yairpinto (button) collected (614)
Seat 3: Duke Croix (small blind) folded before Flop
Seat 4: rogierk449 (big blind) folded on the Flop
Seat 8: Manon947 folded before Flop (didn't bet)
Seat 9: dddocky folded before Flop (didn't bet)



PokerStars Home Game Hand #216954518994: {Club #3225207}  Hold'em No Limit (50/100) - 2020/07/30 16:35:39 ET
Table 'JansPokergame' 9-max (Play Money) Seat #3 is the button
Seat 1: color_singleton (6202 in chips) 
Seat 2: yairpinto (9073 in chips) 
Seat 3: Duke Croix (16107 in chips) 
Seat 4: rogierk449 (24163 in chips) 
Seat 8: Manon947 (1919 in chips) 
Seat 9: dddocky (7128 in chips) 
rogierk449: posts small blind 50
Manon947: posts big blind 100
*** HOLE CARDS ***
Dealt to Duke Croix [Ah 6s]
dddocky: calls 100
color_singleton: folds 
yairpinto: folds 
Duke Croix: calls 100
rogierk449: folds 
Manon947: checks 
*** FLOP *** [6h 2d 2c]
Manon947: bets 331
dddocky: folds 
Duke Croix: calls 331
*** TURN *** [6h 2d 2c] [8s]
Manon947: bets 478
Duke Croix: raises 15198 to 15676 and is all-in
Manon947: calls 1010 and is all-in
Uncalled bet (14188) returned to Duke Croix
*** RIVER *** [6h 2d 2c 8s] [Ad]
*** SHOW DOWN ***
Manon947: shows [Ts 2h] (three of a kind, Deuces)
Duke Croix: shows [Ah 6s] (two pair, Aces and Sixes)
Manon947 collected 3769 from pot
*** SUMMARY ***
Total pot 3988 | Rake 219 
Board [6h 2d 2c 8s Ad]
Seat 1: color_singleton folded before Flop (didn't bet)
Seat 2: yairpinto folded before Flop (didn't bet)
Seat 3: Duke Croix (button) showed [Ah 6s] and lost with two pair, Aces and Sixes
Seat 4: rogierk449 (small blind) folded before Flop
Seat 8: Manon947 (big blind) showed [Ts 2h] and won (3769) with three of a kind, Deuces
Seat 9: dddocky folded on the Flop



PokerStars Home Game Hand #216954550125: {Club #3225207}  Hold'em No Limit (50/100) - 2020/07/30 16:36:30 ET
Table 'JansPokergame' 9-max (Play Money) Seat #4 is the button
Seat 1: color_singleton (6202 in chips) 
Seat 2: yairpinto (9073 in chips) 
Seat 3: Duke Croix (14188 in chips) 
Seat 4: rogierk449 (24113 in chips) 
Seat 8: Manon947 (3769 in chips) 
Seat 9: dddocky (7028 in chips) 
Manon947: posts small blind 50
dddocky: posts big blind 100
*** HOLE CARDS ***
Dealt to Duke Croix [Td Js]
color_singleton has timed out
color_singleton: folds 
yairpinto: folds 
Duke Croix: raises 200 to 300
rogierk449: folds 
Manon947: folds 
dddocky: folds 
Uncalled bet (200) returned to Duke Croix
Duke Croix collected 250 from pot
*** SUMMARY ***
Total pot 250 | Rake 0 
Seat 1: color_singleton folded before Flop (didn't bet)
Seat 2: yairpinto folded before Flop (didn't bet)
Seat 3: Duke Croix collected (250)
Seat 4: rogierk449 (button) folded before Flop (didn't bet)
Seat 8: Manon947 (small blind) folded before Flop
Seat 9: dddocky (big blind) folded before Flop



PokerStars Home Game Hand #216954571168: {Club #3225207}  Hold'em No Limit (50/100) - 2020/07/30 16:37:05 ET
Table 'JansPokergame' 9-max (Play Money) Seat #8 is the button
Seat 2: yairpinto (9073 in chips) 
Seat 3: Duke Croix (14338 in chips) 
Seat 4: rogierk449 (24113 in chips) 
Seat 8: Manon947 (3719 in chips) 
Seat 9: dddocky (6928 in chips) 
dddocky: posts small blind 50
yairpinto: posts big blind 100
*** HOLE CARDS ***
Dealt to Duke Croix [5h 9d]
Duke Croix: folds 
rogierk449: folds 
Manon947: calls 100
dddocky: folds 
yairpinto: checks 
*** FLOP *** [4c 9h 9c]
yairpinto: checks 
Manon947: checks 
*** TURN *** [4c 9h 9c] [8s]
yairpinto: bets 118
Manon947: calls 118
*** RIVER *** [4c 9h 9c 8s] [Qc]
yairpinto: checks 
Manon947: bets 459
yairpinto: folds 
Uncalled bet (459) returned to Manon947
Manon947 collected 459 from pot
*** SUMMARY ***
Total pot 486 | Rake 27 
Board [4c 9h 9c 8s Qc]
Seat 2: yairpinto (big blind) folded on the River
Seat 3: Duke Croix folded before Flop (didn't bet)
Seat 4: rogierk449 folded before Flop (didn't bet)
Seat 8: Manon947 (button) collected (459)
Seat 9: dddocky (small blind) folded before Flop



PokerStars Home Game Hand #216954603431: {Club #3225207}  Hold'em No Limit (50/100) - 2020/07/30 16:37:59 ET
Table 'JansPokergame' 9-max (Play Money) Seat #9 is the button
Seat 2: yairpinto (8855 in chips) 
Seat 3: Duke Croix (14338 in chips) 
Seat 4: rogierk449 (24113 in chips) 
Seat 8: Manon947 (3960 in chips) 
Seat 9: dddocky (6878 in chips) 
yairpinto: posts small blind 50
Duke Croix: posts big blind 100
*** HOLE CARDS ***
Dealt to Duke Croix [Td Qs]
rogierk449: folds 
Manon947: calls 100
dddocky: calls 100
yairpinto: calls 50
Duke Croix: checks 
*** FLOP *** [9h 2c 5c]
yairpinto: checks 
Duke Croix: checks 
Manon947: checks 
dddocky: checks 
*** TURN *** [9h 2c 5c] [Ad]
yairpinto: checks 
Duke Croix: checks 
Manon947: bets 378
dddocky: folds 
yairpinto: folds 
Duke Croix: folds 
Uncalled bet (378) returned to Manon947
Manon947 collected 378 from pot
*** SUMMARY ***
Total pot 400 | Rake 22 
Board [9h 2c 5c Ad]
Seat 2: yairpinto (small blind) folded on the Turn
Seat 3: Duke Croix (big blind) folded on the Turn
Seat 4: rogierk449 folded before Flop (didn't bet)
Seat 8: Manon947 collected (378)
Seat 9: dddocky (button) folded on the Turn



PokerStars Home Game Hand #216954629048: {Club #3225207}  Hold'em No Limit (50/100) - 2020/07/30 16:38:42 ET
Table 'JansPokergame' 9-max (Play Money) Seat #2 is the button
Seat 1: color_singleton (6202 in chips) 
Seat 2: yairpinto (8755 in chips) 
Seat 3: Duke Croix (14238 in chips) 
Seat 4: rogierk449 (24113 in chips) 
Seat 8: Manon947 (4238 in chips) 
Seat 9: dddocky (6778 in chips) 
Duke Croix: posts small blind 50
rogierk449: posts big blind 100
color_singleton: posts small & big blinds 150
*** HOLE CARDS ***
Dealt to Duke Croix [8h 2s]
Manon947: calls 100
dddocky: folds 
color_singleton: checks 
yairpinto: folds 
Duke Croix: calls 50
rogierk449: checks 
*** FLOP *** [3s 2c 3h]
Duke Croix: bets 300
rogierk449: folds 
Manon947: calls 300
color_singleton: folds 
*** TURN *** [3s 2c 3h] [Ac]
Duke Croix: checks 
Manon947: bets 496
Duke Croix: folds 
Uncalled bet (496) returned to Manon947
Manon947 collected 992 from pot
*** SUMMARY ***
Total pot 1050 | Rake 58 
Board [3s 2c 3h Ac]
Seat 1: color_singleton folded on the Flop (didn't bet)
Seat 2: yairpinto (button) folded before Flop (didn't bet)
Seat 3: Duke Croix (small blind) folded on the Turn
Seat 4: rogierk449 (big blind) folded on the Flop
Seat 8: Manon947 collected (992)
Seat 9: dddocky folded before Flop (didn't bet)



PokerStars Home Game Hand #216954656586: {Club #3225207}  Hold'em No Limit (50/100) - 2020/07/30 16:39:27 ET
Table 'JansPokergame' 9-max (Play Money) Seat #3 is the button
Seat 1: color_singleton (6052 in chips) 
Seat 2: yairpinto (8755 in chips) 
Seat 3: Duke Croix (13838 in chips) 
Seat 4: rogierk449 (24013 in chips) 
Seat 8: Manon947 (4830 in chips) 
Seat 9: dddocky (6778 in chips) 
rogierk449: posts small blind 50
Manon947: posts big blind 100
*** HOLE CARDS ***
Dealt to Duke Croix [Qs Th]
dddocky: calls 100
color_singleton: calls 100
yairpinto: folds 
Duke Croix: calls 100
rogierk449: folds 
Manon947: checks 
*** FLOP *** [4c 8s 5c]
Manon947: checks 
dddocky: checks 
color_singleton: checks 
Duke Croix: checks 
*** TURN *** [4c 8s 5c] [Js]
Manon947: bets 212
dddocky: folds 
color_singleton: calls 212
Duke Croix: folds 
*** RIVER *** [4c 8s 5c Js] [Ad]
Manon947: bets 413
color_singleton: calls 413
*** SHOW DOWN ***
Manon947: shows [Jd 2d] (a pair of Jacks)
color_singleton: shows [Jc 9d] (a pair of Jacks - Ace+Nine kicker)
color_singleton collected 1606 from pot
*** SUMMARY ***
Total pot 1700 | Rake 94 
Board [4c 8s 5c Js Ad]
Seat 1: color_singleton showed [Jc 9d] and won (1606) with a pair of Jacks
Seat 2: yairpinto folded before Flop (didn't bet)
Seat 3: Duke Croix (button) folded on the Turn
Seat 4: rogierk449 (small blind) folded before Flop
Seat 8: Manon947 (big blind) showed [Jd 2d] and lost with a pair of Jacks
Seat 9: dddocky folded on the Turn



PokerStars Home Game Hand #216954687574: {Club #3225207}  Hold'em No Limit (50/100) - 2020/07/30 16:40:18 ET
Table 'JansPokergame' 9-max (Play Money) Seat #4 is the button
Seat 1: color_singleton (6933 in chips) 
Seat 2: yairpinto (8755 in chips) 
Seat 3: Duke Croix (13738 in chips) 
Seat 4: rogierk449 (23963 in chips) 
Seat 8: Manon947 (4105 in chips) 
Seat 9: dddocky (6678 in chips) 
Manon947: posts small blind 50
dddocky: posts big blind 100
*** HOLE CARDS ***
Dealt to Duke Croix [3s 9h]
color_singleton: raises 200 to 300
yairpinto: calls 300
Duke Croix: folds 
rogierk449: folds 
Manon947: folds 
dddocky: calls 200
*** FLOP *** [Qs 7c 3h]
dddocky: bets 100
color_singleton: raises 200 to 300
yairpinto: calls 300
dddocky: raises 200 to 500
color_singleton: raises 800 to 1300
yairpinto: calls 1000
dddocky: raises 800 to 2100
color_singleton: calls 800
yairpinto: raises 6355 to 8455 and is all-in
dddocky: calls 4278 and is all-in
color_singleton: calls 4533 and is all-in
Uncalled bet (1822) returned to yairpinto
*** TURN *** [Qs 7c 3h] [8d]
*** RIVER *** [Qs 7c 3h 8d] [Js]
*** SHOW DOWN ***
color_singleton: shows [As Ah] (a pair of Aces)
yairpinto: shows [Kd Qd] (a pair of Queens)
color_singleton collected 482 from side pot
dddocky: shows [Qh 7s] (two pair, Queens and Sevens)
dddocky collected 18979 from main pot
*** SUMMARY ***
Total pot 20594 Main pot 18979. Side pot 482. | Rake 1133 
Board [Qs 7c 3h 8d Js]
Seat 1: color_singleton showed [As Ah] and won (482) with a pair of Aces
Seat 2: yairpinto showed [Kd Qd] and lost with a pair of Queens
Seat 3: Duke Croix folded before Flop (didn't bet)
Seat 4: rogierk449 (button) folded before Flop (didn't bet)
Seat 8: Manon947 (small blind) folded before Flop
Seat 9: dddocky (big blind) showed [Qh 7s] and won (18979) with two pair, Queens and Sevens



PokerStars Home Game Hand #216954746393: {Club #3225207}  Hold'em No Limit (50/100) - 2020/07/30 16:41:43 ET
Table 'JansPokergame' 9-max (Play Money) Seat #8 is the button
Seat 1: color_singleton (482 in chips) 
Seat 2: yairpinto (1822 in chips) 
Seat 3: Duke Croix (13738 in chips) 
Seat 4: rogierk449 (23963 in chips) 
Seat 8: Manon947 (4055 in chips) 
Seat 9: dddocky (18979 in chips) 
dddocky: posts small blind 50
color_singleton: posts big blind 100
*** HOLE CARDS ***
Dealt to Duke Croix [5h 9s]
yairpinto: calls 100
Duke Croix: folds 
rogierk449: calls 100
Manon947: calls 100
dddocky: calls 50
color_singleton: raises 382 to 482 and is all-in
yairpinto: folds 
rogierk449: folds 
Manon947: folds 
dddocky: calls 382
*** FLOP *** [7s 3s 4s]
*** TURN *** [7s 3s 4s] [9c]
*** RIVER *** [7s 3s 4s 9c] [2c]
*** SHOW DOWN ***
dddocky: shows [Js 6d] (high card Jack)
color_singleton: shows [3c Kd] (a pair of Threes)
color_singleton collected 1194 from pot
*** SUMMARY ***
Total pot 1264 | Rake 70 
Board [7s 3s 4s 9c 2c]
Seat 1: color_singleton (big blind) showed [3c Kd] and won (1194) with a pair of Threes
Seat 2: yairpinto folded before Flop
Seat 3: Duke Croix folded before Flop (didn't bet)
Seat 4: rogierk449 folded before Flop
Seat 8: Manon947 (button) folded before Flop
Seat 9: dddocky (small blind) showed [Js 6d] and lost with high card Jack



PokerStars Home Game Hand #216954782150: {Club #3225207}  Hold'em No Limit (50/100) - 2020/07/30 16:42:43 ET
Table 'JansPokergame' 9-max (Play Money) Seat #9 is the button
Seat 1: color_singleton (1194 in chips) 
Seat 2: yairpinto (1722 in chips) 
Seat 3: Duke Croix (13738 in chips) 
Seat 4: rogierk449 (23863 in chips) 
Seat 8: Manon947 (3955 in chips) 
Seat 9: dddocky (18497 in chips) 
color_singleton: posts small blind 50
yairpinto: posts big blind 100
*** HOLE CARDS ***
Dealt to Duke Croix [Ah Th]
Duke Croix: raises 200 to 300
rogierk449: folds 
Manon947: folds 
dddocky: folds 
color_singleton: raises 894 to 1194 and is all-in
yairpinto: folds 
Duke Croix: calls 894
*** FLOP *** [3d 4d 2s]
*** TURN *** [3d 4d 2s] [Td]
*** RIVER *** [3d 4d 2s Td] [6d]
*** SHOW DOWN ***
color_singleton: shows [Ad 8h] (a flush, Ace high)
Duke Croix: shows [Ah Th] (a pair of Tens)
color_singleton collected 2351 from pot
*** SUMMARY ***
Total pot 2488 | Rake 137 
Board [3d 4d 2s Td 6d]
Seat 1: color_singleton (small blind) showed [Ad 8h] and won (2351) with a flush, Ace high
Seat 2: yairpinto (big blind) folded before Flop
Seat 3: Duke Croix showed [Ah Th] and lost with a pair of Tens
Seat 4: rogierk449 folded before Flop (didn't bet)
Seat 8: Manon947 folded before Flop (didn't bet)
Seat 9: dddocky (button) folded before Flop (didn't bet)



PokerStars Home Game Hand #216954796995: {Club #3225207}  Hold'em No Limit (50/100) - 2020/07/30 16:43:08 ET
Table 'JansPokergame' 9-max (Play Money) Seat #1 is the button
Seat 1: color_singleton (2351 in chips) 
Seat 2: yairpinto (1622 in chips) 
Seat 3: Duke Croix (12544 in chips) 
Seat 4: rogierk449 (23863 in chips) 
Seat 8: Manon947 (3955 in chips) 
Seat 9: dddocky (18497 in chips) 
yairpinto: posts small blind 50
Duke Croix: posts big blind 100
*** HOLE CARDS ***
Dealt to Duke Croix [Ad Js]
rogierk449: raises 200 to 300
Manon947: calls 300
dddocky: folds 
color_singleton: calls 300
yairpinto: folds 
Duke Croix: calls 200
*** FLOP *** [Ah Qd 8h]
Duke Croix: bets 600
rogierk449: folds 
Manon947: folds 
color_singleton: calls 600
*** TURN *** [Ah Qd 8h] [Jc]
Duke Croix: bets 1500
color_singleton: calls 1451 and is all-in
Uncalled bet (49) returned to Duke Croix
*** RIVER *** [Ah Qd 8h Jc] [Kh]
*** SHOW DOWN ***
Duke Croix: shows [Ad Js] (two pair, Aces and Jacks)
color_singleton: shows [4s Qs] (a pair of Queens)
Duke Croix collected 5058 from pot
*** SUMMARY ***
Total pot 5352 | Rake 294 
Board [Ah Qd 8h Jc Kh]
Seat 1: color_singleton (button) showed [4s Qs] and lost with a pair of Queens
Seat 2: yairpinto (small blind) folded before Flop
Seat 3: Duke Croix (big blind) showed [Ad Js] and won (5058) with two pair, Aces and Jacks
Seat 4: rogierk449 folded on the Flop
Seat 8: Manon947 folded on the Flop
Seat 9: dddocky folded before Flop (didn't bet)



PokerStars Home Game Hand #216954824620: {Club #3225207}  Hold'em No Limit (50/100) - 2020/07/30 16:43:54 ET
Table 'JansPokergame' 9-max (Play Money) Seat #2 is the button
Seat 2: yairpinto (1572 in chips) 
Seat 3: Duke Croix (15251 in chips) 
Seat 4: rogierk449 (23563 in chips) 
Seat 8: Manon947 (3655 in chips) 
Seat 9: dddocky (18497 in chips) 
Duke Croix: posts small blind 50
rogierk449: posts big blind 100
*** HOLE CARDS ***
Dealt to Duke Croix [9c Qh]
Manon947: calls 100
dddocky: folds 
yairpinto: raises 200 to 300
Duke Croix: folds 
rogierk449: folds 
Manon947: calls 200
*** FLOP *** [3s Js 8d]
Manon947: checks 
yairpinto: bets 354
Manon947: folds 
Uncalled bet (354) returned to yairpinto
yairpinto collected 709 from pot
yairpinto: doesn't show hand 
*** SUMMARY ***
Total pot 750 | Rake 41 
Board [3s Js 8d]
Seat 2: yairpinto (button) collected (709)
Seat 3: Duke Croix (small blind) folded before Flop
Seat 4: rogierk449 (big blind) folded before Flop
Seat 8: Manon947 folded on the Flop
Seat 9: dddocky folded before Flop (didn't bet)



PokerStars Home Game Hand #216954849137: {Club #3225207}  Hold'em No Limit (50/100) - 2020/07/30 16:44:36 ET
Table 'JansPokergame' 9-max (Play Money) Seat #3 is the button
Seat 1: color_singleton (10000 in chips) 
Seat 2: yairpinto (1981 in chips) 
Seat 3: Duke Croix (15201 in chips) 
Seat 4: rogierk449 (23463 in chips) 
Seat 8: Manon947 (3355 in chips) 
Seat 9: dddocky (18497 in chips) 
rogierk449: posts small blind 50
Manon947: posts big blind 100
*** HOLE CARDS ***
Dealt to Duke Croix [Ad 6d]
dddocky: folds 
color_singleton: raises 200 to 300
yairpinto: folds 
Duke Croix: calls 300
rogierk449: calls 250
Manon947: calls 200
*** FLOP *** [7h 7s 8d]
rogierk449: checks 
Manon947: checks 
color_singleton: checks 
Duke Croix: checks 
*** TURN *** [7h 7s 8d] [4c]
rogierk449: bets 567
Manon947: folds 
color_singleton: folds 
Duke Croix: folds 
Uncalled bet (567) returned to rogierk449
rogierk449 collected 1134 from pot
rogierk449: doesn't show hand 
*** SUMMARY ***
Total pot 1200 | Rake 66 
Board [7h 7s 8d 4c]
Seat 1: color_singleton folded on the Turn
Seat 2: yairpinto folded before Flop (didn't bet)
Seat 3: Duke Croix (button) folded on the Turn
Seat 4: rogierk449 (small blind) collected (1134)
Seat 8: Manon947 (big blind) folded on the Turn
Seat 9: dddocky folded before Flop (didn't bet)



PokerStars Home Game Hand #216954870313: {Club #3225207}  Hold'em No Limit (50/100) - 2020/07/30 16:45:11 ET
Table 'JansPokergame' 9-max (Play Money) Seat #4 is the button
Seat 1: color_singleton (9700 in chips) 
Seat 2: yairpinto (1981 in chips) 
Seat 3: Duke Croix (14901 in chips) 
Seat 4: rogierk449 (24297 in chips) 
Seat 8: Manon947 (3055 in chips) 
Seat 9: dddocky (18497 in chips) 
Manon947: posts small blind 50
dddocky: posts big blind 100
*** HOLE CARDS ***
Dealt to Duke Croix [Jc 4d]
color_singleton: folds 
yairpinto: calls 100
Duke Croix: folds 
rogierk449: folds 
Manon947: calls 50
dddocky: checks 
*** FLOP *** [9d 5c Qc]
Manon947: checks 
dddocky: checks 
yairpinto: bets 141
Manon947: raises 141 to 282
dddocky: folds 
yairpinto: calls 141
*** TURN *** [9d 5c Qc] [Qh]
Manon947: bets 816
yairpinto: folds 
Uncalled bet (816) returned to Manon947
Manon947 collected 816 from pot
*** SUMMARY ***
Total pot 864 | Rake 48 
Board [9d 5c Qc Qh]
Seat 1: color_singleton folded before Flop (didn't bet)
Seat 2: yairpinto folded on the Turn
Seat 3: Duke Croix folded before Flop (didn't bet)
Seat 4: rogierk449 (button) folded before Flop (didn't bet)
Seat 8: Manon947 (small blind) collected (816)
Seat 9: dddocky (big blind) folded on the Flop



PokerStars Home Game Hand #216954899828: {Club #3225207}  Hold'em No Limit (50/100) - 2020/07/30 16:46:00 ET
Table 'JansPokergame' 9-max (Play Money) Seat #8 is the button
Seat 1: color_singleton (9700 in chips) 
Seat 2: yairpinto (1599 in chips) 
Seat 3: Duke Croix (14901 in chips) 
Seat 4: rogierk449 (24297 in chips) 
Seat 8: Manon947 (3489 in chips) 
Seat 9: dddocky (18397 in chips) 
dddocky: posts small blind 50
color_singleton: posts big blind 100
*** HOLE CARDS ***
Dealt to Duke Croix [4c 5d]
yairpinto: folds 
Duke Croix has timed out
Duke Croix: folds 
rogierk449: folds 
Manon947: calls 100
dddocky: folds 
color_singleton: raises 100 to 200
Manon947: calls 100
*** FLOP *** [6d Td 7s]
color_singleton: checks 
Manon947: checks 
*** TURN *** [6d Td 7s] [2d]
color_singleton: checks 
Manon947: checks 
*** RIVER *** [6d Td 7s 2d] [9s]
color_singleton: checks 
Manon947: bets 425
color_singleton: raises 425 to 850
Manon947: raises 425 to 1275
color_singleton: calls 425
*** SHOW DOWN ***
Manon947: shows [8s Kd] (a straight, Six to Ten)
color_singleton: shows [8c Kc] (a straight, Six to Ten)
color_singleton collected 1418 from pot
Manon947 collected 1417 from pot
*** SUMMARY ***
Total pot 3000 | Rake 165 
Board [6d Td 7s 2d 9s]
Seat 1: color_singleton (big blind) showed [8c Kc] and won (1418) with a straight, Six to Ten
Seat 2: yairpinto folded before Flop (didn't bet)
Seat 3: Duke Croix folded before Flop (didn't bet)
Seat 4: rogierk449 folded before Flop (didn't bet)
Seat 8: Manon947 (button) showed [8s Kd] and won (1417) with a straight, Six to Ten
Seat 9: dddocky (small blind) folded before Flop



PokerStars Home Game Hand #216954959524: {Club #3225207}  Hold'em No Limit (50/100) - 2020/07/30 16:47:38 ET
Table 'JansPokergame' 9-max (Play Money) Seat #1 is the button
Seat 1: color_singleton (9543 in chips) 
Seat 2: yairpinto (1499 in chips) 
Seat 3: Duke Croix (14901 in chips) 
Seat 4: rogierk449 (24297 in chips) 
Seat 8: Manon947 (3431 in chips) 
Seat 9: dddocky (18530 in chips) 
yairpinto: posts small blind 50
Duke Croix: posts big blind 100
*** HOLE CARDS ***
Dealt to Duke Croix [Ts Qh]
rogierk449: folds 
Manon947: calls 100
dddocky: calls 100
color_singleton: calls 100
yairpinto: calls 50
Duke Croix has timed out
Duke Croix: checks 
*** FLOP *** [Qc 2d 7h]
yairpinto: checks 
Duke Croix: bets 300
Manon947: calls 300
dddocky: folds 
color_singleton: raises 300 to 600
yairpinto: folds 
Duke Croix: calls 300
Manon947: folds 
*** TURN *** [Qc 2d 7h] [5h]
Duke Croix: bets 800
color_singleton: raises 800 to 1600
Duke Croix: calls 800
*** RIVER *** [Qc 2d 7h 5h] [3c]
Duke Croix: checks 
color_singleton: checks 
*** SHOW DOWN ***
Duke Croix: shows [Ts Qh] (a pair of Queens)
color_singleton: shows [Jc Qd] (a pair of Queens - Jack kicker)
color_singleton collected 4914 from pot
*** SUMMARY ***
Total pot 5200 | Rake 286 
Board [Qc 2d 7h 5h 3c]
Seat 1: color_singleton (button) showed [Jc Qd] and won (4914) with a pair of Queens
Seat 2: yairpinto (small blind) folded on the Flop
Seat 3: Duke Croix (big blind) showed [Ts Qh] and lost with a pair of Queens
Seat 4: rogierk449 folded before Flop (didn't bet)
Seat 8: Manon947 folded on the Flop
Seat 9: dddocky folded on the Flop



PokerStars Home Game Hand #216955009902: {Club #3225207}  Hold'em No Limit (50/100) - 2020/07/30 16:49:01 ET
Table 'JansPokergame' 9-max (Play Money) Seat #2 is the button
Seat 1: color_singleton (12157 in chips) 
Seat 2: yairpinto (1399 in chips) 
Seat 3: Duke Croix (12601 in chips) 
Seat 4: rogierk449 (24297 in chips) 
Seat 8: Manon947 (3031 in chips) 
Seat 9: dddocky (18430 in chips) 
Duke Croix: posts small blind 50
rogierk449: posts big blind 100
*** HOLE CARDS ***
Dealt to Duke Croix [Qd Jc]
Manon947: calls 100
dddocky: folds 
color_singleton: raises 200 to 300
yairpinto: folds 
Duke Croix: calls 250
rogierk449: folds 
Manon947: folds 
*** FLOP *** [2h 9c Ah]
Duke Croix: checks 
color_singleton: bets 378
Duke Croix: folds 
Uncalled bet (378) returned to color_singleton
color_singleton collected 756 from pot
color_singleton: doesn't show hand 
*** SUMMARY ***
Total pot 800 | Rake 44 
Board [2h 9c Ah]
Seat 1: color_singleton collected (756)
Seat 2: yairpinto (button) folded before Flop (didn't bet)
Seat 3: Duke Croix (small blind) folded on the Flop
Seat 4: rogierk449 (big blind) folded before Flop
Seat 8: Manon947 folded before Flop
Seat 9: dddocky folded before Flop (didn't bet)



PokerStars Home Game Hand #216955030947: {Club #3225207}  Hold'em No Limit (50/100) - 2020/07/30 16:49:35 ET
Table 'JansPokergame' 9-max (Play Money) Seat #3 is the button
Seat 1: color_singleton (12613 in chips) 
Seat 2: yairpinto (1399 in chips) 
Seat 3: Duke Croix (12301 in chips) 
Seat 4: rogierk449 (24197 in chips) 
Seat 8: Manon947 (2931 in chips) 
Seat 9: dddocky (18430 in chips) 
rogierk449: posts small blind 50
Manon947: posts big blind 100
*** HOLE CARDS ***
Dealt to Duke Croix [Qh 3d]
dddocky: folds 
color_singleton: folds 
yairpinto: folds 
Duke Croix: folds 
rogierk449: folds 
Uncalled bet (50) returned to Manon947
Manon947 collected 100 from pot
Manon947: doesn't show hand 
*** SUMMARY ***
Total pot 100 | Rake 0 
Seat 1: color_singleton folded before Flop (didn't bet)
Seat 2: yairpinto folded before Flop (didn't bet)
Seat 3: Duke Croix (button) folded before Flop (didn't bet)
Seat 4: rogierk449 (small blind) folded before Flop
Seat 8: Manon947 (big blind) collected (100)
Seat 9: dddocky folded before Flop (didn't bet)



PokerStars Home Game Hand #216955036072: {Club #3225207}  Hold'em No Limit (50/100) - 2020/07/30 16:49:44 ET
Table 'JansPokergame' 9-max (Play Money) Seat #4 is the button
Seat 1: color_singleton (12613 in chips) 
Seat 2: yairpinto (1399 in chips) 
Seat 3: Duke Croix (12301 in chips) 
Seat 4: rogierk449 (24147 in chips) 
Seat 8: Manon947 (2981 in chips) 
Seat 9: dddocky (18430 in chips) 
Manon947: posts small blind 50
dddocky: posts big blind 100
*** HOLE CARDS ***
Dealt to Duke Croix [2d 8h]
color_singleton: folds 
yairpinto: folds 
Duke Croix: folds 
rogierk449: folds 
Manon947: calls 50
dddocky: checks 
*** FLOP *** [9d 8d 2c]
Manon947: checks 
dddocky: checks 
*** TURN *** [9d 8d 2c] [7h]
Manon947: checks 
dddocky: checks 
*** RIVER *** [9d 8d 2c 7h] [Ac]
Manon947: checks 
dddocky: checks 
*** SHOW DOWN ***
Manon947: shows [Qc Th] (high card Ace)
dddocky: shows [Kd 8c] (a pair of Eights)
dddocky collected 189 from pot
*** SUMMARY ***
Total pot 200 | Rake 11 
Board [9d 8d 2c 7h Ac]
Seat 1: color_singleton folded before Flop (didn't bet)
Seat 2: yairpinto folded before Flop (didn't bet)
Seat 3: Duke Croix folded before Flop (didn't bet)
Seat 4: rogierk449 (button) folded before Flop (didn't bet)
Seat 8: Manon947 (small blind) showed [Qc Th] and lost with high card Ace
Seat 9: dddocky (big blind) showed [Kd 8c] and won (189) with a pair of Eights



PokerStars Home Game Hand #216955055707: {Club #3225207}  Hold'em No Limit (50/100) - 2020/07/30 16:50:16 ET
Table 'JansPokergame' 9-max (Play Money) Seat #8 is the button
Seat 1: color_singleton (12613 in chips) 
Seat 2: yairpinto (1399 in chips) 
Seat 3: Duke Croix (12301 in chips) 
Seat 4: rogierk449 (24147 in chips) 
Seat 8: Manon947 (2881 in chips) 
Seat 9: dddocky (18519 in chips) 
dddocky: posts small blind 50
color_singleton: posts big blind 100
*** HOLE CARDS ***
Dealt to Duke Croix [Qh Ks]
yairpinto: folds 
Duke Croix: raises 300 to 400
rogierk449: folds 
Manon947: folds 
dddocky: folds 
color_singleton: folds 
Uncalled bet (300) returned to Duke Croix
Duke Croix collected 250 from pot
*** SUMMARY ***
Total pot 250 | Rake 0 
Seat 1: color_singleton (big blind) folded before Flop
Seat 2: yairpinto folded before Flop (didn't bet)
Seat 3: Duke Croix collected (250)
Seat 4: rogierk449 folded before Flop (didn't bet)
Seat 8: Manon947 (button) folded before Flop (didn't bet)
Seat 9: dddocky (small blind) folded before Flop



PokerStars Home Game Hand #216955066560: {Club #3225207}  Hold'em No Limit (50/100) - 2020/07/30 16:50:34 ET
Table 'JansPokergame' 9-max (Play Money) Seat #9 is the button
Seat 1: color_singleton (12513 in chips) 
Seat 2: yairpinto (1399 in chips) 
Seat 3: Duke Croix (12451 in chips) 
Seat 4: rogierk449 (24147 in chips) 
Seat 8: Manon947 (2881 in chips) 
Seat 9: dddocky (18469 in chips) 
color_singleton: posts small blind 50
yairpinto: posts big blind 100
*** HOLE CARDS ***
Dealt to Duke Croix [As 3s]
Duke Croix: calls 100
rogierk449: folds 
Manon947: calls 100
dddocky: calls 100
color_singleton: calls 50
yairpinto: checks 
*** FLOP *** [Jd 5h 9h]
color_singleton: bets 472
yairpinto: calls 472
Duke Croix: folds 
Manon947: folds 
dddocky: folds 
*** TURN *** [Jd 5h 9h] [4c]
color_singleton: bets 1000
yairpinto: calls 827 and is all-in
Uncalled bet (173) returned to color_singleton
*** RIVER *** [Jd 5h 9h 4c] [2c]
*** SHOW DOWN ***
color_singleton: shows [Jc 6c] (a pair of Jacks)
yairpinto: shows [Kh 4h] (a pair of Fours)
color_singleton collected 2928 from pot
*** SUMMARY ***
Total pot 3098 | Rake 170 
Board [Jd 5h 9h 4c 2c]
Seat 1: color_singleton (small blind) showed [Jc 6c] and won (2928) with a pair of Jacks
Seat 2: yairpinto (big blind) showed [Kh 4h] and lost with a pair of Fours
Seat 3: Duke Croix folded on the Flop
Seat 4: rogierk449 folded before Flop (didn't bet)
Seat 8: Manon947 folded on the Flop
Seat 9: dddocky (button) folded on the Flop



PokerStars Home Game Hand #216955102650: {Club #3225207}  Hold'em No Limit (50/100) - 2020/07/30 16:51:33 ET
Table 'JansPokergame' 9-max (Play Money) Seat #1 is the button
Seat 1: color_singleton (14042 in chips) 
Seat 3: Duke Croix (12351 in chips) 
Seat 4: rogierk449 (24147 in chips) 
Seat 8: Manon947 (2781 in chips) 
Seat 9: dddocky (18369 in chips) 
Duke Croix: posts small blind 50
rogierk449: posts big blind 100
*** HOLE CARDS ***
Dealt to Duke Croix [8s 9d]
Manon947: calls 100
dddocky: folds 
color_singleton: folds 
Duke Croix: calls 50
rogierk449: checks 
*** FLOP *** [3s Ks 5d]
Duke Croix: checks 
rogierk449: checks 
Manon947: bets 141
Duke Croix: folds 
rogierk449: folds 
Uncalled bet (141) returned to Manon947
Manon947 collected 283 from pot
*** SUMMARY ***
Total pot 300 | Rake 17 
Board [3s Ks 5d]
Seat 1: color_singleton (button) folded before Flop (didn't bet)
Seat 3: Duke Croix (small blind) folded on the Flop
Seat 4: rogierk449 (big blind) folded on the Flop
Seat 8: Manon947 collected (283)
Seat 9: dddocky folded before Flop (didn't bet)



PokerStars Home Game Hand #216955124446: {Club #3225207}  Hold'em No Limit (50/100) - 2020/07/30 16:52:09 ET
Table 'JansPokergame' 9-max (Play Money) Seat #3 is the button
Seat 1: color_singleton (14042 in chips) 
Seat 2: yairpinto (10000 in chips) 
Seat 3: Duke Croix (12251 in chips) 
Seat 4: rogierk449 (24047 in chips) 
Seat 8: Manon947 (2964 in chips) 
Seat 9: dddocky (18369 in chips) 
rogierk449: posts small blind 50
Manon947: posts big blind 100
yairpinto: posts small blind 50
*** HOLE CARDS ***
Dealt to Duke Croix [Kd 7c]
dddocky: calls 100
color_singleton: folds 
yairpinto: raises 200 to 300
Duke Croix: folds 
rogierk449: calls 250
Manon947: calls 200
dddocky: calls 200
*** FLOP *** [Ah Ac 6s]
rogierk449: checks 
Manon947: checks 
dddocky: checks 
yairpinto: bets 590
rogierk449: folds 
Manon947: folds 
dddocky: folds 
Uncalled bet (590) returned to yairpinto
yairpinto collected 1181 from pot
yairpinto: doesn't show hand 
*** SUMMARY ***
Total pot 1250 | Rake 69 
Board [Ah Ac 6s]
Seat 1: color_singleton folded before Flop (didn't bet)
Seat 2: yairpinto collected (1181)
Seat 3: Duke Croix (button) folded before Flop (didn't bet)
Seat 4: rogierk449 (small blind) folded on the Flop
Seat 8: Manon947 (big blind) folded on the Flop
Seat 9: dddocky folded on the Flop



PokerStars Home Game Hand #216955148417: {Club #3225207}  Hold'em No Limit (50/100) - 2020/07/30 16:52:47 ET
Table 'JansPokergame' 9-max (Play Money) Seat #4 is the button
Seat 1: color_singleton (14042 in chips) 
Seat 2: yairpinto (10831 in chips) 
Seat 3: Duke Croix (12251 in chips) 
Seat 4: rogierk449 (23747 in chips) 
Seat 8: Manon947 (2664 in chips) 
Seat 9: dddocky (18069 in chips) 
Manon947: posts small blind 50
dddocky: posts big blind 100
*** HOLE CARDS ***
Dealt to Duke Croix [Th 3c]
color_singleton: calls 100
yairpinto: folds 
Duke Croix: folds 
rogierk449: folds 
Manon947: folds 
dddocky: checks 
*** FLOP *** [Js 8s 6s]
dddocky: checks 
color_singleton: bets 118
dddocky: folds 
Uncalled bet (118) returned to color_singleton
color_singleton collected 236 from pot
color_singleton: doesn't show hand 
*** SUMMARY ***
Total pot 250 | Rake 14 
Board [Js 8s 6s]
Seat 1: color_singleton collected (236)
Seat 2: yairpinto folded before Flop (didn't bet)
Seat 3: Duke Croix folded before Flop (didn't bet)
Seat 4: rogierk449 (button) folded before Flop (didn't bet)
Seat 8: Manon947 (small blind) folded before Flop
Seat 9: dddocky (big blind) folded on the Flop



PokerStars Home Game Hand #216955162488: {Club #3225207}  Hold'em No Limit (50/100) - 2020/07/30 16:53:11 ET
Table 'JansPokergame' 9-max (Play Money) Seat #8 is the button
Seat 1: color_singleton (14178 in chips) 
Seat 2: yairpinto (10831 in chips) 
Seat 3: Duke Croix (12251 in chips) 
Seat 4: rogierk449 (23747 in chips) 
Seat 8: Manon947 (2614 in chips) 
Seat 9: dddocky (17969 in chips) 
dddocky: posts small blind 50
color_singleton: posts big blind 100
*** HOLE CARDS ***
Dealt to Duke Croix [8h Kd]
yairpinto: folds 
Duke Croix: raises 200 to 300
rogierk449: folds 
Manon947: folds 
dddocky: folds 
color_singleton: calls 200
*** FLOP *** [8s Jc 8c]
color_singleton: checks 
Duke Croix: checks 
*** TURN *** [8s Jc 8c] [3h]
color_singleton: checks 
Duke Croix: bets 400
color_singleton: raises 400 to 800
Duke Croix: calls 400
*** RIVER *** [8s Jc 8c 3h] [2h]
color_singleton: bets 1063
Duke Croix: raises 2137 to 3200
color_singleton: calls 2137
*** SHOW DOWN ***
Duke Croix: shows [8h Kd] (three of a kind, Eights)
color_singleton: mucks hand 
Duke Croix collected 8174 from pot
*** SUMMARY ***
Total pot 8650 | Rake 476 
Board [8s Jc 8c 3h 2h]
Seat 1: color_singleton (big blind) mucked [8d Td]
Seat 2: yairpinto folded before Flop (didn't bet)
Seat 3: Duke Croix showed [8h Kd] and won (8174) with three of a kind, Eights
Seat 4: rogierk449 folded before Flop (didn't bet)
Seat 8: Manon947 (button) folded before Flop (didn't bet)
Seat 9: dddocky (small blind) folded before Flop



PokerStars Home Game Hand #216955194089: {Club #3225207}  Hold'em No Limit (50/100) - 2020/07/30 16:54:03 ET
Table 'JansPokergame' 9-max (Play Money) Seat #9 is the button
Seat 1: color_singleton (9878 in chips) 
Seat 2: yairpinto (10831 in chips) 
Seat 3: Duke Croix (16125 in chips) 
Seat 4: rogierk449 (23747 in chips) 
Seat 8: Manon947 (2614 in chips) 
Seat 9: dddocky (17919 in chips) 
color_singleton: posts small blind 50
yairpinto: posts big blind 100
*** HOLE CARDS ***
Dealt to Duke Croix [9d 5h]
Duke Croix: folds 
rogierk449: folds 
Manon947: folds 
dddocky: folds 
color_singleton: raises 100 to 200
yairpinto: calls 100
*** FLOP *** [Th 7c 4d]
color_singleton: bets 189
yairpinto: folds 
Uncalled bet (189) returned to color_singleton
color_singleton collected 378 from pot
color_singleton: doesn't show hand 
*** SUMMARY ***
Total pot 400 | Rake 22 
Board [Th 7c 4d]
Seat 1: color_singleton (small blind) collected (378)
Seat 2: yairpinto (big blind) folded on the Flop
Seat 3: Duke Croix folded before Flop (didn't bet)
Seat 4: rogierk449 folded before Flop (didn't bet)
Seat 8: Manon947 folded before Flop (didn't bet)
Seat 9: dddocky (button) folded before Flop (didn't bet)



PokerStars Home Game Hand #216955209080: {Club #3225207}  Hold'em No Limit (50/100) - 2020/07/30 16:54:28 ET
Table 'JansPokergame' 9-max (Play Money) Seat #1 is the button
Seat 1: color_singleton (10056 in chips) 
Seat 2: yairpinto (10631 in chips) 
Seat 3: Duke Croix (16125 in chips) 
Seat 4: rogierk449 (23747 in chips) 
Seat 8: Manon947 (2614 in chips) 
Seat 9: dddocky (17919 in chips) 
yairpinto: posts small blind 50
Duke Croix: posts big blind 100
*** HOLE CARDS ***
Dealt to Duke Croix [3c 5h]
rogierk449: raises 200 to 300
Manon947: calls 300
dddocky: calls 300
color_singleton: folds 
yairpinto: calls 250
Duke Croix: folds 
*** FLOP *** [7d Kh 9c]
yairpinto: checks 
rogierk449: checks 
Manon947: checks 
dddocky: bets 1228
yairpinto: raises 3684 to 4912
rogierk449: folds 
Manon947: folds 
dddocky: calls 3684
*** TURN *** [7d Kh 9c] [Tc]
yairpinto: bets 5419 and is all-in
dddocky: calls 5419
*** RIVER *** [7d Kh 9c Tc] [Kd]
*** SHOW DOWN ***
yairpinto: shows [Ks 9s] (a full house, Kings full of Nines)
dddocky: shows [Jd Kc] (three of a kind, Kings)
yairpinto collected 20754 from pot
*** SUMMARY ***
Total pot 21962 | Rake 1208 
Board [7d Kh 9c Tc Kd]
Seat 1: color_singleton (button) folded before Flop (didn't bet)
Seat 2: yairpinto (small blind) showed [Ks 9s] and won (20754) with a full house, Kings full of Nines
Seat 3: Duke Croix (big blind) folded before Flop
Seat 4: rogierk449 folded on the Flop
Seat 8: Manon947 folded on the Flop
Seat 9: dddocky showed [Jd Kc] and lost with three of a kind, Kings



PokerStars Home Game Hand #216955254019: {Club #3225207}  Hold'em No Limit (50/100) - 2020/07/30 16:55:38 ET
Table 'JansPokergame' 9-max (Play Money) Seat #2 is the button
Seat 1: color_singleton (10056 in chips) 
Seat 2: yairpinto (20754 in chips) 
Seat 3: Duke Croix (16025 in chips) 
Seat 4: rogierk449 (23447 in chips) 
Seat 8: Manon947 (2314 in chips) 
Seat 9: dddocky (7288 in chips) 
Duke Croix: posts small blind 50
rogierk449: posts big blind 100
*** HOLE CARDS ***
Dealt to Duke Croix [Kd Jh]
Manon947: folds 
dddocky: calls 100
color_singleton: folds 
yairpinto: raises 200 to 300
Duke Croix: calls 250
rogierk449: folds 
dddocky: calls 200
*** FLOP *** [3d 4s Qs]
Duke Croix: checks 
dddocky: checks 
yairpinto: bets 472
Duke Croix: folds 
dddocky: folds 
Uncalled bet (472) returned to yairpinto
yairpinto collected 945 from pot
yairpinto: doesn't show hand 
*** SUMMARY ***
Total pot 1000 | Rake 55 
Board [3d 4s Qs]
Seat 1: color_singleton folded before Flop (didn't bet)
Seat 2: yairpinto (button) collected (945)
Seat 3: Duke Croix (small blind) folded on the Flop
Seat 4: rogierk449 (big blind) folded before Flop
Seat 8: Manon947 folded before Flop (didn't bet)
Seat 9: dddocky folded on the Flop



PokerStars Home Game Hand #216955269712: {Club #3225207}  Hold'em No Limit (50/100) - 2020/07/30 16:56:13 ET
Table 'JansPokergame' 9-max (Play Money) Seat #3 is the button
Seat 1: color_singleton (10056 in chips) 
Seat 2: yairpinto (21399 in chips) 
Seat 3: Duke Croix (15725 in chips) 
Seat 4: rogierk449 (23347 in chips) 
Seat 8: Manon947 (2314 in chips) 
Seat 9: dddocky (6988 in chips) 
rogierk449: posts small blind 50
Manon947: posts big blind 100
*** HOLE CARDS ***
Dealt to Duke Croix [As Kc]
dddocky: calls 100
color_singleton: folds 
yairpinto: folds 
Duke Croix: raises 400 to 500
rogierk449: calls 450
Manon947: folds 
dddocky: folds 
*** FLOP *** [5h 9d 5d]
rogierk449: bets 567
Duke Croix: folds 
Uncalled bet (567) returned to rogierk449
rogierk449 collected 1134 from pot
rogierk449: doesn't show hand 
*** SUMMARY ***
Total pot 1200 | Rake 66 
Board [5h 9d 5d]
Seat 1: color_singleton folded before Flop (didn't bet)
Seat 2: yairpinto folded before Flop (didn't bet)
Seat 3: Duke Croix (button) folded on the Flop
Seat 4: rogierk449 (small blind) collected (1134)
Seat 8: Manon947 (big blind) folded before Flop
Seat 9: dddocky folded before Flop



PokerStars Home Game Hand #216955285243: {Club #3225207}  Hold'em No Limit (50/100) - 2020/07/30 16:56:48 ET
Table 'JansPokergame' 9-max (Play Money) Seat #4 is the button
Seat 1: color_singleton (10056 in chips) 
Seat 2: yairpinto (21399 in chips) 
Seat 3: Duke Croix (15225 in chips) 
Seat 4: rogierk449 (23981 in chips) 
Seat 8: Manon947 (2214 in chips) 
Seat 9: dddocky (6888 in chips) 
Manon947: posts small blind 50
dddocky: posts big blind 100
*** HOLE CARDS ***
Dealt to Duke Croix [Qc Ad]
color_singleton: folds 
yairpinto: folds 
Duke Croix: raises 300 to 400
rogierk449: folds 
Manon947: folds 
dddocky: folds 
Uncalled bet (300) returned to Duke Croix
Duke Croix collected 250 from pot
*** SUMMARY ***
Total pot 250 | Rake 0 
Seat 1: color_singleton folded before Flop (didn't bet)
Seat 2: yairpinto folded before Flop (didn't bet)
Seat 3: Duke Croix collected (250)
Seat 4: rogierk449 (button) folded before Flop (didn't bet)
Seat 8: Manon947 (small blind) folded before Flop
Seat 9: dddocky (big blind) folded before Flop



PokerStars Home Game Hand #216955291614: {Club #3225207}  Hold'em No Limit (50/100) - 2020/07/30 16:57:02 ET
Table 'JansPokergame' 9-max (Play Money) Seat #8 is the button
Seat 1: color_singleton (10056 in chips) 
Seat 2: yairpinto (21399 in chips) 
Seat 3: Duke Croix (15375 in chips) 
Seat 4: rogierk449 (23981 in chips) 
Seat 8: Manon947 (2164 in chips) 
Seat 9: dddocky (6788 in chips) 
dddocky: posts small blind 50
color_singleton: posts big blind 100
*** HOLE CARDS ***
Dealt to Duke Croix [Jc 6c]
yairpinto: folds 
Duke Croix: folds 
rogierk449: folds 
Manon947: calls 100
dddocky: calls 50
color_singleton: checks 
*** FLOP *** [Kc Js 4c]
dddocky: checks 
color_singleton: checks 
Manon947: bets 141
dddocky: calls 141
color_singleton: folds 
*** TURN *** [Kc Js 4c] [7d]
dddocky: checks 
Manon947: bets 275
dddocky: folds 
Uncalled bet (275) returned to Manon947
Manon947 collected 550 from pot
*** SUMMARY ***
Total pot 582 | Rake 32 
Board [Kc Js 4c 7d]
Seat 1: color_singleton (big blind) folded on the Flop
Seat 2: yairpinto folded before Flop (didn't bet)
Seat 3: Duke Croix folded before Flop (didn't bet)
Seat 4: rogierk449 folded before Flop (didn't bet)
Seat 8: Manon947 (button) collected (550)
Seat 9: dddocky (small blind) folded on the Turn



PokerStars Home Game Hand #216955311088: {Club #3225207}  Hold'em No Limit (50/100) - 2020/07/30 16:57:45 ET
Table 'JansPokergame' 9-max (Play Money) Seat #9 is the button
Seat 1: color_singleton (9956 in chips) 
Seat 2: yairpinto (21399 in chips) 
Seat 3: Duke Croix (15375 in chips) 
Seat 4: rogierk449 (23981 in chips) 
Seat 8: Manon947 (2473 in chips) 
Seat 9: dddocky (6547 in chips) 
color_singleton: posts small blind 50
yairpinto: posts big blind 100
*** HOLE CARDS ***
Dealt to Duke Croix [8h 6d]
Duke Croix: folds 
rogierk449: folds 
Manon947: calls 100
dddocky: calls 100
color_singleton: folds 
yairpinto: checks 
*** FLOP *** [Kd Qh 3s]
yairpinto: checks 
Manon947: bets 165
dddocky: calls 165
yairpinto: folds 
*** TURN *** [Kd Qh 3s] [Ac]
Manon947: checks 
dddocky: checks 
*** RIVER *** [Kd Qh 3s Ac] [9h]
Manon947: bets 321
dddocky: calls 321
*** SHOW DOWN ***
Manon947: shows [5h 5c] (a pair of Fives)
dddocky: shows [Qc 8c] (a pair of Queens)
dddocky collected 1249 from pot
*** SUMMARY ***
Total pot 1322 | Rake 73 
Board [Kd Qh 3s Ac 9h]
Seat 1: color_singleton (small blind) folded before Flop
Seat 2: yairpinto (big blind) folded on the Flop
Seat 3: Duke Croix folded before Flop (didn't bet)
Seat 4: rogierk449 folded before Flop (didn't bet)
Seat 8: Manon947 showed [5h 5c] and lost with a pair of Fives
Seat 9: dddocky (button) showed [Qc 8c] and won (1249) with a pair of Queens



PokerStars Home Game Hand #216955328274: {Club #3225207}  Hold'em No Limit (50/100) - 2020/07/30 16:58:23 ET
Table 'JansPokergame' 9-max (Play Money) Seat #1 is the button
Seat 1: color_singleton (9906 in chips) 
Seat 2: yairpinto (21299 in chips) 
Seat 3: Duke Croix (15375 in chips) 
Seat 4: rogierk449 (23981 in chips) 
Seat 8: Manon947 (1887 in chips) 
Seat 9: dddocky (7210 in chips) 
yairpinto: posts small blind 50
Duke Croix: posts big blind 100
*** HOLE CARDS ***
Dealt to Duke Croix [Ts Tc]
rogierk449: raises 200 to 300
Manon947: calls 300
dddocky: folds 
color_singleton: folds 
yairpinto: folds 
Duke Croix: calls 200
*** FLOP *** [7c 3c 9d]
Duke Croix: bets 400
rogierk449: folds 
Manon947: folds 
Uncalled bet (400) returned to Duke Croix
Duke Croix collected 898 from pot
*** SUMMARY ***
Total pot 950 | Rake 52 
Board [7c 3c 9d]
Seat 1: color_singleton (button) folded before Flop (didn't bet)
Seat 2: yairpinto (small blind) folded before Flop
Seat 3: Duke Croix (big blind) collected (898)
Seat 4: rogierk449 folded on the Flop
Seat 8: Manon947 folded on the Flop
Seat 9: dddocky folded before Flop (didn't bet)



PokerStars Home Game Hand #216955341510: {Club #3225207}  Hold'em No Limit (50/100) - 2020/07/30 16:58:52 ET
Table 'JansPokergame' 9-max (Play Money) Seat #2 is the button
Seat 1: color_singleton (9906 in chips) 
Seat 2: yairpinto (21249 in chips) 
Seat 3: Duke Croix (15973 in chips) 
Seat 4: rogierk449 (23681 in chips) 
Seat 8: Manon947 (1587 in chips) 
Seat 9: dddocky (7210 in chips) 
Duke Croix: posts small blind 50
rogierk449: posts big blind 100
*** HOLE CARDS ***
Dealt to Duke Croix [2c Qc]
Manon947: calls 100
dddocky: folds 
color_singleton: calls 100
yairpinto: calls 100
Duke Croix: calls 50
rogierk449: checks 
*** FLOP *** [Js Qh Td]
Duke Croix: bets 300
rogierk449: folds 
Manon947: calls 300
color_singleton: folds 
yairpinto: calls 300
*** TURN *** [Js Qh Td] [3c]
Duke Croix: bets 600
Manon947: folds 
yairpinto: calls 600
*** RIVER *** [Js Qh Td 3c] [5h]
Duke Croix: bets 1000
yairpinto: folds 
Uncalled bet (1000) returned to Duke Croix
Duke Croix collected 2457 from pot
*** SUMMARY ***
Total pot 2600 | Rake 143 
Board [Js Qh Td 3c 5h]
Seat 1: color_singleton folded on the Flop
Seat 2: yairpinto (button) folded on the River
Seat 3: Duke Croix (small blind) collected (2457)
Seat 4: rogierk449 (big blind) folded on the Flop
Seat 8: Manon947 folded on the Turn
Seat 9: dddocky folded before Flop (didn't bet)



PokerStars Home Game Hand #216955369280: {Club #3225207}  Hold'em No Limit (50/100) - 2020/07/30 16:59:54 ET
Table 'JansPokergame' 9-max (Play Money) Seat #3 is the button
Seat 1: color_singleton (9806 in chips) 
Seat 2: yairpinto (20249 in chips) 
Seat 3: Duke Croix (17430 in chips) 
Seat 4: rogierk449 (23581 in chips) 
Seat 8: Manon947 (1187 in chips) 
Seat 9: dddocky (7210 in chips) 
rogierk449: posts small blind 50
Manon947: posts big blind 100
*** HOLE CARDS ***
Dealt to Duke Croix [6s 2c]
dddocky: folds 
color_singleton: folds 
yairpinto: folds 
Duke Croix: folds 
rogierk449 has timed out
rogierk449: folds 
Uncalled bet (50) returned to Manon947
Manon947 collected 100 from pot
*** SUMMARY ***
Total pot 100 | Rake 0 
Seat 1: color_singleton folded before Flop (didn't bet)
Seat 2: yairpinto folded before Flop (didn't bet)
Seat 3: Duke Croix (button) folded before Flop (didn't bet)
Seat 4: rogierk449 (small blind) folded before Flop
Seat 8: Manon947 (big blind) collected (100)
Seat 9: dddocky folded before Flop (didn't bet)



PokerStars Home Game Hand #216955384261: {Club #3225207}  Hold'em No Limit (50/100) - 2020/07/30 17:00:25 ET
Table 'JansPokergame' 9-max (Play Money) Seat #8 is the button
Seat 1: color_singleton (9806 in chips) 
Seat 2: yairpinto (20249 in chips) 
Seat 3: Duke Croix (17430 in chips) 
Seat 8: Manon947 (1237 in chips) 
Seat 9: dddocky (7210 in chips) 
dddocky: posts small blind 50
color_singleton: posts big blind 100
*** HOLE CARDS ***
Dealt to Duke Croix [4h 2d]
yairpinto: folds 
Duke Croix: folds 
Manon947: raises 100 to 200
dddocky: folds 
color_singleton: calls 100
*** FLOP *** [Jc 5d 3s]
color_singleton: bets 212
Manon947: calls 212
*** TURN *** [Jc 5d 3s] [9c]
color_singleton: bets 413
Manon947: calls 413
*** RIVER *** [Jc 5d 3s 9c] [2h]
color_singleton: checks 
Manon947: bets 412 and is all-in
color_singleton: calls 412
*** SHOW DOWN ***
Manon947: shows [Qd Qh] (a pair of Queens)
color_singleton: shows [4s 5s] (a pair of Fives)
Manon947 collected 2385 from pot
*** SUMMARY ***
Total pot 2524 | Rake 139 
Board [Jc 5d 3s 9c 2h]
Seat 1: color_singleton (big blind) showed [4s 5s] and lost with a pair of Fives
Seat 2: yairpinto folded before Flop (didn't bet)
Seat 3: Duke Croix folded before Flop (didn't bet)
Seat 8: Manon947 (button) showed [Qd Qh] and won (2385) with a pair of Queens
Seat 9: dddocky (small blind) folded before Flop



PokerStars Home Game Hand #216955407409: {Club #3225207}  Hold'em No Limit (50/100) - 2020/07/30 17:01:10 ET
Table 'JansPokergame' 9-max (Play Money) Seat #9 is the button
Seat 1: color_singleton (8569 in chips) 
Seat 2: yairpinto (20249 in chips) 
Seat 3: Duke Croix (17430 in chips) 
Seat 8: Manon947 (2385 in chips) 
Seat 9: dddocky (7160 in chips) 
color_singleton: posts small blind 50
yairpinto: posts big blind 100
*** HOLE CARDS ***
Dealt to Duke Croix [5s 6c]
Duke Croix: calls 100
Manon947: calls 100
dddocky: calls 100
color_singleton: raises 200 to 300
yairpinto: folds 
Duke Croix: calls 200
Manon947: calls 200
dddocky: calls 200
*** FLOP *** [7h Qs Ts]
color_singleton: checks 
Duke Croix: checks 
Manon947: checks 
dddocky: checks 
*** TURN *** [7h Qs Ts] [4h]
color_singleton: checks 
Duke Croix: checks 
Manon947: checks 
dddocky: checks 
*** RIVER *** [7h Qs Ts 4h] [Tc]
color_singleton: checks 
Duke Croix: bets 700
Manon947: folds 
dddocky: folds 
color_singleton: folds 
Uncalled bet (700) returned to Duke Croix
Duke Croix collected 1228 from pot
*** SUMMARY ***
Total pot 1300 | Rake 72 
Board [7h Qs Ts 4h Tc]
Seat 1: color_singleton (small blind) folded on the River
Seat 2: yairpinto (big blind) folded before Flop
Seat 3: Duke Croix collected (1228)
Seat 8: Manon947 folded on the River
Seat 9: dddocky (button) folded on the River



PokerStars Home Game Hand #216955440863: {Club #3225207}  Hold'em No Limit (50/100) - 2020/07/30 17:02:07 ET
Table 'JansPokergame' 9-max (Play Money) Seat #1 is the button
Seat 1: color_singleton (8269 in chips) 
Seat 2: yairpinto (20149 in chips) 
Seat 3: Duke Croix (18358 in chips) 
Seat 8: Manon947 (2085 in chips) 
Seat 9: dddocky (6860 in chips) 
yairpinto: posts small blind 50
Duke Croix: posts big blind 100
*** HOLE CARDS ***
Dealt to Duke Croix [6s Jc]
Manon947: folds 
dddocky: folds 
color_singleton: raises 200 to 300
yairpinto: folds 
Duke Croix: calls 200
*** FLOP *** [Th 9c 2s]
Duke Croix: checks 
color_singleton: bets 307
Duke Croix: folds 
Uncalled bet (307) returned to color_singleton
color_singleton collected 614 from pot
color_singleton: doesn't show hand 
*** SUMMARY ***
Total pot 650 | Rake 36 
Board [Th 9c 2s]
Seat 1: color_singleton (button) collected (614)
Seat 2: yairpinto (small blind) folded before Flop
Seat 3: Duke Croix (big blind) folded on the Flop
Seat 8: Manon947 folded before Flop (didn't bet)
Seat 9: dddocky folded before Flop (didn't bet)



PokerStars Home Game Hand #216955452961: {Club #3225207}  Hold'em No Limit (50/100) - 2020/07/30 17:02:27 ET
Table 'JansPokergame' 9-max (Play Money) Seat #2 is the button
Seat 1: color_singleton (8583 in chips) 
Seat 2: yairpinto (20099 in chips) 
Seat 3: Duke Croix (18058 in chips) 
Seat 9: dddocky (6860 in chips) 
Duke Croix: posts small blind 50
dddocky: posts big blind 100
*** HOLE CARDS ***
Dealt to Duke Croix [Qs 8s]
color_singleton: raises 200 to 300
yairpinto: folds 
Duke Croix: calls 250
dddocky: folds 
*** FLOP *** [Ad Th 5s]
Duke Croix: checks 
color_singleton: bets 330
Duke Croix: folds 
Uncalled bet (330) returned to color_singleton
color_singleton collected 661 from pot
color_singleton: doesn't show hand 
*** SUMMARY ***
Total pot 700 | Rake 39 
Board [Ad Th 5s]
Seat 1: color_singleton collected (661)
Seat 2: yairpinto (button) folded before Flop (didn't bet)
Seat 3: Duke Croix (small blind) folded on the Flop
Seat 9: dddocky (big blind) folded before Flop



PokerStars Home Game Hand #216955460656: {Club #3225207}  Hold'em No Limit (50/100) - 2020/07/30 17:02:41 ET
Table 'JansPokergame' 9-max (Play Money) Seat #3 is the button
Seat 1: color_singleton (8944 in chips) 
Seat 2: yairpinto (20099 in chips) 
Seat 3: Duke Croix (17758 in chips) 
Seat 9: dddocky (6760 in chips) 
dddocky: posts small blind 50
color_singleton: posts big blind 100
*** HOLE CARDS ***
Dealt to Duke Croix [5c 3h]
yairpinto: folds 
Duke Croix: folds 
dddocky: folds 
Uncalled bet (50) returned to color_singleton
color_singleton collected 100 from pot
color_singleton: doesn't show hand 
*** SUMMARY ***
Total pot 100 | Rake 0 
Seat 1: color_singleton (big blind) collected (100)
Seat 2: yairpinto folded before Flop (didn't bet)
Seat 3: Duke Croix (button) folded before Flop (didn't bet)
Seat 9: dddocky (small blind) folded before Flop



PokerStars Home Game Hand #216955465647: {Club #3225207}  Hold'em No Limit (50/100) - 2020/07/30 17:02:49 ET
Table 'JansPokergame' 9-max (Play Money) Seat #9 is the button
Seat 1: color_singleton (8994 in chips) 
Seat 2: yairpinto (20099 in chips) 
Seat 3: Duke Croix (17758 in chips) 
Seat 4: rogierk449 (23531 in chips) 
Seat 9: dddocky (6710 in chips) 
color_singleton: posts small blind 50
yairpinto: posts big blind 100
rogierk449: posts small & big blinds 150
*** HOLE CARDS ***
Dealt to Duke Croix [2h 3d]
Duke Croix: folds 
rogierk449: checks 
dddocky: calls 100
color_singleton: raises 200 to 300
yairpinto: folds 
rogierk449: calls 200
dddocky: calls 200
*** FLOP *** [Js 9s 3c]
color_singleton: checks 
rogierk449: checks 
dddocky: checks 
*** TURN *** [Js 9s 3c] [6d]
color_singleton: checks 
rogierk449: checks 
dddocky: checks 
*** RIVER *** [Js 9s 3c 6d] [5d]
color_singleton: checks 
rogierk449: bets 496
dddocky: folds 
color_singleton: folds 
Uncalled bet (496) returned to rogierk449
rogierk449 collected 992 from pot
rogierk449: doesn't show hand 
*** SUMMARY ***
Total pot 1050 | Rake 58 
Board [Js 9s 3c 6d 5d]
Seat 1: color_singleton (small blind) folded on the River
Seat 2: yairpinto (big blind) folded before Flop
Seat 3: Duke Croix folded before Flop (didn't bet)
Seat 4: rogierk449 collected (992)
Seat 9: dddocky (button) folded on the River



PokerStars Home Game Hand #216955501463: {Club #3225207}  Hold'em No Limit (50/100) - 2020/07/30 17:03:49 ET
Table 'JansPokergame' 9-max (Play Money) Seat #1 is the button
Seat 1: color_singleton (8694 in chips) 
Seat 2: yairpinto (19999 in chips) 
Seat 3: Duke Croix (17758 in chips) 
Seat 4: rogierk449 (24173 in chips) 
Seat 8: Manon947 (2085 in chips) 
Seat 9: dddocky (6410 in chips) 
yairpinto: posts small blind 50
Duke Croix: posts big blind 100
Manon947: posts small & big blinds 150
*** HOLE CARDS ***
Dealt to Duke Croix [Qd 7s]
rogierk449 has timed out
rogierk449: folds 
Manon947: raises 100 to 200
dddocky: folds 
color_singleton: folds 
yairpinto: folds 
Duke Croix: calls 100
*** FLOP *** [Td Jh Jc]
Duke Croix: checks 
Manon947: bets 472
Duke Croix: folds 
Uncalled bet (472) returned to Manon947
Manon947 collected 472 from pot
*** SUMMARY ***
Total pot 500 | Rake 28 
Board [Td Jh Jc]
Seat 1: color_singleton (button) folded before Flop (didn't bet)
Seat 2: yairpinto (small blind) folded before Flop
Seat 3: Duke Croix (big blind) folded on the Flop
Seat 4: rogierk449 folded before Flop (didn't bet)
Seat 8: Manon947 collected (472)
Seat 9: dddocky folded before Flop (didn't bet)



PokerStars Home Game Hand #216955530507: {Club #3225207}  Hold'em No Limit (50/100) - 2020/07/30 17:04:38 ET
Table 'JansPokergame' 9-max (Play Money) Seat #2 is the button
Seat 1: color_singleton (8694 in chips) 
Seat 2: yairpinto (19949 in chips) 
Seat 3: Duke Croix (17558 in chips) 
Seat 4: rogierk449 (24173 in chips) 
Seat 8: Manon947 (2307 in chips) 
Seat 9: dddocky (6410 in chips) 
Duke Croix: posts small blind 50
rogierk449: posts big blind 100
*** HOLE CARDS ***
Dealt to Duke Croix [Qh Jh]
Manon947: folds 
dddocky: folds 
color_singleton: calls 100
yairpinto: folds 
Duke Croix: raises 300 to 400
rogierk449: calls 300
color_singleton: calls 300
*** FLOP *** [Ac Kd Qs]
Duke Croix: checks 
rogierk449: bets 300
color_singleton: calls 300
Duke Croix: calls 300
*** TURN *** [Ac Kd Qs] [Jc]
Duke Croix: checks 
rogierk449: checks 
color_singleton: checks 
*** RIVER *** [Ac Kd Qs Jc] [6h]
Duke Croix: checks 
rogierk449: checks 
color_singleton: bets 992
Duke Croix: calls 992
rogierk449: folds 
*** SHOW DOWN ***
color_singleton: shows [Th 8s] (a straight, Ten to Ace)
Duke Croix: mucks hand 
color_singleton collected 3859 from pot
*** SUMMARY ***
Total pot 4084 | Rake 225 
Board [Ac Kd Qs Jc 6h]
Seat 1: color_singleton showed [Th 8s] and won (3859) with a straight, Ten to Ace
Seat 2: yairpinto (button) folded before Flop (didn't bet)
Seat 3: Duke Croix (small blind) mucked [Qh Jh]
Seat 4: rogierk449 (big blind) folded on the River
Seat 8: Manon947 folded before Flop (didn't bet)
Seat 9: dddocky folded before Flop (didn't bet)



PokerStars Home Game Hand #216955567572: {Club #3225207}  Hold'em No Limit (50/100) - 2020/07/30 17:05:40 ET
Table 'JansPokergame' 9-max (Play Money) Seat #3 is the button
Seat 1: color_singleton (10861 in chips) 
Seat 2: yairpinto (19949 in chips) 
Seat 3: Duke Croix (15866 in chips) 
Seat 4: rogierk449 (23473 in chips) 
Seat 8: Manon947 (2307 in chips) 
Seat 9: dddocky (6410 in chips) 
rogierk449: posts small blind 50
Manon947: posts big blind 100
*** HOLE CARDS ***
Dealt to Duke Croix [Kd Tc]
dddocky: calls 100
color_singleton: folds 
yairpinto: folds 
Duke Croix: calls 100
rogierk449: calls 50
Manon947: checks 
*** FLOP *** [Ac Jc 2d]
rogierk449: checks 
Manon947: checks 
dddocky: checks 
Duke Croix: checks 
*** TURN *** [Ac Jc 2d] [3d]
rogierk449: bets 189
Manon947: calls 189
dddocky: folds 
Duke Croix: folds 
*** RIVER *** [Ac Jc 2d 3d] [4c]
rogierk449: bets 367
Manon947: folds 
Uncalled bet (367) returned to rogierk449
rogierk449 collected 735 from pot
rogierk449: doesn't show hand 
*** SUMMARY ***
Total pot 778 | Rake 43 
Board [Ac Jc 2d 3d 4c]
Seat 1: color_singleton folded before Flop (didn't bet)
Seat 2: yairpinto folded before Flop (didn't bet)
Seat 3: Duke Croix (button) folded on the Turn
Seat 4: rogierk449 (small blind) collected (735)
Seat 8: Manon947 (big blind) folded on the River
Seat 9: dddocky folded on the Turn



PokerStars Home Game Hand #216955591475: {Club #3225207}  Hold'em No Limit (50/100) - 2020/07/30 17:06:20 ET
Table 'JansPokergame' 9-max (Play Money) Seat #4 is the button
Seat 1: color_singleton (10861 in chips) 
Seat 2: yairpinto (19949 in chips) 
Seat 3: Duke Croix (15766 in chips) 
Seat 4: rogierk449 (23919 in chips) 
Seat 8: Manon947 (2018 in chips) 
Seat 9: dddocky (6310 in chips) 
Manon947: posts small blind 50
dddocky: posts big blind 100
*** HOLE CARDS ***
Dealt to Duke Croix [Kc Ad]
color_singleton: folds 
yairpinto: folds 
Duke Croix: raises 300 to 400
rogierk449: folds 
Manon947: calls 350
dddocky: calls 300
*** FLOP *** [Ah Qs 8c]
Manon947: checks 
dddocky: checks 
Duke Croix: bets 700
Manon947: folds 
dddocky: calls 700
*** TURN *** [Ah Qs 8c] [6h]
dddocky: checks 
Duke Croix: bets 1300
dddocky: raises 1300 to 2600
Duke Croix: calls 1300
*** RIVER *** [Ah Qs 8c 6h] [7s]
dddocky: checks 
Duke Croix: checks 
*** SHOW DOWN ***
dddocky: shows [6s As] (two pair, Aces and Sixes)
Duke Croix: mucks hand 
dddocky collected 7371 from pot
*** SUMMARY ***
Total pot 7800 | Rake 429 
Board [Ah Qs 8c 6h 7s]
Seat 1: color_singleton folded before Flop (didn't bet)
Seat 2: yairpinto folded before Flop (didn't bet)
Seat 3: Duke Croix mucked [Kc Ad]
Seat 4: rogierk449 (button) folded before Flop (didn't bet)
Seat 8: Manon947 (small blind) folded on the Flop
Seat 9: dddocky (big blind) showed [6s As] and won (7371) with two pair, Aces and Sixes



PokerStars Home Game Hand #216955622242: {Club #3225207}  Hold'em No Limit (50/100) - 2020/07/30 17:07:12 ET
Table 'JansPokergame' 9-max (Play Money) Seat #8 is the button
Seat 1: color_singleton (10861 in chips) 
Seat 2: yairpinto (19949 in chips) 
Seat 3: Duke Croix (12066 in chips) 
Seat 4: rogierk449 (23919 in chips) 
Seat 8: Manon947 (1618 in chips) 
Seat 9: dddocky (9981 in chips) 
dddocky: posts small blind 50
color_singleton: posts big blind 100
*** HOLE CARDS ***
Dealt to Duke Croix [Jh Jc]
yairpinto: calls 100
Duke Croix: raises 300 to 400
rogierk449: folds 
Manon947: folds 
dddocky: calls 350
color_singleton: calls 300
yairpinto: calls 300
*** FLOP *** [5s 2c Qh]
dddocky: checks 
color_singleton: bets 756
yairpinto: folds 
Duke Croix: folds 
dddocky: calls 756
*** TURN *** [5s 2c Qh] [Ad]
dddocky: checks 
color_singleton: checks 
*** RIVER *** [5s 2c Qh Ad] [6s]
dddocky: checks 
color_singleton: checks 
*** SHOW DOWN ***
dddocky: shows [9s Qc] (a pair of Queens)
color_singleton: shows [Qs Jd] (a pair of Queens - Ace+Jack kicker)
color_singleton collected 2941 from pot
*** SUMMARY ***
Total pot 3112 | Rake 171 
Board [5s 2c Qh Ad 6s]
Seat 1: color_singleton (big blind) showed [Qs Jd] and won (2941) with a pair of Queens
Seat 2: yairpinto folded on the Flop
Seat 3: Duke Croix folded on the Flop
Seat 4: rogierk449 folded before Flop (didn't bet)
Seat 8: Manon947 (button) folded before Flop (didn't bet)
Seat 9: dddocky (small blind) showed [9s Qc] and lost with a pair of Queens



PokerStars Home Game Hand #216955647233: {Club #3225207}  Hold'em No Limit (50/100) - 2020/07/30 17:07:54 ET
Table 'JansPokergame' 9-max (Play Money) Seat #9 is the button
Seat 1: color_singleton (12646 in chips) 
Seat 2: yairpinto (19549 in chips) 
Seat 3: Duke Croix (11666 in chips) 
Seat 4: rogierk449 (23919 in chips) 
Seat 8: Manon947 (1618 in chips) 
Seat 9: dddocky (8825 in chips) 
color_singleton: posts small blind 50
yairpinto: posts big blind 100
*** HOLE CARDS ***
Dealt to Duke Croix [5c Ts]
Duke Croix: folds 
rogierk449: folds 
Manon947: calls 100
dddocky: folds 
color_singleton: raises 100 to 200
yairpinto: folds 
Manon947: calls 100
*** FLOP *** [9h Qc Js]
color_singleton: checks 
Manon947: bets 236
color_singleton: folds 
Uncalled bet (236) returned to Manon947
Manon947 collected 472 from pot
*** SUMMARY ***
Total pot 500 | Rake 28 
Board [9h Qc Js]
Seat 1: color_singleton (small blind) folded on the Flop
Seat 2: yairpinto (big blind) folded before Flop
Seat 3: Duke Croix folded before Flop (didn't bet)
Seat 4: rogierk449 folded before Flop (didn't bet)
Seat 8: Manon947 collected (472)
Seat 9: dddocky (button) folded before Flop (didn't bet)



PokerStars Home Game Hand #216955674013: {Club #3225207}  Hold'em No Limit (50/100) - 2020/07/30 17:08:38 ET
Table 'JansPokergame' 9-max (Play Money) Seat #1 is the button
Seat 1: color_singleton (12446 in chips) 
Seat 2: yairpinto (19449 in chips) 
Seat 3: Duke Croix (11666 in chips) 
Seat 4: rogierk449 (23919 in chips) 
Seat 8: Manon947 (1890 in chips) 
Seat 9: dddocky (8825 in chips) 
yairpinto: posts small blind 50
Duke Croix: posts big blind 100
*** HOLE CARDS ***
Dealt to Duke Croix [Tc Kh]
rogierk449: folds 
Manon947: calls 100
dddocky: calls 100
color_singleton: folds 
yairpinto: calls 50
Duke Croix: raises 500 to 600
Manon947: folds 
dddocky: calls 500
yairpinto: folds 
*** FLOP *** [3d Ah 2h]
Duke Croix: checks 
dddocky: bets 100
Duke Croix: calls 100
*** TURN *** [3d Ah 2h] [Jd]
Duke Croix: checks 
dddocky: bets 100
Duke Croix: calls 100
*** RIVER *** [3d Ah 2h Jd] [Qc]
Duke Croix: bets 1700
dddocky: raises 1700 to 3400
Duke Croix: raises 1700 to 5100
dddocky: calls 1700
*** SHOW DOWN ***
Duke Croix: shows [Tc Kh] (a straight, Ten to Ace)
dddocky: mucks hand 
Duke Croix collected 11340 from pot
*** SUMMARY ***
Total pot 12000 | Rake 660 
Board [3d Ah 2h Jd Qc]
Seat 1: color_singleton (button) folded before Flop (didn't bet)
Seat 2: yairpinto (small blind) folded before Flop
Seat 3: Duke Croix (big blind) showed [Tc Kh] and won (11340) with a straight, Ten to Ace
Seat 4: rogierk449 folded before Flop (didn't bet)
Seat 8: Manon947 folded before Flop
Seat 9: dddocky mucked [Js Jh]



PokerStars Home Game Hand #216955706408: {Club #3225207}  Hold'em No Limit (50/100) - 2020/07/30 17:09:33 ET
Table 'JansPokergame' 9-max (Play Money) Seat #2 is the button
Seat 1: color_singleton (12446 in chips) 
Seat 2: yairpinto (19349 in chips) 
Seat 3: Duke Croix (17106 in chips) 
Seat 4: rogierk449 (23919 in chips) 
Seat 8: Manon947 (1790 in chips) 
Seat 9: dddocky (2925 in chips) 
Duke Croix: posts small blind 50
rogierk449: posts big blind 100
*** HOLE CARDS ***
Dealt to Duke Croix [6d 7s]
Manon947: calls 100
dddocky: folds 
color_singleton: folds 
yairpinto: calls 100
Duke Croix: calls 50
rogierk449: checks 
*** FLOP *** [Js 2c 4d]
Duke Croix: checks 
rogierk449 has timed out
rogierk449: checks 
Manon947: checks 
yairpinto: bets 189
Duke Croix: folds 
rogierk449: calls 189
Manon947: calls 189
*** TURN *** [Js 2c 4d] [Jc]
rogierk449 has timed out
rogierk449: checks 
Manon947: checks 
yairpinto: checks 
*** RIVER *** [Js 2c 4d Jc] [Ac]
rogierk449 has timed out
rogierk449: checks 
Manon947: checks 
yairpinto: checks 
*** SHOW DOWN ***
rogierk449: shows [6s 2d] (two pair, Jacks and Deuces)
Manon947: mucks hand 
yairpinto: mucks hand 
rogierk449 collected 914 from pot
*** SUMMARY ***
Total pot 967 | Rake 53 
Board [Js 2c 4d Jc Ac]
Seat 1: color_singleton folded before Flop (didn't bet)
Seat 2: yairpinto (button) mucked [8h Kc]
Seat 3: Duke Croix (small blind) folded on the Flop
Seat 4: rogierk449 (big blind) showed [6s 2d] and won (914) with two pair, Jacks and Deuces
Seat 8: Manon947 mucked [5h Kd]
Seat 9: dddocky folded before Flop (didn't bet)



PokerStars Home Game Hand #216955778452: {Club #3225207}  Hold'em No Limit (50/100) - 2020/07/30 17:11:34 ET
Table 'JansPokergame' 9-max (Play Money) Seat #3 is the button
Seat 1: color_singleton (12446 in chips) 
Seat 2: yairpinto (19060 in chips) 
Seat 3: Duke Croix (17006 in chips) 
Seat 4: rogierk449 (24544 in chips) 
Seat 8: Manon947 (1501 in chips) 
Seat 9: dddocky (2925 in chips) 
rogierk449: posts small blind 50
Manon947: posts big blind 100
*** HOLE CARDS ***
Dealt to Duke Croix [9h 6h]
dddocky: folds 
color_singleton: folds 
yairpinto: folds 
Duke Croix: folds 
rogierk449: folds 
Uncalled bet (50) returned to Manon947
Manon947 collected 100 from pot
*** SUMMARY ***
Total pot 100 | Rake 0 
Seat 1: color_singleton folded before Flop (didn't bet)
Seat 2: yairpinto folded before Flop (didn't bet)
Seat 3: Duke Croix (button) folded before Flop (didn't bet)
Seat 4: rogierk449 (small blind) folded before Flop
Seat 8: Manon947 (big blind) collected (100)
Seat 9: dddocky folded before Flop (didn't bet)



PokerStars Home Game Hand #216955783642: {Club #3225207}  Hold'em No Limit (50/100) - 2020/07/30 17:11:42 ET
Table 'JansPokergame' 9-max (Play Money) Seat #4 is the button
Seat 1: color_singleton (12446 in chips) 
Seat 2: yairpinto (19060 in chips) 
Seat 3: Duke Croix (17006 in chips) 
Seat 4: rogierk449 (24494 in chips) 
Seat 8: Manon947 (1551 in chips) 
Seat 9: dddocky (2925 in chips) 
Manon947: posts small blind 50
dddocky: posts big blind 100
*** HOLE CARDS ***
Dealt to Duke Croix [8c 3c]
color_singleton: folds 
yairpinto: raises 200 to 300
Duke Croix: folds 
rogierk449: folds 
Manon947: folds 
dddocky: folds 
Uncalled bet (200) returned to yairpinto
yairpinto collected 250 from pot
yairpinto: doesn't show hand 
*** SUMMARY ***
Total pot 250 | Rake 0 
Seat 1: color_singleton folded before Flop (didn't bet)
Seat 2: yairpinto collected (250)
Seat 3: Duke Croix folded before Flop (didn't bet)
Seat 4: rogierk449 (button) folded before Flop (didn't bet)
Seat 8: Manon947 (small blind) folded before Flop
Seat 9: dddocky (big blind) folded before Flop



PokerStars Home Game Hand #216955800928: {Club #3225207}  Hold'em No Limit (50/100) - 2020/07/30 17:12:12 ET
Table 'JansPokergame' 9-max (Play Money) Seat #8 is the button
Seat 1: color_singleton (12446 in chips) 
Seat 2: yairpinto (19210 in chips) 
Seat 3: Duke Croix (17006 in chips) 
Seat 4: rogierk449 (24494 in chips) 
Seat 8: Manon947 (1501 in chips) 
Seat 9: dddocky (2825 in chips) 
dddocky: posts small blind 50
color_singleton: posts big blind 100
*** HOLE CARDS ***
Dealt to Duke Croix [8d 6c]
yairpinto: folds 
Duke Croix: folds 
rogierk449: folds 
Manon947: calls 100
dddocky: folds 
color_singleton: raises 300 to 400
Manon947: calls 300
*** FLOP *** [3h Jh 4s]
color_singleton: bets 1000
Manon947: folds 
Uncalled bet (1000) returned to color_singleton
color_singleton collected 803 from pot
color_singleton: doesn't show hand 
*** SUMMARY ***
Total pot 850 | Rake 47 
Board [3h Jh 4s]
Seat 1: color_singleton (big blind) collected (803)
Seat 2: yairpinto folded before Flop (didn't bet)
Seat 3: Duke Croix folded before Flop (didn't bet)
Seat 4: rogierk449 folded before Flop (didn't bet)
Seat 8: Manon947 (button) folded on the Flop
Seat 9: dddocky (small blind) folded before Flop



PokerStars Home Game Hand #216955820783: {Club #3225207}  Hold'em No Limit (50/100) - 2020/07/30 17:12:45 ET
Table 'JansPokergame' 9-max (Play Money) Seat #9 is the button
Seat 1: color_singleton (12849 in chips) 
Seat 2: yairpinto (19210 in chips) 
Seat 3: Duke Croix (17006 in chips) 
Seat 4: rogierk449 (24494 in chips) 
Seat 8: Manon947 (1101 in chips) 
Seat 9: dddocky (2775 in chips) 
color_singleton: posts small blind 50
yairpinto: posts big blind 100
*** HOLE CARDS ***
Dealt to Duke Croix [Qh Qd]
Duke Croix: raises 300 to 400
rogierk449: folds 
Manon947: folds 
dddocky: calls 400
color_singleton: calls 350
yairpinto: folds 
*** FLOP *** [Kd 2d 5s]
color_singleton: checks 
Duke Croix: checks 
dddocky: bets 100
color_singleton: calls 100
Duke Croix: raises 600 to 700
dddocky: raises 600 to 1300
color_singleton: folds 
Duke Croix: folds 
Uncalled bet (600) returned to dddocky
dddocky collected 2646 from pot
dddocky: doesn't show hand 
*** SUMMARY ***
Total pot 2800 | Rake 154 
Board [Kd 2d 5s]
Seat 1: color_singleton (small blind) folded on the Flop
Seat 2: yairpinto (big blind) folded before Flop
Seat 3: Duke Croix folded on the Flop
Seat 4: rogierk449 folded before Flop (didn't bet)
Seat 8: Manon947 folded before Flop (didn't bet)
Seat 9: dddocky (button) collected (2646)



PokerStars Home Game Hand #216955842851: {Club #3225207}  Hold'em No Limit (50/100) - 2020/07/30 17:13:23 ET
Table 'JansPokergame' 9-max (Play Money) Seat #1 is the button
Seat 1: color_singleton (12349 in chips) 
Seat 2: yairpinto (19110 in chips) 
Seat 3: Duke Croix (15906 in chips) 
Seat 4: rogierk449 (24494 in chips) 
Seat 8: Manon947 (1101 in chips) 
Seat 9: dddocky (4321 in chips) 
yairpinto: posts small blind 50
Duke Croix: posts big blind 100
*** HOLE CARDS ***
Dealt to Duke Croix [7c 9c]
rogierk449: raises 200 to 300
Manon947: calls 300
dddocky: calls 300
color_singleton: folds 
yairpinto: folds 
Duke Croix: calls 200
*** FLOP *** [Qc Js 6h]
Duke Croix: checks 
rogierk449: checks 
Manon947: checks 
dddocky: checks 
*** TURN *** [Qc Js 6h] [Jc]
Duke Croix: bets 600
rogierk449: raises 600 to 1200
Manon947: folds 
dddocky: folds 
Duke Croix: calls 600
*** RIVER *** [Qc Js 6h Jc] [6c]
Duke Croix: checks 
rogierk449: bets 1724
Duke Croix: raises 1724 to 3448
rogierk449: raises 19546 to 22994 and is all-in
Duke Croix: calls 10958 and is all-in
Uncalled bet (8588) returned to rogierk449
*** SHOW DOWN ***
rogierk449: shows [Ad Jd] (a full house, Jacks full of Sixes)
Duke Croix: shows [7c 9c] (a flush, Queen high)
rogierk449 collected 30677 from pot
*** SUMMARY ***
Total pot 32462 | Rake 1785 
Board [Qc Js 6h Jc 6c]
Seat 1: color_singleton (button) folded before Flop (didn't bet)
Seat 2: yairpinto (small blind) folded before Flop
Seat 3: Duke Croix (big blind) showed [7c 9c] and lost with a flush, Queen high
Seat 4: rogierk449 showed [Ad Jd] and won (30677) with a full house, Jacks full of Sixes
Seat 8: Manon947 folded on the Turn
Seat 9: dddocky folded on the Turn



PokerStars Home Game Hand #216955938127: {Club #3225207}  Hold'em No Limit (50/100) - 2020/07/30 17:16:04 ET
Table 'JansPokergame' 9-max (Play Money) Seat #4 is the button
Seat 1: color_singleton (12349 in chips) 
Seat 2: yairpinto (19060 in chips) 
Seat 3: Duke Croix (10000 in chips) 
Seat 4: rogierk449 (38876 in chips) 
Seat 8: Manon947 (1147 in chips) 
Seat 9: dddocky (4021 in chips) 
Manon947: posts small blind 50
dddocky: posts big blind 100
Duke Croix: posts small blind 50
*** HOLE CARDS ***
Dealt to Duke Croix [3h Ac]
color_singleton: folds 
yairpinto: folds 
Duke Croix: raises 200 to 300
rogierk449: calls 300
Manon947: calls 250
dddocky: folds 
*** FLOP *** [Jh Ah 3s]
Manon947: checks 
Duke Croix: bets 500
rogierk449: folds 
Manon947: folds 
Uncalled bet (500) returned to Duke Croix
Duke Croix collected 992 from pot
*** SUMMARY ***
Total pot 1050 | Rake 58 
Board [Jh Ah 3s]
Seat 1: color_singleton folded before Flop (didn't bet)
Seat 2: yairpinto folded before Flop (didn't bet)
Seat 3: Duke Croix collected (992)
Seat 4: rogierk449 (button) folded on the Flop
Seat 8: Manon947 (small blind) folded on the Flop
Seat 9: dddocky (big blind) folded before Flop



PokerStars Home Game Hand #216955955627: {Club #3225207}  Hold'em No Limit (50/100) - 2020/07/30 17:16:33 ET
Table 'JansPokergame' 9-max (Play Money) Seat #8 is the button
Seat 1: color_singleton (12349 in chips) 
Seat 2: yairpinto (19060 in chips) 
Seat 3: Duke Croix (10642 in chips) 
Seat 4: rogierk449 (38576 in chips) 
Seat 8: Manon947 (847 in chips) 
Seat 9: dddocky (3921 in chips) 
dddocky: posts small blind 50
color_singleton: posts big blind 100
*** HOLE CARDS ***
Dealt to Duke Croix [Ks Qh]
yairpinto: folds 
Duke Croix: raises 300 to 400
rogierk449: folds 
Manon947: folds 
dddocky: folds 
color_singleton: folds 
Uncalled bet (300) returned to Duke Croix
Duke Croix collected 250 from pot
*** SUMMARY ***
Total pot 250 | Rake 0 
Seat 1: color_singleton (big blind) folded before Flop
Seat 2: yairpinto folded before Flop (didn't bet)
Seat 3: Duke Croix collected (250)
Seat 4: rogierk449 folded before Flop (didn't bet)
Seat 8: Manon947 (button) folded before Flop (didn't bet)
Seat 9: dddocky (small blind) folded before Flop



PokerStars Home Game Hand #216955965423: {Club #3225207}  Hold'em No Limit (50/100) - 2020/07/30 17:16:50 ET
Table 'JansPokergame' 9-max (Play Money) Seat #9 is the button
Seat 1: color_singleton (12249 in chips) 
Seat 2: yairpinto (19060 in chips) 
Seat 3: Duke Croix (10792 in chips) 
Seat 4: rogierk449 (38576 in chips) 
Seat 8: Manon947 (847 in chips) 
Seat 9: dddocky (3871 in chips) 
color_singleton: posts small blind 50
yairpinto: posts big blind 100
*** HOLE CARDS ***
Dealt to Duke Croix [As Qs]
Duke Croix: raises 300 to 400
rogierk449: folds 
Manon947: calls 400
dddocky: folds 
color_singleton: calls 350
yairpinto: folds 
*** FLOP *** [5d Ah 7h]
color_singleton: checks 
Duke Croix: bets 600
Manon947: folds 
color_singleton: folds 
Uncalled bet (600) returned to Duke Croix
Duke Croix collected 1228 from pot
*** SUMMARY ***
Total pot 1300 | Rake 72 
Board [5d Ah 7h]
Seat 1: color_singleton (small blind) folded on the Flop
Seat 2: yairpinto (big blind) folded before Flop
Seat 3: Duke Croix collected (1228)
Seat 4: rogierk449 folded before Flop (didn't bet)
Seat 8: Manon947 folded on the Flop
Seat 9: dddocky (button) folded before Flop (didn't bet)



PokerStars Home Game Hand #216955979918: {Club #3225207}  Hold'em No Limit (50/100) - 2020/07/30 17:17:14 ET
Table 'JansPokergame' 9-max (Play Money) Seat #1 is the button
Seat 1: color_singleton (11849 in chips) 
Seat 2: yairpinto (18960 in chips) 
Seat 3: Duke Croix (11620 in chips) 
Seat 4: rogierk449 (38576 in chips) 
Seat 8: Manon947 (447 in chips) 
Seat 9: dddocky (3871 in chips) 
yairpinto: posts small blind 50
Duke Croix: posts big blind 100
*** HOLE CARDS ***
Dealt to Duke Croix [3s Jh]
rogierk449: folds 
Manon947: calls 100
dddocky: calls 100
color_singleton: folds 
yairpinto: calls 50
Duke Croix: checks 
*** FLOP *** [9c 4d Ts]
yairpinto: bets 189
Duke Croix: folds 
Manon947: calls 189
dddocky: calls 189
*** TURN *** [9c 4d Ts] [9d]
yairpinto: checks 
Manon947: bets 158 and is all-in
dddocky: folds 
yairpinto: folds 
Uncalled bet (158) returned to Manon947
Manon947 collected 914 from pot
*** SUMMARY ***
Total pot 967 | Rake 53 
Board [9c 4d Ts 9d]
Seat 1: color_singleton (button) folded before Flop (didn't bet)
Seat 2: yairpinto (small blind) folded on the Turn
Seat 3: Duke Croix (big blind) folded on the Flop
Seat 4: rogierk449 folded before Flop (didn't bet)
Seat 8: Manon947 collected (914)
Seat 9: dddocky folded on the Turn



PokerStars Home Game Hand #216956003993: {Club #3225207}  Hold'em No Limit (50/100) - 2020/07/30 17:17:55 ET
Table 'JansPokergame' 9-max (Play Money) Seat #2 is the button
Seat 1: color_singleton (11849 in chips) 
Seat 2: yairpinto (18671 in chips) 
Seat 3: Duke Croix (11520 in chips) 
Seat 4: rogierk449 (38576 in chips) 
Seat 8: Manon947 (1072 in chips) 
Seat 9: dddocky (3582 in chips) 
Duke Croix: posts small blind 50
rogierk449: posts big blind 100
*** HOLE CARDS ***
Dealt to Duke Croix [9h Ts]
Manon947: calls 100
dddocky: calls 100
color_singleton: folds 
yairpinto: folds 
Duke Croix: calls 50
rogierk449: checks 
*** FLOP *** [5s 6d Jh]
Duke Croix: checks 
rogierk449 has timed out
rogierk449: checks 
Manon947: checks 
dddocky: checks 
*** TURN *** [5s 6d Jh] [Kh]
Duke Croix: bets 300
rogierk449: folds 
Manon947: folds 
dddocky: folds 
Uncalled bet (300) returned to Duke Croix
Duke Croix collected 378 from pot
*** SUMMARY ***
Total pot 400 | Rake 22 
Board [5s 6d Jh Kh]
Seat 1: color_singleton folded before Flop (didn't bet)
Seat 2: yairpinto (button) folded before Flop (didn't bet)
Seat 3: Duke Croix (small blind) collected (378)
Seat 4: rogierk449 (big blind) folded on the Turn
Seat 8: Manon947 folded on the Turn
Seat 9: dddocky folded on the Turn



PokerStars Home Game Hand #216956046701: {Club #3225207}  Hold'em No Limit (50/100) - 2020/07/30 17:19:08 ET
Table 'JansPokergame' 9-max (Play Money) Seat #3 is the button
Seat 1: color_singleton (11849 in chips) 
Seat 2: yairpinto (18671 in chips) 
Seat 3: Duke Croix (11798 in chips) 
Seat 4: rogierk449 (38476 in chips) 
Seat 8: Manon947 (972 in chips) 
Seat 9: dddocky (3482 in chips) 
rogierk449: posts small blind 50
Manon947: posts big blind 100
*** HOLE CARDS ***
Dealt to Duke Croix [Qd Kc]
dddocky: folds 
color_singleton: folds 
yairpinto: folds 
Duke Croix: raises 300 to 400
rogierk449: folds 
Manon947: calls 300
*** FLOP *** [7c 4d Js]
Manon947: checks 
Duke Croix: bets 500
Manon947: folds 
Uncalled bet (500) returned to Duke Croix
Duke Croix collected 803 from pot
*** SUMMARY ***
Total pot 850 | Rake 47 
Board [7c 4d Js]
Seat 1: color_singleton folded before Flop (didn't bet)
Seat 2: yairpinto folded before Flop (didn't bet)
Seat 3: Duke Croix (button) collected (803)
Seat 4: rogierk449 (small blind) folded before Flop
Seat 8: Manon947 (big blind) folded on the Flop
Seat 9: dddocky folded before Flop (didn't bet)



PokerStars Home Game Hand #216956068336: {Club #3225207}  Hold'em No Limit (50/100) - 2020/07/30 17:19:45 ET
Table 'JansPokergame' 9-max (Play Money) Seat #4 is the button
Seat 1: color_singleton (11849 in chips) 
Seat 2: yairpinto (18671 in chips) 
Seat 3: Duke Croix (12201 in chips) 
Seat 4: rogierk449 (38426 in chips) 
Seat 8: Manon947 (572 in chips) 
Seat 9: dddocky (3482 in chips) 
Manon947: posts small blind 50
dddocky: posts big blind 100
*** HOLE CARDS ***
Dealt to Duke Croix [8s 9h]
color_singleton: folds 
yairpinto: folds 
Duke Croix: folds 
rogierk449: raises 200 to 300
Manon947: folds 
dddocky: folds 
Uncalled bet (200) returned to rogierk449
rogierk449 collected 250 from pot
rogierk449: doesn't show hand 
*** SUMMARY ***
Total pot 250 | Rake 0 
Seat 1: color_singleton folded before Flop (didn't bet)
Seat 2: yairpinto folded before Flop (didn't bet)
Seat 3: Duke Croix folded before Flop (didn't bet)
Seat 4: rogierk449 (button) collected (250)
Seat 8: Manon947 (small blind) folded before Flop
Seat 9: dddocky (big blind) folded before Flop



PokerStars Home Game Hand #216956079931: {Club #3225207}  Hold'em No Limit (50/100) - 2020/07/30 17:20:05 ET
Table 'JansPokergame' 9-max (Play Money) Seat #8 is the button
Seat 1: color_singleton (11849 in chips) 
Seat 2: yairpinto (18671 in chips) 
Seat 3: Duke Croix (12201 in chips) 
Seat 4: rogierk449 (38576 in chips) 
Seat 8: Manon947 (522 in chips) 
Seat 9: dddocky (3382 in chips) 
dddocky: posts small blind 50
color_singleton: posts big blind 100
*** HOLE CARDS ***
Dealt to Duke Croix [Ts Jc]
yairpinto: folds 
Duke Croix: raises 300 to 400
rogierk449: calls 400
Manon947: folds 
dddocky: folds 
color_singleton: calls 300
*** FLOP *** [5s 6h Js]
color_singleton: checks 
Duke Croix: bets 600
rogierk449: calls 600
color_singleton: folds 
*** TURN *** [5s 6h Js] [Qh]
Duke Croix: bets 1000
rogierk449: calls 1000
*** RIVER *** [5s 6h Js Qh] [2h]
Duke Croix: checks 
rogierk449: checks 
*** SHOW DOWN ***
Duke Croix: shows [Ts Jc] (a pair of Jacks)
rogierk449: mucks hand 
Duke Croix collected 4205 from pot
*** SUMMARY ***
Total pot 4450 | Rake 245 
Board [5s 6h Js Qh 2h]
Seat 1: color_singleton (big blind) folded on the Flop
Seat 2: yairpinto folded before Flop (didn't bet)
Seat 3: Duke Croix showed [Ts Jc] and won (4205) with a pair of Jacks
Seat 4: rogierk449 mucked [8s 7s]
Seat 8: Manon947 (button) folded before Flop (didn't bet)
Seat 9: dddocky (small blind) folded before Flop



PokerStars Home Game Hand #216956107508: {Club #3225207}  Hold'em No Limit (50/100) - 2020/07/30 17:20:52 ET
Table 'JansPokergame' 9-max (Play Money) Seat #9 is the button
Seat 1: color_singleton (11449 in chips) 
Seat 2: yairpinto (18671 in chips) 
Seat 3: Duke Croix (14406 in chips) 
Seat 4: rogierk449 (36576 in chips) 
Seat 8: Manon947 (522 in chips) 
Seat 9: dddocky (3332 in chips) 
color_singleton: posts small blind 50
yairpinto: posts big blind 100
*** HOLE CARDS ***
Dealt to Duke Croix [Jc 9s]
Duke Croix: folds 
rogierk449: calls 100
Manon947: calls 100
dddocky: calls 100
color_singleton: calls 50
yairpinto: checks 
*** FLOP *** [7c 7d 3c]
color_singleton: checks 
yairpinto: checks 
rogierk449: checks 
Manon947: bets 422 and is all-in
dddocky: folds 
color_singleton: folds 
yairpinto: folds 
rogierk449 has timed out
rogierk449: folds 
Uncalled bet (422) returned to Manon947
Manon947 collected 472 from pot
*** SUMMARY ***
Total pot 500 | Rake 28 
Board [7c 7d 3c]
Seat 1: color_singleton (small blind) folded on the Flop
Seat 2: yairpinto (big blind) folded on the Flop
Seat 3: Duke Croix folded before Flop (didn't bet)
Seat 4: rogierk449 folded on the Flop
Seat 8: Manon947 collected (472)
Seat 9: dddocky (button) folded on the Flop



PokerStars Home Game Hand #216956141090: {Club #3225207}  Hold'em No Limit (50/100) - 2020/07/30 17:21:50 ET
Table 'JansPokergame' 9-max (Play Money) Seat #1 is the button
Seat 1: color_singleton (11349 in chips) 
Seat 2: yairpinto (18571 in chips) 
Seat 3: Duke Croix (14406 in chips) 
Seat 8: Manon947 (894 in chips) 
Seat 9: dddocky (3232 in chips) 
yairpinto: posts small blind 50
Duke Croix: posts big blind 100
*** HOLE CARDS ***
Dealt to Duke Croix [8d Ah]
Manon947: folds 
dddocky: calls 100
color_singleton: folds 
yairpinto: calls 50
Duke Croix: checks 
*** FLOP *** [Kc Td 3h]
yairpinto: bets 141
Duke Croix: folds 
dddocky: folds 
Uncalled bet (141) returned to yairpinto
yairpinto collected 283 from pot
yairpinto: doesn't show hand 
*** SUMMARY ***
Total pot 300 | Rake 17 
Board [Kc Td 3h]
Seat 1: color_singleton (button) folded before Flop (didn't bet)
Seat 2: yairpinto (small blind) collected (283)
Seat 3: Duke Croix (big blind) folded on the Flop
Seat 8: Manon947 folded before Flop (didn't bet)
Seat 9: dddocky folded on the Flop



PokerStars Home Game Hand #216956164239: {Club #3225207}  Hold'em No Limit (50/100) - 2020/07/30 17:22:17 ET
Table 'JansPokergame' 9-max (Play Money) Seat #2 is the button
Seat 1: color_singleton (11349 in chips) 
Seat 2: yairpinto (18754 in chips) 
Seat 3: Duke Croix (14306 in chips) 
Seat 8: Manon947 (894 in chips) 
Seat 9: dddocky (3132 in chips) 
Duke Croix: posts small blind 50
Manon947: posts big blind 100
*** HOLE CARDS ***
Dealt to Duke Croix [Qc Kc]
dddocky: folds 
color_singleton: raises 200 to 300
yairpinto: folds 
Duke Croix: raises 400 to 700
Manon947: folds 
color_singleton: folds 
Uncalled bet (400) returned to Duke Croix
Duke Croix collected 700 from pot
*** SUMMARY ***
Total pot 700 | Rake 0 
Seat 1: color_singleton folded before Flop
Seat 2: yairpinto (button) folded before Flop (didn't bet)
Seat 3: Duke Croix (small blind) collected (700)
Seat 8: Manon947 (big blind) folded before Flop
Seat 9: dddocky folded before Flop (didn't bet)



PokerStars Home Game Hand #216956175990: {Club #3225207}  Hold'em No Limit (50/100) - 2020/07/30 17:22:37 ET
Table 'JansPokergame' 9-max (Play Money) Seat #3 is the button
Seat 1: color_singleton (11049 in chips) 
Seat 2: yairpinto (18754 in chips) 
Seat 3: Duke Croix (14706 in chips) 
Seat 8: Manon947 (794 in chips) 
Seat 9: dddocky (3132 in chips) 
Manon947: posts small blind 50
dddocky: posts big blind 100
*** HOLE CARDS ***
Dealt to Duke Croix [5d Js]
color_singleton: folds 
yairpinto: folds 
Duke Croix: folds 
Manon947: folds 
Uncalled bet (50) returned to dddocky
dddocky collected 100 from pot
dddocky: doesn't show hand 
*** SUMMARY ***
Total pot 100 | Rake 0 
Seat 1: color_singleton folded before Flop (didn't bet)
Seat 2: yairpinto folded before Flop (didn't bet)
Seat 3: Duke Croix (button) folded before Flop (didn't bet)
Seat 8: Manon947 (small blind) folded before Flop
Seat 9: dddocky (big blind) collected (100)



PokerStars Home Game Hand #216956181578: {Club #3225207}  Hold'em No Limit (50/100) - 2020/07/30 17:22:47 ET
Table 'JansPokergame' 9-max (Play Money) Seat #8 is the button
Seat 1: color_singleton (11049 in chips) 
Seat 2: yairpinto (18754 in chips) 
Seat 3: Duke Croix (14706 in chips) 
Seat 8: Manon947 (744 in chips) 
Seat 9: dddocky (3182 in chips) 
dddocky: posts small blind 50
color_singleton: posts big blind 100
*** HOLE CARDS ***
Dealt to Duke Croix [Jd 9c]
yairpinto: folds 
Duke Croix: folds 
Manon947: folds 
dddocky: calls 50
color_singleton: raises 200 to 300
dddocky: folds 
Uncalled bet (200) returned to color_singleton
color_singleton collected 200 from pot
color_singleton: doesn't show hand 
*** SUMMARY ***
Total pot 200 | Rake 0 
Seat 1: color_singleton (big blind) collected (200)
Seat 2: yairpinto folded before Flop (didn't bet)
Seat 3: Duke Croix folded before Flop (didn't bet)
Seat 8: Manon947 (button) folded before Flop (didn't bet)
Seat 9: dddocky (small blind) folded before Flop



PokerStars Home Game Hand #216956194446: {Club #3225207}  Hold'em No Limit (50/100) - 2020/07/30 17:23:09 ET
Table 'JansPokergame' 9-max (Play Money) Seat #9 is the button
Seat 1: color_singleton (11149 in chips) 
Seat 2: yairpinto (18754 in chips) 
Seat 3: Duke Croix (14706 in chips) 
Seat 8: Manon947 (744 in chips) 
Seat 9: dddocky (3082 in chips) 
color_singleton: posts small blind 50
yairpinto: posts big blind 100
*** HOLE CARDS ***
Dealt to Duke Croix [Ah 8h]
Duke Croix: raises 300 to 400
Manon947: calls 400
dddocky: folds 
color_singleton: folds 
yairpinto: raises 1250 to 1650
Duke Croix: folds 
Manon947: folds 
Uncalled bet (1250) returned to yairpinto
yairpinto collected 1250 from pot
yairpinto: doesn't show hand 
*** SUMMARY ***
Total pot 1250 | Rake 0 
Seat 1: color_singleton (small blind) folded before Flop
Seat 2: yairpinto (big blind) collected (1250)
Seat 3: Duke Croix folded before Flop
Seat 8: Manon947 folded before Flop
Seat 9: dddocky (button) folded before Flop (didn't bet)



PokerStars Home Game Hand #216956208728: {Club #3225207}  Hold'em No Limit (50/100) - 2020/07/30 17:23:34 ET
Table 'JansPokergame' 9-max (Play Money) Seat #1 is the button
Seat 1: color_singleton (11099 in chips) 
Seat 2: yairpinto (19604 in chips) 
Seat 3: Duke Croix (14306 in chips) 
Seat 8: Manon947 (344 in chips) 
Seat 9: dddocky (3082 in chips) 
yairpinto: posts small blind 50
Duke Croix: posts big blind 100
*** HOLE CARDS ***
Dealt to Duke Croix [Kh 9c]
Manon947: calls 100
dddocky: calls 100
color_singleton: folds 
yairpinto: calls 50
Duke Croix: checks 
*** FLOP *** [2s 3c Kc]
yairpinto: checks 
Duke Croix: bets 200
Manon947: calls 200
dddocky: folds 
yairpinto: folds 
*** TURN *** [2s 3c Kc] [Jh]
Duke Croix: bets 400
Manon947: calls 44 and is all-in
Uncalled bet (356) returned to Duke Croix
*** RIVER *** [2s 3c Kc Jh] [8c]
*** SHOW DOWN ***
Duke Croix: shows [Kh 9c] (a pair of Kings)
Manon947: shows [8h As] (a pair of Eights)
Duke Croix collected 839 from pot
*** SUMMARY ***
Total pot 888 | Rake 49 
Board [2s 3c Kc Jh 8c]
Seat 1: color_singleton (button) folded before Flop (didn't bet)
Seat 2: yairpinto (small blind) folded on the Flop
Seat 3: Duke Croix (big blind) showed [Kh 9c] and won (839) with a pair of Kings
Seat 8: Manon947 showed [8h As] and lost with a pair of Eights
Seat 9: dddocky folded on the Flop



PokerStars Home Game Hand #216956232212: {Club #3225207}  Hold'em No Limit (50/100) - 2020/07/30 17:24:15 ET
Table 'JansPokergame' 9-max (Play Money) Seat #2 is the button
Seat 1: color_singleton (11099 in chips) 
Seat 2: yairpinto (19504 in chips) 
Seat 3: Duke Croix (14801 in chips) 
Seat 4: rogierk449 (36476 in chips) 
Seat 9: dddocky (2982 in chips) 
Duke Croix: posts small blind 50
rogierk449: posts big blind 100
*** HOLE CARDS ***
Dealt to Duke Croix [6c Ac]
dddocky: calls 100
color_singleton: folds 
yairpinto: folds 
Duke Croix: raises 200 to 300
rogierk449: calls 200
dddocky: calls 200
*** FLOP *** [5d Ah Td]
Duke Croix: bets 400
rogierk449: calls 400
dddocky: folds 
*** TURN *** [5d Ah Td] [4d]
Duke Croix: checks 
rogierk449: bets 803
Duke Croix: folds 
Uncalled bet (803) returned to rogierk449
rogierk449 collected 1606 from pot
rogierk449: doesn't show hand 
*** SUMMARY ***
Total pot 1700 | Rake 94 
Board [5d Ah Td 4d]
Seat 1: color_singleton folded before Flop (didn't bet)
Seat 2: yairpinto (button) folded before Flop (didn't bet)
Seat 3: Duke Croix (small blind) folded on the Turn
Seat 4: rogierk449 (big blind) collected (1606)
Seat 9: dddocky folded on the Flop



PokerStars Home Game Hand #216956261882: {Club #3225207}  Hold'em No Limit (50/100) - 2020/07/30 17:25:07 ET
Table 'JansPokergame' 9-max (Play Money) Seat #3 is the button
Seat 1: color_singleton (11099 in chips) 
Seat 2: yairpinto (19504 in chips) 
Seat 3: Duke Croix (14101 in chips) 
Seat 4: rogierk449 (37382 in chips) 
Seat 8: Manon947 (10000 in chips) 
Seat 9: dddocky (2682 in chips) 
rogierk449: posts small blind 50
Manon947: posts big blind 100
*** HOLE CARDS ***
Dealt to Duke Croix [Kc Qs]
dddocky: calls 100
color_singleton: folds 
yairpinto: folds 
Duke Croix: raises 300 to 400
rogierk449: folds 
Manon947: folds 
dddocky: calls 300
*** FLOP *** [6d 3d Js]
dddocky: checks 
Duke Croix: checks 
*** TURN *** [6d 3d Js] [Kd]
dddocky: checks 
Duke Croix: bets 400
dddocky: calls 400
*** RIVER *** [6d 3d Js Kd] [Td]
dddocky: checks 
Duke Croix: checks 
*** SHOW DOWN ***
dddocky: shows [3s Ac] (a pair of Threes)
Duke Croix: shows [Kc Qs] (a pair of Kings)
Duke Croix collected 1654 from pot
*** SUMMARY ***
Total pot 1750 | Rake 96 
Board [6d 3d Js Kd Td]
Seat 1: color_singleton folded before Flop (didn't bet)
Seat 2: yairpinto folded before Flop (didn't bet)
Seat 3: Duke Croix (button) showed [Kc Qs] and won (1654) with a pair of Kings
Seat 4: rogierk449 (small blind) folded before Flop
Seat 8: Manon947 (big blind) folded before Flop
Seat 9: dddocky showed [3s Ac] and lost with a pair of Threes



PokerStars Home Game Hand #216956285752: {Club #3225207}  Hold'em No Limit (50/100) - 2020/07/30 17:25:48 ET
Table 'JansPokergame' 9-max (Play Money) Seat #4 is the button
Seat 1: color_singleton (11099 in chips) 
Seat 2: yairpinto (19504 in chips) 
Seat 3: Duke Croix (14955 in chips) 
Seat 4: rogierk449 (37332 in chips) 
Seat 8: Manon947 (9900 in chips) 
Seat 9: dddocky (1882 in chips) 
Manon947: posts small blind 50
dddocky: posts big blind 100
*** HOLE CARDS ***
Dealt to Duke Croix [8h 5d]
color_singleton: raises 100 to 200
yairpinto: folds 
Duke Croix: folds 
rogierk449: folds 
Manon947: calls 150
dddocky: folds 
*** FLOP *** [7c Qh 5s]
Manon947: checks 
color_singleton: bets 236
Manon947: calls 236
*** TURN *** [7c Qh 5s] [6c]
Manon947: checks 
color_singleton: checks 
*** RIVER *** [7c Qh 5s 6c] [Qd]
Manon947: bets 919
color_singleton: folds 
Uncalled bet (919) returned to Manon947
Manon947 collected 919 from pot
*** SUMMARY ***
Total pot 972 | Rake 53 
Board [7c Qh 5s 6c Qd]
Seat 1: color_singleton folded on the River
Seat 2: yairpinto folded before Flop (didn't bet)
Seat 3: Duke Croix folded before Flop (didn't bet)
Seat 4: rogierk449 (button) folded before Flop (didn't bet)
Seat 8: Manon947 (small blind) collected (919)
Seat 9: dddocky (big blind) folded before Flop



PokerStars Home Game Hand #216956303847: {Club #3225207}  Hold'em No Limit (50/100) - 2020/07/30 17:26:19 ET
Table 'JansPokergame' 9-max (Play Money) Seat #8 is the button
Seat 1: color_singleton (10663 in chips) 
Seat 2: yairpinto (19504 in chips) 
Seat 3: Duke Croix (14955 in chips) 
Seat 4: rogierk449 (37332 in chips) 
Seat 8: Manon947 (10383 in chips) 
Seat 9: dddocky (1782 in chips) 
dddocky: posts small blind 50
color_singleton: posts big blind 100
*** HOLE CARDS ***
Dealt to Duke Croix [5c Td]
yairpinto: raises 200 to 300
Duke Croix: folds 
rogierk449: raises 200 to 500
Manon947: folds 
dddocky: calls 450
color_singleton: calls 400
yairpinto: calls 200
*** FLOP *** [3h Kc 3s]
dddocky: checks 
color_singleton: checks 
yairpinto: checks 
rogierk449: bets 945
dddocky: folds 
color_singleton: folds 
yairpinto: folds 
Uncalled bet (945) returned to rogierk449
rogierk449 collected 1890 from pot
rogierk449: doesn't show hand 
*** SUMMARY ***
Total pot 2000 | Rake 110 
Board [3h Kc 3s]
Seat 1: color_singleton (big blind) folded on the Flop
Seat 2: yairpinto folded on the Flop
Seat 3: Duke Croix folded before Flop (didn't bet)
Seat 4: rogierk449 collected (1890)
Seat 8: Manon947 (button) folded before Flop (didn't bet)
Seat 9: dddocky (small blind) folded on the Flop



PokerStars Home Game Hand #216956325894: {Club #3225207}  Hold'em No Limit (50/100) - 2020/07/30 17:26:58 ET
Table 'JansPokergame' 9-max (Play Money) Seat #9 is the button
Seat 1: color_singleton (10163 in chips) 
Seat 2: yairpinto (19004 in chips) 
Seat 3: Duke Croix (14955 in chips) 
Seat 4: rogierk449 (38722 in chips) 
Seat 8: Manon947 (10383 in chips) 
Seat 9: dddocky (1282 in chips) 
color_singleton: posts small blind 50
yairpinto: posts big blind 100
*** HOLE CARDS ***
Dealt to Duke Croix [Ad Ks]
Duke Croix: raises 400 to 500
rogierk449: folds 
Manon947: folds 
dddocky: folds 
color_singleton: folds 
yairpinto: folds 
Uncalled bet (400) returned to Duke Croix
Duke Croix collected 250 from pot
*** SUMMARY ***
Total pot 250 | Rake 0 
Seat 1: color_singleton (small blind) folded before Flop
Seat 2: yairpinto (big blind) folded before Flop
Seat 3: Duke Croix collected (250)
Seat 4: rogierk449 folded before Flop (didn't bet)
Seat 8: Manon947 folded before Flop (didn't bet)
Seat 9: dddocky (button) folded before Flop (didn't bet)



PokerStars Home Game Hand #216956334419: {Club #3225207}  Hold'em No Limit (50/100) - 2020/07/30 17:27:13 ET
Table 'JansPokergame' 9-max (Play Money) Seat #1 is the button
Seat 1: color_singleton (10113 in chips) 
Seat 2: yairpinto (18904 in chips) 
Seat 3: Duke Croix (15105 in chips) 
Seat 4: rogierk449 (38722 in chips) 
Seat 8: Manon947 (10383 in chips) 
Seat 9: dddocky (1282 in chips) 
yairpinto: posts small blind 50
Duke Croix: posts big blind 100
*** HOLE CARDS ***
Dealt to Duke Croix [6h Td]
rogierk449: folds 
Manon947: folds 
dddocky: folds 
color_singleton: raises 200 to 300
yairpinto: folds 
Duke Croix: folds 
Uncalled bet (200) returned to color_singleton
color_singleton collected 250 from pot
color_singleton: doesn't show hand 
*** SUMMARY ***
Total pot 250 | Rake 0 
Seat 1: color_singleton (button) collected (250)
Seat 2: yairpinto (small blind) folded before Flop
Seat 3: Duke Croix (big blind) folded before Flop
Seat 4: rogierk449 folded before Flop (didn't bet)
Seat 8: Manon947 folded before Flop (didn't bet)
Seat 9: dddocky folded before Flop (didn't bet)



PokerStars Home Game Hand #216956344524: {Club #3225207}  Hold'em No Limit (50/100) - 2020/07/30 17:27:30 ET
Table 'JansPokergame' 9-max (Play Money) Seat #2 is the button
Seat 1: color_singleton (10263 in chips) 
Seat 2: yairpinto (18854 in chips) 
Seat 3: Duke Croix (15005 in chips) 
Seat 4: rogierk449 (38722 in chips) 
Seat 8: Manon947 (10383 in chips) 
Seat 9: dddocky (1282 in chips) 
Duke Croix: posts small blind 50
rogierk449: posts big blind 100
*** HOLE CARDS ***
Dealt to Duke Croix [Ad 8c]
Manon947: raises 100 to 200
dddocky: folds 
color_singleton: folds 
yairpinto: folds 
Duke Croix: calls 150
rogierk449: folds 
*** FLOP *** [Js 6h 7c]
Duke Croix: checks 
Manon947: checks 
*** TURN *** [Js 6h 7c] [3d]
Duke Croix: checks 
Manon947: bets 236
Duke Croix: folds 
Uncalled bet (236) returned to Manon947
Manon947 collected 472 from pot
*** SUMMARY ***
Total pot 500 | Rake 28 
Board [Js 6h 7c 3d]
Seat 1: color_singleton folded before Flop (didn't bet)
Seat 2: yairpinto (button) folded before Flop (didn't bet)
Seat 3: Duke Croix (small blind) folded on the Turn
Seat 4: rogierk449 (big blind) folded before Flop
Seat 8: Manon947 collected (472)
Seat 9: dddocky folded before Flop (didn't bet)



PokerStars Home Game Hand #216956361798: {Club #3225207}  Hold'em No Limit (50/100) - 2020/07/30 17:28:01 ET
Table 'JansPokergame' 9-max (Play Money) Seat #3 is the button
Seat 1: color_singleton (10263 in chips) 
Seat 2: yairpinto (18854 in chips) 
Seat 3: Duke Croix (14805 in chips) 
Seat 4: rogierk449 (38622 in chips) 
Seat 8: Manon947 (10655 in chips) 
Seat 9: dddocky (1282 in chips) 
rogierk449: posts small blind 50
Manon947: posts big blind 100
*** HOLE CARDS ***
Dealt to Duke Croix [Kc 8c]
dddocky: calls 100
color_singleton: folds 
yairpinto: folds 
Duke Croix: calls 100
rogierk449: folds 
Manon947: checks 
*** FLOP *** [3s Td 9c]
Manon947: checks 
dddocky: checks 
Duke Croix: bets 200
Manon947: calls 200
dddocky: folds 
*** TURN *** [3s Td 9c] [8d]
Manon947: checks 
Duke Croix: bets 400
Manon947: calls 400
*** RIVER *** [3s Td 9c 8d] [9h]
Manon947: checks 
Duke Croix: checks 
*** SHOW DOWN ***
Manon947: shows [Th Qc] (two pair, Tens and Nines)
Duke Croix: mucks hand 
Manon947 collected 1465 from pot
*** SUMMARY ***
Total pot 1550 | Rake 85 
Board [3s Td 9c 8d 9h]
Seat 1: color_singleton folded before Flop (didn't bet)
Seat 2: yairpinto folded before Flop (didn't bet)
Seat 3: Duke Croix (button) mucked [Kc 8c]
Seat 4: rogierk449 (small blind) folded before Flop
Seat 8: Manon947 (big blind) showed [Th Qc] and won (1465) with two pair, Tens and Nines
Seat 9: dddocky folded on the Flop



PokerStars Home Game Hand #216956386852: {Club #3225207}  Hold'em No Limit (50/100) - 2020/07/30 17:28:45 ET
Table 'JansPokergame' 9-max (Play Money) Seat #4 is the button
Seat 1: color_singleton (10263 in chips) 
Seat 2: yairpinto (18854 in chips) 
Seat 3: Duke Croix (14105 in chips) 
Seat 4: rogierk449 (38572 in chips) 
Seat 8: Manon947 (11420 in chips) 
Seat 9: dddocky (1182 in chips) 
Manon947: posts small blind 50
dddocky: posts big blind 100
*** HOLE CARDS ***
Dealt to Duke Croix [Ts 7h]
color_singleton: folds 
yairpinto: raises 200 to 300
Duke Croix: folds 
rogierk449: folds 
Manon947: folds 
dddocky: folds 
Uncalled bet (200) returned to yairpinto
yairpinto collected 250 from pot
yairpinto: doesn't show hand 
*** SUMMARY ***
Total pot 250 | Rake 0 
Seat 1: color_singleton folded before Flop (didn't bet)
Seat 2: yairpinto collected (250)
Seat 3: Duke Croix folded before Flop (didn't bet)
Seat 4: rogierk449 (button) folded before Flop (didn't bet)
Seat 8: Manon947 (small blind) folded before Flop
Seat 9: dddocky (big blind) folded before Flop



PokerStars Home Game Hand #216956393998: {Club #3225207}  Hold'em No Limit (50/100) - 2020/07/30 17:28:57 ET
Table 'JansPokergame' 9-max (Play Money) Seat #8 is the button
Seat 1: color_singleton (10263 in chips) 
Seat 2: yairpinto (19004 in chips) 
Seat 3: Duke Croix (14105 in chips) 
Seat 4: rogierk449 (38572 in chips) 
Seat 8: Manon947 (11370 in chips) 
Seat 9: dddocky (1082 in chips) 
dddocky: posts small blind 50
color_singleton: posts big blind 100
*** HOLE CARDS ***
Dealt to Duke Croix [Ks As]
yairpinto: folds 
Duke Croix: raises 300 to 400
rogierk449: calls 400
Manon947: calls 400
dddocky: folds 
color_singleton: calls 300
*** FLOP *** [Ts Qh Jc]
color_singleton: checks 
Duke Croix: checks 
rogierk449: checks 
Manon947: checks 
*** TURN *** [Ts Qh Jc] [9c]
color_singleton: checks 
Duke Croix: bets 700
rogierk449: calls 700
Manon947: folds 
color_singleton: folds 
*** RIVER *** [Ts Qh Jc 9c] [7s]
Duke Croix: bets 1500
rogierk449: calls 1500
*** SHOW DOWN ***
Duke Croix: shows [Ks As] (a straight, Ten to Ace)
rogierk449: mucks hand 
Duke Croix collected 5717 from pot
*** SUMMARY ***
Total pot 6050 | Rake 333 
Board [Ts Qh Jc 9c 7s]
Seat 1: color_singleton (big blind) folded on the Turn
Seat 2: yairpinto folded before Flop (didn't bet)
Seat 3: Duke Croix showed [Ks As] and won (5717) with a straight, Ten to Ace
Seat 4: rogierk449 mucked [8c Ac]
Seat 8: Manon947 (button) folded on the Turn
Seat 9: dddocky (small blind) folded before Flop



PokerStars Home Game Hand #216956422350: {Club #3225207}  Hold'em No Limit (50/100) - 2020/07/30 17:29:48 ET
Table 'JansPokergame' 9-max (Play Money) Seat #9 is the button
Seat 1: color_singleton (9863 in chips) 
Seat 2: yairpinto (19004 in chips) 
Seat 3: Duke Croix (17222 in chips) 
Seat 4: rogierk449 (35972 in chips) 
Seat 8: Manon947 (10970 in chips) 
Seat 9: dddocky (1032 in chips) 
color_singleton: posts small blind 50
yairpinto: posts big blind 100
*** HOLE CARDS ***
Dealt to Duke Croix [3d 9c]
Duke Croix: folds 
rogierk449: raises 300 to 400
Manon947: folds 
dddocky: folds 
color_singleton: folds 
yairpinto: calls 300
*** FLOP *** [Qh 6h Jc]
yairpinto: checks 
rogierk449: bets 500
yairpinto: calls 500
*** TURN *** [Qh 6h Jc] [6d]
yairpinto: checks 
rogierk449: bets 874
yairpinto: calls 874
*** RIVER *** [Qh 6h Jc 6d] [2h]
yairpinto: bets 1700
rogierk449: calls 1700
*** SHOW DOWN ***
yairpinto: shows [Th Jh] (a flush, Queen high)
rogierk449: mucks hand 
yairpinto collected 6613 from pot
*** SUMMARY ***
Total pot 6998 | Rake 385 
Board [Qh 6h Jc 6d 2h]
Seat 1: color_singleton (small blind) folded before Flop
Seat 2: yairpinto (big blind) showed [Th Jh] and won (6613) with a flush, Queen high
Seat 3: Duke Croix folded before Flop (didn't bet)
Seat 4: rogierk449 mucked [Kc Ks]
Seat 8: Manon947 folded before Flop (didn't bet)
Seat 9: dddocky (button) folded before Flop (didn't bet)



PokerStars Home Game Hand #216956452992: {Club #3225207}  Hold'em No Limit (50/100) - 2020/07/30 17:30:41 ET
Table 'JansPokergame' 9-max (Play Money) Seat #1 is the button
Seat 1: color_singleton (9813 in chips) 
Seat 2: yairpinto (22143 in chips) 
Seat 3: Duke Croix (17222 in chips) 
Seat 4: rogierk449 (32498 in chips) 
Seat 8: Manon947 (10970 in chips) 
Seat 9: dddocky (1032 in chips) 
yairpinto: posts small blind 50
Duke Croix: posts big blind 100
*** HOLE CARDS ***
Dealt to Duke Croix [2c Ah]
rogierk449: calls 100
Manon947: calls 100
dddocky: calls 100
color_singleton: calls 100
yairpinto: calls 50
Duke Croix: checks 
*** FLOP *** [4s Th 3c]
yairpinto: checks 
Duke Croix: checks 
rogierk449: bets 283
Manon947: calls 283
dddocky: folds 
color_singleton: calls 283
yairpinto: folds 
Duke Croix: calls 283
*** TURN *** [4s Th 3c] [Ad]
Duke Croix: bets 600
rogierk449: folds 
Manon947: folds 
color_singleton: folds 
Uncalled bet (600) returned to Duke Croix
Duke Croix collected 1637 from pot
*** SUMMARY ***
Total pot 1732 | Rake 95 
Board [4s Th 3c Ad]
Seat 1: color_singleton (button) folded on the Turn
Seat 2: yairpinto (small blind) folded on the Flop
Seat 3: Duke Croix (big blind) collected (1637)
Seat 4: rogierk449 folded on the Turn
Seat 8: Manon947 folded on the Turn
Seat 9: dddocky folded on the Flop



PokerStars Home Game Hand #216956486724: {Club #3225207}  Hold'em No Limit (50/100) - 2020/07/30 17:31:41 ET
Table 'JansPokergame' 9-max (Play Money) Seat #2 is the button
Seat 1: color_singleton (9430 in chips) 
Seat 2: yairpinto (22043 in chips) 
Seat 3: Duke Croix (18476 in chips) 
Seat 4: rogierk449 (32115 in chips) 
Seat 8: Manon947 (10587 in chips) 
Seat 9: dddocky (932 in chips) 
Duke Croix: posts small blind 50
rogierk449: posts big blind 100
*** HOLE CARDS ***
Dealt to Duke Croix [7s Jc]
Manon947: folds 
dddocky: calls 100
color_singleton: folds 
yairpinto: folds 
Duke Croix: calls 50
rogierk449: checks 
*** FLOP *** [6s 5c 9d]
Duke Croix: checks 
rogierk449: checks 
dddocky: checks 
*** TURN *** [6s 5c 9d] [9h]
Duke Croix: checks 
rogierk449: checks 
dddocky: checks 
*** RIVER *** [6s 5c 9d 9h] [5s]
Duke Croix: checks 
rogierk449: checks 
dddocky: checks 
*** SHOW DOWN ***
Duke Croix: shows [7s Jc] (two pair, Nines and Fives)
rogierk449: shows [Kh 3c] (two pair, Nines and Fives - King kicker)
dddocky: shows [6d Jd] (two pair, Nines and Sixes)
dddocky collected 283 from pot
*** SUMMARY ***
Total pot 300 | Rake 17 
Board [6s 5c 9d 9h 5s]
Seat 1: color_singleton folded before Flop (didn't bet)
Seat 2: yairpinto (button) folded before Flop (didn't bet)
Seat 3: Duke Croix (small blind) showed [7s Jc] and lost with two pair, Nines and Fives
Seat 4: rogierk449 (big blind) showed [Kh 3c] and lost with two pair, Nines and Fives
Seat 8: Manon947 folded before Flop (didn't bet)
Seat 9: dddocky showed [6d Jd] and won (283) with two pair, Nines and Sixes



PokerStars Home Game Hand #216956504810: {Club #3225207}  Hold'em No Limit (50/100) - 2020/07/30 17:32:13 ET
Table 'JansPokergame' 9-max (Play Money) Seat #3 is the button
Seat 1: color_singleton (9430 in chips) 
Seat 2: yairpinto (22043 in chips) 
Seat 3: Duke Croix (18376 in chips) 
Seat 4: rogierk449 (32015 in chips) 
Seat 8: Manon947 (10587 in chips) 
Seat 9: dddocky (1115 in chips) 
rogierk449: posts small blind 50
Manon947: posts big blind 100
*** HOLE CARDS ***
Dealt to Duke Croix [Ah 5d]
dddocky: calls 100
color_singleton has timed out
color_singleton: folds 
yairpinto: raises 200 to 300
Duke Croix: folds 
rogierk449: folds 
Manon947: folds 
dddocky: folds 
Uncalled bet (200) returned to yairpinto
yairpinto collected 350 from pot
yairpinto: doesn't show hand 
*** SUMMARY ***
Total pot 350 | Rake 0 
Seat 1: color_singleton folded before Flop (didn't bet)
Seat 2: yairpinto collected (350)
Seat 3: Duke Croix (button) folded before Flop (didn't bet)
Seat 4: rogierk449 (small blind) folded before Flop
Seat 8: Manon947 (big blind) folded before Flop
Seat 9: dddocky folded before Flop



PokerStars Home Game Hand #216956524858: {Club #3225207}  Hold'em No Limit (50/100) - 2020/07/30 17:32:49 ET
Table 'JansPokergame' 9-max (Play Money) Seat #4 is the button
Seat 2: yairpinto (22293 in chips) 
Seat 3: Duke Croix (18376 in chips) 
Seat 4: rogierk449 (31965 in chips) 
Seat 8: Manon947 (10487 in chips) 
Seat 9: dddocky (1015 in chips) 
Manon947: posts small blind 50
dddocky: posts big blind 100
*** HOLE CARDS ***
Dealt to Duke Croix [Ks Kc]
yairpinto: folds 
Duke Croix: raises 300 to 400
rogierk449: folds 
Manon947: folds 
dddocky: folds 
Uncalled bet (300) returned to Duke Croix
Duke Croix collected 250 from pot
*** SUMMARY ***
Total pot 250 | Rake 0 
Seat 2: yairpinto folded before Flop (didn't bet)
Seat 3: Duke Croix collected (250)
Seat 4: rogierk449 (button) folded before Flop (didn't bet)
Seat 8: Manon947 (small blind) folded before Flop
Seat 9: dddocky (big blind) folded before Flop



PokerStars Home Game Hand #216956530194: {Club #3225207}  Hold'em No Limit (50/100) - 2020/07/30 17:32:59 ET
Table 'JansPokergame' 9-max (Play Money) Seat #8 is the button
Seat 2: yairpinto (22293 in chips) 
Seat 3: Duke Croix (18526 in chips) 
Seat 4: rogierk449 (31965 in chips) 
Seat 8: Manon947 (10437 in chips) 
Seat 9: dddocky (915 in chips) 
dddocky: posts small blind 50
yairpinto: posts big blind 100
*** HOLE CARDS ***
Dealt to Duke Croix [8s 5s]
Duke Croix: folds 
rogierk449: folds 
Manon947: calls 100
dddocky: folds 
yairpinto: checks 
*** FLOP *** [7d Qd Tc]
yairpinto: checks 
Manon947: checks 
*** TURN *** [7d Qd Tc] [Qc]
yairpinto: bets 118
Manon947: calls 118
*** RIVER *** [7d Qd Tc Qc] [6s]
yairpinto: checks 
Manon947: bets 229
yairpinto: calls 229
*** SHOW DOWN ***
Manon947: shows [Jd 6d] (two pair, Queens and Sixes)
yairpinto: mucks hand 
Manon947 collected 892 from pot
*** SUMMARY ***
Total pot 944 | Rake 52 
Board [7d Qd Tc Qc 6s]
Seat 2: yairpinto (big blind) mucked [9c 6h]
Seat 3: Duke Croix folded before Flop (didn't bet)
Seat 4: rogierk449 folded before Flop (didn't bet)
Seat 8: Manon947 (button) showed [Jd 6d] and won (892) with two pair, Queens and Sixes
Seat 9: dddocky (small blind) folded before Flop



PokerStars Home Game Hand #216956559304: {Club #3225207}  Hold'em No Limit (50/100) - 2020/07/30 17:33:51 ET
Table 'JansPokergame' 9-max (Play Money) Seat #9 is the button
Seat 2: yairpinto (21846 in chips) 
Seat 3: Duke Croix (18526 in chips) 
Seat 4: rogierk449 (31965 in chips) 
Seat 8: Manon947 (10882 in chips) 
Seat 9: dddocky (865 in chips) 
yairpinto: posts small blind 50
Duke Croix: posts big blind 100
*** HOLE CARDS ***
Dealt to Duke Croix [6s 8d]
rogierk449: folds 
Manon947: folds 
dddocky: calls 100
yairpinto: calls 50
Duke Croix: checks 
*** FLOP *** [Kh Ts 6d]
yairpinto: checks 
Duke Croix: checks 
dddocky: checks 
*** TURN *** [Kh Ts 6d] [8s]
yairpinto: bets 141
Duke Croix: raises 159 to 300
dddocky: folds 
yairpinto: calls 159
*** RIVER *** [Kh Ts 6d 8s] [4s]
yairpinto: checks 
Duke Croix: bets 650
yairpinto: calls 650
*** SHOW DOWN ***
Duke Croix: shows [6s 8d] (two pair, Eights and Sixes)
yairpinto: mucks hand 
Duke Croix collected 2079 from pot
*** SUMMARY ***
Total pot 2200 | Rake 121 
Board [Kh Ts 6d 8s 4s]
Seat 2: yairpinto (small blind) mucked [4d 8h]
Seat 3: Duke Croix (big blind) showed [6s 8d] and won (2079) with two pair, Eights and Sixes
Seat 4: rogierk449 folded before Flop (didn't bet)
Seat 8: Manon947 folded before Flop (didn't bet)
Seat 9: dddocky (button) folded on the Turn



PokerStars Home Game Hand #216956590947: {Club #3225207}  Hold'em No Limit (50/100) - 2020/07/30 17:34:38 ET
Table 'JansPokergame' 9-max (Play Money) Seat #2 is the button
Seat 1: color_singleton (9430 in chips) 
Seat 2: yairpinto (20796 in chips) 
Seat 3: Duke Croix (19555 in chips) 
Seat 4: rogierk449 (31965 in chips) 
Seat 8: Manon947 (10882 in chips) 
Seat 9: dddocky (765 in chips) 
Duke Croix: posts small blind 50
rogierk449: posts big blind 100
color_singleton: posts small & big blinds 150
*** HOLE CARDS ***
Dealt to Duke Croix [Ac 2c]
Manon947: calls 100
dddocky: calls 100
color_singleton: checks 
yairpinto: calls 100
Duke Croix: calls 50
rogierk449: checks 
*** FLOP *** [5c Ts 7d]
Duke Croix: checks 
rogierk449: checks 
Manon947: checks 
dddocky: checks 
color_singleton: bets 614
yairpinto: calls 614
Duke Croix: folds 
rogierk449: calls 614
Manon947: folds 
dddocky: folds 
*** TURN *** [5c Ts 7d] [8d]
rogierk449: checks 
color_singleton: bets 1177
yairpinto: calls 1177
rogierk449: calls 1177
*** RIVER *** [5c Ts 7d 8d] [9s]
rogierk449: checks 
color_singleton: checks 
yairpinto: bets 2846
rogierk449: folds 
color_singleton: folds 
Uncalled bet (2846) returned to yairpinto
yairpinto collected 5692 from pot
yairpinto: doesn't show hand 
*** SUMMARY ***
Total pot 6023 | Rake 331 
Board [5c Ts 7d 8d 9s]
Seat 1: color_singleton folded on the River
Seat 2: yairpinto (button) collected (5692)
Seat 3: Duke Croix (small blind) folded on the Flop
Seat 4: rogierk449 (big blind) folded on the River
Seat 8: Manon947 folded on the Flop
Seat 9: dddocky folded on the Flop



PokerStars Home Game Hand #216956630737: {Club #3225207}  Hold'em No Limit (50/100) - 2020/07/30 17:35:49 ET
Table 'JansPokergame' 9-max (Play Money) Seat #3 is the button
Seat 1: color_singleton (7489 in chips) 
Seat 2: yairpinto (24597 in chips) 
Seat 3: Duke Croix (19455 in chips) 
Seat 4: rogierk449 (30074 in chips) 
Seat 8: Manon947 (10782 in chips) 
Seat 9: dddocky (665 in chips) 
rogierk449: posts small blind 50
Manon947: posts big blind 100
*** HOLE CARDS ***
Dealt to Duke Croix [5s Ks]
dddocky: calls 100
color_singleton: folds 
yairpinto: folds 
Duke Croix: folds 
rogierk449: folds 
Manon947: checks 
*** FLOP *** [8h 9d Jh]
Manon947: checks 
dddocky: checks 
*** TURN *** [8h 9d Jh] [3c]
Manon947: checks 
dddocky: checks 
*** RIVER *** [8h 9d Jh 3c] [9s]
Manon947: bets 236
dddocky: folds 
Uncalled bet (236) returned to Manon947
Manon947 collected 236 from pot
*** SUMMARY ***
Total pot 250 | Rake 14 
Board [8h 9d Jh 3c 9s]
Seat 1: color_singleton folded before Flop (didn't bet)
Seat 2: yairpinto folded before Flop (didn't bet)
Seat 3: Duke Croix (button) folded before Flop (didn't bet)
Seat 4: rogierk449 (small blind) folded before Flop
Seat 8: Manon947 (big blind) collected (236)
Seat 9: dddocky folded on the River



PokerStars Home Game Hand #216956645140: {Club #3225207}  Hold'em No Limit (50/100) - 2020/07/30 17:36:15 ET
Table 'JansPokergame' 9-max (Play Money) Seat #4 is the button
Seat 1: color_singleton (7489 in chips) 
Seat 2: yairpinto (24597 in chips) 
Seat 3: Duke Croix (19455 in chips) 
Seat 4: rogierk449 (30024 in chips) 
Seat 8: Manon947 (10918 in chips) 
Seat 9: dddocky (565 in chips) 
Manon947: posts small blind 50
dddocky: posts big blind 100
*** HOLE CARDS ***
Dealt to Duke Croix [3h Td]
color_singleton: folds 
yairpinto: folds 
Duke Croix: folds 
rogierk449: calls 100
Manon947: calls 50
dddocky: checks 
*** FLOP *** [Kd Js 5d]
Manon947: checks 
dddocky: checks 
rogierk449: checks 
*** TURN *** [Kd Js 5d] [8d]
Manon947: bets 141
dddocky: calls 141
rogierk449: folds 
*** RIVER *** [Kd Js 5d 8d] [2h]
Manon947: checks 
dddocky: checks 
*** SHOW DOWN ***
Manon947: shows [Ts 8h] (a pair of Eights)
dddocky: shows [Jh 7c] (a pair of Jacks)
dddocky collected 550 from pot
*** SUMMARY ***
Total pot 582 | Rake 32 
Board [Kd Js 5d 8d 2h]
Seat 1: color_singleton folded before Flop (didn't bet)
Seat 2: yairpinto folded before Flop (didn't bet)
Seat 3: Duke Croix folded before Flop (didn't bet)
Seat 4: rogierk449 (button) folded on the Turn
Seat 8: Manon947 (small blind) showed [Ts 8h] and lost with a pair of Eights
Seat 9: dddocky (big blind) showed [Jh 7c] and won (550) with a pair of Jacks



PokerStars Home Game Hand #216956665494: {Club #3225207}  Hold'em No Limit (50/100) - 2020/07/30 17:36:52 ET
Table 'JansPokergame' 9-max (Play Money) Seat #8 is the button
Seat 1: color_singleton (7489 in chips) 
Seat 2: yairpinto (24597 in chips) 
Seat 3: Duke Croix (19455 in chips) 
Seat 4: rogierk449 (29924 in chips) 
Seat 8: Manon947 (10677 in chips) 
Seat 9: dddocky (874 in chips) 
dddocky: posts small blind 50
color_singleton: posts big blind 100
*** HOLE CARDS ***
Dealt to Duke Croix [Kd 9h]
yairpinto: folds 
Duke Croix has timed out
Duke Croix: folds 
rogierk449: raises 300 to 400
Manon947: folds 
dddocky: raises 474 to 874 and is all-in
color_singleton: folds 
rogierk449: calls 474
*** FLOP *** [8c 7h Th]
*** TURN *** [8c 7h Th] [4c]
*** RIVER *** [8c 7h Th 4c] [Jd]
*** SHOW DOWN ***
dddocky: shows [6c 6h] (a pair of Sixes)
rogierk449: shows [9d Ad] (a straight, Seven to Jack)
rogierk449 collected 1746 from pot
*** SUMMARY ***
Total pot 1848 | Rake 102 
Board [8c 7h Th 4c Jd]
Seat 1: color_singleton (big blind) folded before Flop
Seat 2: yairpinto folded before Flop (didn't bet)
Seat 3: Duke Croix folded before Flop (didn't bet)
Seat 4: rogierk449 showed [9d Ad] and won (1746) with a straight, Seven to Jack
Seat 8: Manon947 (button) folded before Flop (didn't bet)
Seat 9: dddocky (small blind) showed [6c 6h] and lost with a pair of Sixes



PokerStars Home Game Hand #216956729445: {Club #3225207}  Hold'em No Limit (50/100) - 2020/07/30 17:38:48 ET
Table 'JansPokergame' 9-max (Play Money) Seat #8 is the button
Seat 1: color_singleton (7289 in chips) 
Seat 2: yairpinto (24730 in chips) 
Seat 3: Duke Croix (19455 in chips) 
Seat 4: rogierk449 (30696 in chips) 
Seat 8: Manon947 (10727 in chips) 
color_singleton: posts small blind 50
yairpinto: posts big blind 100
Duke Croix: posts small & big blinds 150
rogierk449: posts small blind 50
*** HOLE CARDS ***
Dealt to Duke Croix [8d Kc]
Duke Croix: checks 
rogierk449: calls 100
Manon947: calls 100
dddocky joins the table at seat #9 
color_singleton: raises 300 to 400
yairpinto: calls 300
Duke Croix: folds 
rogierk449: calls 300
Manon947: calls 300
*** FLOP *** [7d 9c Qd]
color_singleton: bets 1000
yairpinto: folds 
rogierk449: folds 
Manon947: folds 
Uncalled bet (1000) returned to color_singleton
color_singleton collected 1701 from pot
color_singleton: doesn't show hand 
*** SUMMARY ***
Total pot 1800 | Rake 99 
Board [7d 9c Qd]
Seat 1: color_singleton (small blind) collected (1701)
Seat 2: yairpinto (big blind) folded on the Flop
Seat 3: Duke Croix folded before Flop (didn't bet)
Seat 4: rogierk449 folded on the Flop
Seat 8: Manon947 (button) folded on the Flop



PokerStars Home Game Hand #216956748942: {Club #3225207}  Hold'em No Limit (50/100) - 2020/07/30 17:39:23 ET
Table 'JansPokergame' 9-max (Play Money) Seat #1 is the button
Seat 1: color_singleton (8590 in chips) 
Seat 2: yairpinto (24330 in chips) 
Seat 3: Duke Croix (19305 in chips) 
Seat 4: rogierk449 (30246 in chips) 
Seat 8: Manon947 (10327 in chips) 
Seat 9: dddocky (10000 in chips) 
yairpinto: posts small blind 50
Duke Croix: posts big blind 100
dddocky: posts big blind 100
*** HOLE CARDS ***
Dealt to Duke Croix [4d Ac]
rogierk449: folds 
Manon947: calls 100
dddocky: checks 
color_singleton: folds 
yairpinto: calls 50
Duke Croix: checks 
*** FLOP *** [Jh 7s 4h]
yairpinto: checks 
Duke Croix: checks 
Manon947: checks 
dddocky: checks 
*** TURN *** [Jh 7s 4h] [7d]
yairpinto: checks 
Duke Croix: bets 200
Manon947: folds 
dddocky: folds 
yairpinto: folds 
Uncalled bet (200) returned to Duke Croix
Duke Croix collected 378 from pot
*** SUMMARY ***
Total pot 400 | Rake 22 
Board [Jh 7s 4h 7d]
Seat 1: color_singleton (button) folded before Flop (didn't bet)
Seat 2: yairpinto (small blind) folded on the Turn
Seat 3: Duke Croix (big blind) collected (378)
Seat 4: rogierk449 folded before Flop (didn't bet)
Seat 8: Manon947 folded on the Turn
Seat 9: dddocky folded on the Turn (didn't bet)



PokerStars Home Game Hand #216956767063: {Club #3225207}  Hold'em No Limit (50/100) - 2020/07/30 17:39:56 ET
Table 'JansPokergame' 9-max (Play Money) Seat #2 is the button
Seat 1: color_singleton (8590 in chips) 
Seat 2: yairpinto (24230 in chips) 
Seat 3: Duke Croix (19583 in chips) 
Seat 4: rogierk449 (30246 in chips) 
Seat 8: Manon947 (10227 in chips) 
Seat 9: dddocky (9900 in chips) 
Duke Croix: posts small blind 50
rogierk449: posts big blind 100
*** HOLE CARDS ***
Dealt to Duke Croix [Th Td]
Manon947: calls 100
dddocky: calls 100
color_singleton: folds 
yairpinto: calls 100
Duke Croix: raises 400 to 500
rogierk449: folds 
Manon947: calls 400
dddocky: folds 
yairpinto: folds 
*** FLOP *** [4s As Js]
Duke Croix: bets 700
Manon947: folds 
Uncalled bet (700) returned to Duke Croix
Duke Croix collected 1228 from pot
*** SUMMARY ***
Total pot 1300 | Rake 72 
Board [4s As Js]
Seat 1: color_singleton folded before Flop (didn't bet)
Seat 2: yairpinto (button) folded before Flop
Seat 3: Duke Croix (small blind) collected (1228)
Seat 4: rogierk449 (big blind) folded before Flop
Seat 8: Manon947 folded on the Flop
Seat 9: dddocky folded before Flop



PokerStars Home Game Hand #216956787225: {Club #3225207}  Hold'em No Limit (50/100) - 2020/07/30 17:40:33 ET
Table 'JansPokergame' 9-max (Play Money) Seat #3 is the button
Seat 1: color_singleton (8590 in chips) 
Seat 2: yairpinto (24130 in chips) 
Seat 3: Duke Croix (20311 in chips) 
Seat 4: rogierk449 (30146 in chips) 
Seat 8: Manon947 (9727 in chips) 
Seat 9: dddocky (9800 in chips) 
rogierk449: posts small blind 50
Manon947: posts big blind 100
*** HOLE CARDS ***
Dealt to Duke Croix [Qs Jd]
dddocky: calls 100
color_singleton: folds 
yairpinto: folds 
Duke Croix: raises 400 to 500
rogierk449: folds 
Manon947: folds 
dddocky: calls 400
*** FLOP *** [9s 7c 2s]
dddocky: checks 
Duke Croix: checks 
*** TURN *** [9s 7c 2s] [7d]
dddocky: checks 
Duke Croix: bets 700
dddocky: folds 
Uncalled bet (700) returned to Duke Croix
Duke Croix collected 1087 from pot
*** SUMMARY ***
Total pot 1150 | Rake 63 
Board [9s 7c 2s 7d]
Seat 1: color_singleton folded before Flop (didn't bet)
Seat 2: yairpinto folded before Flop (didn't bet)
Seat 3: Duke Croix (button) collected (1087)
Seat 4: rogierk449 (small blind) folded before Flop
Seat 8: Manon947 (big blind) folded before Flop
Seat 9: dddocky folded on the Turn



PokerStars Home Game Hand #216956805868: {Club #3225207}  Hold'em No Limit (50/100) - 2020/07/30 17:41:07 ET
Table 'JansPokergame' 9-max (Play Money) Seat #4 is the button
Seat 1: color_singleton (8590 in chips) 
Seat 2: yairpinto (24130 in chips) 
Seat 3: Duke Croix (20898 in chips) 
Seat 4: rogierk449 (30096 in chips) 
Seat 8: Manon947 (9627 in chips) 
Seat 9: dddocky (9300 in chips) 
Manon947: posts small blind 50
dddocky: posts big blind 100
*** HOLE CARDS ***
Dealt to Duke Croix [7s Th]
color_singleton: folds 
yairpinto: folds 
Duke Croix: folds 
rogierk449: raises 200 to 300
Manon947: calls 250
dddocky: calls 200
*** FLOP *** [2c Ah 5h]
Manon947: checks 
dddocky: checks 
rogierk449: bets 500
Manon947: folds 
dddocky: folds 
Uncalled bet (500) returned to rogierk449
rogierk449 collected 850 from pot
rogierk449: doesn't show hand 
*** SUMMARY ***
Total pot 900 | Rake 50 
Board [2c Ah 5h]
Seat 1: color_singleton folded before Flop (didn't bet)
Seat 2: yairpinto folded before Flop (didn't bet)
Seat 3: Duke Croix folded before Flop (didn't bet)
Seat 4: rogierk449 (button) collected (850)
Seat 8: Manon947 (small blind) folded on the Flop
Seat 9: dddocky (big blind) folded on the Flop



PokerStars Home Game Hand #216956821702: {Club #3225207}  Hold'em No Limit (50/100) - 2020/07/30 17:41:36 ET
Table 'JansPokergame' 9-max (Play Money) Seat #8 is the button
Seat 1: color_singleton (8590 in chips) 
Seat 2: yairpinto (24130 in chips) 
Seat 3: Duke Croix (20898 in chips) 
Seat 4: rogierk449 (30646 in chips) 
Seat 8: Manon947 (9327 in chips) 
Seat 9: dddocky (9000 in chips) 
dddocky: posts small blind 50
color_singleton: posts big blind 100
*** HOLE CARDS ***
Dealt to Duke Croix [Qd Ah]
yairpinto: folds 
Duke Croix: raises 300 to 400
rogierk449: folds 
Manon947: calls 400
dddocky: folds 
color_singleton: folds 
*** FLOP *** [3c 7d 6s]
Duke Croix: checks 
Manon947: checks 
*** TURN *** [3c 7d 6s] [8s]
Duke Croix: checks 
Manon947: checks 
*** RIVER *** [3c 7d 6s 8s] [9s]
Duke Croix: checks 
Manon947: bets 898
Duke Croix: folds 
Uncalled bet (898) returned to Manon947
Manon947 collected 898 from pot
*** SUMMARY ***
Total pot 950 | Rake 52 
Board [3c 7d 6s 8s 9s]
Seat 1: color_singleton (big blind) folded before Flop
Seat 2: yairpinto folded before Flop (didn't bet)
Seat 3: Duke Croix folded on the River
Seat 4: rogierk449 folded before Flop (didn't bet)
Seat 8: Manon947 (button) collected (898)
Seat 9: dddocky (small blind) folded before Flop



PokerStars Home Game Hand #216956849796: {Club #3225207}  Hold'em No Limit (50/100) - 2020/07/30 17:42:27 ET
Table 'JansPokergame' 9-max (Play Money) Seat #9 is the button
Seat 1: color_singleton (8490 in chips) 
Seat 2: yairpinto (24130 in chips) 
Seat 3: Duke Croix (20498 in chips) 
Seat 4: rogierk449 (30646 in chips) 
Seat 8: Manon947 (9825 in chips) 
Seat 9: dddocky (8950 in chips) 
color_singleton: posts small blind 50
yairpinto: posts big blind 100
*** HOLE CARDS ***
Dealt to Duke Croix [Kc Ts]
Duke Croix: raises 300 to 400
rogierk449: folds 
Manon947: folds 
dddocky: calls 400
color_singleton: calls 350
yairpinto: folds 
*** FLOP *** [6c Th 7h]
color_singleton: checks 
Duke Croix: bets 700
dddocky: folds 
color_singleton: calls 700
*** TURN *** [6c Th 7h] [4c]
color_singleton: checks 
Duke Croix: bets 1300
color_singleton: calls 1300
*** RIVER *** [6c Th 7h 4c] [2c]
color_singleton: checks 
Duke Croix: checks 
*** SHOW DOWN ***
color_singleton: shows [7d Ad] (a pair of Sevens)
Duke Croix: shows [Kc Ts] (a pair of Tens)
Duke Croix collected 5008 from pot
*** SUMMARY ***
Total pot 5300 | Rake 292 
Board [6c Th 7h 4c 2c]
Seat 1: color_singleton (small blind) showed [7d Ad] and lost with a pair of Sevens
Seat 2: yairpinto (big blind) folded before Flop
Seat 3: Duke Croix showed [Kc Ts] and won (5008) with a pair of Tens
Seat 4: rogierk449 folded before Flop (didn't bet)
Seat 8: Manon947 folded before Flop (didn't bet)
Seat 9: dddocky (button) folded on the Flop



PokerStars Home Game Hand #216956879317: {Club #3225207}  Hold'em No Limit (50/100) - 2020/07/30 17:43:21 ET
Table 'JansPokergame' 9-max (Play Money) Seat #1 is the button
Seat 1: color_singleton (6090 in chips) 
Seat 2: yairpinto (24030 in chips) 
Seat 3: Duke Croix (23106 in chips) 
Seat 4: rogierk449 (30646 in chips) 
Seat 8: Manon947 (9825 in chips) 
Seat 9: dddocky (8550 in chips) 
yairpinto: posts small blind 50
Duke Croix: posts big blind 100
*** HOLE CARDS ***
Dealt to Duke Croix [3c As]
rogierk449: folds 
Manon947: folds 
dddocky: calls 100
color_singleton: calls 100
yairpinto: calls 50
Duke Croix: checks 
*** FLOP *** [Ad Js Jh]
yairpinto: checks 
Duke Croix: bets 200
dddocky: calls 200
color_singleton: folds 
yairpinto: folds 
*** TURN *** [Ad Js Jh] [4c]
Duke Croix: checks 
dddocky: checks 
*** RIVER *** [Ad Js Jh 4c] [2h]
Duke Croix: bets 400
dddocky: folds 
Uncalled bet (400) returned to Duke Croix
Duke Croix collected 756 from pot
*** SUMMARY ***
Total pot 800 | Rake 44 
Board [Ad Js Jh 4c 2h]
Seat 1: color_singleton (button) folded on the Flop
Seat 2: yairpinto (small blind) folded on the Flop
Seat 3: Duke Croix (big blind) collected (756)
Seat 4: rogierk449 folded before Flop (didn't bet)
Seat 8: Manon947 folded before Flop (didn't bet)
Seat 9: dddocky folded on the River



PokerStars Home Game Hand #216956897608: {Club #3225207}  Hold'em No Limit (50/100) - 2020/07/30 17:43:55 ET
Table 'JansPokergame' 9-max (Play Money) Seat #2 is the button
Seat 1: color_singleton (5990 in chips) 
Seat 2: yairpinto (23930 in chips) 
Seat 3: Duke Croix (23562 in chips) 
Seat 4: rogierk449 (30646 in chips) 
Seat 8: Manon947 (9825 in chips) 
Seat 9: dddocky (8250 in chips) 
Duke Croix: posts small blind 50
rogierk449: posts big blind 100
*** HOLE CARDS ***
Dealt to Duke Croix [4h Qc]
Manon947: calls 100
dddocky: calls 100
color_singleton: raises 200 to 300
yairpinto: folds 
Duke Croix: folds 
rogierk449: raises 400 to 700
Manon947: folds 
dddocky: folds 
color_singleton: calls 400
*** FLOP *** [Ts 7d As]
rogierk449: bets 800
color_singleton: folds 
Uncalled bet (800) returned to rogierk449
rogierk449 collected 1559 from pot
rogierk449: doesn't show hand 
*** SUMMARY ***
Total pot 1650 | Rake 91 
Board [Ts 7d As]
Seat 1: color_singleton folded on the Flop
Seat 2: yairpinto (button) folded before Flop (didn't bet)
Seat 3: Duke Croix (small blind) folded before Flop
Seat 4: rogierk449 (big blind) collected (1559)
Seat 8: Manon947 folded before Flop
Seat 9: dddocky folded before Flop



PokerStars Home Game Hand #216956917398: {Club #3225207}  Hold'em No Limit (50/100) - 2020/07/30 17:44:30 ET
Table 'JansPokergame' 9-max (Play Money) Seat #3 is the button
Seat 1: color_singleton (5290 in chips) 
Seat 2: yairpinto (23930 in chips) 
Seat 3: Duke Croix (23512 in chips) 
Seat 4: rogierk449 (31505 in chips) 
Seat 8: Manon947 (9725 in chips) 
Seat 9: dddocky (8150 in chips) 
rogierk449: posts small blind 50
Manon947: posts big blind 100
*** HOLE CARDS ***
Dealt to Duke Croix [4h 8c]
dddocky: folds 
color_singleton: raises 100 to 200
yairpinto: folds 
Duke Croix: folds 
rogierk449: folds 
Manon947: calls 100
*** FLOP *** [4c 3s 8d]
Manon947: checks 
color_singleton: checks 
*** TURN *** [4c 3s 8d] [5h]
Manon947: checks 
color_singleton: checks 
*** RIVER *** [4c 3s 8d 5h] [Qc]
Manon947: checks 
color_singleton: checks 
*** SHOW DOWN ***
Manon947: shows [3h Ks] (a pair of Threes)
color_singleton: mucks hand 
Manon947 collected 425 from pot
*** SUMMARY ***
Total pot 450 | Rake 25 
Board [4c 3s 8d 5h Qc]
Seat 1: color_singleton mucked [Ts Jc]
Seat 2: yairpinto folded before Flop (didn't bet)
Seat 3: Duke Croix (button) folded before Flop (didn't bet)
Seat 4: rogierk449 (small blind) folded before Flop
Seat 8: Manon947 (big blind) showed [3h Ks] and won (425) with a pair of Threes
Seat 9: dddocky folded before Flop (didn't bet)



PokerStars Home Game Hand #216956935833: {Club #3225207}  Hold'em No Limit (50/100) - 2020/07/30 17:44:59 ET
Table 'JansPokergame' 9-max (Play Money) Seat #4 is the button
Seat 1: color_singleton (5090 in chips) 
Seat 2: yairpinto (23930 in chips) 
Seat 3: Duke Croix (23512 in chips) 
Seat 4: rogierk449 (31455 in chips) 
Seat 8: Manon947 (9950 in chips) 
Seat 9: dddocky (8150 in chips) 
Manon947: posts small blind 50
dddocky: posts big blind 100
*** HOLE CARDS ***
Dealt to Duke Croix [Js 9h]
color_singleton: folds 
yairpinto: folds 
Duke Croix: folds 
rogierk449: folds 
Manon947: calls 50
dddocky: checks 
*** FLOP *** [Ts 7d 8s]
Manon947: bets 100
dddocky: folds 
Uncalled bet (100) returned to Manon947
Manon947 collected 189 from pot
*** SUMMARY ***
Total pot 200 | Rake 11 
Board [Ts 7d 8s]
Seat 1: color_singleton folded before Flop (didn't bet)
Seat 2: yairpinto folded before Flop (didn't bet)
Seat 3: Duke Croix folded before Flop (didn't bet)
Seat 4: rogierk449 (button) folded before Flop (didn't bet)
Seat 8: Manon947 (small blind) collected (189)
Seat 9: dddocky (big blind) folded on the Flop



PokerStars Home Game Hand #216956944550: {Club #3225207}  Hold'em No Limit (50/100) - 2020/07/30 17:45:15 ET
Table 'JansPokergame' 9-max (Play Money) Seat #8 is the button
Seat 1: color_singleton (5090 in chips) 
Seat 2: yairpinto (23930 in chips) 
Seat 3: Duke Croix (23512 in chips) 
Seat 4: rogierk449 (31455 in chips) 
Seat 8: Manon947 (10039 in chips) 
Seat 9: dddocky (8050 in chips) 
dddocky: posts small blind 50
color_singleton: posts big blind 100
*** HOLE CARDS ***
Dealt to Duke Croix [2d 8s]
yairpinto: folds 
Duke Croix: folds 
rogierk449: calls 100
Manon947: calls 100
dddocky: calls 50
color_singleton: checks 
*** FLOP *** [Qs 9s Jh]
dddocky: checks 
color_singleton: checks 
rogierk449: checks 
Manon947: bets 100
dddocky: folds 
color_singleton: folds 
rogierk449: calls 100
*** TURN *** [Qs 9s Jh] [Th]
rogierk449: checks 
Manon947: checks 
*** RIVER *** [Qs 9s Jh Th] [9d]
rogierk449: bets 200
Manon947: calls 200
*** SHOW DOWN ***
rogierk449: shows [8c 7d] (a straight, Eight to Queen)
Manon947: mucks hand 
rogierk449 collected 945 from pot
*** SUMMARY ***
Total pot 1000 | Rake 55 
Board [Qs 9s Jh Th 9d]
Seat 1: color_singleton (big blind) folded on the Flop
Seat 2: yairpinto folded before Flop (didn't bet)
Seat 3: Duke Croix folded before Flop (didn't bet)
Seat 4: rogierk449 showed [8c 7d] and won (945) with a straight, Eight to Queen
Seat 8: Manon947 (button) mucked [As 6s]
Seat 9: dddocky (small blind) folded on the Flop



PokerStars Home Game Hand #216956966450: {Club #3225207}  Hold'em No Limit (50/100) - 2020/07/30 17:45:55 ET
Table 'JansPokergame' 9-max (Play Money) Seat #9 is the button
Seat 1: color_singleton (4990 in chips) 
Seat 2: yairpinto (23930 in chips) 
Seat 3: Duke Croix (23512 in chips) 
Seat 4: rogierk449 (32000 in chips) 
Seat 8: Manon947 (9639 in chips) 
Seat 9: dddocky (7950 in chips) 
color_singleton: posts small blind 50
yairpinto: posts big blind 100
*** HOLE CARDS ***
Dealt to Duke Croix [Ac 8c]
Duke Croix: folds 
rogierk449: folds 
Manon947: folds 
dddocky: calls 100
color_singleton: folds 
yairpinto: checks 
*** FLOP *** [9d 5d 9h]
yairpinto: bets 118
dddocky: folds 
Uncalled bet (118) returned to yairpinto
yairpinto collected 236 from pot
yairpinto: doesn't show hand 
*** SUMMARY ***
Total pot 250 | Rake 14 
Board [9d 5d 9h]
Seat 1: color_singleton (small blind) folded before Flop
Seat 2: yairpinto (big blind) collected (236)
Seat 3: Duke Croix folded before Flop (didn't bet)
Seat 4: rogierk449 folded before Flop (didn't bet)
Seat 8: Manon947 folded before Flop (didn't bet)
Seat 9: dddocky (button) folded on the Flop



PokerStars Home Game Hand #216956978666: {Club #3225207}  Hold'em No Limit (50/100) - 2020/07/30 17:46:17 ET
Table 'JansPokergame' 9-max (Play Money) Seat #1 is the button
Seat 1: color_singleton (4940 in chips) 
Seat 2: yairpinto (24066 in chips) 
Seat 3: Duke Croix (23512 in chips) 
Seat 4: rogierk449 (32000 in chips) 
Seat 8: Manon947 (9639 in chips) 
Seat 9: dddocky (7850 in chips) 
yairpinto: posts small blind 50
Duke Croix: posts big blind 100
*** HOLE CARDS ***
Dealt to Duke Croix [5d Kd]
rogierk449: calls 100
Manon947: calls 100
dddocky: calls 100
color_singleton: calls 100
yairpinto: calls 50
Duke Croix: checks 
*** FLOP *** [8c 7c 9c]
yairpinto: checks 
Duke Croix: checks 
rogierk449: checks 
Manon947: checks 
dddocky: checks 
color_singleton: bets 283
yairpinto: folds 
Duke Croix: folds 
rogierk449: calls 283
Manon947: folds 
dddocky: folds 
*** TURN *** [8c 7c 9c] [3d]
rogierk449: checks 
color_singleton: checks 
*** RIVER *** [8c 7c 9c 3d] [Ts]
rogierk449: bets 551
color_singleton: calls 551
*** SHOW DOWN ***
rogierk449: shows [6c 5c] (a straight flush, Five to Nine)
color_singleton: mucks hand 
rogierk449 collected 2143 from pot
*** SUMMARY ***
Total pot 2268 | Rake 125 
Board [8c 7c 9c 3d Ts]
Seat 1: color_singleton (button) mucked [7s 6d]
Seat 2: yairpinto (small blind) folded on the Flop
Seat 3: Duke Croix (big blind) folded on the Flop
Seat 4: rogierk449 showed [6c 5c] and won (2143) with a straight flush, Five to Nine
Seat 8: Manon947 folded on the Flop
Seat 9: dddocky folded on the Flop



PokerStars Home Game Hand #216957002851: {Club #3225207}  Hold'em No Limit (50/100) - 2020/07/30 17:47:01 ET
Table 'JansPokergame' 9-max (Play Money) Seat #2 is the button
Seat 1: color_singleton (4006 in chips) 
Seat 2: yairpinto (23966 in chips) 
Seat 3: Duke Croix (23412 in chips) 
Seat 4: rogierk449 (33209 in chips) 
Seat 8: Manon947 (9539 in chips) 
Seat 9: dddocky (7750 in chips) 
Duke Croix: posts small blind 50
rogierk449: posts big blind 100
*** HOLE CARDS ***
Dealt to Duke Croix [As 3s]
Manon947: folds 
dddocky: calls 100
color_singleton: folds 
yairpinto: folds 
Duke Croix: raises 300 to 400
rogierk449: folds 
dddocky: folds 
Uncalled bet (300) returned to Duke Croix
Duke Croix collected 300 from pot
*** SUMMARY ***
Total pot 300 | Rake 0 
Seat 1: color_singleton folded before Flop (didn't bet)
Seat 2: yairpinto (button) folded before Flop (didn't bet)
Seat 3: Duke Croix (small blind) collected (300)
Seat 4: rogierk449 (big blind) folded before Flop
Seat 8: Manon947 folded before Flop (didn't bet)
Seat 9: dddocky folded before Flop



PokerStars Home Game Hand #216957019941: {Club #3225207}  Hold'em No Limit (50/100) - 2020/07/30 17:47:33 ET
Table 'JansPokergame' 9-max (Play Money) Seat #3 is the button
Seat 1: color_singleton (4006 in chips) 
Seat 2: yairpinto (23966 in chips) 
Seat 3: Duke Croix (23612 in chips) 
Seat 4: rogierk449 (33109 in chips) 
Seat 8: Manon947 (9539 in chips) 
Seat 9: dddocky (7650 in chips) 
rogierk449: posts small blind 50
Manon947: posts big blind 100
*** HOLE CARDS ***
Dealt to Duke Croix [Ac 4c]
dddocky: calls 100
color_singleton: folds 
yairpinto: folds 
Duke Croix: raises 300 to 400
rogierk449: folds 
Manon947: folds 
dddocky: calls 300
*** FLOP *** [6s 2c Th]
dddocky: checks 
Duke Croix: checks 
*** TURN *** [6s 2c Th] [Td]
dddocky: checks 
Duke Croix: checks 
*** RIVER *** [6s 2c Th Td] [Kd]
dddocky: checks 
Duke Croix: checks 
*** SHOW DOWN ***
dddocky: shows [Jh As] (a pair of Tens)
Duke Croix: mucks hand 
dddocky collected 898 from pot
*** SUMMARY ***
Total pot 950 | Rake 52 
Board [6s 2c Th Td Kd]
Seat 1: color_singleton folded before Flop (didn't bet)
Seat 2: yairpinto folded before Flop (didn't bet)
Seat 3: Duke Croix (button) mucked [Ac 4c]
Seat 4: rogierk449 (small blind) folded before Flop
Seat 8: Manon947 (big blind) folded before Flop
Seat 9: dddocky showed [Jh As] and won (898) with a pair of Tens



PokerStars Home Game Hand #216957039147: {Club #3225207}  Hold'em No Limit (50/100) - 2020/07/30 17:48:08 ET
Table 'JansPokergame' 9-max (Play Money) Seat #4 is the button
Seat 1: color_singleton (4006 in chips) 
Seat 2: yairpinto (23966 in chips) 
Seat 3: Duke Croix (23212 in chips) 
Seat 4: rogierk449 (33059 in chips) 
Seat 8: Manon947 (9439 in chips) 
Seat 9: dddocky (8148 in chips) 
Manon947: posts small blind 50
dddocky: posts big blind 100
*** HOLE CARDS ***
Dealt to Duke Croix [Kc 2c]
color_singleton: folds 
yairpinto: calls 100
Duke Croix: folds 
rogierk449: folds 
Manon947: folds 
dddocky: checks 
*** FLOP *** [Jd As 7s]
dddocky: checks 
yairpinto: bets 118
dddocky: calls 118
*** TURN *** [Jd As 7s] [5c]
dddocky: checks 
yairpinto: checks 
*** RIVER *** [Jd As 7s 5c] [Th]
dddocky: checks 
yairpinto: bets 229
dddocky: folds 
Uncalled bet (229) returned to yairpinto
yairpinto collected 459 from pot
yairpinto: doesn't show hand 
*** SUMMARY ***
Total pot 486 | Rake 27 
Board [Jd As 7s 5c Th]
Seat 1: color_singleton folded before Flop (didn't bet)
Seat 2: yairpinto collected (459)
Seat 3: Duke Croix folded before Flop (didn't bet)
Seat 4: rogierk449 (button) folded before Flop (didn't bet)
Seat 8: Manon947 (small blind) folded before Flop
Seat 9: dddocky (big blind) folded on the River



PokerStars Home Game Hand #216957058293: {Club #3225207}  Hold'em No Limit (50/100) - 2020/07/30 17:48:44 ET
Table 'JansPokergame' 9-max (Play Money) Seat #8 is the button
Seat 1: color_singleton (4006 in chips) 
Seat 2: yairpinto (24207 in chips) 
Seat 3: Duke Croix (23212 in chips) 
Seat 4: rogierk449 (33059 in chips) 
Seat 8: Manon947 (9389 in chips) 
Seat 9: dddocky (7930 in chips) 
dddocky: posts small blind 50
color_singleton: posts big blind 100
*** HOLE CARDS ***
Dealt to Duke Croix [Ac 2s]
yairpinto: folds 
Duke Croix: calls 100
rogierk449: raises 400 to 500
Manon947: folds 
dddocky: folds 
color_singleton: folds 
Duke Croix: folds 
Uncalled bet (400) returned to rogierk449
rogierk449 collected 350 from pot
rogierk449: doesn't show hand 
*** SUMMARY ***
Total pot 350 | Rake 0 
Seat 1: color_singleton (big blind) folded before Flop
Seat 2: yairpinto folded before Flop (didn't bet)
Seat 3: Duke Croix folded before Flop
Seat 4: rogierk449 collected (350)
Seat 8: Manon947 (button) folded before Flop (didn't bet)
Seat 9: dddocky (small blind) folded before Flop



PokerStars Home Game Hand #216957068380: {Club #3225207}  Hold'em No Limit (50/100) - 2020/07/30 17:49:02 ET
Table 'JansPokergame' 9-max (Play Money) Seat #9 is the button
Seat 1: color_singleton (3906 in chips) 
Seat 2: yairpinto (24207 in chips) 
Seat 3: Duke Croix (23112 in chips) 
Seat 4: rogierk449 (33309 in chips) 
Seat 8: Manon947 (9389 in chips) 
Seat 9: dddocky (7880 in chips) 
color_singleton: posts small blind 50
yairpinto: posts big blind 100
*** HOLE CARDS ***
Dealt to Duke Croix [Kd 7d]
Duke Croix: calls 100
rogierk449: folds 
Manon947: raises 100 to 200
dddocky: folds 
color_singleton: folds 
yairpinto: calls 100
Duke Croix: calls 100
*** FLOP *** [9s 5s 6h]
yairpinto: checks 
Duke Croix: checks 
Manon947: bets 307
yairpinto: folds 
Duke Croix: folds 
Uncalled bet (307) returned to Manon947
Manon947 collected 614 from pot
*** SUMMARY ***
Total pot 650 | Rake 36 
Board [9s 5s 6h]
Seat 1: color_singleton (small blind) folded before Flop
Seat 2: yairpinto (big blind) folded on the Flop
Seat 3: Duke Croix folded on the Flop
Seat 4: rogierk449 folded before Flop (didn't bet)
Seat 8: Manon947 collected (614)
Seat 9: dddocky (button) folded before Flop (didn't bet)



PokerStars Home Game Hand #216957088090: {Club #3225207}  Hold'em No Limit (50/100) - 2020/07/30 17:49:39 ET
Table 'JansPokergame' 9-max (Play Money) Seat #1 is the button
Seat 1: color_singleton (3856 in chips) 
Seat 2: yairpinto (24007 in chips) 
Seat 3: Duke Croix (22912 in chips) 
Seat 4: rogierk449 (33309 in chips) 
Seat 8: Manon947 (9803 in chips) 
Seat 9: dddocky (7880 in chips) 
yairpinto: posts small blind 50
Duke Croix: posts big blind 100
*** HOLE CARDS ***
Dealt to Duke Croix [4c 5c]
rogierk449: calls 100
Manon947: calls 100
dddocky: calls 100
color_singleton: calls 100
yairpinto: calls 50
Duke Croix: checks 
*** FLOP *** [2c Ts 5h]
yairpinto: checks 
Duke Croix: checks 
rogierk449: bets 567
Manon947: folds 
dddocky: folds 
color_singleton: folds 
yairpinto: folds 
Duke Croix: folds 
Uncalled bet (567) returned to rogierk449
rogierk449 collected 567 from pot
rogierk449: doesn't show hand 
*** SUMMARY ***
Total pot 600 | Rake 33 
Board [2c Ts 5h]
Seat 1: color_singleton (button) folded on the Flop
Seat 2: yairpinto (small blind) folded on the Flop
Seat 3: Duke Croix (big blind) folded on the Flop
Seat 4: rogierk449 collected (567)
Seat 8: Manon947 folded on the Flop
Seat 9: dddocky folded on the Flop



PokerStars Home Game Hand #216957106583: {Club #3225207}  Hold'em No Limit (50/100) - 2020/07/30 17:50:14 ET
Table 'JansPokergame' 9-max (Play Money) Seat #2 is the button
Seat 1: color_singleton (3756 in chips) 
Seat 2: yairpinto (23907 in chips) 
Seat 3: Duke Croix (22812 in chips) 
Seat 4: rogierk449 (33776 in chips) 
Seat 8: Manon947 (9703 in chips) 
Seat 9: dddocky (7780 in chips) 
Duke Croix: posts small blind 50
rogierk449: posts big blind 100
*** HOLE CARDS ***
Dealt to Duke Croix [9c Js]
Manon947: folds 
dddocky: calls 100
color_singleton: raises 200 to 300
yairpinto: folds 
Duke Croix: folds 
rogierk449: folds 
dddocky: calls 200
*** FLOP *** [Td 3d 4d]
dddocky: bets 709
color_singleton: folds 
Uncalled bet (709) returned to dddocky
dddocky collected 709 from pot
dddocky: doesn't show hand 
*** SUMMARY ***
Total pot 750 | Rake 41 
Board [Td 3d 4d]
Seat 1: color_singleton folded on the Flop
Seat 2: yairpinto (button) folded before Flop (didn't bet)
Seat 3: Duke Croix (small blind) folded before Flop
Seat 4: rogierk449 (big blind) folded before Flop
Seat 8: Manon947 folded before Flop (didn't bet)
Seat 9: dddocky collected (709)



PokerStars Home Game Hand #216957120155: {Club #3225207}  Hold'em No Limit (50/100) - 2020/07/30 17:50:40 ET
Table 'JansPokergame' 9-max (Play Money) Seat #3 is the button
Seat 1: color_singleton (3456 in chips) 
Seat 2: yairpinto (23907 in chips) 
Seat 3: Duke Croix (22762 in chips) 
Seat 4: rogierk449 (33676 in chips) 
Seat 8: Manon947 (9703 in chips) 
Seat 9: dddocky (8189 in chips) 
rogierk449: posts small blind 50
Manon947: posts big blind 100
*** HOLE CARDS ***
Dealt to Duke Croix [9c 6s]
dddocky: calls 100
color_singleton: calls 100
yairpinto: calls 100
Duke Croix: calls 100
rogierk449: folds 
Manon947: checks 
*** FLOP *** [2s 9s 8s]
Manon947: checks 
dddocky: checks 
color_singleton: checks 
yairpinto: checks 
Duke Croix: bets 300
Manon947: calls 300
dddocky: folds 
color_singleton: folds 
yairpinto: folds 
*** TURN *** [2s 9s 8s] [Jc]
Manon947: bets 543
Duke Croix: folds 
Uncalled bet (543) returned to Manon947
Manon947 collected 1087 from pot
*** SUMMARY ***
Total pot 1150 | Rake 63 
Board [2s 9s 8s Jc]
Seat 1: color_singleton folded on the Flop
Seat 2: yairpinto folded on the Flop
Seat 3: Duke Croix (button) folded on the Turn
Seat 4: rogierk449 (small blind) folded before Flop
Seat 8: Manon947 (big blind) collected (1087)
Seat 9: dddocky folded on the Flop



PokerStars Home Game Hand #216957150710: {Club #3225207}  Hold'em No Limit (50/100) - 2020/07/30 17:51:37 ET
Table 'JansPokergame' 9-max (Play Money) Seat #4 is the button
Seat 1: color_singleton (3356 in chips) 
Seat 2: yairpinto (23807 in chips) 
Seat 3: Duke Croix (22362 in chips) 
Seat 4: rogierk449 (33626 in chips) 
Seat 8: Manon947 (10390 in chips) 
Seat 9: dddocky (8089 in chips) 
Manon947: posts small blind 50
dddocky: posts big blind 100
*** HOLE CARDS ***
Dealt to Duke Croix [Qc 2d]
color_singleton: folds 
yairpinto: calls 100
Duke Croix: folds 
rogierk449: raises 300 to 400
Manon947: folds 
dddocky: folds 
yairpinto: folds 
Uncalled bet (300) returned to rogierk449
rogierk449 collected 350 from pot
rogierk449: doesn't show hand 
*** SUMMARY ***
Total pot 350 | Rake 0 
Seat 1: color_singleton folded before Flop (didn't bet)
Seat 2: yairpinto folded before Flop
Seat 3: Duke Croix folded before Flop (didn't bet)
Seat 4: rogierk449 (button) collected (350)
Seat 8: Manon947 (small blind) folded before Flop
Seat 9: dddocky (big blind) folded before Flop



PokerStars Home Game Hand #216957158443: {Club #3225207}  Hold'em No Limit (50/100) - 2020/07/30 17:51:52 ET
Table 'JansPokergame' 9-max (Play Money) Seat #8 is the button
Seat 1: color_singleton (3356 in chips) 
Seat 2: yairpinto (23707 in chips) 
Seat 3: Duke Croix (22362 in chips) 
Seat 4: rogierk449 (33876 in chips) 
Seat 8: Manon947 (10340 in chips) 
Seat 9: dddocky (7989 in chips) 
dddocky: posts small blind 50
color_singleton: posts big blind 100
*** HOLE CARDS ***
Dealt to Duke Croix [Td Kh]
yairpinto: folds 
Duke Croix: raises 300 to 400
rogierk449: folds 
Manon947: folds 
dddocky: folds 
color_singleton: folds 
Uncalled bet (300) returned to Duke Croix
Duke Croix collected 250 from pot
*** SUMMARY ***
Total pot 250 | Rake 0 
Seat 1: color_singleton (big blind) folded before Flop
Seat 2: yairpinto folded before Flop (didn't bet)
Seat 3: Duke Croix collected (250)
Seat 4: rogierk449 folded before Flop (didn't bet)
Seat 8: Manon947 (button) folded before Flop (didn't bet)
Seat 9: dddocky (small blind) folded before Flop



PokerStars Home Game Hand #216957164172: {Club #3225207}  Hold'em No Limit (50/100) - 2020/07/30 17:52:03 ET
Table 'JansPokergame' 9-max (Play Money) Seat #9 is the button
Seat 1: color_singleton (3256 in chips) 
Seat 2: yairpinto (23707 in chips) 
Seat 3: Duke Croix (22512 in chips) 
Seat 4: rogierk449 (33876 in chips) 
Seat 8: Manon947 (10340 in chips) 
Seat 9: dddocky (7939 in chips) 
color_singleton: posts small blind 50
yairpinto: posts big blind 100
*** HOLE CARDS ***
Dealt to Duke Croix [2d Js]
Duke Croix: folds 
rogierk449: folds 
Manon947: calls 100
dddocky: calls 100
color_singleton: folds 
yairpinto: checks 
*** FLOP *** [Ts Ad Qh]
yairpinto: checks 
Manon947: bets 165
dddocky: calls 165
yairpinto: folds 
*** TURN *** [Ts Ad Qh] [Ah]
Manon947: bets 321
dddocky: folds 
Uncalled bet (321) returned to Manon947
Manon947 collected 643 from pot
*** SUMMARY ***
Total pot 680 | Rake 37 
Board [Ts Ad Qh Ah]
Seat 1: color_singleton (small blind) folded before Flop
Seat 2: yairpinto (big blind) folded on the Flop
Seat 3: Duke Croix folded before Flop (didn't bet)
Seat 4: rogierk449 folded before Flop (didn't bet)
Seat 8: Manon947 collected (643)
Seat 9: dddocky (button) folded on the Turn



PokerStars Home Game Hand #216957177178: {Club #3225207}  Hold'em No Limit (50/100) - 2020/07/30 17:52:27 ET
Table 'JansPokergame' 9-max (Play Money) Seat #1 is the button
Seat 1: color_singleton (3206 in chips) 
Seat 2: yairpinto (23607 in chips) 
Seat 3: Duke Croix (22512 in chips) 
Seat 4: rogierk449 (33876 in chips) 
Seat 8: Manon947 (10718 in chips) 
Seat 9: dddocky (7674 in chips) 
yairpinto: posts small blind 50
Duke Croix: posts big blind 100
*** HOLE CARDS ***
Dealt to Duke Croix [Js 8s]
rogierk449: folds 
Manon947: folds 
dddocky: folds 
color_singleton: raises 200 to 300
yairpinto: calls 250
Duke Croix: calls 200
*** FLOP *** [7s Ks 2c]
yairpinto: checks 
Duke Croix: bets 400
color_singleton: raises 400 to 800
yairpinto: folds 
Duke Croix: calls 400
*** TURN *** [7s Ks 2c] [6d]
Duke Croix: checks 
color_singleton: bets 1200
Duke Croix: calls 1200
*** RIVER *** [7s Ks 2c 6d] [Th]
Duke Croix: checks 
color_singleton: bets 906 and is all-in
Duke Croix: folds 
Uncalled bet (906) returned to color_singleton
color_singleton collected 4630 from pot
color_singleton: doesn't show hand 
*** SUMMARY ***
Total pot 4900 | Rake 270 
Board [7s Ks 2c 6d Th]
Seat 1: color_singleton (button) collected (4630)
Seat 2: yairpinto (small blind) folded on the Flop
Seat 3: Duke Croix (big blind) folded on the River
Seat 4: rogierk449 folded before Flop (didn't bet)
Seat 8: Manon947 folded before Flop (didn't bet)
Seat 9: dddocky folded before Flop (didn't bet)



PokerStars Home Game Hand #216957204256: {Club #3225207}  Hold'em No Limit (50/100) - 2020/07/30 17:53:18 ET
Table 'JansPokergame' 9-max (Play Money) Seat #2 is the button
Seat 1: color_singleton (5536 in chips) 
Seat 2: yairpinto (23307 in chips) 
Seat 3: Duke Croix (20212 in chips) 
Seat 4: rogierk449 (33876 in chips) 
Seat 8: Manon947 (10718 in chips) 
Seat 9: dddocky (7674 in chips) 
Duke Croix: posts small blind 50
rogierk449: posts big blind 100
*** HOLE CARDS ***
Dealt to Duke Croix [Kd Ks]
Manon947: folds 
dddocky: folds 
color_singleton: folds 
yairpinto: raises 200 to 300
Duke Croix: raises 600 to 900
rogierk449: folds 
yairpinto: folds 
Uncalled bet (600) returned to Duke Croix
Duke Croix collected 700 from pot
*** SUMMARY ***
Total pot 700 | Rake 0 
Seat 1: color_singleton folded before Flop (didn't bet)
Seat 2: yairpinto (button) folded before Flop
Seat 3: Duke Croix (small blind) collected (700)
Seat 4: rogierk449 (big blind) folded before Flop
Seat 8: Manon947 folded before Flop (didn't bet)
Seat 9: dddocky folded before Flop (didn't bet)



PokerStars Home Game Hand #216957216224: {Club #3225207}  Hold'em No Limit (50/100) - 2020/07/30 17:53:41 ET
Table 'JansPokergame' 9-max (Play Money) Seat #3 is the button
Seat 1: color_singleton (5536 in chips) 
Seat 2: yairpinto (23007 in chips) 
Seat 3: Duke Croix (20612 in chips) 
Seat 4: rogierk449 (33776 in chips) 
Seat 8: Manon947 (10718 in chips) 
Seat 9: dddocky (7674 in chips) 
rogierk449: posts small blind 50
Manon947: posts big blind 100
*** HOLE CARDS ***
Dealt to Duke Croix [6s 2s]
dddocky: folds 
color_singleton: calls 100
yairpinto: folds 
Duke Croix: folds 
rogierk449: calls 50
Manon947: checks 
*** FLOP *** [Th 4d Qh]
rogierk449: checks 
Manon947: bets 141
color_singleton: calls 141
rogierk449: folds 
*** TURN *** [Th 4d Qh] [3d]
Manon947: bets 275
color_singleton: calls 275
*** RIVER *** [Th 4d Qh 3d] [4s]
Manon947: bets 535
color_singleton: folds 
Uncalled bet (535) returned to Manon947
Manon947 collected 1070 from pot
*** SUMMARY ***
Total pot 1132 | Rake 62 
Board [Th 4d Qh 3d 4s]
Seat 1: color_singleton folded on the River
Seat 2: yairpinto folded before Flop (didn't bet)
Seat 3: Duke Croix (button) folded before Flop (didn't bet)
Seat 4: rogierk449 (small blind) folded on the Flop
Seat 8: Manon947 (big blind) collected (1070)
Seat 9: dddocky folded before Flop (didn't bet)



PokerStars Home Game Hand #216957237917: {Club #3225207}  Hold'em No Limit (50/100) - 2020/07/30 17:54:22 ET
Table 'JansPokergame' 9-max (Play Money) Seat #4 is the button
Seat 1: color_singleton (5020 in chips) 
Seat 2: yairpinto (23007 in chips) 
Seat 3: Duke Croix (20612 in chips) 
Seat 4: rogierk449 (33676 in chips) 
Seat 8: Manon947 (11272 in chips) 
Seat 9: dddocky (7674 in chips) 
Manon947: posts small blind 50
dddocky: posts big blind 100
*** HOLE CARDS ***
Dealt to Duke Croix [8h Ks]
color_singleton: folds 
yairpinto: folds 
Duke Croix: folds 
rogierk449: raises 400 to 500
Manon947: folds 
dddocky: folds 
Uncalled bet (400) returned to rogierk449
rogierk449 collected 250 from pot
rogierk449: doesn't show hand 
*** SUMMARY ***
Total pot 250 | Rake 0 
Seat 1: color_singleton folded before Flop (didn't bet)
Seat 2: yairpinto folded before Flop (didn't bet)
Seat 3: Duke Croix folded before Flop (didn't bet)
Seat 4: rogierk449 (button) collected (250)
Seat 8: Manon947 (small blind) folded before Flop
Seat 9: dddocky (big blind) folded before Flop



PokerStars Home Game Hand #216957251605: {Club #3225207}  Hold'em No Limit (50/100) - 2020/07/30 17:54:33 ET
Table 'JansPokergame' 9-max (Play Money) Seat #8 is the button
Seat 1: color_singleton (5020 in chips) 
Seat 2: yairpinto (23007 in chips) 
Seat 3: Duke Croix (20612 in chips) 
Seat 4: rogierk449 (33826 in chips) 
Seat 8: Manon947 (11222 in chips) 
Seat 9: dddocky (7574 in chips) 
dddocky: posts small blind 50
color_singleton: posts big blind 100
*** HOLE CARDS ***
Dealt to Duke Croix [Kh 6d]
yairpinto: folds 
Duke Croix: folds 
rogierk449: folds 
Manon947: calls 100
dddocky: calls 50
color_singleton: checks 
*** FLOP *** [Jc 9d 4d]
dddocky: checks 
color_singleton: checks 
Manon947: checks 
*** TURN *** [Jc 9d 4d] [Kd]
dddocky: checks 
color_singleton: checks 
Manon947: bets 141
dddocky: calls 141
color_singleton: folds 
*** RIVER *** [Jc 9d 4d Kd] [9h]
dddocky: checks 
Manon947: bets 550
dddocky: folds 
Uncalled bet (550) returned to Manon947
Manon947 collected 550 from pot
*** SUMMARY ***
Total pot 582 | Rake 32 
Board [Jc 9d 4d Kd 9h]
Seat 1: color_singleton (big blind) folded on the Turn
Seat 2: yairpinto folded before Flop (didn't bet)
Seat 3: Duke Croix folded before Flop (didn't bet)
Seat 4: rogierk449 folded before Flop (didn't bet)
Seat 8: Manon947 (button) collected (550)
Seat 9: dddocky (small blind) folded on the River



PokerStars Home Game Hand #216957272378: {Club #3225207}  Hold'em No Limit (50/100) - 2020/07/30 17:55:16 ET
Table 'JansPokergame' 9-max (Play Money) Seat #9 is the button
Seat 1: color_singleton (4920 in chips) 
Seat 2: yairpinto (23007 in chips) 
Seat 3: Duke Croix (20612 in chips) 
Seat 4: rogierk449 (33826 in chips) 
Seat 8: Manon947 (11531 in chips) 
Seat 9: dddocky (7333 in chips) 
color_singleton: posts small blind 50
yairpinto: posts big blind 100
*** HOLE CARDS ***
Dealt to Duke Croix [8h As]
Duke Croix: raises 200 to 300
rogierk449: calls 300
Manon947: folds 
dddocky: folds 
color_singleton: folds 
yairpinto: folds 
*** FLOP *** [2s 8c Jd]
Duke Croix: checks 
rogierk449: checks 
*** TURN *** [2s 8c Jd] [Kd]
Duke Croix: checks 
rogierk449 has timed out
rogierk449: checks 
*** RIVER *** [2s 8c Jd Kd] [Qc]
Duke Croix: checks 
rogierk449: checks 
*** SHOW DOWN ***
Duke Croix: shows [8h As] (a pair of Eights)
rogierk449: mucks hand 
Duke Croix collected 709 from pot
*** SUMMARY ***
Total pot 750 | Rake 41 
Board [2s 8c Jd Kd Qc]
Seat 1: color_singleton (small blind) folded before Flop
Seat 2: yairpinto (big blind) folded before Flop
Seat 3: Duke Croix showed [8h As] and won (709) with a pair of Eights
Seat 4: rogierk449 mucked [3h 2h]
Seat 8: Manon947 folded before Flop (didn't bet)
Seat 9: dddocky (button) folded before Flop (didn't bet)



PokerStars Home Game Hand #216957289571: {Club #3225207}  Hold'em No Limit (50/100) - 2020/07/30 17:55:59 ET
Table 'JansPokergame' 9-max (Play Money) Seat #1 is the button
Seat 1: color_singleton (4870 in chips) 
Seat 2: yairpinto (22907 in chips) 
Seat 3: Duke Croix (21021 in chips) 
Seat 4: rogierk449 (33526 in chips) 
Seat 8: Manon947 (11531 in chips) 
Seat 9: dddocky (7333 in chips) 
yairpinto: posts small blind 50
Duke Croix: posts big blind 100
*** HOLE CARDS ***
Dealt to Duke Croix [Jc Kc]
rogierk449: raises 200 to 300
Manon947: folds 
dddocky: folds 
color_singleton: folds 
yairpinto: calls 250
Duke Croix: calls 200
*** FLOP *** [5s Qd 2s]
yairpinto: checks 
Duke Croix: checks 
rogierk449: checks 
*** TURN *** [5s Qd 2s] [8d]
yairpinto: bets 425
Duke Croix: folds 
rogierk449: folds 
Uncalled bet (425) returned to yairpinto
yairpinto collected 850 from pot
yairpinto: doesn't show hand 
*** SUMMARY ***
Total pot 900 | Rake 50 
Board [5s Qd 2s 8d]
Seat 1: color_singleton (button) folded before Flop (didn't bet)
Seat 2: yairpinto (small blind) collected (850)
Seat 3: Duke Croix (big blind) folded on the Turn
Seat 4: rogierk449 folded on the Turn
Seat 8: Manon947 folded before Flop (didn't bet)
Seat 9: dddocky folded before Flop (didn't bet)



PokerStars Home Game Hand #216957306445: {Club #3225207}  Hold'em No Limit (50/100) - 2020/07/30 17:56:40 ET
Table 'JansPokergame' 9-max (Play Money) Seat #2 is the button
Seat 1: color_singleton (4870 in chips) 
Seat 2: yairpinto (23457 in chips) 
Seat 3: Duke Croix (20721 in chips) 
Seat 4: rogierk449 (33226 in chips) 
Seat 8: Manon947 (11531 in chips) 
Seat 9: dddocky (7333 in chips) 
Duke Croix: posts small blind 50
rogierk449: posts big blind 100
*** HOLE CARDS ***
Dealt to Duke Croix [9c Ac]
Manon947: calls 100
dddocky: calls 100
color_singleton: raises 100 to 200
yairpinto: calls 200
Duke Croix: calls 150
rogierk449: folds 
Manon947: calls 100
dddocky: calls 100
*** FLOP *** [Kc 9h Jc]
Duke Croix: bets 600
Manon947: folds 
dddocky: raises 600 to 1200
color_singleton: calls 1200
yairpinto: folds 
Duke Croix: calls 600
*** TURN *** [Kc 9h Jc] [4c]
Duke Croix: checks 
dddocky: checks 
color_singleton: checks 
*** RIVER *** [Kc 9h Jc 4c] [Qd]
Duke Croix: bets 1900
dddocky: raises 1900 to 3800
color_singleton: calls 3470 and is all-in
Duke Croix: raises 15521 to 19321 and is all-in
dddocky: calls 2133 and is all-in
Uncalled bet (13388) returned to Duke Croix
*** SHOW DOWN ***
Duke Croix: shows [9c Ac] (a flush, Ace high)
dddocky: shows [Tc Ks] (a straight, Nine to King)
Duke Croix collected 4655 from side pot
color_singleton: shows [8s Td] (a straight, Nine to King)
Duke Croix collected 14279 from main pot
*** SUMMARY ***
Total pot 20036 Main pot 14279. Side pot 4655. | Rake 1102 
Board [Kc 9h Jc 4c Qd]
Seat 1: color_singleton showed [8s Td] and lost with a straight, Nine to King
Seat 2: yairpinto (button) folded on the Flop
Seat 3: Duke Croix (small blind) showed [9c Ac] and won (18934) with a flush, Ace high
Seat 4: rogierk449 (big blind) folded before Flop
Seat 8: Manon947 folded on the Flop
Seat 9: dddocky showed [Tc Ks] and lost with a straight, Nine to King



PokerStars Home Game Hand #216957333505: {Club #3225207}  Hold'em No Limit (50/100) - 2020/07/30 17:57:45 ET
Table 'JansPokergame' 9-max (Play Money) Seat #3 is the button
Seat 2: yairpinto (23257 in chips) 
Seat 3: Duke Croix (32322 in chips) 
Seat 4: rogierk449 (33126 in chips) 
Seat 8: Manon947 (11331 in chips) 
rogierk449: posts small blind 50
Manon947: posts big blind 100
*** HOLE CARDS ***
Dealt to Duke Croix [6h 2h]
yairpinto: folds 
Duke Croix: folds 
rogierk449: folds 
Uncalled bet (50) returned to Manon947
Manon947 collected 100 from pot
*** SUMMARY ***
Total pot 100 | Rake 0 
Seat 2: yairpinto folded before Flop (didn't bet)
Seat 3: Duke Croix (button) folded before Flop (didn't bet)
Seat 4: rogierk449 (small blind) folded before Flop
Seat 8: Manon947 (big blind) collected (100)



PokerStars Home Game Hand #216957337283: {Club #3225207}  Hold'em No Limit (50/100) - 2020/07/30 17:57:54 ET
Table 'JansPokergame' 9-max (Play Money) Seat #4 is the button
Seat 1: color_singleton (10000 in chips) 
Seat 2: yairpinto (23257 in chips) 
Seat 3: Duke Croix (32322 in chips) 
Seat 4: rogierk449 (33076 in chips) 
Seat 8: Manon947 (11381 in chips) 
Manon947: posts small blind 50
color_singleton: posts big blind 100
*** HOLE CARDS ***
Dealt to Duke Croix [7d Qs]
yairpinto: folds 
Duke Croix: folds 
rogierk449: folds 
Manon947: calls 50
color_singleton: checks 
*** FLOP *** [6c 9s Js]
Manon947: bets 189
color_singleton: folds 
Uncalled bet (189) returned to Manon947
Manon947 collected 189 from pot
*** SUMMARY ***
Total pot 200 | Rake 11 
Board [6c 9s Js]
Seat 1: color_singleton (big blind) folded on the Flop
Seat 2: yairpinto folded before Flop (didn't bet)
Seat 3: Duke Croix folded before Flop (didn't bet)
Seat 4: rogierk449 (button) folded before Flop (didn't bet)
Seat 8: Manon947 (small blind) collected (189)



PokerStars Home Game Hand #216957349058: {Club #3225207}  Hold'em No Limit (50/100) - 2020/07/30 17:58:23 ET
Table 'JansPokergame' 9-max (Play Money) Seat #8 is the button
Seat 1: color_singleton (9900 in chips) 
Seat 2: yairpinto (23257 in chips) 
Seat 3: Duke Croix (32322 in chips) 
Seat 4: rogierk449 (33076 in chips) 
Seat 8: Manon947 (11470 in chips) 
color_singleton: posts small blind 50
yairpinto: posts big blind 100
*** HOLE CARDS ***
Dealt to Duke Croix [Ks 6s]
Duke Croix: folds 
rogierk449: folds 
rogierk449 leaves the table
Manon947: folds 
color_singleton: calls 50
yairpinto: checks 
*** FLOP *** [9c 6c 2d]
color_singleton: checks 
yairpinto: checks 
*** TURN *** [9c 6c 2d] [6d]
color_singleton: checks 
yairpinto: checks 
*** RIVER *** [9c 6c 2d 6d] [8s]
color_singleton: checks 
yairpinto: checks 
*** SHOW DOWN ***
color_singleton: shows [Js 8h] (two pair, Eights and Sixes)
yairpinto: mucks hand 
color_singleton collected 189 from pot
*** SUMMARY ***
Total pot 200 | Rake 11 
Board [9c 6c 2d 6d 8s]
Seat 1: color_singleton (small blind) showed [Js 8h] and won (189) with two pair, Eights and Sixes
Seat 2: yairpinto (big blind) mucked [Qh 7c]
Seat 3: Duke Croix folded before Flop (didn't bet)
Seat 4: rogierk449 folded before Flop (didn't bet)
Seat 8: Manon947 (button) folded before Flop (didn't bet)



PokerStars Home Game Hand #216957360897: {Club #3225207}  Hold'em No Limit (50/100) - 2020/07/30 17:58:51 ET
Table 'JansPokergame' 9-max (Play Money) Seat #1 is the button
Seat 1: color_singleton (9989 in chips) 
Seat 2: yairpinto (23157 in chips) 
Seat 3: Duke Croix (32322 in chips) 
Seat 8: Manon947 (11470 in chips) 
yairpinto: posts small blind 50
Duke Croix: posts big blind 100
*** HOLE CARDS ***
Dealt to Duke Croix [9d 4s]
Manon947: calls 100
color_singleton: calls 100
yairpinto: calls 50
Duke Croix: checks 
*** FLOP *** [2c Jh Qh]
yairpinto: bets 189
Duke Croix: folds 
Manon947: calls 189
color_singleton: folds 
*** TURN *** [2c Jh Qh] [3d]
yairpinto: checks 
Manon947: checks 
*** RIVER *** [2c Jh Qh 3d] [9h]
yairpinto: bets 367
Manon947: calls 367
*** SHOW DOWN ***
yairpinto: shows [Ts Kc] (a straight, Nine to King)
Manon947: mucks hand 
yairpinto collected 1429 from pot
*** SUMMARY ***
Total pot 1512 | Rake 83 
Board [2c Jh Qh 3d 9h]
Seat 1: color_singleton (button) folded on the Flop
Seat 2: yairpinto (small blind) showed [Ts Kc] and won (1429) with a straight, Nine to King
Seat 3: Duke Croix (big blind) folded on the Flop
Seat 8: Manon947 mucked [9c 6c]



PokerStars Home Game Hand #216957374587: {Club #3225207}  Hold'em No Limit (50/100) - 2020/07/30 17:59:25 ET
Table 'JansPokergame' 9-max (Play Money) Seat #2 is the button
Seat 1: color_singleton (9889 in chips) 
Seat 2: yairpinto (23930 in chips) 
Seat 3: Duke Croix (32222 in chips) 
Seat 8: Manon947 (10814 in chips) 
Duke Croix: posts small blind 50
Manon947: posts big blind 100
*** HOLE CARDS ***
Dealt to Duke Croix [Ks 7h]
color_singleton: folds 
yairpinto: folds 
Duke Croix: calls 50
dddocky is disconnected 
Manon947: checks 
*** FLOP *** [Td 9h Kh]
Duke Croix: bets 200
Manon947: calls 200
*** TURN *** [Td 9h Kh] [8c]
Duke Croix: checks 
Manon947: checks 
*** RIVER *** [Td 9h Kh 8c] [8s]
Duke Croix: bets 400
Manon947: folds 
Uncalled bet (400) returned to Duke Croix
Duke Croix collected 567 from pot
*** SUMMARY ***
Total pot 600 | Rake 33 
Board [Td 9h Kh 8c 8s]
Seat 1: color_singleton folded before Flop (didn't bet)
Seat 2: yairpinto (button) folded before Flop (didn't bet)
Seat 3: Duke Croix (small blind) collected (567)
Seat 8: Manon947 (big blind) folded on the River



PokerStars Home Game Hand #216957388148: {Club #3225207}  Hold'em No Limit (50/100) - 2020/07/30 17:59:58 ET
Table 'JansPokergame' 9-max (Play Money) Seat #3 is the button
Seat 1: color_singleton (9889 in chips) 
Seat 2: yairpinto (23930 in chips) 
Seat 3: Duke Croix (32489 in chips) 
Seat 8: Manon947 (10514 in chips) 
Manon947: posts small blind 50
color_singleton: posts big blind 100
*** HOLE CARDS ***
Dealt to Duke Croix [Jh Qc]
yairpinto: folds 
Duke Croix: raises 300 to 400
Manon947: calls 350
color_singleton: calls 300
*** FLOP *** [Qs 2d Ad]
Manon947: checks 
color_singleton: checks 
Duke Croix: checks 
*** TURN *** [Qs 2d Ad] [Ah]
Manon947: checks 
color_singleton: checks 
Duke Croix: bets 600
Manon947: calls 600
color_singleton: folds 
*** RIVER *** [Qs 2d Ad Ah] [Kd]
Manon947: checks 
Duke Croix: checks 
*** SHOW DOWN ***
Manon947: shows [5h 5s] (two pair, Aces and Fives)
Duke Croix: shows [Jh Qc] (two pair, Aces and Queens)
Duke Croix collected 2268 from pot
*** SUMMARY ***
Total pot 2400 | Rake 132 
Board [Qs 2d Ad Ah Kd]
Seat 1: color_singleton (big blind) folded on the Turn
Seat 2: yairpinto folded before Flop (didn't bet)
Seat 3: Duke Croix (button) showed [Jh Qc] and won (2268) with two pair, Aces and Queens
Seat 8: Manon947 (small blind) showed [5h 5s] and lost with two pair, Aces and Fives



PokerStars Home Game Hand #216957402269: {Club #3225207}  Hold'em No Limit (50/100) - 2020/07/30 18:00:30 ET
Table 'JansPokergame' 9-max (Play Money) Seat #8 is the button
Seat 1: color_singleton (9489 in chips) 
Seat 2: yairpinto (23930 in chips) 
Seat 3: Duke Croix (33757 in chips) 
Seat 8: Manon947 (9514 in chips) 
color_singleton: posts small blind 50
yairpinto: posts big blind 100
*** HOLE CARDS ***
Dealt to Duke Croix [3s Jd]
Duke Croix: folds 
Manon947: calls 100
color_singleton: calls 50
yairpinto: checks 
*** FLOP *** [6c As 9s]
color_singleton: checks 
yairpinto: bets 141
Manon947: folds 
color_singleton: folds 
Uncalled bet (141) returned to yairpinto
yairpinto collected 283 from pot
yairpinto: doesn't show hand 
*** SUMMARY ***
Total pot 300 | Rake 17 
Board [6c As 9s]
Seat 1: color_singleton (small blind) folded on the Flop
Seat 2: yairpinto (big blind) collected (283)
Seat 3: Duke Croix folded before Flop (didn't bet)
Seat 8: Manon947 (button) folded on the Flop



PokerStars Home Game Hand #216957412676: {Club #3225207}  Hold'em No Limit (50/100) - 2020/07/30 18:00:53 ET
Table 'JansPokergame' 9-max (Play Money) Seat #1 is the button
Seat 1: color_singleton (9389 in chips) 
Seat 2: yairpinto (24113 in chips) 
Seat 3: Duke Croix (33757 in chips) 
Seat 8: Manon947 (9414 in chips) 
yairpinto: posts small blind 50
Duke Croix: posts big blind 100
*** HOLE CARDS ***
Dealt to Duke Croix [6c 9d]
Manon947: calls 100
color_singleton: raises 200 to 300
yairpinto: folds 
Duke Croix has timed out
Duke Croix: folds 
Manon947: folds 
Uncalled bet (200) returned to color_singleton
color_singleton collected 350 from pot
color_singleton: doesn't show hand 
*** SUMMARY ***
Total pot 350 | Rake 0 
Seat 1: color_singleton (button) collected (350)
Seat 2: yairpinto (small blind) folded before Flop
Seat 3: Duke Croix (big blind) folded before Flop
Seat 8: Manon947 folded before Flop



PokerStars Home Game Hand #216957467712: {Club #3225207}  Hold'em No Limit (50/100) - 2020/07/30 18:02:42 ET
Table 'JansPokergame' 9-max (Play Money) Seat #1 is the button
Seat 1: color_singleton (9133 in chips) 
Seat 2: yairpinto (24750 in chips) 
Seat 3: Duke Croix (33657 in chips) 
Seat 8: Manon947 (9023 in chips) 
yairpinto: posts small blind 50
Duke Croix: posts big blind 100
*** HOLE CARDS ***
Dealt to Duke Croix [9c Th]
Manon947: folds 
color_singleton: raises 200 to 300
yairpinto: folds 
Duke Croix: calls 200
*** FLOP *** [8s Ac 2c]
Duke Croix: checks 
color_singleton: bets 307
Duke Croix: folds 
Uncalled bet (307) returned to color_singleton
color_singleton collected 614 from pot
color_singleton: doesn't show hand 
*** SUMMARY ***
Total pot 650 | Rake 36 
Board [8s Ac 2c]
Seat 1: color_singleton (button) collected (614)
Seat 2: yairpinto (small blind) folded before Flop
Seat 3: Duke Croix (big blind) folded on the Flop
Seat 8: Manon947 folded before Flop (didn't bet)



PokerStars Home Game Hand #216957476454: {Club #3225207}  Hold'em No Limit (50/100) - 2020/07/30 18:02:59 ET
Table 'JansPokergame' 9-max (Play Money) Seat #2 is the button
Seat 1: color_singleton (9447 in chips) 
Seat 2: yairpinto (24700 in chips) 
Seat 3: Duke Croix (33357 in chips) 
Seat 8: Manon947 (9023 in chips) 
Duke Croix: posts small blind 50
Manon947: posts big blind 100
*** HOLE CARDS ***
Dealt to Duke Croix [Qc 3h]
color_singleton: raises 100 to 200
yairpinto: folds 
Duke Croix: folds 
Manon947: folds 
Uncalled bet (100) returned to color_singleton
color_singleton collected 250 from pot
color_singleton: doesn't show hand 
*** SUMMARY ***
Total pot 250 | Rake 0 
Seat 1: color_singleton collected (250)
Seat 2: yairpinto (button) folded before Flop (didn't bet)
Seat 3: Duke Croix (small blind) folded before Flop
Seat 8: Manon947 (big blind) folded before Flop



PokerStars Home Game Hand #216957480456: {Club #3225207}  Hold'em No Limit (50/100) - 2020/07/30 18:03:07 ET
Table 'JansPokergame' 9-max (Play Money) Seat #3 is the button
Seat 1: color_singleton (9597 in chips) 
Seat 2: yairpinto (24700 in chips) 
Seat 3: Duke Croix (33307 in chips) 
Seat 8: Manon947 (8923 in chips) 
Manon947: posts small blind 50
color_singleton: posts big blind 100
*** HOLE CARDS ***
Dealt to Duke Croix [4h Ac]
yairpinto: folds 
Duke Croix: raises 300 to 400
Manon947: folds 
color_singleton: folds 
Uncalled bet (300) returned to Duke Croix
Duke Croix collected 250 from pot
*** SUMMARY ***
Total pot 250 | Rake 0 
Seat 1: color_singleton (big blind) folded before Flop
Seat 2: yairpinto folded before Flop (didn't bet)
Seat 3: Duke Croix (button) collected (250)
Seat 8: Manon947 (small blind) folded before Flop



PokerStars Home Game Hand #216957483878: {Club #3225207}  Hold'em No Limit (50/100) - 2020/07/30 18:03:14 ET
Table 'JansPokergame' 9-max (Play Money) Seat #8 is the button
Seat 1: color_singleton (9497 in chips) 
Seat 2: yairpinto (24700 in chips) 
Seat 3: Duke Croix (33457 in chips) 
Seat 8: Manon947 (8873 in chips) 
color_singleton: posts small blind 50
yairpinto: posts big blind 100
*** HOLE CARDS ***
Dealt to Duke Croix [7c Th]
Duke Croix: folds 
Manon947: calls 100
color_singleton: raises 200 to 300
yairpinto: folds 
Manon947: calls 200
*** FLOP *** [Ac 3c Kc]
color_singleton: bets 330
Manon947: calls 330
*** TURN *** [Ac 3c Kc] [8h]
color_singleton: checks 
Manon947: bets 1285
color_singleton: calls 1285
*** RIVER *** [Ac 3c Kc 8h] [7d]
color_singleton: checks 
Manon947: checks 
*** SHOW DOWN ***
color_singleton: shows [Qs Qc] (a pair of Queens)
Manon947: shows [Qd Kh] (a pair of Kings)
Manon947 collected 3714 from pot
*** SUMMARY ***
Total pot 3930 | Rake 216 
Board [Ac 3c Kc 8h 7d]
Seat 1: color_singleton (small blind) showed [Qs Qc] and lost with a pair of Queens
Seat 2: yairpinto (big blind) folded before Flop
Seat 3: Duke Croix folded before Flop (didn't bet)
Seat 8: Manon947 (button) showed [Qd Kh] and won (3714) with a pair of Kings



PokerStars Home Game Hand #216957503314: {Club #3225207}  Hold'em No Limit (50/100) - 2020/07/30 18:03:51 ET
Table 'JansPokergame' 9-max (Play Money) Seat #1 is the button
Seat 1: color_singleton (7582 in chips) 
Seat 2: yairpinto (24600 in chips) 
Seat 3: Duke Croix (33457 in chips) 
Seat 8: Manon947 (10672 in chips) 
yairpinto: posts small blind 50
Duke Croix: posts big blind 100
*** HOLE CARDS ***
Dealt to Duke Croix [3h 7d]
Manon947: calls 100
color_singleton: calls 100
yairpinto: calls 50
Duke Croix: checks 
*** FLOP *** [8c Ad 4c]
yairpinto: bets 189
Duke Croix: folds 
Manon947: calls 189
color_singleton: calls 189
*** TURN *** [8c Ad 4c] [Qs]
yairpinto: checks 
Manon947: bets 457
color_singleton: folds 
yairpinto: folds 
Uncalled bet (457) returned to Manon947
Manon947 collected 914 from pot
*** SUMMARY ***
Total pot 967 | Rake 53 
Board [8c Ad 4c Qs]
Seat 1: color_singleton (button) folded on the Turn
Seat 2: yairpinto (small blind) folded on the Turn
Seat 3: Duke Croix (big blind) folded on the Flop
Seat 8: Manon947 collected (914)



PokerStars Home Game Hand #216957519217: {Club #3225207}  Hold'em No Limit (50/100) - 2020/07/30 18:04:22 ET
Table 'JansPokergame' 9-max (Play Money) Seat #2 is the button
Seat 1: color_singleton (7293 in chips) 
Seat 2: yairpinto (24311 in chips) 
Seat 3: Duke Croix (33357 in chips) 
Seat 8: Manon947 (11297 in chips) 
Duke Croix: posts small blind 50
Manon947: posts big blind 100
*** HOLE CARDS ***
Dealt to Duke Croix [5d 4d]
color_singleton: folds 
yairpinto: raises 200 to 300
Duke Croix: calls 250
Manon947: calls 200
*** FLOP *** [3s 7d Ts]
Duke Croix: checks 
Manon947: checks 
yairpinto: bets 425
Duke Croix: folds 
Manon947: folds 
Uncalled bet (425) returned to yairpinto
yairpinto collected 850 from pot
yairpinto: doesn't show hand 
*** SUMMARY ***
Total pot 900 | Rake 50 
Board [3s 7d Ts]
Seat 1: color_singleton folded before Flop (didn't bet)
Seat 2: yairpinto (button) collected (850)
Seat 3: Duke Croix (small blind) folded on the Flop
Seat 8: Manon947 (big blind) folded on the Flop



PokerStars Home Game Hand #216957531682: {Club #3225207}  Hold'em No Limit (50/100) - 2020/07/30 18:04:46 ET
Table 'JansPokergame' 9-max (Play Money) Seat #3 is the button
Seat 1: color_singleton (7293 in chips) 
Seat 2: yairpinto (24861 in chips) 
Seat 3: Duke Croix (33057 in chips) 
Seat 8: Manon947 (10997 in chips) 
Manon947: posts small blind 50
color_singleton: posts big blind 100
*** HOLE CARDS ***
Dealt to Duke Croix [3s 7s]
yairpinto: folds 
Duke Croix: folds 
Manon947: calls 50
color_singleton: checks 
*** FLOP *** [2c 9h Td]
Manon947: checks 
color_singleton: checks 
*** TURN *** [2c 9h Td] [6s]
Manon947: checks 
color_singleton: bets 189
Manon947: calls 189
*** RIVER *** [2c 9h Td 6s] [9c]
Manon947: checks 
color_singleton: checks 
*** SHOW DOWN ***
Manon947: shows [Ac Qs] (a pair of Nines)
color_singleton: shows [6c 2d] (two pair, Nines and Sixes)
color_singleton collected 546 from pot
*** SUMMARY ***
Total pot 578 | Rake 32 
Board [2c 9h Td 6s 9c]
Seat 1: color_singleton (big blind) showed [6c 2d] and won (546) with two pair, Nines and Sixes
Seat 2: yairpinto folded before Flop (didn't bet)
Seat 3: Duke Croix (button) folded before Flop (didn't bet)
Seat 8: Manon947 (small blind) showed [Ac Qs] and lost with a pair of Nines



PokerStars Home Game Hand #216957548247: {Club #3225207}  Hold'em No Limit (50/100) - 2020/07/30 18:05:19 ET
Table 'JansPokergame' 9-max (Play Money) Seat #8 is the button
Seat 1: color_singleton (7550 in chips) 
Seat 2: yairpinto (24861 in chips) 
Seat 3: Duke Croix (33057 in chips) 
Seat 8: Manon947 (10708 in chips) 
color_singleton: posts small blind 50
yairpinto: posts big blind 100
*** HOLE CARDS ***
Dealt to Duke Croix [4d 7c]
Duke Croix: folds 
Manon947: calls 100
color_singleton: raises 200 to 300
yairpinto: folds 
Manon947: folds 
Uncalled bet (200) returned to color_singleton
color_singleton collected 300 from pot
color_singleton: doesn't show hand 
*** SUMMARY ***
Total pot 300 | Rake 0 
Seat 1: color_singleton (small blind) collected (300)
Seat 2: yairpinto (big blind) folded before Flop
Seat 3: Duke Croix folded before Flop (didn't bet)
Seat 8: Manon947 (button) folded before Flop



PokerStars Home Game Hand #216957557295: {Club #3225207}  Hold'em No Limit (50/100) - 2020/07/30 18:05:36 ET
Table 'JansPokergame' 9-max (Play Money) Seat #1 is the button
Seat 1: color_singleton (7750 in chips) 
Seat 2: yairpinto (24761 in chips) 
Seat 3: Duke Croix (33057 in chips) 
Seat 8: Manon947 (10608 in chips) 
yairpinto: posts small blind 50
Duke Croix: posts big blind 100
*** HOLE CARDS ***
Dealt to Duke Croix [Ts 7d]
Manon947: calls 100
color_singleton: folds 
yairpinto: folds 
Duke Croix: checks 
*** FLOP *** [6h Qd 4d]
Duke Croix: checks 
Manon947: checks 
*** TURN *** [6h Qd 4d] [4s]
Duke Croix: checks 
Manon947: checks 
*** RIVER *** [6h Qd 4d 4s] [5s]
Duke Croix: checks 
Manon947: checks 
*** SHOW DOWN ***
Duke Croix: shows [Ts 7d] (a pair of Fours)
Manon947: shows [Kh 9h] (a pair of Fours - King kicker)
Manon947 collected 236 from pot
*** SUMMARY ***
Total pot 250 | Rake 14 
Board [6h Qd 4d 4s 5s]
Seat 1: color_singleton (button) folded before Flop (didn't bet)
Seat 2: yairpinto (small blind) folded before Flop
Seat 3: Duke Croix (big blind) showed [Ts 7d] and lost with a pair of Fours
Seat 8: Manon947 showed [Kh 9h] and won (236) with a pair of Fours



PokerStars Home Game Hand #216957568741: {Club #3225207}  Hold'em No Limit (50/100) - 2020/07/30 18:05:59 ET
Table 'JansPokergame' 9-max (Play Money) Seat #2 is the button
Seat 1: color_singleton (7750 in chips) 
Seat 2: yairpinto (24711 in chips) 
Seat 3: Duke Croix (32957 in chips) 
Seat 8: Manon947 (10744 in chips) 
Duke Croix: posts small blind 50
Manon947: posts big blind 100
*** HOLE CARDS ***
Dealt to Duke Croix [7c Qd]
color_singleton: raises 200 to 300
yairpinto: calls 300
Duke Croix: folds 
Manon947: folds 
*** FLOP *** [5s 6s Th]
color_singleton: bets 709
yairpinto: folds 
Uncalled bet (709) returned to color_singleton
color_singleton collected 709 from pot
color_singleton: doesn't show hand 
*** SUMMARY ***
Total pot 750 | Rake 41 
Board [5s 6s Th]
Seat 1: color_singleton collected (709)
Seat 2: yairpinto (button) folded on the Flop
Seat 3: Duke Croix (small blind) folded before Flop
Seat 8: Manon947 (big blind) folded before Flop



PokerStars Home Game Hand #216957578761: {Club #3225207}  Hold'em No Limit (50/100) - 2020/07/30 18:06:18 ET
Table 'JansPokergame' 9-max (Play Money) Seat #3 is the button
Seat 1: color_singleton (8159 in chips) 
Seat 2: yairpinto (24411 in chips) 
Seat 3: Duke Croix (32907 in chips) 
Seat 8: Manon947 (10644 in chips) 
Manon947: posts small blind 50
color_singleton: posts big blind 100
*** HOLE CARDS ***
Dealt to Duke Croix [3s Qd]
yairpinto: folds 
Duke Croix: folds 
Manon947: folds 
Uncalled bet (50) returned to color_singleton
color_singleton collected 100 from pot
color_singleton: doesn't show hand 
*** SUMMARY ***
Total pot 100 | Rake 0 
Seat 1: color_singleton (big blind) collected (100)
Seat 2: yairpinto folded before Flop (didn't bet)
Seat 3: Duke Croix (button) folded before Flop (didn't bet)
Seat 8: Manon947 (small blind) folded before Flop



PokerStars Home Game Hand #216957583739: {Club #3225207}  Hold'em No Limit (50/100) - 2020/07/30 18:06:28 ET
Table 'JansPokergame' 9-max (Play Money) Seat #8 is the button
Seat 1: color_singleton (8209 in chips) 
Seat 2: yairpinto (24411 in chips) 
Seat 3: Duke Croix (32907 in chips) 
Seat 8: Manon947 (10594 in chips) 
color_singleton: posts small blind 50
yairpinto: posts big blind 100
*** HOLE CARDS ***
Dealt to Duke Croix [Kc Jc]
Duke Croix: raises 300 to 400
Manon947: folds 
color_singleton: folds 
yairpinto: folds 
Uncalled bet (300) returned to Duke Croix
Duke Croix collected 250 from pot
*** SUMMARY ***
Total pot 250 | Rake 0 
Seat 1: color_singleton (small blind) folded before Flop
Seat 2: yairpinto (big blind) folded before Flop
Seat 3: Duke Croix collected (250)
Seat 8: Manon947 (button) folded before Flop (didn't bet)



PokerStars Home Game Hand #216957588177: {Club #3225207}  Hold'em No Limit (50/100) - 2020/07/30 18:06:36 ET
Table 'JansPokergame' 9-max (Play Money) Seat #1 is the button
Seat 1: color_singleton (8159 in chips) 
Seat 2: yairpinto (24311 in chips) 
Seat 3: Duke Croix (33057 in chips) 
Seat 8: Manon947 (10594 in chips) 
yairpinto: posts small blind 50
Duke Croix: posts big blind 100
*** HOLE CARDS ***
Dealt to Duke Croix [As 8h]
Manon947: calls 100
color_singleton: raises 200 to 300
yairpinto: folds 
Duke Croix: calls 200
Manon947: calls 200
*** FLOP *** [9c 4c Qs]
Duke Croix: checks 
Manon947: checks 
color_singleton: bets 898
Duke Croix: folds 
Manon947: folds 
Uncalled bet (898) returned to color_singleton
color_singleton collected 898 from pot
color_singleton: doesn't show hand 
*** SUMMARY ***
Total pot 950 | Rake 52 
Board [9c 4c Qs]
Seat 1: color_singleton (button) collected (898)
Seat 2: yairpinto (small blind) folded before Flop
Seat 3: Duke Croix (big blind) folded on the Flop
Seat 8: Manon947 folded on the Flop



PokerStars Home Game Hand #216957599084: {Club #3225207}  Hold'em No Limit (50/100) - 2020/07/30 18:06:57 ET
Table 'JansPokergame' 9-max (Play Money) Seat #2 is the button
Seat 1: color_singleton (8757 in chips) 
Seat 2: yairpinto (24261 in chips) 
Seat 3: Duke Croix (32757 in chips) 
Seat 8: Manon947 (10294 in chips) 
Duke Croix: posts small blind 50
Manon947: posts big blind 100
*** HOLE CARDS ***
Dealt to Duke Croix [5h 4c]
color_singleton: folds 
yairpinto: raises 200 to 300
Duke Croix: folds 
Manon947: calls 200
*** FLOP *** [Th Qh 8s]
Manon947: checks 
yairpinto: bets 307
Manon947: folds 
Uncalled bet (307) returned to yairpinto
yairpinto collected 614 from pot
yairpinto: doesn't show hand 
*** SUMMARY ***
Total pot 650 | Rake 36 
Board [Th Qh 8s]
Seat 1: color_singleton folded before Flop (didn't bet)
Seat 2: yairpinto (button) collected (614)
Seat 3: Duke Croix (small blind) folded before Flop
Seat 8: Manon947 (big blind) folded on the Flop



PokerStars Home Game Hand #216957607696: {Club #3225207}  Hold'em No Limit (50/100) - 2020/07/30 18:07:14 ET
Table 'JansPokergame' 9-max (Play Money) Seat #3 is the button
Seat 1: color_singleton (8757 in chips) 
Seat 2: yairpinto (24575 in chips) 
Seat 3: Duke Croix (32707 in chips) 
Seat 8: Manon947 (9994 in chips) 
Manon947: posts small blind 50
color_singleton: posts big blind 100
*** HOLE CARDS ***
Dealt to Duke Croix [6d Ks]
yairpinto: folds 
Duke Croix: folds 
Manon947: calls 50
color_singleton: checks 
*** FLOP *** [9s Js As]
Manon947: bets 100
color_singleton: calls 100
*** TURN *** [9s Js As] [Jc]
Manon947: bets 100
color_singleton: folds 
Uncalled bet (100) returned to Manon947
Manon947 collected 378 from pot
*** SUMMARY ***
Total pot 400 | Rake 22 
Board [9s Js As Jc]
Seat 1: color_singleton (big blind) folded on the Turn
Seat 2: yairpinto folded before Flop (didn't bet)
Seat 3: Duke Croix (button) folded before Flop (didn't bet)
Seat 8: Manon947 (small blind) collected (378)



PokerStars Home Game Hand #216957620764: {Club #3225207}  Hold'em No Limit (50/100) - 2020/07/30 18:07:40 ET
Table 'JansPokergame' 9-max (Play Money) Seat #8 is the button
Seat 1: color_singleton (8557 in chips) 
Seat 2: yairpinto (24575 in chips) 
Seat 3: Duke Croix (32707 in chips) 
Seat 8: Manon947 (10172 in chips) 
color_singleton: posts small blind 50
yairpinto: posts big blind 100
*** HOLE CARDS ***
Dealt to Duke Croix [2h 9d]
Duke Croix: folds 
Manon947: folds 
color_singleton: folds 
Uncalled bet (50) returned to yairpinto
yairpinto collected 100 from pot
yairpinto: doesn't show hand 
*** SUMMARY ***
Total pot 100 | Rake 0 
Seat 1: color_singleton (small blind) folded before Flop
Seat 2: yairpinto (big blind) collected (100)
Seat 3: Duke Croix folded before Flop (didn't bet)
Seat 8: Manon947 (button) folded before Flop (didn't bet)



PokerStars Home Game Hand #216957624534: {Club #3225207}  Hold'em No Limit (50/100) - 2020/07/30 18:07:47 ET
Table 'JansPokergame' 9-max (Play Money) Seat #1 is the button
Seat 1: color_singleton (8507 in chips) 
Seat 2: yairpinto (24625 in chips) 
Seat 3: Duke Croix (32707 in chips) 
Seat 8: Manon947 (10172 in chips) 
yairpinto: posts small blind 50
Duke Croix: posts big blind 100
*** HOLE CARDS ***
Dealt to Duke Croix [Qc Ks]
Manon947: calls 100
color_singleton: folds 
yairpinto: calls 50
Duke Croix: raises 400 to 500
Manon947: folds 
yairpinto: folds 
Uncalled bet (400) returned to Duke Croix
Duke Croix collected 300 from pot
*** SUMMARY ***
Total pot 300 | Rake 0 
Seat 1: color_singleton (button) folded before Flop (didn't bet)
Seat 2: yairpinto (small blind) folded before Flop
Seat 3: Duke Croix (big blind) collected (300)
Seat 8: Manon947 folded before Flop



PokerStars Home Game Hand #216957630572: {Club #3225207}  Hold'em No Limit (50/100) - 2020/07/30 18:07:59 ET
Table 'JansPokergame' 9-max (Play Money) Seat #2 is the button
Seat 1: color_singleton (8507 in chips) 
Seat 2: yairpinto (24525 in chips) 
Seat 3: Duke Croix (32907 in chips) 
Seat 8: Manon947 (10072 in chips) 
Duke Croix: posts small blind 50
Manon947: posts big blind 100
*** HOLE CARDS ***
Dealt to Duke Croix [Kh Ts]
color_singleton: folds 
yairpinto: raises 200 to 300
Duke Croix: calls 250
Manon947: folds 
*** FLOP *** [3h As 2h]
Duke Croix: checks 
yairpinto: bets 330
Duke Croix: folds 
Uncalled bet (330) returned to yairpinto
yairpinto collected 661 from pot
yairpinto: doesn't show hand 
*** SUMMARY ***
Total pot 700 | Rake 39 
Board [3h As 2h]
Seat 1: color_singleton folded before Flop (didn't bet)
Seat 2: yairpinto (button) collected (661)
Seat 3: Duke Croix (small blind) folded on the Flop
Seat 8: Manon947 (big blind) folded before Flop



PokerStars Home Game Hand #216957639421: {Club #3225207}  Hold'em No Limit (50/100) - 2020/07/30 18:08:16 ET
Table 'JansPokergame' 9-max (Play Money) Seat #3 is the button
Seat 1: color_singleton (8507 in chips) 
Seat 2: yairpinto (24886 in chips) 
Seat 3: Duke Croix (32607 in chips) 
Seat 8: Manon947 (9972 in chips) 
Manon947: posts small blind 50
color_singleton: posts big blind 100
*** HOLE CARDS ***
Dealt to Duke Croix [6s 7s]
yairpinto: folds 
Duke Croix: calls 100
Manon947: calls 50
color_singleton: checks 
*** FLOP *** [8d 9c 3d]
Manon947: bets 141
color_singleton: folds 
Duke Croix: calls 141
*** TURN *** [8d 9c 3d] [7h]
Manon947: checks 
Duke Croix: bets 500
Manon947: folds 
Uncalled bet (500) returned to Duke Croix
Duke Croix collected 550 from pot
*** SUMMARY ***
Total pot 582 | Rake 32 
Board [8d 9c 3d 7h]
Seat 1: color_singleton (big blind) folded on the Flop
Seat 2: yairpinto folded before Flop (didn't bet)
Seat 3: Duke Croix (button) collected (550)
Seat 8: Manon947 (small blind) folded on the Turn



PokerStars Home Game Hand #216957654214: {Club #3225207}  Hold'em No Limit (50/100) - 2020/07/30 18:08:45 ET
Table 'JansPokergame' 9-max (Play Money) Seat #8 is the button
Seat 1: color_singleton (8407 in chips) 
Seat 2: yairpinto (24886 in chips) 
Seat 3: Duke Croix (32916 in chips) 
Seat 8: Manon947 (9731 in chips) 
color_singleton: posts small blind 50
yairpinto: posts big blind 100
*** HOLE CARDS ***
Dealt to Duke Croix [Qs 5d]
Duke Croix: folds 
Manon947: calls 100
color_singleton: raises 100 to 200
yairpinto: folds 
Manon947: calls 100
*** FLOP *** [8s 6h 3s]
color_singleton: checks 
Manon947: checks 
*** TURN *** [8s 6h 3s] [9c]
color_singleton: bets 236
Manon947: folds 
Uncalled bet (236) returned to color_singleton
color_singleton collected 472 from pot
color_singleton: doesn't show hand 
*** SUMMARY ***
Total pot 500 | Rake 28 
Board [8s 6h 3s 9c]
Seat 1: color_singleton (small blind) collected (472)
Seat 2: yairpinto (big blind) folded before Flop
Seat 3: Duke Croix folded before Flop (didn't bet)
Seat 8: Manon947 (button) folded on the Turn



PokerStars Home Game Hand #216957669922: {Club #3225207}  Hold'em No Limit (50/100) - 2020/07/30 18:09:17 ET
Table 'JansPokergame' 9-max (Play Money) Seat #1 is the button
Seat 1: color_singleton (8679 in chips) 
Seat 2: yairpinto (24786 in chips) 
Seat 3: Duke Croix (32916 in chips) 
Seat 8: Manon947 (9531 in chips) 
yairpinto: posts small blind 50
Duke Croix: posts big blind 100
*** HOLE CARDS ***
Dealt to Duke Croix [4c 3c]
Manon947: folds 
color_singleton: folds 
yairpinto: raises 200 to 300
Duke Croix: calls 200
*** FLOP *** [5s 7c 3d]
yairpinto: bets 283
Duke Croix: calls 283
*** TURN *** [5s 7c 3d] [Jc]
yairpinto: checks 
dddocky was removed from the table for failing to post
dddocky leaves the table
Duke Croix: bets 600
yairpinto: calls 600
*** RIVER *** [5s 7c 3d Jc] [2d]
yairpinto: checks 
Duke Croix: bets 1750
yairpinto: folds 
Uncalled bet (1750) returned to Duke Croix
Duke Croix collected 2236 from pot
*** SUMMARY ***
Total pot 2366 | Rake 130 
Board [5s 7c 3d Jc 2d]
Seat 1: color_singleton (button) folded before Flop (didn't bet)
Seat 2: yairpinto (small blind) folded on the River
Seat 3: Duke Croix (big blind) collected (2236)
Seat 8: Manon947 folded before Flop (didn't bet)



PokerStars Home Game Hand #216957696120: {Club #3225207}  Hold'em No Limit (50/100) - 2020/07/30 18:10:08 ET
Table 'JansPokergame' 9-max (Play Money) Seat #2 is the button
Seat 1: color_singleton (8679 in chips) 
Seat 2: yairpinto (23603 in chips) 
Seat 3: Duke Croix (33969 in chips) 
Seat 8: Manon947 (9531 in chips) 
Duke Croix: posts small blind 50
Manon947: posts big blind 100
*** HOLE CARDS ***
Dealt to Duke Croix [Ac Kc]
color_singleton: raises 200 to 300
yairpinto: calls 300
Duke Croix: raises 600 to 900
Manon947: folds 
color_singleton: calls 600
yairpinto: folds 
*** FLOP *** [Js 3d Qc]
Duke Croix: checks 
color_singleton: bets 1039
Duke Croix: folds 
Uncalled bet (1039) returned to color_singleton
color_singleton collected 2079 from pot
color_singleton: doesn't show hand 
*** SUMMARY ***
Total pot 2200 | Rake 121 
Board [Js 3d Qc]
Seat 1: color_singleton collected (2079)
Seat 2: yairpinto (button) folded before Flop
Seat 3: Duke Croix (small blind) folded on the Flop
Seat 8: Manon947 (big blind) folded before Flop



PokerStars Home Game Hand #216957715673: {Club #3225207}  Hold'em No Limit (50/100) - 2020/07/30 18:10:47 ET
Table 'JansPokergame' 9-max (Play Money) Seat #3 is the button
Seat 1: color_singleton (9858 in chips) 
Seat 2: yairpinto (23303 in chips) 
Seat 3: Duke Croix (33069 in chips) 
Seat 8: Manon947 (9431 in chips) 
Manon947: posts small blind 50
color_singleton: posts big blind 100
*** HOLE CARDS ***
Dealt to Duke Croix [4c Kc]
yairpinto: folds 
Duke Croix: folds 
Manon947: calls 50
color_singleton: checks 
*** FLOP *** [7s Ts 5c]
Manon947: checks 
color_singleton: bets 189
Manon947: calls 189
*** TURN *** [7s Ts 5c] [6s]
Manon947: bets 273
color_singleton: raises 273 to 546
Manon947: calls 273
*** RIVER *** [7s Ts 5c 6s] [2d]
Manon947: checks 
color_singleton: checks 
*** SHOW DOWN ***
Manon947: shows [9d 8c] (a straight, Six to Ten)
color_singleton: mucks hand 
Manon947 collected 1578 from pot
*** SUMMARY ***
Total pot 1670 | Rake 92 
Board [7s Ts 5c 6s 2d]
Seat 1: color_singleton (big blind) mucked [7c 6h]
Seat 2: yairpinto folded before Flop (didn't bet)
Seat 3: Duke Croix (button) folded before Flop (didn't bet)
Seat 8: Manon947 (small blind) showed [9d 8c] and won (1578) with a straight, Six to Ten



PokerStars Home Game Hand #216957731261: {Club #3225207}  Hold'em No Limit (50/100) - 2020/07/30 18:11:18 ET
Table 'JansPokergame' 9-max (Play Money) Seat #8 is the button
Seat 1: color_singleton (9023 in chips) 
Seat 3: Duke Croix (33069 in chips) 
Seat 8: Manon947 (10174 in chips) 
color_singleton: posts small blind 50
yairpinto: is sitting out 
Duke Croix: posts big blind 100
*** HOLE CARDS ***
Dealt to Duke Croix [7h 2d]
Manon947: calls 100
color_singleton: calls 50
Duke Croix: checks 
*** FLOP *** [6h 4h 6s]
color_singleton: bets 141
Duke Croix: folds 
Manon947: calls 141
*** TURN *** [6h 4h 6s] [Kd]
yairpinto leaves the table
color_singleton: checks 
Manon947: checks 
*** RIVER *** [6h 4h 6s Kd] [Qd]
color_singleton: checks 
Manon947: checks 
*** SHOW DOWN ***
color_singleton: shows [9s 7d] (a pair of Sixes)
Manon947: shows [Tc 4c] (two pair, Sixes and Fours)
Manon947 collected 550 from pot
*** SUMMARY ***
Total pot 582 | Rake 32 
Board [6h 4h 6s Kd Qd]
Seat 1: color_singleton (small blind) showed [9s 7d] and lost with a pair of Sixes
Seat 3: Duke Croix (big blind) folded on the Flop
Seat 8: Manon947 (button) showed [Tc 4c] and won (550) with two pair, Sixes and Fours



PokerStars Home Game Hand #216957754061: {Club #3225207}  Hold'em No Limit (50/100) - 2020/07/30 18:11:48 ET
Table 'JansPokergame' 9-max (Play Money) Seat #1 is the button
Seat 1: color_singleton (8782 in chips) 
Seat 3: Duke Croix (32969 in chips) 
Seat 8: Manon947 (10483 in chips) 
Duke Croix: posts small blind 50
Manon947: posts big blind 100
*** HOLE CARDS ***
Dealt to Duke Croix [7h Ah]
color_singleton: raises 100 to 200
Duke Croix: calls 150
Manon947: calls 100
*** FLOP *** [Ad 5c Qd]
Duke Croix: bets 400
Manon947: folds 
color_singleton: calls 400
*** TURN *** [Ad 5c Qd] [Ts]
Duke Croix: checks 
color_singleton: checks 
*** RIVER *** [Ad 5c Qd Ts] [As]
Duke Croix: bets 700
color_singleton: folds 
Uncalled bet (700) returned to Duke Croix
Duke Croix collected 1323 from pot
*** SUMMARY ***
Total pot 1400 | Rake 77 
Board [Ad 5c Qd Ts As]
Seat 1: color_singleton (button) folded on the River
Seat 3: Duke Croix (small blind) collected (1323)
Seat 8: Manon947 (big blind) folded on the Flop



PokerStars Home Game Hand #216957769973: {Club #3225207}  Hold'em No Limit (50/100) - 2020/07/30 18:12:19 ET
Table 'JansPokergame' 9-max (Play Money) Seat #3 is the button
Seat 1: color_singleton (8182 in chips) 
Seat 3: Duke Croix (33692 in chips) 
Seat 8: Manon947 (10283 in chips) 
Manon947: posts small blind 50
color_singleton: posts big blind 100
*** HOLE CARDS ***
Dealt to Duke Croix [5c Js]
Duke Croix: folds 
Manon947: calls 50
color_singleton: raises 200 to 300
Manon947: calls 200
*** FLOP *** [Jh 6d Jc]
Manon947: checks 
color_singleton: checks 
*** TURN *** [Jh 6d Jc] [5s]
Manon947: checks 
color_singleton: checks 
*** RIVER *** [Jh 6d Jc 5s] [Jd]
Manon947: checks 
color_singleton: checks 
*** SHOW DOWN ***
Manon947: shows [7s 3s] (three of a kind, Jacks)
color_singleton: shows [Ac 2h] (three of a kind, Jacks - Ace kicker)
color_singleton collected 567 from pot
*** SUMMARY ***
Total pot 600 | Rake 33 
Board [Jh 6d Jc 5s Jd]
Seat 1: color_singleton (big blind) showed [Ac 2h] and won (567) with three of a kind, Jacks
Seat 3: Duke Croix (button) folded before Flop (didn't bet)
Seat 8: Manon947 (small blind) showed [7s 3s] and lost with three of a kind, Jacks



PokerStars Home Game Hand #216957784298: {Club #3225207}  Hold'em No Limit (50/100) - 2020/07/30 18:12:48 ET
Table 'JansPokergame' 9-max (Play Money) Seat #8 is the button
Seat 1: color_singleton (8449 in chips) 
Seat 3: Duke Croix (33692 in chips) 
Seat 8: Manon947 (9983 in chips) 
color_singleton: posts small blind 50
Duke Croix: posts big blind 100
*** HOLE CARDS ***
Dealt to Duke Croix [Qd 6h]
Manon947: calls 100
color_singleton: calls 50
Duke Croix: checks 
*** FLOP *** [2d 8s Kc]
color_singleton: checks 
Duke Croix: checks 
Manon947: checks 
*** TURN *** [2d 8s Kc] [Td]
color_singleton: checks 
Duke Croix: checks 
Manon947: checks 
*** RIVER *** [2d 8s Kc Td] [7d]
color_singleton: checks 
Duke Croix: checks 
Manon947: checks 
*** SHOW DOWN ***
color_singleton: shows [3s 6s] (high card King)
Duke Croix: shows [Qd 6h] (high card King - Queen kicker)
Manon947: mucks hand 
Duke Croix collected 283 from pot
*** SUMMARY ***
Total pot 300 | Rake 17 
Board [2d 8s Kc Td 7d]
Seat 1: color_singleton (small blind) showed [3s 6s] and lost with high card King
Seat 3: Duke Croix (big blind) showed [Qd 6h] and won (283) with high card King
Seat 8: Manon947 (button) mucked [Jc 3h]



PokerStars Home Game Hand #216957799170: {Club #3225207}  Hold'em No Limit (50/100) - 2020/07/30 18:13:17 ET
Table 'JansPokergame' 9-max (Play Money) Seat #1 is the button
Seat 1: color_singleton (8349 in chips) 
Seat 3: Duke Croix (33875 in chips) 
Seat 8: Manon947 (9883 in chips) 
Duke Croix: posts small blind 50
Manon947: posts big blind 100
*** HOLE CARDS ***
Dealt to Duke Croix [8c 4s]
color_singleton: folds 
Duke Croix: calls 50
Manon947: checks 
*** FLOP *** [Qs 3c 2c]
Duke Croix: checks 
Manon947: checks 
*** TURN *** [Qs 3c 2c] [2s]
Duke Croix: checks 
Manon947: checks 
*** RIVER *** [Qs 3c 2c 2s] [Ks]
Duke Croix: checks 
Manon947: checks 
*** SHOW DOWN ***
Duke Croix: shows [8c 4s] (a pair of Deuces)
Manon947: shows [Th Js] (a pair of Deuces - King+Queen+Jack kicker)
Manon947 collected 189 from pot
*** SUMMARY ***
Total pot 200 | Rake 11 
Board [Qs 3c 2c 2s Ks]
Seat 1: color_singleton (button) folded before Flop (didn't bet)
Seat 3: Duke Croix (small blind) showed [8c 4s] and lost with a pair of Deuces
Seat 8: Manon947 (big blind) showed [Th Js] and won (189) with a pair of Deuces



PokerStars Home Game Hand #216957809638: {Club #3225207}  Hold'em No Limit (50/100) - 2020/07/30 18:13:38 ET
Table 'JansPokergame' 9-max (Play Money) Seat #3 is the button
Seat 1: color_singleton (8349 in chips) 
Seat 3: Duke Croix (33775 in chips) 
Seat 8: Manon947 (9972 in chips) 
Manon947: posts small blind 50
color_singleton: posts big blind 100
*** HOLE CARDS ***
Dealt to Duke Croix [8h 6d]
Duke Croix: folds 
Manon947: calls 50
color_singleton: checks 
*** FLOP *** [Kc 3s 9s]
Manon947: checks 
color_singleton: checks 
*** TURN *** [Kc 3s 9s] [4s]
Manon947: checks 
color_singleton: checks 
*** RIVER *** [Kc 3s 9s 4s] [9c]
Manon947: checks 
color_singleton: checks 
*** SHOW DOWN ***
Manon947: shows [Ah 2s] (a pair of Nines)
color_singleton: shows [Jh 4c] (two pair, Nines and Fours)
color_singleton collected 189 from pot
*** SUMMARY ***
Total pot 200 | Rake 11 
Board [Kc 3s 9s 4s 9c]
Seat 1: color_singleton (big blind) showed [Jh 4c] and won (189) with two pair, Nines and Fours
Seat 3: Duke Croix (button) folded before Flop (didn't bet)
Seat 8: Manon947 (small blind) showed [Ah 2s] and lost with a pair of Nines



PokerStars Home Game Hand #216957821245: {Club #3225207}  Hold'em No Limit (50/100) - 2020/07/30 18:14:02 ET
Table 'JansPokergame' 9-max (Play Money) Seat #8 is the button
Seat 1: color_singleton (8438 in chips) 
Seat 3: Duke Croix (33775 in chips) 
Seat 8: Manon947 (9872 in chips) 
color_singleton: posts small blind 50
Duke Croix: posts big blind 100
*** HOLE CARDS ***
Dealt to Duke Croix [3h 8d]
Manon947: calls 100
color_singleton: calls 50
Duke Croix: checks 
*** FLOP *** [7d 4h 2c]
color_singleton: checks 
Duke Croix: checks 
Manon947: checks 
*** TURN *** [7d 4h 2c] [9s]
color_singleton: bets 141
Duke Croix: folds 
Manon947: calls 141
*** RIVER *** [7d 4h 2c 9s] [6s]
color_singleton: checks 
Manon947: checks 
*** SHOW DOWN ***
color_singleton: shows [6c 8c] (a pair of Sixes)
Manon947: mucks hand 
color_singleton collected 550 from pot
*** SUMMARY ***
Total pot 582 | Rake 32 
Board [7d 4h 2c 9s 6s]
Seat 1: color_singleton (small blind) showed [6c 8c] and won (550) with a pair of Sixes
Seat 3: Duke Croix (big blind) folded on the Turn
Seat 8: Manon947 (button) mucked [As Tc]



PokerStars Home Game Hand #216957835817: {Club #3225207}  Hold'em No Limit (50/100) - 2020/07/30 18:14:31 ET
Table 'JansPokergame' 9-max (Play Money) Seat #1 is the button
Seat 1: color_singleton (8747 in chips) 
Seat 3: Duke Croix (33675 in chips) 
Seat 8: Manon947 (9631 in chips) 
Duke Croix: posts small blind 50
Manon947: posts big blind 100
*** HOLE CARDS ***
Dealt to Duke Croix [2h Jh]
color_singleton: raises 200 to 300
Duke Croix: folds 
Manon947: calls 200
*** FLOP *** [Kh 6c Ah]
Manon947: checks 
color_singleton: bets 307
Manon947: folds 
Uncalled bet (307) returned to color_singleton
color_singleton collected 614 from pot
color_singleton: doesn't show hand 
*** SUMMARY ***
Total pot 650 | Rake 36 
Board [Kh 6c Ah]
Seat 1: color_singleton (button) collected (614)
Seat 3: Duke Croix (small blind) folded before Flop
Seat 8: Manon947 (big blind) folded on the Flop



PokerStars Home Game Hand #216957844355: {Club #3225207}  Hold'em No Limit (50/100) - 2020/07/30 18:14:48 ET
Table 'JansPokergame' 9-max (Play Money) Seat #3 is the button
Seat 1: color_singleton (9061 in chips) 
Seat 3: Duke Croix (33625 in chips) 
Seat 8: Manon947 (9331 in chips) 
Manon947: posts small blind 50
color_singleton: posts big blind 100
*** HOLE CARDS ***
Dealt to Duke Croix [4d Ac]
Duke Croix: folds 
Manon947: calls 50
color_singleton: checks 
*** FLOP *** [4h 4s 8c]
Manon947: checks 
color_singleton: checks 
*** TURN *** [4h 4s 8c] [5h]
Manon947: checks 
color_singleton: checks 
*** RIVER *** [4h 4s 8c 5h] [3d]
Manon947: checks 
color_singleton: checks 
*** SHOW DOWN ***
Manon947: shows [2c Jh] (a pair of Fours)
color_singleton: shows [3c 7d] (two pair, Fours and Threes)
color_singleton collected 189 from pot
*** SUMMARY ***
Total pot 200 | Rake 11 
Board [4h 4s 8c 5h 3d]
Seat 1: color_singleton (big blind) showed [3c 7d] and won (189) with two pair, Fours and Threes
Seat 3: Duke Croix (button) folded before Flop (didn't bet)
Seat 8: Manon947 (small blind) showed [2c Jh] and lost with a pair of Fours



PokerStars Home Game Hand #216957856853: {Club #3225207}  Hold'em No Limit (50/100) - 2020/07/30 18:15:14 ET
Table 'JansPokergame' 9-max (Play Money) Seat #8 is the button
Seat 1: color_singleton (9150 in chips) 
Seat 3: Duke Croix (33625 in chips) 
Seat 8: Manon947 (9231 in chips) 
color_singleton: posts small blind 50
Duke Croix: posts big blind 100
*** HOLE CARDS ***
Dealt to Duke Croix [4s Qs]
Manon947: calls 100
color_singleton: calls 50
Duke Croix: checks 
*** FLOP *** [Ts 5s Td]
color_singleton: checks 
Duke Croix: bets 200
Manon947: folds 
color_singleton: calls 200
*** TURN *** [Ts 5s Td] [3h]
color_singleton: bets 330
Duke Croix: raises 330 to 660
color_singleton: calls 330
*** RIVER *** [Ts 5s Td 3h] [6d]
color_singleton: checks 
Duke Croix: checks 
*** SHOW DOWN ***
color_singleton: shows [9h Tc] (three of a kind, Tens)
Duke Croix: mucks hand 
color_singleton collected 1909 from pot
*** SUMMARY ***
Total pot 2020 | Rake 111 
Board [Ts 5s Td 3h 6d]
Seat 1: color_singleton (small blind) showed [9h Tc] and won (1909) with three of a kind, Tens
Seat 3: Duke Croix (big blind) mucked [4s Qs]
Seat 8: Manon947 (button) folded on the Flop



PokerStars Home Game Hand #216957874466: {Club #3225207}  Hold'em No Limit (50/100) - 2020/07/30 18:15:49 ET
Table 'JansPokergame' 9-max (Play Money) Seat #1 is the button
Seat 1: color_singleton (10099 in chips) 
Seat 3: Duke Croix (32665 in chips) 
Seat 8: Manon947 (9131 in chips) 
Duke Croix: posts small blind 50
Manon947: posts big blind 100
*** HOLE CARDS ***
Dealt to Duke Croix [Jd 3h]
color_singleton: folds 
Duke Croix: calls 50
Manon947: checks 
*** FLOP *** [8s 3c 2d]
Duke Croix: checks 
Manon947: checks 
*** TURN *** [8s 3c 2d] [5d]
Duke Croix: checks 
Manon947: checks 
*** RIVER *** [8s 3c 2d 5d] [Qd]
Duke Croix: checks 
Manon947: checks 
*** SHOW DOWN ***
Duke Croix: shows [Jd 3h] (a pair of Threes)
Manon947: mucks hand 
Duke Croix collected 189 from pot
*** SUMMARY ***
Total pot 200 | Rake 11 
Board [8s 3c 2d 5d Qd]
Seat 1: color_singleton (button) folded before Flop (didn't bet)
Seat 3: Duke Croix (small blind) showed [Jd 3h] and won (189) with a pair of Threes
Seat 8: Manon947 (big blind) mucked [6h Js]



PokerStars Home Game Hand #216957885626: {Club #3225207}  Hold'em No Limit (50/100) - 2020/07/30 18:16:12 ET
Table 'JansPokergame' 9-max (Play Money) Seat #3 is the button
Seat 1: color_singleton (10099 in chips) 
Seat 3: Duke Croix (32754 in chips) 
Seat 8: Manon947 (9031 in chips) 
Manon947: posts small blind 50
color_singleton: posts big blind 100
*** HOLE CARDS ***
Dealt to Duke Croix [7s Jd]
Duke Croix: folds 
Manon947: calls 50
color_singleton: checks 
*** FLOP *** [Kc 5h 6h]
Manon947: bets 100
color_singleton: calls 100
*** TURN *** [Kc 5h 6h] [3s]
Manon947: checks 
color_singleton: checks 
*** RIVER *** [Kc 5h 6h 3s] [5c]
Manon947: bets 189
color_singleton: raises 189 to 378
Manon947: folds 
Uncalled bet (189) returned to color_singleton
color_singleton collected 735 from pot
color_singleton: doesn't show hand 
*** SUMMARY ***
Total pot 778 | Rake 43 
Board [Kc 5h 6h 3s 5c]
Seat 1: color_singleton (big blind) collected (735)
Seat 3: Duke Croix (button) folded before Flop (didn't bet)
Seat 8: Manon947 (small blind) folded on the River



PokerStars Home Game Hand #216957898325: {Club #3225207}  Hold'em No Limit (50/100) - 2020/07/30 18:16:37 ET
Table 'JansPokergame' 9-max (Play Money) Seat #8 is the button
Seat 1: color_singleton (10445 in chips) 
Seat 3: Duke Croix (32754 in chips) 
Seat 8: Manon947 (8642 in chips) 
color_singleton: posts small blind 50
Duke Croix: posts big blind 100
*** HOLE CARDS ***
Dealt to Duke Croix [5h Kd]
Manon947: folds 
color_singleton: raises 200 to 300
Duke Croix: calls 200
*** FLOP *** [4h 9h Ts]
color_singleton: checks 
Duke Croix: checks 
*** TURN *** [4h 9h Ts] [5s]
color_singleton: checks 
Duke Croix: checks 
*** RIVER *** [4h 9h Ts 5s] [8d]
color_singleton: checks 
Duke Croix: checks 
*** SHOW DOWN ***
color_singleton: shows [Ad 6d] (high card Ace)
Duke Croix: shows [5h Kd] (a pair of Fives)
Duke Croix collected 567 from pot
*** SUMMARY ***
Total pot 600 | Rake 33 
Board [4h 9h Ts 5s 8d]
Seat 1: color_singleton (small blind) showed [Ad 6d] and lost with high card Ace
Seat 3: Duke Croix (big blind) showed [5h Kd] and won (567) with a pair of Fives
Seat 8: Manon947 (button) folded before Flop (didn't bet)



PokerStars Home Game Hand #216957911285: {Club #3225207}  Hold'em No Limit (50/100) - 2020/07/30 18:17:04 ET
Table 'JansPokergame' 9-max (Play Money) Seat #1 is the button
Seat 1: color_singleton (10145 in chips) 
Seat 3: Duke Croix (33021 in chips) 
Seat 8: Manon947 (8642 in chips) 
Duke Croix: posts small blind 50
Manon947: posts big blind 100
*** HOLE CARDS ***
Dealt to Duke Croix [Th 3c]
color_singleton: folds 
Duke Croix: folds 
Uncalled bet (50) returned to Manon947
Manon947 collected 100 from pot
*** SUMMARY ***
Total pot 100 | Rake 0 
Seat 1: color_singleton (button) folded before Flop (didn't bet)
Seat 3: Duke Croix (small blind) folded before Flop
Seat 8: Manon947 (big blind) collected (100)



PokerStars Home Game Hand #216957914019: {Club #3225207}  Hold'em No Limit (50/100) - 2020/07/30 18:17:09 ET
Table 'JansPokergame' 9-max (Play Money) Seat #3 is the button
Seat 1: color_singleton (10145 in chips) 
Seat 3: Duke Croix (32971 in chips) 
Seat 8: Manon947 (8692 in chips) 
Manon947: posts small blind 50
color_singleton: posts big blind 100
*** HOLE CARDS ***
Dealt to Duke Croix [5h 4c]
Duke Croix: folds 
Manon947: calls 50
color_singleton: checks 
*** FLOP *** [Kc 6d 5s]
Manon947: checks 
color_singleton: checks 
*** TURN *** [Kc 6d 5s] [Jd]
Manon947: checks 
color_singleton: checks 
*** RIVER *** [Kc 6d 5s Jd] [2c]
Manon947: checks 
color_singleton: checks 
*** SHOW DOWN ***
Manon947: shows [3d 8h] (high card King)
color_singleton: shows [7s 6h] (a pair of Sixes)
color_singleton collected 189 from pot
*** SUMMARY ***
Total pot 200 | Rake 11 
Board [Kc 6d 5s Jd 2c]
Seat 1: color_singleton (big blind) showed [7s 6h] and won (189) with a pair of Sixes
Seat 3: Duke Croix (button) folded before Flop (didn't bet)
Seat 8: Manon947 (small blind) showed [3d 8h] and lost with high card King



PokerStars Home Game Hand #216957927016: {Club #3225207}  Hold'em No Limit (50/100) - 2020/07/30 18:17:35 ET
Table 'JansPokergame' 9-max (Play Money) Seat #8 is the button
Seat 1: color_singleton (10234 in chips) 
Seat 3: Duke Croix (32971 in chips) 
Seat 8: Manon947 (8592 in chips) 
color_singleton: posts small blind 50
Duke Croix: posts big blind 100
*** HOLE CARDS ***
Dealt to Duke Croix [7h 2h]
Manon947: calls 100
color_singleton: folds 
Duke Croix: checks 
*** FLOP *** [8d 7c 3c]
Duke Croix: bets 200
Manon947: calls 200
*** TURN *** [8d 7c 3c] [4h]
Duke Croix: bets 400
Manon947: folds 
Uncalled bet (400) returned to Duke Croix
Duke Croix collected 614 from pot
*** SUMMARY ***
Total pot 650 | Rake 36 
Board [8d 7c 3c 4h]
Seat 1: color_singleton (small blind) folded before Flop
Seat 3: Duke Croix (big blind) collected (614)
Seat 8: Manon947 (button) folded on the Turn



PokerStars Home Game Hand #216957936316: {Club #3225207}  Hold'em No Limit (50/100) - 2020/07/30 18:17:55 ET
Table 'JansPokergame' 9-max (Play Money) Seat #1 is the button
Seat 1: color_singleton (10184 in chips) 
Seat 3: Duke Croix (33285 in chips) 
Seat 8: Manon947 (8292 in chips) 
Duke Croix: posts small blind 50
Manon947: posts big blind 100
*** HOLE CARDS ***
Dealt to Duke Croix [Ac 6c]
color_singleton: raises 100 to 200
Duke Croix: calls 150
Manon947: folds 
*** FLOP *** [Qh 5s Jd]
Duke Croix: checks 
color_singleton: bets 236
Duke Croix: folds 
Uncalled bet (236) returned to color_singleton
color_singleton collected 472 from pot
color_singleton: doesn't show hand 
*** SUMMARY ***
Total pot 500 | Rake 28 
Board [Qh 5s Jd]
Seat 1: color_singleton (button) collected (472)
Seat 3: Duke Croix (small blind) folded on the Flop
Seat 8: Manon947 (big blind) folded before Flop



PokerStars Home Game Hand #216957944245: {Club #3225207}  Hold'em No Limit (50/100) - 2020/07/30 18:18:11 ET
Table 'JansPokergame' 9-max (Play Money) Seat #3 is the button
Seat 1: color_singleton (10456 in chips) 
Seat 3: Duke Croix (33085 in chips) 
Seat 8: Manon947 (8192 in chips) 
Manon947: posts small blind 50
color_singleton: posts big blind 100
*** HOLE CARDS ***
Dealt to Duke Croix [Ac 2d]
Duke Croix: calls 100
Manon947: calls 50
color_singleton: checks 
*** FLOP *** [Qs 9d Ah]
Manon947: checks 
color_singleton: bets 141
Duke Croix: calls 141
Manon947: folds 
*** TURN *** [Qs 9d Ah] [6d]
color_singleton: checks 
Duke Croix: checks 
*** RIVER *** [Qs 9d Ah 6d] [8c]
color_singleton: checks 
Duke Croix: checks 
*** SHOW DOWN ***
color_singleton: shows [Tc 9s] (a pair of Nines)
Duke Croix: shows [Ac 2d] (a pair of Aces)
Duke Croix collected 550 from pot
*** SUMMARY ***
Total pot 582 | Rake 32 
Board [Qs 9d Ah 6d 8c]
Seat 1: color_singleton (big blind) showed [Tc 9s] and lost with a pair of Nines
Seat 3: Duke Croix (button) showed [Ac 2d] and won (550) with a pair of Aces
Seat 8: Manon947 (small blind) folded on the Flop



PokerStars Home Game Hand #216957957834: {Club #3225207}  Hold'em No Limit (50/100) - 2020/07/30 18:18:38 ET
Table 'JansPokergame' 9-max (Play Money) Seat #8 is the button
Seat 1: color_singleton (10215 in chips) 
Seat 3: Duke Croix (33394 in chips) 
Seat 8: Manon947 (8092 in chips) 
color_singleton: posts small blind 50
Duke Croix: posts big blind 100
*** HOLE CARDS ***
Dealt to Duke Croix [Qh Jh]
Manon947: folds 
color_singleton: calls 50
Duke Croix: raises 300 to 400
color_singleton: folds 
Uncalled bet (300) returned to Duke Croix
Duke Croix collected 200 from pot
*** SUMMARY ***
Total pot 200 | Rake 0 
Seat 1: color_singleton (small blind) folded before Flop
Seat 3: Duke Croix (big blind) collected (200)
Seat 8: Manon947 (button) folded before Flop (didn't bet)



PokerStars Home Game Hand #216957962654: {Club #3225207}  Hold'em No Limit (50/100) - 2020/07/30 18:18:48 ET
Table 'JansPokergame' 9-max (Play Money) Seat #1 is the button
Seat 1: color_singleton (10115 in chips) 
Seat 3: Duke Croix (33494 in chips) 
Seat 8: Manon947 (8092 in chips) 
Duke Croix: posts small blind 50
Manon947: posts big blind 100
*** HOLE CARDS ***
Dealt to Duke Croix [6c 2h]
color_singleton: folds 
Duke Croix: calls 50
Manon947: checks 
*** FLOP *** [9s 7d 2s]
Duke Croix: bets 200
Manon947: folds 
Uncalled bet (200) returned to Duke Croix
Duke Croix collected 189 from pot
*** SUMMARY ***
Total pot 200 | Rake 11 
Board [9s 7d 2s]
Seat 1: color_singleton (button) folded before Flop (didn't bet)
Seat 3: Duke Croix (small blind) collected (189)
Seat 8: Manon947 (big blind) folded on the Flop



PokerStars Home Game Hand #216957970467: {Club #3225207}  Hold'em No Limit (50/100) - 2020/07/30 18:19:04 ET
Table 'JansPokergame' 9-max (Play Money) Seat #3 is the button
Seat 1: color_singleton (10115 in chips) 
Seat 3: Duke Croix (33583 in chips) 
Seat 8: Manon947 (7992 in chips) 
Manon947: posts small blind 50
color_singleton: posts big blind 100
*** HOLE CARDS ***
Dealt to Duke Croix [Jc 4c]
Duke Croix: folds 
Manon947: calls 50
color_singleton: checks 
*** FLOP *** [8s 4d Ks]
Manon947: checks 
color_singleton: checks 
*** TURN *** [8s 4d Ks] [6c]
Manon947: checks 
color_singleton: checks 
*** RIVER *** [8s 4d Ks 6c] [6s]
Manon947: checks 
color_singleton: bets 189
Manon947: folds 
Uncalled bet (189) returned to color_singleton
color_singleton collected 189 from pot
color_singleton: doesn't show hand 
*** SUMMARY ***
Total pot 200 | Rake 11 
Board [8s 4d Ks 6c 6s]
Seat 1: color_singleton (big blind) collected (189)
Seat 3: Duke Croix (button) folded before Flop (didn't bet)
Seat 8: Manon947 (small blind) folded on the River



PokerStars Home Game Hand #216957982294: {Club #3225207}  Hold'em No Limit (50/100) - 2020/07/30 18:19:28 ET
Table 'JansPokergame' 9-max (Play Money) Seat #8 is the button
Seat 1: color_singleton (10204 in chips) 
Seat 3: Duke Croix (33583 in chips) 
Seat 8: Manon947 (7892 in chips) 
color_singleton: posts small blind 50
Duke Croix: posts big blind 100
*** HOLE CARDS ***
Dealt to Duke Croix [2s Ks]
Manon947: calls 100
color_singleton: raises 200 to 300
Duke Croix: calls 200
Manon947: calls 200
*** FLOP *** [Jh 9s 3c]
color_singleton: checks 
Duke Croix: checks 
Manon947: checks 
*** TURN *** [Jh 9s 3c] [Tc]
color_singleton: checks 
Duke Croix: checks 
Manon947: checks 
*** RIVER *** [Jh 9s 3c Tc] [6d]
color_singleton: bets 425
Duke Croix: folds 
Manon947: calls 425
*** SHOW DOWN ***
color_singleton: shows [Td Kd] (a pair of Tens)
Manon947: mucks hand 
color_singleton collected 1654 from pot
*** SUMMARY ***
Total pot 1750 | Rake 96 
Board [Jh 9s 3c Tc 6d]
Seat 1: color_singleton (small blind) showed [Td Kd] and won (1654) with a pair of Tens
Seat 3: Duke Croix (big blind) folded on the River
Seat 8: Manon947 (button) mucked [5d Ah]



PokerStars Home Game Hand #216958008539: {Club #3225207}  Hold'em No Limit (50/100) - 2020/07/30 18:20:02 ET
Table 'JansPokergame' 9-max (Play Money) Seat #1 is the button
Seat 1: color_singleton (11133 in chips) 
Seat 3: Duke Croix (33283 in chips) 
Seat 8: Manon947 (7167 in chips) 
Duke Croix: posts small blind 50
Manon947: posts big blind 100
*** HOLE CARDS ***
Dealt to Duke Croix [7h Qs]
color_singleton: folds 
Duke Croix: calls 50
Manon947: checks 
*** FLOP *** [Ah Ts Kh]
Duke Croix: checks 
Manon947: checks 
*** TURN *** [Ah Ts Kh] [6s]
Duke Croix: checks 
Manon947: bets 100
Duke Croix: folds 
Uncalled bet (100) returned to Manon947
Manon947 collected 189 from pot
*** SUMMARY ***
Total pot 200 | Rake 11 
Board [Ah Ts Kh 6s]
Seat 1: color_singleton (button) folded before Flop (didn't bet)
Seat 3: Duke Croix (small blind) folded on the Turn
Seat 8: Manon947 (big blind) collected (189)



PokerStars Home Game Hand #216958019007: {Club #3225207}  Hold'em No Limit (50/100) - 2020/07/30 18:20:24 ET
Table 'JansPokergame' 9-max (Play Money) Seat #3 is the button
Seat 1: color_singleton (11133 in chips) 
Seat 3: Duke Croix (33183 in chips) 
Seat 8: Manon947 (7256 in chips) 
Manon947: posts small blind 50
color_singleton: posts big blind 100
*** HOLE CARDS ***
Dealt to Duke Croix [8s 2h]
Duke Croix: folds 
Manon947: calls 50
color_singleton: checks 
*** FLOP *** [7s 6d 3d]
Manon947: bets 100
color_singleton: folds 
Uncalled bet (100) returned to Manon947
Manon947 collected 189 from pot
*** SUMMARY ***
Total pot 200 | Rake 11 
Board [7s 6d 3d]
Seat 1: color_singleton (big blind) folded on the Flop
Seat 3: Duke Croix (button) folded before Flop (didn't bet)
Seat 8: Manon947 (small blind) collected (189)



PokerStars Home Game Hand #216958027008: {Club #3225207}  Hold'em No Limit (50/100) - 2020/07/30 18:20:40 ET
Table 'JansPokergame' 9-max (Play Money) Seat #8 is the button
Seat 1: color_singleton (11033 in chips) 
Seat 3: Duke Croix (33183 in chips) 
Seat 8: Manon947 (7345 in chips) 
color_singleton: posts small blind 50
Duke Croix: posts big blind 100
*** HOLE CARDS ***
Dealt to Duke Croix [3h Tc]
Manon947: folds 
color_singleton: calls 50
Duke Croix: checks 
*** FLOP *** [Qc 6d Td]
color_singleton: checks 
Duke Croix: bets 200
color_singleton: calls 200
*** TURN *** [Qc 6d Td] [Kh]
color_singleton: checks 
Duke Croix: checks 
*** RIVER *** [Qc 6d Td Kh] [7d]
color_singleton: checks 
Duke Croix: checks 
*** SHOW DOWN ***
color_singleton: shows [7c 9h] (a pair of Sevens)
Duke Croix: shows [3h Tc] (a pair of Tens)
Duke Croix collected 567 from pot
*** SUMMARY ***
Total pot 600 | Rake 33 
Board [Qc 6d Td Kh 7d]
Seat 1: color_singleton (small blind) showed [7c 9h] and lost with a pair of Sevens
Seat 3: Duke Croix (big blind) showed [3h Tc] and won (567) with a pair of Tens
Seat 8: Manon947 (button) folded before Flop (didn't bet)



PokerStars Home Game Hand #216958040764: {Club #3225207}  Hold'em No Limit (50/100) - 2020/07/30 18:21:08 ET
Table 'JansPokergame' 9-max (Play Money) Seat #1 is the button
Seat 1: color_singleton (10733 in chips) 
Seat 3: Duke Croix (33450 in chips) 
Seat 8: Manon947 (7345 in chips) 
Duke Croix: posts small blind 50
Manon947: posts big blind 100
*** HOLE CARDS ***
Dealt to Duke Croix [7s 6c]
color_singleton: raises 100 to 200
Duke Croix: calls 150
Manon947: calls 100
*** FLOP *** [Tc Qs 5d]
Duke Croix: checks 
Manon947: checks 
color_singleton: checks 
*** TURN *** [Tc Qs 5d] [3h]
Duke Croix: checks 
Manon947: checks 
color_singleton: checks 
*** RIVER *** [Tc Qs 5d 3h] [6d]
Duke Croix: checks 
Manon947: checks 
color_singleton: checks 
*** SHOW DOWN ***
Duke Croix: shows [7s 6c] (a pair of Sixes)
Manon947: mucks hand 
color_singleton: mucks hand 
Duke Croix collected 567 from pot
*** SUMMARY ***
Total pot 600 | Rake 33 
Board [Tc Qs 5d 3h 6d]
Seat 1: color_singleton (button) mucked [8s Js]
Seat 3: Duke Croix (small blind) showed [7s 6c] and won (567) with a pair of Sixes
Seat 8: Manon947 (big blind) mucked [Jd 9d]



PokerStars Home Game Hand #216958055580: {Club #3225207}  Hold'em No Limit (50/100) - 2020/07/30 18:21:38 ET
Table 'JansPokergame' 9-max (Play Money) Seat #3 is the button
Seat 1: color_singleton (10533 in chips) 
Seat 3: Duke Croix (33817 in chips) 
Seat 8: Manon947 (7145 in chips) 
Manon947: posts small blind 50
color_singleton: posts big blind 100
*** HOLE CARDS ***
Dealt to Duke Croix [7s 3s]
Duke Croix: folds 
Manon947: raises 100 to 200
color_singleton: calls 100
*** FLOP *** [7h Ts 7c]
Manon947: bets 189
color_singleton: calls 189
*** TURN *** [7h Ts 7c] [5c]
Manon947: bets 367
color_singleton: folds 
Uncalled bet (367) returned to Manon947
Manon947 collected 735 from pot
*** SUMMARY ***
Total pot 778 | Rake 43 
Board [7h Ts 7c 5c]
Seat 1: color_singleton (big blind) folded on the Turn
Seat 3: Duke Croix (button) folded before Flop (didn't bet)
Seat 8: Manon947 (small blind) collected (735)



PokerStars Home Game Hand #216958065584: {Club #3225207}  Hold'em No Limit (50/100) - 2020/07/30 18:21:59 ET
Table 'JansPokergame' 9-max (Play Money) Seat #8 is the button
Seat 1: color_singleton (10144 in chips) 
Seat 3: Duke Croix (33817 in chips) 
Seat 8: Manon947 (7491 in chips) 
color_singleton: posts small blind 50
Duke Croix: posts big blind 100
*** HOLE CARDS ***
Dealt to Duke Croix [3s Ts]
Manon947: calls 100
color_singleton: raises 200 to 300
Duke Croix: folds 
Manon947: folds 
Uncalled bet (200) returned to color_singleton
color_singleton collected 300 from pot
color_singleton: doesn't show hand 
*** SUMMARY ***
Total pot 300 | Rake 0 
Seat 1: color_singleton (small blind) collected (300)
Seat 3: Duke Croix (big blind) folded before Flop
Seat 8: Manon947 (button) folded before Flop



PokerStars Home Game Hand #216958075973: {Club #3225207}  Hold'em No Limit (50/100) - 2020/07/30 18:22:20 ET
Table 'JansPokergame' 9-max (Play Money) Seat #1 is the button
Seat 1: color_singleton (10344 in chips) 
Seat 3: Duke Croix (33717 in chips) 
Seat 8: Manon947 (7391 in chips) 
Duke Croix: posts small blind 50
Manon947: posts big blind 100
*** HOLE CARDS ***
Dealt to Duke Croix [7d 2d]
color_singleton: folds 
Duke Croix: calls 50
Manon947: checks 
*** FLOP *** [Qs 2s 4d]
Duke Croix: checks 
Manon947: checks 
*** TURN *** [Qs 2s 4d] [2h]
Duke Croix: bets 200
Manon947: folds 
Uncalled bet (200) returned to Duke Croix
Duke Croix collected 189 from pot
*** SUMMARY ***
Total pot 200 | Rake 11 
Board [Qs 2s 4d 2h]
Seat 1: color_singleton (button) folded before Flop (didn't bet)
Seat 3: Duke Croix (small blind) collected (189)
Seat 8: Manon947 (big blind) folded on the Turn



PokerStars Home Game Hand #216958083311: {Club #3225207}  Hold'em No Limit (50/100) - 2020/07/30 18:22:35 ET
Table 'JansPokergame' 9-max (Play Money) Seat #3 is the button
Seat 1: color_singleton (10344 in chips) 
Seat 3: Duke Croix (33806 in chips) 
Seat 8: Manon947 (7291 in chips) 
Manon947: posts small blind 50
color_singleton: posts big blind 100
*** HOLE CARDS ***
Dealt to Duke Croix [Kh Qs]
Duke Croix: raises 300 to 400
Manon947: folds 
color_singleton: calls 300
*** FLOP *** [Tc 6c Jh]
color_singleton: bets 401
Duke Croix: calls 401
*** TURN *** [Tc 6c Jh] [Js]
color_singleton: checks 
Duke Croix: bets 600
color_singleton: calls 600
*** RIVER *** [Tc 6c Jh Js] [6s]
color_singleton: checks 
Duke Croix: bets 2000
color_singleton: folds 
Uncalled bet (2000) returned to Duke Croix
Duke Croix collected 2695 from pot
*** SUMMARY ***
Total pot 2852 | Rake 157 
Board [Tc 6c Jh Js 6s]
Seat 1: color_singleton (big blind) folded on the River
Seat 3: Duke Croix (button) collected (2695)
Seat 8: Manon947 (small blind) folded before Flop



PokerStars Home Game Hand #216958098809: {Club #3225207}  Hold'em No Limit (50/100) - 2020/07/30 18:23:07 ET
Table 'JansPokergame' 9-max (Play Money) Seat #8 is the button
Seat 1: color_singleton (8943 in chips) 
Seat 3: Duke Croix (35100 in chips) 
Seat 8: Manon947 (7241 in chips) 
color_singleton: posts small blind 50
Duke Croix: posts big blind 100
*** HOLE CARDS ***
Dealt to Duke Croix [Th Kh]
Manon947: calls 100
color_singleton: raises 100 to 200
Duke Croix: calls 100
Manon947: calls 100
*** FLOP *** [6h 5h Qs]
color_singleton: bets 283
Duke Croix: calls 283
Manon947: calls 283
*** TURN *** [6h 5h Qs] [8h]
color_singleton: checks 
Duke Croix: bets 700
Manon947: folds 
color_singleton: folds 
Uncalled bet (700) returned to Duke Croix
Duke Croix collected 1369 from pot
*** SUMMARY ***
Total pot 1449 | Rake 80 
Board [6h 5h Qs 8h]
Seat 1: color_singleton (small blind) folded on the Turn
Seat 3: Duke Croix (big blind) collected (1369)
Seat 8: Manon947 (button) folded on the Turn



PokerStars Home Game Hand #216958116168: {Club #3225207}  Hold'em No Limit (50/100) - 2020/07/30 18:23:43 ET
Table 'JansPokergame' 9-max (Play Money) Seat #1 is the button
Seat 1: color_singleton (8460 in chips) 
Seat 3: Duke Croix (35986 in chips) 
Seat 8: Manon947 (6758 in chips) 
Duke Croix: posts small blind 50
Manon947: posts big blind 100
*** HOLE CARDS ***
Dealt to Duke Croix [7d 8s]
color_singleton: folds 
Duke Croix: calls 50
Manon947: raises 100 to 200
Duke Croix: calls 100
*** FLOP *** [2c 4s Jd]
Duke Croix: checks 
Manon947: bets 189
Duke Croix: folds 
Uncalled bet (189) returned to Manon947
Manon947 collected 378 from pot
*** SUMMARY ***
Total pot 400 | Rake 22 
Board [2c 4s Jd]
Seat 1: color_singleton (button) folded before Flop (didn't bet)
Seat 3: Duke Croix (small blind) folded on the Flop
Seat 8: Manon947 (big blind) collected (378)



PokerStars Home Game Hand #216958124634: {Club #3225207}  Hold'em No Limit (50/100) - 2020/07/30 18:24:00 ET
Table 'JansPokergame' 9-max (Play Money) Seat #3 is the button
Seat 1: color_singleton (8460 in chips) 
Seat 3: Duke Croix (35786 in chips) 
Seat 8: Manon947 (6936 in chips) 
Manon947: posts small blind 50
color_singleton: posts big blind 100
*** HOLE CARDS ***
Dealt to Duke Croix [6s Ts]
Duke Croix: folds 
Manon947: calls 50
color_singleton: checks 
*** FLOP *** [7d 5c Kh]
Manon947: checks 
color_singleton: bets 189
Manon947: calls 189
*** TURN *** [7d 5c Kh] [3h]
Manon947: checks 
color_singleton: checks 
*** RIVER *** [7d 5c Kh 3h] [7s]
Manon947: checks 
color_singleton: checks 
*** SHOW DOWN ***
Manon947: shows [2d Ad] (a pair of Sevens)
color_singleton: shows [Kc 2h] (two pair, Kings and Sevens)
color_singleton collected 546 from pot
*** SUMMARY ***
Total pot 578 | Rake 32 
Board [7d 5c Kh 3h 7s]
Seat 1: color_singleton (big blind) showed [Kc 2h] and won (546) with two pair, Kings and Sevens
Seat 3: Duke Croix (button) folded before Flop (didn't bet)
Seat 8: Manon947 (small blind) showed [2d Ad] and lost with a pair of Sevens



PokerStars Home Game Hand #216958137870: {Club #3225207}  Hold'em No Limit (50/100) - 2020/07/30 18:24:28 ET
Table 'JansPokergame' 9-max (Play Money) Seat #8 is the button
Seat 1: color_singleton (8717 in chips) 
Seat 3: Duke Croix (35786 in chips) 
Seat 8: Manon947 (6647 in chips) 
color_singleton: posts small blind 50
Duke Croix: posts big blind 100
*** HOLE CARDS ***
Dealt to Duke Croix [4c 4h]
Manon947: calls 100
color_singleton: calls 50
Duke Croix: raises 300 to 400
Manon947: folds 
color_singleton: folds 
Uncalled bet (300) returned to Duke Croix
Duke Croix collected 300 from pot
*** SUMMARY ***
Total pot 300 | Rake 0 
Seat 1: color_singleton (small blind) folded before Flop
Seat 3: Duke Croix (big blind) collected (300)
Seat 8: Manon947 (button) folded before Flop



PokerStars Home Game Hand #216958146092: {Club #3225207}  Hold'em No Limit (50/100) - 2020/07/30 18:24:45 ET
Table 'JansPokergame' 9-max (Play Money) Seat #1 is the button
Seat 1: color_singleton (8617 in chips) 
Seat 3: Duke Croix (35986 in chips) 
Seat 8: Manon947 (6547 in chips) 
Duke Croix: posts small blind 50
Manon947: posts big blind 100
*** HOLE CARDS ***
Dealt to Duke Croix [7h Jh]
color_singleton: raises 100 to 200
Duke Croix: calls 150
Manon947: calls 100
*** FLOP *** [5h Kd As]
Duke Croix: checks 
Manon947: checks 
color_singleton: bets 283
Duke Croix: folds 
Manon947: calls 283
*** TURN *** [5h Kd As] [7c]
Manon947: checks 
color_singleton: checks 
*** RIVER *** [5h Kd As 7c] [9c]
Manon947: checks 
color_singleton: checks 
*** SHOW DOWN ***
Manon947: shows [Td Qh] (high card Ace)
color_singleton: shows [Kc 3h] (a pair of Kings)
color_singleton collected 1102 from pot
*** SUMMARY ***
Total pot 1166 | Rake 64 
Board [5h Kd As 7c 9c]
Seat 1: color_singleton (button) showed [Kc 3h] and won (1102) with a pair of Kings
Seat 3: Duke Croix (small blind) folded on the Flop
Seat 8: Manon947 (big blind) showed [Td Qh] and lost with high card Ace



PokerStars Home Game Hand #216958159490: {Club #3225207}  Hold'em No Limit (50/100) - 2020/07/30 18:25:13 ET
Table 'JansPokergame' 9-max (Play Money) Seat #3 is the button
Seat 1: color_singleton (9236 in chips) 
Seat 3: Duke Croix (35786 in chips) 
Seat 8: Manon947 (6064 in chips) 
Manon947: posts small blind 50
color_singleton: posts big blind 100
*** HOLE CARDS ***
Dealt to Duke Croix [6s 5d]
Duke Croix: calls 100
Manon947: folds 
color_singleton: checks 
*** FLOP *** [Qh Jh 2h]
color_singleton: checks 
Duke Croix: checks 
*** TURN *** [Qh Jh 2h] [5c]
color_singleton: bets 118
Duke Croix: folds 
Uncalled bet (118) returned to color_singleton
color_singleton collected 236 from pot
color_singleton: doesn't show hand 
*** SUMMARY ***
Total pot 250 | Rake 14 
Board [Qh Jh 2h 5c]
Seat 1: color_singleton (big blind) collected (236)
Seat 3: Duke Croix (button) folded on the Turn
Seat 8: Manon947 (small blind) folded before Flop



PokerStars Home Game Hand #216958168161: {Club #3225207}  Hold'em No Limit (50/100) - 2020/07/30 18:25:31 ET
Table 'JansPokergame' 9-max (Play Money) Seat #8 is the button
Seat 1: color_singleton (9372 in chips) 
Seat 3: Duke Croix (35686 in chips) 
Seat 8: Manon947 (6014 in chips) 
color_singleton: posts small blind 50
Duke Croix: posts big blind 100
*** HOLE CARDS ***
Dealt to Duke Croix [5c Js]
Manon947: folds 
color_singleton: raises 200 to 300
Duke Croix: calls 200
*** FLOP *** [Qc 7d Tc]
color_singleton: bets 283
Duke Croix: folds 
Uncalled bet (283) returned to color_singleton
color_singleton collected 567 from pot
color_singleton: doesn't show hand 
*** SUMMARY ***
Total pot 600 | Rake 33 
Board [Qc 7d Tc]
Seat 1: color_singleton (small blind) collected (567)
Seat 3: Duke Croix (big blind) folded on the Flop
Seat 8: Manon947 (button) folded before Flop (didn't bet)



PokerStars Home Game Hand #216958176873: {Club #3225207}  Hold'em No Limit (50/100) - 2020/07/30 18:25:49 ET
Table 'JansPokergame' 9-max (Play Money) Seat #1 is the button
Seat 1: color_singleton (9639 in chips) 
Seat 3: Duke Croix (35386 in chips) 
Seat 8: Manon947 (6014 in chips) 
Duke Croix: posts small blind 50
Manon947: posts big blind 100
*** HOLE CARDS ***
Dealt to Duke Croix [As 8c]
color_singleton: raises 100 to 200
Duke Croix: calls 150
Manon947: calls 100
*** FLOP *** [9c 3d Kc]
Duke Croix: checks 
Manon947: checks 
color_singleton: bets 283
Duke Croix: folds 
Manon947: calls 283
*** TURN *** [9c 3d Kc] [9s]
Manon947: checks 
color_singleton: checks 
*** RIVER *** [9c 3d Kc 9s] [6d]
Manon947: bets 551
color_singleton: folds 
Uncalled bet (551) returned to Manon947
Manon947 collected 1102 from pot
*** SUMMARY ***
Total pot 1166 | Rake 64 
Board [9c 3d Kc 9s 6d]
Seat 1: color_singleton (button) folded on the River
Seat 3: Duke Croix (small blind) folded on the Flop
Seat 8: Manon947 (big blind) collected (1102)



PokerStars Home Game Hand #216958192703: {Club #3225207}  Hold'em No Limit (50/100) - 2020/07/30 18:26:22 ET
Table 'JansPokergame' 9-max (Play Money) Seat #3 is the button
Seat 1: color_singleton (9156 in chips) 
Seat 3: Duke Croix (35186 in chips) 
Seat 8: Manon947 (6633 in chips) 
Manon947: posts small blind 50
color_singleton: posts big blind 100
*** HOLE CARDS ***
Dealt to Duke Croix [2c Ts]
Duke Croix: folds 
Manon947: folds 
Uncalled bet (50) returned to color_singleton
color_singleton collected 100 from pot
color_singleton: doesn't show hand 
*** SUMMARY ***
Total pot 100 | Rake 0 
Seat 1: color_singleton (big blind) collected (100)
Seat 3: Duke Croix (button) folded before Flop (didn't bet)
Seat 8: Manon947 (small blind) folded before Flop



PokerStars Home Game Hand #216958196342: {Club #3225207}  Hold'em No Limit (50/100) - 2020/07/30 18:26:30 ET
Table 'JansPokergame' 9-max (Play Money) Seat #8 is the button
Seat 1: color_singleton (9206 in chips) 
Seat 3: Duke Croix (35186 in chips) 
Seat 8: Manon947 (6583 in chips) 
color_singleton: posts small blind 50
Duke Croix: posts big blind 100
*** HOLE CARDS ***
Dealt to Duke Croix [4s 6h]
Manon947: calls 100
color_singleton: calls 50
Duke Croix: checks 
*** FLOP *** [Ks 5s 7s]
color_singleton: checks 
Duke Croix: checks 
Manon947: bets 141
color_singleton: folds 
Duke Croix: folds 
Uncalled bet (141) returned to Manon947
Manon947 collected 283 from pot
*** SUMMARY ***
Total pot 300 | Rake 17 
Board [Ks 5s 7s]
Seat 1: color_singleton (small blind) folded on the Flop
Seat 3: Duke Croix (big blind) folded on the Flop
Seat 8: Manon947 (button) collected (283)



PokerStars Home Game Hand #216958205589: {Club #3225207}  Hold'em No Limit (50/100) - 2020/07/30 18:26:49 ET
Table 'JansPokergame' 9-max (Play Money) Seat #1 is the button
Seat 1: color_singleton (9106 in chips) 
Seat 3: Duke Croix (35086 in chips) 
Seat 8: Manon947 (6766 in chips) 
Duke Croix: posts small blind 50
Manon947: posts big blind 100
*** HOLE CARDS ***
Dealt to Duke Croix [Ac 3s]
color_singleton: folds 
Duke Croix: calls 50
Manon947: checks 
*** FLOP *** [7c As 8h]
Duke Croix: bets 200
Manon947: folds 
Uncalled bet (200) returned to Duke Croix
Duke Croix collected 189 from pot
*** SUMMARY ***
Total pot 200 | Rake 11 
Board [7c As 8h]
Seat 1: color_singleton (button) folded before Flop (didn't bet)
Seat 3: Duke Croix (small blind) collected (189)
Seat 8: Manon947 (big blind) folded on the Flop



PokerStars Home Game Hand #216958211828: {Club #3225207}  Hold'em No Limit (50/100) - 2020/07/30 18:27:02 ET
Table 'JansPokergame' 9-max (Play Money) Seat #3 is the button
Seat 1: color_singleton (9106 in chips) 
Seat 3: Duke Croix (35175 in chips) 
Seat 8: Manon947 (6666 in chips) 
Manon947: posts small blind 50
color_singleton: posts big blind 100
*** HOLE CARDS ***
Dealt to Duke Croix [Kh 2s]
Duke Croix: folds 
Manon947: raises 100 to 200
color_singleton: calls 100
*** FLOP *** [9d 6s 6h]
Manon947: checks 
color_singleton: bets 189
Manon947: folds 
Uncalled bet (189) returned to color_singleton
color_singleton collected 378 from pot
color_singleton: doesn't show hand 
*** SUMMARY ***
Total pot 400 | Rake 22 
Board [9d 6s 6h]
Seat 1: color_singleton (big blind) collected (378)
Seat 3: Duke Croix (button) folded before Flop (didn't bet)
Seat 8: Manon947 (small blind) folded on the Flop



PokerStars Home Game Hand #216958220304: {Club #3225207}  Hold'em No Limit (50/100) - 2020/07/30 18:27:20 ET
Table 'JansPokergame' 9-max (Play Money) Seat #8 is the button
Seat 1: color_singleton (9284 in chips) 
Seat 3: Duke Croix (35175 in chips) 
Seat 8: Manon947 (6466 in chips) 
color_singleton: posts small blind 50
Duke Croix: posts big blind 100
*** HOLE CARDS ***
Dealt to Duke Croix [Qh 8d]
Manon947: folds 
color_singleton: calls 50
Duke Croix: checks 
*** FLOP *** [2d 3h 5s]
color_singleton: checks 
Duke Croix: checks 
*** TURN *** [2d 3h 5s] [Th]
color_singleton: checks 
Duke Croix: checks 
*** RIVER *** [2d 3h 5s Th] [2c]
color_singleton: checks 
Duke Croix: checks 
*** SHOW DOWN ***
color_singleton: shows [Jd 6s] (a pair of Deuces)
Duke Croix: shows [Qh 8d] (a pair of Deuces - Queen kicker)
Duke Croix collected 189 from pot
*** SUMMARY ***
Total pot 200 | Rake 11 
Board [2d 3h 5s Th 2c]
Seat 1: color_singleton (small blind) showed [Jd 6s] and lost with a pair of Deuces
Seat 3: Duke Croix (big blind) showed [Qh 8d] and won (189) with a pair of Deuces
Seat 8: Manon947 (button) folded before Flop (didn't bet)



PokerStars Home Game Hand #216958227522: {Club #3225207}  Hold'em No Limit (50/100) - 2020/07/30 18:27:35 ET
Table 'JansPokergame' 9-max (Play Money) Seat #1 is the button
Seat 1: color_singleton (9184 in chips) 
Seat 3: Duke Croix (35264 in chips) 
Seat 8: Manon947 (6466 in chips) 
Duke Croix: posts small blind 50
Manon947: posts big blind 100
*** HOLE CARDS ***
Dealt to Duke Croix [Th 2h]
color_singleton: raises 200 to 300
Duke Croix: folds 
Manon947: folds 
Uncalled bet (200) returned to color_singleton
color_singleton collected 250 from pot
color_singleton: doesn't show hand 
*** SUMMARY ***
Total pot 250 | Rake 0 
Seat 1: color_singleton (button) collected (250)
Seat 3: Duke Croix (small blind) folded before Flop
Seat 8: Manon947 (big blind) folded before Flop



PokerStars Home Game Hand #216958232070: {Club #3225207}  Hold'em No Limit (50/100) - 2020/07/30 18:27:45 ET
Table 'JansPokergame' 9-max (Play Money) Seat #3 is the button
Seat 1: color_singleton (9334 in chips) 
Seat 3: Duke Croix (35214 in chips) 
Seat 8: Manon947 (6366 in chips) 
Manon947: posts small blind 50
color_singleton: posts big blind 100
*** HOLE CARDS ***
Dealt to Duke Croix [7c Kh]
Duke Croix: raises 200 to 300
Manon947: folds 
color_singleton: calls 200
*** FLOP *** [Ts 9d 2d]
color_singleton: checks 
Duke Croix: checks 
*** TURN *** [Ts 9d 2d] [5s]
color_singleton: bets 307
Duke Croix: folds 
Uncalled bet (307) returned to color_singleton
color_singleton collected 614 from pot
color_singleton: doesn't show hand 
*** SUMMARY ***
Total pot 650 | Rake 36 
Board [Ts 9d 2d 5s]
Seat 1: color_singleton (big blind) collected (614)
Seat 3: Duke Croix (button) folded on the Turn
Seat 8: Manon947 (small blind) folded before Flop



PokerStars Home Game Hand #216958239388: {Club #3225207}  Hold'em No Limit (50/100) - 2020/07/30 18:28:01 ET
Table 'JansPokergame' 9-max (Play Money) Seat #8 is the button
Seat 1: color_singleton (9648 in chips) 
Seat 3: Duke Croix (34914 in chips) 
Seat 8: Manon947 (6316 in chips) 
color_singleton: posts small blind 50
Duke Croix: posts big blind 100
*** HOLE CARDS ***
Dealt to Duke Croix [4d 3s]
Manon947: raises 100 to 200
color_singleton: calls 150
Duke Croix: folds 
*** FLOP *** [7d Ac Td]
color_singleton: checks 
Manon947: bets 236
color_singleton: raises 236 to 472
Manon947: raises 236 to 708
color_singleton: raises 236 to 944
Manon947: raises 236 to 1180
color_singleton: calls 236
*** TURN *** [7d Ac Td] [8c]
color_singleton: bets 2703
Manon947: raises 2233 to 4936 and is all-in
color_singleton: calls 2233
*** RIVER *** [7d Ac Td 8c] [6h]
*** SHOW DOWN ***
color_singleton: shows [Ks Ah] (a pair of Aces)
Manon947: shows [Th Ts] (three of a kind, Tens)
Manon947 collected 12032 from pot
*** SUMMARY ***
Total pot 12732 | Rake 700 
Board [7d Ac Td 8c 6h]
Seat 1: color_singleton (small blind) showed [Ks Ah] and lost with a pair of Aces
Seat 3: Duke Croix (big blind) folded before Flop
Seat 8: Manon947 (button) showed [Th Ts] and won (12032) with three of a kind, Tens



PokerStars Home Game Hand #216958265671: {Club #3225207}  Hold'em No Limit (50/100) - 2020/07/30 18:28:56 ET
Table 'JansPokergame' 9-max (Play Money) Seat #1 is the button
Seat 1: color_singleton (3332 in chips) 
Seat 3: Duke Croix (34814 in chips) 
Seat 8: Manon947 (12032 in chips) 
Duke Croix: posts small blind 50
Manon947: posts big blind 100
*** HOLE CARDS ***
Dealt to Duke Croix [Jh 8d]
color_singleton: raises 200 to 300
Duke Croix: folds 
Manon947: calls 200
*** FLOP *** [6h 4c Kc]
Manon947: checks 
color_singleton: bets 614
Manon947: folds 
Uncalled bet (614) returned to color_singleton
color_singleton collected 614 from pot
color_singleton: doesn't show hand 
*** SUMMARY ***
Total pot 650 | Rake 36 
Board [6h 4c Kc]
Seat 1: color_singleton (button) collected (614)
Seat 3: Duke Croix (small blind) folded before Flop
Seat 8: Manon947 (big blind) folded on the Flop



PokerStars Home Game Hand #216958275832: {Club #3225207}  Hold'em No Limit (50/100) - 2020/07/30 18:29:17 ET
Table 'JansPokergame' 9-max (Play Money) Seat #3 is the button
Seat 1: color_singleton (3646 in chips) 
Seat 3: Duke Croix (34764 in chips) 
Seat 8: Manon947 (11732 in chips) 
Manon947: posts small blind 50
color_singleton: posts big blind 100
*** HOLE CARDS ***
Dealt to Duke Croix [Qh 9c]
Duke Croix: calls 100
Manon947: folds 
color_singleton: checks 
*** FLOP *** [5s 6s 7h]
color_singleton: bets 236
Duke Croix: folds 
Uncalled bet (236) returned to color_singleton
color_singleton collected 236 from pot
color_singleton: doesn't show hand 
*** SUMMARY ***
Total pot 250 | Rake 14 
Board [5s 6s 7h]
Seat 1: color_singleton (big blind) collected (236)
Seat 3: Duke Croix (button) folded on the Flop
Seat 8: Manon947 (small blind) folded before Flop



PokerStars Home Game Hand #216958283170: {Club #3225207}  Hold'em No Limit (50/100) - 2020/07/30 18:29:32 ET
Table 'JansPokergame' 9-max (Play Money) Seat #8 is the button
Seat 1: color_singleton (3782 in chips) 
Seat 3: Duke Croix (34664 in chips) 
Seat 8: Manon947 (11682 in chips) 
color_singleton: posts small blind 50
Duke Croix: posts big blind 100
*** HOLE CARDS ***
Dealt to Duke Croix [2h Ks]
Manon947: folds 
color_singleton: raises 200 to 300
Duke Croix: folds 
Uncalled bet (200) returned to color_singleton
color_singleton collected 200 from pot
color_singleton: doesn't show hand 
*** SUMMARY ***
Total pot 200 | Rake 0 
Seat 1: color_singleton (small blind) collected (200)
Seat 3: Duke Croix (big blind) folded before Flop
Seat 8: Manon947 (button) folded before Flop (didn't bet)



PokerStars Home Game Hand #216958288222: {Club #3225207}  Hold'em No Limit (50/100) - 2020/07/30 18:29:43 ET
Table 'JansPokergame' 9-max (Play Money) Seat #1 is the button
Seat 1: color_singleton (3882 in chips) 
Seat 3: Duke Croix (34564 in chips) 
Seat 8: Manon947 (11682 in chips) 
Duke Croix: posts small blind 50
Manon947: posts big blind 100
*** HOLE CARDS ***
Dealt to Duke Croix [2d 8h]
color_singleton: raises 300 to 400
Duke Croix: folds 
Manon947: folds 
Uncalled bet (300) returned to color_singleton
color_singleton collected 250 from pot
color_singleton: doesn't show hand 
*** SUMMARY ***
Total pot 250 | Rake 0 
Seat 1: color_singleton (button) collected (250)
Seat 3: Duke Croix (small blind) folded before Flop
Seat 8: Manon947 (big blind) folded before Flop



PokerStars Home Game Hand #216958295019: {Club #3225207}  Hold'em No Limit (50/100) - 2020/07/30 18:29:57 ET
Table 'JansPokergame' 9-max (Play Money) Seat #3 is the button
Seat 1: color_singleton (4032 in chips) 
Seat 3: Duke Croix (34514 in chips) 
Seat 8: Manon947 (11582 in chips) 
Manon947: posts small blind 50
color_singleton: posts big blind 100
*** HOLE CARDS ***
Dealt to Duke Croix [7s 4h]
Duke Croix: folds 
Manon947: calls 50
color_singleton: raises 300 to 400
Manon947: folds 
Uncalled bet (300) returned to color_singleton
color_singleton collected 200 from pot
color_singleton: doesn't show hand 
*** SUMMARY ***
Total pot 200 | Rake 0 
Seat 1: color_singleton (big blind) collected (200)
Seat 3: Duke Croix (button) folded before Flop (didn't bet)
Seat 8: Manon947 (small blind) folded before Flop



PokerStars Home Game Hand #216958300551: {Club #3225207}  Hold'em No Limit (50/100) - 2020/07/30 18:30:09 ET
Table 'JansPokergame' 9-max (Play Money) Seat #8 is the button
Seat 1: color_singleton (4132 in chips) 
Seat 3: Duke Croix (34514 in chips) 
Seat 8: Manon947 (11482 in chips) 
color_singleton: posts small blind 50
Duke Croix: posts big blind 100
*** HOLE CARDS ***
Dealt to Duke Croix [Kh 3h]
Manon947: folds 
color_singleton: raises 100 to 200
Duke Croix: calls 100
*** FLOP *** [Ac 6d Ts]
color_singleton: bets 189
Duke Croix: folds 
Uncalled bet (189) returned to color_singleton
color_singleton collected 378 from pot
color_singleton: doesn't show hand 
*** SUMMARY ***
Total pot 400 | Rake 22 
Board [Ac 6d Ts]
Seat 1: color_singleton (small blind) collected (378)
Seat 3: Duke Croix (big blind) folded on the Flop
Seat 8: Manon947 (button) folded before Flop (didn't bet)



PokerStars Home Game Hand #216958308240: {Club #3225207}  Hold'em No Limit (50/100) - 2020/07/30 18:30:25 ET
Table 'JansPokergame' 9-max (Play Money) Seat #1 is the button
Seat 1: color_singleton (4310 in chips) 
Seat 3: Duke Croix (34314 in chips) 
Seat 8: Manon947 (11482 in chips) 
Duke Croix: posts small blind 50
Manon947: posts big blind 100
*** HOLE CARDS ***
Dealt to Duke Croix [Ac 9s]
color_singleton: calls 100
Duke Croix: raises 300 to 400
Manon947: folds 
color_singleton: calls 300
*** FLOP *** [6d 5c 8s]
Duke Croix: checks 
color_singleton: checks 
*** TURN *** [6d 5c 8s] [3c]
Duke Croix: checks 
color_singleton: checks 
*** RIVER *** [6d 5c 8s 3c] [Tc]
Duke Croix: checks 
color_singleton: checks 
*** SHOW DOWN ***
Duke Croix: shows [Ac 9s] (high card Ace)
color_singleton: mucks hand 
Duke Croix collected 850 from pot
*** SUMMARY ***
Total pot 900 | Rake 50 
Board [6d 5c 8s 3c Tc]
Seat 1: color_singleton (button) mucked [9d Jd]
Seat 3: Duke Croix (small blind) showed [Ac 9s] and won (850) with high card Ace
Seat 8: Manon947 (big blind) folded before Flop



PokerStars Home Game Hand #216958318864: {Club #3225207}  Hold'em No Limit (50/100) - 2020/07/30 18:30:47 ET
Table 'JansPokergame' 9-max (Play Money) Seat #3 is the button
Seat 1: color_singleton (3910 in chips) 
Seat 3: Duke Croix (34764 in chips) 
Seat 8: Manon947 (11382 in chips) 
Manon947: posts small blind 50
color_singleton: posts big blind 100
*** HOLE CARDS ***
Dealt to Duke Croix [9h 5c]
Duke Croix: folds 
Manon947: calls 50
color_singleton: checks 
*** FLOP *** [2c Kc 3d]
Manon947: checks 
color_singleton: bets 100
Manon947: folds 
Uncalled bet (100) returned to color_singleton
color_singleton collected 189 from pot
color_singleton: doesn't show hand 
*** SUMMARY ***
Total pot 200 | Rake 11 
Board [2c Kc 3d]
Seat 1: color_singleton (big blind) collected (189)
Seat 3: Duke Croix (button) folded before Flop (didn't bet)
Seat 8: Manon947 (small blind) folded on the Flop



PokerStars Home Game Hand #216958327279: {Club #3225207}  Hold'em No Limit (50/100) - 2020/07/30 18:31:04 ET
Table 'JansPokergame' 9-max (Play Money) Seat #8 is the button
Seat 1: color_singleton (3999 in chips) 
Seat 3: Duke Croix (34764 in chips) 
Seat 8: Manon947 (11282 in chips) 
color_singleton: posts small blind 50
Duke Croix: posts big blind 100
*** HOLE CARDS ***
Dealt to Duke Croix [4d Ks]
Manon947: calls 100
color_singleton: raises 200 to 300
Duke Croix: folds 
Manon947: calls 200
*** FLOP *** [9d 9s Qh]
color_singleton: bets 330
Manon947: folds 
Uncalled bet (330) returned to color_singleton
color_singleton collected 661 from pot
color_singleton: doesn't show hand 
*** SUMMARY ***
Total pot 700 | Rake 39 
Board [9d 9s Qh]
Seat 1: color_singleton (small blind) collected (661)
Seat 3: Duke Croix (big blind) folded before Flop
Seat 8: Manon947 (button) folded on the Flop



PokerStars Home Game Hand #216958338703: {Club #3225207}  Hold'em No Limit (50/100) - 2020/07/30 18:31:28 ET
Table 'JansPokergame' 9-max (Play Money) Seat #1 is the button
Seat 1: color_singleton (4360 in chips) 
Seat 3: Duke Croix (34664 in chips) 
Seat 8: Manon947 (10982 in chips) 
Duke Croix: posts small blind 50
Manon947: posts big blind 100
*** HOLE CARDS ***
Dealt to Duke Croix [8c Ks]
color_singleton: raises 250 to 350
Duke Croix: calls 300
Manon947: calls 250
*** FLOP *** [Kh 4s 2s]
Duke Croix: bets 500
Manon947: folds 
color_singleton: folds 
Uncalled bet (500) returned to Duke Croix
Duke Croix collected 992 from pot
*** SUMMARY ***
Total pot 1050 | Rake 58 
Board [Kh 4s 2s]
Seat 1: color_singleton (button) folded on the Flop
Seat 3: Duke Croix (small blind) collected (992)
Seat 8: Manon947 (big blind) folded on the Flop



PokerStars Home Game Hand #216958347373: {Club #3225207}  Hold'em No Limit (50/100) - 2020/07/30 18:31:46 ET
Table 'JansPokergame' 9-max (Play Money) Seat #3 is the button
Seat 1: color_singleton (4010 in chips) 
Seat 3: Duke Croix (35306 in chips) 
Seat 8: Manon947 (10632 in chips) 
Manon947: posts small blind 50
color_singleton: posts big blind 100
*** HOLE CARDS ***
Dealt to Duke Croix [8c Tc]
Duke Croix: raises 200 to 300
Manon947: folds 
color_singleton: calls 200
*** FLOP *** [Ac Th 9s]
color_singleton: checks 
Duke Croix: checks 
*** TURN *** [Ac Th 9s] [2d]
color_singleton: checks 
Duke Croix: bets 300
color_singleton: folds 
Uncalled bet (300) returned to Duke Croix
Duke Croix collected 614 from pot
*** SUMMARY ***
Total pot 650 | Rake 36 
Board [Ac Th 9s 2d]
Seat 1: color_singleton (big blind) folded on the Turn
Seat 3: Duke Croix (button) collected (614)
Seat 8: Manon947 (small blind) folded before Flop



PokerStars Home Game Hand #216958358746: {Club #3225207}  Hold'em No Limit (50/100) - 2020/07/30 18:32:09 ET
Table 'JansPokergame' 9-max (Play Money) Seat #8 is the button
Seat 1: color_singleton (3710 in chips) 
Seat 3: Duke Croix (35620 in chips) 
Seat 8: Manon947 (10582 in chips) 
color_singleton: posts small blind 50
Duke Croix: posts big blind 100
*** HOLE CARDS ***
Dealt to Duke Croix [Qh Td]
Manon947: folds 
color_singleton: folds 
Uncalled bet (50) returned to Duke Croix
Duke Croix collected 100 from pot
*** SUMMARY ***
Total pot 100 | Rake 0 
Seat 1: color_singleton (small blind) folded before Flop
Seat 3: Duke Croix (big blind) collected (100)
Seat 8: Manon947 (button) folded before Flop (didn't bet)



PokerStars Home Game Hand #216958362145: {Club #3225207}  Hold'em No Limit (50/100) - 2020/07/30 18:32:16 ET
Table 'JansPokergame' 9-max (Play Money) Seat #1 is the button
Seat 1: color_singleton (3660 in chips) 
Seat 3: Duke Croix (35670 in chips) 
Seat 8: Manon947 (10582 in chips) 
Duke Croix: posts small blind 50
Manon947: posts big blind 100
*** HOLE CARDS ***
Dealt to Duke Croix [5h Qc]
color_singleton: raises 200 to 300
Duke Croix: folds 
Manon947: folds 
Uncalled bet (200) returned to color_singleton
color_singleton collected 250 from pot
color_singleton: doesn't show hand 
*** SUMMARY ***
Total pot 250 | Rake 0 
Seat 1: color_singleton (button) collected (250)
Seat 3: Duke Croix (small blind) folded before Flop
Seat 8: Manon947 (big blind) folded before Flop



PokerStars Home Game Hand #216958366793: {Club #3225207}  Hold'em No Limit (50/100) - 2020/07/30 18:32:26 ET
Table 'JansPokergame' 9-max (Play Money) Seat #3 is the button
Seat 1: color_singleton (3810 in chips) 
Seat 3: Duke Croix (35620 in chips) 
Seat 8: Manon947 (10482 in chips) 
Manon947: posts small blind 50
color_singleton: posts big blind 100
*** HOLE CARDS ***
Dealt to Duke Croix [Td 3c]
Duke Croix: folds 
Manon947: folds 
Uncalled bet (50) returned to color_singleton
color_singleton collected 100 from pot
color_singleton: doesn't show hand 
*** SUMMARY ***
Total pot 100 | Rake 0 
Seat 1: color_singleton (big blind) collected (100)
Seat 3: Duke Croix (button) folded before Flop (didn't bet)
Seat 8: Manon947 (small blind) folded before Flop



PokerStars Home Game Hand #216958370493: {Club #3225207}  Hold'em No Limit (50/100) - 2020/07/30 18:32:34 ET
Table 'JansPokergame' 9-max (Play Money) Seat #8 is the button
Seat 1: color_singleton (3860 in chips) 
Seat 3: Duke Croix (35620 in chips) 
Seat 8: Manon947 (10432 in chips) 
color_singleton: posts small blind 50
Duke Croix: posts big blind 100
*** HOLE CARDS ***
Dealt to Duke Croix [4d Ks]
Manon947: folds 
color_singleton: calls 50
Duke Croix: checks 
*** FLOP *** [Qh Kc 3s]
color_singleton: bets 189
Duke Croix: calls 189
*** TURN *** [Qh Kc 3s] [2h]
color_singleton: bets 100
Duke Croix: raises 300 to 400
color_singleton: calls 300
*** RIVER *** [Qh Kc 3s 2h] [Kh]
color_singleton: checks 
Duke Croix: bets 700
color_singleton: calls 700
*** SHOW DOWN ***
Duke Croix: shows [4d Ks] (three of a kind, Kings)
color_singleton: mucks hand 
Duke Croix collected 2625 from pot
*** SUMMARY ***
Total pot 2778 | Rake 153 
Board [Qh Kc 3s 2h Kh]
Seat 1: color_singleton (small blind) mucked [Qd 7c]
Seat 3: Duke Croix (big blind) showed [4d Ks] and won (2625) with three of a kind, Kings
Seat 8: Manon947 (button) folded before Flop (didn't bet)



PokerStars Home Game Hand #216958386629: {Club #3225207}  Hold'em No Limit (50/100) - 2020/07/30 18:33:07 ET
Table 'JansPokergame' 9-max (Play Money) Seat #1 is the button
Seat 1: color_singleton (2471 in chips) 
Seat 3: Duke Croix (36856 in chips) 
Seat 8: Manon947 (10432 in chips) 
Duke Croix: posts small blind 50
Manon947: posts big blind 100
*** HOLE CARDS ***
Dealt to Duke Croix [Kd 7d]
color_singleton: raises 100 to 200
Duke Croix: calls 150
Manon947: calls 100
*** FLOP *** [4d 5c 9c]
Duke Croix: checks 
Manon947: bets 100
color_singleton: calls 100
Duke Croix: folds 
*** TURN *** [4d 5c 9c] [8c]
Manon947: checks 
color_singleton: bets 756
Manon947: folds 
Uncalled bet (756) returned to color_singleton
color_singleton collected 756 from pot
color_singleton: doesn't show hand 
*** SUMMARY ***
Total pot 800 | Rake 44 
Board [4d 5c 9c 8c]
Seat 1: color_singleton (button) collected (756)
Seat 3: Duke Croix (small blind) folded on the Flop
Seat 8: Manon947 (big blind) folded on the Turn



PokerStars Home Game Hand #216958398120: {Club #3225207}  Hold'em No Limit (50/100) - 2020/07/30 18:33:31 ET
Table 'JansPokergame' 9-max (Play Money) Seat #3 is the button
Seat 1: color_singleton (2927 in chips) 
Seat 3: Duke Croix (36656 in chips) 
Seat 8: Manon947 (10132 in chips) 
Manon947: posts small blind 50
color_singleton: posts big blind 100
*** HOLE CARDS ***
Dealt to Duke Croix [8s 7h]
Duke Croix: calls 100
Manon947: calls 50
color_singleton: raises 200 to 300
Duke Croix: calls 200
Manon947: folds 
*** FLOP *** [6s Kd 2d]
color_singleton: bets 330
Duke Croix: folds 
Uncalled bet (330) returned to color_singleton
color_singleton collected 661 from pot
color_singleton: doesn't show hand 
*** SUMMARY ***
Total pot 700 | Rake 39 
Board [6s Kd 2d]
Seat 1: color_singleton (big blind) collected (661)
Seat 3: Duke Croix (button) folded on the Flop
Seat 8: Manon947 (small blind) folded before Flop



PokerStars Home Game Hand #216958406958: {Club #3225207}  Hold'em No Limit (50/100) - 2020/07/30 18:33:49 ET
Table 'JansPokergame' 9-max (Play Money) Seat #8 is the button
Seat 1: color_singleton (3288 in chips) 
Seat 3: Duke Croix (36356 in chips) 
Seat 8: Manon947 (10032 in chips) 
color_singleton: posts small blind 50
Duke Croix: posts big blind 100
*** HOLE CARDS ***
Dealt to Duke Croix [2h 6s]
Manon947: folds 
color_singleton: calls 50
Duke Croix: checks 
*** FLOP *** [3c 2d 3h]
color_singleton: bets 189
Duke Croix: calls 189
*** TURN *** [3c 2d 3h] [Ks]
color_singleton: bets 273
Duke Croix: folds 
Uncalled bet (273) returned to color_singleton
color_singleton collected 546 from pot
color_singleton: doesn't show hand 
*** SUMMARY ***
Total pot 578 | Rake 32 
Board [3c 2d 3h Ks]
Seat 1: color_singleton (small blind) collected (546)
Seat 3: Duke Croix (big blind) folded on the Turn
Seat 8: Manon947 (button) folded before Flop (didn't bet)



PokerStars Home Game Hand #216958417128: {Club #3225207}  Hold'em No Limit (50/100) - 2020/07/30 18:34:10 ET
Table 'JansPokergame' 9-max (Play Money) Seat #1 is the button
Seat 1: color_singleton (3545 in chips) 
Seat 3: Duke Croix (36067 in chips) 
Seat 8: Manon947 (10032 in chips) 
Duke Croix: posts small blind 50
Manon947: posts big blind 100
*** HOLE CARDS ***
Dealt to Duke Croix [9c Td]
color_singleton: folds 
Duke Croix: calls 50
Manon947: checks 
*** FLOP *** [6d Kc 3d]
Duke Croix: checks 
Manon947: checks 
*** TURN *** [6d Kc 3d] [5d]
Duke Croix: checks 
Manon947: checks 
*** RIVER *** [6d Kc 3d 5d] [Jd]
Duke Croix: bets 300
Manon947: raises 300 to 600
Duke Croix: calls 300
*** SHOW DOWN ***
Manon947: shows [6c Jh] (two pair, Jacks and Sixes)
Duke Croix: shows [9c Td] (a flush, Jack high)
Duke Croix collected 1323 from pot
*** SUMMARY ***
Total pot 1400 | Rake 77 
Board [6d Kc 3d 5d Jd]
Seat 1: color_singleton (button) folded before Flop (didn't bet)
Seat 3: Duke Croix (small blind) showed [9c Td] and won (1323) with a flush, Jack high
Seat 8: Manon947 (big blind) showed [6c Jh] and lost with two pair, Jacks and Sixes



PokerStars Home Game Hand #216958431687: {Club #3225207}  Hold'em No Limit (50/100) - 2020/07/30 18:34:41 ET
Table 'JansPokergame' 9-max (Play Money) Seat #3 is the button
Seat 1: color_singleton (3545 in chips) 
Seat 3: Duke Croix (36690 in chips) 
Seat 8: Manon947 (9332 in chips) 
Manon947: posts small blind 50
color_singleton: posts big blind 100
*** HOLE CARDS ***
Dealt to Duke Croix [9h 6d]
Duke Croix: folds 
Manon947: folds 
Uncalled bet (50) returned to color_singleton
color_singleton collected 100 from pot
color_singleton: doesn't show hand 
*** SUMMARY ***
Total pot 100 | Rake 0 
Seat 1: color_singleton (big blind) collected (100)
Seat 3: Duke Croix (button) folded before Flop (didn't bet)
Seat 8: Manon947 (small blind) folded before Flop



PokerStars Home Game Hand #216958435591: {Club #3225207}  Hold'em No Limit (50/100) - 2020/07/30 18:34:49 ET
Table 'JansPokergame' 9-max (Play Money) Seat #8 is the button
Seat 1: color_singleton (3595 in chips) 
Seat 3: Duke Croix (36690 in chips) 
Seat 8: Manon947 (9282 in chips) 
color_singleton: posts small blind 50
Duke Croix: posts big blind 100
*** HOLE CARDS ***
Dealt to Duke Croix [Ks 6h]
Manon947: folds 
color_singleton: raises 300 to 400
Duke Croix: folds 
Uncalled bet (300) returned to color_singleton
color_singleton collected 200 from pot
color_singleton: doesn't show hand 
*** SUMMARY ***
Total pot 200 | Rake 0 
Seat 1: color_singleton (small blind) collected (200)
Seat 3: Duke Croix (big blind) folded before Flop
Seat 8: Manon947 (button) folded before Flop (didn't bet)



PokerStars Home Game Hand #216958441675: {Club #3225207}  Hold'em No Limit (50/100) - 2020/07/30 18:35:01 ET
Table 'JansPokergame' 9-max (Play Money) Seat #1 is the button
Seat 1: color_singleton (3695 in chips) 
Seat 3: Duke Croix (36590 in chips) 
Seat 8: Manon947 (9282 in chips) 
Duke Croix: posts small blind 50
Manon947: posts big blind 100
*** HOLE CARDS ***
Dealt to Duke Croix [9h 2c]
color_singleton: raises 100 to 200
Duke Croix: folds 
Manon947: calls 100
*** FLOP *** [7h 9s Qh]
Manon947: bets 212
color_singleton: calls 212
*** TURN *** [7h 9s Qh] [Jh]
Manon947: bets 413
color_singleton: calls 413
*** RIVER *** [7h 9s Qh Jh] [4c]
Manon947: checks 
color_singleton: checks 
*** SHOW DOWN ***
Manon947: shows [Jc Qd] (two pair, Queens and Jacks)
color_singleton: mucks hand 
Manon947 collected 1606 from pot
*** SUMMARY ***
Total pot 1700 | Rake 94 
Board [7h 9s Qh Jh 4c]
Seat 1: color_singleton (button) mucked [As Ad]
Seat 3: Duke Croix (small blind) folded before Flop
Seat 8: Manon947 (big blind) showed [Jc Qd] and won (1606) with two pair, Queens and Jacks



PokerStars Home Game Hand #216958457110: {Club #3225207}  Hold'em No Limit (50/100) - 2020/07/30 18:35:34 ET
Table 'JansPokergame' 9-max (Play Money) Seat #3 is the button
Seat 1: color_singleton (2870 in chips) 
Seat 3: Duke Croix (36540 in chips) 
Seat 8: Manon947 (10063 in chips) 
Manon947: posts small blind 50
color_singleton: posts big blind 100
*** HOLE CARDS ***
Dealt to Duke Croix [7c 3s]
Duke Croix: folds 
Manon947: calls 50
color_singleton: raises 300 to 400
Manon947: folds 
Uncalled bet (300) returned to color_singleton
color_singleton collected 200 from pot
color_singleton: doesn't show hand 
*** SUMMARY ***
Total pot 200 | Rake 0 
Seat 1: color_singleton (big blind) collected (200)
Seat 3: Duke Croix (button) folded before Flop (didn't bet)
Seat 8: Manon947 (small blind) folded before Flop



PokerStars Home Game Hand #216958465113: {Club #3225207}  Hold'em No Limit (50/100) - 2020/07/30 18:35:50 ET
Table 'JansPokergame' 9-max (Play Money) Seat #8 is the button
Seat 1: color_singleton (2970 in chips) 
Seat 3: Duke Croix (36540 in chips) 
Seat 8: Manon947 (9963 in chips) 
color_singleton: posts small blind 50
Duke Croix: posts big blind 100
*** HOLE CARDS ***
Dealt to Duke Croix [Kh 4d]
Manon947: calls 100
color_singleton: calls 50
Duke Croix: checks 
*** FLOP *** [6d Th Qh]
color_singleton: bets 283
Duke Croix: folds 
Manon947: folds 
Uncalled bet (283) returned to color_singleton
color_singleton collected 283 from pot
color_singleton: doesn't show hand 
*** SUMMARY ***
Total pot 300 | Rake 17 
Board [6d Th Qh]
Seat 1: color_singleton (small blind) collected (283)
Seat 3: Duke Croix (big blind) folded on the Flop
Seat 8: Manon947 (button) folded on the Flop



PokerStars Home Game Hand #216958473178: {Club #3225207}  Hold'em No Limit (50/100) - 2020/07/30 18:36:07 ET
Table 'JansPokergame' 9-max (Play Money) Seat #1 is the button
Seat 1: color_singleton (3153 in chips) 
Seat 3: Duke Croix (36440 in chips) 
Seat 8: Manon947 (9863 in chips) 
Duke Croix: posts small blind 50
Manon947: posts big blind 100
*** HOLE CARDS ***
Dealt to Duke Croix [2c 5h]
color_singleton: folds 
Duke Croix: folds 
Uncalled bet (50) returned to Manon947
Manon947 collected 100 from pot
*** SUMMARY ***
Total pot 100 | Rake 0 
Seat 1: color_singleton (button) folded before Flop (didn't bet)
Seat 3: Duke Croix (small blind) folded before Flop
Seat 8: Manon947 (big blind) collected (100)



PokerStars Home Game Hand #216958475811: {Club #3225207}  Hold'em No Limit (50/100) - 2020/07/30 18:36:13 ET
Table 'JansPokergame' 9-max (Play Money) Seat #3 is the button
Seat 1: color_singleton (3153 in chips) 
Seat 3: Duke Croix (36390 in chips) 
Seat 8: Manon947 (9913 in chips) 
Manon947: posts small blind 50
color_singleton: posts big blind 100
*** HOLE CARDS ***
Dealt to Duke Croix [Kh 4h]
Duke Croix: folds 
Manon947: calls 50
color_singleton: checks 
*** FLOP *** [6c 3s 8c]
Manon947: checks 
color_singleton: bets 189
Manon947: folds 
Uncalled bet (189) returned to color_singleton
color_singleton collected 189 from pot
color_singleton: doesn't show hand 
*** SUMMARY ***
Total pot 200 | Rake 11 
Board [6c 3s 8c]
Seat 1: color_singleton (big blind) collected (189)
Seat 3: Duke Croix (button) folded before Flop (didn't bet)
Seat 8: Manon947 (small blind) folded on the Flop



PokerStars Home Game Hand #216958482796: {Club #3225207}  Hold'em No Limit (50/100) - 2020/07/30 18:36:27 ET
Table 'JansPokergame' 9-max (Play Money) Seat #8 is the button
Seat 1: color_singleton (3242 in chips) 
Seat 3: Duke Croix (36390 in chips) 
Seat 8: Manon947 (9813 in chips) 
color_singleton: posts small blind 50
Duke Croix: posts big blind 100
*** HOLE CARDS ***
Dealt to Duke Croix [Kc 8c]
Manon947: calls 100
color_singleton: calls 50
Duke Croix: checks 
*** FLOP *** [4s 4c As]
color_singleton: bets 283
Duke Croix: folds 
Manon947: raises 283 to 566
color_singleton: calls 283
*** TURN *** [4s 4c As] [2s]
color_singleton: bets 1353
Manon947: raises 1353 to 2706
color_singleton: calls 1223 and is all-in
Uncalled bet (130) returned to Manon947
*** RIVER *** [4s 4c As 2s] [Ad]
*** SHOW DOWN ***
color_singleton: shows [Js 3s] (a flush, Ace high)
Manon947: shows [4d Jd] (a full house, Fours full of Aces)
Manon947 collected 6222 from pot
*** SUMMARY ***
Total pot 6584 | Rake 362 
Board [4s 4c As 2s Ad]
Seat 1: color_singleton (small blind) showed [Js 3s] and lost with a flush, Ace high
Seat 3: Duke Croix (big blind) folded on the Flop
Seat 8: Manon947 (button) showed [4d Jd] and won (6222) with a full house, Fours full of Aces



PokerStars Home Game Hand #216958496243: {Club #3225207}  Hold'em No Limit (50/100) - 2020/07/30 18:36:55 ET
Table 'JansPokergame' 9-max (Play Money) Seat #3 is the button
Seat 3: Duke Croix (36290 in chips) 
Seat 8: Manon947 (12793 in chips) 
Duke Croix: posts small blind 50
Manon947: posts big blind 100
*** HOLE CARDS ***
Dealt to Duke Croix [4h Js]
Duke Croix: calls 50
Manon947: checks 
*** FLOP *** [3h 9d 2d]
Manon947: checks 
Duke Croix: checks 
*** TURN *** [3h 9d 2d] [9c]
Manon947: checks 
Duke Croix: checks 
*** RIVER *** [3h 9d 2d 9c] [Qd]
Manon947: checks 
Duke Croix: checks 
*** SHOW DOWN ***
Manon947: shows [Jh 7s] (a pair of Nines)
Duke Croix: mucks hand 
Manon947 collected 189 from pot
*** SUMMARY ***
Total pot 200 | Rake 11 
Board [3h 9d 2d 9c Qd]
Seat 3: Duke Croix (button) (small blind) mucked [4h Js]
Seat 8: Manon947 (big blind) showed [Jh 7s] and won (189) with a pair of Nines



