PokerStars Home Game Hand #216245928840: {Club #3225207}  Hold'em No Limit (50/100) - 2020/07/09 14:47:26 ET
Table 'lets goo' 9-max (Play Money) Seat #2 is the button
Seat 2: Duke Croix (10000 in chips) 
Seat 8: color_singleton (10000 in chips) 
Seat 9: HighCardJasper (10000 in chips) 
color_singleton: posts small blind 50
HighCardJasper: posts big blind 100
*** HOLE CARDS ***
Dealt to Duke Croix [Qh 7c]
Duke Croix: folds 
color_singleton: calls 50
HighCardJasper: checks 
*** FLOP *** [Jc 4d Qc]
color_singleton: checks 
HighCardJasper: bets 100
color_singleton: folds 
Uncalled bet (100) returned to HighCardJasper
HighCardJasper collected 189 from pot
HighCardJasper: doesn't show hand 
*** SUMMARY ***
Total pot 200 | Rake 11 
Board [Jc 4d Qc]
Seat 2: Duke Croix (button) folded before Flop (didn't bet)
Seat 8: color_singleton (small blind) folded on the Flop
Seat 9: HighCardJasper (big blind) collected (189)



PokerStars Home Game Hand #216245946622: {Club #3225207}  Hold'em No Limit (50/100) - 2020/07/09 14:47:55 ET
Table 'lets goo' 9-max (Play Money) Seat #8 is the button
Seat 1: dddocky (10000 in chips) 
Seat 2: Duke Croix (10000 in chips) 
Seat 8: color_singleton (9900 in chips) 
Seat 9: HighCardJasper (10089 in chips) 
HighCardJasper: posts small blind 50
dddocky: posts big blind 100
*** HOLE CARDS ***
Dealt to Duke Croix [4s Ts]
RichRick1337 joins the table at seat #5 
Duke Croix: folds 
color_singleton: raises 100 to 200
HighCardJasper: calls 150
dddocky: calls 100
*** FLOP *** [Qs Td 3s]
HighCardJasper: checks 
dddocky: checks 
color_singleton: checks 
*** TURN *** [Qs Td 3s] [8c]
HighCardJasper: checks 
dddocky: bets 567
color_singleton: folds 
HighCardJasper: folds 
Uncalled bet (567) returned to dddocky
dddocky collected 567 from pot
dddocky: doesn't show hand 
*** SUMMARY ***
Total pot 600 | Rake 33 
Board [Qs Td 3s 8c]
Seat 1: dddocky (big blind) collected (567)
Seat 2: Duke Croix folded before Flop (didn't bet)
Seat 8: color_singleton (button) folded on the Turn
Seat 9: HighCardJasper (small blind) folded on the Turn



PokerStars Home Game Hand #216245969747: {Club #3225207}  Hold'em No Limit (50/100) - 2020/07/09 14:48:33 ET
Table 'lets goo' 9-max (Play Money) Seat #9 is the button
Seat 1: dddocky (10367 in chips) 
Seat 2: Duke Croix (10000 in chips) 
Seat 5: RichRick1337 (10000 in chips) 
Seat 8: color_singleton (9700 in chips) 
Seat 9: HighCardJasper (9889 in chips) 
dddocky: posts small blind 50
Duke Croix: posts big blind 100
RichRick1337: posts big blind 100
*** HOLE CARDS ***
Dealt to Duke Croix [4c 3c]
FragileMemory joins the table at seat #3 
RichRick1337: checks 
color_singleton: calls 100
HighCardJasper: calls 100
dddocky: folds 
Duke Croix: checks 
*** FLOP *** [Kc 5h 8d]
Duke Croix: checks 
RichRick1337: checks 
color_singleton: checks 
HighCardJasper: checks 
*** TURN *** [Kc 5h 8d] [4s]
Duke Croix: checks 
RichRick1337: checks 
color_singleton: checks 
HighCardJasper: bets 100
Duke Croix: folds 
RichRick1337: folds 
color_singleton: folds 
Uncalled bet (100) returned to HighCardJasper
HighCardJasper collected 425 from pot
HighCardJasper: doesn't show hand 
*** SUMMARY ***
Total pot 450 | Rake 25 
Board [Kc 5h 8d 4s]
Seat 1: dddocky (small blind) folded before Flop
Seat 2: Duke Croix (big blind) folded on the Turn
Seat 5: RichRick1337 folded on the Turn (didn't bet)
Seat 8: color_singleton folded on the Turn
Seat 9: HighCardJasper (button) collected (425)



PokerStars Home Game Hand #216246011563: {Club #3225207}  Hold'em No Limit (50/100) - 2020/07/09 14:49:42 ET
Table 'lets goo' 9-max (Play Money) Seat #1 is the button
Seat 1: dddocky (10317 in chips) 
Seat 2: Duke Croix (9900 in chips) 
Seat 3: FragileMemory (10000 in chips) 
Seat 5: RichRick1337 (9900 in chips) 
Seat 8: color_singleton (9600 in chips) 
Seat 9: HighCardJasper (10214 in chips) 
Duke Croix: posts small blind 50
FragileMemory: posts big blind 100
*** HOLE CARDS ***
Dealt to Duke Croix [5c 6h]
RichRick1337: calls 100
color_singleton: folds 
HighCardJasper: calls 100
dddocky: folds 
Duke Croix: calls 50
FragileMemory: raises 100 to 200
RichRick1337: calls 100
HighCardJasper: calls 100
Duke Croix: calls 100
*** FLOP *** [6c Td Ad]
Duke Croix: checks 
FragileMemory: bets 100
RichRick1337: calls 100
HighCardJasper: calls 100
Duke Croix: folds 
*** TURN *** [6c Td Ad] [3c]
FragileMemory: bets 100
RichRick1337: folds 
HighCardJasper: calls 100
*** RIVER *** [6c Td Ad 3c] [9h]
FragileMemory: bets 400
HighCardJasper: folds 
Uncalled bet (400) returned to FragileMemory
FragileMemory collected 1228 from pot
FragileMemory: doesn't show hand 
*** SUMMARY ***
Total pot 1300 | Rake 72 
Board [6c Td Ad 3c 9h]
Seat 1: dddocky (button) folded before Flop (didn't bet)
Seat 2: Duke Croix (small blind) folded on the Flop
Seat 3: FragileMemory (big blind) collected (1228)
Seat 5: RichRick1337 folded on the Turn
Seat 8: color_singleton folded before Flop (didn't bet)
Seat 9: HighCardJasper folded on the River



PokerStars Home Game Hand #216246054495: {Club #3225207}  Hold'em No Limit (50/100) - 2020/07/09 14:50:50 ET
Table 'lets goo' 9-max (Play Money) Seat #2 is the button
Seat 1: dddocky (10317 in chips) 
Seat 2: Duke Croix (9700 in chips) 
Seat 3: FragileMemory (10828 in chips) 
Seat 5: RichRick1337 (9600 in chips) 
Seat 8: color_singleton (9600 in chips) 
Seat 9: HighCardJasper (9814 in chips) 
FragileMemory: posts small blind 50
RichRick1337: posts big blind 100
*** HOLE CARDS ***
Dealt to Duke Croix [8s 9d]
color_singleton: folds 
HighCardJasper: calls 100
dddocky: folds 
Duke Croix: calls 100
FragileMemory: calls 50
RichRick1337: checks 
*** FLOP *** [4d 9h Qs]
FragileMemory: checks 
RichRick1337: checks 
HighCardJasper: bets 100
Duke Croix: calls 100
FragileMemory: folds 
RichRick1337: folds 
*** TURN *** [4d 9h Qs] [Jc]
HighCardJasper: bets 100
Duke Croix: folds 
Uncalled bet (100) returned to HighCardJasper
HighCardJasper collected 567 from pot
HighCardJasper: doesn't show hand 
*** SUMMARY ***
Total pot 600 | Rake 33 
Board [4d 9h Qs Jc]
Seat 1: dddocky folded before Flop (didn't bet)
Seat 2: Duke Croix (button) folded on the Turn
Seat 3: FragileMemory (small blind) folded on the Flop
Seat 5: RichRick1337 (big blind) folded on the Flop
Seat 8: color_singleton folded before Flop (didn't bet)
Seat 9: HighCardJasper collected (567)



PokerStars Home Game Hand #216246086387: {Club #3225207}  Hold'em No Limit (50/100) - 2020/07/09 14:51:42 ET
Table 'lets goo' 9-max (Play Money) Seat #3 is the button
Seat 1: dddocky (10317 in chips) 
Seat 2: Duke Croix (9500 in chips) 
Seat 3: FragileMemory (10728 in chips) 
Seat 5: RichRick1337 (9500 in chips) 
Seat 8: color_singleton (9600 in chips) 
Seat 9: HighCardJasper (10181 in chips) 
RichRick1337: posts small blind 50
color_singleton: posts big blind 100
*** HOLE CARDS ***
Dealt to Duke Croix [Jd 7d]
HighCardJasper: raises 100 to 200
dddocky: calls 200
Duke Croix: folds 
FragileMemory: calls 200
RichRick1337: folds 
color_singleton: calls 100
*** FLOP *** [9h 2c 7c]
color_singleton: checks 
HighCardJasper: checks 
dddocky: checks 
FragileMemory: bets 100
color_singleton: folds 
HighCardJasper: calls 100
dddocky: calls 100
*** TURN *** [9h 2c 7c] [Kd]
HighCardJasper: checks 
dddocky: checks 
FragileMemory: checks 
*** RIVER *** [9h 2c 7c Kd] [Ks]
HighCardJasper: bets 200
dddocky: raises 1487 to 1687
FragileMemory: folds 
HighCardJasper: folds 
Uncalled bet (1487) returned to dddocky
dddocky collected 1465 from pot
dddocky: doesn't show hand 
*** SUMMARY ***
Total pot 1550 | Rake 85 
Board [9h 2c 7c Kd Ks]
Seat 1: dddocky collected (1465)
Seat 2: Duke Croix folded before Flop (didn't bet)
Seat 3: FragileMemory (button) folded on the River
Seat 5: RichRick1337 (small blind) folded before Flop
Seat 8: color_singleton (big blind) folded on the Flop
Seat 9: HighCardJasper folded on the River



PokerStars Home Game Hand #216246128696: {Club #3225207}  Hold'em No Limit (50/100) - 2020/07/09 14:52:51 ET
Table 'lets goo' 9-max (Play Money) Seat #5 is the button
Seat 1: dddocky (11282 in chips) 
Seat 2: Duke Croix (9500 in chips) 
Seat 3: FragileMemory (10428 in chips) 
Seat 5: RichRick1337 (9450 in chips) 
Seat 8: color_singleton (9400 in chips) 
Seat 9: HighCardJasper (9681 in chips) 
color_singleton: posts small blind 50
HighCardJasper: posts big blind 100
*** HOLE CARDS ***
Dealt to Duke Croix [Js 8d]
dddocky: folds 
Duke Croix: folds 
FragileMemory: folds 
RichRick1337: folds 
color_singleton: raises 200 to 300
HighCardJasper: calls 200
*** FLOP *** [4c 6h Ks]
color_singleton: bets 283
HighCardJasper: calls 283
*** TURN *** [4c 6h Ks] [2s]
color_singleton: bets 551
HighCardJasper: calls 551
*** RIVER *** [4c 6h Ks 2s] [7c]
color_singleton: checks 
HighCardJasper: bets 1000
color_singleton: folds 
Uncalled bet (1000) returned to HighCardJasper
HighCardJasper collected 2143 from pot
HighCardJasper: doesn't show hand 
*** SUMMARY ***
Total pot 2268 | Rake 125 
Board [4c 6h Ks 2s 7c]
Seat 1: dddocky folded before Flop (didn't bet)
Seat 2: Duke Croix folded before Flop (didn't bet)
Seat 3: FragileMemory folded before Flop (didn't bet)
Seat 5: RichRick1337 (button) folded before Flop (didn't bet)
Seat 8: color_singleton (small blind) folded on the River
Seat 9: HighCardJasper (big blind) collected (2143)



PokerStars Home Game Hand #216246169475: {Club #3225207}  Hold'em No Limit (50/100) - 2020/07/09 14:53:58 ET
Table 'lets goo' 9-max (Play Money) Seat #8 is the button
Seat 1: dddocky (11282 in chips) 
Seat 2: Duke Croix (9500 in chips) 
Seat 5: RichRick1337 (9450 in chips) 
Seat 8: color_singleton (8266 in chips) 
Seat 9: HighCardJasper (10690 in chips) 
HighCardJasper: posts small blind 50
dddocky: posts big blind 100
*** HOLE CARDS ***
Dealt to Duke Croix [9d 6c]
Duke Croix: folds 
RichRick1337: calls 100
color_singleton: calls 100
HighCardJasper: calls 50
dddocky: checks 
*** FLOP *** [Kh 2s 2d]
HighCardJasper: checks 
dddocky: checks 
RichRick1337: bets 100
color_singleton: folds 
HighCardJasper: folds 
dddocky: folds 
Uncalled bet (100) returned to RichRick1337
RichRick1337 collected 378 from pot
RichRick1337: doesn't show hand 
*** SUMMARY ***
Total pot 400 | Rake 22 
Board [Kh 2s 2d]
Seat 1: dddocky (big blind) folded on the Flop
Seat 2: Duke Croix folded before Flop (didn't bet)
Seat 5: RichRick1337 collected (378)
Seat 8: color_singleton (button) folded on the Flop
Seat 9: HighCardJasper (small blind) folded on the Flop



PokerStars Home Game Hand #216246191446: {Club #3225207}  Hold'em No Limit (50/100) - 2020/07/09 14:54:34 ET
Table 'lets goo' 9-max (Play Money) Seat #9 is the button
Seat 1: dddocky (11182 in chips) 
Seat 2: Duke Croix (9500 in chips) 
Seat 5: RichRick1337 (9728 in chips) 
Seat 8: color_singleton (8166 in chips) 
Seat 9: HighCardJasper (10590 in chips) 
dddocky: posts small blind 50
Duke Croix: posts big blind 100
*** HOLE CARDS ***
Dealt to Duke Croix [5d 3c]
RichRick1337: raises 100 to 200
color_singleton: folds 
HighCardJasper: calls 200
dddocky: calls 150
Duke Croix: calls 100
*** FLOP *** [Ac Tc Kh]
dddocky: bets 100
Duke Croix: folds 
RichRick1337: calls 100
HighCardJasper: calls 100
*** TURN *** [Ac Tc Kh] [9d]
dddocky: bets 100
RichRick1337: calls 100
HighCardJasper: calls 100
*** RIVER *** [Ac Tc Kh 9d] [Td]
dddocky: bets 1323
RichRick1337: folds 
HighCardJasper: folds 
Uncalled bet (1323) returned to dddocky
dddocky collected 1323 from pot
dddocky: doesn't show hand 
*** SUMMARY ***
Total pot 1400 | Rake 77 
Board [Ac Tc Kh 9d Td]
Seat 1: dddocky (small blind) collected (1323)
Seat 2: Duke Croix (big blind) folded on the Flop
Seat 5: RichRick1337 folded on the River
Seat 8: color_singleton folded before Flop (didn't bet)
Seat 9: HighCardJasper (button) folded on the River



PokerStars Home Game Hand #216246233738: {Club #3225207}  Hold'em No Limit (50/100) - 2020/07/09 14:55:58 ET
Table 'lets goo' 9-max (Play Money) Seat #1 is the button
Seat 1: dddocky (12105 in chips) 
Seat 2: Duke Croix (9300 in chips) 
Seat 3: FragileMemory (10428 in chips) 
Seat 5: RichRick1337 (9328 in chips) 
Seat 8: color_singleton (8166 in chips) 
Seat 9: HighCardJasper (10190 in chips) 
Duke Croix: posts small blind 50
FragileMemory: posts big blind 100
*** HOLE CARDS ***
Dealt to Duke Croix [Qh 3c]
RichRick1337: folds 
color_singleton: folds 
HighCardJasper: calls 100
dddocky: calls 100
Duke Croix: calls 50
FragileMemory: raises 100 to 200
HighCardJasper: calls 100
dddocky: calls 100
Duke Croix: calls 100
*** FLOP *** [8c 6h 9d]
Duke Croix: checks 
FragileMemory: checks 
HighCardJasper: checks 
dddocky: bets 100
Duke Croix: folds 
FragileMemory: folds 
HighCardJasper: calls 100
*** TURN *** [8c 6h 9d] [Qc]
HighCardJasper: checks 
dddocky: bets 100
HighCardJasper: calls 100
*** RIVER *** [8c 6h 9d Qc] [4c]
HighCardJasper: checks 
dddocky: checks 
*** SHOW DOWN ***
HighCardJasper: shows [2c 8h] (a pair of Eights)
dddocky: shows [Ah 9h] (a pair of Nines)
dddocky collected 1134 from pot
*** SUMMARY ***
Total pot 1200 | Rake 66 
Board [8c 6h 9d Qc 4c]
Seat 1: dddocky (button) showed [Ah 9h] and won (1134) with a pair of Nines
Seat 2: Duke Croix (small blind) folded on the Flop
Seat 3: FragileMemory (big blind) folded on the Flop
Seat 5: RichRick1337 folded before Flop (didn't bet)
Seat 8: color_singleton folded before Flop (didn't bet)
Seat 9: HighCardJasper showed [2c 8h] and lost with a pair of Eights



PokerStars Home Game Hand #216246283966: {Club #3225207}  Hold'em No Limit (50/100) - 2020/07/09 14:57:39 ET
Table 'lets goo' 9-max (Play Money) Seat #2 is the button
Seat 1: dddocky (12839 in chips) 
Seat 2: Duke Croix (9100 in chips) 
Seat 3: FragileMemory (10228 in chips) 
Seat 5: RichRick1337 (9328 in chips) 
Seat 8: color_singleton (8166 in chips) 
Seat 9: HighCardJasper (9790 in chips) 
FragileMemory: posts small blind 50
RichRick1337: posts big blind 100
*** HOLE CARDS ***
Dealt to Duke Croix [As 2d]
color_singleton: raises 100 to 200
HighCardJasper: folds 
dddocky: calls 200
Duke Croix: folds 
FragileMemory: folds 
RichRick1337: calls 100
*** FLOP *** [8d 4c 6s]
RichRick1337: checks 
color_singleton: checks 
dddocky said, "twitch.tv/drdukeplays"
dddocky: checks 
*** TURN *** [8d 4c 6s] [8h]
RichRick1337: checks 
color_singleton: checks 
dddocky: checks 
*** RIVER *** [8d 4c 6s 8h] [2s]
RichRick1337 has timed out
RichRick1337: checks 
color_singleton: bets 307
dddocky: folds 
RichRick1337: calls 307
*** SHOW DOWN ***
color_singleton: shows [Ah 2h] (two pair, Eights and Deuces)
RichRick1337: shows [Th 8s] (three of a kind, Eights)
RichRick1337 collected 1194 from pot
*** SUMMARY ***
Total pot 1264 | Rake 70 
Board [8d 4c 6s 8h 2s]
Seat 1: dddocky folded on the River
Seat 2: Duke Croix (button) folded before Flop (didn't bet)
Seat 3: FragileMemory (small blind) folded before Flop
Seat 5: RichRick1337 (big blind) showed [Th 8s] and won (1194) with three of a kind, Eights
Seat 8: color_singleton showed [Ah 2h] and lost with two pair, Eights and Deuces
Seat 9: HighCardJasper folded before Flop (didn't bet)



PokerStars Home Game Hand #216246319067: {Club #3225207}  Hold'em No Limit (50/100) - 2020/07/09 14:58:58 ET
Table 'lets goo' 9-max (Play Money) Seat #5 is the button
Seat 1: dddocky (12639 in chips) 
Seat 2: Duke Croix (9100 in chips) 
Seat 5: RichRick1337 (10015 in chips) 
Seat 8: color_singleton (7659 in chips) 
Seat 9: HighCardJasper (9790 in chips) 
color_singleton: posts small blind 50
HighCardJasper: posts big blind 100
*** HOLE CARDS ***
Dealt to Duke Croix [3d 2s]
dddocky: calls 100
Duke Croix: folds 
RichRick1337: calls 100
color_singleton: calls 50
HighCardJasper: checks 
*** FLOP *** [4s Js 9h]
color_singleton: bets 189
HighCardJasper: calls 189
dddocky: calls 189
RichRick1337: folds 
*** TURN *** [4s Js 9h] [Ah]
color_singleton: checks 
HighCardJasper: checks 
dddocky: checks 
*** RIVER *** [4s Js 9h Ah] [7h]
color_singleton: checks 
HighCardJasper: bets 200
dddocky: calls 200
color_singleton: folds 
*** SHOW DOWN ***
HighCardJasper: shows [Ac 2h] (a pair of Aces)
dddocky: mucks hand 
HighCardJasper collected 1292 from pot
*** SUMMARY ***
Total pot 1367 | Rake 75 
Board [4s Js 9h Ah 7h]
Seat 1: dddocky mucked [Jc 5s]
Seat 2: Duke Croix folded before Flop (didn't bet)
Seat 5: RichRick1337 (button) folded on the Flop
Seat 8: color_singleton (small blind) folded on the River
Seat 9: HighCardJasper (big blind) showed [Ac 2h] and won (1292) with a pair of Aces



PokerStars Home Game Hand #216246347601: {Club #3225207}  Hold'em No Limit (50/100) - 2020/07/09 14:59:59 ET
Table 'lets goo' 9-max (Play Money) Seat #8 is the button
Seat 1: dddocky (12150 in chips) 
Seat 2: Duke Croix (9100 in chips) 
Seat 5: RichRick1337 (9915 in chips) 
Seat 8: color_singleton (7370 in chips) 
Seat 9: HighCardJasper (10593 in chips) 
HighCardJasper: posts small blind 50
dddocky: posts big blind 100
*** HOLE CARDS ***
Dealt to Duke Croix [Ks Kh]
Duke Croix: raises 300 to 400
RichRick1337: folds 
color_singleton: folds 
HighCardJasper: folds 
dddocky: folds 
Uncalled bet (300) returned to Duke Croix
Duke Croix collected 250 from pot
*** SUMMARY ***
Total pot 250 | Rake 0 
Seat 1: dddocky (big blind) folded before Flop
Seat 2: Duke Croix collected (250)
Seat 5: RichRick1337 folded before Flop (didn't bet)
Seat 8: color_singleton (button) folded before Flop (didn't bet)
Seat 9: HighCardJasper (small blind) folded before Flop



PokerStars Home Game Hand #216246356298: {Club #3225207}  Hold'em No Limit (50/100) - 2020/07/09 15:00:17 ET
Table 'lets goo' 9-max (Play Money) Seat #9 is the button
Seat 1: dddocky (12050 in chips) 
Seat 2: Duke Croix (9250 in chips) 
Seat 5: RichRick1337 (9915 in chips) 
Seat 8: color_singleton (7370 in chips) 
Seat 9: HighCardJasper (10543 in chips) 
dddocky: posts small blind 50
Duke Croix: posts big blind 100
*** HOLE CARDS ***
Dealt to Duke Croix [Kh 6d]
RichRick1337: calls 100
color_singleton: folds 
HighCardJasper: calls 100
dddocky: folds 
Duke Croix: checks 
*** FLOP *** [8d Kc 9s]
Duke Croix: bets 200
RichRick1337: folds 
HighCardJasper: calls 200
*** TURN *** [8d Kc 9s] [Jh]
Duke Croix: bets 400
HighCardJasper: folds 
Uncalled bet (400) returned to Duke Croix
Duke Croix collected 709 from pot
*** SUMMARY ***
Total pot 750 | Rake 41 
Board [8d Kc 9s Jh]
Seat 1: dddocky (small blind) folded before Flop
Seat 2: Duke Croix (big blind) collected (709)
Seat 5: RichRick1337 folded on the Flop
Seat 8: color_singleton folded before Flop (didn't bet)
Seat 9: HighCardJasper (button) folded on the Turn



PokerStars Home Game Hand #216246381895: {Club #3225207}  Hold'em No Limit (50/100) - 2020/07/09 15:01:06 ET
Table 'lets goo' 9-max (Play Money) Seat #1 is the button
Seat 1: dddocky (12000 in chips) 
Seat 2: Duke Croix (9659 in chips) 
Seat 5: RichRick1337 (9815 in chips) 
Seat 8: color_singleton (7370 in chips) 
Seat 9: HighCardJasper (10243 in chips) 
Duke Croix: posts small blind 50
RichRick1337: posts big blind 100
*** HOLE CARDS ***
Dealt to Duke Croix [9s 5d]
color_singleton: raises 100 to 200
HighCardJasper: calls 200
dddocky: calls 200
Duke Croix: folds 
RichRick1337: calls 100
*** FLOP *** [Jh Tc 7h]
RichRick1337: bets 100
color_singleton: calls 100
HighCardJasper: calls 100
dddocky: calls 100
*** TURN *** [Jh Tc 7h] [Ac]
RichRick1337: bets 500
color_singleton: calls 500
HighCardJasper: folds 
dddocky: calls 500
*** RIVER *** [Jh Tc 7h Ac] [7s]
RichRick1337: checks 
color_singleton: checks 
dddocky: checks 
*** SHOW DOWN ***
RichRick1337: shows [Jd Js] (a full house, Jacks full of Sevens)
color_singleton: mucks hand 
dddocky: mucks hand 
RichRick1337 collected 2599 from pot
*** SUMMARY ***
Total pot 2750 | Rake 151 
Board [Jh Tc 7h Ac 7s]
Seat 1: dddocky (button) mucked [Ad Qd]
Seat 2: Duke Croix (small blind) folded before Flop
Seat 5: RichRick1337 (big blind) showed [Jd Js] and won (2599) with a full house, Jacks full of Sevens
Seat 8: color_singleton mucked [3d As]
Seat 9: HighCardJasper folded on the Turn



PokerStars Home Game Hand #216246414790: {Club #3225207}  Hold'em No Limit (50/100) - 2020/07/09 15:02:05 ET
Table 'lets goo' 9-max (Play Money) Seat #2 is the button
Seat 1: dddocky (11200 in chips) 
Seat 2: Duke Croix (9609 in chips) 
Seat 5: RichRick1337 (11614 in chips) 
Seat 8: color_singleton (6570 in chips) 
Seat 9: HighCardJasper (9943 in chips) 
RichRick1337: posts small blind 50
color_singleton: posts big blind 100
*** HOLE CARDS ***
Dealt to Duke Croix [6s 4s]
HighCardJasper: folds 
dddocky: calls 100
Duke Croix: calls 100
RichRick1337: calls 50
color_singleton: checks 
*** FLOP *** [9h Td 3d]
RichRick1337: checks 
color_singleton: checks 
dddocky: checks 
Duke Croix: checks 
*** TURN *** [9h Td 3d] [Qc]
RichRick1337: checks 
color_singleton: bets 200
dddocky: folds 
Duke Croix: folds 
RichRick1337: folds 
Uncalled bet (200) returned to color_singleton
color_singleton collected 378 from pot
color_singleton: doesn't show hand 
*** SUMMARY ***
Total pot 400 | Rake 22 
Board [9h Td 3d Qc]
Seat 1: dddocky folded on the Turn
Seat 2: Duke Croix (button) folded on the Turn
Seat 5: RichRick1337 (small blind) folded on the Turn
Seat 8: color_singleton (big blind) collected (378)
Seat 9: HighCardJasper folded before Flop (didn't bet)



PokerStars Home Game Hand #216246452761: {Club #3225207}  Hold'em No Limit (50/100) - 2020/07/09 15:03:05 ET
Table 'lets goo' 9-max (Play Money) Seat #5 is the button
Seat 1: dddocky (11100 in chips) 
Seat 2: Duke Croix (9509 in chips) 
Seat 3: FragileMemory (10178 in chips) 
Seat 5: RichRick1337 (11514 in chips) 
Seat 8: color_singleton (6848 in chips) 
Seat 9: HighCardJasper (9943 in chips) 
color_singleton: posts small blind 50
HighCardJasper: posts big blind 100
FragileMemory: posts small & big blinds 150
*** HOLE CARDS ***
Dealt to Duke Croix [8h 4h]
dddocky: folds 
Duke Croix: folds 
FragileMemory: checks 
RichRick1337: calls 100
color_singleton: calls 50
HighCardJasper: checks 
*** FLOP *** [9s 7c Ks]
color_singleton: checks 
HighCardJasper: checks 
FragileMemory: checks 
RichRick1337: checks 
*** TURN *** [9s 7c Ks] [9h]
color_singleton: checks 
HighCardJasper: checks 
FragileMemory: checks 
RichRick1337: bets 300
color_singleton: folds 
HighCardJasper: calls 300
FragileMemory: folds 
*** RIVER *** [9s 7c Ks 9h] [3d]
HighCardJasper: bets 400
RichRick1337: calls 400
*** SHOW DOWN ***
HighCardJasper: shows [Qh 9d] (three of a kind, Nines)
RichRick1337: mucks hand 
HighCardJasper collected 1748 from pot
*** SUMMARY ***
Total pot 1850 | Rake 102 
Board [9s 7c Ks 9h 3d]
Seat 1: dddocky folded before Flop (didn't bet)
Seat 2: Duke Croix folded before Flop (didn't bet)
Seat 3: FragileMemory folded on the Turn (didn't bet)
Seat 5: RichRick1337 (button) mucked [7h 2c]
Seat 8: color_singleton (small blind) folded on the Turn
Seat 9: HighCardJasper (big blind) showed [Qh 9d] and won (1748) with three of a kind, Nines



PokerStars Home Game Hand #216246495961: {Club #3225207}  Hold'em No Limit (50/100) - 2020/07/09 15:04:15 ET
Table 'lets goo' 9-max (Play Money) Seat #8 is the button
Seat 1: dddocky (11100 in chips) 
Seat 2: Duke Croix (9509 in chips) 
Seat 3: FragileMemory (10028 in chips) 
Seat 5: RichRick1337 (10714 in chips) 
Seat 8: color_singleton (6748 in chips) 
Seat 9: HighCardJasper (10891 in chips) 
HighCardJasper: posts small blind 50
dddocky: posts big blind 100
*** HOLE CARDS ***
Dealt to Duke Croix [Qh Ah]
Duke Croix: raises 300 to 400
FragileMemory: folds 
RichRick1337: folds 
color_singleton: folds 
HighCardJasper: calls 350
dddocky: calls 300
*** FLOP *** [Qs 2d Qc]
HighCardJasper: checks 
dddocky: checks 
Duke Croix: checks 
*** TURN *** [Qs 2d Qc] [2h]
HighCardJasper: checks 
dddocky: checks 
Duke Croix: bets 600
HighCardJasper: folds 
dddocky: calls 600
*** RIVER *** [Qs 2d Qc 2h] [4c]
dddocky: checks 
Duke Croix: bets 1000
dddocky: calls 1000
*** SHOW DOWN ***
Duke Croix: shows [Qh Ah] (a full house, Queens full of Deuces)
dddocky: mucks hand 
Duke Croix collected 4158 from pot
*** SUMMARY ***
Total pot 4400 | Rake 242 
Board [Qs 2d Qc 2h 4c]
Seat 1: dddocky (big blind) mucked [Kc 3d]
Seat 2: Duke Croix showed [Qh Ah] and won (4158) with a full house, Queens full of Deuces
Seat 3: FragileMemory folded before Flop (didn't bet)
Seat 5: RichRick1337 folded before Flop (didn't bet)
Seat 8: color_singleton (button) folded before Flop (didn't bet)
Seat 9: HighCardJasper (small blind) folded on the Turn



PokerStars Home Game Hand #216246535679: {Club #3225207}  Hold'em No Limit (50/100) - 2020/07/09 15:05:16 ET
Table 'lets goo' 9-max (Play Money) Seat #9 is the button
Seat 1: dddocky (9100 in chips) 
Seat 2: Duke Croix (11667 in chips) 
Seat 5: RichRick1337 (10714 in chips) 
Seat 8: color_singleton (6748 in chips) 
Seat 9: HighCardJasper (10491 in chips) 
dddocky: posts small blind 50
Duke Croix: posts big blind 100
*** HOLE CARDS ***
Dealt to Duke Croix [Jc 8d]
RichRick1337: calls 100
color_singleton: raises 200 to 300
HighCardJasper: folds 
dddocky: folds 
Duke Croix: calls 200
RichRick1337: calls 200
*** FLOP *** [9s 3c 5s]
Duke Croix: checks 
RichRick1337: checks 
color_singleton: checks 
*** TURN *** [9s 3c 5s] [2d]
Duke Croix: checks 
RichRick1337: checks 
color_singleton: checks 
*** RIVER *** [9s 3c 5s 2d] [Kd]
Duke Croix: checks 
RichRick1337: checks 
color_singleton: checks 
*** SHOW DOWN ***
Duke Croix: shows [Jc 8d] (high card King)
RichRick1337: shows [Qh 7d] (high card King - Queen kicker)
color_singleton: shows [Jh Ah] (high card Ace)
color_singleton collected 898 from pot
*** SUMMARY ***
Total pot 950 | Rake 52 
Board [9s 3c 5s 2d Kd]
Seat 1: dddocky (small blind) folded before Flop
Seat 2: Duke Croix (big blind) showed [Jc 8d] and lost with high card King
Seat 5: RichRick1337 showed [Qh 7d] and lost with high card King
Seat 8: color_singleton showed [Jh Ah] and won (898) with high card Ace
Seat 9: HighCardJasper (button) folded before Flop (didn't bet)



PokerStars Home Game Hand #216246569896: {Club #3225207}  Hold'em No Limit (50/100) - 2020/07/09 15:06:07 ET
Table 'lets goo' 9-max (Play Money) Seat #1 is the button
Seat 1: dddocky (9050 in chips) 
Seat 2: Duke Croix (11367 in chips) 
Seat 5: RichRick1337 (10414 in chips) 
Seat 8: color_singleton (7346 in chips) 
Seat 9: HighCardJasper (10491 in chips) 
Duke Croix: posts small blind 50
RichRick1337: posts big blind 100
*** HOLE CARDS ***
Dealt to Duke Croix [Jh Qs]
color_singleton: raises 100 to 200
HighCardJasper: calls 200
dddocky: calls 200
Duke Croix: calls 150
RichRick1337: folds 
*** FLOP *** [Qc 9d Td]
Duke Croix: bets 500
color_singleton: calls 500
HighCardJasper: folds 
dddocky: calls 500
*** TURN *** [Qc 9d Td] [7c]
Duke Croix: bets 1100
color_singleton: calls 1100
dddocky: calls 1100
*** RIVER *** [Qc 9d Td 7c] [3h]
Duke Croix: bets 2600
color_singleton: folds 
dddocky: folds 
Uncalled bet (2600) returned to Duke Croix
Duke Croix collected 5386 from pot
*** SUMMARY ***
Total pot 5700 | Rake 314 
Board [Qc 9d Td 7c 3h]
Seat 1: dddocky (button) folded on the River
Seat 2: Duke Croix (small blind) collected (5386)
Seat 5: RichRick1337 (big blind) folded before Flop
Seat 8: color_singleton folded on the River
Seat 9: HighCardJasper folded on the Flop



PokerStars Home Game Hand #216246613392: {Club #3225207}  Hold'em No Limit (50/100) - 2020/07/09 15:07:11 ET
Table 'lets goo' 9-max (Play Money) Seat #2 is the button
Seat 1: dddocky (7250 in chips) 
Seat 2: Duke Croix (14953 in chips) 
Seat 5: RichRick1337 (10314 in chips) 
Seat 8: color_singleton (5546 in chips) 
Seat 9: HighCardJasper (10291 in chips) 
RichRick1337: posts small blind 50
color_singleton: posts big blind 100
*** HOLE CARDS ***
Dealt to Duke Croix [Qc 4c]
HighCardJasper: calls 100
dddocky: folds 
Duke Croix: folds 
RichRick1337: raises 100 to 200
color_singleton: calls 100
HighCardJasper: calls 100
*** FLOP *** [Ah 7c Ts]
RichRick1337: checks 
color_singleton: checks 
HighCardJasper: bets 200
RichRick1337: calls 200
color_singleton: folds 
*** TURN *** [Ah 7c Ts] [4s]
RichRick1337: checks 
HighCardJasper: bets 200
RichRick1337: calls 200
*** RIVER *** [Ah 7c Ts 4s] [Qs]
RichRick1337: checks 
HighCardJasper: bets 400
RichRick1337: calls 400
*** SHOW DOWN ***
HighCardJasper: shows [6s Ad] (a pair of Aces)
RichRick1337: mucks hand 
HighCardJasper collected 2079 from pot
*** SUMMARY ***
Total pot 2200 | Rake 121 
Board [Ah 7c Ts 4s Qs]
Seat 1: dddocky folded before Flop (didn't bet)
Seat 2: Duke Croix (button) folded before Flop (didn't bet)
Seat 5: RichRick1337 (small blind) mucked [Jd Td]
Seat 8: color_singleton (big blind) folded on the Flop
Seat 9: HighCardJasper showed [6s Ad] and won (2079) with a pair of Aces



PokerStars Home Game Hand #216246647011: {Club #3225207}  Hold'em No Limit (50/100) - 2020/07/09 15:08:01 ET
Table 'lets goo' 9-max (Play Money) Seat #5 is the button
Seat 1: dddocky (7250 in chips) 
Seat 2: Duke Croix (14953 in chips) 
Seat 3: FragileMemory (10028 in chips) 
Seat 5: RichRick1337 (9314 in chips) 
Seat 8: color_singleton (5346 in chips) 
Seat 9: HighCardJasper (11370 in chips) 
color_singleton: posts small blind 50
HighCardJasper: posts big blind 100
FragileMemory: posts small & big blinds 150
*** HOLE CARDS ***
Dealt to Duke Croix [5d Kc]
dddocky: folds 
Duke Croix: folds 
FragileMemory: checks 
RichRick1337: folds 
color_singleton: calls 50
HighCardJasper: checks 
*** FLOP *** [9d 4h Jh]
color_singleton: checks 
HighCardJasper: checks 
FragileMemory: bets 100
color_singleton: folds 
HighCardJasper: calls 100
*** TURN *** [9d 4h Jh] [Qc]
HighCardJasper: checks 
FragileMemory: checks 
*** RIVER *** [9d 4h Jh Qc] [Qh]
HighCardJasper: checks 
FragileMemory: bets 260
HighCardJasper: folds 
Uncalled bet (260) returned to FragileMemory
FragileMemory collected 520 from pot
FragileMemory: doesn't show hand 
*** SUMMARY ***
Total pot 550 | Rake 30 
Board [9d 4h Jh Qc Qh]
Seat 1: dddocky folded before Flop (didn't bet)
Seat 2: Duke Croix folded before Flop (didn't bet)
Seat 3: FragileMemory collected (520)
Seat 5: RichRick1337 (button) folded before Flop (didn't bet)
Seat 8: color_singleton (small blind) folded on the Flop
Seat 9: HighCardJasper (big blind) folded on the River



PokerStars Home Game Hand #216246683633: {Club #3225207}  Hold'em No Limit (50/100) - 2020/07/09 15:08:56 ET
Table 'lets goo' 9-max (Play Money) Seat #8 is the button
Seat 1: dddocky (7250 in chips) 
Seat 2: Duke Croix (14953 in chips) 
Seat 3: FragileMemory (10298 in chips) 
Seat 5: RichRick1337 (9314 in chips) 
Seat 8: color_singleton (5246 in chips) 
Seat 9: HighCardJasper (11170 in chips) 
HighCardJasper: posts small blind 50
dddocky: posts big blind 100
*** HOLE CARDS ***
Dealt to Duke Croix [Jc Kd]
Duke Croix: raises 250 to 350
FragileMemory: calls 350
RichRick1337: folds 
color_singleton: folds 
HighCardJasper: folds 
dddocky: calls 250
*** FLOP *** [Kc Qh 5s]
dddocky: bets 1039
Duke Croix: calls 1039
FragileMemory: calls 1039
*** TURN *** [Kc Qh 5s] [6s]
dddocky: checks 
Duke Croix: bets 1300
FragileMemory: raises 7609 to 8909 and is all-in
dddocky: folds 
Duke Croix: folds 
Uncalled bet (7609) returned to FragileMemory
FragileMemory collected 6442 from pot
FragileMemory: doesn't show hand 
*** SUMMARY ***
Total pot 6817 | Rake 375 
Board [Kc Qh 5s 6s]
Seat 1: dddocky (big blind) folded on the Turn
Seat 2: Duke Croix folded on the Turn
Seat 3: FragileMemory collected (6442)
Seat 5: RichRick1337 folded before Flop (didn't bet)
Seat 8: color_singleton (button) folded before Flop (didn't bet)
Seat 9: HighCardJasper (small blind) folded before Flop



PokerStars Home Game Hand #216246728462: {Club #3225207}  Hold'em No Limit (50/100) - 2020/07/09 15:10:04 ET
Table 'lets goo' 9-max (Play Money) Seat #9 is the button
Seat 1: dddocky (5861 in chips) 
Seat 2: Duke Croix (12264 in chips) 
Seat 3: FragileMemory (14051 in chips) 
Seat 5: RichRick1337 (9314 in chips) 
Seat 8: color_singleton (5246 in chips) 
Seat 9: HighCardJasper (11120 in chips) 
dddocky: posts small blind 50
Duke Croix: posts big blind 100
*** HOLE CARDS ***
Dealt to Duke Croix [Kd 4s]
FragileMemory has timed out
FragileMemory: folds 
RichRick1337: calls 100
color_singleton: folds 
HighCardJasper: calls 100
dddocky: calls 50
Duke Croix: checks 
*** FLOP *** [Js 8s 5d]
dddocky: checks 
Duke Croix: checks 
RichRick1337: checks 
HighCardJasper: bets 200
dddocky: folds 
Duke Croix: folds 
RichRick1337: folds 
Uncalled bet (200) returned to HighCardJasper
HighCardJasper collected 378 from pot
HighCardJasper: doesn't show hand 
*** SUMMARY ***
Total pot 400 | Rake 22 
Board [Js 8s 5d]
Seat 1: dddocky (small blind) folded on the Flop
Seat 2: Duke Croix (big blind) folded on the Flop
Seat 3: FragileMemory folded before Flop (didn't bet)
Seat 5: RichRick1337 folded on the Flop
Seat 8: color_singleton folded before Flop (didn't bet)
Seat 9: HighCardJasper (button) collected (378)



PokerStars Home Game Hand #216246771486: {Club #3225207}  Hold'em No Limit (50/100) - 2020/07/09 15:11:09 ET
Table 'lets goo' 9-max (Play Money) Seat #1 is the button
Seat 1: dddocky (5761 in chips) 
Seat 2: Duke Croix (12164 in chips) 
Seat 3: FragileMemory (14051 in chips) 
Seat 5: RichRick1337 (9214 in chips) 
Seat 8: color_singleton (5246 in chips) 
Seat 9: HighCardJasper (11398 in chips) 
Duke Croix: posts small blind 50
FragileMemory: posts big blind 100
*** HOLE CARDS ***
Dealt to Duke Croix [7d 4d]
RichRick1337: calls 100
color_singleton: folds 
HighCardJasper: raises 100 to 200
dddocky: folds 
Duke Croix: folds 
FragileMemory: calls 100
RichRick1337: calls 100
*** FLOP *** [Js 6c 6d]
FragileMemory: checks 
RichRick1337: checks 
HighCardJasper: bets 100
FragileMemory: folds 
RichRick1337: calls 100
*** TURN *** [Js 6c 6d] [Kd]
RichRick1337: checks 
HighCardJasper: checks 
*** RIVER *** [Js 6c 6d Kd] [9d]
RichRick1337: bets 100
HighCardJasper: raises 300 to 400
RichRick1337: calls 300
*** SHOW DOWN ***
HighCardJasper: shows [Ah 9c] (two pair, Nines and Sixes)
RichRick1337: mucks hand 
HighCardJasper collected 1559 from pot
*** SUMMARY ***
Total pot 1650 | Rake 91 
Board [Js 6c 6d Kd 9d]
Seat 1: dddocky (button) folded before Flop (didn't bet)
Seat 2: Duke Croix (small blind) folded before Flop
Seat 3: FragileMemory (big blind) folded on the Flop
Seat 5: RichRick1337 mucked [9h Td]
Seat 8: color_singleton folded before Flop (didn't bet)
Seat 9: HighCardJasper showed [Ah 9c] and won (1559) with two pair, Nines and Sixes



PokerStars Home Game Hand #216246813017: {Club #3225207}  Hold'em No Limit (50/100) - 2020/07/09 15:12:11 ET
Table 'lets goo' 9-max (Play Money) Seat #2 is the button
Seat 1: dddocky (5761 in chips) 
Seat 2: Duke Croix (12114 in chips) 
Seat 3: FragileMemory (13851 in chips) 
Seat 5: RichRick1337 (8514 in chips) 
Seat 8: color_singleton (5246 in chips) 
Seat 9: HighCardJasper (12257 in chips) 
FragileMemory: posts small blind 50
RichRick1337: posts big blind 100
*** HOLE CARDS ***
Dealt to Duke Croix [8s 7c]
color_singleton: folds 
HighCardJasper: raises 100 to 200
dddocky: folds 
Duke Croix: folds 
FragileMemory: calls 150
RichRick1337: folds 
*** FLOP *** [6h 4c Qc]
FragileMemory: checks 
HighCardJasper: checks 
*** TURN *** [6h 4c Qc] [9d]
FragileMemory: checks 
HighCardJasper: checks 
*** RIVER *** [6h 4c Qc 9d] [Jd]
FragileMemory: checks 
HighCardJasper: bets 300
FragileMemory: folds 
Uncalled bet (300) returned to HighCardJasper
HighCardJasper collected 472 from pot
HighCardJasper: doesn't show hand 
*** SUMMARY ***
Total pot 500 | Rake 28 
Board [6h 4c Qc 9d Jd]
Seat 1: dddocky folded before Flop (didn't bet)
Seat 2: Duke Croix (button) folded before Flop (didn't bet)
Seat 3: FragileMemory (small blind) folded on the River
Seat 5: RichRick1337 (big blind) folded before Flop
Seat 8: color_singleton folded before Flop (didn't bet)
Seat 9: HighCardJasper collected (472)



PokerStars Home Game Hand #216246849528: {Club #3225207}  Hold'em No Limit (50/100) - 2020/07/09 15:13:01 ET
Table 'lets goo' 9-max (Play Money) Seat #3 is the button
Seat 1: dddocky (5761 in chips) 
Seat 2: Duke Croix (12114 in chips) 
Seat 3: FragileMemory (13651 in chips) 
Seat 5: RichRick1337 (8414 in chips) 
Seat 8: color_singleton (5246 in chips) 
Seat 9: HighCardJasper (12529 in chips) 
RichRick1337: posts small blind 50
color_singleton: posts big blind 100
*** HOLE CARDS ***
Dealt to Duke Croix [5h Jc]
HighCardJasper: calls 100
dddocky: folds 
Duke Croix: folds 
FragileMemory: calls 100
RichRick1337: calls 50
color_singleton: checks 
*** FLOP *** [7s 3h 2d]
RichRick1337: checks 
color_singleton: checks 
HighCardJasper: checks 
FragileMemory: bets 100
RichRick1337: folds 
color_singleton: calls 100
HighCardJasper: calls 100
*** TURN *** [7s 3h 2d] [5s]
color_singleton: checks 
HighCardJasper: bets 100
FragileMemory: raises 430 to 530
color_singleton: folds 
HighCardJasper: folds 
Uncalled bet (430) returned to FragileMemory
FragileMemory collected 850 from pot
FragileMemory: doesn't show hand 
*** SUMMARY ***
Total pot 900 | Rake 50 
Board [7s 3h 2d 5s]
Seat 1: dddocky folded before Flop (didn't bet)
Seat 2: Duke Croix folded before Flop (didn't bet)
Seat 3: FragileMemory (button) collected (850)
Seat 5: RichRick1337 (small blind) folded on the Flop
Seat 8: color_singleton (big blind) folded on the Turn
Seat 9: HighCardJasper folded on the Turn



PokerStars Home Game Hand #216246900298: {Club #3225207}  Hold'em No Limit (50/100) - 2020/07/09 15:14:18 ET
Table 'lets goo' 9-max (Play Money) Seat #5 is the button
Seat 1: dddocky (5761 in chips) 
Seat 2: Duke Croix (12114 in chips) 
Seat 3: FragileMemory (14201 in chips) 
Seat 5: RichRick1337 (8314 in chips) 
Seat 8: color_singleton (5046 in chips) 
Seat 9: HighCardJasper (12229 in chips) 
color_singleton: posts small blind 50
HighCardJasper: posts big blind 100
*** HOLE CARDS ***
Dealt to Duke Croix [5d Jh]
dddocky: folds 
Duke Croix: folds 
FragileMemory: calls 100
RichRick1337: calls 100
color_singleton: raises 200 to 300
HighCardJasper: calls 200
FragileMemory: calls 200
RichRick1337: calls 200
*** FLOP *** [Ac Qh 7d]
color_singleton: checks 
HighCardJasper: checks 
FragileMemory: checks 
RichRick1337: checks 
*** TURN *** [Ac Qh 7d] [8d]
color_singleton: checks 
HighCardJasper: bets 300
FragileMemory: calls 300
RichRick1337: folds 
color_singleton: calls 300
*** RIVER *** [Ac Qh 7d 8d] [5s]
color_singleton: checks 
HighCardJasper: bets 700
FragileMemory: folds 
color_singleton: folds 
Uncalled bet (700) returned to HighCardJasper
HighCardJasper collected 1984 from pot
HighCardJasper: doesn't show hand 
*** SUMMARY ***
Total pot 2100 | Rake 116 
Board [Ac Qh 7d 8d 5s]
Seat 1: dddocky folded before Flop (didn't bet)
Seat 2: Duke Croix folded before Flop (didn't bet)
Seat 3: FragileMemory folded on the River
Seat 5: RichRick1337 (button) folded on the Turn
Seat 8: color_singleton (small blind) folded on the River
Seat 9: HighCardJasper (big blind) collected (1984)



PokerStars Home Game Hand #216246952882: {Club #3225207}  Hold'em No Limit (50/100) - 2020/07/09 15:15:36 ET
Table 'lets goo' 9-max (Play Money) Seat #8 is the button
Seat 2: Duke Croix (12114 in chips) 
Seat 3: FragileMemory (13601 in chips) 
Seat 5: RichRick1337 (8014 in chips) 
Seat 8: color_singleton (4446 in chips) 
Seat 9: HighCardJasper (13613 in chips) 
HighCardJasper: posts small blind 50
Duke Croix: posts big blind 100
*** HOLE CARDS ***
Dealt to Duke Croix [4s 5s]
FragileMemory: calls 100
RichRick1337: calls 100
color_singleton: calls 100
HighCardJasper: calls 50
Duke Croix: checks 
*** FLOP *** [5c 6d 8d]
HighCardJasper: checks 
Duke Croix: bets 200
FragileMemory: calls 200
RichRick1337: folds 
color_singleton: folds 
HighCardJasper: calls 200
*** TURN *** [5c 6d 8d] [Kd]
HighCardJasper: checks 
Duke Croix: checks 
FragileMemory: checks 
*** RIVER *** [5c 6d 8d Kd] [Ac]
HighCardJasper: bets 100
Duke Croix: folds 
FragileMemory: raises 100 to 200
HighCardJasper: calls 100
*** SHOW DOWN ***
FragileMemory: shows [Jc 4c] (high card Ace)
HighCardJasper: shows [Td 8h] (a pair of Eights)
HighCardJasper collected 1417 from pot
*** SUMMARY ***
Total pot 1500 | Rake 83 
Board [5c 6d 8d Kd Ac]
Seat 2: Duke Croix (big blind) folded on the River
Seat 3: FragileMemory showed [Jc 4c] and lost with high card Ace
Seat 5: RichRick1337 folded on the Flop
Seat 8: color_singleton (button) folded on the Flop
Seat 9: HighCardJasper (small blind) showed [Td 8h] and won (1417) with a pair of Eights



PokerStars Home Game Hand #216246993090: {Club #3225207}  Hold'em No Limit (50/100) - 2020/07/09 15:16:35 ET
Table 'lets goo' 9-max (Play Money) Seat #9 is the button
Seat 2: Duke Croix (11814 in chips) 
Seat 3: FragileMemory (13101 in chips) 
Seat 5: RichRick1337 (7914 in chips) 
Seat 8: color_singleton (4346 in chips) 
Seat 9: HighCardJasper (14530 in chips) 
Duke Croix: posts small blind 50
FragileMemory: posts big blind 100
*** HOLE CARDS ***
Dealt to Duke Croix [4c Kc]
RichRick1337: folds 
color_singleton: calls 100
HighCardJasper: folds 
Duke Croix: calls 50
FragileMemory: checks 
*** FLOP *** [Ac 7h Qd]
Duke Croix: checks 
FragileMemory: checks 
color_singleton: bets 141
Duke Croix: folds 
FragileMemory: folds 
Uncalled bet (141) returned to color_singleton
color_singleton collected 283 from pot
color_singleton: doesn't show hand 
*** SUMMARY ***
Total pot 300 | Rake 17 
Board [Ac 7h Qd]
Seat 2: Duke Croix (small blind) folded on the Flop
Seat 3: FragileMemory (big blind) folded on the Flop
Seat 5: RichRick1337 folded before Flop (didn't bet)
Seat 8: color_singleton collected (283)
Seat 9: HighCardJasper (button) folded before Flop (didn't bet)



PokerStars Home Game Hand #216247023380: {Club #3225207}  Hold'em No Limit (50/100) - 2020/07/09 15:17:20 ET
Table 'lets goo' 9-max (Play Money) Seat #2 is the button
Seat 1: dddocky (5761 in chips) 
Seat 2: Duke Croix (11714 in chips) 
Seat 3: FragileMemory (13001 in chips) 
Seat 5: RichRick1337 (7914 in chips) 
Seat 8: color_singleton (4529 in chips) 
Seat 9: HighCardJasper (14530 in chips) 
FragileMemory: posts small blind 50
RichRick1337: posts big blind 100
dddocky: posts small & big blinds 150
*** HOLE CARDS ***
Dealt to Duke Croix [Th Jd]
color_singleton: folds 
HighCardJasper has timed out
HighCardJasper: folds 
dddocky: checks 
Duke Croix: raises 200 to 300
FragileMemory: folds 
RichRick1337: calls 200
dddocky: folds 
*** FLOP *** [Kc 8h 5d]
RichRick1337: checks 
Duke Croix: checks 
*** TURN *** [Kc 8h 5d] [5s]
RichRick1337: checks 
Duke Croix: checks 
*** RIVER *** [Kc 8h 5d 5s] [2c]
RichRick1337: checks 
Duke Croix: checks 
*** SHOW DOWN ***
RichRick1337: shows [Qd 3c] (a pair of Fives)
Duke Croix: mucks hand 
RichRick1337 collected 756 from pot
*** SUMMARY ***
Total pot 800 | Rake 44 
Board [Kc 8h 5d 5s 2c]
Seat 1: dddocky folded before Flop (didn't bet)
Seat 2: Duke Croix (button) mucked [Th Jd]
Seat 3: FragileMemory (small blind) folded before Flop
Seat 5: RichRick1337 (big blind) showed [Qd 3c] and won (756) with a pair of Fives
Seat 8: color_singleton folded before Flop (didn't bet)
Seat 9: HighCardJasper folded before Flop (didn't bet)



PokerStars Home Game Hand #216247061519: {Club #3225207}  Hold'em No Limit (50/100) - 2020/07/09 15:18:17 ET
Table 'lets goo' 9-max (Play Money) Seat #3 is the button
Seat 1: dddocky (5611 in chips) 
Seat 2: Duke Croix (11414 in chips) 
Seat 3: FragileMemory (12951 in chips) 
Seat 5: RichRick1337 (8370 in chips) 
Seat 8: color_singleton (4529 in chips) 
Seat 9: HighCardJasper (14530 in chips) 
RichRick1337: posts small blind 50
color_singleton: posts big blind 100
*** HOLE CARDS ***
Dealt to Duke Croix [Jc 4d]
HighCardJasper: raises 100 to 200
dddocky: folds 
Duke Croix: folds 
FragileMemory: folds 
RichRick1337: calls 150
color_singleton: calls 100
*** FLOP *** [6h 4s 5d]
RichRick1337: bets 100
color_singleton: calls 100
HighCardJasper: calls 100
*** TURN *** [6h 4s 5d] [3h]
RichRick1337: bets 100
color_singleton: folds 
HighCardJasper: calls 100
*** RIVER *** [6h 4s 5d 3h] [2d]
RichRick1337: bets 1000
HighCardJasper: calls 1000
*** SHOW DOWN ***
RichRick1337: shows [4c 2s] (a straight, Deuce to Six)
HighCardJasper: shows [Ac Qc] (a straight, Deuce to Six)
RichRick1337 collected 1465 from pot
HighCardJasper collected 1464 from pot
*** SUMMARY ***
Total pot 3100 | Rake 171 
Board [6h 4s 5d 3h 2d]
Seat 1: dddocky folded before Flop (didn't bet)
Seat 2: Duke Croix folded before Flop (didn't bet)
Seat 3: FragileMemory (button) folded before Flop (didn't bet)
Seat 5: RichRick1337 (small blind) showed [4c 2s] and won (1465) with a straight, Deuce to Six
Seat 8: color_singleton (big blind) folded on the Turn
Seat 9: HighCardJasper showed [Ac Qc] and won (1464) with a straight, Deuce to Six



PokerStars Home Game Hand #216247112606: {Club #3225207}  Hold'em No Limit (50/100) - 2020/07/09 15:19:34 ET
Table 'lets goo' 9-max (Play Money) Seat #5 is the button
Seat 1: dddocky (5611 in chips) 
Seat 2: Duke Croix (11414 in chips) 
Seat 3: FragileMemory (12951 in chips) 
Seat 5: RichRick1337 (8435 in chips) 
Seat 8: color_singleton (4229 in chips) 
Seat 9: HighCardJasper (14594 in chips) 
color_singleton: posts small blind 50
HighCardJasper: posts big blind 100
*** HOLE CARDS ***
Dealt to Duke Croix [3h Th]
dddocky: folds 
Duke Croix: folds 
FragileMemory: raises 100 to 200
RichRick1337: calls 200
color_singleton: calls 150
HighCardJasper: calls 100
*** FLOP *** [Qc 9d 2d]
color_singleton: checks 
HighCardJasper: checks 
FragileMemory: bets 378
RichRick1337: folds 
color_singleton: calls 378
HighCardJasper: folds 
*** TURN *** [Qc 9d 2d] [4c]
color_singleton: checks 
FragileMemory: checks 
*** RIVER *** [Qc 9d 2d 4c] [5h]
color_singleton: checks 
FragileMemory: checks 
*** SHOW DOWN ***
color_singleton: shows [Js Td] (high card Queen)
FragileMemory: shows [Jc Jh] (a pair of Jacks)
FragileMemory collected 1470 from pot
*** SUMMARY ***
Total pot 1556 | Rake 86 
Board [Qc 9d 2d 4c 5h]
Seat 1: dddocky folded before Flop (didn't bet)
Seat 2: Duke Croix folded before Flop (didn't bet)
Seat 3: FragileMemory showed [Jc Jh] and won (1470) with a pair of Jacks
Seat 5: RichRick1337 (button) folded on the Flop
Seat 8: color_singleton (small blind) showed [Js Td] and lost with high card Queen
Seat 9: HighCardJasper (big blind) folded on the Flop



PokerStars Home Game Hand #216247149963: {Club #3225207}  Hold'em No Limit (50/100) - 2020/07/09 15:20:30 ET
Table 'lets goo' 9-max (Play Money) Seat #8 is the button
Seat 1: dddocky (5611 in chips) 
Seat 2: Duke Croix (11414 in chips) 
Seat 3: FragileMemory (13843 in chips) 
Seat 5: RichRick1337 (8235 in chips) 
Seat 8: color_singleton (3651 in chips) 
Seat 9: HighCardJasper (14394 in chips) 
HighCardJasper: posts small blind 50
dddocky: posts big blind 100
*** HOLE CARDS ***
Dealt to Duke Croix [9s Ks]
Duke Croix: raises 300 to 400
FragileMemory: folds 
RichRick1337: folds 
color_singleton: calls 400
HighCardJasper: folds 
dddocky: folds 
*** FLOP *** [Tc Ac 3h]
Duke Croix: checks 
color_singleton: checks 
*** TURN *** [Tc Ac 3h] [Js]
Duke Croix: checks 
color_singleton: checks 
*** RIVER *** [Tc Ac 3h Js] [9h]
Duke Croix: checks 
color_singleton: bets 449
Duke Croix: folds 
Uncalled bet (449) returned to color_singleton
color_singleton collected 898 from pot
color_singleton: doesn't show hand 
*** SUMMARY ***
Total pot 950 | Rake 52 
Board [Tc Ac 3h Js 9h]
Seat 1: dddocky (big blind) folded before Flop
Seat 2: Duke Croix folded on the River
Seat 3: FragileMemory folded before Flop (didn't bet)
Seat 5: RichRick1337 folded before Flop (didn't bet)
Seat 8: color_singleton (button) collected (898)
Seat 9: HighCardJasper (small blind) folded before Flop



PokerStars Home Game Hand #216247180858: {Club #3225207}  Hold'em No Limit (50/100) - 2020/07/09 15:21:16 ET
Table 'lets goo' 9-max (Play Money) Seat #9 is the button
Seat 1: dddocky (5511 in chips) 
Seat 2: Duke Croix (11014 in chips) 
Seat 3: FragileMemory (13843 in chips) 
Seat 5: RichRick1337 (8235 in chips) 
Seat 8: color_singleton (4149 in chips) 
Seat 9: HighCardJasper (14344 in chips) 
dddocky: posts small blind 50
Duke Croix: posts big blind 100
*** HOLE CARDS ***
Dealt to Duke Croix [3h As]
FragileMemory: folds 
RichRick1337: calls 100
color_singleton: calls 100
HighCardJasper: calls 100
dddocky: calls 50
Duke Croix: checks 
*** FLOP *** [2s 2h 3c]
dddocky: checks 
Duke Croix: bets 300
RichRick1337: folds 
color_singleton: folds 
HighCardJasper: folds 
dddocky: folds 
Uncalled bet (300) returned to Duke Croix
Duke Croix collected 472 from pot
*** SUMMARY ***
Total pot 500 | Rake 28 
Board [2s 2h 3c]
Seat 1: dddocky (small blind) folded on the Flop
Seat 2: Duke Croix (big blind) collected (472)
Seat 3: FragileMemory folded before Flop (didn't bet)
Seat 5: RichRick1337 folded on the Flop
Seat 8: color_singleton folded on the Flop
Seat 9: HighCardJasper (button) folded on the Flop



PokerStars Home Game Hand #216247197646: {Club #3225207}  Hold'em No Limit (50/100) - 2020/07/09 15:21:41 ET
Table 'lets goo' 9-max (Play Money) Seat #1 is the button
Seat 1: dddocky (5411 in chips) 
Seat 2: Duke Croix (11386 in chips) 
Seat 3: FragileMemory (13843 in chips) 
Seat 5: RichRick1337 (8135 in chips) 
Seat 8: color_singleton (4049 in chips) 
Seat 9: HighCardJasper (14244 in chips) 
Duke Croix: posts small blind 50
FragileMemory: posts big blind 100
*** HOLE CARDS ***
Dealt to Duke Croix [9s Ks]
RichRick1337: calls 100
color_singleton: raises 100 to 200
HighCardJasper: calls 200
dddocky: calls 200
Duke Croix: calls 150
FragileMemory: calls 100
RichRick1337: raises 100 to 300
color_singleton: calls 100
HighCardJasper: calls 100
dddocky: calls 100
Duke Croix: calls 100
FragileMemory: calls 100
*** FLOP *** [Jd 6c Tc]
Duke Croix: checks 
FragileMemory: checks 
RichRick1337: checks 
color_singleton: checks 
HighCardJasper: bets 300
dddocky: calls 300
Duke Croix: folds 
FragileMemory: calls 300
RichRick1337: calls 300
color_singleton: folds 
*** TURN *** [Jd 6c Tc] [4c]
FragileMemory: checks 
RichRick1337: checks 
HighCardJasper: bets 300
dddocky: folds 
FragileMemory: folds 
RichRick1337: folds 
Uncalled bet (300) returned to HighCardJasper
HighCardJasper collected 2835 from pot
HighCardJasper: doesn't show hand 
*** SUMMARY ***
Total pot 3000 | Rake 165 
Board [Jd 6c Tc 4c]
Seat 1: dddocky (button) folded on the Turn
Seat 2: Duke Croix (small blind) folded on the Flop
Seat 3: FragileMemory (big blind) folded on the Turn
Seat 5: RichRick1337 folded on the Turn
Seat 8: color_singleton folded on the Flop
Seat 9: HighCardJasper collected (2835)



PokerStars Home Game Hand #216247247005: {Club #3225207}  Hold'em No Limit (50/100) - 2020/07/09 15:22:44 ET
Table 'lets goo' 9-max (Play Money) Seat #2 is the button
Seat 1: dddocky (4811 in chips) 
Seat 2: Duke Croix (11086 in chips) 
Seat 3: FragileMemory (13243 in chips) 
Seat 5: RichRick1337 (7535 in chips) 
Seat 8: color_singleton (3749 in chips) 
Seat 9: HighCardJasper (16479 in chips) 
FragileMemory: posts small blind 50
RichRick1337: posts big blind 100
*** HOLE CARDS ***
Dealt to Duke Croix [Kh Qh]
color_singleton: folds 
HighCardJasper: calls 100
dddocky: calls 100
Duke Croix: raises 300 to 400
FragileMemory: calls 350
RichRick1337: folds 
HighCardJasper: folds 
dddocky: calls 300
*** FLOP *** [8s 8h Qc]
FragileMemory: bets 661
dddocky: folds 
Duke Croix: calls 661
*** TURN *** [8s 8h Qc] [Kd]
FragileMemory: checks 
Duke Croix: bets 1000
FragileMemory: calls 1000
*** RIVER *** [8s 8h Qc Kd] [7c]
FragileMemory: checks 
Duke Croix: bets 1500
FragileMemory: calls 1500
*** SHOW DOWN ***
Duke Croix: shows [Kh Qh] (two pair, Kings and Queens)
FragileMemory: mucks hand 
Duke Croix collected 7297 from pot
*** SUMMARY ***
Total pot 7722 | Rake 425 
Board [8s 8h Qc Kd 7c]
Seat 1: dddocky folded on the Flop
Seat 2: Duke Croix (button) showed [Kh Qh] and won (7297) with two pair, Kings and Queens
Seat 3: FragileMemory (small blind) mucked [Qs Js]
Seat 5: RichRick1337 (big blind) folded before Flop
Seat 8: color_singleton folded before Flop (didn't bet)
Seat 9: HighCardJasper folded before Flop



PokerStars Home Game Hand #216247285509: {Club #3225207}  Hold'em No Limit (50/100) - 2020/07/09 15:23:42 ET
Table 'lets goo' 9-max (Play Money) Seat #3 is the button
Seat 1: dddocky (4411 in chips) 
Seat 2: Duke Croix (14822 in chips) 
Seat 3: FragileMemory (9682 in chips) 
Seat 5: RichRick1337 (7435 in chips) 
Seat 8: color_singleton (3749 in chips) 
Seat 9: HighCardJasper (16379 in chips) 
RichRick1337: posts small blind 50
color_singleton: posts big blind 100
*** HOLE CARDS ***
Dealt to Duke Croix [Th 5h]
HighCardJasper: calls 100
dddocky: calls 100
Duke Croix: folds 
FragileMemory: folds 
RichRick1337: calls 50
color_singleton: raises 200 to 300
HighCardJasper: folds 
dddocky: calls 200
RichRick1337: calls 200
*** FLOP *** [8d 5c 9d]
RichRick1337: checks 
color_singleton: checks 
dddocky: checks 
*** TURN *** [8d 5c 9d] [5s]
RichRick1337: checks 
color_singleton: checks 
dddocky: checks 
*** RIVER *** [8d 5c 9d 5s] [9s]
RichRick1337: checks 
color_singleton: checks 
dddocky: checks 
*** SHOW DOWN ***
RichRick1337: shows [Ad 7h] (two pair, Nines and Fives)
color_singleton: shows [2s Ah] (two pair, Nines and Fives)
dddocky: shows [Qd 8s] (two pair, Nines and Eights)
dddocky collected 945 from pot
*** SUMMARY ***
Total pot 1000 | Rake 55 
Board [8d 5c 9d 5s 9s]
Seat 1: dddocky showed [Qd 8s] and won (945) with two pair, Nines and Eights
Seat 2: Duke Croix folded before Flop (didn't bet)
Seat 3: FragileMemory (button) folded before Flop (didn't bet)
Seat 5: RichRick1337 (small blind) showed [Ad 7h] and lost with two pair, Nines and Fives
Seat 8: color_singleton (big blind) showed [2s Ah] and lost with two pair, Nines and Fives
Seat 9: HighCardJasper folded before Flop



PokerStars Home Game Hand #216247318488: {Club #3225207}  Hold'em No Limit (50/100) - 2020/07/09 15:24:32 ET
Table 'lets goo' 9-max (Play Money) Seat #5 is the button
Seat 1: dddocky (5056 in chips) 
Seat 2: Duke Croix (14822 in chips) 
Seat 3: FragileMemory (9682 in chips) 
Seat 5: RichRick1337 (7135 in chips) 
Seat 8: color_singleton (3449 in chips) 
Seat 9: HighCardJasper (16279 in chips) 
color_singleton: posts small blind 50
HighCardJasper: posts big blind 100
*** HOLE CARDS ***
Dealt to Duke Croix [6c 4d]
dddocky: calls 100
Duke Croix: folds 
FragileMemory: calls 100
RichRick1337: calls 100
color_singleton: calls 50
HighCardJasper: checks 
*** FLOP *** [As 2s Jc]
color_singleton: checks 
HighCardJasper: checks 
dddocky: checks 
FragileMemory: checks 
RichRick1337: checks 
*** TURN *** [As 2s Jc] [7c]
color_singleton: checks 
HighCardJasper: checks 
dddocky: bets 472
FragileMemory: folds 
RichRick1337: folds 
color_singleton: folds 
HighCardJasper: folds 
Uncalled bet (472) returned to dddocky
dddocky collected 472 from pot
dddocky: doesn't show hand 
*** SUMMARY ***
Total pot 500 | Rake 28 
Board [As 2s Jc 7c]
Seat 1: dddocky collected (472)
Seat 2: Duke Croix folded before Flop (didn't bet)
Seat 3: FragileMemory folded on the Turn
Seat 5: RichRick1337 (button) folded on the Turn
Seat 8: color_singleton (small blind) folded on the Turn
Seat 9: HighCardJasper (big blind) folded on the Turn



PokerStars Home Game Hand #216247350858: {Club #3225207}  Hold'em No Limit (50/100) - 2020/07/09 15:25:21 ET
Table 'lets goo' 9-max (Play Money) Seat #8 is the button
Seat 1: dddocky (5428 in chips) 
Seat 2: Duke Croix (14822 in chips) 
Seat 3: FragileMemory (9582 in chips) 
Seat 5: RichRick1337 (7035 in chips) 
Seat 8: color_singleton (3349 in chips) 
Seat 9: HighCardJasper (16179 in chips) 
HighCardJasper: posts small blind 50
dddocky: posts big blind 100
*** HOLE CARDS ***
Dealt to Duke Croix [7s 7c]
Duke Croix: raises 300 to 400
FragileMemory: folds 
RichRick1337: calls 400
color_singleton: calls 400
HighCardJasper: folds 
dddocky: calls 300
*** FLOP *** [Qd Qc Js]
dddocky: checks 
Duke Croix: bets 1000
RichRick1337: folds 
color_singleton: folds 
dddocky: folds 
Uncalled bet (1000) returned to Duke Croix
Duke Croix collected 1559 from pot
*** SUMMARY ***
Total pot 1650 | Rake 91 
Board [Qd Qc Js]
Seat 1: dddocky (big blind) folded on the Flop
Seat 2: Duke Croix collected (1559)
Seat 3: FragileMemory folded before Flop (didn't bet)
Seat 5: RichRick1337 folded on the Flop
Seat 8: color_singleton (button) folded on the Flop
Seat 9: HighCardJasper (small blind) folded before Flop



PokerStars Home Game Hand #216247372940: {Club #3225207}  Hold'em No Limit (50/100) - 2020/07/09 15:25:47 ET
Table 'lets goo' 9-max (Play Money) Seat #9 is the button
Seat 1: dddocky (5028 in chips) 
Seat 2: Duke Croix (15981 in chips) 
Seat 3: FragileMemory (9582 in chips) 
Seat 5: RichRick1337 (6635 in chips) 
Seat 8: color_singleton (2949 in chips) 
Seat 9: HighCardJasper (16129 in chips) 
dddocky: posts small blind 50
Duke Croix: posts big blind 100
*** HOLE CARDS ***
Dealt to Duke Croix [6c Ah]
FragileMemory: calls 100
RichRick1337: calls 100
color_singleton: folds 
HighCardJasper: calls 100
dddocky: calls 50
Duke Croix: checks 
*** FLOP *** [7c Js 9s]
dddocky: checks 
Duke Croix: checks 
FragileMemory: checks 
RichRick1337: checks 
HighCardJasper: checks 
*** TURN *** [7c Js 9s] [As]
dddocky: checks 
Duke Croix: bets 300
FragileMemory: folds 
RichRick1337: folds 
HighCardJasper: folds 
dddocky: folds 
Uncalled bet (300) returned to Duke Croix
Duke Croix collected 472 from pot
*** SUMMARY ***
Total pot 500 | Rake 28 
Board [7c Js 9s As]
Seat 1: dddocky (small blind) folded on the Turn
Seat 2: Duke Croix (big blind) collected (472)
Seat 3: FragileMemory folded on the Turn
Seat 5: RichRick1337 folded on the Turn
Seat 8: color_singleton folded before Flop (didn't bet)
Seat 9: HighCardJasper (button) folded on the Turn



PokerStars Home Game Hand #216247402403: {Club #3225207}  Hold'em No Limit (50/100) - 2020/07/09 15:26:32 ET
Table 'lets goo' 9-max (Play Money) Seat #1 is the button
Seat 1: dddocky (4928 in chips) 
Seat 2: Duke Croix (16353 in chips) 
Seat 3: FragileMemory (9482 in chips) 
Seat 5: RichRick1337 (6535 in chips) 
Seat 8: color_singleton (2949 in chips) 
Seat 9: HighCardJasper (16029 in chips) 
Duke Croix: posts small blind 50
FragileMemory: posts big blind 100
*** HOLE CARDS ***
Dealt to Duke Croix [Ts 2d]
RichRick1337: calls 100
color_singleton: calls 100
HighCardJasper: folds 
dddocky: folds 
Duke Croix: calls 50
FragileMemory: checks 
*** FLOP *** [3s Kh 7c]
Duke Croix: checks 
FragileMemory: checks 
RichRick1337: checks 
color_singleton: checks 
*** TURN *** [3s Kh 7c] [Td]
Duke Croix: bets 200
FragileMemory: calls 200
RichRick1337: folds 
color_singleton: folds 
*** RIVER *** [3s Kh 7c Td] [Js]
Duke Croix: checks 
FragileMemory: checks 
*** SHOW DOWN ***
Duke Croix: shows [Ts 2d] (a pair of Tens)
FragileMemory: shows [Qc Qh] (a pair of Queens)
FragileMemory collected 756 from pot
*** SUMMARY ***
Total pot 800 | Rake 44 
Board [3s Kh 7c Td Js]
Seat 1: dddocky (button) folded before Flop (didn't bet)
Seat 2: Duke Croix (small blind) showed [Ts 2d] and lost with a pair of Tens
Seat 3: FragileMemory (big blind) showed [Qc Qh] and won (756) with a pair of Queens
Seat 5: RichRick1337 folded on the Turn
Seat 8: color_singleton folded on the Turn
Seat 9: HighCardJasper folded before Flop (didn't bet)



PokerStars Home Game Hand #216247433354: {Club #3225207}  Hold'em No Limit (50/100) - 2020/07/09 15:27:19 ET
Table 'lets goo' 9-max (Play Money) Seat #2 is the button
Seat 1: dddocky (4928 in chips) 
Seat 2: Duke Croix (16053 in chips) 
Seat 3: FragileMemory (9938 in chips) 
Seat 5: RichRick1337 (6435 in chips) 
Seat 8: color_singleton (2849 in chips) 
Seat 9: HighCardJasper (16029 in chips) 
FragileMemory: posts small blind 50
RichRick1337: posts big blind 100
*** HOLE CARDS ***
Dealt to Duke Croix [7c 4c]
color_singleton: folds 
HighCardJasper: calls 100
dddocky: calls 100
Duke Croix: folds 
FragileMemory: calls 50
RichRick1337: checks 
*** FLOP *** [Kd 7d 6s]
FragileMemory: checks 
RichRick1337: checks 
HighCardJasper: checks 
dddocky: bets 100
FragileMemory: calls 100
RichRick1337: folds 
HighCardJasper: calls 100
*** TURN *** [Kd 7d 6s] [5h]
FragileMemory: checks 
HighCardJasper: checks 
dddocky: bets 100
FragileMemory: calls 100
HighCardJasper: calls 100
*** RIVER *** [Kd 7d 6s 5h] [Jd]
FragileMemory: bets 472
HighCardJasper: folds 
dddocky: calls 472
*** SHOW DOWN ***
FragileMemory: shows [Ac Jh] (a pair of Jacks)
dddocky: shows [8c Kh] (a pair of Kings)
dddocky collected 1837 from pot
*** SUMMARY ***
Total pot 1944 | Rake 107 
Board [Kd 7d 6s 5h Jd]
Seat 1: dddocky showed [8c Kh] and won (1837) with a pair of Kings
Seat 2: Duke Croix (button) folded before Flop (didn't bet)
Seat 3: FragileMemory (small blind) showed [Ac Jh] and lost with a pair of Jacks
Seat 5: RichRick1337 (big blind) folded on the Flop
Seat 8: color_singleton folded before Flop (didn't bet)
Seat 9: HighCardJasper folded on the River



PokerStars Home Game Hand #216247469985: {Club #3225207}  Hold'em No Limit (50/100) - 2020/07/09 15:28:14 ET
Table 'lets goo' 9-max (Play Money) Seat #3 is the button
Seat 1: dddocky (5993 in chips) 
Seat 2: Duke Croix (16053 in chips) 
Seat 3: FragileMemory (9166 in chips) 
Seat 5: RichRick1337 (6335 in chips) 
Seat 8: color_singleton (2849 in chips) 
Seat 9: HighCardJasper (15729 in chips) 
RichRick1337: posts small blind 50
color_singleton: posts big blind 100
*** HOLE CARDS ***
Dealt to Duke Croix [3s 3h]
HighCardJasper: calls 100
dddocky: calls 100
Duke Croix: calls 100
FragileMemory: folds 
RichRick1337: raises 100 to 200
color_singleton: calls 100
HighCardJasper: calls 100
dddocky: calls 100
Duke Croix: calls 100
*** FLOP *** [4h 8d Kh]
RichRick1337: checks 
color_singleton: bets 472
HighCardJasper: folds 
dddocky: calls 472
Duke Croix: folds 
RichRick1337: folds 
*** TURN *** [4h 8d Kh] [Tc]
color_singleton: bets 918
dddocky: calls 918
*** RIVER *** [4h 8d Kh Tc] [2c]
color_singleton: bets 1259 and is all-in
dddocky: folds 
Uncalled bet (1259) returned to color_singleton
color_singleton collected 3572 from pot
color_singleton: doesn't show hand 
*** SUMMARY ***
Total pot 3780 | Rake 208 
Board [4h 8d Kh Tc 2c]
Seat 1: dddocky folded on the River
Seat 2: Duke Croix folded on the Flop
Seat 3: FragileMemory (button) folded before Flop (didn't bet)
Seat 5: RichRick1337 (small blind) folded on the Flop
Seat 8: color_singleton (big blind) collected (3572)
Seat 9: HighCardJasper folded on the Flop



PokerStars Home Game Hand #216247515607: {Club #3225207}  Hold'em No Limit (50/100) - 2020/07/09 15:29:24 ET
Table 'lets goo' 9-max (Play Money) Seat #5 is the button
Seat 1: dddocky (4403 in chips) 
Seat 2: Duke Croix (15853 in chips) 
Seat 3: FragileMemory (9166 in chips) 
Seat 5: RichRick1337 (6135 in chips) 
Seat 8: color_singleton (4831 in chips) 
Seat 9: HighCardJasper (15529 in chips) 
color_singleton: posts small blind 50
HighCardJasper: posts big blind 100
*** HOLE CARDS ***
Dealt to Duke Croix [Qs 7d]
dddocky: calls 100
Duke Croix: folds 
FragileMemory: folds 
RichRick1337: calls 100
color_singleton: calls 50
HighCardJasper: checks 
*** FLOP *** [2s 4h 5d]
color_singleton: checks 
HighCardJasper: bets 100
dddocky: calls 100
RichRick1337: calls 100
color_singleton: calls 100
*** TURN *** [2s 4h 5d] [Jc]
color_singleton: checks 
HighCardJasper: checks 
dddocky: checks 
RichRick1337: checks 
*** RIVER *** [2s 4h 5d Jc] [Kh]
color_singleton: bets 378
HighCardJasper: folds 
dddocky: calls 378
RichRick1337: raises 378 to 756
color_singleton: calls 378
dddocky: folds 
*** SHOW DOWN ***
RichRick1337: shows [Kc 4c] (two pair, Kings and Fours)
color_singleton: shows [3d As] (a straight, Ace to Five)
color_singleton collected 2542 from pot
*** SUMMARY ***
Total pot 2690 | Rake 148 
Board [2s 4h 5d Jc Kh]
Seat 1: dddocky folded on the River
Seat 2: Duke Croix folded before Flop (didn't bet)
Seat 3: FragileMemory folded before Flop (didn't bet)
Seat 5: RichRick1337 (button) showed [Kc 4c] and lost with two pair, Kings and Fours
Seat 8: color_singleton (small blind) showed [3d As] and won (2542) with a straight, Ace to Five
Seat 9: HighCardJasper (big blind) folded on the River



PokerStars Home Game Hand #216247557784: {Club #3225207}  Hold'em No Limit (50/100) - 2020/07/09 15:30:27 ET
Table 'lets goo' 9-max (Play Money) Seat #8 is the button
Seat 1: dddocky (3825 in chips) 
Seat 2: Duke Croix (15853 in chips) 
Seat 3: FragileMemory (9166 in chips) 
Seat 5: RichRick1337 (5179 in chips) 
Seat 8: color_singleton (6417 in chips) 
Seat 9: HighCardJasper (15329 in chips) 
HighCardJasper: posts small blind 50
dddocky: posts big blind 100
*** HOLE CARDS ***
Dealt to Duke Croix [9h 5s]
Duke Croix: folds 
FragileMemory: calls 100
RichRick1337: calls 100
color_singleton: folds 
HighCardJasper: raises 100 to 200
dddocky: folds 
FragileMemory: calls 100
RichRick1337: folds 
*** FLOP *** [Qs 6s Kh]
HighCardJasper: checks 
FragileMemory: checks 
*** TURN *** [Qs 6s Kh] [Jc]
HighCardJasper: checks 
FragileMemory: checks 
*** RIVER *** [Qs 6s Kh Jc] [7s]
HighCardJasper: bets 300
FragileMemory: calls 300
*** SHOW DOWN ***
HighCardJasper: shows [Jd Js] (three of a kind, Jacks)
FragileMemory: mucks hand 
HighCardJasper collected 1134 from pot
*** SUMMARY ***
Total pot 1200 | Rake 66 
Board [Qs 6s Kh Jc 7s]
Seat 1: dddocky (big blind) folded before Flop
Seat 2: Duke Croix folded before Flop (didn't bet)
Seat 3: FragileMemory mucked [Qh Ac]
Seat 5: RichRick1337 folded before Flop
Seat 8: color_singleton (button) folded before Flop (didn't bet)
Seat 9: HighCardJasper (small blind) showed [Jd Js] and won (1134) with three of a kind, Jacks



PokerStars Home Game Hand #216247588943: {Club #3225207}  Hold'em No Limit (50/100) - 2020/07/09 15:31:15 ET
Table 'lets goo' 9-max (Play Money) Seat #9 is the button
Seat 1: dddocky (3725 in chips) 
Seat 2: Duke Croix (15853 in chips) 
Seat 3: FragileMemory (8666 in chips) 
Seat 5: RichRick1337 (5079 in chips) 
Seat 8: color_singleton (6417 in chips) 
Seat 9: HighCardJasper (15963 in chips) 
dddocky: posts small blind 50
Duke Croix: posts big blind 100
*** HOLE CARDS ***
Dealt to Duke Croix [3d 5d]
FragileMemory: calls 100
RichRick1337: calls 100
color_singleton: folds 
HighCardJasper: calls 100
dddocky: folds 
Duke Croix: checks 
*** FLOP *** [5c Td 9d]
Duke Croix: bets 300
FragileMemory: folds 
RichRick1337: folds 
HighCardJasper: folds 
Uncalled bet (300) returned to Duke Croix
Duke Croix collected 425 from pot
*** SUMMARY ***
Total pot 450 | Rake 25 
Board [5c Td 9d]
Seat 1: dddocky (small blind) folded before Flop
Seat 2: Duke Croix (big blind) collected (425)
Seat 3: FragileMemory folded on the Flop
Seat 5: RichRick1337 folded on the Flop
Seat 8: color_singleton folded before Flop (didn't bet)
Seat 9: HighCardJasper (button) folded on the Flop



PokerStars Home Game Hand #216247611482: {Club #3225207}  Hold'em No Limit (50/100) - 2020/07/09 15:31:49 ET
Table 'lets goo' 9-max (Play Money) Seat #1 is the button
Seat 1: dddocky (3675 in chips) 
Seat 2: Duke Croix (16178 in chips) 
Seat 3: FragileMemory (8566 in chips) 
Seat 5: RichRick1337 (4979 in chips) 
Seat 8: color_singleton (6417 in chips) 
Seat 9: HighCardJasper (15863 in chips) 
Duke Croix: posts small blind 50
FragileMemory: posts big blind 100
*** HOLE CARDS ***
Dealt to Duke Croix [Kd 2c]
RichRick1337: calls 100
color_singleton: raises 100 to 200
HighCardJasper: calls 200
dddocky: folds 
Duke Croix: folds 
FragileMemory: calls 100
RichRick1337: calls 100
*** FLOP *** [5h 3s 5d]
FragileMemory: checks 
RichRick1337: checks 
color_singleton: checks 
HighCardJasper: checks 
*** TURN *** [5h 3s 5d] [4h]
FragileMemory: checks 
RichRick1337: checks 
color_singleton: checks 
HighCardJasper: checks 
*** RIVER *** [5h 3s 5d 4h] [8d]
FragileMemory: checks 
RichRick1337: checks 
color_singleton: checks 
HighCardJasper: bets 200
FragileMemory: folds 
RichRick1337: calls 200
color_singleton: folds 
*** SHOW DOWN ***
HighCardJasper: shows [Jc 6d] (a pair of Fives)
RichRick1337: shows [6c 6h] (two pair, Sixes and Fives)
RichRick1337 collected 1181 from pot
*** SUMMARY ***
Total pot 1250 | Rake 69 
Board [5h 3s 5d 4h 8d]
Seat 1: dddocky (button) folded before Flop (didn't bet)
Seat 2: Duke Croix (small blind) folded before Flop
Seat 3: FragileMemory (big blind) folded on the River
Seat 5: RichRick1337 showed [6c 6h] and won (1181) with two pair, Sixes and Fives
Seat 8: color_singleton folded on the River
Seat 9: HighCardJasper showed [Jc 6d] and lost with a pair of Fives



PokerStars Home Game Hand #216247654940: {Club #3225207}  Hold'em No Limit (50/100) - 2020/07/09 15:32:54 ET
Table 'lets goo' 9-max (Play Money) Seat #2 is the button
Seat 1: dddocky (3675 in chips) 
Seat 2: Duke Croix (16128 in chips) 
Seat 3: FragileMemory (8366 in chips) 
Seat 5: RichRick1337 (5760 in chips) 
Seat 8: color_singleton (6217 in chips) 
Seat 9: HighCardJasper (15463 in chips) 
FragileMemory: posts small blind 50
RichRick1337: posts big blind 100
*** HOLE CARDS ***
Dealt to Duke Croix [Qs Qh]
color_singleton: folds 
HighCardJasper: calls 100
dddocky: calls 100
Duke Croix: raises 400 to 500
FragileMemory: folds 
RichRick1337: folds 
HighCardJasper: folds 
dddocky: calls 400
*** FLOP *** [4c Ah 2d]
dddocky: checks 
Duke Croix: bets 1000
dddocky: raises 1000 to 2000
Duke Croix: folds 
Uncalled bet (1000) returned to dddocky
dddocky collected 3071 from pot
dddocky: doesn't show hand 
*** SUMMARY ***
Total pot 3250 | Rake 179 
Board [4c Ah 2d]
Seat 1: dddocky collected (3071)
Seat 2: Duke Croix (button) folded on the Flop
Seat 3: FragileMemory (small blind) folded before Flop
Seat 5: RichRick1337 (big blind) folded before Flop
Seat 8: color_singleton folded before Flop (didn't bet)
Seat 9: HighCardJasper folded before Flop



PokerStars Home Game Hand #216247687921: {Club #3225207}  Hold'em No Limit (50/100) - 2020/07/09 15:33:44 ET
Table 'lets goo' 9-max (Play Money) Seat #3 is the button
Seat 1: dddocky (5246 in chips) 
Seat 2: Duke Croix (14628 in chips) 
Seat 3: FragileMemory (8316 in chips) 
Seat 5: RichRick1337 (5660 in chips) 
Seat 8: color_singleton (6217 in chips) 
Seat 9: HighCardJasper (15363 in chips) 
RichRick1337: posts small blind 50
color_singleton: posts big blind 100
*** HOLE CARDS ***
Dealt to Duke Croix [4c 6d]
HighCardJasper: calls 100
dddocky: calls 100
Duke Croix: folds 
FragileMemory: folds 
RichRick1337: calls 50
color_singleton: checks 
*** FLOP *** [8h 6c Ad]
RichRick1337: checks 
color_singleton: checks 
HighCardJasper: bets 200
dddocky: calls 200
RichRick1337: folds 
color_singleton: calls 200
*** TURN *** [8h 6c Ad] [5d]
color_singleton: checks 
HighCardJasper: checks 
dddocky: checks 
*** RIVER *** [8h 6c Ad 5d] [6s]
color_singleton: checks 
HighCardJasper: bets 300
dddocky: folds 
color_singleton: calls 300
*** SHOW DOWN ***
HighCardJasper: shows [As 9h] (two pair, Aces and Sixes)
color_singleton: mucks hand 
HighCardJasper collected 1512 from pot
*** SUMMARY ***
Total pot 1600 | Rake 88 
Board [8h 6c Ad 5d 6s]
Seat 1: dddocky folded on the River
Seat 2: Duke Croix folded before Flop (didn't bet)
Seat 3: FragileMemory (button) folded before Flop (didn't bet)
Seat 5: RichRick1337 (small blind) folded on the Flop
Seat 8: color_singleton (big blind) mucked [Jh 8s]
Seat 9: HighCardJasper showed [As 9h] and won (1512) with two pair, Aces and Sixes



PokerStars Home Game Hand #216247733310: {Club #3225207}  Hold'em No Limit (50/100) - 2020/07/09 15:34:53 ET
Table 'lets goo' 9-max (Play Money) Seat #5 is the button
Seat 1: dddocky (4946 in chips) 
Seat 2: Duke Croix (14628 in chips) 
Seat 3: FragileMemory (8316 in chips) 
Seat 5: RichRick1337 (5560 in chips) 
Seat 8: color_singleton (5617 in chips) 
Seat 9: HighCardJasper (16275 in chips) 
color_singleton: posts small blind 50
HighCardJasper: posts big blind 100
*** HOLE CARDS ***
Dealt to Duke Croix [7d 4s]
dddocky: calls 100
Duke Croix: folds 
FragileMemory: folds 
RichRick1337: calls 100
color_singleton: folds 
HighCardJasper: checks 
*** FLOP *** [Qs 9s Qh]
HighCardJasper: checks 
dddocky: checks 
RichRick1337: checks 
*** TURN *** [Qs 9s Qh] [Kd]
HighCardJasper: checks 
dddocky: checks 
RichRick1337: checks 
*** RIVER *** [Qs 9s Qh Kd] [6d]
HighCardJasper: checks 
dddocky: bets 331
RichRick1337: folds 
HighCardJasper: folds 
Uncalled bet (331) returned to dddocky
dddocky collected 331 from pot
dddocky: doesn't show hand 
*** SUMMARY ***
Total pot 350 | Rake 19 
Board [Qs 9s Qh Kd 6d]
Seat 1: dddocky collected (331)
Seat 2: Duke Croix folded before Flop (didn't bet)
Seat 3: FragileMemory folded before Flop (didn't bet)
Seat 5: RichRick1337 (button) folded on the River
Seat 8: color_singleton (small blind) folded before Flop
Seat 9: HighCardJasper (big blind) folded on the River



PokerStars Home Game Hand #216247765221: {Club #3225207}  Hold'em No Limit (50/100) - 2020/07/09 15:35:41 ET
Table 'lets goo' 9-max (Play Money) Seat #8 is the button
Seat 1: dddocky (5177 in chips) 
Seat 2: Duke Croix (14628 in chips) 
Seat 3: FragileMemory (8316 in chips) 
Seat 5: RichRick1337 (5460 in chips) 
Seat 8: color_singleton (5567 in chips) 
Seat 9: HighCardJasper (16175 in chips) 
HighCardJasper: posts small blind 50
dddocky: posts big blind 100
*** HOLE CARDS ***
Dealt to Duke Croix [7h 5h]
Duke Croix: folds 
FragileMemory: calls 100
RichRick1337: calls 100
color_singleton: folds 
HighCardJasper: calls 50
dddocky: checks 
*** FLOP *** [6c 3c 9c]
HighCardJasper: checks 
dddocky: checks 
FragileMemory: checks 
RichRick1337: bets 100
HighCardJasper: calls 100
dddocky: folds 
FragileMemory: folds 
*** TURN *** [6c 3c 9c] [6d]
HighCardJasper: checks 
RichRick1337: checks 
*** RIVER *** [6c 3c 9c 6d] [As]
HighCardJasper: checks 
RichRick1337: checks 
*** SHOW DOWN ***
HighCardJasper: shows [3d Td] (two pair, Sixes and Threes)
RichRick1337: shows [Ks 3s] (two pair, Sixes and Threes)
HighCardJasper collected 284 from pot
RichRick1337 collected 283 from pot
*** SUMMARY ***
Total pot 600 | Rake 33 
Board [6c 3c 9c 6d As]
Seat 1: dddocky (big blind) folded on the Flop
Seat 2: Duke Croix folded before Flop (didn't bet)
Seat 3: FragileMemory folded on the Flop
Seat 5: RichRick1337 showed [Ks 3s] and won (283) with two pair, Sixes and Threes
Seat 8: color_singleton (button) folded before Flop (didn't bet)
Seat 9: HighCardJasper (small blind) showed [3d Td] and won (284) with two pair, Sixes and Threes



PokerStars Home Game Hand #216247801615: {Club #3225207}  Hold'em No Limit (50/100) - 2020/07/09 15:36:36 ET
Table 'lets goo' 9-max (Play Money) Seat #9 is the button
Seat 1: dddocky (5077 in chips) 
Seat 2: Duke Croix (14628 in chips) 
Seat 3: FragileMemory (8216 in chips) 
Seat 5: RichRick1337 (5543 in chips) 
Seat 8: color_singleton (5567 in chips) 
Seat 9: HighCardJasper (16259 in chips) 
dddocky: posts small blind 50
Duke Croix: posts big blind 100
*** HOLE CARDS ***
Dealt to Duke Croix [8h 9c]
FragileMemory: calls 100
RichRick1337: calls 100
color_singleton: raises 200 to 300
HighCardJasper: folds 
dddocky: calls 250
Duke Croix: calls 200
FragileMemory: folds 
RichRick1337: calls 200
*** FLOP *** [2d 4s As]
dddocky: checks 
Duke Croix: checks 
RichRick1337: checks 
color_singleton: bets 614
dddocky: calls 614
Duke Croix: folds 
RichRick1337: folds 
*** TURN *** [2d 4s As] [4d]
dddocky: checks 
color_singleton: bets 1194
dddocky: calls 1194
*** RIVER *** [2d 4s As 4d] [Ks]
dddocky: checks 
color_singleton: checks 
*** SHOW DOWN ***
dddocky: shows [5s Ac] (two pair, Aces and Fours)
color_singleton: shows [Ad Jd] (two pair, Aces and Fours)
dddocky collected 2323 from pot
color_singleton collected 2323 from pot
*** SUMMARY ***
Total pot 4916 | Rake 270 
Board [2d 4s As 4d Ks]
Seat 1: dddocky (small blind) showed [5s Ac] and won (2323) with two pair, Aces and Fours
Seat 2: Duke Croix (big blind) folded on the Flop
Seat 3: FragileMemory folded before Flop
Seat 5: RichRick1337 folded on the Flop
Seat 8: color_singleton showed [Ad Jd] and won (2323) with two pair, Aces and Fours
Seat 9: HighCardJasper (button) folded before Flop (didn't bet)



PokerStars Home Game Hand #216247849506: {Club #3225207}  Hold'em No Limit (50/100) - 2020/07/09 15:37:48 ET
Table 'lets goo' 9-max (Play Money) Seat #1 is the button
Seat 1: dddocky (5292 in chips) 
Seat 2: Duke Croix (14328 in chips) 
Seat 3: FragileMemory (8116 in chips) 
Seat 5: RichRick1337 (5243 in chips) 
Seat 8: color_singleton (5782 in chips) 
Seat 9: HighCardJasper (16259 in chips) 
Duke Croix: posts small blind 50
FragileMemory: posts big blind 100
*** HOLE CARDS ***
Dealt to Duke Croix [Ks 5h]
RichRick1337: calls 100
color_singleton: folds 
HighCardJasper: calls 100
dddocky: calls 100
Duke Croix: calls 50
FragileMemory: checks 
*** FLOP *** [3c Js Tc]
Duke Croix: checks 
FragileMemory: checks 
RichRick1337: checks 
HighCardJasper: checks 
dddocky: bets 100
Duke Croix: folds 
Manon947 joins the table at seat #4 
FragileMemory: folds 
RichRick1337: folds 
HighCardJasper: calls 100
*** TURN *** [3c Js Tc] [Jh]
HighCardJasper: checks 
dddocky: bets 100
HighCardJasper: folds 
Uncalled bet (100) returned to dddocky
dddocky collected 661 from pot
dddocky: doesn't show hand 
*** SUMMARY ***
Total pot 700 | Rake 39 
Board [3c Js Tc Jh]
Seat 1: dddocky (button) collected (661)
Seat 2: Duke Croix (small blind) folded on the Flop
Seat 3: FragileMemory (big blind) folded on the Flop
Seat 5: RichRick1337 folded on the Flop
Seat 8: color_singleton folded before Flop (didn't bet)
Seat 9: HighCardJasper folded on the Turn



PokerStars Home Game Hand #216247880216: {Club #3225207}  Hold'em No Limit (50/100) - 2020/07/09 15:38:35 ET
Table 'lets goo' 9-max (Play Money) Seat #2 is the button
Seat 1: dddocky (5753 in chips) 
Seat 2: Duke Croix (14228 in chips) 
Seat 3: FragileMemory (8016 in chips) 
Seat 4: Manon947 (10000 in chips) 
Seat 5: RichRick1337 (5143 in chips) 
Seat 8: color_singleton (5782 in chips) 
Seat 9: HighCardJasper (16059 in chips) 
FragileMemory: posts small blind 50
Manon947: posts big blind 100
*** HOLE CARDS ***
Dealt to Duke Croix [9h 3d]
RichRick1337: calls 100
color_singleton: folds 
HighCardJasper: calls 100
dddocky: calls 100
Duke Croix: folds 
FragileMemory: calls 50
Manon947: checks 
*** FLOP *** [6c 8c Qc]
FragileMemory: checks 
Manon947: checks 
RichRick1337: checks 
HighCardJasper: checks 
dddocky: checks 
*** TURN *** [6c 8c Qc] [8h]
FragileMemory: checks 
Manon947: checks 
RichRick1337 has timed out
RichRick1337: checks 
HighCardJasper: checks 
dddocky: checks 
*** RIVER *** [6c 8c Qc 8h] [Js]
FragileMemory: checks 
Manon947: checks 
RichRick1337: checks 
HighCardJasper: bets 300
dddocky: raises 300 to 600
FragileMemory: folds 
Manon947: folds 
RichRick1337: folds 
HighCardJasper: folds 
Uncalled bet (300) returned to dddocky
dddocky collected 1039 from pot
dddocky: doesn't show hand 
*** SUMMARY ***
Total pot 1100 | Rake 61 
Board [6c 8c Qc 8h Js]
Seat 1: dddocky collected (1039)
Seat 2: Duke Croix (button) folded before Flop (didn't bet)
Seat 3: FragileMemory (small blind) folded on the River
Seat 4: Manon947 (big blind) folded on the River
Seat 5: RichRick1337 folded on the River
Seat 8: color_singleton folded before Flop (didn't bet)
Seat 9: HighCardJasper folded on the River



PokerStars Home Game Hand #216247934923: {Club #3225207}  Hold'em No Limit (50/100) - 2020/07/09 15:39:59 ET
Table 'lets goo' 9-max (Play Money) Seat #3 is the button
Seat 1: dddocky (6392 in chips) 
Seat 2: Duke Croix (14228 in chips) 
Seat 3: FragileMemory (7916 in chips) 
Seat 4: Manon947 (9900 in chips) 
Seat 5: RichRick1337 (5043 in chips) 
Seat 8: color_singleton (5782 in chips) 
Seat 9: HighCardJasper (15659 in chips) 
Manon947: posts small blind 50
RichRick1337: posts big blind 100
*** HOLE CARDS ***
Dealt to Duke Croix [Qc Ah]
color_singleton: folds 
HighCardJasper: calls 100
dddocky: calls 100
Duke Croix: raises 300 to 400
FragileMemory: folds 
Manon947: calls 350
RichRick1337: calls 300
HighCardJasper: folds 
dddocky: calls 300
*** FLOP *** [3d Td 2d]
Manon947: checks 
RichRick1337: checks 
dddocky: checks 
Duke Croix: checks 
*** TURN *** [3d Td 2d] [5s]
Manon947: checks 
RichRick1337: checks 
dddocky: checks 
Duke Croix: checks 
*** RIVER *** [3d Td 2d 5s] [Th]
Manon947: checks 
RichRick1337: checks 
dddocky: checks 
Duke Croix: checks 
*** SHOW DOWN ***
Manon947: shows [Kd Qh] (a pair of Tens)
RichRick1337: shows [3s Ks] (two pair, Tens and Threes)
dddocky: shows [5d As] (two pair, Tens and Fives)
Duke Croix: mucks hand 
dddocky collected 1606 from pot
*** SUMMARY ***
Total pot 1700 | Rake 94 
Board [3d Td 2d 5s Th]
Seat 1: dddocky showed [5d As] and won (1606) with two pair, Tens and Fives
Seat 2: Duke Croix mucked [Qc Ah]
Seat 3: FragileMemory (button) folded before Flop (didn't bet)
Seat 4: Manon947 (small blind) showed [Kd Qh] and lost with a pair of Tens
Seat 5: RichRick1337 (big blind) showed [3s Ks] and lost with two pair, Tens and Threes
Seat 8: color_singleton folded before Flop (didn't bet)
Seat 9: HighCardJasper folded before Flop



PokerStars Home Game Hand #216247969113: {Club #3225207}  Hold'em No Limit (50/100) - 2020/07/09 15:40:51 ET
Table 'lets goo' 9-max (Play Money) Seat #4 is the button
Seat 1: dddocky (7598 in chips) 
Seat 2: Duke Croix (13828 in chips) 
Seat 3: FragileMemory (7916 in chips) 
Seat 4: Manon947 (9500 in chips) 
Seat 5: RichRick1337 (4643 in chips) 
Seat 8: color_singleton (5782 in chips) 
Seat 9: HighCardJasper (15559 in chips) 
RichRick1337: posts small blind 50
color_singleton: posts big blind 100
*** HOLE CARDS ***
Dealt to Duke Croix [Js 2h]
HighCardJasper: calls 100
dddocky: folds 
Duke Croix: folds 
FragileMemory: calls 100
Manon947: folds 
RichRick1337: calls 50
color_singleton: checks 
*** FLOP *** [Ac 9h Td]
RichRick1337: bets 100
color_singleton: folds 
HighCardJasper: calls 100
FragileMemory: folds 
*** TURN *** [Ac 9h Td] [3h]
RichRick1337: checks 
HighCardJasper: checks 
*** RIVER *** [Ac 9h Td 3h] [Ah]
RichRick1337: bets 300
HighCardJasper: folds 
Uncalled bet (300) returned to RichRick1337
RichRick1337 collected 567 from pot
RichRick1337: doesn't show hand 
*** SUMMARY ***
Total pot 600 | Rake 33 
Board [Ac 9h Td 3h Ah]
Seat 1: dddocky folded before Flop (didn't bet)
Seat 2: Duke Croix folded before Flop (didn't bet)
Seat 3: FragileMemory folded on the Flop
Seat 4: Manon947 (button) folded before Flop (didn't bet)
Seat 5: RichRick1337 (small blind) collected (567)
Seat 8: color_singleton (big blind) folded on the Flop
Seat 9: HighCardJasper folded on the River



PokerStars Home Game Hand #216247992798: {Club #3225207}  Hold'em No Limit (50/100) - 2020/07/09 15:41:27 ET
Table 'lets goo' 9-max (Play Money) Seat #5 is the button
Seat 1: dddocky (7598 in chips) 
Seat 2: Duke Croix (13828 in chips) 
Seat 3: FragileMemory (7816 in chips) 
Seat 4: Manon947 (9500 in chips) 
Seat 5: RichRick1337 (5010 in chips) 
Seat 8: color_singleton (5682 in chips) 
Seat 9: HighCardJasper (15359 in chips) 
color_singleton: posts small blind 50
HighCardJasper: posts big blind 100
*** HOLE CARDS ***
Dealt to Duke Croix [4h 7h]
dddocky: calls 100
Duke Croix: folds 
FragileMemory: folds 
Manon947: folds 
RichRick1337: calls 100
color_singleton: raises 200 to 300
HighCardJasper: folds 
dddocky: folds 
RichRick1337: calls 200
*** FLOP *** [3s Ks 9h]
color_singleton: checks 
RichRick1337: checks 
*** TURN *** [3s Ks 9h] [Js]
color_singleton: checks 
RichRick1337: checks 
*** RIVER *** [3s Ks 9h Js] [Qd]
color_singleton: checks 
RichRick1337: checks 
*** SHOW DOWN ***
color_singleton: shows [5h Ad] (high card Ace)
RichRick1337: shows [8h Jc] (a pair of Jacks)
RichRick1337 collected 756 from pot
*** SUMMARY ***
Total pot 800 | Rake 44 
Board [3s Ks 9h Js Qd]
Seat 1: dddocky folded before Flop
Seat 2: Duke Croix folded before Flop (didn't bet)
Seat 3: FragileMemory folded before Flop (didn't bet)
Seat 4: Manon947 folded before Flop (didn't bet)
Seat 5: RichRick1337 (button) showed [8h Jc] and won (756) with a pair of Jacks
Seat 8: color_singleton (small blind) showed [5h Ad] and lost with high card Ace
Seat 9: HighCardJasper (big blind) folded before Flop



PokerStars Home Game Hand #216248026256: {Club #3225207}  Hold'em No Limit (50/100) - 2020/07/09 15:42:18 ET
Table 'lets goo' 9-max (Play Money) Seat #8 is the button
Seat 1: dddocky (7498 in chips) 
Seat 2: Duke Croix (13828 in chips) 
Seat 3: FragileMemory (7816 in chips) 
Seat 4: Manon947 (9500 in chips) 
Seat 5: RichRick1337 (5466 in chips) 
Seat 8: color_singleton (5382 in chips) 
Seat 9: HighCardJasper (15259 in chips) 
HighCardJasper: posts small blind 50
dddocky: posts big blind 100
*** HOLE CARDS ***
Dealt to Duke Croix [8h 7d]
Duke Croix: folds 
FragileMemory: folds 
Manon947: calls 100
RichRick1337: calls 100
color_singleton: calls 100
HighCardJasper: folds 
dddocky: checks 
*** FLOP *** [4s 8s 6s]
dddocky: checks 
Manon947: checks 
RichRick1337: checks 
color_singleton: bets 212
dddocky: folds 
Manon947: folds 
RichRick1337: calls 212
*** TURN *** [4s 8s 6s] [7h]
RichRick1337: checks 
color_singleton: bets 413
RichRick1337: calls 413
*** RIVER *** [4s 8s 6s 7h] [Tc]
RichRick1337: checks 
color_singleton: bets 803
RichRick1337: calls 803
*** SHOW DOWN ***
color_singleton: shows [Ks 9c] (a straight, Six to Ten)
RichRick1337: mucks hand 
color_singleton collected 3124 from pot
*** SUMMARY ***
Total pot 3306 | Rake 182 
Board [4s 8s 6s 7h Tc]
Seat 1: dddocky (big blind) folded on the Flop
Seat 2: Duke Croix folded before Flop (didn't bet)
Seat 3: FragileMemory folded before Flop (didn't bet)
Seat 4: Manon947 folded on the Flop
Seat 5: RichRick1337 mucked [3s Kh]
Seat 8: color_singleton (button) showed [Ks 9c] and won (3124) with a straight, Six to Ten
Seat 9: HighCardJasper (small blind) folded before Flop



PokerStars Home Game Hand #216248061835: {Club #3225207}  Hold'em No Limit (50/100) - 2020/07/09 15:43:12 ET
Table 'lets goo' 9-max (Play Money) Seat #9 is the button
Seat 1: dddocky (7398 in chips) 
Seat 2: Duke Croix (13828 in chips) 
Seat 3: FragileMemory (7816 in chips) 
Seat 4: Manon947 (9400 in chips) 
Seat 5: RichRick1337 (3938 in chips) 
Seat 8: color_singleton (6978 in chips) 
Seat 9: HighCardJasper (15209 in chips) 
dddocky: posts small blind 50
Duke Croix: posts big blind 100
*** HOLE CARDS ***
Dealt to Duke Croix [5h 8h]
FragileMemory: calls 100
Manon947: calls 100
RichRick1337: calls 100
color_singleton: calls 100
HighCardJasper: calls 100
dddocky: calls 50
Duke Croix: checks 
*** FLOP *** [Kh Qd 5d]
dddocky: bets 100
Duke Croix: folds 
FragileMemory: folds 
Manon947: raises 100 to 200
RichRick1337: folds 
color_singleton: calls 200
HighCardJasper: calls 200
dddocky: calls 100
*** TURN *** [Kh Qd 5d] [Ad]
dddocky: checks 
Manon947: bets 708
color_singleton: folds 
HighCardJasper: calls 708
dddocky: folds 
*** RIVER *** [Kh Qd 5d Ad] [8c]
Manon947: bets 2756
HighCardJasper: raises 2756 to 5512
Manon947: calls 2756
*** SHOW DOWN ***
HighCardJasper: shows [Jd Th] (a straight, Ten to Ace)
Manon947: mucks hand 
HighCardJasper collected 13173 from pot
*** SUMMARY ***
Total pot 13940 | Rake 767 
Board [Kh Qd 5d Ad 8c]
Seat 1: dddocky (small blind) folded on the Turn
Seat 2: Duke Croix (big blind) folded on the Flop
Seat 3: FragileMemory folded on the Flop
Seat 4: Manon947 mucked [Ac Qh]
Seat 5: RichRick1337 folded on the Flop
Seat 8: color_singleton folded on the Turn
Seat 9: HighCardJasper (button) showed [Jd Th] and won (13173) with a straight, Ten to Ace



PokerStars Home Game Hand #216248118791: {Club #3225207}  Hold'em No Limit (50/100) - 2020/07/09 15:44:39 ET
Table 'lets goo' 9-max (Play Money) Seat #1 is the button
Seat 1: dddocky (7098 in chips) 
Seat 2: Duke Croix (13728 in chips) 
Seat 3: FragileMemory (7716 in chips) 
Seat 4: Manon947 (2880 in chips) 
Seat 5: RichRick1337 (3838 in chips) 
Seat 8: color_singleton (6678 in chips) 
Seat 9: HighCardJasper (21862 in chips) 
Duke Croix: posts small blind 50
FragileMemory: posts big blind 100
*** HOLE CARDS ***
Dealt to Duke Croix [Qh 4h]
Manon947 has timed out
Manon947: folds 
RichRick1337: calls 100
color_singleton: raises 200 to 300
HighCardJasper: folds 
dddocky: folds 
Duke Croix: folds 
FragileMemory: folds 
RichRick1337: calls 200
*** FLOP *** [9c 2d 8h]
RichRick1337: checks 
color_singleton: bets 354
RichRick1337: folds 
Uncalled bet (354) returned to color_singleton
color_singleton collected 709 from pot
color_singleton: doesn't show hand 
*** SUMMARY ***
Total pot 750 | Rake 41 
Board [9c 2d 8h]
Seat 1: dddocky (button) folded before Flop (didn't bet)
Seat 2: Duke Croix (small blind) folded before Flop
Seat 3: FragileMemory (big blind) folded before Flop
Seat 4: Manon947 folded before Flop (didn't bet)
Seat 5: RichRick1337 folded on the Flop
Seat 8: color_singleton collected (709)
Seat 9: HighCardJasper folded before Flop (didn't bet)



PokerStars Home Game Hand #216248158980: {Club #3225207}  Hold'em No Limit (50/100) - 2020/07/09 15:45:40 ET
Table 'lets goo' 9-max (Play Money) Seat #2 is the button
Seat 1: dddocky (7098 in chips) 
Seat 2: Duke Croix (13678 in chips) 
Seat 3: FragileMemory (7616 in chips) 
Seat 4: Manon947 (2880 in chips) 
Seat 5: RichRick1337 (3538 in chips) 
Seat 8: color_singleton (7087 in chips) 
Seat 9: HighCardJasper (21862 in chips) 
FragileMemory: posts small blind 50
Manon947: posts big blind 100
*** HOLE CARDS ***
Dealt to Duke Croix [Ah 2c]
RichRick1337: calls 100
color_singleton: folds 
HighCardJasper: calls 100
dddocky: calls 100
Duke Croix: calls 100
FragileMemory: folds 
Manon947: checks 
*** FLOP *** [Qd 4s 4h]
Manon947: bets 260
RichRick1337: calls 260
HighCardJasper: folds 
dddocky: calls 260
Duke Croix: folds 
*** TURN *** [Qd 4s 4h] [9s]
Manon947: bets 628
RichRick1337: calls 628
dddocky: folds 
*** RIVER *** [Qd 4s 4h 9s] [Qs]
Manon947: checks 
RichRick1337: checks 
*** SHOW DOWN ***
Manon947: shows [7d 7h] (two pair, Queens and Sevens)
RichRick1337: shows [Th Qh] (a full house, Queens full of Fours)
RichRick1337 collected 2444 from pot
*** SUMMARY ***
Total pot 2586 | Rake 142 
Board [Qd 4s 4h 9s Qs]
Seat 1: dddocky folded on the Turn
Seat 2: Duke Croix (button) folded on the Flop
Seat 3: FragileMemory (small blind) folded before Flop
Seat 4: Manon947 (big blind) showed [7d 7h] and lost with two pair, Queens and Sevens
Seat 5: RichRick1337 showed [Th Qh] and won (2444) with a full house, Queens full of Fours
Seat 8: color_singleton folded before Flop (didn't bet)
Seat 9: HighCardJasper folded on the Flop



PokerStars Home Game Hand #216248208474: {Club #3225207}  Hold'em No Limit (50/100) - 2020/07/09 15:46:42 ET
Table 'lets goo' 9-max (Play Money) Seat #3 is the button
Seat 1: dddocky (6738 in chips) 
Seat 2: Duke Croix (13578 in chips) 
Seat 3: FragileMemory (7566 in chips) 
Seat 4: Manon947 (1892 in chips) 
Seat 5: RichRick1337 (4994 in chips) 
Seat 8: color_singleton (7087 in chips) 
Seat 9: HighCardJasper (21762 in chips) 
Manon947: posts small blind 50
RichRick1337: posts big blind 100
*** HOLE CARDS ***
Dealt to Duke Croix [7s 9c]
color_singleton: folds 
HighCardJasper: calls 100
dddocky: calls 100
Duke Croix: folds 
FragileMemory: folds 
Manon947: calls 50
RichRick1337: checks 
*** FLOP *** [4s 5s Tc]
Manon947: checks 
RichRick1337: checks 
HighCardJasper: checks 
dddocky: checks 
*** TURN *** [4s 5s Tc] [2c]
Manon947: checks 
RichRick1337: checks 
HighCardJasper: checks 
dddocky: checks 
*** RIVER *** [4s 5s Tc 2c] [3h]
Manon947: checks 
RichRick1337: bets 700
HighCardJasper: calls 700
dddocky: folds 
Manon947: folds 
*** SHOW DOWN ***
RichRick1337: shows [As 5d] (a straight, Ace to Five)
HighCardJasper: shows [Ad 5h] (a straight, Ace to Five)
RichRick1337 collected 851 from pot
HighCardJasper collected 850 from pot
*** SUMMARY ***
Total pot 1800 | Rake 99 
Board [4s 5s Tc 2c 3h]
Seat 1: dddocky folded on the River
Seat 2: Duke Croix folded before Flop (didn't bet)
Seat 3: FragileMemory (button) folded before Flop (didn't bet)
Seat 4: Manon947 (small blind) folded on the River
Seat 5: RichRick1337 (big blind) showed [As 5d] and won (851) with a straight, Ace to Five
Seat 8: color_singleton folded before Flop (didn't bet)
Seat 9: HighCardJasper showed [Ad 5h] and won (850) with a straight, Ace to Five



PokerStars Home Game Hand #216248237495: {Club #3225207}  Hold'em No Limit (50/100) - 2020/07/09 15:47:26 ET
Table 'lets goo' 9-max (Play Money) Seat #4 is the button
Seat 1: dddocky (6638 in chips) 
Seat 2: Duke Croix (13578 in chips) 
Seat 3: FragileMemory (7566 in chips) 
Seat 4: Manon947 (1792 in chips) 
Seat 5: RichRick1337 (5045 in chips) 
Seat 8: color_singleton (7087 in chips) 
Seat 9: HighCardJasper (21812 in chips) 
RichRick1337: posts small blind 50
color_singleton: posts big blind 100
*** HOLE CARDS ***
Dealt to Duke Croix [Ac 8c]
HighCardJasper: calls 100
dddocky: calls 100
Duke Croix: raises 500 to 600
FragileMemory: folds 
Manon947: folds 
RichRick1337: calls 550
color_singleton: folds 
HighCardJasper: folds 
dddocky: folds 
*** FLOP *** [8s 6h 3h]
RichRick1337: checks 
Duke Croix: bets 1000
RichRick1337: folds 
Uncalled bet (1000) returned to Duke Croix
Duke Croix collected 1417 from pot
*** SUMMARY ***
Total pot 1500 | Rake 83 
Board [8s 6h 3h]
Seat 1: dddocky folded before Flop
Seat 2: Duke Croix collected (1417)
Seat 3: FragileMemory folded before Flop (didn't bet)
Seat 4: Manon947 (button) folded before Flop (didn't bet)
Seat 5: RichRick1337 (small blind) folded on the Flop
Seat 8: color_singleton (big blind) folded before Flop
Seat 9: HighCardJasper folded before Flop



PokerStars Home Game Hand #216248258366: {Club #3225207}  Hold'em No Limit (50/100) - 2020/07/09 15:47:58 ET
Table 'lets goo' 9-max (Play Money) Seat #5 is the button
Seat 1: dddocky (6538 in chips) 
Seat 2: Duke Croix (14395 in chips) 
Seat 3: FragileMemory (7566 in chips) 
Seat 4: Manon947 (1792 in chips) 
Seat 5: RichRick1337 (4445 in chips) 
Seat 8: color_singleton (6987 in chips) 
Seat 9: HighCardJasper (21712 in chips) 
color_singleton: posts small blind 50
HighCardJasper: posts big blind 100
*** HOLE CARDS ***
Dealt to Duke Croix [As Ad]
dddocky: folds 
Duke Croix: raises 300 to 400
FragileMemory: calls 400
Manon947: calls 400
RichRick1337: folds 
color_singleton: folds 
HighCardJasper: folds 
*** FLOP *** [5d Ks 5s]
Duke Croix: bets 800
FragileMemory: folds 
Manon947: folds 
Uncalled bet (800) returned to Duke Croix
Duke Croix collected 1276 from pot
*** SUMMARY ***
Total pot 1350 | Rake 74 
Board [5d Ks 5s]
Seat 1: dddocky folded before Flop (didn't bet)
Seat 2: Duke Croix collected (1276)
Seat 3: FragileMemory folded on the Flop
Seat 4: Manon947 folded on the Flop
Seat 5: RichRick1337 (button) folded before Flop (didn't bet)
Seat 8: color_singleton (small blind) folded before Flop
Seat 9: HighCardJasper (big blind) folded before Flop



PokerStars Home Game Hand #216248275434: {Club #3225207}  Hold'em No Limit (50/100) - 2020/07/09 15:48:24 ET
Table 'lets goo' 9-max (Play Money) Seat #8 is the button
Seat 1: dddocky (6538 in chips) 
Seat 2: Duke Croix (15271 in chips) 
Seat 3: FragileMemory (7166 in chips) 
Seat 4: Manon947 (1392 in chips) 
Seat 5: RichRick1337 (4445 in chips) 
Seat 8: color_singleton (6937 in chips) 
Seat 9: HighCardJasper (21612 in chips) 
HighCardJasper: posts small blind 50
dddocky: posts big blind 100
*** HOLE CARDS ***
Dealt to Duke Croix [6d 3h]
Duke Croix: folds 
FragileMemory: folds 
Manon947: calls 100
RichRick1337: calls 100
color_singleton: raises 200 to 300
HighCardJasper: folds 
dddocky: calls 200
Manon947: calls 200
RichRick1337: calls 200
*** FLOP *** [7c 6c 5c]
dddocky: checks 
Manon947: checks 
RichRick1337: checks 
color_singleton: bets 590
dddocky: folds 
Manon947: folds 
RichRick1337: folds 
Uncalled bet (590) returned to color_singleton
color_singleton collected 1181 from pot
color_singleton: doesn't show hand 
*** SUMMARY ***
Total pot 1250 | Rake 69 
Board [7c 6c 5c]
Seat 1: dddocky (big blind) folded on the Flop
Seat 2: Duke Croix folded before Flop (didn't bet)
Seat 3: FragileMemory folded before Flop (didn't bet)
Seat 4: Manon947 folded on the Flop
Seat 5: RichRick1337 folded on the Flop
Seat 8: color_singleton (button) collected (1181)
Seat 9: HighCardJasper (small blind) folded before Flop



PokerStars Home Game Hand #216248305355: {Club #3225207}  Hold'em No Limit (50/100) - 2020/07/09 15:49:10 ET
Table 'lets goo' 9-max (Play Money) Seat #9 is the button
Seat 1: dddocky (6238 in chips) 
Seat 2: Duke Croix (15271 in chips) 
Seat 3: FragileMemory (7166 in chips) 
Seat 4: Manon947 (1092 in chips) 
Seat 5: RichRick1337 (4145 in chips) 
Seat 8: color_singleton (7818 in chips) 
Seat 9: HighCardJasper (21562 in chips) 
dddocky: posts small blind 50
Duke Croix: posts big blind 100
*** HOLE CARDS ***
Dealt to Duke Croix [2s 8c]
FragileMemory: folds 
Manon947: calls 100
RichRick1337: calls 100
color_singleton: folds 
HighCardJasper: raises 100 to 200
dddocky: folds 
Duke Croix: folds 
Manon947: calls 100
RichRick1337: calls 100
*** FLOP *** [9d Qh 5d]
Manon947: bets 354
RichRick1337: calls 354
HighCardJasper: folds 
*** TURN *** [9d Qh 5d] [Kc]
Manon947: bets 538 and is all-in
RichRick1337: calls 538
*** RIVER *** [9d Qh 5d Kc] [Ts]
*** SHOW DOWN ***
Manon947: shows [Qc 9s] (two pair, Queens and Nines)
RichRick1337: shows [6s 7c] (high card King)
Manon947 collected 2395 from pot
*** SUMMARY ***
Total pot 2534 | Rake 139 
Board [9d Qh 5d Kc Ts]
Seat 1: dddocky (small blind) folded before Flop
Seat 2: Duke Croix (big blind) folded before Flop
Seat 3: FragileMemory folded before Flop (didn't bet)
Seat 4: Manon947 showed [Qc 9s] and won (2395) with two pair, Queens and Nines
Seat 5: RichRick1337 showed [6s 7c] and lost with high card King
Seat 8: color_singleton folded before Flop (didn't bet)
Seat 9: HighCardJasper (button) folded on the Flop



PokerStars Home Game Hand #216248338088: {Club #3225207}  Hold'em No Limit (50/100) - 2020/07/09 15:50:00 ET
Table 'lets goo' 9-max (Play Money) Seat #1 is the button
Seat 1: dddocky (6188 in chips) 
Seat 2: Duke Croix (15171 in chips) 
Seat 3: FragileMemory (7166 in chips) 
Seat 4: Manon947 (2395 in chips) 
Seat 5: RichRick1337 (3053 in chips) 
Seat 8: color_singleton (7818 in chips) 
Seat 9: HighCardJasper (21362 in chips) 
Duke Croix: posts small blind 50
FragileMemory: posts big blind 100
*** HOLE CARDS ***
Dealt to Duke Croix [4d 4c]
Manon947: calls 100
RichRick1337: calls 100
color_singleton: calls 100
HighCardJasper: calls 100
dddocky: calls 100
Duke Croix: calls 50
FragileMemory: checks 
*** FLOP *** [Ks As 9h]
Duke Croix: checks 
FragileMemory: bets 100
Manon947: calls 100
RichRick1337: folds 
color_singleton: calls 100
HighCardJasper: calls 100
dddocky: calls 100
Duke Croix: folds 
*** TURN *** [Ks As 9h] [Qs]
FragileMemory: bets 100
Manon947: calls 100
color_singleton: calls 100
HighCardJasper: calls 100
dddocky: calls 100
*** RIVER *** [Ks As 9h Qs] [Qd]
FragileMemory: bets 100
Manon947: raises 903 to 1003
color_singleton: folds 
HighCardJasper: folds 
dddocky: folds 
FragileMemory: calls 903
*** SHOW DOWN ***
Manon947: shows [Kc 8s] (two pair, Kings and Queens)
FragileMemory: shows [3s Ah] (two pair, Aces and Queens)
FragileMemory collected 3502 from pot
*** SUMMARY ***
Total pot 3706 | Rake 204 
Board [Ks As 9h Qs Qd]
Seat 1: dddocky (button) folded on the River
Seat 2: Duke Croix (small blind) folded on the Flop
Seat 3: FragileMemory (big blind) showed [3s Ah] and won (3502) with two pair, Aces and Queens
Seat 4: Manon947 showed [Kc 8s] and lost with two pair, Kings and Queens
Seat 5: RichRick1337 folded on the Flop
Seat 8: color_singleton folded on the River
Seat 9: HighCardJasper folded on the River



PokerStars Home Game Hand #216248388592: {Club #3225207}  Hold'em No Limit (50/100) - 2020/07/09 15:51:16 ET
Table 'lets goo' 9-max (Play Money) Seat #2 is the button
Seat 1: dddocky (5888 in chips) 
Seat 2: Duke Croix (15071 in chips) 
Seat 3: FragileMemory (9365 in chips) 
Seat 4: Manon947 (1092 in chips) 
Seat 5: RichRick1337 (2953 in chips) 
Seat 8: color_singleton (7518 in chips) 
Seat 9: HighCardJasper (21062 in chips) 
FragileMemory: posts small blind 50
Manon947: posts big blind 100
*** HOLE CARDS ***
Dealt to Duke Croix [3c 9c]
RichRick1337: calls 100
color_singleton: folds 
HighCardJasper: raises 100 to 200
dddocky: calls 200
Duke Croix: folds 
FragileMemory: calls 150
Manon947: folds 
RichRick1337: calls 100
*** FLOP *** [Td Qd 7s]
FragileMemory: checks 
RichRick1337: bets 100
HighCardJasper: calls 100
dddocky: folds 
FragileMemory: folds 
*** TURN *** [Td Qd 7s] [6s]
RichRick1337: bets 400
HighCardJasper: folds 
Uncalled bet (400) returned to RichRick1337
RichRick1337 collected 1039 from pot
RichRick1337: doesn't show hand 
*** SUMMARY ***
Total pot 1100 | Rake 61 
Board [Td Qd 7s 6s]
Seat 1: dddocky folded on the Flop
Seat 2: Duke Croix (button) folded before Flop (didn't bet)
Seat 3: FragileMemory (small blind) folded on the Flop
Seat 4: Manon947 (big blind) folded before Flop
Seat 5: RichRick1337 collected (1039)
Seat 8: color_singleton folded before Flop (didn't bet)
Seat 9: HighCardJasper folded on the Turn



PokerStars Home Game Hand #216248423717: {Club #3225207}  Hold'em No Limit (50/100) - 2020/07/09 15:52:10 ET
Table 'lets goo' 9-max (Play Money) Seat #3 is the button
Seat 1: dddocky (5688 in chips) 
Seat 2: Duke Croix (15071 in chips) 
Seat 3: FragileMemory (9165 in chips) 
Seat 4: Manon947 (992 in chips) 
Seat 5: RichRick1337 (3692 in chips) 
Seat 8: color_singleton (7518 in chips) 
Seat 9: HighCardJasper (20762 in chips) 
Manon947: posts small blind 50
RichRick1337: posts big blind 100
*** HOLE CARDS ***
Dealt to Duke Croix [3d 6s]
color_singleton: raises 200 to 300
HighCardJasper: folds 
dddocky: calls 300
Duke Croix: folds 
FragileMemory: calls 300
Manon947: calls 250
RichRick1337: calls 200
*** FLOP *** [Ac 5c 8c]
Manon947: checks 
RichRick1337: checks 
color_singleton: bets 1417
dddocky: folds 
FragileMemory: folds 
Manon947: folds 
RichRick1337: folds 
Uncalled bet (1417) returned to color_singleton
color_singleton collected 1417 from pot
color_singleton: doesn't show hand 
*** SUMMARY ***
Total pot 1500 | Rake 83 
Board [Ac 5c 8c]
Seat 1: dddocky folded on the Flop
Seat 2: Duke Croix folded before Flop (didn't bet)
Seat 3: FragileMemory (button) folded on the Flop
Seat 4: Manon947 (small blind) folded on the Flop
Seat 5: RichRick1337 (big blind) folded on the Flop
Seat 8: color_singleton collected (1417)
Seat 9: HighCardJasper folded before Flop (didn't bet)



PokerStars Home Game Hand #216248455947: {Club #3225207}  Hold'em No Limit (50/100) - 2020/07/09 15:52:59 ET
Table 'lets goo' 9-max (Play Money) Seat #4 is the button
Seat 1: dddocky (5388 in chips) 
Seat 2: Duke Croix (15071 in chips) 
Seat 3: FragileMemory (8865 in chips) 
Seat 4: Manon947 (692 in chips) 
Seat 5: RichRick1337 (3392 in chips) 
Seat 8: color_singleton (8635 in chips) 
Seat 9: HighCardJasper (20762 in chips) 
RichRick1337: posts small blind 50
color_singleton: posts big blind 100
*** HOLE CARDS ***
Dealt to Duke Croix [7d 3d]
HighCardJasper: calls 100
dddocky: calls 100
Duke Croix: folds 
FragileMemory: folds 
Manon947: calls 100
RichRick1337: calls 50
color_singleton: raises 200 to 300
HighCardJasper: folds 
dddocky: calls 200
Manon947: calls 200
RichRick1337: calls 200
*** FLOP *** [5d 9s 7c]
RichRick1337: checks 
color_singleton: checks 
dddocky: checks 
Manon947: checks 
*** TURN *** [5d 9s 7c] [3c]
RichRick1337: checks 
color_singleton: checks 
dddocky: checks 
Manon947: checks 
*** RIVER *** [5d 9s 7c 3c] [3h]
RichRick1337: checks 
color_singleton: checks 
dddocky: checks 
Manon947: checks 
*** SHOW DOWN ***
RichRick1337: shows [2d Qd] (a pair of Threes)
color_singleton: shows [Ac Jd] (a pair of Threes - Ace kicker)
dddocky: mucks hand 
Manon947: mucks hand 
color_singleton collected 1228 from pot
*** SUMMARY ***
Total pot 1300 | Rake 72 
Board [5d 9s 7c 3c 3h]
Seat 1: dddocky mucked [Qc 8h]
Seat 2: Duke Croix folded before Flop (didn't bet)
Seat 3: FragileMemory folded before Flop (didn't bet)
Seat 4: Manon947 (button) mucked [Th 4h]
Seat 5: RichRick1337 (small blind) showed [2d Qd] and lost with a pair of Threes
Seat 8: color_singleton (big blind) showed [Ac Jd] and won (1228) with a pair of Threes
Seat 9: HighCardJasper folded before Flop



PokerStars Home Game Hand #216248504742: {Club #3225207}  Hold'em No Limit (50/100) - 2020/07/09 15:54:13 ET
Table 'lets goo' 9-max (Play Money) Seat #5 is the button
Seat 1: dddocky (5088 in chips) 
Seat 2: Duke Croix (15071 in chips) 
Seat 3: FragileMemory (8865 in chips) 
Seat 4: Manon947 (392 in chips) 
Seat 5: RichRick1337 (3092 in chips) 
Seat 8: color_singleton (9563 in chips) 
Seat 9: HighCardJasper (20662 in chips) 
color_singleton: posts small blind 50
HighCardJasper: posts big blind 100
*** HOLE CARDS ***
Dealt to Duke Croix [5h 5s]
dddocky: folds 
Duke Croix: raises 300 to 400
FragileMemory: folds 
Manon947: folds 
RichRick1337: calls 400
color_singleton: folds 
HighCardJasper: folds 
*** FLOP *** [4h Td 3h]
Duke Croix: bets 500
RichRick1337: folds 
Uncalled bet (500) returned to Duke Croix
Duke Croix collected 898 from pot
*** SUMMARY ***
Total pot 950 | Rake 52 
Board [4h Td 3h]
Seat 1: dddocky folded before Flop (didn't bet)
Seat 2: Duke Croix collected (898)
Seat 3: FragileMemory folded before Flop (didn't bet)
Seat 4: Manon947 folded before Flop (didn't bet)
Seat 5: RichRick1337 (button) folded on the Flop
Seat 8: color_singleton (small blind) folded before Flop
Seat 9: HighCardJasper (big blind) folded before Flop



PokerStars Home Game Hand #216248521618: {Club #3225207}  Hold'em No Limit (50/100) - 2020/07/09 15:54:39 ET
Table 'lets goo' 9-max (Play Money) Seat #8 is the button
Seat 1: dddocky (5088 in chips) 
Seat 2: Duke Croix (15569 in chips) 
Seat 3: FragileMemory (8865 in chips) 
Seat 4: Manon947 (392 in chips) 
Seat 5: RichRick1337 (2692 in chips) 
Seat 8: color_singleton (9513 in chips) 
Seat 9: HighCardJasper (20562 in chips) 
HighCardJasper: posts small blind 50
dddocky: posts big blind 100
*** HOLE CARDS ***
Dealt to Duke Croix [Js 9d]
Duke Croix: folds 
FragileMemory: folds 
Manon947: folds 
RichRick1337: calls 100
color_singleton: calls 100
HighCardJasper: calls 50
dddocky: checks 
*** FLOP *** [6s Ac Qd]
HighCardJasper: checks 
dddocky: checks 
RichRick1337: bets 900
color_singleton: folds 
HighCardJasper: folds 
dddocky: folds 
Uncalled bet (900) returned to RichRick1337
RichRick1337 collected 378 from pot
RichRick1337: doesn't show hand 
*** SUMMARY ***
Total pot 400 | Rake 22 
Board [6s Ac Qd]
Seat 1: dddocky (big blind) folded on the Flop
Seat 2: Duke Croix folded before Flop (didn't bet)
Seat 3: FragileMemory folded before Flop (didn't bet)
Seat 4: Manon947 folded before Flop (didn't bet)
Seat 5: RichRick1337 collected (378)
Seat 8: color_singleton (button) folded on the Flop
Seat 9: HighCardJasper (small blind) folded on the Flop



PokerStars Home Game Hand #216248538339: {Club #3225207}  Hold'em No Limit (50/100) - 2020/07/09 15:55:08 ET
Table 'lets goo' 9-max (Play Money) Seat #9 is the button
Seat 1: dddocky (4988 in chips) 
Seat 2: Duke Croix (15569 in chips) 
Seat 3: FragileMemory (8865 in chips) 
Seat 4: Manon947 (392 in chips) 
Seat 5: RichRick1337 (2970 in chips) 
Seat 8: color_singleton (9413 in chips) 
Seat 9: HighCardJasper (20462 in chips) 
dddocky: posts small blind 50
Duke Croix: posts big blind 100
*** HOLE CARDS ***
Dealt to Duke Croix [Ts 5h]
FragileMemory: calls 100
Manon947: calls 100
RichRick1337: calls 100
color_singleton: calls 100
HighCardJasper: calls 100
dddocky: calls 50
Duke Croix: checks 
*** FLOP *** [Kh 5c 2h]
dddocky: checks 
Duke Croix: checks 
FragileMemory: checks 
Manon947: bets 292 and is all-in
RichRick1337: folds 
color_singleton: calls 292
HighCardJasper: folds 
dddocky: folds 
Duke Croix: calls 292
FragileMemory: folds 
*** TURN *** [Kh 5c 2h] [Tc]
Duke Croix: bets 800
color_singleton: folds 
Uncalled bet (800) returned to Duke Croix
*** RIVER *** [Kh 5c 2h Tc] [8h]
*** SHOW DOWN ***
Duke Croix: shows [Ts 5h] (two pair, Tens and Fives)
Manon947: shows [6c Kd] (a pair of Kings)
Duke Croix collected 1489 from pot
*** SUMMARY ***
Total pot 1576 | Rake 87 
Board [Kh 5c 2h Tc 8h]
Seat 1: dddocky (small blind) folded on the Flop
Seat 2: Duke Croix (big blind) showed [Ts 5h] and won (1489) with two pair, Tens and Fives
Seat 3: FragileMemory folded on the Flop
Seat 4: Manon947 showed [6c Kd] and lost with a pair of Kings
Seat 5: RichRick1337 folded on the Flop
Seat 8: color_singleton folded on the Turn
Seat 9: HighCardJasper (button) folded on the Flop



PokerStars Home Game Hand #216248566976: {Club #3225207}  Hold'em No Limit (50/100) - 2020/07/09 15:56:09 ET
Table 'lets goo' 9-max (Play Money) Seat #1 is the button
Seat 1: dddocky (4888 in chips) 
Seat 2: Duke Croix (16666 in chips) 
Seat 3: FragileMemory (8765 in chips) 
Seat 5: RichRick1337 (2870 in chips) 
Seat 8: color_singleton (9021 in chips) 
Seat 9: HighCardJasper (20362 in chips) 
Duke Croix: posts small blind 50
FragileMemory: posts big blind 100
*** HOLE CARDS ***
Dealt to Duke Croix [Th Ah]
RichRick1337: calls 100
color_singleton: folds 
HighCardJasper: calls 100
dddocky: calls 100
Duke Croix: raises 400 to 500
FragileMemory: calls 400
RichRick1337: folds 
HighCardJasper: folds 
dddocky: folds 
*** FLOP *** [Ad Qs Jc]
Duke Croix: bets 700
FragileMemory: folds 
Uncalled bet (700) returned to Duke Croix
Duke Croix collected 1228 from pot
*** SUMMARY ***
Total pot 1300 | Rake 72 
Board [Ad Qs Jc]
Seat 1: dddocky (button) folded before Flop
Seat 2: Duke Croix (small blind) collected (1228)
Seat 3: FragileMemory (big blind) folded on the Flop
Seat 5: RichRick1337 folded before Flop
Seat 8: color_singleton folded before Flop (didn't bet)
Seat 9: HighCardJasper folded before Flop



PokerStars Home Game Hand #216248587642: {Club #3225207}  Hold'em No Limit (50/100) - 2020/07/09 15:56:52 ET
Table 'lets goo' 9-max (Play Money) Seat #2 is the button
Seat 1: dddocky (4788 in chips) 
Seat 2: Duke Croix (17394 in chips) 
Seat 3: FragileMemory (8265 in chips) 
Seat 4: Manon947 (10000 in chips) 
Seat 5: RichRick1337 (2770 in chips) 
Seat 8: color_singleton (9021 in chips) 
Seat 9: HighCardJasper (20262 in chips) 
FragileMemory: posts small blind 50
Manon947: posts big blind 100
*** HOLE CARDS ***
Dealt to Duke Croix [2h 6c]
RichRick1337: calls 100
color_singleton: folds 
HighCardJasper: calls 100
dddocky: calls 100
Duke Croix: folds 
FragileMemory: calls 50
Manon947: checks 
*** FLOP *** [3c Kd 9s]
FragileMemory: bets 100
Manon947: folds 
RichRick1337: folds 
HighCardJasper: folds 
dddocky: folds 
Uncalled bet (100) returned to FragileMemory
FragileMemory collected 472 from pot
FragileMemory: doesn't show hand 
*** SUMMARY ***
Total pot 500 | Rake 28 
Board [3c Kd 9s]
Seat 1: dddocky folded on the Flop
Seat 2: Duke Croix (button) folded before Flop (didn't bet)
Seat 3: FragileMemory (small blind) collected (472)
Seat 4: Manon947 (big blind) folded on the Flop
Seat 5: RichRick1337 folded on the Flop
Seat 8: color_singleton folded before Flop (didn't bet)
Seat 9: HighCardJasper folded on the Flop



PokerStars Home Game Hand #216248604464: {Club #3225207}  Hold'em No Limit (50/100) - 2020/07/09 15:57:27 ET
Table 'lets goo' 9-max (Play Money) Seat #3 is the button
Seat 1: dddocky (4688 in chips) 
Seat 2: Duke Croix (17394 in chips) 
Seat 3: FragileMemory (8637 in chips) 
Seat 4: Manon947 (9900 in chips) 
Seat 5: RichRick1337 (2670 in chips) 
Seat 8: color_singleton (9021 in chips) 
Seat 9: HighCardJasper (20162 in chips) 
Manon947: posts small blind 50
RichRick1337: posts big blind 100
*** HOLE CARDS ***
Dealt to Duke Croix [Ks Ac]
color_singleton has timed out
color_singleton: folds 
HighCardJasper: calls 100
dddocky: folds 
Duke Croix: raises 400 to 500
FragileMemory: folds 
Manon947: calls 450
RichRick1337: calls 400
HighCardJasper: folds 
*** FLOP *** [8d 7c 7d]
Manon947: checks 
RichRick1337: checks 
Duke Croix: bets 800
Manon947: calls 800
RichRick1337: folds 
*** TURN *** [8d 7c 7d] [Js]
Manon947: checks 
Duke Croix: checks 
*** RIVER *** [8d 7c 7d Js] [Jc]
Manon947: bets 1512
Duke Croix: calls 1512
*** SHOW DOWN ***
Manon947: shows [Qd Qh] (two pair, Queens and Jacks)
Duke Croix: mucks hand 
Manon947 collected 5882 from pot
*** SUMMARY ***
Total pot 6224 | Rake 342 
Board [8d 7c 7d Js Jc]
Seat 1: dddocky folded before Flop (didn't bet)
Seat 2: Duke Croix mucked [Ks Ac]
Seat 3: FragileMemory (button) folded before Flop (didn't bet)
Seat 4: Manon947 (small blind) showed [Qd Qh] and won (5882) with two pair, Queens and Jacks
Seat 5: RichRick1337 (big blind) folded on the Flop
Seat 8: color_singleton folded before Flop (didn't bet)
Seat 9: HighCardJasper folded before Flop



PokerStars Home Game Hand #216248641256: {Club #3225207}  Hold'em No Limit (50/100) - 2020/07/09 15:58:43 ET
Table 'lets goo' 9-max (Play Money) Seat #4 is the button
Seat 1: dddocky (4688 in chips) 
Seat 2: Duke Croix (14582 in chips) 
Seat 3: FragileMemory (8637 in chips) 
Seat 4: Manon947 (12970 in chips) 
Seat 5: RichRick1337 (2170 in chips) 
Seat 8: color_singleton (9021 in chips) 
Seat 9: HighCardJasper (20062 in chips) 
RichRick1337: posts small blind 50
color_singleton: posts big blind 100
*** HOLE CARDS ***
Dealt to Duke Croix [3h Ad]
HighCardJasper: calls 100
dddocky: calls 100
Duke Croix: calls 100
FragileMemory: calls 100
Manon947: folds 
RichRick1337: calls 50
color_singleton: raises 200 to 300
HighCardJasper: calls 200
dddocky: calls 200
Duke Croix: calls 200
FragileMemory: calls 200
RichRick1337: calls 200
*** FLOP *** [Kh Qs 8h]
RichRick1337: checks 
color_singleton: checks 
HighCardJasper: bets 200
dddocky: folds 
Duke Croix: folds 
FragileMemory: folds 
RichRick1337: calls 200
color_singleton: calls 200
*** TURN *** [Kh Qs 8h] [Kc]
RichRick1337: bets 100
color_singleton: folds 
HighCardJasper: raises 200 to 300
RichRick1337: raises 200 to 500
HighCardJasper: calls 200
*** RIVER *** [Kh Qs 8h Kc] [2h]
RichRick1337: bets 100
HighCardJasper: raises 600 to 700
RichRick1337: raises 470 to 1170 and is all-in
HighCardJasper: calls 470
*** SHOW DOWN ***
RichRick1337: shows [Ks 5s] (three of a kind, Kings)
HighCardJasper: shows [Qc 2c] (two pair, Kings and Queens)
RichRick1337 collected 5424 from pot
*** SUMMARY ***
Total pot 5740 | Rake 316 
Board [Kh Qs 8h Kc 2h]
Seat 1: dddocky folded on the Flop
Seat 2: Duke Croix folded on the Flop
Seat 3: FragileMemory folded on the Flop
Seat 4: Manon947 (button) folded before Flop (didn't bet)
Seat 5: RichRick1337 (small blind) showed [Ks 5s] and won (5424) with three of a kind, Kings
Seat 8: color_singleton (big blind) folded on the Turn
Seat 9: HighCardJasper showed [Qc 2c] and lost with two pair, Kings and Queens



PokerStars Home Game Hand #216248698122: {Club #3225207}  Hold'em No Limit (50/100) - 2020/07/09 16:00:26 ET
Table 'lets goo' 9-max (Play Money) Seat #5 is the button
Seat 1: dddocky (4388 in chips) 
Seat 2: Duke Croix (14282 in chips) 
Seat 3: FragileMemory (8337 in chips) 
Seat 4: Manon947 (12970 in chips) 
Seat 5: RichRick1337 (5424 in chips) 
Seat 8: color_singleton (8521 in chips) 
Seat 9: HighCardJasper (17892 in chips) 
color_singleton: posts small blind 50
HighCardJasper: posts big blind 100
*** HOLE CARDS ***
Dealt to Duke Croix [4c Th]
dddocky: folds 
Duke Croix: folds 
FragileMemory: calls 100
Manon947: calls 100
RichRick1337: calls 100
color_singleton: raises 100 to 200
HighCardJasper: calls 100
FragileMemory: calls 100
Manon947: calls 100
RichRick1337: calls 100
*** FLOP *** [Ts 6d Kd]
color_singleton: checks 
HighCardJasper: checks 
FragileMemory: checks 
Manon947: checks 
RichRick1337: checks 
*** TURN *** [Ts 6d Kd] [3d]
color_singleton: checks 
HighCardJasper: checks 
FragileMemory: bets 472
Manon947: folds 
RichRick1337: calls 472
color_singleton: folds 
HighCardJasper: folds 
*** RIVER *** [Ts 6d Kd 3d] [5h]
FragileMemory: bets 918
RichRick1337: calls 918
*** SHOW DOWN ***
FragileMemory: shows [3h 2s] (a pair of Threes)
RichRick1337: shows [5c Tc] (two pair, Tens and Fives)
RichRick1337 collected 3572 from pot
*** SUMMARY ***
Total pot 3780 | Rake 208 
Board [Ts 6d Kd 3d 5h]
Seat 1: dddocky folded before Flop (didn't bet)
Seat 2: Duke Croix folded before Flop (didn't bet)
Seat 3: FragileMemory showed [3h 2s] and lost with a pair of Threes
Seat 4: Manon947 folded on the Turn
Seat 5: RichRick1337 (button) showed [5c Tc] and won (3572) with two pair, Tens and Fives
Seat 8: color_singleton (small blind) folded on the Turn
Seat 9: HighCardJasper (big blind) folded on the Turn



PokerStars Home Game Hand #216248739582: {Club #3225207}  Hold'em No Limit (50/100) - 2020/07/09 16:01:39 ET
Table 'lets goo' 9-max (Play Money) Seat #8 is the button
Seat 1: dddocky (4388 in chips) 
Seat 2: Duke Croix (14282 in chips) 
Seat 3: FragileMemory (6747 in chips) 
Seat 4: Manon947 (12770 in chips) 
Seat 5: RichRick1337 (7406 in chips) 
Seat 8: color_singleton (8321 in chips) 
Seat 9: HighCardJasper (17692 in chips) 
HighCardJasper: posts small blind 50
dddocky: posts big blind 100
*** HOLE CARDS ***
Dealt to Duke Croix [8s Qh]
Duke Croix: folds 
FragileMemory: calls 100
Manon947: calls 100
RichRick1337: calls 100
color_singleton: folds 
HighCardJasper: calls 50
dddocky: checks 
*** FLOP *** [5h 4s 7s]
HighCardJasper: checks 
dddocky: checks 
FragileMemory: checks 
Manon947: bets 236
RichRick1337: calls 236
HighCardJasper: folds 
dddocky: calls 236
FragileMemory: raises 708 to 944
Manon947: calls 708
RichRick1337: calls 708
dddocky: folds 
*** TURN *** [5h 4s 7s] [8c]
FragileMemory: bets 1686
Manon947: calls 1686
RichRick1337: folds 
*** RIVER *** [5h 4s 7s 8c] [2d]
FragileMemory: bets 3279
Manon947: calls 3279
*** SHOW DOWN ***
FragileMemory: shows [4h 5s] (two pair, Fives and Fours)
Manon947: shows [3c 6c] (a straight, Four to Eight)
Manon947 collected 12756 from pot
*** SUMMARY ***
Total pot 13498 | Rake 742 
Board [5h 4s 7s 8c 2d]
Seat 1: dddocky (big blind) folded on the Flop
Seat 2: Duke Croix folded before Flop (didn't bet)
Seat 3: FragileMemory showed [4h 5s] and lost with two pair, Fives and Fours
Seat 4: Manon947 showed [3c 6c] and won (12756) with a straight, Four to Eight
Seat 5: RichRick1337 folded on the Turn
Seat 8: color_singleton (button) folded before Flop (didn't bet)
Seat 9: HighCardJasper (small blind) folded on the Flop



PokerStars Home Game Hand #216248779313: {Club #3225207}  Hold'em No Limit (50/100) - 2020/07/09 16:02:42 ET
Table 'lets goo' 9-max (Play Money) Seat #9 is the button
Seat 1: dddocky (4052 in chips) 
Seat 2: Duke Croix (14282 in chips) 
Seat 3: FragileMemory (738 in chips) 
Seat 4: Manon947 (19517 in chips) 
Seat 5: RichRick1337 (6362 in chips) 
Seat 8: color_singleton (8321 in chips) 
Seat 9: HighCardJasper (17592 in chips) 
dddocky: posts small blind 50
Duke Croix: posts big blind 100
*** HOLE CARDS ***
Dealt to Duke Croix [Qs 8h]
RichRick1337 said, "+++++++++"
FragileMemory: calls 100
Manon947: calls 100
RichRick1337: calls 100
color_singleton: calls 100
HighCardJasper: calls 100
dddocky: calls 50
Duke Croix: checks 
*** FLOP *** [As 4d 5c]
dddocky: checks 
Duke Croix: checks 
FragileMemory: bets 638 and is all-in
Manon947: calls 638
RichRick1337: calls 638
color_singleton: folds 
HighCardJasper: folds 
dddocky: folds 
Duke Croix: folds 
*** TURN *** [As 4d 5c] [5s]
Manon947: bets 1235
RichRick1337: calls 1235
*** RIVER *** [As 4d 5c 5s] [9s]
Manon947: bets 2402
RichRick1337: folds 
Uncalled bet (2402) returned to Manon947
*** SHOW DOWN ***
Manon947: shows [Qd Ac] (two pair, Aces and Fives)
Manon947 collected 2334 from side pot
FragileMemory: shows [2c Ks] (a pair of Fives)
Manon947 collected 2470 from main pot
*** SUMMARY ***
Total pot 5084 Main pot 2470. Side pot 2334. | Rake 280 
Board [As 4d 5c 5s 9s]
Seat 1: dddocky (small blind) folded on the Flop
Seat 2: Duke Croix (big blind) folded on the Flop
Seat 3: FragileMemory showed [2c Ks] and lost with a pair of Fives
Seat 4: Manon947 showed [Qd Ac] and won (4804) with two pair, Aces and Fives
Seat 5: RichRick1337 folded on the River
Seat 8: color_singleton folded on the Flop
Seat 9: HighCardJasper (button) folded on the Flop



PokerStars Home Game Hand #216248832446: {Club #3225207}  Hold'em No Limit (50/100) - 2020/07/09 16:04:05 ET
Table 'lets goo' 9-max (Play Money) Seat #1 is the button
Seat 1: dddocky (3952 in chips) 
Seat 2: Duke Croix (14182 in chips) 
Seat 4: Manon947 (22348 in chips) 
Seat 5: RichRick1337 (4389 in chips) 
Seat 8: color_singleton (8221 in chips) 
Seat 9: HighCardJasper (17492 in chips) 
Duke Croix: posts small blind 50
Manon947: posts big blind 100
*** HOLE CARDS ***
Dealt to Duke Croix [7d 7h]
RichRick1337: calls 100
color_singleton: folds 
HighCardJasper: raises 200 to 300
dddocky: calls 300
Duke Croix: calls 250
Manon947: calls 200
RichRick1337: calls 200
*** FLOP *** [3c 8h Qd]
Duke Croix: checks 
Manon947: checks 
RichRick1337: checks 
HighCardJasper: bets 500
dddocky: folds 
Duke Croix: folds 
Manon947: folds 
RichRick1337: folds 
Uncalled bet (500) returned to HighCardJasper
HighCardJasper collected 1417 from pot
HighCardJasper: doesn't show hand 
*** SUMMARY ***
Total pot 1500 | Rake 83 
Board [3c 8h Qd]
Seat 1: dddocky (button) folded on the Flop
Seat 2: Duke Croix (small blind) folded on the Flop
Seat 4: Manon947 (big blind) folded on the Flop
Seat 5: RichRick1337 folded on the Flop
Seat 8: color_singleton folded before Flop (didn't bet)
Seat 9: HighCardJasper collected (1417)



PokerStars Home Game Hand #216248872848: {Club #3225207}  Hold'em No Limit (50/100) - 2020/07/09 16:05:06 ET
Table 'lets goo' 9-max (Play Money) Seat #2 is the button
Seat 1: dddocky (3652 in chips) 
Seat 2: Duke Croix (13882 in chips) 
Seat 4: Manon947 (22048 in chips) 
Seat 5: RichRick1337 (4089 in chips) 
Seat 8: color_singleton (8221 in chips) 
Seat 9: HighCardJasper (18609 in chips) 
Manon947: posts small blind 50
RichRick1337: posts big blind 100
*** HOLE CARDS ***
Dealt to Duke Croix [7h Jc]
color_singleton: raises 200 to 300
HighCardJasper: folds 
dddocky: folds 
Duke Croix: folds 
Manon947: folds 
RichRick1337: calls 200
*** FLOP *** [2d 7d 8c]
RichRick1337: checks 
color_singleton: checks 
*** TURN *** [2d 7d 8c] [5c]
RichRick1337: checks 
color_singleton: checks 
*** RIVER *** [2d 7d 8c 5c] [2s]
RichRick1337: bets 100
color_singleton: calls 100
*** SHOW DOWN ***
RichRick1337: shows [9c 9h] (two pair, Nines and Deuces)
color_singleton: mucks hand 
RichRick1337 collected 803 from pot
*** SUMMARY ***
Total pot 850 | Rake 47 
Board [2d 7d 8c 5c 2s]
Seat 1: dddocky folded before Flop (didn't bet)
Seat 2: Duke Croix (button) folded before Flop (didn't bet)
Seat 4: Manon947 (small blind) folded before Flop
Seat 5: RichRick1337 (big blind) showed [9c 9h] and won (803) with two pair, Nines and Deuces
Seat 8: color_singleton mucked [Ah Kd]
Seat 9: HighCardJasper folded before Flop (didn't bet)



PokerStars Home Game Hand #216248901924: {Club #3225207}  Hold'em No Limit (50/100) - 2020/07/09 16:05:51 ET
Table 'lets goo' 9-max (Play Money) Seat #4 is the button
Seat 1: dddocky (3652 in chips) 
Seat 2: Duke Croix (13882 in chips) 
Seat 3: FragileMemory (10000 in chips) 
Seat 4: Manon947 (21998 in chips) 
Seat 5: RichRick1337 (4492 in chips) 
Seat 8: color_singleton (7821 in chips) 
Seat 9: HighCardJasper (18609 in chips) 
RichRick1337: posts small blind 50
color_singleton: posts big blind 100
FragileMemory: posts small & big blinds 150
*** HOLE CARDS ***
Dealt to Duke Croix [Ad 2s]
HighCardJasper: raises 100 to 200
dddocky: calls 200
Duke Croix: calls 200
FragileMemory: calls 100
Manon947: calls 200
RichRick1337: calls 150
color_singleton: calls 100
*** FLOP *** [Th 7h Ah]
RichRick1337: bets 400
color_singleton: folds 
HighCardJasper: calls 400
dddocky: folds 
Duke Croix: calls 400
FragileMemory: folds 
Manon947: folds 
*** TURN *** [Th 7h Ah] [3h]
RichRick1337: checks 
HighCardJasper: bets 1000
Duke Croix: folds 
RichRick1337: folds 
Uncalled bet (1000) returned to HighCardJasper
HighCardJasper collected 2504 from pot
HighCardJasper: doesn't show hand 
*** SUMMARY ***
Total pot 2650 | Rake 146 
Board [Th 7h Ah 3h]
Seat 1: dddocky folded on the Flop
Seat 2: Duke Croix folded on the Turn
Seat 3: FragileMemory folded on the Flop
Seat 4: Manon947 (button) folded on the Flop
Seat 5: RichRick1337 (small blind) folded on the Turn
Seat 8: color_singleton (big blind) folded on the Flop
Seat 9: HighCardJasper collected (2504)



PokerStars Home Game Hand #216248931978: {Club #3225207}  Hold'em No Limit (50/100) - 2020/07/09 16:06:36 ET
Table 'lets goo' 9-max (Play Money) Seat #5 is the button
Seat 1: dddocky (3452 in chips) 
Seat 2: Duke Croix (13282 in chips) 
Seat 3: FragileMemory (9750 in chips) 
Seat 5: RichRick1337 (3892 in chips) 
Seat 8: color_singleton (7621 in chips) 
Seat 9: HighCardJasper (20513 in chips) 
color_singleton: posts small blind 50
HighCardJasper: posts big blind 100
*** HOLE CARDS ***
Dealt to Duke Croix [7d Qs]
dddocky: folds 
Manon947 is disconnected 
Duke Croix: folds 
FragileMemory: calls 100
RichRick1337: calls 100
color_singleton: raises 200 to 300
HighCardJasper: folds 
FragileMemory: raises 200 to 500
RichRick1337: calls 400
color_singleton: calls 200
*** FLOP *** [6d 9s Tc]
color_singleton: checks 
FragileMemory: bets 756
RichRick1337: folds 
color_singleton: calls 756
*** TURN *** [6d 9s Tc] [8h]
color_singleton: checks 
FragileMemory: bets 1470
color_singleton: folds 
Uncalled bet (1470) returned to FragileMemory
FragileMemory collected 2941 from pot
FragileMemory: doesn't show hand 
*** SUMMARY ***
Total pot 3112 | Rake 171 
Board [6d 9s Tc 8h]
Seat 1: dddocky folded before Flop (didn't bet)
Seat 2: Duke Croix folded before Flop (didn't bet)
Seat 3: FragileMemory collected (2941)
Seat 5: RichRick1337 (button) folded on the Flop
Seat 8: color_singleton (small blind) folded on the Turn
Seat 9: HighCardJasper (big blind) folded before Flop



PokerStars Home Game Hand #216248973747: {Club #3225207}  Hold'em No Limit (50/100) - 2020/07/09 16:07:40 ET
Table 'lets goo' 9-max (Play Money) Seat #8 is the button
Seat 1: dddocky (3452 in chips) 
Seat 2: Duke Croix (13282 in chips) 
Seat 3: FragileMemory (11435 in chips) 
Seat 5: RichRick1337 (3392 in chips) 
Seat 8: color_singleton (6365 in chips) 
Seat 9: HighCardJasper (20413 in chips) 
HighCardJasper: posts small blind 50
dddocky: posts big blind 100
*** HOLE CARDS ***
Dealt to Duke Croix [Ts 2c]
Duke Croix: folds 
FragileMemory: folds 
RichRick1337: calls 100
color_singleton: folds 
HighCardJasper: calls 50
dddocky: checks 
*** FLOP *** [8h 2s 7d]
HighCardJasper: bets 200
dddocky: folds 
RichRick1337: folds 
Uncalled bet (200) returned to HighCardJasper
HighCardJasper collected 283 from pot
HighCardJasper: doesn't show hand 
*** SUMMARY ***
Total pot 300 | Rake 17 
Board [8h 2s 7d]
Seat 1: dddocky (big blind) folded on the Flop
Seat 2: Duke Croix folded before Flop (didn't bet)
Seat 3: FragileMemory folded before Flop (didn't bet)
Seat 5: RichRick1337 folded on the Flop
Seat 8: color_singleton (button) folded before Flop (didn't bet)
Seat 9: HighCardJasper (small blind) collected (283)



PokerStars Home Game Hand #216248995877: {Club #3225207}  Hold'em No Limit (50/100) - 2020/07/09 16:08:14 ET
Table 'lets goo' 9-max (Play Money) Seat #9 is the button
Seat 1: dddocky (3352 in chips) 
Seat 2: Duke Croix (13282 in chips) 
Seat 3: FragileMemory (11435 in chips) 
Seat 5: RichRick1337 (3292 in chips) 
Seat 8: color_singleton (6365 in chips) 
Seat 9: HighCardJasper (20596 in chips) 
dddocky: posts small blind 50
Duke Croix: posts big blind 100
*** HOLE CARDS ***
Dealt to Duke Croix [Ad Jc]
FragileMemory: folds 
RichRick1337: calls 100
color_singleton: folds 
HighCardJasper: calls 100
dddocky: calls 50
Duke Croix: raises 400 to 500
RichRick1337: calls 400
HighCardJasper: folds 
dddocky: folds 
*** FLOP *** [Qc 3h 7s]
Duke Croix: bets 600
RichRick1337: calls 600
*** TURN *** [Qc 3h 7s] [7h]
Duke Croix: checks 
RichRick1337: checks 
*** RIVER *** [Qc 3h 7s 7h] [5c]
Duke Croix: checks 
RichRick1337: checks 
*** SHOW DOWN ***
Duke Croix: shows [Ad Jc] (a pair of Sevens)
RichRick1337: shows [Jh Qd] (two pair, Queens and Sevens)
RichRick1337 collected 2268 from pot
*** SUMMARY ***
Total pot 2400 | Rake 132 
Board [Qc 3h 7s 7h 5c]
Seat 1: dddocky (small blind) folded before Flop
Seat 2: Duke Croix (big blind) showed [Ad Jc] and lost with a pair of Sevens
Seat 3: FragileMemory folded before Flop (didn't bet)
Seat 5: RichRick1337 showed [Jh Qd] and won (2268) with two pair, Queens and Sevens
Seat 8: color_singleton folded before Flop (didn't bet)
Seat 9: HighCardJasper (button) folded before Flop



PokerStars Home Game Hand #216249031510: {Club #3225207}  Hold'em No Limit (50/100) - 2020/07/09 16:09:09 ET
Table 'lets goo' 9-max (Play Money) Seat #1 is the button
Seat 1: dddocky (3252 in chips) 
Seat 2: Duke Croix (12182 in chips) 
Seat 3: FragileMemory (11435 in chips) 
Seat 5: RichRick1337 (4460 in chips) 
Seat 8: color_singleton (6365 in chips) 
Seat 9: HighCardJasper (20496 in chips) 
Duke Croix: posts small blind 50
FragileMemory: posts big blind 100
*** HOLE CARDS ***
Dealt to Duke Croix [Ac Td]
RichRick1337: raises 100 to 200
color_singleton: calls 200
HighCardJasper: calls 200
dddocky: calls 200
Duke Croix: calls 150
FragileMemory: folds 
*** FLOP *** [8s 8c 4h]
Duke Croix: checks 
RichRick1337: bets 1200
color_singleton: folds 
HighCardJasper: folds 
dddocky: folds 
Duke Croix: folds 
Uncalled bet (1200) returned to RichRick1337
RichRick1337 collected 1039 from pot
RichRick1337: doesn't show hand 
*** SUMMARY ***
Total pot 1100 | Rake 61 
Board [8s 8c 4h]
Seat 1: dddocky (button) folded on the Flop
Seat 2: Duke Croix (small blind) folded on the Flop
Seat 3: FragileMemory (big blind) folded before Flop
Seat 5: RichRick1337 collected (1039)
Seat 8: color_singleton folded on the Flop
Seat 9: HighCardJasper folded on the Flop



PokerStars Home Game Hand #216249055546: {Club #3225207}  Hold'em No Limit (50/100) - 2020/07/09 16:09:45 ET
Table 'lets goo' 9-max (Play Money) Seat #2 is the button
Seat 1: dddocky (3052 in chips) 
Seat 2: Duke Croix (11982 in chips) 
Seat 3: FragileMemory (11335 in chips) 
Seat 5: RichRick1337 (5299 in chips) 
Seat 8: color_singleton (6165 in chips) 
Seat 9: HighCardJasper (20296 in chips) 
FragileMemory: posts small blind 50
RichRick1337: posts big blind 100
*** HOLE CARDS ***
Dealt to Duke Croix [9h Ad]
color_singleton: folds 
HighCardJasper: calls 100
dddocky: calls 100
Duke Croix has timed out
Duke Croix: folds 
FragileMemory: folds 
RichRick1337: checks 
*** FLOP *** [Js Th 3c]
RichRick1337: checks 
HighCardJasper: checks 
dddocky: checks 
*** TURN *** [Js Th 3c] [Kh]
RichRick1337: checks 
HighCardJasper: checks 
dddocky: checks 
*** RIVER *** [Js Th 3c Kh] [5h]
RichRick1337: bets 1100
HighCardJasper: folds 
dddocky: folds 
Uncalled bet (1100) returned to RichRick1337
RichRick1337 collected 331 from pot
RichRick1337: doesn't show hand 
*** SUMMARY ***
Total pot 350 | Rake 19 
Board [Js Th 3c Kh 5h]
Seat 1: dddocky folded on the River
Seat 2: Duke Croix (button) folded before Flop (didn't bet)
Seat 3: FragileMemory (small blind) folded before Flop
Seat 5: RichRick1337 (big blind) collected (331)
Seat 8: color_singleton folded before Flop (didn't bet)
Seat 9: HighCardJasper folded on the River



PokerStars Home Game Hand #216249099248: {Club #3225207}  Hold'em No Limit (50/100) - 2020/07/09 16:10:51 ET
Table 'lets goo' 9-max (Play Money) Seat #3 is the button
Seat 1: dddocky (2952 in chips) 
Seat 2: Duke Croix (11982 in chips) 
Seat 3: FragileMemory (11285 in chips) 
Seat 5: RichRick1337 (5530 in chips) 
Seat 8: color_singleton (6165 in chips) 
Seat 9: HighCardJasper (20196 in chips) 
RichRick1337: posts small blind 50
color_singleton: posts big blind 100
*** HOLE CARDS ***
Dealt to Duke Croix [Tc Ts]
HighCardJasper: calls 100
dddocky: calls 100
Duke Croix: raises 400 to 500
FragileMemory: folds 
RichRick1337: calls 450
color_singleton: folds 
HighCardJasper: folds 
dddocky: folds 
*** FLOP *** [3d Qd 4h]
RichRick1337: checks 
Duke Croix: bets 700
RichRick1337: folds 
Uncalled bet (700) returned to Duke Croix
Duke Croix collected 1228 from pot
*** SUMMARY ***
Total pot 1300 | Rake 72 
Board [3d Qd 4h]
Seat 1: dddocky folded before Flop
Seat 2: Duke Croix collected (1228)
Seat 3: FragileMemory (button) folded before Flop (didn't bet)
Seat 5: RichRick1337 (small blind) folded on the Flop
Seat 8: color_singleton (big blind) folded before Flop
Seat 9: HighCardJasper folded before Flop



PokerStars Home Game Hand #216249124678: {Club #3225207}  Hold'em No Limit (50/100) - 2020/07/09 16:11:30 ET
Table 'lets goo' 9-max (Play Money) Seat #5 is the button
Seat 1: dddocky (2852 in chips) 
Seat 2: Duke Croix (12710 in chips) 
Seat 3: FragileMemory (11285 in chips) 
Seat 4: Manon947 (21798 in chips) 
Seat 5: RichRick1337 (5030 in chips) 
Seat 8: color_singleton (6065 in chips) 
Seat 9: HighCardJasper (20096 in chips) 
color_singleton: posts small blind 50
HighCardJasper: posts big blind 100
Manon947: posts small & big blinds 150
*** HOLE CARDS ***
Dealt to Duke Croix [2d 6s]
dddocky: calls 100
Duke Croix: folds 
FragileMemory: folds 
Manon947: checks 
RichRick1337: raises 100 to 200
color_singleton: calls 150
HighCardJasper: calls 100
dddocky: calls 100
Manon947: calls 100
*** FLOP *** [9s Tc 2h]
color_singleton: checks 
HighCardJasper: checks 
dddocky: checks 
Manon947: checks 
RichRick1337: bets 500
color_singleton: calls 500
HighCardJasper: folds 
dddocky: folds 
Manon947: folds 
*** TURN *** [9s Tc 2h] [4h]
color_singleton: checks 
RichRick1337: checks 
*** RIVER *** [9s Tc 2h 4h] [3s]
color_singleton: checks 
RichRick1337: bets 100
color_singleton: calls 100
*** SHOW DOWN ***
RichRick1337: shows [Ah Ac] (a pair of Aces)
color_singleton: mucks hand 
RichRick1337 collected 2126 from pot
*** SUMMARY ***
Total pot 2250 | Rake 124 
Board [9s Tc 2h 4h 3s]
Seat 1: dddocky folded on the Flop
Seat 2: Duke Croix folded before Flop (didn't bet)
Seat 3: FragileMemory folded before Flop (didn't bet)
Seat 4: Manon947 folded on the Flop
Seat 5: RichRick1337 (button) showed [Ah Ac] and won (2126) with a pair of Aces
Seat 8: color_singleton (small blind) mucked [2s Ad]
Seat 9: HighCardJasper (big blind) folded on the Flop



PokerStars Home Game Hand #216249174254: {Club #3225207}  Hold'em No Limit (50/100) - 2020/07/09 16:12:45 ET
Table 'lets goo' 9-max (Play Money) Seat #8 is the button
Seat 1: dddocky (2652 in chips) 
Seat 2: Duke Croix (12710 in chips) 
Seat 3: FragileMemory (11285 in chips) 
Seat 4: Manon947 (21548 in chips) 
Seat 5: RichRick1337 (6356 in chips) 
Seat 8: color_singleton (5265 in chips) 
Seat 9: HighCardJasper (19896 in chips) 
HighCardJasper: posts small blind 50
dddocky: posts big blind 100
*** HOLE CARDS ***
Dealt to Duke Croix [Kh Ks]
Duke Croix: raises 300 to 400
FragileMemory: folds 
Manon947: folds 
RichRick1337: calls 400
color_singleton: folds 
HighCardJasper: calls 350
dddocky: calls 300
*** FLOP *** [Jh 7h 3s]
HighCardJasper: checks 
dddocky: bets 100
Duke Croix: raises 400 to 500
RichRick1337: calls 500
HighCardJasper: folds 
dddocky: calls 400
*** TURN *** [Jh 7h 3s] [4d]
dddocky: checks 
Duke Croix: bets 1100
RichRick1337: folds 
dddocky: calls 1100
*** RIVER *** [Jh 7h 3s 4d] [7c]
dddocky: bets 100
Duke Croix: raises 600 to 700
dddocky: calls 552 and is all-in
Uncalled bet (48) returned to Duke Croix
*** SHOW DOWN ***
Duke Croix: shows [Kh Ks] (two pair, Kings and Sevens)
dddocky: shows [Ah Js] (two pair, Jacks and Sevens)
Duke Croix collected 6241 from pot
*** SUMMARY ***
Total pot 6604 | Rake 363 
Board [Jh 7h 3s 4d 7c]
Seat 1: dddocky (big blind) showed [Ah Js] and lost with two pair, Jacks and Sevens
Seat 2: Duke Croix showed [Kh Ks] and won (6241) with two pair, Kings and Sevens
Seat 3: FragileMemory folded before Flop (didn't bet)
Seat 4: Manon947 folded before Flop (didn't bet)
Seat 5: RichRick1337 folded on the Turn
Seat 8: color_singleton (button) folded before Flop (didn't bet)
Seat 9: HighCardJasper (small blind) folded on the Flop



PokerStars Home Game Hand #216249215979: {Club #3225207}  Hold'em No Limit (50/100) - 2020/07/09 16:13:48 ET
Table 'lets goo' 9-max (Play Money) Seat #9 is the button
Seat 2: Duke Croix (16299 in chips) 
Seat 3: FragileMemory (11285 in chips) 
Seat 4: Manon947 (21548 in chips) 
Seat 5: RichRick1337 (5456 in chips) 
Seat 8: color_singleton (5265 in chips) 
Seat 9: HighCardJasper (19496 in chips) 
Duke Croix: posts small blind 50
FragileMemory: posts big blind 100
*** HOLE CARDS ***
Dealt to Duke Croix [2s Kd]
Manon947: calls 100
RichRick1337: calls 100
color_singleton: folds 
HighCardJasper: raises 100 to 200
Duke Croix: folds 
FragileMemory: calls 100
Manon947: calls 100
RichRick1337: calls 100
*** FLOP *** [4h 3c 3d]
FragileMemory: bets 401
Manon947: folds 
RichRick1337: calls 401
HighCardJasper: calls 401
*** TURN *** [4h 3c 3d] [2h]
FragileMemory: bets 970
RichRick1337: calls 970
HighCardJasper: raises 970 to 1940
FragileMemory: raises 970 to 2910
RichRick1337: calls 1940
HighCardJasper: calls 970
*** RIVER *** [4h 3c 3d 2h] [3s]
FragileMemory: bets 7774 and is all-in
RichRick1337: calls 1945 and is all-in
HighCardJasper: folds 
Uncalled bet (5829) returned to FragileMemory
*** SHOW DOWN ***
FragileMemory: shows [5h 4c] (a full house, Threes full of Fours)
RichRick1337: shows [2c 4d] (a full house, Threes full of Fours)
FragileMemory collected 6933 from pot
RichRick1337 collected 6933 from pot
*** SUMMARY ***
Total pot 14673 | Rake 807 
Board [4h 3c 3d 2h 3s]
Seat 2: Duke Croix (small blind) folded before Flop
Seat 3: FragileMemory (big blind) showed [5h 4c] and won (6933) with a full house, Threes full of Fours
Seat 4: Manon947 folded on the Flop
Seat 5: RichRick1337 showed [2c 4d] and won (6933) with a full house, Threes full of Fours
Seat 8: color_singleton folded before Flop (didn't bet)
Seat 9: HighCardJasper (button) folded on the River



PokerStars Home Game Hand #216249282725: {Club #3225207}  Hold'em No Limit (50/100) - 2020/07/09 16:15:25 ET
Table 'lets goo' 9-max (Play Money) Seat #2 is the button
Seat 1: dddocky (10000 in chips) 
Seat 2: Duke Croix (16249 in chips) 
Seat 3: FragileMemory (12762 in chips) 
Seat 4: Manon947 (21348 in chips) 
Seat 5: RichRick1337 (6933 in chips) 
Seat 8: color_singleton (5265 in chips) 
Seat 9: HighCardJasper (15985 in chips) 
FragileMemory: posts small blind 50
Manon947: posts big blind 100
dddocky: posts small blind 50
*** HOLE CARDS ***
Dealt to Duke Croix [4d 8s]
RichRick1337: calls 100
color_singleton: folds 
HighCardJasper: calls 100
dddocky: calls 100
Duke Croix: folds 
FragileMemory: calls 50
Manon947: raises 100 to 200
RichRick1337: raises 100 to 300
HighCardJasper: calls 200
dddocky: calls 200
FragileMemory: folds 
Manon947: calls 100
*** FLOP *** [Qs Kd Kh]
Manon947: checks 
RichRick1337: checks 
HighCardJasper: bets 200
dddocky: folds 
Manon947: calls 200
RichRick1337: folds 
*** TURN *** [Qs Kd Kh] [5c]
Manon947: checks 
HighCardJasper: checks 
*** RIVER *** [Qs Kd Kh 5c] [2s]
Manon947: checks 
HighCardJasper: checks 
*** SHOW DOWN ***
Manon947: shows [2c Ac] (two pair, Kings and Deuces)
HighCardJasper: shows [8c Qh] (two pair, Kings and Queens)
HighCardJasper collected 1654 from pot
*** SUMMARY ***
Total pot 1750 | Rake 96 
Board [Qs Kd Kh 5c 2s]
Seat 1: dddocky folded on the Flop
Seat 2: Duke Croix (button) folded before Flop (didn't bet)
Seat 3: FragileMemory (small blind) folded before Flop
Seat 4: Manon947 (big blind) showed [2c Ac] and lost with two pair, Kings and Deuces
Seat 5: RichRick1337 folded on the Flop
Seat 8: color_singleton folded before Flop (didn't bet)
Seat 9: HighCardJasper showed [8c Qh] and won (1654) with two pair, Kings and Queens



PokerStars Home Game Hand #216249325717: {Club #3225207}  Hold'em No Limit (50/100) - 2020/07/09 16:16:29 ET
Table 'lets goo' 9-max (Play Money) Seat #3 is the button
Seat 1: dddocky (9650 in chips) 
Seat 2: Duke Croix (16249 in chips) 
Seat 3: FragileMemory (12662 in chips) 
Seat 4: Manon947 (20848 in chips) 
Seat 5: RichRick1337 (6633 in chips) 
Seat 8: color_singleton (5265 in chips) 
Seat 9: HighCardJasper (17139 in chips) 
Manon947: posts small blind 50
RichRick1337: posts big blind 100
*** HOLE CARDS ***
Dealt to Duke Croix [8h 4c]
color_singleton: folds 
HighCardJasper: calls 100
dddocky: calls 100
Duke Croix: folds 
FragileMemory: folds 
Manon947: calls 50
RichRick1337: raises 100 to 200
HighCardJasper: calls 100
dddocky: calls 100
Manon947: folds 
*** FLOP *** [7c 6d 2d]
RichRick1337: checks 
HighCardJasper: checks 
dddocky: checks 
*** TURN *** [7c 6d 2d] [Kd]
RichRick1337: checks 
Manon947 is disconnected 
HighCardJasper: checks 
dddocky: checks 
*** RIVER *** [7c 6d 2d Kd] [Kc]
RichRick1337: checks 
HighCardJasper: checks 
dddocky: checks 
*** SHOW DOWN ***
RichRick1337: shows [7h Ts] (two pair, Kings and Sevens)
HighCardJasper: mucks hand 
dddocky: mucks hand 
RichRick1337 collected 661 from pot
*** SUMMARY ***
Total pot 700 | Rake 39 
Board [7c 6d 2d Kd Kc]
Seat 1: dddocky mucked [9c Js]
Seat 2: Duke Croix folded before Flop (didn't bet)
Seat 3: FragileMemory (button) folded before Flop (didn't bet)
Seat 4: Manon947 (small blind) folded before Flop
Seat 5: RichRick1337 (big blind) showed [7h Ts] and won (661) with two pair, Kings and Sevens
Seat 8: color_singleton folded before Flop (didn't bet)
Seat 9: HighCardJasper mucked [Tc 2c]



PokerStars Home Game Hand #216249361400: {Club #3225207}  Hold'em No Limit (50/100) - 2020/07/09 16:17:23 ET
Table 'lets goo' 9-max (Play Money) Seat #4 is the button
Seat 1: dddocky (9450 in chips) 
Seat 2: Duke Croix (16249 in chips) 
Seat 3: FragileMemory (12662 in chips) 
Seat 4: Manon947 (20748 in chips) 
Seat 5: RichRick1337 (7094 in chips) 
Seat 8: color_singleton (5265 in chips) 
Seat 9: HighCardJasper (16939 in chips) 
RichRick1337: posts small blind 50
color_singleton: posts big blind 100
*** HOLE CARDS ***
Dealt to Duke Croix [Jh Js]
HighCardJasper: folds 
dddocky: calls 100
Duke Croix: raises 400 to 500
FragileMemory: calls 500
Manon947 has timed out while disconnected
Manon947: folds 
RichRick1337: calls 450
color_singleton: folds 
dddocky: calls 400
*** FLOP *** [5c 9c 6s]
RichRick1337: checks 
dddocky: checks 
Duke Croix has timed out
Duke Croix: checks 
FragileMemory: bets 992
RichRick1337: calls 992
dddocky: folds 
Duke Croix: calls 992
*** TURN *** [5c 9c 6s] [5h]
RichRick1337: checks 
Duke Croix: bets 2000
FragileMemory: calls 2000
RichRick1337: calls 2000
*** RIVER *** [5c 9c 6s 5h] [8c]
RichRick1337: checks 
Duke Croix: checks 
FragileMemory: bets 9170 and is all-in
RichRick1337: folds 
Duke Croix: folds 
Uncalled bet (9170) returned to FragileMemory
FragileMemory collected 10467 from pot
FragileMemory: doesn't show hand 
*** SUMMARY ***
Total pot 11076 | Rake 609 
Board [5c 9c 6s 5h 8c]
Seat 1: dddocky folded on the Flop
Seat 2: Duke Croix folded on the River
Seat 3: FragileMemory collected (10467)
Seat 4: Manon947 (button) folded before Flop (didn't bet)
Seat 5: RichRick1337 (small blind) folded on the River
Seat 8: color_singleton (big blind) folded before Flop
Seat 9: HighCardJasper folded before Flop (didn't bet)



PokerStars Home Game Hand #216249448794: {Club #3225207}  Hold'em No Limit (50/100) - 2020/07/09 16:19:32 ET
Table 'lets goo' 9-max (Play Money) Seat #5 is the button
Seat 1: dddocky (8950 in chips) 
Seat 2: Duke Croix (12757 in chips) 
Seat 3: FragileMemory (19637 in chips) 
Seat 5: RichRick1337 (3602 in chips) 
Seat 8: color_singleton (5165 in chips) 
Seat 9: HighCardJasper (16939 in chips) 
color_singleton: posts small blind 50
HighCardJasper: posts big blind 100
*** HOLE CARDS ***
Dealt to Duke Croix [As 2d]
dddocky: folds 
Duke Croix: folds 
FragileMemory: calls 100
RichRick1337: raises 100 to 200
color_singleton: calls 150
HighCardJasper: calls 100
FragileMemory: calls 100
*** FLOP *** [7d Jd 3d]
color_singleton: checks 
HighCardJasper: bets 200
FragileMemory: calls 200
RichRick1337: calls 200
color_singleton: calls 200
*** TURN *** [7d Jd 3d] [Qh]
color_singleton: checks 
HighCardJasper: bets 100
FragileMemory: calls 100
RichRick1337: calls 100
color_singleton: raises 200 to 300
HighCardJasper: raises 700 to 1000
FragileMemory: folds 
RichRick1337: folds 
color_singleton: raises 1000 to 2000
HighCardJasper: calls 1000
*** RIVER *** [7d Jd 3d Qh] [Js]
color_singleton: bets 2765 and is all-in
HighCardJasper: calls 2765
*** SHOW DOWN ***
color_singleton: shows [Ad 4d] (a flush, Ace high)
HighCardJasper: shows [Td 8d] (a flush, Jack high)
color_singleton collected 10707 from pot
*** SUMMARY ***
Total pot 11330 | Rake 623 
Board [7d Jd 3d Qh Js]
Seat 1: dddocky folded before Flop (didn't bet)
Seat 2: Duke Croix folded before Flop (didn't bet)
Seat 3: FragileMemory folded on the Turn
Seat 5: RichRick1337 (button) folded on the Turn
Seat 8: color_singleton (small blind) showed [Ad 4d] and won (10707) with a flush, Ace high
Seat 9: HighCardJasper (big blind) showed [Td 8d] and lost with a flush, Jack high



PokerStars Home Game Hand #216249530572: {Club #3225207}  Hold'em No Limit (50/100) - 2020/07/09 16:21:19 ET
Table 'lets goo' 9-max (Play Money) Seat #8 is the button
Seat 1: dddocky (8950 in chips) 
Seat 2: Duke Croix (12757 in chips) 
Seat 3: FragileMemory (19137 in chips) 
Seat 5: RichRick1337 (3102 in chips) 
Seat 8: color_singleton (10707 in chips) 
Seat 9: HighCardJasper (11774 in chips) 
HighCardJasper: posts small blind 50
dddocky: posts big blind 100
*** HOLE CARDS ***
Dealt to Duke Croix [6s As]
Duke Croix: calls 100
FragileMemory: folds 
RichRick1337: raises 100 to 200
color_singleton: folds 
HighCardJasper: calls 150
dddocky: folds 
Duke Croix: calls 100
*** FLOP *** [9c 3h Qh]
HighCardJasper: checks 
Duke Croix: checks 
RichRick1337: bets 100
HighCardJasper: calls 100
Duke Croix: folds 
*** TURN *** [9c 3h Qh] [Ad]
HighCardJasper: checks 
RichRick1337: checks 
*** RIVER *** [9c 3h Qh Ad] [Jc]
HighCardJasper: checks 
RichRick1337: checks 
*** SHOW DOWN ***
HighCardJasper: shows [7c 3d] (a pair of Threes)
RichRick1337: shows [8s 8h] (a pair of Eights)
RichRick1337 collected 850 from pot
*** SUMMARY ***
Total pot 900 | Rake 50 
Board [9c 3h Qh Ad Jc]
Seat 1: dddocky (big blind) folded before Flop
Seat 2: Duke Croix folded on the Flop
Seat 3: FragileMemory folded before Flop (didn't bet)
Seat 5: RichRick1337 showed [8s 8h] and won (850) with a pair of Eights
Seat 8: color_singleton (button) folded before Flop (didn't bet)
Seat 9: HighCardJasper (small blind) showed [7c 3d] and lost with a pair of Threes



PokerStars Home Game Hand #216249568956: {Club #3225207}  Hold'em No Limit (50/100) - 2020/07/09 16:22:15 ET
Table 'lets goo' 9-max (Play Money) Seat #9 is the button
Seat 1: dddocky (8850 in chips) 
Seat 2: Duke Croix (12557 in chips) 
Seat 3: FragileMemory (19137 in chips) 
Seat 5: RichRick1337 (3652 in chips) 
Seat 8: color_singleton (10707 in chips) 
Seat 9: HighCardJasper (11474 in chips) 
dddocky: posts small blind 50
Duke Croix: posts big blind 100
*** HOLE CARDS ***
Dealt to Duke Croix [2s 6s]
FragileMemory: calls 100
RichRick1337: calls 100
color_singleton: folds 
HighCardJasper: calls 100
dddocky: folds 
Duke Croix: checks 
*** FLOP *** [Jh As Th]
Duke Croix: checks 
FragileMemory: checks 
RichRick1337: checks 
HighCardJasper: bets 200
Duke Croix: folds 
FragileMemory: folds 
RichRick1337: folds 
Uncalled bet (200) returned to HighCardJasper
HighCardJasper collected 425 from pot
HighCardJasper: doesn't show hand 
*** SUMMARY ***
Total pot 450 | Rake 25 
Board [Jh As Th]
Seat 1: dddocky (small blind) folded before Flop
Seat 2: Duke Croix (big blind) folded on the Flop
Seat 3: FragileMemory folded on the Flop
Seat 5: RichRick1337 folded on the Flop
Seat 8: color_singleton folded before Flop (didn't bet)
Seat 9: HighCardJasper (button) collected (425)



PokerStars Home Game Hand #216249589467: {Club #3225207}  Hold'em No Limit (50/100) - 2020/07/09 16:22:45 ET
Table 'lets goo' 9-max (Play Money) Seat #1 is the button
Seat 1: dddocky (8800 in chips) 
Seat 2: Duke Croix (12457 in chips) 
Seat 3: FragileMemory (19037 in chips) 
Seat 5: RichRick1337 (3552 in chips) 
Seat 8: color_singleton (10707 in chips) 
Seat 9: HighCardJasper (11799 in chips) 
Duke Croix: posts small blind 50
FragileMemory: posts big blind 100
*** HOLE CARDS ***
Dealt to Duke Croix [8h 6d]
RichRick1337: raises 100 to 200
color_singleton: folds 
HighCardJasper: calls 200
dddocky: calls 200
Duke Croix: folds 
FragileMemory: folds 
*** FLOP *** [6s Th 3h]
RichRick1337: bets 200
HighCardJasper: folds 
dddocky: calls 200
*** TURN *** [6s Th 3h] [Ac]
RichRick1337: checks 
dddocky: checks 
*** RIVER *** [6s Th 3h Ac] [4c]
RichRick1337: checks 
dddocky: checks 
*** SHOW DOWN ***
RichRick1337: shows [Kh Kd] (a pair of Kings)
dddocky: mucks hand 
RichRick1337 collected 1087 from pot
*** SUMMARY ***
Total pot 1150 | Rake 63 
Board [6s Th 3h Ac 4c]
Seat 1: dddocky (button) mucked [8c 8d]
Seat 2: Duke Croix (small blind) folded before Flop
Seat 3: FragileMemory (big blind) folded before Flop
Seat 5: RichRick1337 showed [Kh Kd] and won (1087) with a pair of Kings
Seat 8: color_singleton folded before Flop (didn't bet)
Seat 9: HighCardJasper folded on the Flop



PokerStars Home Game Hand #216249614404: {Club #3225207}  Hold'em No Limit (50/100) - 2020/07/09 16:23:22 ET
Table 'lets goo' 9-max (Play Money) Seat #2 is the button
Seat 1: dddocky (8400 in chips) 
Seat 2: Duke Croix (12407 in chips) 
Seat 3: FragileMemory (18937 in chips) 
Seat 5: RichRick1337 (4239 in chips) 
Seat 8: color_singleton (10707 in chips) 
Seat 9: HighCardJasper (11599 in chips) 
FragileMemory: posts small blind 50
RichRick1337: posts big blind 100
*** HOLE CARDS ***
Dealt to Duke Croix [4s Ad]
color_singleton: folds 
HighCardJasper: calls 100
dddocky: calls 100
Duke Croix: calls 100
FragileMemory: folds 
RichRick1337: checks 
*** FLOP *** [8d Jh 8h]
RichRick1337: checks 
HighCardJasper: bets 100
dddocky: calls 100
Duke Croix: folds 
RichRick1337: calls 100
*** TURN *** [8d Jh 8h] [2s]
RichRick1337: checks 
HighCardJasper: checks 
dddocky: checks 
*** RIVER *** [8d Jh 8h 2s] [3h]
RichRick1337: bets 100
HighCardJasper: folds 
dddocky: raises 909 to 1009
RichRick1337: calls 909
*** SHOW DOWN ***
dddocky: shows [Th 5h] (a flush, Jack high)
RichRick1337: mucks hand 
dddocky collected 2616 from pot
*** SUMMARY ***
Total pot 2768 | Rake 152 
Board [8d Jh 8h 2s 3h]
Seat 1: dddocky showed [Th 5h] and won (2616) with a flush, Jack high
Seat 2: Duke Croix (button) folded on the Flop
Seat 3: FragileMemory (small blind) folded before Flop
Seat 5: RichRick1337 (big blind) mucked [3d 5s]
Seat 8: color_singleton folded before Flop (didn't bet)
Seat 9: HighCardJasper folded on the River



PokerStars Home Game Hand #216249648104: {Club #3225207}  Hold'em No Limit (50/100) - 2020/07/09 16:24:12 ET
Table 'lets goo' 9-max (Play Money) Seat #3 is the button
Seat 1: dddocky (9807 in chips) 
Seat 2: Duke Croix (12307 in chips) 
Seat 3: FragileMemory (18887 in chips) 
Seat 5: RichRick1337 (3030 in chips) 
Seat 8: color_singleton (10707 in chips) 
Seat 9: HighCardJasper (11399 in chips) 
RichRick1337: posts small blind 50
color_singleton: posts big blind 100
*** HOLE CARDS ***
Dealt to Duke Croix [Js Qc]
HighCardJasper: calls 100
dddocky: calls 100
Duke Croix: raises 300 to 400
FragileMemory: folds 
RichRick1337: calls 350
color_singleton: folds 
HighCardJasper: folds 
dddocky: calls 300
*** FLOP *** [Ac 7h Th]
RichRick1337: checks 
dddocky: checks 
Duke Croix: checks 
*** TURN *** [Ac 7h Th] [7s]
RichRick1337: checks 
dddocky: checks 
Duke Croix: bets 700
RichRick1337: folds 
dddocky: folds 
Uncalled bet (700) returned to Duke Croix
Duke Croix collected 1323 from pot
*** SUMMARY ***
Total pot 1400 | Rake 77 
Board [Ac 7h Th 7s]
Seat 1: dddocky folded on the Turn
Seat 2: Duke Croix collected (1323)
Seat 3: FragileMemory (button) folded before Flop (didn't bet)
Seat 5: RichRick1337 (small blind) folded on the Turn
Seat 8: color_singleton (big blind) folded before Flop
Seat 9: HighCardJasper folded before Flop



PokerStars Home Game Hand #216249675124: {Club #3225207}  Hold'em No Limit (50/100) - 2020/07/09 16:24:52 ET
Table 'lets goo' 9-max (Play Money) Seat #5 is the button
Seat 1: dddocky (9407 in chips) 
Seat 2: Duke Croix (13230 in chips) 
Seat 3: FragileMemory (18887 in chips) 
Seat 5: RichRick1337 (2630 in chips) 
Seat 8: color_singleton (10607 in chips) 
Seat 9: HighCardJasper (11299 in chips) 
color_singleton: posts small blind 50
HighCardJasper: posts big blind 100
*** HOLE CARDS ***
Dealt to Duke Croix [4d 7c]
dddocky: folds 
Duke Croix: folds 
FragileMemory: calls 100
RichRick1337: calls 100
color_singleton: calls 50
HighCardJasper: checks 
*** FLOP *** [Th Ks 5c]
color_singleton: checks 
HighCardJasper: bets 200
FragileMemory: folds 
RichRick1337: folds 
color_singleton: calls 200
*** TURN *** [Th Ks 5c] [Qs]
color_singleton: checks 
HighCardJasper: bets 300
color_singleton: calls 300
*** RIVER *** [Th Ks 5c Qs] [7d]
color_singleton: checks 
HighCardJasper: checks 
*** SHOW DOWN ***
color_singleton: shows [9h Ts] (a pair of Tens)
HighCardJasper: shows [Kh 3d] (a pair of Kings)
HighCardJasper collected 1323 from pot
*** SUMMARY ***
Total pot 1400 | Rake 77 
Board [Th Ks 5c Qs 7d]
Seat 1: dddocky folded before Flop (didn't bet)
Seat 2: Duke Croix folded before Flop (didn't bet)
Seat 3: FragileMemory folded on the Flop
Seat 5: RichRick1337 (button) folded on the Flop
Seat 8: color_singleton (small blind) showed [9h Ts] and lost with a pair of Tens
Seat 9: HighCardJasper (big blind) showed [Kh 3d] and won (1323) with a pair of Kings



PokerStars Home Game Hand #216249720276: {Club #3225207}  Hold'em No Limit (50/100) - 2020/07/09 16:25:59 ET
Table 'lets goo' 9-max (Play Money) Seat #8 is the button
Seat 1: dddocky (9407 in chips) 
Seat 2: Duke Croix (13230 in chips) 
Seat 3: FragileMemory (18787 in chips) 
Seat 5: RichRick1337 (2530 in chips) 
Seat 8: color_singleton (10007 in chips) 
Seat 9: HighCardJasper (12022 in chips) 
HighCardJasper: posts small blind 50
dddocky: posts big blind 100
*** HOLE CARDS ***
Dealt to Duke Croix [Tc 4c]
Duke Croix: folds 
FragileMemory: folds 
RichRick1337: calls 100
color_singleton: folds 
HighCardJasper: calls 50
dddocky: checks 
*** FLOP *** [5d 9c As]
HighCardJasper: checks 
dddocky: bets 100
RichRick1337: folds 
HighCardJasper: calls 100
*** TURN *** [5d 9c As] [7d]
HighCardJasper: checks 
dddocky: bets 100
HighCardJasper: folds 
Uncalled bet (100) returned to dddocky
dddocky collected 472 from pot
dddocky: doesn't show hand 
*** SUMMARY ***
Total pot 500 | Rake 28 
Board [5d 9c As 7d]
Seat 1: dddocky (big blind) collected (472)
Seat 2: Duke Croix folded before Flop (didn't bet)
Seat 3: FragileMemory folded before Flop (didn't bet)
Seat 5: RichRick1337 folded on the Flop
Seat 8: color_singleton (button) folded before Flop (didn't bet)
Seat 9: HighCardJasper (small blind) folded on the Turn



PokerStars Home Game Hand #216249742619: {Club #3225207}  Hold'em No Limit (50/100) - 2020/07/09 16:26:32 ET
Table 'lets goo' 9-max (Play Money) Seat #9 is the button
Seat 1: dddocky (9679 in chips) 
Seat 2: Duke Croix (13230 in chips) 
Seat 5: RichRick1337 (2430 in chips) 
Seat 8: color_singleton (10007 in chips) 
Seat 9: HighCardJasper (11822 in chips) 
dddocky: posts small blind 50
Duke Croix: posts big blind 100
*** HOLE CARDS ***
Dealt to Duke Croix [6h 7d]
RichRick1337: calls 100
color_singleton: raises 200 to 300
HighCardJasper: calls 300
dddocky: calls 250
Duke Croix: calls 200
RichRick1337: calls 200
*** FLOP *** [9c 9s 8d]
dddocky: bets 100
Duke Croix: raises 600 to 700
RichRick1337: folds 
color_singleton: folds 
Manon947 was removed from the table for failing to post
Manon947 leaves the table
HighCardJasper: folds 
dddocky: folds 
Uncalled bet (600) returned to Duke Croix
Duke Croix collected 1606 from pot
*** SUMMARY ***
Total pot 1700 | Rake 94 
Board [9c 9s 8d]
Seat 1: dddocky (small blind) folded on the Flop
Seat 2: Duke Croix (big blind) collected (1606)
Seat 5: RichRick1337 folded on the Flop
Seat 8: color_singleton folded on the Flop
Seat 9: HighCardJasper (button) folded on the Flop



PokerStars Home Game Hand #216249775202: {Club #3225207}  Hold'em No Limit (50/100) - 2020/07/09 16:27:20 ET
Table 'lets goo' 9-max (Play Money) Seat #1 is the button
Seat 1: dddocky (9279 in chips) 
Seat 2: Duke Croix (14436 in chips) 
Seat 5: RichRick1337 (2130 in chips) 
Seat 8: color_singleton (9707 in chips) 
Seat 9: HighCardJasper (11522 in chips) 
Duke Croix: posts small blind 50
RichRick1337: posts big blind 100
*** HOLE CARDS ***
Dealt to Duke Croix [5h As]
color_singleton: folds 
HighCardJasper: calls 100
dddocky: folds 
Duke Croix: calls 50
RichRick1337: raises 100 to 200
HighCardJasper: calls 100
Duke Croix: calls 100
*** FLOP *** [8c Ks 4s]
Duke Croix: checks 
RichRick1337: checks 
HighCardJasper: checks 
*** TURN *** [8c Ks 4s] [4c]
Duke Croix: checks 
RichRick1337: bets 100
HighCardJasper: folds 
Duke Croix: folds 
Uncalled bet (100) returned to RichRick1337
RichRick1337 collected 567 from pot
RichRick1337: doesn't show hand 
*** SUMMARY ***
Total pot 600 | Rake 33 
Board [8c Ks 4s 4c]
Seat 1: dddocky (button) folded before Flop (didn't bet)
Seat 2: Duke Croix (small blind) folded on the Turn
Seat 5: RichRick1337 (big blind) collected (567)
Seat 8: color_singleton folded before Flop (didn't bet)
Seat 9: HighCardJasper folded on the Turn



PokerStars Home Game Hand #216249800911: {Club #3225207}  Hold'em No Limit (50/100) - 2020/07/09 16:27:58 ET
Table 'lets goo' 9-max (Play Money) Seat #2 is the button
Seat 1: dddocky (9279 in chips) 
Seat 2: Duke Croix (14236 in chips) 
Seat 5: RichRick1337 (2497 in chips) 
Seat 8: color_singleton (9707 in chips) 
Seat 9: HighCardJasper (11322 in chips) 
RichRick1337: posts small blind 50
color_singleton: posts big blind 100
*** HOLE CARDS ***
Dealt to Duke Croix [Jh 5d]
HighCardJasper: calls 100
dddocky: folds 
Duke Croix: folds 
RichRick1337: raises 400 to 500
color_singleton: folds 
HighCardJasper: folds 
Uncalled bet (400) returned to RichRick1337
RichRick1337 collected 300 from pot
RichRick1337: doesn't show hand 
*** SUMMARY ***
Total pot 300 | Rake 0 
Seat 1: dddocky folded before Flop (didn't bet)
Seat 2: Duke Croix (button) folded before Flop (didn't bet)
Seat 5: RichRick1337 (small blind) collected (300)
Seat 8: color_singleton (big blind) folded before Flop
Seat 9: HighCardJasper folded before Flop



PokerStars Home Game Hand #216249808745: {Club #3225207}  Hold'em No Limit (50/100) - 2020/07/09 16:28:09 ET
Table 'lets goo' 9-max (Play Money) Seat #5 is the button
Seat 1: dddocky (9279 in chips) 
Seat 2: Duke Croix (14236 in chips) 
Seat 5: RichRick1337 (2697 in chips) 
Seat 8: color_singleton (9607 in chips) 
Seat 9: HighCardJasper (11222 in chips) 
color_singleton: posts small blind 50
HighCardJasper: posts big blind 100
*** HOLE CARDS ***
Dealt to Duke Croix [3d Kh]
dddocky: calls 100
Duke Croix: folds 
RichRick1337: raises 300 to 400
color_singleton: folds 
HighCardJasper: folds 
dddocky: calls 300
*** FLOP *** [2s Js 3c]
dddocky: checks 
RichRick1337: checks 
*** TURN *** [2s Js 3c] [6s]
dddocky: checks 
RichRick1337: checks 
*** RIVER *** [2s Js 3c 6s] [5d]
dddocky: checks 
RichRick1337: checks 
*** SHOW DOWN ***
dddocky: shows [7h Ad] (high card Ace)
RichRick1337: shows [6d Ah] (a pair of Sixes)
RichRick1337 collected 898 from pot
*** SUMMARY ***
Total pot 950 | Rake 52 
Board [2s Js 3c 6s 5d]
Seat 1: dddocky showed [7h Ad] and lost with high card Ace
Seat 2: Duke Croix folded before Flop (didn't bet)
Seat 5: RichRick1337 (button) showed [6d Ah] and won (898) with a pair of Sixes
Seat 8: color_singleton (small blind) folded before Flop
Seat 9: HighCardJasper (big blind) folded before Flop



PokerStars Home Game Hand #216249823356: {Club #3225207}  Hold'em No Limit (50/100) - 2020/07/09 16:28:31 ET
Table 'lets goo' 9-max (Play Money) Seat #8 is the button
Seat 1: dddocky (8879 in chips) 
Seat 2: Duke Croix (14236 in chips) 
Seat 5: RichRick1337 (3195 in chips) 
Seat 8: color_singleton (9557 in chips) 
Seat 9: HighCardJasper (11122 in chips) 
HighCardJasper: posts small blind 50
dddocky: posts big blind 100
*** HOLE CARDS ***
Dealt to Duke Croix [9h 2h]
Duke Croix: folds 
RichRick1337: calls 100
color_singleton: raises 200 to 300
HighCardJasper: calls 250
dddocky: folds 
RichRick1337: calls 200
*** FLOP *** [9d 2s As]
HighCardJasper: checks 
RichRick1337: checks 
color_singleton: bets 472
HighCardJasper: folds 
RichRick1337: calls 472
*** TURN *** [9d 2s As] [2d]
RichRick1337: checks 
color_singleton: checks 
*** RIVER *** [9d 2s As 2d] [Tc]
RichRick1337: checks 
color_singleton: checks 
*** SHOW DOWN ***
RichRick1337: shows [Kd 5s] (a pair of Deuces)
color_singleton: shows [8h Ah] (two pair, Aces and Deuces)
color_singleton collected 1837 from pot
*** SUMMARY ***
Total pot 1944 | Rake 107 
Board [9d 2s As 2d Tc]
Seat 1: dddocky (big blind) folded before Flop
Seat 2: Duke Croix folded before Flop (didn't bet)
Seat 5: RichRick1337 showed [Kd 5s] and lost with a pair of Deuces
Seat 8: color_singleton (button) showed [8h Ah] and won (1837) with two pair, Aces and Deuces
Seat 9: HighCardJasper (small blind) folded on the Flop



PokerStars Home Game Hand #216249857331: {Club #3225207}  Hold'em No Limit (50/100) - 2020/07/09 16:29:22 ET
Table 'lets goo' 9-max (Play Money) Seat #9 is the button
Seat 1: dddocky (8779 in chips) 
Seat 2: Duke Croix (14236 in chips) 
Seat 5: RichRick1337 (2423 in chips) 
Seat 8: color_singleton (10622 in chips) 
Seat 9: HighCardJasper (10822 in chips) 
dddocky: posts small blind 50
Duke Croix: posts big blind 100
*** HOLE CARDS ***
Dealt to Duke Croix [5c Kh]
RichRick1337: raises 300 to 400
color_singleton: folds 
HighCardJasper: calls 400
dddocky: folds 
Duke Croix: calls 300
*** FLOP *** [Td 4c 9h]
Duke Croix: checks 
RichRick1337: checks 
HighCardJasper: checks 
*** TURN *** [Td 4c 9h] [5d]
Duke Croix: bets 600
RichRick1337: folds 
HighCardJasper: folds 
Uncalled bet (600) returned to Duke Croix
Duke Croix collected 1181 from pot
*** SUMMARY ***
Total pot 1250 | Rake 69 
Board [Td 4c 9h 5d]
Seat 1: dddocky (small blind) folded before Flop
Seat 2: Duke Croix (big blind) collected (1181)
Seat 5: RichRick1337 folded on the Turn
Seat 8: color_singleton folded before Flop (didn't bet)
Seat 9: HighCardJasper (button) folded on the Turn



PokerStars Home Game Hand #216249877308: {Club #3225207}  Hold'em No Limit (50/100) - 2020/07/09 16:29:52 ET
Table 'lets goo' 9-max (Play Money) Seat #1 is the button
Seat 1: dddocky (8729 in chips) 
Seat 2: Duke Croix (15017 in chips) 
Seat 3: FragileMemory (18787 in chips) 
Seat 5: RichRick1337 (2023 in chips) 
Seat 8: color_singleton (10622 in chips) 
Seat 9: HighCardJasper (10422 in chips) 
Duke Croix: posts small blind 50
FragileMemory: posts big blind 100
*** HOLE CARDS ***
Dealt to Duke Croix [Ts 9d]
RichRick1337: calls 100
color_singleton: folds 
HighCardJasper: raises 200 to 300
dddocky: folds 
Duke Croix: folds 
FragileMemory: calls 200
RichRick1337: calls 200
*** FLOP *** [2h 2c Td]
FragileMemory: bets 449
RichRick1337: folds 
HighCardJasper: folds 
Uncalled bet (449) returned to FragileMemory
FragileMemory collected 898 from pot
FragileMemory: doesn't show hand 
*** SUMMARY ***
Total pot 950 | Rake 52 
Board [2h 2c Td]
Seat 1: dddocky (button) folded before Flop (didn't bet)
Seat 2: Duke Croix (small blind) folded before Flop
Seat 3: FragileMemory (big blind) collected (898)
Seat 5: RichRick1337 folded on the Flop
Seat 8: color_singleton folded before Flop (didn't bet)
Seat 9: HighCardJasper folded on the Flop



PokerStars Home Game Hand #216249899536: {Club #3225207}  Hold'em No Limit (50/100) - 2020/07/09 16:30:25 ET
Table 'lets goo' 9-max (Play Money) Seat #2 is the button
Seat 1: dddocky (8729 in chips) 
Seat 2: Duke Croix (14967 in chips) 
Seat 3: FragileMemory (19385 in chips) 
Seat 5: RichRick1337 (1723 in chips) 
Seat 8: color_singleton (10622 in chips) 
Seat 9: HighCardJasper (10122 in chips) 
FragileMemory: posts small blind 50
RichRick1337: posts big blind 100
*** HOLE CARDS ***
Dealt to Duke Croix [Th 7s]
color_singleton: raises 200 to 300
HighCardJasper: calls 300
dddocky: folds 
Duke Croix: folds 
FragileMemory: folds 
RichRick1337: calls 200
*** FLOP *** [6h 5s Ac]
RichRick1337: checks 
color_singleton: checks 
HighCardJasper: checks 
*** TURN *** [6h 5s Ac] [Jd]
RichRick1337: checks 
color_singleton: bets 200
HighCardJasper: folds 
RichRick1337: folds 
Uncalled bet (200) returned to color_singleton
color_singleton collected 898 from pot
color_singleton: doesn't show hand 
*** SUMMARY ***
Total pot 950 | Rake 52 
Board [6h 5s Ac Jd]
Seat 1: dddocky folded before Flop (didn't bet)
Seat 2: Duke Croix (button) folded before Flop (didn't bet)
Seat 3: FragileMemory (small blind) folded before Flop
Seat 5: RichRick1337 (big blind) folded on the Turn
Seat 8: color_singleton collected (898)
Seat 9: HighCardJasper folded on the Turn



PokerStars Home Game Hand #216249928614: {Club #3225207}  Hold'em No Limit (50/100) - 2020/07/09 16:31:08 ET
Table 'lets goo' 9-max (Play Money) Seat #3 is the button
Seat 1: dddocky (8729 in chips) 
Seat 2: Duke Croix (14967 in chips) 
Seat 3: FragileMemory (19335 in chips) 
Seat 5: RichRick1337 (1423 in chips) 
Seat 8: color_singleton (11220 in chips) 
Seat 9: HighCardJasper (9822 in chips) 
RichRick1337: posts small blind 50
color_singleton: posts big blind 100
*** HOLE CARDS ***
Dealt to Duke Croix [9d 8h]
HighCardJasper: folds 
dddocky: calls 100
Duke Croix: calls 100
FragileMemory: calls 100
RichRick1337: calls 50
color_singleton: checks 
*** FLOP *** [2d 7d Th]
RichRick1337: checks 
color_singleton: bets 472
dddocky: folds 
Duke Croix: calls 472
FragileMemory: folds 
RichRick1337: folds 
*** TURN *** [2d 7d Th] [5c]
color_singleton: bets 1365
Duke Croix: calls 1365
*** RIVER *** [2d 7d Th 5c] [6h]
color_singleton: checks 
Duke Croix: bets 2000
color_singleton: calls 2000
*** SHOW DOWN ***
Duke Croix: shows [9d 8h] (a straight, Six to Ten)
color_singleton: mucks hand 
Duke Croix collected 7724 from pot
*** SUMMARY ***
Total pot 8174 | Rake 450 
Board [2d 7d Th 5c 6h]
Seat 1: dddocky folded on the Flop
Seat 2: Duke Croix showed [9d 8h] and won (7724) with a straight, Six to Ten
Seat 3: FragileMemory (button) folded on the Flop
Seat 5: RichRick1337 (small blind) folded on the Flop
Seat 8: color_singleton (big blind) mucked [Ts 8s]
Seat 9: HighCardJasper folded before Flop (didn't bet)



PokerStars Home Game Hand #216249959692: {Club #3225207}  Hold'em No Limit (50/100) - 2020/07/09 16:31:54 ET
Table 'lets goo' 9-max (Play Money) Seat #5 is the button
Seat 1: dddocky (8629 in chips) 
Seat 2: Duke Croix (18754 in chips) 
Seat 3: FragileMemory (19235 in chips) 
Seat 5: RichRick1337 (1323 in chips) 
Seat 8: color_singleton (7283 in chips) 
Seat 9: HighCardJasper (9822 in chips) 
color_singleton: posts small blind 50
HighCardJasper: posts big blind 100
*** HOLE CARDS ***
Dealt to Duke Croix [5h 9h]
dddocky: calls 100
Duke Croix: folds 
FragileMemory: folds 
RichRick1337: calls 100
color_singleton: raises 100 to 200
HighCardJasper: raises 100 to 300
dddocky: calls 200
RichRick1337: calls 200
color_singleton: calls 100
*** FLOP *** [2h 4c 5s]
color_singleton: checks 
HighCardJasper: bets 200
dddocky: folds 
RichRick1337: folds 
color_singleton: calls 200
*** TURN *** [2h 4c 5s] [9d]
color_singleton: checks 
HighCardJasper: bets 300
color_singleton: folds 
Uncalled bet (300) returned to HighCardJasper
HighCardJasper collected 1512 from pot
HighCardJasper: doesn't show hand 
*** SUMMARY ***
Total pot 1600 | Rake 88 
Board [2h 4c 5s 9d]
Seat 1: dddocky folded on the Flop
Seat 2: Duke Croix folded before Flop (didn't bet)
Seat 3: FragileMemory folded before Flop (didn't bet)
Seat 5: RichRick1337 (button) folded on the Flop
Seat 8: color_singleton (small blind) folded on the Turn
Seat 9: HighCardJasper (big blind) collected (1512)



PokerStars Home Game Hand #216249989793: {Club #3225207}  Hold'em No Limit (50/100) - 2020/07/09 16:32:39 ET
Table 'lets goo' 9-max (Play Money) Seat #8 is the button
Seat 1: dddocky (8329 in chips) 
Seat 2: Duke Croix (18754 in chips) 
Seat 3: FragileMemory (19235 in chips) 
Seat 5: RichRick1337 (1023 in chips) 
Seat 8: color_singleton (6783 in chips) 
Seat 9: HighCardJasper (10834 in chips) 
HighCardJasper: posts small blind 50
dddocky: posts big blind 100
*** HOLE CARDS ***
Dealt to Duke Croix [3d Kh]
Duke Croix: folds 
FragileMemory: calls 100
RichRick1337: calls 100
color_singleton: folds 
HighCardJasper: raises 100 to 200
dddocky: calls 100
FragileMemory: calls 100
RichRick1337: calls 100
*** FLOP *** [9d As 9c]
HighCardJasper: bets 200
dddocky: calls 200
FragileMemory: folds 
RichRick1337: folds 
*** TURN *** [9d As 9c] [7s]
HighCardJasper: checks 
dddocky: checks 
*** RIVER *** [9d As 9c 7s] [Ah]
HighCardJasper: bets 400
dddocky: raises 400 to 800
HighCardJasper: folds 
Uncalled bet (400) returned to dddocky
dddocky collected 1890 from pot
dddocky: doesn't show hand 
*** SUMMARY ***
Total pot 2000 | Rake 110 
Board [9d As 9c 7s Ah]
Seat 1: dddocky (big blind) collected (1890)
Seat 2: Duke Croix folded before Flop (didn't bet)
Seat 3: FragileMemory folded on the Flop
Seat 5: RichRick1337 folded on the Flop
Seat 8: color_singleton (button) folded before Flop (didn't bet)
Seat 9: HighCardJasper (small blind) folded on the River



PokerStars Home Game Hand #216250024211: {Club #3225207}  Hold'em No Limit (50/100) - 2020/07/09 16:33:31 ET
Table 'lets goo' 9-max (Play Money) Seat #9 is the button
Seat 1: dddocky (9419 in chips) 
Seat 2: Duke Croix (18754 in chips) 
Seat 3: FragileMemory (19035 in chips) 
Seat 5: RichRick1337 (823 in chips) 
Seat 8: color_singleton (6783 in chips) 
Seat 9: HighCardJasper (10034 in chips) 
dddocky: posts small blind 50
Duke Croix: posts big blind 100
*** HOLE CARDS ***
Dealt to Duke Croix [2h 7h]
FragileMemory: calls 100
RichRick1337: calls 100
color_singleton: folds 
HighCardJasper: raises 200 to 300
dddocky: calls 250
Duke Croix: folds 
FragileMemory: folds 
RichRick1337: calls 200
*** FLOP *** [8h Kc Ts]
dddocky: checks 
RichRick1337: checks 
HighCardJasper: bets 300
dddocky: folds 
RichRick1337: folds 
Uncalled bet (300) returned to HighCardJasper
HighCardJasper collected 1039 from pot
HighCardJasper: doesn't show hand 
*** SUMMARY ***
Total pot 1100 | Rake 61 
Board [8h Kc Ts]
Seat 1: dddocky (small blind) folded on the Flop
Seat 2: Duke Croix (big blind) folded before Flop
Seat 3: FragileMemory folded before Flop
Seat 5: RichRick1337 folded on the Flop
Seat 8: color_singleton folded before Flop (didn't bet)
Seat 9: HighCardJasper (button) collected (1039)



PokerStars Home Game Hand #216250051974: {Club #3225207}  Hold'em No Limit (50/100) - 2020/07/09 16:34:12 ET
Table 'lets goo' 9-max (Play Money) Seat #1 is the button
Seat 1: dddocky (9119 in chips) 
Seat 2: Duke Croix (18654 in chips) 
Seat 3: FragileMemory (18935 in chips) 
Seat 5: RichRick1337 (523 in chips) 
Seat 8: color_singleton (6783 in chips) 
Seat 9: HighCardJasper (10773 in chips) 
Duke Croix: posts small blind 50
FragileMemory: posts big blind 100
*** HOLE CARDS ***
Dealt to Duke Croix [2c 5c]
RichRick1337: calls 100
color_singleton has timed out
color_singleton: folds 
HighCardJasper: calls 100
dddocky: calls 100
Duke Croix: calls 50
FragileMemory: checks 
*** FLOP *** [Ad Qd 7s]
Duke Croix: checks 
FragileMemory: bets 236
RichRick1337: folds 
HighCardJasper: folds 
dddocky: calls 236
Duke Croix: folds 
*** TURN *** [Ad Qd 7s] [8h]
FragileMemory: bets 459
dddocky: calls 459
*** RIVER *** [Ad Qd 7s 8h] [Qs]
FragileMemory: bets 1786
dddocky: raises 1786 to 3572
FragileMemory: raises 1786 to 5358
dddocky: raises 1786 to 7144
FragileMemory: raises 10996 to 18140 and is all-in
dddocky: calls 1180 and is all-in
Uncalled bet (9816) returned to FragileMemory
*** SHOW DOWN ***
FragileMemory: shows [3d Qc] (three of a kind, Queens)
dddocky: shows [Ah Ac] (a full house, Aces full of Queens)
dddocky collected 17518 from pot
*** SUMMARY ***
Total pot 18538 | Rake 1020 
Board [Ad Qd 7s 8h Qs]
Seat 1: dddocky (button) showed [Ah Ac] and won (17518) with a full house, Aces full of Queens
Seat 2: Duke Croix (small blind) folded on the Flop
Seat 3: FragileMemory (big blind) showed [3d Qc] and lost with three of a kind, Queens
Seat 5: RichRick1337 folded on the Flop
Seat 8: color_singleton folded before Flop (didn't bet)
Seat 9: HighCardJasper folded on the Flop



PokerStars Home Game Hand #216250111150: {Club #3225207}  Hold'em No Limit (50/100) - 2020/07/09 16:35:41 ET
Table 'lets goo' 9-max (Play Money) Seat #2 is the button
Seat 1: dddocky (17518 in chips) 
Seat 2: Duke Croix (18554 in chips) 
Seat 3: FragileMemory (9816 in chips) 
Seat 5: RichRick1337 (423 in chips) 
Seat 8: color_singleton (6783 in chips) 
Seat 9: HighCardJasper (10673 in chips) 
FragileMemory: posts small blind 50
RichRick1337: posts big blind 100
*** HOLE CARDS ***
Dealt to Duke Croix [5s Ks]
color_singleton: folds 
HighCardJasper: calls 100
dddocky: calls 100
Duke Croix: folds 
FragileMemory: folds 
RichRick1337: checks 
*** FLOP *** [Qs 2c 4d]
RichRick1337: checks 
HighCardJasper: bets 200
dddocky: calls 200
RichRick1337: folds 
*** TURN *** [Qs 2c 4d] [As]
HighCardJasper: bets 200
dddocky: calls 200
*** RIVER *** [Qs 2c 4d As] [7d]
HighCardJasper: checks 
dddocky: checks 
*** SHOW DOWN ***
HighCardJasper: shows [Qd Th] (a pair of Queens)
dddocky: mucks hand 
HighCardJasper collected 1087 from pot
*** SUMMARY ***
Total pot 1150 | Rake 63 
Board [Qs 2c 4d As 7d]
Seat 1: dddocky mucked [8h Qc]
Seat 2: Duke Croix (button) folded before Flop (didn't bet)
Seat 3: FragileMemory (small blind) folded before Flop
Seat 5: RichRick1337 (big blind) folded on the Flop
Seat 8: color_singleton folded before Flop (didn't bet)
Seat 9: HighCardJasper showed [Qd Th] and won (1087) with a pair of Queens



PokerStars Home Game Hand #216250150300: {Club #3225207}  Hold'em No Limit (50/100) - 2020/07/09 16:36:40 ET
Table 'lets goo' 9-max (Play Money) Seat #3 is the button
Seat 1: dddocky (17018 in chips) 
Seat 2: Duke Croix (18554 in chips) 
Seat 3: FragileMemory (9766 in chips) 
Seat 5: RichRick1337 (323 in chips) 
Seat 8: color_singleton (6783 in chips) 
Seat 9: HighCardJasper (11260 in chips) 
RichRick1337: posts small blind 50
color_singleton: posts big blind 100
*** HOLE CARDS ***
Dealt to Duke Croix [Ah Ts]
HighCardJasper: raises 100 to 200
dddocky: folds 
Duke Croix: raises 300 to 500
FragileMemory: folds 
RichRick1337: calls 273 and is all-in
color_singleton: folds 
HighCardJasper: calls 300
*** FLOP *** [6c 4s Qd]
HighCardJasper: bets 300
Duke Croix: folds 
Uncalled bet (300) returned to HighCardJasper
*** TURN *** [6c 4s Qd] [9d]
*** RIVER *** [6c 4s Qd 9d] [9c]
*** SHOW DOWN ***
HighCardJasper: shows [6s Qs] (two pair, Queens and Nines)
HighCardJasper collected 335 from side pot
RichRick1337: shows [6d 7d] (two pair, Nines and Sixes)
HighCardJasper collected 1010 from main pot
*** SUMMARY ***
Total pot 1423 Main pot 1010. Side pot 335. | Rake 78 
Board [6c 4s Qd 9d 9c]
Seat 1: dddocky folded before Flop (didn't bet)
Seat 2: Duke Croix folded on the Flop
Seat 3: FragileMemory (button) folded before Flop (didn't bet)
Seat 5: RichRick1337 (small blind) showed [6d 7d] and lost with two pair, Nines and Sixes
Seat 8: color_singleton (big blind) folded before Flop
Seat 9: HighCardJasper showed [6s Qs] and won (1345) with two pair, Queens and Nines



PokerStars Home Game Hand #216250178001: {Club #3225207}  Hold'em No Limit (50/100) - 2020/07/09 16:37:22 ET
Table 'lets goo' 9-max (Play Money) Seat #8 is the button
Seat 1: dddocky (17018 in chips) 
Seat 2: Duke Croix (18054 in chips) 
Seat 3: FragileMemory (9766 in chips) 
Seat 8: color_singleton (6683 in chips) 
Seat 9: HighCardJasper (12105 in chips) 
HighCardJasper: posts small blind 50
dddocky: posts big blind 100
*** HOLE CARDS ***
Dealt to Duke Croix [6c 8s]
Duke Croix: folds 
FragileMemory: calls 100
color_singleton: folds 
HighCardJasper: raises 100 to 200
dddocky: calls 100
FragileMemory: calls 100
*** FLOP *** [4c Th 7d]
HighCardJasper: bets 300
dddocky: calls 300
FragileMemory: raises 733 to 1033
HighCardJasper: folds 
dddocky: folds 
Uncalled bet (733) returned to FragileMemory
FragileMemory collected 1417 from pot
FragileMemory: doesn't show hand 
*** SUMMARY ***
Total pot 1500 | Rake 83 
Board [4c Th 7d]
Seat 1: dddocky (big blind) folded on the Flop
Seat 2: Duke Croix folded before Flop (didn't bet)
Seat 3: FragileMemory collected (1417)
Seat 8: color_singleton (button) folded before Flop (didn't bet)
Seat 9: HighCardJasper (small blind) folded on the Flop



PokerStars Home Game Hand #216250201392: {Club #3225207}  Hold'em No Limit (50/100) - 2020/07/09 16:37:57 ET
Table 'lets goo' 9-max (Play Money) Seat #9 is the button
Seat 1: dddocky (16518 in chips) 
Seat 2: Duke Croix (18054 in chips) 
Seat 3: FragileMemory (10683 in chips) 
Seat 8: color_singleton (6683 in chips) 
Seat 9: HighCardJasper (11605 in chips) 
dddocky: posts small blind 50
Duke Croix: posts big blind 100
*** HOLE CARDS ***
Dealt to Duke Croix [2c Ks]
FragileMemory: folds 
color_singleton: calls 100
HighCardJasper: raises 200 to 300
dddocky: calls 250
Duke Croix: folds 
color_singleton: calls 200
*** FLOP *** [5c 9d 7d]
dddocky: checks 
color_singleton: bets 472
HighCardJasper: calls 472
dddocky: calls 472
*** TURN *** [5c 9d 7d] [5d]
dddocky: checks 
color_singleton: checks 
HighCardJasper: checks 
*** RIVER *** [5c 9d 7d 5d] [Th]
dddocky: checks 
color_singleton: checks 
HighCardJasper: bets 1000
dddocky: calls 1000
color_singleton: folds 
*** SHOW DOWN ***
HighCardJasper: shows [Ad As] (two pair, Aces and Fives)
dddocky: mucks hand 
HighCardJasper collected 4173 from pot
*** SUMMARY ***
Total pot 4416 | Rake 243 
Board [5c 9d 7d 5d Th]
Seat 1: dddocky (small blind) mucked [Qh Td]
Seat 2: Duke Croix (big blind) folded before Flop
Seat 3: FragileMemory folded before Flop (didn't bet)
Seat 8: color_singleton folded on the River
Seat 9: HighCardJasper (button) showed [Ad As] and won (4173) with two pair, Aces and Fives



PokerStars Home Game Hand #216250246038: {Club #3225207}  Hold'em No Limit (50/100) - 2020/07/09 16:39:04 ET
Table 'lets goo' 9-max (Play Money) Seat #1 is the button
Seat 1: dddocky (14746 in chips) 
Seat 2: Duke Croix (17954 in chips) 
Seat 3: FragileMemory (10683 in chips) 
Seat 8: color_singleton (5911 in chips) 
Seat 9: HighCardJasper (14006 in chips) 
Duke Croix: posts small blind 50
FragileMemory: posts big blind 100
*** HOLE CARDS ***
Dealt to Duke Croix [7d Jd]
color_singleton: folds 
HighCardJasper: calls 100
dddocky: folds 
Duke Croix: calls 50
FragileMemory: checks 
*** FLOP *** [3s 8c 9h]
Duke Croix: checks 
FragileMemory: checks 
HighCardJasper: checks 
*** TURN *** [3s 8c 9h] [Ac]
Duke Croix: checks 
FragileMemory: checks 
HighCardJasper: checks 
*** RIVER *** [3s 8c 9h Ac] [5c]
Duke Croix: checks 
FragileMemory: checks 
HighCardJasper: checks 
*** SHOW DOWN ***
Duke Croix: shows [7d Jd] (high card Ace)
FragileMemory: mucks hand 
HighCardJasper: shows [3h 7c] (a pair of Threes)
HighCardJasper collected 283 from pot
*** SUMMARY ***
Total pot 300 | Rake 17 
Board [3s 8c 9h Ac 5c]
Seat 1: dddocky (button) folded before Flop (didn't bet)
Seat 2: Duke Croix (small blind) showed [7d Jd] and lost with high card Ace
Seat 3: FragileMemory (big blind) mucked [6h 4s]
Seat 8: color_singleton folded before Flop (didn't bet)
Seat 9: HighCardJasper showed [3h 7c] and won (283) with a pair of Threes



PokerStars Home Game Hand #216250279362: {Club #3225207}  Hold'em No Limit (50/100) - 2020/07/09 16:39:54 ET
Table 'lets goo' 9-max (Play Money) Seat #2 is the button
Seat 2: Duke Croix (17854 in chips) 
Seat 3: FragileMemory (10583 in chips) 
Seat 8: color_singleton (5911 in chips) 
Seat 9: HighCardJasper (14189 in chips) 
FragileMemory: posts small blind 50
color_singleton: posts big blind 100
*** HOLE CARDS ***
Dealt to Duke Croix [Kd 3c]
HighCardJasper: calls 100
Duke Croix: folds 
FragileMemory: folds 
color_singleton: checks 
*** FLOP *** [9c Kc Jh]
color_singleton: checks 
HighCardJasper: checks 
*** TURN *** [9c Kc Jh] [4s]
color_singleton: checks 
HighCardJasper: checks 
*** RIVER *** [9c Kc Jh 4s] [Ah]
color_singleton: checks 
HighCardJasper: checks 
*** SHOW DOWN ***
color_singleton: shows [6c Ts] (high card Ace)
HighCardJasper: mucks hand 
color_singleton collected 236 from pot
*** SUMMARY ***
Total pot 250 | Rake 14 
Board [9c Kc Jh 4s Ah]
Seat 2: Duke Croix (button) folded before Flop (didn't bet)
Seat 3: FragileMemory (small blind) folded before Flop
Seat 8: color_singleton (big blind) showed [6c Ts] and won (236) with high card Ace
Seat 9: HighCardJasper mucked [5d 8c]



PokerStars Home Game Hand #216250296789: {Club #3225207}  Hold'em No Limit (50/100) - 2020/07/09 16:40:20 ET
Table 'lets goo' 9-max (Play Money) Seat #3 is the button
Seat 2: Duke Croix (17854 in chips) 
Seat 3: FragileMemory (10533 in chips) 
Seat 8: color_singleton (6047 in chips) 
Seat 9: HighCardJasper (14089 in chips) 
color_singleton: posts small blind 50
HighCardJasper: posts big blind 100
*** HOLE CARDS ***
Dealt to Duke Croix [2s 7s]
Duke Croix: folds 
FragileMemory: folds 
color_singleton: calls 50
HighCardJasper: checks 
*** FLOP *** [9h Qc 7d]
color_singleton: checks 
HighCardJasper: checks 
*** TURN *** [9h Qc 7d] [Jc]
color_singleton: bets 100
HighCardJasper: folds 
Uncalled bet (100) returned to color_singleton
color_singleton collected 189 from pot
color_singleton: doesn't show hand 
*** SUMMARY ***
Total pot 200 | Rake 11 
Board [9h Qc 7d Jc]
Seat 2: Duke Croix folded before Flop (didn't bet)
Seat 3: FragileMemory (button) folded before Flop (didn't bet)
Seat 8: color_singleton (small blind) collected (189)
Seat 9: HighCardJasper (big blind) folded on the Turn



PokerStars Home Game Hand #216250316726: {Club #3225207}  Hold'em No Limit (50/100) - 2020/07/09 16:40:51 ET
Table 'lets goo' 9-max (Play Money) Seat #8 is the button
Seat 2: Duke Croix (17854 in chips) 
Seat 3: FragileMemory (10533 in chips) 
Seat 8: color_singleton (6136 in chips) 
Seat 9: HighCardJasper (13989 in chips) 
HighCardJasper: posts small blind 50
Duke Croix: posts big blind 100
*** HOLE CARDS ***
Dealt to Duke Croix [9s Jd]
FragileMemory: calls 100
color_singleton: folds 
HighCardJasper: calls 50
Duke Croix: checks 
*** FLOP *** [2s Kc 8h]
HighCardJasper: checks 
Duke Croix: checks 
FragileMemory: bets 141
HighCardJasper: calls 141
Duke Croix: folds 
*** TURN *** [2s Kc 8h] [6d]
HighCardJasper: checks 
FragileMemory: bets 275
HighCardJasper: calls 275
*** RIVER *** [2s Kc 8h 6d] [Td]
HighCardJasper: checks 
FragileMemory: bets 535
HighCardJasper: calls 535
*** SHOW DOWN ***
FragileMemory: shows [9d Ks] (a pair of Kings)
HighCardJasper: shows [6c 2h] (two pair, Sixes and Deuces)
HighCardJasper collected 2081 from pot
*** SUMMARY ***
Total pot 2202 | Rake 121 
Board [2s Kc 8h 6d Td]
Seat 2: Duke Croix (big blind) folded on the Flop
Seat 3: FragileMemory showed [9d Ks] and lost with a pair of Kings
Seat 8: color_singleton (button) folded before Flop (didn't bet)
Seat 9: HighCardJasper (small blind) showed [6c 2h] and won (2081) with two pair, Sixes and Deuces



PokerStars Home Game Hand #216250352044: {Club #3225207}  Hold'em No Limit (50/100) - 2020/07/09 16:41:40 ET
Table 'lets goo' 9-max (Play Money) Seat #9 is the button
Seat 2: Duke Croix (17754 in chips) 
Seat 3: FragileMemory (9482 in chips) 
Seat 8: color_singleton (6136 in chips) 
Seat 9: HighCardJasper (15019 in chips) 
Duke Croix: posts small blind 50
FragileMemory: posts big blind 100
*** HOLE CARDS ***
Dealt to Duke Croix [9s 8c]
color_singleton: folds 
HighCardJasper: calls 100
Duke Croix: calls 50
FragileMemory: checks 
*** FLOP *** [3s 2d Th]
Duke Croix: checks 
FragileMemory: bets 100
HighCardJasper: raises 100 to 200
Duke Croix: folds 
FragileMemory: calls 100
*** TURN *** [3s 2d Th] [3c]
FragileMemory: bets 330
HighCardJasper: folds 
Uncalled bet (330) returned to FragileMemory
FragileMemory collected 661 from pot
FragileMemory: doesn't show hand 
*** SUMMARY ***
Total pot 700 | Rake 39 
Board [3s 2d Th 3c]
Seat 2: Duke Croix (small blind) folded on the Flop
Seat 3: FragileMemory (big blind) collected (661)
Seat 8: color_singleton folded before Flop (didn't bet)
Seat 9: HighCardJasper (button) folded on the Turn



PokerStars Home Game Hand #216250388339: {Club #3225207}  Hold'em No Limit (50/100) - 2020/07/09 16:42:35 ET
Table 'lets goo' 9-max (Play Money) Seat #2 is the button
Seat 1: dddocky (14746 in chips) 
Seat 2: Duke Croix (17654 in chips) 
Seat 3: FragileMemory (9843 in chips) 
Seat 8: color_singleton (6136 in chips) 
Seat 9: HighCardJasper (14719 in chips) 
FragileMemory: posts small blind 50
color_singleton: posts big blind 100
dddocky: posts small & big blinds 150
*** HOLE CARDS ***
Dealt to Duke Croix [5c Kd]
HighCardJasper: calls 100
dddocky: checks 
Duke Croix: calls 100
FragileMemory: calls 50
color_singleton: checks 
*** FLOP *** [3h Kh 7s]
FragileMemory: checks 
color_singleton: checks 
HighCardJasper: checks 
dddocky: checks 
Duke Croix: bets 400
FragileMemory: folds 
color_singleton: calls 400
HighCardJasper: folds 
dddocky: folds 
*** TURN *** [3h Kh 7s] [6h]
color_singleton: checks 
Duke Croix: checks 
*** RIVER *** [3h Kh 7s 6h] [Th]
color_singleton: bets 638
Duke Croix: folds 
Uncalled bet (638) returned to color_singleton
color_singleton collected 1276 from pot
color_singleton: doesn't show hand 
*** SUMMARY ***
Total pot 1350 | Rake 74 
Board [3h Kh 7s 6h Th]
Seat 1: dddocky folded on the Flop (didn't bet)
Seat 2: Duke Croix (button) folded on the River
Seat 3: FragileMemory (small blind) folded on the Flop
Seat 8: color_singleton (big blind) collected (1276)
Seat 9: HighCardJasper folded on the Flop



PokerStars Home Game Hand #216250436478: {Club #3225207}  Hold'em No Limit (50/100) - 2020/07/09 16:43:48 ET
Table 'lets goo' 9-max (Play Money) Seat #3 is the button
Seat 1: dddocky (14596 in chips) 
Seat 2: Duke Croix (17154 in chips) 
Seat 3: FragileMemory (9743 in chips) 
Seat 8: color_singleton (6912 in chips) 
Seat 9: HighCardJasper (14619 in chips) 
color_singleton: posts small blind 50
HighCardJasper: posts big blind 100
*** HOLE CARDS ***
Dealt to Duke Croix [9h Kh]
dddocky: calls 100
Duke Croix: calls 100
FragileMemory: folds 
color_singleton: calls 50
HighCardJasper: checks 
*** FLOP *** [Jc Kd Jh]
color_singleton: checks 
HighCardJasper: checks 
dddocky: checks 
Duke Croix: bets 300
color_singleton: folds 
HighCardJasper: folds 
dddocky: calls 300
*** TURN *** [Jc Kd Jh] [6h]
dddocky: checks 
Duke Croix: bets 500
dddocky: calls 500
*** RIVER *** [Jc Kd Jh 6h] [Ad]
dddocky: bets 1890
Duke Croix: folds 
Uncalled bet (1890) returned to dddocky
dddocky collected 1890 from pot
dddocky: doesn't show hand 
*** SUMMARY ***
Total pot 2000 | Rake 110 
Board [Jc Kd Jh 6h Ad]
Seat 1: dddocky collected (1890)
Seat 2: Duke Croix folded on the River
Seat 3: FragileMemory (button) folded before Flop (didn't bet)
Seat 8: color_singleton (small blind) folded on the Flop
Seat 9: HighCardJasper (big blind) folded on the Flop



PokerStars Home Game Hand #216250476136: {Club #3225207}  Hold'em No Limit (50/100) - 2020/07/09 16:44:48 ET
Table 'lets goo' 9-max (Play Money) Seat #8 is the button
Seat 1: dddocky (15586 in chips) 
Seat 2: Duke Croix (16254 in chips) 
Seat 3: FragileMemory (9743 in chips) 
Seat 8: color_singleton (6812 in chips) 
Seat 9: HighCardJasper (14519 in chips) 
HighCardJasper: posts small blind 50
dddocky: posts big blind 100
*** HOLE CARDS ***
Dealt to Duke Croix [Tc Ah]
Duke Croix: raises 200 to 300
FragileMemory: folds 
color_singleton: folds 
HighCardJasper: folds 
dddocky: calls 200
*** FLOP *** [Kh Ad 7d]
dddocky: checks 
Duke Croix: bets 400
dddocky: folds 
Uncalled bet (400) returned to Duke Croix
Duke Croix collected 614 from pot
*** SUMMARY ***
Total pot 650 | Rake 36 
Board [Kh Ad 7d]
Seat 1: dddocky (big blind) folded on the Flop
Seat 2: Duke Croix collected (614)
Seat 3: FragileMemory folded before Flop (didn't bet)
Seat 8: color_singleton (button) folded before Flop (didn't bet)
Seat 9: HighCardJasper (small blind) folded before Flop



PokerStars Home Game Hand #216250490817: {Club #3225207}  Hold'em No Limit (50/100) - 2020/07/09 16:45:10 ET
Table 'lets goo' 9-max (Play Money) Seat #9 is the button
Seat 1: dddocky (15286 in chips) 
Seat 2: Duke Croix (16568 in chips) 
Seat 3: FragileMemory (9743 in chips) 
Seat 8: color_singleton (6812 in chips) 
Seat 9: HighCardJasper (14469 in chips) 
dddocky: posts small blind 50
Duke Croix: posts big blind 100
*** HOLE CARDS ***
Dealt to Duke Croix [8s Ah]
FragileMemory: calls 100
color_singleton: raises 100 to 200
HighCardJasper: calls 200
dddocky: folds 
Duke Croix: calls 100
FragileMemory: calls 100
*** FLOP *** [Qd 7s 4h]
Duke Croix: checks 
FragileMemory: bets 401
color_singleton: folds 
HighCardJasper: folds 
Duke Croix: folds 
Uncalled bet (401) returned to FragileMemory
FragileMemory collected 803 from pot
FragileMemory: doesn't show hand 
*** SUMMARY ***
Total pot 850 | Rake 47 
Board [Qd 7s 4h]
Seat 1: dddocky (small blind) folded before Flop
Seat 2: Duke Croix (big blind) folded on the Flop
Seat 3: FragileMemory collected (803)
Seat 8: color_singleton folded on the Flop
Seat 9: HighCardJasper (button) folded on the Flop



PokerStars Home Game Hand #216250524266: {Club #3225207}  Hold'em No Limit (50/100) - 2020/07/09 16:46:00 ET
Table 'lets goo' 9-max (Play Money) Seat #1 is the button
Seat 1: dddocky (15236 in chips) 
Seat 2: Duke Croix (16368 in chips) 
Seat 3: FragileMemory (10346 in chips) 
Seat 8: color_singleton (6612 in chips) 
Seat 9: HighCardJasper (14269 in chips) 
Duke Croix: posts small blind 50
FragileMemory: posts big blind 100
*** HOLE CARDS ***
Dealt to Duke Croix [7h 9d]
color_singleton: folds 
HighCardJasper: calls 100
dddocky: calls 100
Duke Croix: calls 50
FragileMemory: checks 
*** FLOP *** [Td Ts 6s]
Duke Croix: checks 
FragileMemory: bets 189
HighCardJasper: calls 189
dddocky: folds 
Duke Croix: calls 189
*** TURN *** [Td Ts 6s] [Jc]
Duke Croix: checks 
FragileMemory: bets 457
HighCardJasper: folds 
Duke Croix: folds 
Uncalled bet (457) returned to FragileMemory
FragileMemory collected 914 from pot
FragileMemory: doesn't show hand 
*** SUMMARY ***
Total pot 967 | Rake 53 
Board [Td Ts 6s Jc]
Seat 1: dddocky (button) folded on the Flop
Seat 2: Duke Croix (small blind) folded on the Turn
Seat 3: FragileMemory (big blind) collected (914)
Seat 8: color_singleton folded before Flop (didn't bet)
Seat 9: HighCardJasper folded on the Turn



PokerStars Home Game Hand #216250554443: {Club #3225207}  Hold'em No Limit (50/100) - 2020/07/09 16:46:45 ET
Table 'lets goo' 9-max (Play Money) Seat #2 is the button
Seat 1: dddocky (15136 in chips) 
Seat 2: Duke Croix (16079 in chips) 
Seat 3: FragileMemory (10971 in chips) 
Seat 8: color_singleton (6612 in chips) 
Seat 9: HighCardJasper (13980 in chips) 
FragileMemory: posts small blind 50
color_singleton: posts big blind 100
*** HOLE CARDS ***
Dealt to Duke Croix [5d 8d]
HighCardJasper: raises 100 to 200
dddocky: folds 
Duke Croix: calls 200
FragileMemory: calls 150
color_singleton: calls 100
*** FLOP *** [3d Tc Js]
FragileMemory: bets 378
color_singleton: calls 378
HighCardJasper: folds 
Duke Croix: folds 
*** TURN *** [3d Tc Js] [8c]
FragileMemory: bets 735
color_singleton: calls 735
*** RIVER *** [3d Tc Js 8c] [7c]
FragileMemory: checks 
color_singleton: checks 
*** SHOW DOWN ***
FragileMemory: shows [Ah Jd] (a pair of Jacks)
color_singleton: shows [9c Qh] (a straight, Eight to Queen)
color_singleton collected 2860 from pot
*** SUMMARY ***
Total pot 3026 | Rake 166 
Board [3d Tc Js 8c 7c]
Seat 1: dddocky folded before Flop (didn't bet)
Seat 2: Duke Croix (button) folded on the Flop
Seat 3: FragileMemory (small blind) showed [Ah Jd] and lost with a pair of Jacks
Seat 8: color_singleton (big blind) showed [9c Qh] and won (2860) with a straight, Eight to Queen
Seat 9: HighCardJasper folded on the Flop



PokerStars Home Game Hand #216250581618: {Club #3225207}  Hold'em No Limit (50/100) - 2020/07/09 16:47:26 ET
Table 'lets goo' 9-max (Play Money) Seat #3 is the button
Seat 1: dddocky (15136 in chips) 
Seat 2: Duke Croix (15879 in chips) 
Seat 3: FragileMemory (9658 in chips) 
Seat 8: color_singleton (8159 in chips) 
Seat 9: HighCardJasper (13780 in chips) 
color_singleton: posts small blind 50
HighCardJasper: posts big blind 100
*** HOLE CARDS ***
Dealt to Duke Croix [Ks 9d]
dddocky: calls 100
Duke Croix: calls 100
FragileMemory: calls 100
color_singleton: raises 100 to 200
HighCardJasper: calls 100
dddocky: calls 100
Duke Croix: calls 100
FragileMemory: calls 100
*** FLOP *** [5d 6h 9h]
color_singleton: checks 
HighCardJasper: checks 
dddocky: checks 
Duke Croix: bets 500
FragileMemory: calls 500
color_singleton: folds 
HighCardJasper: folds 
dddocky: folds 
*** TURN *** [5d 6h 9h] [3c]
Duke Croix: bets 1000
FragileMemory: folds 
Uncalled bet (1000) returned to Duke Croix
Duke Croix collected 1890 from pot
*** SUMMARY ***
Total pot 2000 | Rake 110 
Board [5d 6h 9h 3c]
Seat 1: dddocky folded on the Flop
Seat 2: Duke Croix collected (1890)
Seat 3: FragileMemory (button) folded on the Turn
Seat 8: color_singleton (small blind) folded on the Flop
Seat 9: HighCardJasper (big blind) folded on the Flop



PokerStars Home Game Hand #216250623290: {Club #3225207}  Hold'em No Limit (50/100) - 2020/07/09 16:48:29 ET
Table 'lets goo' 9-max (Play Money) Seat #8 is the button
Seat 1: dddocky (14936 in chips) 
Seat 2: Duke Croix (17069 in chips) 
Seat 3: FragileMemory (8958 in chips) 
Seat 8: color_singleton (7959 in chips) 
Seat 9: HighCardJasper (13580 in chips) 
HighCardJasper: posts small blind 50
dddocky: posts big blind 100
*** HOLE CARDS ***
Dealt to Duke Croix [5d Ac]
Duke Croix: calls 100
FragileMemory: folds 
color_singleton: calls 100
HighCardJasper: raises 200 to 300
dddocky: calls 200
Duke Croix: calls 200
color_singleton: calls 200
*** FLOP *** [9s Kc 5c]
HighCardJasper: checks 
dddocky: checks 
Duke Croix: checks 
color_singleton: checks 
*** TURN *** [9s Kc 5c] [5s]
HighCardJasper: checks 
dddocky: bets 100
Duke Croix: raises 600 to 700
color_singleton: folds 
HighCardJasper: folds 
dddocky: calls 600
*** RIVER *** [9s Kc 5c 5s] [8d]
dddocky: checks 
Duke Croix said, "5"
Duke Croix: bets 1500
dddocky: calls 1500
*** SHOW DOWN ***
Duke Croix: shows [5d Ac] (three of a kind, Fives)
dddocky: mucks hand 
Duke Croix collected 5292 from pot
*** SUMMARY ***
Total pot 5600 | Rake 308 
Board [9s Kc 5c 5s 8d]
Seat 1: dddocky (big blind) mucked [9c Kh]
Seat 2: Duke Croix showed [5d Ac] and won (5292) with three of a kind, Fives
Seat 3: FragileMemory folded before Flop (didn't bet)
Seat 8: color_singleton (button) folded on the Turn
Seat 9: HighCardJasper (small blind) folded on the Turn



PokerStars Home Game Hand #216250662876: {Club #3225207}  Hold'em No Limit (50/100) - 2020/07/09 16:49:28 ET
Table 'lets goo' 9-max (Play Money) Seat #9 is the button
Seat 1: dddocky (12436 in chips) 
Seat 2: Duke Croix (19861 in chips) 
Seat 3: FragileMemory (8958 in chips) 
Seat 8: color_singleton (7659 in chips) 
Seat 9: HighCardJasper (13280 in chips) 
dddocky: posts small blind 50
Duke Croix: posts big blind 100
*** HOLE CARDS ***
Dealt to Duke Croix [2h Qh]
FragileMemory: folds 
color_singleton: folds 
HighCardJasper: calls 100
dddocky: calls 50
Duke Croix: checks 
*** FLOP *** [Qc 5s 7d]
dddocky: checks 
Duke Croix: bets 300
HighCardJasper: folds 
dddocky: calls 300
*** TURN *** [Qc 5s 7d] [9h]
dddocky: checks 
Duke Croix: bets 500
dddocky: calls 500
*** RIVER *** [Qc 5s 7d 9h] [5h]
dddocky: bets 1795
Duke Croix: folds 
Uncalled bet (1795) returned to dddocky
dddocky collected 1795 from pot
*** SUMMARY ***
Total pot 1900 | Rake 105 
Board [Qc 5s 7d 9h 5h]
Seat 1: dddocky (small blind) collected (1795)
Seat 2: Duke Croix (big blind) folded on the River
Seat 3: FragileMemory folded before Flop (didn't bet)
Seat 8: color_singleton folded before Flop (didn't bet)
Seat 9: HighCardJasper (button) folded on the Flop



PokerStars Home Game Hand #216250703568: {Club #3225207}  Hold'em No Limit (50/100) - 2020/07/09 16:50:26 ET
Table 'lets goo' 9-max (Play Money) Seat #1 is the button
Seat 1: dddocky (13331 in chips) 
Seat 2: Duke Croix (18961 in chips) 
Seat 3: FragileMemory (8958 in chips) 
Seat 8: color_singleton (7659 in chips) 
Seat 9: HighCardJasper (13180 in chips) 
Duke Croix: posts small blind 50
FragileMemory: posts big blind 100
*** HOLE CARDS ***
Dealt to Duke Croix [Qc Ad]
color_singleton: raises 100 to 200
HighCardJasper has timed out
HighCardJasper: folds 
dddocky: folds 
Duke Croix: raises 400 to 600
FragileMemory: folds 
color_singleton: calls 400
*** FLOP *** [Kh 6h 5c]
Duke Croix: checks 
color_singleton: checks 
*** TURN *** [Kh 6h 5c] [Tc]
Duke Croix: checks 
color_singleton: checks 
*** RIVER *** [Kh 6h 5c Tc] [Jh]
Duke Croix: bets 900
color_singleton: folds 
Uncalled bet (900) returned to Duke Croix
Duke Croix collected 1228 from pot
*** SUMMARY ***
Total pot 1300 | Rake 72 
Board [Kh 6h 5c Tc Jh]
Seat 1: dddocky (button) folded before Flop (didn't bet)
Seat 2: Duke Croix (small blind) collected (1228)
Seat 3: FragileMemory (big blind) folded before Flop
Seat 8: color_singleton folded on the River
Seat 9: HighCardJasper folded before Flop (didn't bet)



PokerStars Home Game Hand #216250738602: {Club #3225207}  Hold'em No Limit (50/100) - 2020/07/09 16:51:19 ET
Table 'lets goo' 9-max (Play Money) Seat #2 is the button
Seat 1: dddocky (13331 in chips) 
Seat 2: Duke Croix (19589 in chips) 
Seat 3: FragileMemory (8858 in chips) 
Seat 8: color_singleton (7059 in chips) 
FragileMemory: posts small blind 50
color_singleton: posts big blind 100
*** HOLE CARDS ***
Dealt to Duke Croix [7d 4d]
dddocky: calls 100
Duke Croix: calls 100
FragileMemory: calls 50
color_singleton: checks 
*** FLOP *** [Jh Kh 6c]
FragileMemory: checks 
color_singleton: checks 
dddocky: checks 
Duke Croix: checks 
*** TURN *** [Jh Kh 6c] [7h]
FragileMemory: checks 
color_singleton: checks 
dddocky: checks 
Duke Croix: checks 
*** RIVER *** [Jh Kh 6c 7h] [5h]
FragileMemory: bets 189
color_singleton: calls 189
dddocky: calls 189
Duke Croix: folds 
*** SHOW DOWN ***
FragileMemory: shows [8s Ah] (a flush, Ace high)
color_singleton: mucks hand 
dddocky: mucks hand 
FragileMemory collected 914 from pot
*** SUMMARY ***
Total pot 967 | Rake 53 
Board [Jh Kh 6c 7h 5h]
Seat 1: dddocky mucked [9s Ad]
Seat 2: Duke Croix (button) folded on the River
Seat 3: FragileMemory (small blind) showed [8s Ah] and won (914) with a flush, Ace high
Seat 8: color_singleton (big blind) mucked [8d 4s]



PokerStars Home Game Hand #216250764469: {Club #3225207}  Hold'em No Limit (50/100) - 2020/07/09 16:51:59 ET
Table 'lets goo' 9-max (Play Money) Seat #3 is the button
Seat 1: dddocky (13042 in chips) 
Seat 2: Duke Croix (19489 in chips) 
Seat 3: FragileMemory (9483 in chips) 
Seat 8: color_singleton (6770 in chips) 
color_singleton: posts small blind 50
dddocky: posts big blind 100
*** HOLE CARDS ***
Dealt to Duke Croix [4c Js]
Duke Croix: folds 
FragileMemory: calls 100
color_singleton: folds 
dddocky: checks 
*** FLOP *** [4h Td 3h]
dddocky: checks 
FragileMemory: checks 
*** TURN *** [4h Td 3h] [7s]
dddocky: checks 
FragileMemory: checks 
*** RIVER *** [4h Td 3h 7s] [6d]
dddocky: bets 100
FragileMemory: calls 100
*** SHOW DOWN ***
dddocky: shows [6h 4s] (two pair, Sixes and Fours)
FragileMemory: mucks hand 
dddocky collected 425 from pot
*** SUMMARY ***
Total pot 450 | Rake 25 
Board [4h Td 3h 7s 6d]
Seat 1: dddocky (big blind) showed [6h 4s] and won (425) with two pair, Sixes and Fours
Seat 2: Duke Croix folded before Flop (didn't bet)
Seat 3: FragileMemory (button) mucked [9s Ks]
Seat 8: color_singleton (small blind) folded before Flop



PokerStars Home Game Hand #216250781164: {Club #3225207}  Hold'em No Limit (50/100) - 2020/07/09 16:52:25 ET
Table 'lets goo' 9-max (Play Money) Seat #8 is the button
Seat 1: dddocky (13267 in chips) 
Seat 2: Duke Croix (19489 in chips) 
Seat 3: FragileMemory (9283 in chips) 
Seat 5: RichRick1337 (10000 in chips) 
Seat 8: color_singleton (6720 in chips) 
dddocky: posts small blind 50
Duke Croix: posts big blind 100
RichRick1337: posts small & big blinds 150
*** HOLE CARDS ***
Dealt to Duke Croix [Jd 9s]
FragileMemory: calls 100
RichRick1337: checks 
color_singleton: folds 
dddocky: calls 50
Duke Croix: raises 300 to 400
FragileMemory: folds 
RichRick1337: calls 300
dddocky: calls 300
*** FLOP *** [5s As 4c]
dddocky: checks 
Duke Croix: checks 
RichRick1337: checks 
*** TURN *** [5s As 4c] [6d]
dddocky: checks 
Duke Croix: checks 
RichRick1337: checks 
*** RIVER *** [5s As 4c 6d] [7c]
dddocky: checks 
Duke Croix: checks 
RichRick1337: bets 500
dddocky: folds 
Duke Croix: folds 
Uncalled bet (500) returned to RichRick1337
RichRick1337 collected 1276 from pot
RichRick1337: doesn't show hand 
*** SUMMARY ***
Total pot 1350 | Rake 74 
Board [5s As 4c 6d 7c]
Seat 1: dddocky (small blind) folded on the River
Seat 2: Duke Croix (big blind) folded on the River
Seat 3: FragileMemory folded before Flop
Seat 5: RichRick1337 collected (1276)
Seat 8: color_singleton (button) folded before Flop (didn't bet)



PokerStars Home Game Hand #216250812348: {Club #3225207}  Hold'em No Limit (50/100) - 2020/07/09 16:53:13 ET
Table 'lets goo' 9-max (Play Money) Seat #1 is the button
Seat 1: dddocky (12867 in chips) 
Seat 2: Duke Croix (19089 in chips) 
Seat 3: FragileMemory (9183 in chips) 
Seat 5: RichRick1337 (10826 in chips) 
Seat 8: color_singleton (6720 in chips) 
Duke Croix: posts small blind 50
FragileMemory: posts big blind 100
*** HOLE CARDS ***
Dealt to Duke Croix [Jh Ah]
RichRick1337: calls 100
color_singleton: folds 
dddocky: folds 
Duke Croix: raises 300 to 400
FragileMemory: calls 300
RichRick1337: calls 300
*** FLOP *** [Ad 9h 9d]
Duke Croix: bets 800
FragileMemory: raises 1367 to 2167
RichRick1337: folds 
Duke Croix: calls 1367
*** TURN *** [Ad 9h 9d] [Jd]
Duke Croix: bets 16522 and is all-in
FragileMemory: calls 6616 and is all-in
Uncalled bet (9906) returned to Duke Croix
*** RIVER *** [Ad 9h 9d Jd] [Td]
*** SHOW DOWN ***
Duke Croix: shows [Jh Ah] (two pair, Aces and Jacks)
FragileMemory: shows [7d As] (a flush, Ace high)
FragileMemory collected 17734 from pot
*** SUMMARY ***
Total pot 18766 | Rake 1032 
Board [Ad 9h 9d Jd Td]
Seat 1: dddocky (button) folded before Flop (didn't bet)
Seat 2: Duke Croix (small blind) showed [Jh Ah] and lost with two pair, Aces and Jacks
Seat 3: FragileMemory (big blind) showed [7d As] and won (17734) with a flush, Ace high
Seat 5: RichRick1337 folded on the Flop
Seat 8: color_singleton folded before Flop (didn't bet)



PokerStars Home Game Hand #216250848392: {Club #3225207}  Hold'em No Limit (50/100) - 2020/07/09 16:54:08 ET
Table 'lets goo' 9-max (Play Money) Seat #2 is the button
Seat 1: dddocky (12867 in chips) 
Seat 2: Duke Croix (9906 in chips) 
Seat 3: FragileMemory (17734 in chips) 
Seat 5: RichRick1337 (10426 in chips) 
Seat 8: color_singleton (6720 in chips) 
Seat 9: HighCardJasper (13180 in chips) 
FragileMemory: posts small blind 50
RichRick1337: posts big blind 100
HighCardJasper: posts small & big blinds 150
*** HOLE CARDS ***
Dealt to Duke Croix [3c 5c]
color_singleton: folds 
HighCardJasper: checks 
dddocky: calls 100
Duke Croix: calls 100
FragileMemory: calls 50
RichRick1337: checks 
*** FLOP *** [Ad Ac 9h]
FragileMemory: checks 
RichRick1337: bets 900
HighCardJasper: folds 
dddocky: folds 
Duke Croix: folds 
FragileMemory: calls 900
*** TURN *** [Ad Ac 9h] [Kd]
FragileMemory: checks 
RichRick1337: bets 500
FragileMemory: raises 500 to 1000
RichRick1337: calls 500
*** RIVER *** [Ad Ac 9h Kd] [5s]
FragileMemory: bets 2055
RichRick1337: calls 2055
*** SHOW DOWN ***
FragileMemory: shows [Ks Ah] (a full house, Aces full of Kings)
RichRick1337: mucks hand 
FragileMemory collected 7995 from pot
*** SUMMARY ***
Total pot 8460 | Rake 465 
Board [Ad Ac 9h Kd 5s]
Seat 1: dddocky folded on the Flop
Seat 2: Duke Croix (button) folded on the Flop
Seat 3: FragileMemory (small blind) showed [Ks Ah] and won (7995) with a full house, Aces full of Kings
Seat 5: RichRick1337 (big blind) mucked [4h 9s]
Seat 8: color_singleton folded before Flop (didn't bet)
Seat 9: HighCardJasper folded on the Flop (didn't bet)



PokerStars Home Game Hand #216250887997: {Club #3225207}  Hold'em No Limit (50/100) - 2020/07/09 16:55:13 ET
Table 'lets goo' 9-max (Play Money) Seat #3 is the button
Seat 1: dddocky (12767 in chips) 
Seat 2: Duke Croix (9806 in chips) 
Seat 3: FragileMemory (21674 in chips) 
Seat 5: RichRick1337 (6371 in chips) 
Seat 8: color_singleton (6720 in chips) 
Seat 9: HighCardJasper (13030 in chips) 
RichRick1337: posts small blind 50
color_singleton: posts big blind 100
*** HOLE CARDS ***
Dealt to Duke Croix [9d 7s]
HighCardJasper: calls 100
dddocky: calls 100
Duke Croix: folds 
FragileMemory: folds 
RichRick1337: calls 50
color_singleton: checks 
*** FLOP *** [Tc 7d 4h]
RichRick1337: checks 
color_singleton: checks 
HighCardJasper: bets 100
dddocky: calls 100
RichRick1337: calls 100
color_singleton: calls 100
*** TURN *** [Tc 7d 4h] [Js]
RichRick1337: bets 400
color_singleton: folds 
HighCardJasper: calls 400
dddocky: folds 
*** RIVER *** [Tc 7d 4h Js] [3c]
RichRick1337: bets 800
HighCardJasper: calls 800
*** SHOW DOWN ***
RichRick1337: shows [4c Jc] (two pair, Jacks and Fours)
HighCardJasper: mucks hand 
RichRick1337 collected 3024 from pot
*** SUMMARY ***
Total pot 3200 | Rake 176 
Board [Tc 7d 4h Js 3c]
Seat 1: dddocky folded on the Turn
Seat 2: Duke Croix folded before Flop (didn't bet)
Seat 3: FragileMemory (button) folded before Flop (didn't bet)
Seat 5: RichRick1337 (small blind) showed [4c Jc] and won (3024) with two pair, Jacks and Fours
Seat 8: color_singleton (big blind) folded on the Turn
Seat 9: HighCardJasper mucked [8h Jd]



PokerStars Home Game Hand #216250918685: {Club #3225207}  Hold'em No Limit (50/100) - 2020/07/09 16:56:17 ET
Table 'lets goo' 9-max (Play Money) Seat #5 is the button
Seat 1: dddocky (12567 in chips) 
Seat 2: Duke Croix (9806 in chips) 
Seat 3: FragileMemory (21674 in chips) 
Seat 5: RichRick1337 (7995 in chips) 
Seat 8: color_singleton (6520 in chips) 
Seat 9: HighCardJasper (11630 in chips) 
color_singleton: posts small blind 50
HighCardJasper: posts big blind 100
*** HOLE CARDS ***
Dealt to Duke Croix [Td 2h]
dddocky: folds 
Duke Croix: folds 
FragileMemory: folds 
RichRick1337: calls 100
color_singleton: calls 50
HighCardJasper: checks 
*** FLOP *** [Ac 4h 7s]
color_singleton: checks 
HighCardJasper: checks 
RichRick1337: bets 600
color_singleton: folds 
HighCardJasper: folds 
Uncalled bet (600) returned to RichRick1337
RichRick1337 collected 283 from pot
RichRick1337: doesn't show hand 
*** SUMMARY ***
Total pot 300 | Rake 17 
Board [Ac 4h 7s]
Seat 1: dddocky folded before Flop (didn't bet)
Seat 2: Duke Croix folded before Flop (didn't bet)
Seat 3: FragileMemory folded before Flop (didn't bet)
Seat 5: RichRick1337 (button) collected (283)
Seat 8: color_singleton (small blind) folded on the Flop
Seat 9: HighCardJasper (big blind) folded on the Flop



PokerStars Home Game Hand #216250931150: {Club #3225207}  Hold'em No Limit (50/100) - 2020/07/09 16:56:42 ET
Table 'lets goo' 9-max (Play Money) Seat #8 is the button
Seat 1: dddocky (12567 in chips) 
Seat 2: Duke Croix (9806 in chips) 
Seat 3: FragileMemory (21674 in chips) 
Seat 5: RichRick1337 (8178 in chips) 
Seat 8: color_singleton (6420 in chips) 
Seat 9: HighCardJasper (11530 in chips) 
HighCardJasper: posts small blind 50
dddocky: posts big blind 100
*** HOLE CARDS ***
Dealt to Duke Croix [3d 5d]
Duke Croix: calls 100
FragileMemory: calls 100
RichRick1337: calls 100
color_singleton: calls 100
HighCardJasper: raises 100 to 200
dddocky: folds 
Duke Croix: calls 100
FragileMemory: calls 100
RichRick1337: calls 100
color_singleton: calls 100
*** FLOP *** [Kd 6h 2h]
HighCardJasper: bets 200
Duke Croix: calls 200
FragileMemory: folds 
RichRick1337: folds 
color_singleton: folds 
*** TURN *** [Kd 6h 2h] [Kh]
HighCardJasper: checks 
Duke Croix: bets 1000
HighCardJasper: calls 1000
*** RIVER *** [Kd 6h 2h Kh] [Ac]
HighCardJasper: bets 2000
Duke Croix: folds 
Uncalled bet (2000) returned to HighCardJasper
HighCardJasper collected 3307 from pot
HighCardJasper: doesn't show hand 
*** SUMMARY ***
Total pot 3500 | Rake 193 
Board [Kd 6h 2h Kh Ac]
Seat 1: dddocky (big blind) folded before Flop
Seat 2: Duke Croix folded on the River
Seat 3: FragileMemory folded on the Flop
Seat 5: RichRick1337 folded on the Flop
Seat 8: color_singleton (button) folded on the Flop
Seat 9: HighCardJasper (small blind) collected (3307)



PokerStars Home Game Hand #216250970799: {Club #3225207}  Hold'em No Limit (50/100) - 2020/07/09 16:58:04 ET
Table 'lets goo' 9-max (Play Money) Seat #9 is the button
Seat 1: dddocky (12467 in chips) 
Seat 2: Duke Croix (8406 in chips) 
Seat 3: FragileMemory (21474 in chips) 
Seat 5: RichRick1337 (7978 in chips) 
Seat 8: color_singleton (6220 in chips) 
Seat 9: HighCardJasper (13437 in chips) 
dddocky: posts small blind 50
Duke Croix: posts big blind 100
*** HOLE CARDS ***
Dealt to Duke Croix [Ts 4d]
FragileMemory: calls 100
RichRick1337: raises 100 to 200
color_singleton: folds 
HighCardJasper: calls 200
dddocky: folds 
Duke Croix: calls 100
FragileMemory: calls 100
*** FLOP *** [7h 7d 8c]
Duke Croix: checks 
FragileMemory: checks 
RichRick1337: bets 900
HighCardJasper: calls 900
Duke Croix: folds 
FragileMemory: folds 
*** TURN *** [7h 7d 8c] [Jd]
RichRick1337: checks 
HighCardJasper: checks 
*** RIVER *** [7h 7d 8c Jd] [Qs]
RichRick1337: checks 
HighCardJasper: checks 
*** SHOW DOWN ***
RichRick1337: shows [6h 6d] (two pair, Sevens and Sixes)
HighCardJasper: shows [7c 6s] (three of a kind, Sevens)
HighCardJasper collected 2504 from pot
*** SUMMARY ***
Total pot 2650 | Rake 146 
Board [7h 7d 8c Jd Qs]
Seat 1: dddocky (small blind) folded before Flop
Seat 2: Duke Croix (big blind) folded on the Flop
Seat 3: FragileMemory folded on the Flop
Seat 5: RichRick1337 showed [6h 6d] and lost with two pair, Sevens and Sixes
Seat 8: color_singleton folded before Flop (didn't bet)
Seat 9: HighCardJasper (button) showed [7c 6s] and won (2504) with three of a kind, Sevens



PokerStars Home Game Hand #216251010211: {Club #3225207}  Hold'em No Limit (50/100) - 2020/07/09 16:58:49 ET
Table 'lets goo' 9-max (Play Money) Seat #1 is the button
Seat 1: dddocky (12417 in chips) 
Seat 2: Duke Croix (8206 in chips) 
Seat 3: FragileMemory (21274 in chips) 
Seat 5: RichRick1337 (6878 in chips) 
Seat 8: color_singleton (6220 in chips) 
Seat 9: HighCardJasper (14841 in chips) 
Duke Croix: posts small blind 50
FragileMemory: posts big blind 100
*** HOLE CARDS ***
Dealt to Duke Croix [8d 5d]
RichRick1337: calls 100
color_singleton: folds 
HighCardJasper: calls 100
dddocky: folds 
Duke Croix has timed out
Duke Croix: folds 
FragileMemory: checks 
*** FLOP *** [7s 9d 2c]
FragileMemory: checks 
RichRick1337: bets 500
HighCardJasper: folds 
FragileMemory: folds 
Uncalled bet (500) returned to RichRick1337
RichRick1337 collected 331 from pot
RichRick1337: doesn't show hand 
*** SUMMARY ***
Total pot 350 | Rake 19 
Board [7s 9d 2c]
Seat 1: dddocky (button) folded before Flop (didn't bet)
Seat 2: Duke Croix (small blind) folded before Flop
Seat 3: FragileMemory (big blind) folded on the Flop
Seat 5: RichRick1337 collected (331)
Seat 8: color_singleton folded before Flop (didn't bet)
Seat 9: HighCardJasper folded on the Flop



PokerStars Home Game Hand #216251036899: {Club #3225207}  Hold'em No Limit (50/100) - 2020/07/09 16:59:44 ET
Table 'lets goo' 9-max (Play Money) Seat #2 is the button
Seat 1: dddocky (12417 in chips) 
Seat 2: Duke Croix (8156 in chips) 
Seat 3: FragileMemory (21174 in chips) 
Seat 5: RichRick1337 (7109 in chips) 
Seat 8: color_singleton (6220 in chips) 
Seat 9: HighCardJasper (14741 in chips) 
FragileMemory: posts small blind 50
RichRick1337: posts big blind 100
*** HOLE CARDS ***
Dealt to Duke Croix [7h 3s]
color_singleton: folds 
HighCardJasper: calls 100
dddocky: calls 100
Duke Croix: folds 
FragileMemory: calls 50
RichRick1337: checks 
*** FLOP *** [9c Tc 9s]
FragileMemory: checks 
RichRick1337: checks 
HighCardJasper: bets 200
dddocky: folds 
FragileMemory: folds 
RichRick1337: folds 
Uncalled bet (200) returned to HighCardJasper
HighCardJasper collected 378 from pot
HighCardJasper: doesn't show hand 
*** SUMMARY ***
Total pot 400 | Rake 22 
Board [9c Tc 9s]
Seat 1: dddocky folded on the Flop
Seat 2: Duke Croix (button) folded before Flop (didn't bet)
Seat 3: FragileMemory (small blind) folded on the Flop
Seat 5: RichRick1337 (big blind) folded on the Flop
Seat 8: color_singleton folded before Flop (didn't bet)
Seat 9: HighCardJasper collected (378)



PokerStars Home Game Hand #216251056677: {Club #3225207}  Hold'em No Limit (50/100) - 2020/07/09 17:00:23 ET
Table 'lets goo' 9-max (Play Money) Seat #3 is the button
Seat 1: dddocky (12317 in chips) 
Seat 2: Duke Croix (8156 in chips) 
Seat 3: FragileMemory (21074 in chips) 
Seat 5: RichRick1337 (7009 in chips) 
Seat 8: color_singleton (6220 in chips) 
Seat 9: HighCardJasper (15019 in chips) 
RichRick1337: posts small blind 50
color_singleton: posts big blind 100
*** HOLE CARDS ***
Dealt to Duke Croix [2d 6c]
HighCardJasper: calls 100
dddocky: calls 100
Duke Croix: folds 
FragileMemory: folds 
RichRick1337: calls 50
color_singleton: raises 200 to 300
HighCardJasper: calls 200
dddocky: calls 200
RichRick1337: folds 
*** FLOP *** [Qd 3d Jc]
color_singleton: checks 
HighCardJasper: checks 
dddocky: checks 
*** TURN *** [Qd 3d Jc] [Kc]
color_singleton: checks 
HighCardJasper: checks 
dddocky: checks 
*** RIVER *** [Qd 3d Jc Kc] [Ts]
color_singleton: bets 945
HighCardJasper: folds 
dddocky: calls 945
*** SHOW DOWN ***
color_singleton: shows [9d As] (a straight, Ten to Ace)
dddocky: mucks hand 
color_singleton collected 2731 from pot
*** SUMMARY ***
Total pot 2890 | Rake 159 
Board [Qd 3d Jc Kc Ts]
Seat 1: dddocky mucked [Tc Th]
Seat 2: Duke Croix folded before Flop (didn't bet)
Seat 3: FragileMemory (button) folded before Flop (didn't bet)
Seat 5: RichRick1337 (small blind) folded before Flop
Seat 8: color_singleton (big blind) showed [9d As] and won (2731) with a straight, Ten to Ace
Seat 9: HighCardJasper folded on the River



PokerStars Home Game Hand #216251087898: {Club #3225207}  Hold'em No Limit (50/100) - 2020/07/09 17:01:18 ET
Table 'lets goo' 9-max (Play Money) Seat #5 is the button
Seat 1: dddocky (11072 in chips) 
Seat 2: Duke Croix (8156 in chips) 
Seat 3: FragileMemory (21074 in chips) 
Seat 5: RichRick1337 (6909 in chips) 
Seat 8: color_singleton (7706 in chips) 
Seat 9: HighCardJasper (14719 in chips) 
color_singleton: posts small blind 50
HighCardJasper: posts big blind 100
*** HOLE CARDS ***
Dealt to Duke Croix [2s Jc]
dddocky: calls 100
Duke Croix: folds 
FragileMemory: folds 
RichRick1337: raises 100 to 200
color_singleton: calls 150
HighCardJasper: calls 100
dddocky: calls 100
*** FLOP *** [2h 9s 7s]
color_singleton: checks 
HighCardJasper: checks 
dddocky: checks 
RichRick1337: checks 
*** TURN *** [2h 9s 7s] [7d]
color_singleton: checks 
HighCardJasper: checks 
dddocky: checks 
RichRick1337: checks 
*** RIVER *** [2h 9s 7s 7d] [Qc]
color_singleton: checks 
HighCardJasper: bets 200
dddocky: folds 
RichRick1337: folds 
color_singleton: folds 
Uncalled bet (200) returned to HighCardJasper
HighCardJasper collected 756 from pot
HighCardJasper: doesn't show hand 
*** SUMMARY ***
Total pot 800 | Rake 44 
Board [2h 9s 7s 7d Qc]
Seat 1: dddocky folded on the River
Seat 2: Duke Croix folded before Flop (didn't bet)
Seat 3: FragileMemory folded before Flop (didn't bet)
Seat 5: RichRick1337 (button) folded on the River
Seat 8: color_singleton (small blind) folded on the River
Seat 9: HighCardJasper (big blind) collected (756)



PokerStars Home Game Hand #216251115709: {Club #3225207}  Hold'em No Limit (50/100) - 2020/07/09 17:02:02 ET
Table 'lets goo' 9-max (Play Money) Seat #8 is the button
Seat 1: dddocky (10872 in chips) 
Seat 2: Duke Croix (8156 in chips) 
Seat 3: FragileMemory (21074 in chips) 
Seat 5: RichRick1337 (6709 in chips) 
Seat 8: color_singleton (7506 in chips) 
Seat 9: HighCardJasper (15275 in chips) 
HighCardJasper: posts small blind 50
dddocky: posts big blind 100
*** HOLE CARDS ***
Dealt to Duke Croix [Jd 2c]
Duke Croix: folds 
FragileMemory: calls 100
RichRick1337: calls 100
color_singleton: folds 
HighCardJasper: calls 50
dddocky: checks 
*** FLOP *** [3h 8d 6h]
HighCardJasper: checks 
dddocky: checks 
FragileMemory: checks 
RichRick1337: checks 
*** TURN *** [3h 8d 6h] [Tc]
HighCardJasper: checks 
dddocky: checks 
FragileMemory: checks 
RichRick1337: checks 
*** RIVER *** [3h 8d 6h Tc] [Kc]
HighCardJasper: checks 
dddocky: checks 
FragileMemory: bets 189
RichRick1337: folds 
HighCardJasper: folds 
dddocky: folds 
Uncalled bet (189) returned to FragileMemory
FragileMemory collected 378 from pot
FragileMemory: doesn't show hand 
*** SUMMARY ***
Total pot 400 | Rake 22 
Board [3h 8d 6h Tc Kc]
Seat 1: dddocky (big blind) folded on the River
Seat 2: Duke Croix folded before Flop (didn't bet)
Seat 3: FragileMemory collected (378)
Seat 5: RichRick1337 folded on the River
Seat 8: color_singleton (button) folded before Flop (didn't bet)
Seat 9: HighCardJasper (small blind) folded on the River



PokerStars Home Game Hand #216251150586: {Club #3225207}  Hold'em No Limit (50/100) - 2020/07/09 17:02:57 ET
Table 'lets goo' 9-max (Play Money) Seat #9 is the button
Seat 1: dddocky (10772 in chips) 
Seat 2: Duke Croix (8156 in chips) 
Seat 3: FragileMemory (21352 in chips) 
Seat 5: RichRick1337 (6609 in chips) 
Seat 8: color_singleton (7506 in chips) 
Seat 9: HighCardJasper (15175 in chips) 
dddocky: posts small blind 50
Duke Croix: posts big blind 100
*** HOLE CARDS ***
Dealt to Duke Croix [Jd 2d]
FragileMemory: calls 100
RichRick1337: raises 100 to 200
color_singleton: folds 
HighCardJasper: calls 200
dddocky: calls 150
Duke Croix: calls 100
FragileMemory: calls 100
*** FLOP *** [2s 3c 7d]
dddocky: checks 
Duke Croix: bets 400
FragileMemory: calls 400
RichRick1337: calls 400
HighCardJasper: calls 400
dddocky: folds 
*** TURN *** [2s 3c 7d] [Jh]
Duke Croix: bets 1200
FragileMemory: folds 
RichRick1337: folds 
HighCardJasper: folds 
Uncalled bet (1200) returned to Duke Croix
Duke Croix collected 2457 from pot
*** SUMMARY ***
Total pot 2600 | Rake 143 
Board [2s 3c 7d Jh]
Seat 1: dddocky (small blind) folded on the Flop
Seat 2: Duke Croix (big blind) collected (2457)
Seat 3: FragileMemory folded on the Turn
Seat 5: RichRick1337 folded on the Turn
Seat 8: color_singleton folded before Flop (didn't bet)
Seat 9: HighCardJasper (button) folded on the Turn



PokerStars Home Game Hand #216251182158: {Club #3225207}  Hold'em No Limit (50/100) - 2020/07/09 17:03:46 ET
Table 'lets goo' 9-max (Play Money) Seat #1 is the button
Seat 1: dddocky (10572 in chips) 
Seat 2: Duke Croix (10013 in chips) 
Seat 3: FragileMemory (20752 in chips) 
Seat 5: RichRick1337 (6009 in chips) 
Seat 8: color_singleton (7506 in chips) 
Seat 9: HighCardJasper (14575 in chips) 
Duke Croix: posts small blind 50
FragileMemory: posts big blind 100
*** HOLE CARDS ***
Dealt to Duke Croix [Js Kd]
RichRick1337: folds 
color_singleton: raises 200 to 300
HighCardJasper: calls 300
dddocky: calls 300
Duke Croix: calls 250
FragileMemory: raises 200 to 500
color_singleton: calls 200
HighCardJasper: calls 200
dddocky: calls 200
Duke Croix: calls 200
*** FLOP *** [3h 7d Ah]
Duke Croix: checks 
FragileMemory: bets 1181
color_singleton: raises 1181 to 2362
HighCardJasper: folds 
dddocky: folds 
Duke Croix: folds 
FragileMemory: raises 17890 to 20252 and is all-in
color_singleton: calls 4644 and is all-in
Uncalled bet (13246) returned to FragileMemory
*** TURN *** [3h 7d Ah] [7c]
*** RIVER *** [3h 7d Ah 7c] [2d]
*** SHOW DOWN ***
FragileMemory: shows [3s 3d] (a full house, Threes full of Sevens)
color_singleton: shows [Ad Kh] (two pair, Aces and Sevens)
FragileMemory collected 15604 from pot
*** SUMMARY ***
Total pot 16512 | Rake 908 
Board [3h 7d Ah 7c 2d]
Seat 1: dddocky (button) folded on the Flop
Seat 2: Duke Croix (small blind) folded on the Flop
Seat 3: FragileMemory (big blind) showed [3s 3d] and won (15604) with a full house, Threes full of Sevens
Seat 5: RichRick1337 folded before Flop (didn't bet)
Seat 8: color_singleton showed [Ad Kh] and lost with two pair, Aces and Sevens
Seat 9: HighCardJasper folded on the Flop



PokerStars Home Game Hand #216251220142: {Club #3225207}  Hold'em No Limit (50/100) - 2020/07/09 17:04:44 ET
Table 'lets goo' 9-max (Play Money) Seat #2 is the button
Seat 1: dddocky (10072 in chips) 
Seat 2: Duke Croix (9513 in chips) 
Seat 3: FragileMemory (28850 in chips) 
Seat 5: RichRick1337 (6009 in chips) 
Seat 9: HighCardJasper (14075 in chips) 
FragileMemory: posts small blind 50
RichRick1337: posts big blind 100
*** HOLE CARDS ***
Dealt to Duke Croix [5s Js]
HighCardJasper: calls 100
dddocky: calls 100
Duke Croix: folds 
FragileMemory: calls 50
RichRick1337: checks 
*** FLOP *** [9d Jh 4s]
Manon947 joins the table at seat #4 
FragileMemory: checks 
RichRick1337: bets 400
HighCardJasper: folds 
dddocky: folds 
FragileMemory: calls 400
*** TURN *** [9d Jh 4s] [7s]
FragileMemory: checks 
RichRick1337: bets 300
FragileMemory: calls 300
*** RIVER *** [9d Jh 4s 7s] [4h]
FragileMemory: bets 100
RichRick1337: raises 800 to 900
FragileMemory: folds 
Uncalled bet (800) returned to RichRick1337
RichRick1337 collected 1890 from pot
RichRick1337: doesn't show hand 
*** SUMMARY ***
Total pot 2000 | Rake 110 
Board [9d Jh 4s 7s 4h]
Seat 1: dddocky folded on the Flop
Seat 2: Duke Croix (button) folded before Flop (didn't bet)
Seat 3: FragileMemory (small blind) folded on the River
Seat 5: RichRick1337 (big blind) collected (1890)
Seat 9: HighCardJasper folded on the Flop



PokerStars Home Game Hand #216251269294: {Club #3225207}  Hold'em No Limit (50/100) - 2020/07/09 17:05:59 ET
Table 'lets goo' 9-max (Play Money) Seat #3 is the button
Seat 1: dddocky (9972 in chips) 
Seat 2: Duke Croix (9513 in chips) 
Seat 3: FragileMemory (27950 in chips) 
Seat 5: RichRick1337 (6999 in chips) 
Seat 8: color_singleton (10000 in chips) 
Seat 9: HighCardJasper (13975 in chips) 
RichRick1337: posts small blind 50
color_singleton: posts big blind 100
*** HOLE CARDS ***
Dealt to Duke Croix [6d 9h]
HighCardJasper: raises 100 to 200
dddocky: calls 200
Duke Croix: folds 
FragileMemory: calls 200
RichRick1337: calls 150
color_singleton: folds 
*** FLOP *** [7s Kh 6h]
RichRick1337: checks 
HighCardJasper: bets 200
dddocky: folds 
FragileMemory: folds 
RichRick1337: calls 200
*** TURN *** [7s Kh 6h] [8s]
RichRick1337: bets 800
HighCardJasper: calls 800
*** RIVER *** [7s Kh 6h 8s] [7h]
RichRick1337: bets 1100
HighCardJasper: calls 1100
*** SHOW DOWN ***
RichRick1337: shows [9d Th] (a straight, Six to Ten)
HighCardJasper: mucks hand 
RichRick1337 collected 4819 from pot
*** SUMMARY ***
Total pot 5100 | Rake 281 
Board [7s Kh 6h 8s 7h]
Seat 1: dddocky folded on the Flop
Seat 2: Duke Croix folded before Flop (didn't bet)
Seat 3: FragileMemory (button) folded on the Flop
Seat 5: RichRick1337 (small blind) showed [9d Th] and won (4819) with a straight, Six to Ten
Seat 8: color_singleton (big blind) folded before Flop
Seat 9: HighCardJasper mucked [Kd 8d]



PokerStars Home Game Hand #216251307141: {Club #3225207}  Hold'em No Limit (50/100) - 2020/07/09 17:06:57 ET
Table 'lets goo' 9-max (Play Money) Seat #5 is the button
Seat 1: dddocky (9772 in chips) 
Seat 2: Duke Croix (9513 in chips) 
Seat 3: FragileMemory (27750 in chips) 
Seat 4: Manon947 (10000 in chips) 
Seat 5: RichRick1337 (9518 in chips) 
Seat 8: color_singleton (9900 in chips) 
Seat 9: HighCardJasper (11675 in chips) 
color_singleton: posts small blind 50
HighCardJasper: posts big blind 100
Manon947: posts big blind 100
*** HOLE CARDS ***
Dealt to Duke Croix [4c 2c]
dddocky: folds 
Duke Croix: calls 100
FragileMemory: calls 100
Manon947: checks 
RichRick1337: calls 100
color_singleton: calls 50
HighCardJasper: checks 
*** FLOP *** [2d Qs Ah]
color_singleton: checks 
HighCardJasper: checks 
Duke Croix: checks 
FragileMemory: checks 
Manon947: checks 
RichRick1337: checks 
*** TURN *** [2d Qs Ah] [Tc]
color_singleton: checks 
HighCardJasper: checks 
Duke Croix: checks 
FragileMemory: bets 283
Manon947: raises 283 to 566
RichRick1337: folds 
color_singleton: folds 
HighCardJasper: folds 
Duke Croix: folds 
FragileMemory: folds 
Uncalled bet (283) returned to Manon947
Manon947 collected 1102 from pot
*** SUMMARY ***
Total pot 1166 | Rake 64 
Board [2d Qs Ah Tc]
Seat 1: dddocky folded before Flop (didn't bet)
Seat 2: Duke Croix folded on the Turn
Seat 3: FragileMemory folded on the Turn
Seat 4: Manon947 collected (1102)
Seat 5: RichRick1337 (button) folded on the Turn
Seat 8: color_singleton (small blind) folded on the Turn
Seat 9: HighCardJasper (big blind) folded on the Turn



PokerStars Home Game Hand #216251349593: {Club #3225207}  Hold'em No Limit (50/100) - 2020/07/09 17:08:02 ET
Table 'lets goo' 9-max (Play Money) Seat #8 is the button
Seat 1: dddocky (9772 in chips) 
Seat 2: Duke Croix (9413 in chips) 
Seat 3: FragileMemory (27367 in chips) 
Seat 4: Manon947 (10719 in chips) 
Seat 5: RichRick1337 (9418 in chips) 
Seat 8: color_singleton (9800 in chips) 
Seat 9: HighCardJasper (11575 in chips) 
HighCardJasper: posts small blind 50
dddocky: posts big blind 100
*** HOLE CARDS ***
Dealt to Duke Croix [5s 5h]
Duke Croix: raises 300 to 400
FragileMemory: folds 
Manon947: calls 400
RichRick1337: folds 
color_singleton: folds 
HighCardJasper: folds 
dddocky: folds 
*** FLOP *** [6c Qd 3s]
Duke Croix: bets 650
Manon947: folds 
Uncalled bet (650) returned to Duke Croix
Duke Croix collected 898 from pot
*** SUMMARY ***
Total pot 950 | Rake 52 
Board [6c Qd 3s]
Seat 1: dddocky (big blind) folded before Flop
Seat 2: Duke Croix collected (898)
Seat 3: FragileMemory folded before Flop (didn't bet)
Seat 4: Manon947 folded on the Flop
Seat 5: RichRick1337 folded before Flop (didn't bet)
Seat 8: color_singleton (button) folded before Flop (didn't bet)
Seat 9: HighCardJasper (small blind) folded before Flop



PokerStars Home Game Hand #216251373048: {Club #3225207}  Hold'em No Limit (50/100) - 2020/07/09 17:08:38 ET
Table 'lets goo' 9-max (Play Money) Seat #9 is the button
Seat 1: dddocky (9672 in chips) 
Seat 2: Duke Croix (9911 in chips) 
Seat 3: FragileMemory (27367 in chips) 
Seat 4: Manon947 (10319 in chips) 
Seat 5: RichRick1337 (9418 in chips) 
Seat 8: color_singleton (9800 in chips) 
Seat 9: HighCardJasper (11525 in chips) 
dddocky: posts small blind 50
Duke Croix: posts big blind 100
*** HOLE CARDS ***
Dealt to Duke Croix [Jc 6s]
FragileMemory: folds 
Manon947: calls 100
RichRick1337: calls 100
color_singleton has timed out
color_singleton: folds 
HighCardJasper: calls 100
dddocky: folds 
Duke Croix: checks 
*** FLOP *** [8d Qd 3c]
Duke Croix: checks 
Manon947 has timed out
Manon947: checks 
RichRick1337: checks 
HighCardJasper: checks 
*** TURN *** [8d Qd 3c] [6c]
Duke Croix: bets 300
Manon947: folds 
RichRick1337: folds 
HighCardJasper: folds 
Uncalled bet (300) returned to Duke Croix
Duke Croix collected 425 from pot
*** SUMMARY ***
Total pot 450 | Rake 25 
Board [8d Qd 3c 6c]
Seat 1: dddocky (small blind) folded before Flop
Seat 2: Duke Croix (big blind) collected (425)
Seat 3: FragileMemory folded before Flop (didn't bet)
Seat 4: Manon947 folded on the Turn
Seat 5: RichRick1337 folded on the Turn
Seat 8: color_singleton folded before Flop (didn't bet)
Seat 9: HighCardJasper (button) folded on the Turn



PokerStars Home Game Hand #216251423389: {Club #3225207}  Hold'em No Limit (50/100) - 2020/07/09 17:09:55 ET
Table 'lets goo' 9-max (Play Money) Seat #1 is the button
Seat 1: dddocky (9622 in chips) 
Seat 2: Duke Croix (10236 in chips) 
Seat 3: FragileMemory (27367 in chips) 
Seat 4: Manon947 (10219 in chips) 
Seat 5: RichRick1337 (9318 in chips) 
Seat 8: color_singleton (9800 in chips) 
Seat 9: HighCardJasper (11425 in chips) 
Duke Croix: posts small blind 50
FragileMemory: posts big blind 100
*** HOLE CARDS ***
Dealt to Duke Croix [Qs 7s]
Manon947: calls 100
RichRick1337: raises 100 to 200
color_singleton: calls 200
HighCardJasper: calls 200
dddocky: calls 200
Duke Croix: calls 150
FragileMemory: calls 100
Manon947: calls 100
*** FLOP *** [4h 2c Jd]
Duke Croix: checks 
FragileMemory: checks 
Manon947: bets 100
RichRick1337: raises 100 to 200
color_singleton: folds 
HighCardJasper: folds 
dddocky: calls 200
Duke Croix: folds 
FragileMemory: folds 
Manon947: calls 100
*** TURN *** [4h 2c Jd] [Qh]
Manon947: bets 945
RichRick1337: folds 
dddocky: folds 
Uncalled bet (945) returned to Manon947
Manon947 collected 1890 from pot
*** SUMMARY ***
Total pot 2000 | Rake 110 
Board [4h 2c Jd Qh]
Seat 1: dddocky (button) folded on the Turn
Seat 2: Duke Croix (small blind) folded on the Flop
Seat 3: FragileMemory (big blind) folded on the Flop
Seat 4: Manon947 collected (1890)
Seat 5: RichRick1337 folded on the Turn
Seat 8: color_singleton folded on the Flop
Seat 9: HighCardJasper folded on the Flop



PokerStars Home Game Hand #216251468913: {Club #3225207}  Hold'em No Limit (50/100) - 2020/07/09 17:11:06 ET
Table 'lets goo' 9-max (Play Money) Seat #2 is the button
Seat 1: dddocky (9222 in chips) 
Seat 2: Duke Croix (10036 in chips) 
Seat 3: FragileMemory (27167 in chips) 
Seat 4: Manon947 (11709 in chips) 
Seat 5: RichRick1337 (8918 in chips) 
Seat 8: color_singleton (9600 in chips) 
Seat 9: HighCardJasper (11225 in chips) 
FragileMemory: posts small blind 50
Manon947: posts big blind 100
*** HOLE CARDS ***
Dealt to Duke Croix [6h 3h]
RichRick1337: calls 100
color_singleton: raises 100 to 200
HighCardJasper: calls 200
dddocky: calls 200
Duke Croix: folds 
FragileMemory: folds 
Manon947: calls 100
RichRick1337: calls 100
*** FLOP *** [Kd Ad 7c]
Manon947: bets 496
RichRick1337: calls 496
color_singleton: calls 496
HighCardJasper: calls 496
dddocky: calls 496
*** TURN *** [Kd Ad 7c] [Jh]
Manon947: checks 
RichRick1337: checks 
color_singleton: checks 
HighCardJasper: checks 
dddocky: bets 1668
Manon947: folds 
RichRick1337: folds 
color_singleton: folds 
HighCardJasper: folds 
Uncalled bet (1668) returned to dddocky
dddocky collected 3336 from pot
dddocky: doesn't show hand 
*** SUMMARY ***
Total pot 3530 | Rake 194 
Board [Kd Ad 7c Jh]
Seat 1: dddocky collected (3336)
Seat 2: Duke Croix (button) folded before Flop (didn't bet)
Seat 3: FragileMemory (small blind) folded before Flop
Seat 4: Manon947 (big blind) folded on the Turn
Seat 5: RichRick1337 folded on the Turn
Seat 8: color_singleton folded on the Turn
Seat 9: HighCardJasper folded on the Turn



PokerStars Home Game Hand #216251537745: {Club #3225207}  Hold'em No Limit (50/100) - 2020/07/09 17:12:53 ET
Table 'lets goo' 9-max (Play Money) Seat #3 is the button
Seat 1: dddocky (11862 in chips) 
Seat 2: Duke Croix (10036 in chips) 
Seat 3: FragileMemory (27117 in chips) 
Seat 4: Manon947 (11013 in chips) 
Seat 5: RichRick1337 (8222 in chips) 
Seat 8: color_singleton (8904 in chips) 
Seat 9: HighCardJasper (10529 in chips) 
Manon947: posts small blind 50
RichRick1337: posts big blind 100
*** HOLE CARDS ***
Dealt to Duke Croix [Qh 4h]
color_singleton: folds 
HighCardJasper: calls 100
dddocky: folds 
Duke Croix: calls 100
FragileMemory: folds 
Manon947: calls 50
RichRick1337: raises 400 to 500
HighCardJasper: folds 
Duke Croix: folds 
Manon947: calls 400
*** FLOP *** [6h Kh 4d]
Manon947: checks 
RichRick1337: bets 1400
Manon947 has timed out
Manon947: folds 
Uncalled bet (1400) returned to RichRick1337
RichRick1337 collected 1134 from pot
RichRick1337: doesn't show hand 
*** SUMMARY ***
Total pot 1200 | Rake 66 
Board [6h Kh 4d]
Seat 1: dddocky folded before Flop (didn't bet)
Seat 2: Duke Croix folded before Flop
Seat 3: FragileMemory (button) folded before Flop (didn't bet)
Seat 4: Manon947 (small blind) folded on the Flop
Seat 5: RichRick1337 (big blind) collected (1134)
Seat 8: color_singleton folded before Flop (didn't bet)
Seat 9: HighCardJasper folded before Flop



PokerStars Home Game Hand #216251573827: {Club #3225207}  Hold'em No Limit (50/100) - 2020/07/09 17:13:49 ET
Table 'lets goo' 9-max (Play Money) Seat #5 is the button
Seat 1: dddocky (11862 in chips) 
Seat 2: Duke Croix (9936 in chips) 
Seat 3: FragileMemory (27117 in chips) 
Seat 5: RichRick1337 (8856 in chips) 
Seat 8: color_singleton (8904 in chips) 
Seat 9: HighCardJasper (10429 in chips) 
color_singleton: posts small blind 50
HighCardJasper: posts big blind 100
*** HOLE CARDS ***
Dealt to Duke Croix [3s 6d]
dddocky: folds 
Duke Croix: folds 
FragileMemory: folds 
RichRick1337: calls 100
color_singleton: calls 50
HighCardJasper: checks 
*** FLOP *** [7d 4c 6c]
color_singleton: checks 
HighCardJasper: checks 
RichRick1337: checks 
*** TURN *** [7d 4c 6c] [7c]
color_singleton: checks 
HighCardJasper: bets 200
RichRick1337: calls 200
color_singleton: folds 
*** RIVER *** [7d 4c 6c 7c] [Jd]
HighCardJasper: bets 500
RichRick1337: folds 
Uncalled bet (500) returned to HighCardJasper
HighCardJasper collected 661 from pot
HighCardJasper: doesn't show hand 
*** SUMMARY ***
Total pot 700 | Rake 39 
Board [7d 4c 6c 7c Jd]
Seat 1: dddocky folded before Flop (didn't bet)
Seat 2: Duke Croix folded before Flop (didn't bet)
Seat 3: FragileMemory folded before Flop (didn't bet)
Seat 5: RichRick1337 (button) folded on the River
Seat 8: color_singleton (small blind) folded on the Turn
Seat 9: HighCardJasper (big blind) collected (661)



PokerStars Home Game Hand #216251608147: {Club #3225207}  Hold'em No Limit (50/100) - 2020/07/09 17:14:42 ET
Table 'lets goo' 9-max (Play Money) Seat #8 is the button
Seat 1: dddocky (11862 in chips) 
Seat 2: Duke Croix (9936 in chips) 
Seat 3: FragileMemory (27117 in chips) 
Seat 4: Manon947 (10513 in chips) 
Seat 5: RichRick1337 (8556 in chips) 
Seat 8: color_singleton (8804 in chips) 
Seat 9: HighCardJasper (10790 in chips) 
HighCardJasper: posts small blind 50
dddocky: posts big blind 100
*** HOLE CARDS ***
Dealt to Duke Croix [9d 6c]
Duke Croix: folds 
FragileMemory: calls 100
Manon947: folds 
RichRick1337: calls 100
color_singleton: folds 
HighCardJasper: calls 50
dddocky: checks 
*** FLOP *** [Qc 6h 8h]
HighCardJasper: bets 200
dddocky: folds 
FragileMemory: folds 
RichRick1337: folds 
Uncalled bet (200) returned to HighCardJasper
HighCardJasper collected 378 from pot
HighCardJasper: doesn't show hand 
*** SUMMARY ***
Total pot 400 | Rake 22 
Board [Qc 6h 8h]
Seat 1: dddocky (big blind) folded on the Flop
Seat 2: Duke Croix folded before Flop (didn't bet)
Seat 3: FragileMemory folded on the Flop
Seat 4: Manon947 folded before Flop (didn't bet)
Seat 5: RichRick1337 folded on the Flop
Seat 8: color_singleton (button) folded before Flop (didn't bet)
Seat 9: HighCardJasper (small blind) collected (378)



PokerStars Home Game Hand #216251629219: {Club #3225207}  Hold'em No Limit (50/100) - 2020/07/09 17:15:15 ET
Table 'lets goo' 9-max (Play Money) Seat #9 is the button
Seat 1: dddocky (11762 in chips) 
Seat 2: Duke Croix (9936 in chips) 
Seat 3: FragileMemory (27017 in chips) 
Seat 4: Manon947 (10513 in chips) 
Seat 5: RichRick1337 (8456 in chips) 
Seat 8: color_singleton (8804 in chips) 
Seat 9: HighCardJasper (11068 in chips) 
dddocky: posts small blind 50
Duke Croix: posts big blind 100
*** HOLE CARDS ***
Dealt to Duke Croix [3s Qd]
FragileMemory: calls 100
Manon947: calls 100
RichRick1337: calls 100
color_singleton: folds 
HighCardJasper: calls 100
dddocky: calls 50
Duke Croix: checks 
*** FLOP *** [Ks Js Th]
dddocky: checks 
Duke Croix: checks 
FragileMemory: checks 
Manon947: checks 
RichRick1337: bets 700
HighCardJasper: folds 
dddocky: folds 
Duke Croix: calls 700
FragileMemory: folds 
Manon947: folds 
*** TURN *** [Ks Js Th] [3d]
Duke Croix: checks 
RichRick1337: checks 
*** RIVER *** [Ks Js Th 3d] [4s]
Duke Croix: checks 
RichRick1337: checks 
*** SHOW DOWN ***
Duke Croix: shows [3s Qd] (a pair of Threes)
RichRick1337: shows [8d Kh] (a pair of Kings)
RichRick1337 collected 1890 from pot
*** SUMMARY ***
Total pot 2000 | Rake 110 
Board [Ks Js Th 3d 4s]
Seat 1: dddocky (small blind) folded on the Flop
Seat 2: Duke Croix (big blind) showed [3s Qd] and lost with a pair of Threes
Seat 3: FragileMemory folded on the Flop
Seat 4: Manon947 folded on the Flop
Seat 5: RichRick1337 showed [8d Kh] and won (1890) with a pair of Kings
Seat 8: color_singleton folded before Flop (didn't bet)
Seat 9: HighCardJasper (button) folded on the Flop



PokerStars Home Game Hand #216251676161: {Club #3225207}  Hold'em No Limit (50/100) - 2020/07/09 17:16:28 ET
Table 'lets goo' 9-max (Play Money) Seat #1 is the button
Seat 1: dddocky (11662 in chips) 
Seat 2: Duke Croix (9136 in chips) 
Seat 3: FragileMemory (26917 in chips) 
Seat 4: Manon947 (10413 in chips) 
Seat 5: RichRick1337 (9546 in chips) 
Seat 8: color_singleton (8804 in chips) 
Seat 9: HighCardJasper (10968 in chips) 
Duke Croix: posts small blind 50
FragileMemory: posts big blind 100
*** HOLE CARDS ***
Dealt to Duke Croix [Td 4c]
Manon947: calls 100
RichRick1337: calls 100
color_singleton: folds 
HighCardJasper: calls 100
dddocky: calls 100
Duke Croix: calls 50
FragileMemory: checks 
*** FLOP *** [Ad 6d Js]
Duke Croix: checks 
FragileMemory: checks 
Manon947 has timed out
Manon947: checks 
RichRick1337: checks 
HighCardJasper: checks 
dddocky: checks 
*** TURN *** [Ad 6d Js] [7s]
Duke Croix: checks 
FragileMemory: checks 
Manon947: checks 
RichRick1337: checks 
HighCardJasper: checks 
dddocky: bets 100
Duke Croix: folds 
FragileMemory: calls 100
Manon947: calls 100
RichRick1337: folds 
HighCardJasper: folds 
*** RIVER *** [Ad 6d Js 7s] [Th]
FragileMemory: checks 
Manon947: checks 
dddocky: bets 100
FragileMemory: calls 100
Manon947: calls 100
*** SHOW DOWN ***
dddocky: shows [Ah Kc] (a pair of Aces)
FragileMemory: mucks hand 
Manon947: mucks hand 
dddocky collected 1134 from pot
*** SUMMARY ***
Total pot 1200 | Rake 66 
Board [Ad 6d Js 7s Th]
Seat 1: dddocky (button) showed [Ah Kc] and won (1134) with a pair of Aces
Seat 2: Duke Croix (small blind) folded on the Turn
Seat 3: FragileMemory (big blind) mucked [6s 5h]
Seat 4: Manon947 mucked [8d Ks]
Seat 5: RichRick1337 folded on the Turn
Seat 8: color_singleton folded before Flop (didn't bet)
Seat 9: HighCardJasper folded on the Turn



PokerStars Home Game Hand #216251733307: {Club #3225207}  Hold'em No Limit (50/100) - 2020/07/09 17:17:58 ET
Table 'lets goo' 9-max (Play Money) Seat #2 is the button
Seat 1: dddocky (12496 in chips) 
Seat 2: Duke Croix (9036 in chips) 
Seat 3: FragileMemory (26617 in chips) 
Seat 4: Manon947 (10113 in chips) 
Seat 5: RichRick1337 (9446 in chips) 
Seat 8: color_singleton (8804 in chips) 
Seat 9: HighCardJasper (10868 in chips) 
FragileMemory: posts small blind 50
Manon947: posts big blind 100
*** HOLE CARDS ***
Dealt to Duke Croix [4d 7s]
RichRick1337: calls 100
color_singleton: folds 
HighCardJasper: calls 100
dddocky: calls 100
Duke Croix: folds 
FragileMemory: calls 50
Manon947: checks 
*** FLOP *** [Qd 9s 7c]
FragileMemory: checks 
Manon947: checks 
RichRick1337: bets 100
HighCardJasper: calls 100
dddocky: folds 
FragileMemory: folds 
Manon947: calls 100
*** TURN *** [Qd 9s 7c] [Kh]
Manon947: bets 378
RichRick1337: calls 378
HighCardJasper: folds 
*** RIVER *** [Qd 9s 7c Kh] [6h]
Manon947: bets 735
RichRick1337: calls 735
*** SHOW DOWN ***
Manon947: shows [4c Kd] (a pair of Kings)
RichRick1337: shows [6c 9c] (two pair, Nines and Sixes)
RichRick1337 collected 2860 from pot
*** SUMMARY ***
Total pot 3026 | Rake 166 
Board [Qd 9s 7c Kh 6h]
Seat 1: dddocky folded on the Flop
Seat 2: Duke Croix (button) folded before Flop (didn't bet)
Seat 3: FragileMemory (small blind) folded on the Flop
Seat 4: Manon947 (big blind) showed [4c Kd] and lost with a pair of Kings
Seat 5: RichRick1337 showed [6c 9c] and won (2860) with two pair, Nines and Sixes
Seat 8: color_singleton folded before Flop (didn't bet)
Seat 9: HighCardJasper folded on the Turn



PokerStars Home Game Hand #216251771349: {Club #3225207}  Hold'em No Limit (50/100) - 2020/07/09 17:18:57 ET
Table 'lets goo' 9-max (Play Money) Seat #3 is the button
Seat 1: dddocky (12396 in chips) 
Seat 2: Duke Croix (9036 in chips) 
Seat 3: FragileMemory (26517 in chips) 
Seat 4: Manon947 (8800 in chips) 
Seat 5: RichRick1337 (10993 in chips) 
Seat 8: color_singleton (8804 in chips) 
Seat 9: HighCardJasper (10668 in chips) 
Manon947: posts small blind 50
RichRick1337: posts big blind 100
*** HOLE CARDS ***
Dealt to Duke Croix [Ad 5s]
color_singleton: raises 100 to 200
HighCardJasper: raises 100 to 300
dddocky: folds 
Duke Croix: folds 
FragileMemory: raises 100 to 400
Manon947: folds 
RichRick1337: calls 300
color_singleton: calls 200
HighCardJasper: calls 100
*** FLOP *** [Kd 8s Jc]
RichRick1337: checks 
color_singleton: checks 
HighCardJasper: checks 
FragileMemory: checks 
*** TURN *** [Kd 8s Jc] [9s]
RichRick1337: checks 
color_singleton: checks 
HighCardJasper: checks 
FragileMemory: checks 
*** RIVER *** [Kd 8s Jc 9s] [4s]
RichRick1337: checks 
color_singleton: checks 
HighCardJasper: checks 
FragileMemory: bets 779
RichRick1337: folds 
color_singleton: folds 
HighCardJasper: folds 
Uncalled bet (779) returned to FragileMemory
FragileMemory collected 1559 from pot
FragileMemory: doesn't show hand 
*** SUMMARY ***
Total pot 1650 | Rake 91 
Board [Kd 8s Jc 9s 4s]
Seat 1: dddocky folded before Flop (didn't bet)
Seat 2: Duke Croix folded before Flop (didn't bet)
Seat 3: FragileMemory (button) collected (1559)
Seat 4: Manon947 (small blind) folded before Flop
Seat 5: RichRick1337 (big blind) folded on the River
Seat 8: color_singleton folded on the River
Seat 9: HighCardJasper folded on the River



PokerStars Home Game Hand #216251810506: {Club #3225207}  Hold'em No Limit (50/100) - 2020/07/09 17:19:59 ET
Table 'lets goo' 9-max (Play Money) Seat #4 is the button
Seat 1: dddocky (12396 in chips) 
Seat 2: Duke Croix (9036 in chips) 
Seat 3: FragileMemory (27676 in chips) 
Seat 4: Manon947 (8750 in chips) 
Seat 5: RichRick1337 (10593 in chips) 
Seat 8: color_singleton (8404 in chips) 
Seat 9: HighCardJasper (10268 in chips) 
RichRick1337: posts small blind 50
color_singleton: posts big blind 100
*** HOLE CARDS ***
Dealt to Duke Croix [6d Ah]
HighCardJasper: raises 200 to 300
dddocky: calls 300
Duke Croix: folds 
FragileMemory: raises 200 to 500
Manon947: calls 500
RichRick1337: folds 
color_singleton: folds 
HighCardJasper: calls 200
dddocky: folds 
*** FLOP *** [Jc 9h 3c]
HighCardJasper: bets 300
FragileMemory: folds 
Manon947: folds 
Uncalled bet (300) returned to HighCardJasper
HighCardJasper collected 1843 from pot
HighCardJasper: doesn't show hand 
*** SUMMARY ***
Total pot 1950 | Rake 107 
Board [Jc 9h 3c]
Seat 1: dddocky folded before Flop
Seat 2: Duke Croix folded before Flop (didn't bet)
Seat 3: FragileMemory folded on the Flop
Seat 4: Manon947 (button) folded on the Flop
Seat 5: RichRick1337 (small blind) folded before Flop
Seat 8: color_singleton (big blind) folded before Flop
Seat 9: HighCardJasper collected (1843)



PokerStars Home Game Hand #216251843443: {Club #3225207}  Hold'em No Limit (50/100) - 2020/07/09 17:20:51 ET
Table 'lets goo' 9-max (Play Money) Seat #5 is the button
Seat 1: dddocky (12096 in chips) 
Seat 2: Duke Croix (9036 in chips) 
Seat 3: FragileMemory (27176 in chips) 
Seat 4: Manon947 (8250 in chips) 
Seat 5: RichRick1337 (10543 in chips) 
Seat 8: color_singleton (8304 in chips) 
Seat 9: HighCardJasper (11611 in chips) 
color_singleton: posts small blind 50
HighCardJasper: posts big blind 100
*** HOLE CARDS ***
Dealt to Duke Croix [3d 9s]
dddocky: folds 
Duke Croix: folds 
FragileMemory: calls 100
Manon947: calls 100
RichRick1337: raises 100 to 200
color_singleton: folds 
HighCardJasper: calls 100
FragileMemory: raises 100 to 300
Manon947: calls 200
RichRick1337: calls 100
HighCardJasper: calls 100
*** FLOP *** [Jh Qs 2h]
HighCardJasper: bets 300
FragileMemory: raises 300 to 600
Manon947: folds 
RichRick1337: folds 
HighCardJasper: calls 300
*** TURN *** [Jh Qs 2h] [9c]
HighCardJasper: checks 
FragileMemory: bets 1157
HighCardJasper: folds 
Uncalled bet (1157) returned to FragileMemory
FragileMemory collected 2315 from pot
FragileMemory: doesn't show hand 
*** SUMMARY ***
Total pot 2450 | Rake 135 
Board [Jh Qs 2h 9c]
Seat 1: dddocky folded before Flop (didn't bet)
Seat 2: Duke Croix folded before Flop (didn't bet)
Seat 3: FragileMemory collected (2315)
Seat 4: Manon947 folded on the Flop
Seat 5: RichRick1337 (button) folded on the Flop
Seat 8: color_singleton (small blind) folded before Flop
Seat 9: HighCardJasper (big blind) folded on the Turn



PokerStars Home Game Hand #216251875486: {Club #3225207}  Hold'em No Limit (50/100) - 2020/07/09 17:21:42 ET
Table 'lets goo' 9-max (Play Money) Seat #8 is the button
Seat 1: dddocky (12096 in chips) 
Seat 2: Duke Croix (9036 in chips) 
Seat 3: FragileMemory (28591 in chips) 
Seat 4: Manon947 (7950 in chips) 
Seat 5: RichRick1337 (10243 in chips) 
Seat 8: color_singleton (8254 in chips) 
Seat 9: HighCardJasper (10711 in chips) 
HighCardJasper: posts small blind 50
dddocky: posts big blind 100
*** HOLE CARDS ***
Dealt to Duke Croix [7d Th]
Duke Croix: folds 
FragileMemory: calls 100
Manon947: folds 
RichRick1337: calls 100
color_singleton: calls 100
HighCardJasper: raises 100 to 200
dddocky: calls 100
FragileMemory: calls 100
RichRick1337: calls 100
color_singleton: calls 100
*** FLOP *** [Ad Ks Ah]
HighCardJasper: bets 200
dddocky: calls 200
FragileMemory: folds 
RichRick1337: raises 772 to 972
color_singleton: folds 
HighCardJasper: folds 
dddocky: folds 
Uncalled bet (772) returned to RichRick1337
RichRick1337 collected 1512 from pot
RichRick1337: doesn't show hand 
*** SUMMARY ***
Total pot 1600 | Rake 88 
Board [Ad Ks Ah]
Seat 1: dddocky (big blind) folded on the Flop
Seat 2: Duke Croix folded before Flop (didn't bet)
Seat 3: FragileMemory folded on the Flop
Seat 4: Manon947 folded before Flop (didn't bet)
Seat 5: RichRick1337 collected (1512)
Seat 8: color_singleton (button) folded on the Flop
Seat 9: HighCardJasper (small blind) folded on the Flop



PokerStars Home Game Hand #216251909971: {Club #3225207}  Hold'em No Limit (50/100) - 2020/07/09 17:22:37 ET
Table 'lets goo' 9-max (Play Money) Seat #9 is the button
Seat 1: dddocky (11696 in chips) 
Seat 2: Duke Croix (9036 in chips) 
Seat 3: FragileMemory (28391 in chips) 
Seat 4: Manon947 (7950 in chips) 
Seat 5: RichRick1337 (11355 in chips) 
Seat 8: color_singleton (8054 in chips) 
Seat 9: HighCardJasper (10311 in chips) 
dddocky: posts small blind 50
Duke Croix: posts big blind 100
*** HOLE CARDS ***
Dealt to Duke Croix [5s 6d]
FragileMemory: calls 100
Manon947: calls 100
RichRick1337: calls 100
color_singleton: folds 
HighCardJasper: calls 100
dddocky: calls 50
Duke Croix: checks 
*** FLOP *** [Ac 6c 5h]
dddocky: checks 
Duke Croix: bets 400
FragileMemory: folds 
Manon947: folds 
RichRick1337: folds 
HighCardJasper: folds 
dddocky: folds 
Uncalled bet (400) returned to Duke Croix
Duke Croix collected 567 from pot
*** SUMMARY ***
Total pot 600 | Rake 33 
Board [Ac 6c 5h]
Seat 1: dddocky (small blind) folded on the Flop
Seat 2: Duke Croix (big blind) collected (567)
Seat 3: FragileMemory folded on the Flop
Seat 4: Manon947 folded on the Flop
Seat 5: RichRick1337 folded on the Flop
Seat 8: color_singleton folded before Flop (didn't bet)
Seat 9: HighCardJasper (button) folded on the Flop



PokerStars Home Game Hand #216251930476: {Club #3225207}  Hold'em No Limit (50/100) - 2020/07/09 17:23:08 ET
Table 'lets goo' 9-max (Play Money) Seat #1 is the button
Seat 1: dddocky (11596 in chips) 
Seat 2: Duke Croix (9503 in chips) 
Seat 3: FragileMemory (28291 in chips) 
Seat 4: Manon947 (7850 in chips) 
Seat 5: RichRick1337 (11255 in chips) 
Seat 8: color_singleton (8054 in chips) 
Seat 9: HighCardJasper (10211 in chips) 
Duke Croix: posts small blind 50
FragileMemory: posts big blind 100
*** HOLE CARDS ***
Dealt to Duke Croix [3h 6s]
Manon947: calls 100
RichRick1337: calls 100
color_singleton: raises 200 to 300
HighCardJasper: calls 300
dddocky: folds 
Duke Croix: folds 
FragileMemory: folds 
Manon947: calls 200
RichRick1337: calls 200
*** FLOP *** [Tc 8h 6d]
Manon947: checks 
RichRick1337: checks 
color_singleton: checks 
HighCardJasper: checks 
*** TURN *** [Tc 8h 6d] [Js]
Manon947: bets 638
RichRick1337: folds 
color_singleton: calls 638
HighCardJasper: calls 638
*** RIVER *** [Tc 8h 6d Js] [2d]
Manon947: checks 
color_singleton: checks 
HighCardJasper: bets 1000
Manon947: folds 
color_singleton: calls 1000
*** SHOW DOWN ***
HighCardJasper: shows [Qh 9d] (a straight, Eight to Queen)
color_singleton: mucks hand 
HighCardJasper collected 4974 from pot
*** SUMMARY ***
Total pot 5264 | Rake 290 
Board [Tc 8h 6d Js 2d]
Seat 1: dddocky (button) folded before Flop (didn't bet)
Seat 2: Duke Croix (small blind) folded before Flop
Seat 3: FragileMemory (big blind) folded before Flop
Seat 4: Manon947 folded on the River
Seat 5: RichRick1337 folded on the Turn
Seat 8: color_singleton mucked [Jd Ks]
Seat 9: HighCardJasper showed [Qh 9d] and won (4974) with a straight, Eight to Queen



PokerStars Home Game Hand #216251989492: {Club #3225207}  Hold'em No Limit (50/100) - 2020/07/09 17:24:42 ET
Table 'lets goo' 9-max (Play Money) Seat #2 is the button
Seat 1: dddocky (11596 in chips) 
Seat 2: Duke Croix (9453 in chips) 
Seat 3: FragileMemory (28191 in chips) 
Seat 4: Manon947 (6912 in chips) 
Seat 5: RichRick1337 (10955 in chips) 
Seat 8: color_singleton (6116 in chips) 
Seat 9: HighCardJasper (13247 in chips) 
FragileMemory: posts small blind 50
Manon947: posts big blind 100
*** HOLE CARDS ***
Dealt to Duke Croix [4s 5d]
RichRick1337: calls 100
color_singleton: folds 
HighCardJasper: raises 100 to 200
dddocky: calls 200
Duke Croix: folds 
FragileMemory: folds 
Manon947: calls 100
RichRick1337: calls 100
*** FLOP *** [8c Ts Qc]
Manon947: checks 
RichRick1337: checks 
HighCardJasper: checks 
dddocky: checks 
*** TURN *** [8c Ts Qc] [8d]
Manon947: checks 
RichRick1337: checks 
HighCardJasper: checks 
dddocky: checks 
*** RIVER *** [8c Ts Qc 8d] [6s]
Manon947: bets 401
RichRick1337: folds 
HighCardJasper: folds 
dddocky: folds 
Uncalled bet (401) returned to Manon947
Manon947 collected 803 from pot
*** SUMMARY ***
Total pot 850 | Rake 47 
Board [8c Ts Qc 8d 6s]
Seat 1: dddocky folded on the River
Seat 2: Duke Croix (button) folded before Flop (didn't bet)
Seat 3: FragileMemory (small blind) folded before Flop
Seat 4: Manon947 (big blind) collected (803)
Seat 5: RichRick1337 folded on the River
Seat 8: color_singleton folded before Flop (didn't bet)
Seat 9: HighCardJasper folded on the River



PokerStars Home Game Hand #216252028583: {Club #3225207}  Hold'em No Limit (50/100) - 2020/07/09 17:25:44 ET
Table 'lets goo' 9-max (Play Money) Seat #3 is the button
Seat 1: dddocky (11396 in chips) 
Seat 2: Duke Croix (9453 in chips) 
Seat 3: FragileMemory (28141 in chips) 
Seat 4: Manon947 (7515 in chips) 
Seat 5: RichRick1337 (10755 in chips) 
Seat 8: color_singleton (6116 in chips) 
Seat 9: HighCardJasper (13047 in chips) 
Manon947: posts small blind 50
RichRick1337: posts big blind 100
*** HOLE CARDS ***
Dealt to Duke Croix [4h 3c]
color_singleton: folds 
HighCardJasper: raises 100 to 200
dddocky: folds 
Duke Croix: folds 
FragileMemory: folds 
Manon947: calls 150
RichRick1337: calls 100
*** FLOP *** [8d 9s 3s]
Manon947: checks 
RichRick1337: checks 
HighCardJasper: bets 200
Manon947: calls 200
RichRick1337: calls 200
*** TURN *** [8d 9s 3s] [Ac]
Manon947: checks 
RichRick1337: checks 
HighCardJasper: checks 
*** RIVER *** [8d 9s 3s Ac] [Ts]
Manon947: bets 567
RichRick1337: calls 567
HighCardJasper: folds 
*** SHOW DOWN ***
Manon947: shows [Js Th] (a pair of Tens)
RichRick1337: shows [As 5h] (a pair of Aces)
RichRick1337 collected 2206 from pot
*** SUMMARY ***
Total pot 2334 | Rake 128 
Board [8d 9s 3s Ac Ts]
Seat 1: dddocky folded before Flop (didn't bet)
Seat 2: Duke Croix folded before Flop (didn't bet)
Seat 3: FragileMemory (button) folded before Flop (didn't bet)
Seat 4: Manon947 (small blind) showed [Js Th] and lost with a pair of Tens
Seat 5: RichRick1337 (big blind) showed [As 5h] and won (2206) with a pair of Aces
Seat 8: color_singleton folded before Flop (didn't bet)
Seat 9: HighCardJasper folded on the River



PokerStars Home Game Hand #216252072931: {Club #3225207}  Hold'em No Limit (50/100) - 2020/07/09 17:26:48 ET
Table 'lets goo' 9-max (Play Money) Seat #4 is the button
Seat 2: Duke Croix (9453 in chips) 
Seat 3: FragileMemory (28141 in chips) 
Seat 4: Manon947 (6548 in chips) 
Seat 5: RichRick1337 (11994 in chips) 
Seat 8: color_singleton (6116 in chips) 
Seat 9: HighCardJasper (12647 in chips) 
RichRick1337: posts small blind 50
color_singleton: posts big blind 100
*** HOLE CARDS ***
Dealt to Duke Croix [7c Ts]
HighCardJasper: raises 200 to 300
Duke Croix: folds 
FragileMemory: folds 
Manon947: folds 
RichRick1337: calls 250
color_singleton: folds 
*** FLOP *** [Qh Qc 3s]
RichRick1337: checks 
HighCardJasper: checks 
*** TURN *** [Qh Qc 3s] [Jc]
RichRick1337: checks 
HighCardJasper: bets 200
RichRick1337: calls 200
*** RIVER *** [Qh Qc 3s Jc] [6h]
RichRick1337: checks 
HighCardJasper: bets 500
RichRick1337: folds 
Uncalled bet (500) returned to HighCardJasper
HighCardJasper collected 1039 from pot
HighCardJasper: doesn't show hand 
*** SUMMARY ***
Total pot 1100 | Rake 61 
Board [Qh Qc 3s Jc 6h]
Seat 2: Duke Croix folded before Flop (didn't bet)
Seat 3: FragileMemory folded before Flop (didn't bet)
Seat 4: Manon947 (button) folded before Flop (didn't bet)
Seat 5: RichRick1337 (small blind) folded on the River
Seat 8: color_singleton (big blind) folded before Flop
Seat 9: HighCardJasper collected (1039)



PokerStars Home Game Hand #216252103087: {Club #3225207}  Hold'em No Limit (50/100) - 2020/07/09 17:27:37 ET
Table 'lets goo' 9-max (Play Money) Seat #5 is the button
Seat 2: Duke Croix (9453 in chips) 
Seat 3: FragileMemory (28141 in chips) 
Seat 4: Manon947 (6548 in chips) 
Seat 5: RichRick1337 (11494 in chips) 
Seat 8: color_singleton (6016 in chips) 
Seat 9: HighCardJasper (13186 in chips) 
color_singleton: posts small blind 50
HighCardJasper: posts big blind 100
*** HOLE CARDS ***
Dealt to Duke Croix [9c 6d]
Duke Croix: folds 
FragileMemory: calls 100
Manon947: folds 
RichRick1337: calls 100
color_singleton: calls 50
HighCardJasper: checks 
*** FLOP *** [Kh 8c 7d]
color_singleton: checks 
HighCardJasper: checks 
FragileMemory: checks 
RichRick1337: bets 100
color_singleton: folds 
HighCardJasper: calls 100
FragileMemory: calls 100
*** TURN *** [Kh 8c 7d] [As]
HighCardJasper: checks 
FragileMemory: bets 330
RichRick1337: raises 330 to 660
HighCardJasper: folds 
FragileMemory: raises 330 to 990
RichRick1337: calls 330
*** RIVER *** [Kh 8c 7d As] [Ad]
FragileMemory: checks 
RichRick1337: bets 1000
FragileMemory: calls 1000
*** SHOW DOWN ***
RichRick1337: shows [Ac 8d] (a full house, Aces full of Eights)
FragileMemory: mucks hand 
RichRick1337 collected 4423 from pot
*** SUMMARY ***
Total pot 4680 | Rake 257 
Board [Kh 8c 7d As Ad]
Seat 2: Duke Croix folded before Flop (didn't bet)
Seat 3: FragileMemory mucked [Kd 7h]
Seat 4: Manon947 folded before Flop (didn't bet)
Seat 5: RichRick1337 (button) showed [Ac 8d] and won (4423) with a full house, Aces full of Eights
Seat 8: color_singleton (small blind) folded on the Flop
Seat 9: HighCardJasper (big blind) folded on the Turn



PokerStars Home Game Hand #216252144463: {Club #3225207}  Hold'em No Limit (50/100) - 2020/07/09 17:28:43 ET
Table 'lets goo' 9-max (Play Money) Seat #8 is the button
Seat 2: Duke Croix (9453 in chips) 
Seat 3: FragileMemory (25951 in chips) 
Seat 4: Manon947 (6548 in chips) 
Seat 5: RichRick1337 (13727 in chips) 
Seat 8: color_singleton (5916 in chips) 
Seat 9: HighCardJasper (12986 in chips) 
HighCardJasper: posts small blind 50
Duke Croix: posts big blind 100
*** HOLE CARDS ***
Dealt to Duke Croix [Jh 8h]
FragileMemory: calls 100
Manon947: folds 
RichRick1337: calls 100
color_singleton: raises 200 to 300
HighCardJasper: calls 250
Duke Croix: calls 200
FragileMemory: calls 200
RichRick1337: calls 200
*** FLOP *** [8s Ac Js]
HighCardJasper: checks 
Duke Croix: bets 700
FragileMemory: raises 700 to 1400
RichRick1337: folds 
color_singleton: folds 
HighCardJasper: folds 
Duke Croix: calls 700
*** TURN *** [8s Ac Js] [Th]
Duke Croix: checks 
FragileMemory: checks 
*** RIVER *** [8s Ac Js Th] [3h]
Duke Croix: bets 2300
FragileMemory: folds 
Uncalled bet (2300) returned to Duke Croix
Duke Croix collected 4063 from pot
*** SUMMARY ***
Total pot 4300 | Rake 237 
Board [8s Ac Js Th 3h]
Seat 2: Duke Croix (big blind) collected (4063)
Seat 3: FragileMemory folded on the River
Seat 4: Manon947 folded before Flop (didn't bet)
Seat 5: RichRick1337 folded on the Flop
Seat 8: color_singleton (button) folded on the Flop
Seat 9: HighCardJasper (small blind) folded on the Flop



PokerStars Home Game Hand #216252183927: {Club #3225207}  Hold'em No Limit (50/100) - 2020/07/09 17:29:47 ET
Table 'lets goo' 9-max (Play Money) Seat #9 is the button
Seat 2: Duke Croix (11816 in chips) 
Seat 3: FragileMemory (24251 in chips) 
Seat 4: Manon947 (6548 in chips) 
Seat 5: RichRick1337 (13427 in chips) 
Seat 8: color_singleton (5616 in chips) 
Seat 9: HighCardJasper (12686 in chips) 
Duke Croix: posts small blind 50
FragileMemory: posts big blind 100
*** HOLE CARDS ***
Dealt to Duke Croix [Ks Ac]
Manon947: calls 100
RichRick1337: calls 100
color_singleton: folds 
HighCardJasper: calls 100
Duke Croix: raises 400 to 500
FragileMemory: calls 400
Manon947: folds 
RichRick1337: calls 400
HighCardJasper: folds 
*** FLOP *** [2c Ah Jh]
Duke Croix: bets 700
FragileMemory: calls 700
RichRick1337: folds 
*** TURN *** [2c Ah Jh] [5s]
Duke Croix: bets 1500
FragileMemory: calls 1500
*** RIVER *** [2c Ah Jh 5s] [3s]
Duke Croix: bets 1800
FragileMemory: folds 
Uncalled bet (1800) returned to Duke Croix
Duke Croix collected 5764 from pot
*** SUMMARY ***
Total pot 6100 | Rake 336 
Board [2c Ah Jh 5s 3s]
Seat 2: Duke Croix (small blind) collected (5764)
Seat 3: FragileMemory (big blind) folded on the River
Seat 4: Manon947 folded before Flop
Seat 5: RichRick1337 folded on the Flop
Seat 8: color_singleton folded before Flop (didn't bet)
Seat 9: HighCardJasper (button) folded before Flop



PokerStars Home Game Hand #216252215542: {Club #3225207}  Hold'em No Limit (50/100) - 2020/07/09 17:30:38 ET
Table 'lets goo' 9-max (Play Money) Seat #2 is the button
Seat 2: Duke Croix (14880 in chips) 
Seat 3: FragileMemory (21551 in chips) 
Seat 4: Manon947 (6448 in chips) 
Seat 5: RichRick1337 (12927 in chips) 
Seat 8: color_singleton (5616 in chips) 
Seat 9: HighCardJasper (12586 in chips) 
FragileMemory: posts small blind 50
Manon947: posts big blind 100
*** HOLE CARDS ***
Dealt to Duke Croix [2c 5d]
RichRick1337: calls 100
color_singleton: raises 200 to 300
HighCardJasper: calls 300
Duke Croix: folds 
FragileMemory: folds 
Manon947: folds 
RichRick1337: calls 200
*** FLOP *** [Td Js Kd]
RichRick1337: checks 
color_singleton: bets 496
HighCardJasper: folds 
RichRick1337: folds 
Uncalled bet (496) returned to color_singleton
color_singleton collected 992 from pot
color_singleton: doesn't show hand 
*** SUMMARY ***
Total pot 1050 | Rake 58 
Board [Td Js Kd]
Seat 2: Duke Croix (button) folded before Flop (didn't bet)
Seat 3: FragileMemory (small blind) folded before Flop
Seat 4: Manon947 (big blind) folded before Flop
Seat 5: RichRick1337 folded on the Flop
Seat 8: color_singleton collected (992)
Seat 9: HighCardJasper folded on the Flop



PokerStars Home Game Hand #216252235691: {Club #3225207}  Hold'em No Limit (50/100) - 2020/07/09 17:31:11 ET
Table 'lets goo' 9-max (Play Money) Seat #3 is the button
Seat 2: Duke Croix (14880 in chips) 
Seat 3: FragileMemory (21501 in chips) 
Seat 4: Manon947 (6348 in chips) 
Seat 5: RichRick1337 (12627 in chips) 
Seat 8: color_singleton (6308 in chips) 
Seat 9: HighCardJasper (12286 in chips) 
Manon947: posts small blind 50
RichRick1337: posts big blind 100
*** HOLE CARDS ***
Dealt to Duke Croix [Kc Ah]
color_singleton: folds 
HighCardJasper: raises 200 to 300
Duke Croix: raises 500 to 800
FragileMemory: folds 
Manon947: folds 
RichRick1337: folds 
HighCardJasper: calls 500
*** FLOP *** [Td Qh 2s]
HighCardJasper: checks 
Duke Croix: checks 
*** TURN *** [Td Qh 2s] [Kd]
HighCardJasper: bets 500
Duke Croix: raises 500 to 1000
HighCardJasper: raises 500 to 1500
Duke Croix: calls 500
*** RIVER *** [Td Qh 2s Kd] [Jh]
HighCardJasper: bets 2000
Duke Croix: raises 10580 to 12580 and is all-in
HighCardJasper: folds 
Uncalled bet (10580) returned to Duke Croix
Duke Croix collected 8269 from pot
*** SUMMARY ***
Total pot 8750 | Rake 481 
Board [Td Qh 2s Kd Jh]
Seat 2: Duke Croix collected (8269)
Seat 3: FragileMemory (button) folded before Flop (didn't bet)
Seat 4: Manon947 (small blind) folded before Flop
Seat 5: RichRick1337 (big blind) folded before Flop
Seat 8: color_singleton folded before Flop (didn't bet)
Seat 9: HighCardJasper folded on the River



PokerStars Home Game Hand #216252280045: {Club #3225207}  Hold'em No Limit (50/100) - 2020/07/09 17:32:23 ET
Table 'lets goo' 9-max (Play Money) Seat #4 is the button
Seat 1: dddocky (11396 in chips) 
Seat 2: Duke Croix (18849 in chips) 
Seat 3: FragileMemory (21501 in chips) 
Seat 4: Manon947 (6298 in chips) 
Seat 5: RichRick1337 (12527 in chips) 
Seat 8: color_singleton (6308 in chips) 
Seat 9: HighCardJasper (7986 in chips) 
RichRick1337: posts small blind 50
color_singleton: posts big blind 100
dddocky: posts small & big blinds 150
*** HOLE CARDS ***
Dealt to Duke Croix [Ac 7h]
HighCardJasper: calls 100
dddocky: checks 
Duke Croix: calls 100
FragileMemory: calls 100
Manon947: calls 100
RichRick1337: raises 100 to 200
color_singleton: folds 
HighCardJasper: calls 100
dddocky: calls 100
Duke Croix: calls 100
FragileMemory: calls 100
Manon947: calls 100
*** FLOP *** [6h 3c 7c]
RichRick1337: checks 
HighCardJasper: checks 
dddocky: checks 
Duke Croix: bets 500
FragileMemory: raises 1138 to 1638
Manon947: folds 
RichRick1337: folds 
HighCardJasper: folds 
dddocky: folds 
Duke Croix: calls 1138
*** TURN *** [6h 3c 7c] [Qc]
Duke Croix: checks 
FragileMemory: bets 2186
Duke Croix: calls 2186
*** RIVER *** [6h 3c 7c Qc] [3h]
Duke Croix: checks 
FragileMemory: bets 100
Duke Croix: calls 100
*** SHOW DOWN ***
FragileMemory: shows [5d 4c] (a straight, Three to Seven)
Duke Croix: mucks hand 
FragileMemory collected 8692 from pot
*** SUMMARY ***
Total pot 9198 | Rake 506 
Board [6h 3c 7c Qc 3h]
Seat 1: dddocky folded on the Flop
Seat 2: Duke Croix mucked [Ac 7h]
Seat 3: FragileMemory showed [5d 4c] and won (8692) with a straight, Three to Seven
Seat 4: Manon947 (button) folded on the Flop
Seat 5: RichRick1337 (small blind) folded on the Flop
Seat 8: color_singleton (big blind) folded before Flop
Seat 9: HighCardJasper folded on the Flop



PokerStars Home Game Hand #216252319920: {Club #3225207}  Hold'em No Limit (50/100) - 2020/07/09 17:33:28 ET
Table 'lets goo' 9-max (Play Money) Seat #5 is the button
Seat 1: dddocky (11146 in chips) 
Seat 2: Duke Croix (14725 in chips) 
Seat 3: FragileMemory (26069 in chips) 
Seat 4: Manon947 (6098 in chips) 
Seat 5: RichRick1337 (12327 in chips) 
Seat 8: color_singleton (6208 in chips) 
Seat 9: HighCardJasper (7786 in chips) 
color_singleton: posts small blind 50
HighCardJasper: posts big blind 100
*** HOLE CARDS ***
Dealt to Duke Croix [7c 2d]
dddocky: folds 
Duke Croix: folds 
FragileMemory: calls 100
Manon947: calls 100
RichRick1337: calls 100
color_singleton: calls 50
HighCardJasper: checks 
*** FLOP *** [3c 7s 3h]
color_singleton: checks 
HighCardJasper: bets 200
FragileMemory: folds 
Manon947: folds 
RichRick1337: raises 200 to 400
color_singleton: folds 
HighCardJasper: calls 200
*** TURN *** [3c 7s 3h] [Kd]
HighCardJasper: checks 
RichRick1337: checks 
*** RIVER *** [3c 7s 3h Kd] [5s]
HighCardJasper: bets 500
RichRick1337: folds 
Uncalled bet (500) returned to HighCardJasper
HighCardJasper collected 1228 from pot
HighCardJasper: doesn't show hand 
*** SUMMARY ***
Total pot 1300 | Rake 72 
Board [3c 7s 3h Kd 5s]
Seat 1: dddocky folded before Flop (didn't bet)
Seat 2: Duke Croix folded before Flop (didn't bet)
Seat 3: FragileMemory folded on the Flop
Seat 4: Manon947 folded on the Flop
Seat 5: RichRick1337 (button) folded on the River
Seat 8: color_singleton (small blind) folded on the Flop
Seat 9: HighCardJasper (big blind) collected (1228)



PokerStars Home Game Hand #216252349498: {Club #3225207}  Hold'em No Limit (50/100) - 2020/07/09 17:34:17 ET
Table 'lets goo' 9-max (Play Money) Seat #8 is the button
Seat 1: dddocky (11146 in chips) 
Seat 2: Duke Croix (14725 in chips) 
Seat 3: FragileMemory (25969 in chips) 
Seat 4: Manon947 (5998 in chips) 
Seat 5: RichRick1337 (11827 in chips) 
Seat 8: color_singleton (6108 in chips) 
Seat 9: HighCardJasper (8514 in chips) 
HighCardJasper: posts small blind 50
dddocky: posts big blind 100
*** HOLE CARDS ***
Dealt to Duke Croix [7c 2s]
Duke Croix: folds 
FragileMemory: calls 100
Manon947: calls 100
RichRick1337: calls 100
color_singleton: calls 100
HighCardJasper: calls 50
dddocky: checks 
*** FLOP *** [Qc Ad Kh]
HighCardJasper: checks 
dddocky: checks 
FragileMemory: bets 283
Manon947: calls 283
RichRick1337: calls 283
color_singleton: calls 283
HighCardJasper: folds 
dddocky: calls 283
*** TURN *** [Qc Ad Kh] [7s]
dddocky: checks 
FragileMemory: bets 100
Manon947: calls 100
RichRick1337: calls 100
color_singleton: calls 100
dddocky: calls 100
*** RIVER *** [Qc Ad Kh 7s] [4h]
dddocky: checks 
FragileMemory: checks 
Manon947: bets 1188
RichRick1337: folds 
color_singleton: calls 1188
dddocky: folds 
FragileMemory: folds 
*** SHOW DOWN ***
Manon947: shows [Jc 7d] (a pair of Sevens)
color_singleton: shows [4c Kc] (two pair, Kings and Fours)
color_singleton collected 4622 from pot
*** SUMMARY ***
Total pot 4891 | Rake 269 
Board [Qc Ad Kh 7s 4h]
Seat 1: dddocky (big blind) folded on the River
Seat 2: Duke Croix folded before Flop (didn't bet)
Seat 3: FragileMemory folded on the River
Seat 4: Manon947 showed [Jc 7d] and lost with a pair of Sevens
Seat 5: RichRick1337 folded on the River
Seat 8: color_singleton (button) showed [4c Kc] and won (4622) with two pair, Kings and Fours
Seat 9: HighCardJasper (small blind) folded on the Flop



PokerStars Home Game Hand #216252399998: {Club #3225207}  Hold'em No Limit (50/100) - 2020/07/09 17:35:41 ET
Table 'lets goo' 9-max (Play Money) Seat #9 is the button
Seat 1: dddocky (10663 in chips) 
Seat 2: Duke Croix (14725 in chips) 
Seat 3: FragileMemory (25486 in chips) 
Seat 4: Manon947 (4327 in chips) 
Seat 5: RichRick1337 (11344 in chips) 
Seat 8: color_singleton (9059 in chips) 
Seat 9: HighCardJasper (8414 in chips) 
dddocky: posts small blind 50
Duke Croix: posts big blind 100
*** HOLE CARDS ***
Dealt to Duke Croix [3h 4d]
FragileMemory: calls 100
Manon947: calls 100
RichRick1337: calls 100
color_singleton: folds 
HighCardJasper: calls 100
dddocky: calls 50
Duke Croix: checks 
*** FLOP *** [3d Kh As]
dddocky: checks 
Duke Croix: checks 
FragileMemory: bets 283
Manon947: calls 283
RichRick1337: folds 
HighCardJasper: folds 
dddocky: folds 
Duke Croix: calls 283
*** TURN *** [3d Kh As] [3s]
Duke Croix: checks 
FragileMemory: bets 684
Manon947: calls 684
Duke Croix: raises 684 to 1368
FragileMemory: calls 684
Manon947: calls 684
*** RIVER *** [3d Kh As 3s] [9s]
Duke Croix: bets 2600
FragileMemory: folds 
Manon947: folds 
Uncalled bet (2600) returned to Duke Croix
Duke Croix collected 5248 from pot
*** SUMMARY ***
Total pot 5553 | Rake 305 
Board [3d Kh As 3s 9s]
Seat 1: dddocky (small blind) folded on the Flop
Seat 2: Duke Croix (big blind) collected (5248)
Seat 3: FragileMemory folded on the River
Seat 4: Manon947 folded on the River
Seat 5: RichRick1337 folded on the Flop
Seat 8: color_singleton folded before Flop (didn't bet)
Seat 9: HighCardJasper (button) folded on the Flop



PokerStars Home Game Hand #216252450038: {Club #3225207}  Hold'em No Limit (50/100) - 2020/07/09 17:37:04 ET
Table 'lets goo' 9-max (Play Money) Seat #1 is the button
Seat 1: dddocky (10563 in chips) 
Seat 2: Duke Croix (18222 in chips) 
Seat 3: FragileMemory (23735 in chips) 
Seat 4: Manon947 (2576 in chips) 
Seat 5: RichRick1337 (11244 in chips) 
Seat 8: color_singleton (9059 in chips) 
Seat 9: HighCardJasper (8314 in chips) 
Duke Croix: posts small blind 50
FragileMemory: posts big blind 100
*** HOLE CARDS ***
Dealt to Duke Croix [Qs 5d]
Manon947: calls 100
RichRick1337: calls 100
color_singleton: folds 
HighCardJasper: calls 100
dddocky: folds 
Duke Croix: calls 50
FragileMemory: checks 
*** FLOP *** [8h 5h Ah]
Duke Croix: checks 
FragileMemory: bets 472
Manon947: folds 
RichRick1337: folds 
HighCardJasper: folds 
Duke Croix: folds 
Uncalled bet (472) returned to FragileMemory
FragileMemory collected 472 from pot
FragileMemory: doesn't show hand 
*** SUMMARY ***
Total pot 500 | Rake 28 
Board [8h 5h Ah]
Seat 1: dddocky (button) folded before Flop (didn't bet)
Seat 2: Duke Croix (small blind) folded on the Flop
Seat 3: FragileMemory (big blind) collected (472)
Seat 4: Manon947 folded on the Flop
Seat 5: RichRick1337 folded on the Flop
Seat 8: color_singleton folded before Flop (didn't bet)
Seat 9: HighCardJasper folded on the Flop



PokerStars Home Game Hand #216252482089: {Club #3225207}  Hold'em No Limit (50/100) - 2020/07/09 17:37:42 ET
Table 'lets goo' 9-max (Play Money) Seat #2 is the button
Seat 1: dddocky (10563 in chips) 
Seat 2: Duke Croix (18122 in chips) 
Seat 3: FragileMemory (24107 in chips) 
Seat 4: Manon947 (2476 in chips) 
Seat 5: RichRick1337 (11144 in chips) 
Seat 8: color_singleton (9059 in chips) 
Seat 9: HighCardJasper (8214 in chips) 
FragileMemory: posts small blind 50
Manon947: posts big blind 100
*** HOLE CARDS ***
Dealt to Duke Croix [9h 6h]
RichRick1337: raises 100 to 200
color_singleton: calls 200
HighCardJasper: calls 200
dddocky: folds 
Duke Croix: folds 
FragileMemory: folds 
Manon947: calls 100
*** FLOP *** [6s Ks 8c]
Manon947: checks 
RichRick1337: bets 100
color_singleton: folds 
HighCardJasper: calls 100
Manon947: calls 100
*** TURN *** [6s Ks 8c] [5h]
Manon947: checks 
RichRick1337: checks 
HighCardJasper: checks 
*** RIVER *** [6s Ks 8c 5h] [As]
Manon947: checks 
RichRick1337: checks 
HighCardJasper: bets 500
Manon947: calls 500
RichRick1337: calls 500
*** SHOW DOWN ***
HighCardJasper: shows [2d Ac] (a pair of Aces)
Manon947: mucks hand 
RichRick1337: shows [Ah Kd] (two pair, Aces and Kings)
RichRick1337 collected 2504 from pot
*** SUMMARY ***
Total pot 2650 | Rake 146 
Board [6s Ks 8c 5h As]
Seat 1: dddocky folded before Flop (didn't bet)
Seat 2: Duke Croix (button) folded before Flop (didn't bet)
Seat 3: FragileMemory (small blind) folded before Flop
Seat 4: Manon947 (big blind) mucked [Tc 8s]
Seat 5: RichRick1337 showed [Ah Kd] and won (2504) with two pair, Aces and Kings
Seat 8: color_singleton folded on the Flop
Seat 9: HighCardJasper showed [2d Ac] and lost with a pair of Aces



PokerStars Home Game Hand #216252516719: {Club #3225207}  Hold'em No Limit (50/100) - 2020/07/09 17:38:40 ET
Table 'lets goo' 9-max (Play Money) Seat #3 is the button
Seat 1: dddocky (10563 in chips) 
Seat 2: Duke Croix (18122 in chips) 
Seat 3: FragileMemory (24057 in chips) 
Seat 4: Manon947 (1676 in chips) 
Seat 5: RichRick1337 (12848 in chips) 
Seat 8: color_singleton (8859 in chips) 
Seat 9: HighCardJasper (7414 in chips) 
Manon947: posts small blind 50
RichRick1337: posts big blind 100
*** HOLE CARDS ***
Dealt to Duke Croix [3c Ah]
color_singleton: folds 
HighCardJasper: calls 100
dddocky: folds 
Duke Croix: calls 100
FragileMemory: folds 
Manon947: folds 
RichRick1337: checks 
*** FLOP *** [Js Kc 8h]
RichRick1337: bets 165
HighCardJasper: calls 165
Duke Croix: folds 
*** TURN *** [Js Kc 8h] [Qs]
RichRick1337: checks 
HighCardJasper: checks 
*** RIVER *** [Js Kc 8h Qs] [Th]
RichRick1337: checks 
HighCardJasper: checks 
*** SHOW DOWN ***
RichRick1337: shows [Jc 6h] (a pair of Jacks)
HighCardJasper: shows [Jd 4c] (a pair of Jacks)
RichRick1337 collected 322 from pot
HighCardJasper collected 321 from pot
*** SUMMARY ***
Total pot 680 | Rake 37 
Board [Js Kc 8h Qs Th]
Seat 1: dddocky folded before Flop (didn't bet)
Seat 2: Duke Croix folded on the Flop
Seat 3: FragileMemory (button) folded before Flop (didn't bet)
Seat 4: Manon947 (small blind) folded before Flop
Seat 5: RichRick1337 (big blind) showed [Jc 6h] and won (322) with a pair of Jacks
Seat 8: color_singleton folded before Flop (didn't bet)
Seat 9: HighCardJasper showed [Jd 4c] and won (321) with a pair of Jacks



PokerStars Home Game Hand #216252538431: {Club #3225207}  Hold'em No Limit (50/100) - 2020/07/09 17:39:16 ET
Table 'lets goo' 9-max (Play Money) Seat #4 is the button
Seat 1: dddocky (10563 in chips) 
Seat 2: Duke Croix (18022 in chips) 
Seat 3: FragileMemory (24057 in chips) 
Seat 4: Manon947 (1626 in chips) 
Seat 5: RichRick1337 (12905 in chips) 
Seat 8: color_singleton (8859 in chips) 
Seat 9: HighCardJasper (7470 in chips) 
RichRick1337: posts small blind 50
color_singleton: posts big blind 100
*** HOLE CARDS ***
Dealt to Duke Croix [Kc Qd]
HighCardJasper: calls 100
dddocky: folds 
Duke Croix: raises 300 to 400
FragileMemory: folds 
Manon947: folds 
RichRick1337: calls 350
color_singleton: folds 
HighCardJasper: folds 
*** FLOP *** [3h 9h Kh]
RichRick1337: checks 
Duke Croix: bets 650
RichRick1337: folds 
Uncalled bet (650) returned to Duke Croix
Duke Croix collected 945 from pot
*** SUMMARY ***
Total pot 1000 | Rake 55 
Board [3h 9h Kh]
Seat 1: dddocky folded before Flop (didn't bet)
Seat 2: Duke Croix collected (945)
Seat 3: FragileMemory folded before Flop (didn't bet)
Seat 4: Manon947 (button) folded before Flop (didn't bet)
Seat 5: RichRick1337 (small blind) folded on the Flop
Seat 8: color_singleton (big blind) folded before Flop
Seat 9: HighCardJasper folded before Flop



PokerStars Home Game Hand #216252562644: {Club #3225207}  Hold'em No Limit (50/100) - 2020/07/09 17:39:56 ET
Table 'lets goo' 9-max (Play Money) Seat #5 is the button
Seat 1: dddocky (10563 in chips) 
Seat 2: Duke Croix (18567 in chips) 
Seat 3: FragileMemory (24057 in chips) 
Seat 4: Manon947 (1626 in chips) 
Seat 5: RichRick1337 (12505 in chips) 
Seat 8: color_singleton (8759 in chips) 
Seat 9: HighCardJasper (7370 in chips) 
color_singleton: posts small blind 50
HighCardJasper: posts big blind 100
*** HOLE CARDS ***
Dealt to Duke Croix [6h Qd]
dddocky: calls 100
Duke Croix: folds 
FragileMemory: calls 100
Manon947: folds 
RichRick1337: calls 100
color_singleton: raises 100 to 200
HighCardJasper: calls 100
dddocky: calls 100
FragileMemory: calls 100
RichRick1337: calls 100
*** FLOP *** [3d 4s 7d]
color_singleton: checks 
HighCardJasper: checks 
dddocky: checks 
FragileMemory: bets 472
RichRick1337: folds 
color_singleton: folds 
HighCardJasper: folds 
dddocky: folds 
Uncalled bet (472) returned to FragileMemory
FragileMemory collected 945 from pot
FragileMemory: doesn't show hand 
*** SUMMARY ***
Total pot 1000 | Rake 55 
Board [3d 4s 7d]
Seat 1: dddocky folded on the Flop
Seat 2: Duke Croix folded before Flop (didn't bet)
Seat 3: FragileMemory collected (945)
Seat 4: Manon947 folded before Flop (didn't bet)
Seat 5: RichRick1337 (button) folded on the Flop
Seat 8: color_singleton (small blind) folded on the Flop
Seat 9: HighCardJasper (big blind) folded on the Flop



PokerStars Home Game Hand #216252583783: {Club #3225207}  Hold'em No Limit (50/100) - 2020/07/09 17:40:32 ET
Table 'lets goo' 9-max (Play Money) Seat #8 is the button
Seat 1: dddocky (10363 in chips) 
Seat 2: Duke Croix (18567 in chips) 
Seat 3: FragileMemory (24802 in chips) 
Seat 4: Manon947 (1626 in chips) 
Seat 5: RichRick1337 (12305 in chips) 
Seat 8: color_singleton (8559 in chips) 
Seat 9: HighCardJasper (7170 in chips) 
HighCardJasper: posts small blind 50
dddocky: posts big blind 100
*** HOLE CARDS ***
Dealt to Duke Croix [Jc 4d]
Duke Croix: folds 
FragileMemory: calls 100
Manon947: folds 
RichRick1337: calls 100
color_singleton: folds 
HighCardJasper: calls 50
dddocky: checks 
*** FLOP *** [5h 6s Tc]
HighCardJasper: checks 
dddocky: checks 
FragileMemory: bets 189
RichRick1337: calls 189
HighCardJasper: folds 
dddocky: folds 
*** TURN *** [5h 6s Tc] [Kc]
FragileMemory: bets 367
RichRick1337: calls 367
*** RIVER *** [5h 6s Tc Kc] [2s]
FragileMemory: checks 
RichRick1337: checks 
*** SHOW DOWN ***
FragileMemory: shows [Ac 5c] (a pair of Fives)
RichRick1337: shows [Td 4s] (a pair of Tens)
RichRick1337 collected 1429 from pot
*** SUMMARY ***
Total pot 1512 | Rake 83 
Board [5h 6s Tc Kc 2s]
Seat 1: dddocky (big blind) folded on the Flop
Seat 2: Duke Croix folded before Flop (didn't bet)
Seat 3: FragileMemory showed [Ac 5c] and lost with a pair of Fives
Seat 4: Manon947 folded before Flop (didn't bet)
Seat 5: RichRick1337 showed [Td 4s] and won (1429) with a pair of Tens
Seat 8: color_singleton (button) folded before Flop (didn't bet)
Seat 9: HighCardJasper (small blind) folded on the Flop



PokerStars Home Game Hand #216252619007: {Club #3225207}  Hold'em No Limit (50/100) - 2020/07/09 17:41:31 ET
Table 'lets goo' 9-max (Play Money) Seat #9 is the button
Seat 1: dddocky (10263 in chips) 
Seat 2: Duke Croix (18567 in chips) 
Seat 3: FragileMemory (24146 in chips) 
Seat 4: Manon947 (1626 in chips) 
Seat 5: RichRick1337 (13078 in chips) 
Seat 8: color_singleton (8559 in chips) 
Seat 9: HighCardJasper (7070 in chips) 
dddocky: posts small blind 50
Duke Croix: posts big blind 100
*** HOLE CARDS ***
Dealt to Duke Croix [Td 3d]
FragileMemory: calls 100
Manon947: calls 100
RichRick1337: calls 100
color_singleton: folds 
HighCardJasper: calls 100
dddocky: calls 50
Duke Croix has timed out
Duke Croix: checks 
*** FLOP *** [5d 9d 2h]
dddocky: checks 
Duke Croix: bets 300
FragileMemory: folds 
Manon947: calls 300
RichRick1337: calls 300
HighCardJasper: folds 
dddocky: folds 
*** TURN *** [5d 9d 2h] [3s]
Duke Croix: bets 700
Manon947: folds 
RichRick1337: calls 700
*** RIVER *** [5d 9d 2h 3s] [6c]
Duke Croix: bets 1000
RichRick1337: calls 1000
*** SHOW DOWN ***
Duke Croix: shows [Td 3d] (a pair of Threes)
RichRick1337: shows [7c 9h] (a pair of Nines)
RichRick1337 collected 4630 from pot
*** SUMMARY ***
Total pot 4900 | Rake 270 
Board [5d 9d 2h 3s 6c]
Seat 1: dddocky (small blind) folded on the Flop
Seat 2: Duke Croix (big blind) showed [Td 3d] and lost with a pair of Threes
Seat 3: FragileMemory folded on the Flop
Seat 4: Manon947 folded on the Turn
Seat 5: RichRick1337 showed [7c 9h] and won (4630) with a pair of Nines
Seat 8: color_singleton folded before Flop (didn't bet)
Seat 9: HighCardJasper (button) folded on the Flop



PokerStars Home Game Hand #216252660235: {Club #3225207}  Hold'em No Limit (50/100) - 2020/07/09 17:42:41 ET
Table 'lets goo' 9-max (Play Money) Seat #1 is the button
Seat 1: dddocky (10163 in chips) 
Seat 2: Duke Croix (16467 in chips) 
Seat 3: FragileMemory (24046 in chips) 
Seat 4: Manon947 (1226 in chips) 
Seat 5: RichRick1337 (15608 in chips) 
Seat 8: color_singleton (8559 in chips) 
Seat 9: HighCardJasper (6970 in chips) 
Duke Croix: posts small blind 50
FragileMemory: posts big blind 100
*** HOLE CARDS ***
Dealt to Duke Croix [Ah 3h]
Manon947: folds 
RichRick1337: calls 100
color_singleton: folds 
HighCardJasper has timed out
HighCardJasper: folds 
dddocky: calls 100
Duke Croix: calls 50
FragileMemory: checks 
*** FLOP *** [3c 5s Th]
Duke Croix: bets 200
FragileMemory: calls 200
RichRick1337: calls 200
dddocky: calls 200
*** TURN *** [3c 5s Th] [2d]
Duke Croix: checks 
FragileMemory: checks 
RichRick1337: checks 
dddocky: checks 
*** RIVER *** [3c 5s Th 2d] [5h]
Duke Croix: checks 
FragileMemory: checks 
RichRick1337: checks 
dddocky: checks 
*** SHOW DOWN ***
Duke Croix: shows [Ah 3h] (two pair, Fives and Threes)
FragileMemory: mucks hand 
RichRick1337: mucks hand 
dddocky: mucks hand 
Duke Croix collected 1134 from pot
*** SUMMARY ***
Total pot 1200 | Rake 66 
Board [3c 5s Th 2d 5h]
Seat 1: dddocky (button) mucked [Qd Ac]
Seat 2: Duke Croix (small blind) showed [Ah 3h] and won (1134) with two pair, Fives and Threes
Seat 3: FragileMemory (big blind) mucked [Ks Qc]
Seat 4: Manon947 folded before Flop (didn't bet)
Seat 5: RichRick1337 mucked [6d Jh]
Seat 8: color_singleton folded before Flop (didn't bet)
Seat 9: HighCardJasper folded before Flop (didn't bet)



PokerStars Home Game Hand #216252705223: {Club #3225207}  Hold'em No Limit (50/100) - 2020/07/09 17:43:56 ET
Table 'lets goo' 9-max (Play Money) Seat #2 is the button
Seat 1: dddocky (9863 in chips) 
Seat 2: Duke Croix (17301 in chips) 
Seat 3: FragileMemory (23746 in chips) 
Seat 4: Manon947 (1226 in chips) 
Seat 8: color_singleton (8559 in chips) 
Seat 9: HighCardJasper (6970 in chips) 
FragileMemory: posts small blind 50
Manon947: posts big blind 100
*** HOLE CARDS ***
Dealt to Duke Croix [6h Qd]
color_singleton: raises 100 to 200
HighCardJasper: calls 200
dddocky: folds 
Duke Croix: folds 
FragileMemory: calls 150
Manon947: calls 100
*** FLOP *** [Th Qh Jh]
FragileMemory: checks 
Manon947: checks 
color_singleton: checks 
HighCardJasper: checks 
*** TURN *** [Th Qh Jh] [Kc]
FragileMemory: bets 378
Manon947: raises 378 to 756
color_singleton: folds 
HighCardJasper: folds 
FragileMemory: raises 22790 to 23546 and is all-in
Manon947: calls 270 and is all-in
Uncalled bet (22520) returned to FragileMemory
*** RIVER *** [Th Qh Jh Kc] [2s]
*** SHOW DOWN ***
FragileMemory: shows [Ad 7s] (a straight, Ten to Ace)
Manon947: shows [Ac 9s] (a straight, Ten to Ace)
FragileMemory collected 1348 from pot
Manon947 collected 1347 from pot
*** SUMMARY ***
Total pot 2852 | Rake 157 
Board [Th Qh Jh Kc 2s]
Seat 1: dddocky folded before Flop (didn't bet)
Seat 2: Duke Croix (button) folded before Flop (didn't bet)
Seat 3: FragileMemory (small blind) showed [Ad 7s] and won (1348) with a straight, Ten to Ace
Seat 4: Manon947 (big blind) showed [Ac 9s] and won (1347) with a straight, Ten to Ace
Seat 8: color_singleton folded on the Turn
Seat 9: HighCardJasper folded on the Turn



PokerStars Home Game Hand #216252734118: {Club #3225207}  Hold'em No Limit (50/100) - 2020/07/09 17:44:45 ET
Table 'lets goo' 9-max (Play Money) Seat #3 is the button
Seat 1: dddocky (9863 in chips) 
Seat 2: Duke Croix (17301 in chips) 
Seat 3: FragileMemory (23868 in chips) 
Seat 4: Manon947 (1347 in chips) 
Seat 8: color_singleton (8359 in chips) 
Seat 9: HighCardJasper (6770 in chips) 
Manon947: posts small blind 50
color_singleton: posts big blind 100
*** HOLE CARDS ***
Dealt to Duke Croix [6c 3s]
HighCardJasper: calls 100
dddocky: calls 100
Duke Croix: folds 
FragileMemory: calls 100
Manon947: calls 50
color_singleton: checks 
*** FLOP *** [9d 2s 2d]
Manon947: checks 
color_singleton: checks 
HighCardJasper: bets 200
dddocky: folds 
FragileMemory: folds 
Manon947: folds 
color_singleton: folds 
Uncalled bet (200) returned to HighCardJasper
HighCardJasper collected 472 from pot
HighCardJasper: doesn't show hand 
*** SUMMARY ***
Total pot 500 | Rake 28 
Board [9d 2s 2d]
Seat 1: dddocky folded on the Flop
Seat 2: Duke Croix folded before Flop (didn't bet)
Seat 3: FragileMemory (button) folded on the Flop
Seat 4: Manon947 (small blind) folded on the Flop
Seat 8: color_singleton (big blind) folded on the Flop
Seat 9: HighCardJasper collected (472)



PokerStars Home Game Hand #216252761734: {Club #3225207}  Hold'em No Limit (50/100) - 2020/07/09 17:45:32 ET
Table 'lets goo' 9-max (Play Money) Seat #4 is the button
Seat 1: dddocky (9763 in chips) 
Seat 2: Duke Croix (17301 in chips) 
Seat 3: FragileMemory (23768 in chips) 
Seat 4: Manon947 (1247 in chips) 
Seat 8: color_singleton (8259 in chips) 
Seat 9: HighCardJasper (7142 in chips) 
color_singleton: posts small blind 50
HighCardJasper: posts big blind 100
*** HOLE CARDS ***
Dealt to Duke Croix [Ah Js]
dddocky: calls 100
Duke Croix: raises 400 to 500
FragileMemory: calls 500
Manon947: folds 
color_singleton: calls 450
HighCardJasper: calls 400
dddocky: calls 400
*** FLOP *** [8h 2h 3h]
color_singleton: checks 
HighCardJasper: checks 
dddocky: bets 2362
Duke Croix: calls 2362
FragileMemory: folds 
color_singleton: folds 
HighCardJasper: folds 
*** TURN *** [8h 2h 3h] [Jc]
dddocky: checks 
Duke Croix: bets 2000
dddocky: calls 2000
*** RIVER *** [8h 2h 3h Jc] [6s]
dddocky: checks 
Duke Croix: checks 
*** SHOW DOWN ***
dddocky: shows [3c 8c] (two pair, Eights and Threes)
Duke Croix: mucks hand 
dddocky collected 10607 from pot
*** SUMMARY ***
Total pot 11224 | Rake 617 
Board [8h 2h 3h Jc 6s]
Seat 1: dddocky showed [3c 8c] and won (10607) with two pair, Eights and Threes
Seat 2: Duke Croix mucked [Ah Js]
Seat 3: FragileMemory folded on the Flop
Seat 4: Manon947 (button) folded before Flop (didn't bet)
Seat 8: color_singleton (small blind) folded on the Flop
Seat 9: HighCardJasper (big blind) folded on the Flop



PokerStars Home Game Hand #216252795768: {Club #3225207}  Hold'em No Limit (50/100) - 2020/07/09 17:46:29 ET
Table 'lets goo' 9-max (Play Money) Seat #8 is the button
Seat 1: dddocky (15508 in chips) 
Seat 2: Duke Croix (12439 in chips) 
Seat 4: Manon947 (1247 in chips) 
Seat 8: color_singleton (7759 in chips) 
Seat 9: HighCardJasper (6642 in chips) 
HighCardJasper: posts small blind 50
dddocky: posts big blind 100
*** HOLE CARDS ***
Dealt to Duke Croix [Tc 8s]
Duke Croix: folds 
Manon947: calls 100
color_singleton: folds 
HighCardJasper: calls 50
dddocky: checks 
*** FLOP *** [Kc Qh 6h]
HighCardJasper: checks 
dddocky: checks 
Manon947: bets 100
HighCardJasper: calls 100
dddocky: folds 
*** TURN *** [Kc Qh 6h] [3d]
HighCardJasper: checks 
FragileMemory leaves the table
Manon947: bets 236
HighCardJasper: calls 236
*** RIVER *** [Kc Qh 6h 3d] [7h]
HighCardJasper: bets 600
Manon947: raises 211 to 811 and is all-in
HighCardJasper: calls 211
*** SHOW DOWN ***
Manon947: shows [Kd Ad] (a pair of Kings)
HighCardJasper: shows [6d 7c] (two pair, Sevens and Sixes)
HighCardJasper collected 2451 from pot
*** SUMMARY ***
Total pot 2594 | Rake 143 
Board [Kc Qh 6h 3d 7h]
Seat 1: dddocky (big blind) folded on the Flop
Seat 2: Duke Croix folded before Flop (didn't bet)
Seat 4: Manon947 showed [Kd Ad] and lost with a pair of Kings
Seat 8: color_singleton (button) folded before Flop (didn't bet)
Seat 9: HighCardJasper (small blind) showed [6d 7c] and won (2451) with two pair, Sevens and Sixes



PokerStars Home Game Hand #216252831360: {Club #3225207}  Hold'em No Limit (50/100) - 2020/07/09 17:47:30 ET
Table 'lets goo' 9-max (Play Money) Seat #9 is the button
Seat 1: dddocky (15408 in chips) 
Seat 2: Duke Croix (12439 in chips) 
Seat 8: color_singleton (7759 in chips) 
Seat 9: HighCardJasper (7846 in chips) 
dddocky: posts small blind 50
Duke Croix: posts big blind 100
*** HOLE CARDS ***
Dealt to Duke Croix [Th 9d]
color_singleton: folds 
HighCardJasper: calls 100
dddocky: folds 
Duke Croix: checks 
*** FLOP *** [2c 9s 2h]
Duke Croix: bets 200
HighCardJasper: calls 200
*** TURN *** [2c 9s 2h] [6h]
Duke Croix: bets 400
HighCardJasper: folds 
Uncalled bet (400) returned to Duke Croix
Duke Croix collected 614 from pot
*** SUMMARY ***
Total pot 650 | Rake 36 
Board [2c 9s 2h 6h]
Seat 1: dddocky (small blind) folded before Flop
Seat 2: Duke Croix (big blind) collected (614)
Seat 8: color_singleton folded before Flop (didn't bet)
Seat 9: HighCardJasper (button) folded on the Turn



PokerStars Home Game Hand #216252851734: {Club #3225207}  Hold'em No Limit (50/100) - 2020/07/09 17:48:05 ET
Table 'lets goo' 9-max (Play Money) Seat #1 is the button
Seat 1: dddocky (15358 in chips) 
Seat 2: Duke Croix (12753 in chips) 
Seat 4: Manon947 (10000 in chips) 
Seat 8: color_singleton (7759 in chips) 
Seat 9: HighCardJasper (7546 in chips) 
Duke Croix: posts small blind 50
Manon947: posts big blind 100
*** HOLE CARDS ***
Dealt to Duke Croix [9d 8d]
color_singleton: raises 100 to 200
HighCardJasper: calls 200
dddocky: folds 
Duke Croix: calls 150
Manon947: calls 100
*** FLOP *** [5c 9s Td]
Duke Croix: bets 400
Manon947: calls 400
color_singleton: folds 
HighCardJasper: folds 
*** TURN *** [5c 9s Td] [6h]
Duke Croix: bets 700
Manon947: folds 
Uncalled bet (700) returned to Duke Croix
Duke Croix collected 1512 from pot
*** SUMMARY ***
Total pot 1600 | Rake 88 
Board [5c 9s Td 6h]
Seat 1: dddocky (button) folded before Flop (didn't bet)
Seat 2: Duke Croix (small blind) collected (1512)
Seat 4: Manon947 (big blind) folded on the Turn
Seat 8: color_singleton folded on the Flop
Seat 9: HighCardJasper folded on the Flop



PokerStars Home Game Hand #216252870340: {Club #3225207}  Hold'em No Limit (50/100) - 2020/07/09 17:48:36 ET
Table 'lets goo' 9-max (Play Money) Seat #2 is the button
Seat 1: dddocky (15358 in chips) 
Seat 2: Duke Croix (13665 in chips) 
Seat 4: Manon947 (9400 in chips) 
Seat 8: color_singleton (7559 in chips) 
Seat 9: HighCardJasper (7346 in chips) 
Manon947: posts small blind 50
color_singleton: posts big blind 100
*** HOLE CARDS ***
Dealt to Duke Croix [3s 7h]
HighCardJasper: calls 100
dddocky: calls 100
Duke Croix: folds 
Manon947: calls 50
color_singleton: raises 200 to 300
HighCardJasper: calls 200
dddocky: calls 200
Manon947: folds 
*** FLOP *** [5c 4s Qc]
color_singleton: bets 472
HighCardJasper: folds 
dddocky: calls 472
*** TURN *** [5c 4s Qc] [8h]
color_singleton: checks 
dddocky: checks 
*** RIVER *** [5c 4s Qc 8h] [6c]
color_singleton: bets 1837
dddocky: calls 1837
*** SHOW DOWN ***
color_singleton: shows [6h 6d] (three of a kind, Sixes)
dddocky: shows [Kc 3c] (a flush, King high)
dddocky collected 5309 from pot
*** SUMMARY ***
Total pot 5618 | Rake 309 
Board [5c 4s Qc 8h 6c]
Seat 1: dddocky showed [Kc 3c] and won (5309) with a flush, King high
Seat 2: Duke Croix (button) folded before Flop (didn't bet)
Seat 4: Manon947 (small blind) folded before Flop
Seat 8: color_singleton (big blind) showed [6h 6d] and lost with three of a kind, Sixes
Seat 9: HighCardJasper folded on the Flop



PokerStars Home Game Hand #216252903467: {Club #3225207}  Hold'em No Limit (50/100) - 2020/07/09 17:49:33 ET
Table 'lets goo' 9-max (Play Money) Seat #4 is the button
Seat 1: dddocky (18058 in chips) 
Seat 2: Duke Croix (13665 in chips) 
Seat 4: Manon947 (9300 in chips) 
Seat 8: color_singleton (4950 in chips) 
Seat 9: HighCardJasper (7046 in chips) 
color_singleton: posts small blind 50
HighCardJasper: posts big blind 100
*** HOLE CARDS ***
Dealt to Duke Croix [Qd Kh]
dddocky: calls 100
Duke Croix: raises 300 to 400
Manon947: folds 
color_singleton: calls 350
HighCardJasper: folds 
dddocky: folds 
*** FLOP *** [2s Td Ah]
color_singleton: checks 
Duke Croix: checks 
*** TURN *** [2s Td Ah] [6c]
color_singleton: checks 
Duke Croix: checks 
*** RIVER *** [2s Td Ah 6c] [9c]
color_singleton: checks 
Duke Croix: checks 
*** SHOW DOWN ***
color_singleton: shows [8c 8s] (a pair of Eights)
Duke Croix: mucks hand 
color_singleton collected 945 from pot
*** SUMMARY ***
Total pot 1000 | Rake 55 
Board [2s Td Ah 6c 9c]
Seat 1: dddocky folded before Flop
Seat 2: Duke Croix mucked [Qd Kh]
Seat 4: Manon947 (button) folded before Flop (didn't bet)
Seat 8: color_singleton (small blind) showed [8c 8s] and won (945) with a pair of Eights
Seat 9: HighCardJasper (big blind) folded before Flop



PokerStars Home Game Hand #216252921004: {Club #3225207}  Hold'em No Limit (50/100) - 2020/07/09 17:50:04 ET
Table 'lets goo' 9-max (Play Money) Seat #8 is the button
Seat 1: dddocky (17958 in chips) 
Seat 2: Duke Croix (13265 in chips) 
Seat 4: Manon947 (9300 in chips) 
Seat 8: color_singleton (5495 in chips) 
Seat 9: HighCardJasper (6946 in chips) 
HighCardJasper: posts small blind 50
dddocky: posts big blind 100
*** HOLE CARDS ***
Dealt to Duke Croix [9s 8c]
Duke Croix: calls 100
Manon947: calls 100
color_singleton: calls 100
HighCardJasper: raises 100 to 200
dddocky: folds 
Duke Croix: calls 100
Manon947: calls 100
color_singleton: calls 100
*** FLOP *** [4c Qs 9h]
HighCardJasper: checks 
Duke Croix: bets 400
Manon947: calls 400
color_singleton: folds 
HighCardJasper: folds 
*** TURN *** [4c Qs 9h] [7c]
Duke Croix: bets 900
Manon947: folds 
Uncalled bet (900) returned to Duke Croix
Duke Croix collected 1606 from pot
*** SUMMARY ***
Total pot 1700 | Rake 94 
Board [4c Qs 9h 7c]
Seat 1: dddocky (big blind) folded before Flop
Seat 2: Duke Croix collected (1606)
Seat 4: Manon947 folded on the Turn
Seat 8: color_singleton (button) folded on the Flop
Seat 9: HighCardJasper (small blind) folded on the Flop



PokerStars Home Game Hand #216252944930: {Club #3225207}  Hold'em No Limit (50/100) - 2020/07/09 17:50:45 ET
Table 'lets goo' 9-max (Play Money) Seat #9 is the button
Seat 1: dddocky (17858 in chips) 
Seat 2: Duke Croix (14271 in chips) 
Seat 4: Manon947 (8700 in chips) 
Seat 8: color_singleton (5295 in chips) 
Seat 9: HighCardJasper (6746 in chips) 
dddocky: posts small blind 50
Duke Croix: posts big blind 100
*** HOLE CARDS ***
Dealt to Duke Croix [4d 2d]
Manon947: calls 100
color_singleton: calls 100
HighCardJasper: calls 100
dddocky: calls 50
Duke Croix: checks 
*** FLOP *** [Tc 7h 8d]
dddocky: bets 100
Duke Croix: calls 100
Manon947: calls 100
color_singleton: calls 100
HighCardJasper: calls 100
*** TURN *** [Tc 7h 8d] [9d]
dddocky: checks 
Duke Croix: bets 300
Manon947: calls 300
color_singleton: calls 300
HighCardJasper: folds 
dddocky: raises 300 to 600
Duke Croix: calls 300
Manon947: calls 300
color_singleton: calls 300
*** RIVER *** [Tc 7h 8d 9d] [3d]
dddocky: bets 100
Duke Croix: raises 1400 to 1500
Manon947: calls 1500
color_singleton: folds 
dddocky: calls 1400
*** SHOW DOWN ***
Duke Croix: shows [4d 2d] (a flush, Nine high)
Manon947: mucks hand 
dddocky: mucks hand 
Duke Croix collected 7465 from pot
*** SUMMARY ***
Total pot 7900 | Rake 435 
Board [Tc 7h 8d 9d 3d]
Seat 1: dddocky (small blind) mucked [9s Js]
Seat 2: Duke Croix (big blind) showed [4d 2d] and won (7465) with a flush, Nine high
Seat 4: Manon947 mucked [6c 2c]
Seat 8: color_singleton folded on the River
Seat 9: HighCardJasper (button) folded on the Turn



PokerStars Home Game Hand #216252990082: {Club #3225207}  Hold'em No Limit (50/100) - 2020/07/09 17:51:55 ET
Table 'lets goo' 9-max (Play Money) Seat #1 is the button
Seat 1: dddocky (15558 in chips) 
Seat 2: Duke Croix (19436 in chips) 
Seat 4: Manon947 (6400 in chips) 
Seat 8: color_singleton (4495 in chips) 
Seat 9: HighCardJasper (6546 in chips) 
Duke Croix: posts small blind 50
Manon947: posts big blind 100
*** HOLE CARDS ***
Dealt to Duke Croix [2s Ah]
color_singleton: raises 100 to 200
HighCardJasper: calls 200
dddocky: folds 
Duke Croix: calls 150
Manon947: calls 100
*** FLOP *** [4s 4h 4d]
Duke Croix: checks 
Manon947: checks 
color_singleton: bets 378
HighCardJasper: folds 
Duke Croix: folds 
Manon947: folds 
Uncalled bet (378) returned to color_singleton
color_singleton collected 756 from pot
color_singleton: doesn't show hand 
*** SUMMARY ***
Total pot 800 | Rake 44 
Board [4s 4h 4d]
Seat 1: dddocky (button) folded before Flop (didn't bet)
Seat 2: Duke Croix (small blind) folded on the Flop
Seat 4: Manon947 (big blind) folded on the Flop
Seat 8: color_singleton collected (756)
Seat 9: HighCardJasper folded on the Flop



PokerStars Home Game Hand #216253006427: {Club #3225207}  Hold'em No Limit (50/100) - 2020/07/09 17:52:24 ET
Table 'lets goo' 9-max (Play Money) Seat #2 is the button
Seat 1: dddocky (15558 in chips) 
Seat 2: Duke Croix (19236 in chips) 
Seat 4: Manon947 (6200 in chips) 
Seat 8: color_singleton (5051 in chips) 
Seat 9: HighCardJasper (6346 in chips) 
Manon947: posts small blind 50
color_singleton: posts big blind 100
*** HOLE CARDS ***
Dealt to Duke Croix [6s 2d]
HighCardJasper: raises 100 to 200
dddocky: calls 200
Duke Croix: folds 
Manon947: folds 
color_singleton: calls 100
*** FLOP *** [6c 2s 3c]
color_singleton: checks 
HighCardJasper: checks 
dddocky: checks 
*** TURN *** [6c 2s 3c] [7h]
color_singleton: bets 307
HighCardJasper: folds 
dddocky: folds 
Uncalled bet (307) returned to color_singleton
color_singleton collected 614 from pot
color_singleton: doesn't show hand 
*** SUMMARY ***
Total pot 650 | Rake 36 
Board [6c 2s 3c 7h]
Seat 1: dddocky folded on the Turn
Seat 2: Duke Croix (button) folded before Flop (didn't bet)
Seat 4: Manon947 (small blind) folded before Flop
Seat 8: color_singleton (big blind) collected (614)
Seat 9: HighCardJasper folded on the Turn



PokerStars Home Game Hand #216253019523: {Club #3225207}  Hold'em No Limit (50/100) - 2020/07/09 17:52:47 ET
Table 'lets goo' 9-max (Play Money) Seat #4 is the button
Seat 1: dddocky (15358 in chips) 
Seat 2: Duke Croix (19236 in chips) 
Seat 4: Manon947 (6150 in chips) 
Seat 8: color_singleton (5465 in chips) 
Seat 9: HighCardJasper (6146 in chips) 
color_singleton: posts small blind 50
HighCardJasper: posts big blind 100
*** HOLE CARDS ***
Dealt to Duke Croix [Qh Kc]
dddocky: calls 100
Duke Croix: raises 400 to 500
Manon947: folds 
color_singleton: calls 450
HighCardJasper: folds 
dddocky: calls 400
*** FLOP *** [4h 2c 4s]
color_singleton: bets 756
dddocky: folds 
Duke Croix: folds 
Uncalled bet (756) returned to color_singleton
color_singleton collected 1512 from pot
color_singleton: doesn't show hand 
*** SUMMARY ***
Total pot 1600 | Rake 88 
Board [4h 2c 4s]
Seat 1: dddocky folded on the Flop
Seat 2: Duke Croix folded on the Flop
Seat 4: Manon947 (button) folded before Flop (didn't bet)
Seat 8: color_singleton (small blind) collected (1512)
Seat 9: HighCardJasper (big blind) folded before Flop



PokerStars Home Game Hand #216253032416: {Club #3225207}  Hold'em No Limit (50/100) - 2020/07/09 17:53:10 ET
Table 'lets goo' 9-max (Play Money) Seat #8 is the button
Seat 1: dddocky (14858 in chips) 
Seat 2: Duke Croix (18736 in chips) 
Seat 4: Manon947 (6150 in chips) 
Seat 5: RichRick1337 (15308 in chips) 
Seat 8: color_singleton (6477 in chips) 
Seat 9: HighCardJasper (6046 in chips) 
HighCardJasper: posts small blind 50
dddocky: posts big blind 100
RichRick1337: posts small & big blinds 150
*** HOLE CARDS ***
Dealt to Duke Croix [4h 7d]
Duke Croix: folds 
Manon947: calls 100
RichRick1337: checks 
color_singleton: folds 
HighCardJasper: calls 50
dddocky: checks 
*** FLOP *** [Ac 5d Ks]
HighCardJasper: checks 
dddocky: checks 
Manon947: checks 
RichRick1337: checks 
*** TURN *** [Ac 5d Ks] [2h]
HighCardJasper: bets 200
dddocky: folds 
Manon947: folds 
RichRick1337: folds 
Uncalled bet (200) returned to HighCardJasper
HighCardJasper collected 425 from pot
HighCardJasper: doesn't show hand 
*** SUMMARY ***
Total pot 450 | Rake 25 
Board [Ac 5d Ks 2h]
Seat 1: dddocky (big blind) folded on the Turn
Seat 2: Duke Croix folded before Flop (didn't bet)
Seat 4: Manon947 folded on the Turn
Seat 5: RichRick1337 folded on the Turn (didn't bet)
Seat 8: color_singleton (button) folded before Flop (didn't bet)
Seat 9: HighCardJasper (small blind) collected (425)



PokerStars Home Game Hand #216253057684: {Club #3225207}  Hold'em No Limit (50/100) - 2020/07/09 17:53:54 ET
Table 'lets goo' 9-max (Play Money) Seat #9 is the button
Seat 1: dddocky (14758 in chips) 
Seat 2: Duke Croix (18736 in chips) 
Seat 4: Manon947 (6050 in chips) 
Seat 5: RichRick1337 (15158 in chips) 
Seat 8: color_singleton (6477 in chips) 
Seat 9: HighCardJasper (6371 in chips) 
dddocky: posts small blind 50
Duke Croix: posts big blind 100
*** HOLE CARDS ***
Dealt to Duke Croix [Qh 8c]
Manon947: calls 100
RichRick1337: folds 
color_singleton: folds 
HighCardJasper: calls 100
dddocky: calls 50
Duke Croix: checks 
*** FLOP *** [Qd 2c 5d]
dddocky: checks 
Duke Croix: bets 200
Manon947: folds 
HighCardJasper: folds 
dddocky: folds 
Uncalled bet (200) returned to Duke Croix
Duke Croix collected 378 from pot
*** SUMMARY ***
Total pot 400 | Rake 22 
Board [Qd 2c 5d]
Seat 1: dddocky (small blind) folded on the Flop
Seat 2: Duke Croix (big blind) collected (378)
Seat 4: Manon947 folded on the Flop
Seat 5: RichRick1337 folded before Flop (didn't bet)
Seat 8: color_singleton folded before Flop (didn't bet)
Seat 9: HighCardJasper (button) folded on the Flop



PokerStars Home Game Hand #216253079469: {Club #3225207}  Hold'em No Limit (50/100) - 2020/07/09 17:54:33 ET
Table 'lets goo' 9-max (Play Money) Seat #1 is the button
Seat 1: dddocky (14658 in chips) 
Seat 2: Duke Croix (19014 in chips) 
Seat 4: Manon947 (5950 in chips) 
Seat 5: RichRick1337 (15158 in chips) 
Seat 8: color_singleton (6477 in chips) 
Seat 9: HighCardJasper (6271 in chips) 
Duke Croix: posts small blind 50
Manon947: posts big blind 100
*** HOLE CARDS ***
Dealt to Duke Croix [5s 9h]
RichRick1337: calls 100
color_singleton: calls 100
HighCardJasper: calls 100
dddocky: calls 100
Duke Croix: calls 50
Manon947: checks 
*** FLOP *** [Jh Kc Jd]
Duke Croix: checks 
Manon947: checks 
RichRick1337: checks 
color_singleton: checks 
HighCardJasper: checks 
dddocky: checks 
*** TURN *** [Jh Kc Jd] [7d]
Duke Croix: checks 
Manon947: checks 
RichRick1337: checks 
color_singleton: bets 283
HighCardJasper: folds 
dddocky: calls 283
Duke Croix: folds 
Manon947: folds 
RichRick1337: folds 
*** RIVER *** [Jh Kc Jd 7d] [9s]
color_singleton: bets 600
dddocky: calls 600
*** SHOW DOWN ***
color_singleton: shows [9c Js] (a full house, Jacks full of Nines)
dddocky: mucks hand 
color_singleton collected 2236 from pot
*** SUMMARY ***
Total pot 2366 | Rake 130 
Board [Jh Kc Jd 7d 9s]
Seat 1: dddocky (button) mucked [Kd 8c]
Seat 2: Duke Croix (small blind) folded on the Turn
Seat 4: Manon947 (big blind) folded on the Turn
Seat 5: RichRick1337 folded on the Turn
Seat 8: color_singleton showed [9c Js] and won (2236) with a full house, Jacks full of Nines
Seat 9: HighCardJasper folded on the Turn



PokerStars Home Game Hand #216253111720: {Club #3225207}  Hold'em No Limit (50/100) - 2020/07/09 17:55:39 ET
Table 'lets goo' 9-max (Play Money) Seat #2 is the button
Seat 1: dddocky (13675 in chips) 
Seat 2: Duke Croix (18914 in chips) 
Seat 4: Manon947 (5850 in chips) 
Seat 5: RichRick1337 (15058 in chips) 
Seat 8: color_singleton (7730 in chips) 
Seat 9: HighCardJasper (6171 in chips) 
Manon947: posts small blind 50
RichRick1337: posts big blind 100
*** HOLE CARDS ***
Dealt to Duke Croix [Kd 3c]
color_singleton: folds 
HighCardJasper: calls 100
dddocky: calls 100
Duke Croix: folds 
Manon947: calls 50
RichRick1337: checks 
*** FLOP *** [4c 5h Ad]
Manon947: checks 
RichRick1337: checks 
HighCardJasper: checks 
dddocky: checks 
*** TURN *** [4c 5h Ad] [As]
Manon947: checks 
RichRick1337: checks 
HighCardJasper: checks 
dddocky: checks 
*** RIVER *** [4c 5h Ad As] [Qd]
Manon947: checks 
RichRick1337: checks 
HighCardJasper: checks 
dddocky: checks 
*** SHOW DOWN ***
Manon947: shows [Ts 5d] (two pair, Aces and Fives)
RichRick1337: mucks hand 
HighCardJasper: mucks hand 
dddocky: mucks hand 
Manon947 collected 378 from pot
*** SUMMARY ***
Total pot 400 | Rake 22 
Board [4c 5h Ad As Qd]
Seat 1: dddocky mucked [4h Jh]
Seat 2: Duke Croix (button) folded before Flop (didn't bet)
Seat 4: Manon947 (small blind) showed [Ts 5d] and won (378) with two pair, Aces and Fives
Seat 5: RichRick1337 (big blind) mucked [8c Ks]
Seat 8: color_singleton folded before Flop (didn't bet)
Seat 9: HighCardJasper mucked [2d Jc]



PokerStars Home Game Hand #216253129321: {Club #3225207}  Hold'em No Limit (50/100) - 2020/07/09 17:56:19 ET
Table 'lets goo' 9-max (Play Money) Seat #4 is the button
Seat 1: dddocky (13575 in chips) 
Seat 2: Duke Croix (18914 in chips) 
Seat 4: Manon947 (6128 in chips) 
Seat 5: RichRick1337 (14958 in chips) 
Seat 8: color_singleton (7730 in chips) 
Seat 9: HighCardJasper (6071 in chips) 
RichRick1337: posts small blind 50
color_singleton: posts big blind 100
*** HOLE CARDS ***
Dealt to Duke Croix [5c 8h]
HighCardJasper: calls 100
dddocky: folds 
Duke Croix: folds 
Manon947: calls 100
RichRick1337: calls 50
color_singleton: checks 
*** FLOP *** [As 2s 2c]
RichRick1337: checks 
color_singleton: checks 
HighCardJasper: checks 
Manon947: checks 
*** TURN *** [As 2s 2c] [Tc]
RichRick1337: checks 
color_singleton: checks 
HighCardJasper: checks 
Manon947: checks 
*** RIVER *** [As 2s 2c Tc] [9h]
RichRick1337: bets 378
color_singleton: folds 
HighCardJasper: folds 
Manon947: raises 378 to 756
RichRick1337: calls 378
*** SHOW DOWN ***
Manon947: shows [Jd 9s] (two pair, Nines and Deuces)
RichRick1337: shows [Ts 6h] (two pair, Tens and Deuces)
RichRick1337 collected 1807 from pot
*** SUMMARY ***
Total pot 1912 | Rake 105 
Board [As 2s 2c Tc 9h]
Seat 1: dddocky folded before Flop (didn't bet)
Seat 2: Duke Croix folded before Flop (didn't bet)
Seat 4: Manon947 (button) showed [Jd 9s] and lost with two pair, Nines and Deuces
Seat 5: RichRick1337 (small blind) showed [Ts 6h] and won (1807) with two pair, Tens and Deuces
Seat 8: color_singleton (big blind) folded on the River
Seat 9: HighCardJasper folded on the River



PokerStars Home Game Hand #216253150619: {Club #3225207}  Hold'em No Limit (50/100) - 2020/07/09 17:57:08 ET
Table 'lets goo' 9-max (Play Money) Seat #5 is the button
Seat 1: dddocky (13575 in chips) 
Seat 2: Duke Croix (18914 in chips) 
Seat 4: Manon947 (5272 in chips) 
Seat 5: RichRick1337 (15909 in chips) 
Seat 8: color_singleton (7630 in chips) 
Seat 9: HighCardJasper (5971 in chips) 
color_singleton: posts small blind 50
HighCardJasper: posts big blind 100
*** HOLE CARDS ***
Dealt to Duke Croix [8d Jh]
dddocky: calls 100
Duke Croix: folds 
Manon947: calls 100
RichRick1337: calls 100
color_singleton: folds 
HighCardJasper: checks 
*** FLOP *** [3c Jc 9h]
HighCardJasper: checks 
dddocky: checks 
Manon947: checks 
RichRick1337: checks 
*** TURN *** [3c Jc 9h] [3h]
HighCardJasper: checks 
dddocky: checks 
Manon947: checks 
RichRick1337: bets 425
HighCardJasper: folds 
dddocky: folds 
Manon947: folds 
Uncalled bet (425) returned to RichRick1337
RichRick1337 collected 425 from pot
RichRick1337: doesn't show hand 
*** SUMMARY ***
Total pot 450 | Rake 25 
Board [3c Jc 9h 3h]
Seat 1: dddocky folded on the Turn
Seat 2: Duke Croix folded before Flop (didn't bet)
Seat 4: Manon947 folded on the Turn
Seat 5: RichRick1337 (button) collected (425)
Seat 8: color_singleton (small blind) folded before Flop
Seat 9: HighCardJasper (big blind) folded on the Turn



PokerStars Home Game Hand #216253170483: {Club #3225207}  Hold'em No Limit (50/100) - 2020/07/09 17:57:53 ET
Table 'lets goo' 9-max (Play Money) Seat #8 is the button
Seat 1: dddocky (13475 in chips) 
Seat 2: Duke Croix (18914 in chips) 
Seat 4: Manon947 (5172 in chips) 
Seat 5: RichRick1337 (16234 in chips) 
Seat 8: color_singleton (7580 in chips) 
Seat 9: HighCardJasper (5871 in chips) 
HighCardJasper: posts small blind 50
dddocky: posts big blind 100
*** HOLE CARDS ***
Dealt to Duke Croix [3h 9c]
Duke Croix: folds 
Manon947: calls 100
RichRick1337: raises 100 to 200
color_singleton: calls 200
HighCardJasper: calls 150
dddocky: folds 
Manon947: calls 100
*** FLOP *** [5d Qd Jc]
HighCardJasper: checks 
Manon947: checks 
RichRick1337: bets 100
color_singleton: calls 100
HighCardJasper: calls 100
Manon947: calls 100
*** TURN *** [5d Qd Jc] [4s]
HighCardJasper: checks 
Manon947: bets 614
RichRick1337: calls 614
color_singleton: folds 
HighCardJasper: folds 
*** RIVER *** [5d Qd Jc 4s] [Th]
Manon947: bets 1194
RichRick1337: calls 1194
*** SHOW DOWN ***
Manon947: shows [Kc 4h] (a pair of Fours)
RichRick1337: shows [As 5s] (a pair of Fives)
RichRick1337 collected 4646 from pot
*** SUMMARY ***
Total pot 4916 | Rake 270 
Board [5d Qd Jc 4s Th]
Seat 1: dddocky (big blind) folded before Flop
Seat 2: Duke Croix folded before Flop (didn't bet)
Seat 4: Manon947 showed [Kc 4h] and lost with a pair of Fours
Seat 5: RichRick1337 showed [As 5s] and won (4646) with a pair of Fives
Seat 8: color_singleton (button) folded on the Turn
Seat 9: HighCardJasper (small blind) folded on the Turn



PokerStars Home Game Hand #216253202964: {Club #3225207}  Hold'em No Limit (50/100) - 2020/07/09 17:59:06 ET
Table 'lets goo' 9-max (Play Money) Seat #9 is the button
Seat 1: dddocky (13375 in chips) 
Seat 2: Duke Croix (18914 in chips) 
Seat 4: Manon947 (3064 in chips) 
Seat 5: RichRick1337 (18772 in chips) 
Seat 8: color_singleton (7280 in chips) 
Seat 9: HighCardJasper (5571 in chips) 
dddocky: posts small blind 50
Duke Croix: posts big blind 100
*** HOLE CARDS ***
Dealt to Duke Croix [7d 2h]
Manon947: calls 100
RichRick1337: calls 100
color_singleton: folds 
HighCardJasper: calls 100
dddocky: calls 50
Duke Croix: checks 
*** FLOP *** [6c Ah 6h]
dddocky: checks 
Duke Croix: checks 
Manon947: checks 
RichRick1337: checks 
HighCardJasper: checks 
*** TURN *** [6c Ah 6h] [3c]
dddocky: bets 100
Duke Croix: folds 
Manon947: calls 100
RichRick1337: calls 100
HighCardJasper: calls 100
*** RIVER *** [6c Ah 6h 3c] [8h]
dddocky: bets 100
Manon947: calls 100
RichRick1337: calls 100
HighCardJasper: folds 
*** SHOW DOWN ***
dddocky: shows [5h As] (two pair, Aces and Sixes)
Manon947: mucks hand 
RichRick1337: mucks hand 
dddocky collected 1134 from pot
*** SUMMARY ***
Total pot 1200 | Rake 66 
Board [6c Ah 6h 3c 8h]
Seat 1: dddocky (small blind) showed [5h As] and won (1134) with two pair, Aces and Sixes
Seat 2: Duke Croix (big blind) folded on the Turn
Seat 4: Manon947 mucked [Qd Kd]
Seat 5: RichRick1337 mucked [7c Ks]
Seat 8: color_singleton folded before Flop (didn't bet)
Seat 9: HighCardJasper (button) folded on the River



PokerStars Home Game Hand #216253227662: {Club #3225207}  Hold'em No Limit (50/100) - 2020/07/09 18:00:01 ET
Table 'lets goo' 9-max (Play Money) Seat #1 is the button
Seat 1: dddocky (14209 in chips) 
Seat 2: Duke Croix (18814 in chips) 
Seat 4: Manon947 (2764 in chips) 
Seat 5: RichRick1337 (18472 in chips) 
Seat 8: color_singleton (7280 in chips) 
Seat 9: HighCardJasper (5371 in chips) 
Duke Croix: posts small blind 50
Manon947: posts big blind 100
*** HOLE CARDS ***
Dealt to Duke Croix [9h Jd]
RichRick1337: raises 100 to 200
color_singleton: folds 
HighCardJasper: folds 
dddocky: calls 200
Duke Croix: calls 150
Manon947: folds 
*** FLOP *** [Ts Qc 5d]
Duke Croix: bets 300
RichRick1337: calls 300
dddocky: folds 
*** TURN *** [Ts Qc 5d] [4c]
Duke Croix: bets 800
RichRick1337: calls 800
*** RIVER *** [Ts Qc 5d 4c] [9c]
Duke Croix: checks 
RichRick1337: checks 
*** SHOW DOWN ***
Duke Croix: shows [9h Jd] (a pair of Nines)
RichRick1337: mucks hand 
Duke Croix collected 2740 from pot
*** SUMMARY ***
Total pot 2900 | Rake 160 
Board [Ts Qc 5d 4c 9c]
Seat 1: dddocky (button) folded on the Flop
Seat 2: Duke Croix (small blind) showed [9h Jd] and won (2740) with a pair of Nines
Seat 4: Manon947 (big blind) folded before Flop
Seat 5: RichRick1337 mucked [3c 9s]
Seat 8: color_singleton folded before Flop (didn't bet)
Seat 9: HighCardJasper folded before Flop (didn't bet)



PokerStars Home Game Hand #216253241938: {Club #3225207}  Hold'em No Limit (50/100) - 2020/07/09 18:00:31 ET
Table 'lets goo' 9-max (Play Money) Seat #2 is the button
Seat 1: dddocky (14009 in chips) 
Seat 2: Duke Croix (20254 in chips) 
Seat 4: Manon947 (2664 in chips) 
Seat 5: RichRick1337 (17172 in chips) 
Seat 8: color_singleton (7280 in chips) 
Seat 9: HighCardJasper (5371 in chips) 
Manon947: posts small blind 50
RichRick1337: posts big blind 100
*** HOLE CARDS ***
Dealt to Duke Croix [Kd 2h]
color_singleton: folds 
HighCardJasper: calls 100
dddocky: calls 100
Duke Croix: folds 
Manon947: calls 50
RichRick1337: checks 
*** FLOP *** [5c Td 8s]
Manon947: bets 100
RichRick1337: folds 
HighCardJasper: calls 100
dddocky: folds 
*** TURN *** [5c Td 8s] [Ts]
Manon947: bets 100
HighCardJasper: calls 100
*** RIVER *** [5c Td 8s Ts] [Jc]
Manon947: bets 100
HighCardJasper: raises 300 to 400
Manon947: calls 300
*** SHOW DOWN ***
HighCardJasper: shows [8c 5d] (two pair, Tens and Eights)
Manon947: mucks hand 
HighCardJasper collected 1512 from pot
*** SUMMARY ***
Total pot 1600 | Rake 88 
Board [5c Td 8s Ts Jc]
Seat 1: dddocky folded on the Flop
Seat 2: Duke Croix (button) folded before Flop (didn't bet)
Seat 4: Manon947 (small blind) mucked [Ad Kc]
Seat 5: RichRick1337 (big blind) folded on the Flop
Seat 8: color_singleton folded before Flop (didn't bet)
Seat 9: HighCardJasper showed [8c 5d] and won (1512) with two pair, Tens and Eights



PokerStars Home Game Hand #216253268619: {Club #3225207}  Hold'em No Limit (50/100) - 2020/07/09 18:01:24 ET
Table 'lets goo' 9-max (Play Money) Seat #4 is the button
Seat 1: dddocky (13909 in chips) 
Seat 2: Duke Croix (20254 in chips) 
Seat 4: Manon947 (1964 in chips) 
Seat 5: RichRick1337 (17072 in chips) 
Seat 8: color_singleton (7280 in chips) 
Seat 9: HighCardJasper (6183 in chips) 
RichRick1337: posts small blind 50
color_singleton: posts big blind 100
*** HOLE CARDS ***
Dealt to Duke Croix [Ah Ts]
HighCardJasper: calls 100
dddocky: folds 
Duke Croix: raises 300 to 400
Manon947: folds 
RichRick1337: calls 350
color_singleton: folds 
HighCardJasper: folds 
*** FLOP *** [Kc Th Qh]
RichRick1337: checks 
Duke Croix: bets 500
RichRick1337: calls 500
*** TURN *** [Kc Th Qh] [9s]
RichRick1337: checks 
Duke Croix: checks 
*** RIVER *** [Kc Th Qh 9s] [Kd]
RichRick1337: bets 1890
Duke Croix: folds 
Uncalled bet (1890) returned to RichRick1337
RichRick1337 collected 1890 from pot
RichRick1337: doesn't show hand 
*** SUMMARY ***
Total pot 2000 | Rake 110 
Board [Kc Th Qh 9s Kd]
Seat 1: dddocky folded before Flop (didn't bet)
Seat 2: Duke Croix folded on the River
Seat 4: Manon947 (button) folded before Flop (didn't bet)
Seat 5: RichRick1337 (small blind) collected (1890)
Seat 8: color_singleton (big blind) folded before Flop
Seat 9: HighCardJasper folded before Flop



PokerStars Home Game Hand #216253302028: {Club #3225207}  Hold'em No Limit (50/100) - 2020/07/09 18:02:25 ET
Table 'lets goo' 9-max (Play Money) Seat #5 is the button
Seat 1: dddocky (13909 in chips) 
Seat 2: Duke Croix (19354 in chips) 
Seat 4: Manon947 (1964 in chips) 
Seat 5: RichRick1337 (18062 in chips) 
Seat 8: color_singleton (7180 in chips) 
Seat 9: HighCardJasper (6083 in chips) 
color_singleton: posts small blind 50
HighCardJasper: posts big blind 100
*** HOLE CARDS ***
Dealt to Duke Croix [Kh 9c]
dddocky: calls 100
Duke Croix: calls 100
Manon947: calls 100
RichRick1337: calls 100
color_singleton: calls 50
HighCardJasper: raises 200 to 300
dddocky: calls 200
Duke Croix: calls 200
Manon947: folds 
RichRick1337: calls 200
color_singleton: calls 200
*** FLOP *** [As 5c 9s]
color_singleton: checks 
HighCardJasper: bets 200
dddocky: folds 
Duke Croix: calls 200
RichRick1337: folds 
color_singleton: folds 
*** TURN *** [As 5c 9s] [9h]
HighCardJasper: bets 300
Duke Croix: raises 600 to 900
HighCardJasper: calls 600
*** RIVER *** [As 5c 9s 9h] [Qd]
HighCardJasper: bets 1000
Duke Croix: raises 1000 to 2000
HighCardJasper: raises 2683 to 4683 and is all-in
Duke Croix: calls 2683
*** SHOW DOWN ***
HighCardJasper: shows [Ad Ac] (a full house, Aces full of Nines)
Duke Croix: shows [Kh 9c] (three of a kind, Nines)
HighCardJasper collected 12442 from pot
*** SUMMARY ***
Total pot 13166 | Rake 724 
Board [As 5c 9s 9h Qd]
Seat 1: dddocky folded on the Flop
Seat 2: Duke Croix showed [Kh 9c] and lost with three of a kind, Nines
Seat 4: Manon947 folded before Flop
Seat 5: RichRick1337 (button) folded on the Flop
Seat 8: color_singleton (small blind) folded on the Flop
Seat 9: HighCardJasper (big blind) showed [Ad Ac] and won (12442) with a full house, Aces full of Nines



PokerStars Home Game Hand #216253361187: {Club #3225207}  Hold'em No Limit (50/100) - 2020/07/09 18:04:05 ET
Table 'lets goo' 9-max (Play Money) Seat #8 is the button
Seat 1: dddocky (13609 in chips) 
Seat 2: Duke Croix (13271 in chips) 
Seat 4: Manon947 (1864 in chips) 
Seat 5: RichRick1337 (17762 in chips) 
Seat 8: color_singleton (6880 in chips) 
Seat 9: HighCardJasper (12442 in chips) 
HighCardJasper: posts small blind 50
dddocky: posts big blind 100
*** HOLE CARDS ***
Dealt to Duke Croix [3s 2c]
Duke Croix: folds 
Manon947: folds 
RichRick1337: calls 100
color_singleton: folds 
HighCardJasper: calls 50
dddocky: checks 
*** FLOP *** [9d 6d Td]
HighCardJasper: bets 200
dddocky: folds 
RichRick1337: folds 
Uncalled bet (200) returned to HighCardJasper
HighCardJasper collected 283 from pot
HighCardJasper: doesn't show hand 
*** SUMMARY ***
Total pot 300 | Rake 17 
Board [9d 6d Td]
Seat 1: dddocky (big blind) folded on the Flop
Seat 2: Duke Croix folded before Flop (didn't bet)
Seat 4: Manon947 folded before Flop (didn't bet)
Seat 5: RichRick1337 folded on the Flop
Seat 8: color_singleton (button) folded before Flop (didn't bet)
Seat 9: HighCardJasper (small blind) collected (283)



PokerStars Home Game Hand #216253376457: {Club #3225207}  Hold'em No Limit (50/100) - 2020/07/09 18:04:32 ET
Table 'lets goo' 9-max (Play Money) Seat #9 is the button
Seat 1: dddocky (13509 in chips) 
Seat 2: Duke Croix (13271 in chips) 
Seat 4: Manon947 (1864 in chips) 
Seat 5: RichRick1337 (17662 in chips) 
Seat 8: color_singleton (6880 in chips) 
Seat 9: HighCardJasper (12625 in chips) 
dddocky: posts small blind 50
Duke Croix: posts big blind 100
*** HOLE CARDS ***
Dealt to Duke Croix [3d 5h]
Manon947: calls 100
RichRick1337: calls 100
color_singleton: folds 
HighCardJasper: raises 100 to 200
dddocky: folds 
Duke Croix: folds 
Manon947: calls 100
RichRick1337: calls 100
*** FLOP *** [4s 7c Qc]
Manon947: checks 
RichRick1337: checks 
HighCardJasper: checks 
*** TURN *** [4s 7c Qc] [8s]
Manon947: checks 
RichRick1337: checks 
HighCardJasper: checks 
*** RIVER *** [4s 7c Qc 8s] [6d]
Manon947: bets 354
RichRick1337: calls 354
HighCardJasper: folds 
*** SHOW DOWN ***
Manon947: shows [Js 7s] (a pair of Sevens)
RichRick1337: shows [8h Tc] (a pair of Eights)
RichRick1337 collected 1378 from pot
*** SUMMARY ***
Total pot 1458 | Rake 80 
Board [4s 7c Qc 8s 6d]
Seat 1: dddocky (small blind) folded before Flop
Seat 2: Duke Croix (big blind) folded before Flop
Seat 4: Manon947 showed [Js 7s] and lost with a pair of Sevens
Seat 5: RichRick1337 showed [8h Tc] and won (1378) with a pair of Eights
Seat 8: color_singleton folded before Flop (didn't bet)
Seat 9: HighCardJasper (button) folded on the River



PokerStars Home Game Hand #216253410037: {Club #3225207}  Hold'em No Limit (50/100) - 2020/07/09 18:05:33 ET
Table 'lets goo' 9-max (Play Money) Seat #1 is the button
Seat 1: dddocky (13459 in chips) 
Seat 2: Duke Croix (13171 in chips) 
Seat 4: Manon947 (1310 in chips) 
Seat 5: RichRick1337 (18486 in chips) 
Seat 8: color_singleton (6880 in chips) 
Seat 9: HighCardJasper (12425 in chips) 
Duke Croix: posts small blind 50
Manon947: posts big blind 100
*** HOLE CARDS ***
Dealt to Duke Croix [Kd 7h]
RichRick1337: calls 100
color_singleton: folds 
HighCardJasper: calls 100
dddocky: calls 100
Duke Croix: calls 50
Manon947: checks 
*** FLOP *** [4d 3d Ac]
Duke Croix: checks 
Manon947: checks 
RichRick1337: checks 
HighCardJasper: checks 
dddocky: checks 
*** TURN *** [4d 3d Ac] [8h]
Duke Croix: checks 
Manon947: checks 
RichRick1337: checks 
HighCardJasper: checks 
dddocky: checks 
*** RIVER *** [4d 3d Ac 8h] [Jh]
Duke Croix: checks 
Manon947: checks 
RichRick1337: checks 
HighCardJasper: checks 
dddocky: checks 
*** SHOW DOWN ***
Duke Croix: shows [Kd 7h] (high card Ace)
Manon947: mucks hand 
RichRick1337: mucks hand 
HighCardJasper: shows [4h Ts] (a pair of Fours)
dddocky: mucks hand 
HighCardJasper collected 472 from pot
*** SUMMARY ***
Total pot 500 | Rake 28 
Board [4d 3d Ac 8h Jh]
Seat 1: dddocky (button) mucked [5c Qc]
Seat 2: Duke Croix (small blind) showed [Kd 7h] and lost with high card Ace
Seat 4: Manon947 (big blind) mucked [6s Qs]
Seat 5: RichRick1337 mucked [Qh 5d]
Seat 8: color_singleton folded before Flop (didn't bet)
Seat 9: HighCardJasper showed [4h Ts] and won (472) with a pair of Fours



PokerStars Home Game Hand #216253435351: {Club #3225207}  Hold'em No Limit (50/100) - 2020/07/09 18:06:19 ET
Table 'lets goo' 9-max (Play Money) Seat #2 is the button
Seat 1: dddocky (13359 in chips) 
Seat 2: Duke Croix (13071 in chips) 
Seat 4: Manon947 (1210 in chips) 
Seat 5: RichRick1337 (18386 in chips) 
Seat 8: color_singleton (6880 in chips) 
Seat 9: HighCardJasper (12797 in chips) 
Manon947: posts small blind 50
RichRick1337: posts big blind 100
*** HOLE CARDS ***
Dealt to Duke Croix [Ac Kc]
color_singleton: raises 100 to 200
HighCardJasper: calls 200
dddocky: folds 
Duke Croix: raises 300 to 500
Manon947: folds 
RichRick1337: folds 
color_singleton: calls 300
HighCardJasper: folds 
*** FLOP *** [7c 9c 9s]
color_singleton: checks 
Duke Croix: bets 900
color_singleton: calls 900
*** TURN *** [7c 9c 9s] [Qc]
color_singleton: checks 
Duke Croix: checks 
*** RIVER *** [7c 9c 9s Qc] [Jh]
color_singleton: bets 1488
Duke Croix: raises 1912 to 3400
color_singleton: calls 1912
*** SHOW DOWN ***
Duke Croix: shows [Ac Kc] (a flush, Ace high)
color_singleton: mucks hand 
Duke Croix collected 9403 from pot
*** SUMMARY ***
Total pot 9950 | Rake 547 
Board [7c 9c 9s Qc Jh]
Seat 1: dddocky folded before Flop (didn't bet)
Seat 2: Duke Croix (button) showed [Ac Kc] and won (9403) with a flush, Ace high
Seat 4: Manon947 (small blind) folded before Flop
Seat 5: RichRick1337 (big blind) folded before Flop
Seat 8: color_singleton mucked [9d Ah]
Seat 9: HighCardJasper folded before Flop



PokerStars Home Game Hand #216253462854: {Club #3225207}  Hold'em No Limit (50/100) - 2020/07/09 18:07:09 ET
Table 'lets goo' 9-max (Play Money) Seat #4 is the button
Seat 1: dddocky (13359 in chips) 
Seat 2: Duke Croix (17674 in chips) 
Seat 4: Manon947 (1160 in chips) 
Seat 5: RichRick1337 (18286 in chips) 
Seat 8: color_singleton (2080 in chips) 
Seat 9: HighCardJasper (12597 in chips) 
RichRick1337: posts small blind 50
color_singleton: posts big blind 100
*** HOLE CARDS ***
Dealt to Duke Croix [5d 3s]
HighCardJasper: raises 100 to 200
dddocky: calls 200
Duke Croix: folds 
Manon947: calls 200
RichRick1337: calls 150
color_singleton: folds 
*** FLOP *** [4s 5s 4d]
RichRick1337: bets 850
HighCardJasper: folds 
dddocky: folds 
Manon947: folds 
Uncalled bet (850) returned to RichRick1337
RichRick1337 collected 850 from pot
RichRick1337: doesn't show hand 
*** SUMMARY ***
Total pot 900 | Rake 50 
Board [4s 5s 4d]
Seat 1: dddocky folded on the Flop
Seat 2: Duke Croix folded before Flop (didn't bet)
Seat 4: Manon947 (button) folded on the Flop
Seat 5: RichRick1337 (small blind) collected (850)
Seat 8: color_singleton (big blind) folded before Flop
Seat 9: HighCardJasper folded on the Flop



PokerStars Home Game Hand #216253480160: {Club #3225207}  Hold'em No Limit (50/100) - 2020/07/09 18:07:40 ET
Table 'lets goo' 9-max (Play Money) Seat #5 is the button
Seat 1: dddocky (13159 in chips) 
Seat 2: Duke Croix (17674 in chips) 
Seat 4: Manon947 (960 in chips) 
Seat 5: RichRick1337 (18936 in chips) 
Seat 8: color_singleton (1980 in chips) 
Seat 9: HighCardJasper (12397 in chips) 
color_singleton: posts small blind 50
HighCardJasper: posts big blind 100
*** HOLE CARDS ***
Dealt to Duke Croix [5c Qc]
dddocky: folds 
Duke Croix: folds 
Manon947: calls 100
RichRick1337: calls 100
color_singleton: raises 300 to 400
HighCardJasper: folds 
Manon947: calls 300
RichRick1337: calls 300
*** FLOP *** [2h 5d Kh]
color_singleton: checks 
Manon947: checks 
RichRick1337: checks 
*** TURN *** [2h 5d Kh] [4s]
color_singleton: checks 
Manon947: bets 560 and is all-in
RichRick1337: folds 
color_singleton: folds 
Uncalled bet (560) returned to Manon947
Manon947 collected 1228 from pot
*** SUMMARY ***
Total pot 1300 | Rake 72 
Board [2h 5d Kh 4s]
Seat 1: dddocky folded before Flop (didn't bet)
Seat 2: Duke Croix folded before Flop (didn't bet)
Seat 4: Manon947 collected (1228)
Seat 5: RichRick1337 (button) folded on the Turn
Seat 8: color_singleton (small blind) folded on the Turn
Seat 9: HighCardJasper (big blind) folded before Flop



PokerStars Home Game Hand #216253517334: {Club #3225207}  Hold'em No Limit (50/100) - 2020/07/09 18:08:47 ET
Table 'lets goo' 9-max (Play Money) Seat #8 is the button
Seat 1: dddocky (13159 in chips) 
Seat 2: Duke Croix (17674 in chips) 
Seat 4: Manon947 (1788 in chips) 
Seat 5: RichRick1337 (18536 in chips) 
Seat 8: color_singleton (1580 in chips) 
Seat 9: HighCardJasper (12297 in chips) 
HighCardJasper: posts small blind 50
dddocky: posts big blind 100
*** HOLE CARDS ***
Dealt to Duke Croix [8h 4d]
Duke Croix: folds 
Manon947: calls 100
RichRick1337: calls 100
color_singleton: folds 
HighCardJasper: calls 50
dddocky: checks 
*** FLOP *** [Jc 9d Kc]
HighCardJasper: bets 200
dddocky: folds 
Manon947: calls 200
RichRick1337: folds 
*** TURN *** [Jc 9d Kc] [3s]
HighCardJasper: bets 200
Manon947: raises 200 to 400
HighCardJasper: calls 200
*** RIVER *** [Jc 9d Kc 3s] [9s]
HighCardJasper: bets 1000
Manon947: raises 88 to 1088 and is all-in
HighCardJasper: calls 88
*** SHOW DOWN ***
Manon947: shows [Qd Th] (a straight, Nine to King)
HighCardJasper: shows [Qs Td] (a straight, Nine to King)
HighCardJasper collected 1784 from pot
Manon947 collected 1784 from pot
*** SUMMARY ***
Total pot 3776 | Rake 208 
Board [Jc 9d Kc 3s 9s]
Seat 1: dddocky (big blind) folded on the Flop
Seat 2: Duke Croix folded before Flop (didn't bet)
Seat 4: Manon947 showed [Qd Th] and won (1784) with a straight, Nine to King
Seat 5: RichRick1337 folded on the Flop
Seat 8: color_singleton (button) folded before Flop (didn't bet)
Seat 9: HighCardJasper (small blind) showed [Qs Td] and won (1784) with a straight, Nine to King



PokerStars Home Game Hand #216253552324: {Club #3225207}  Hold'em No Limit (50/100) - 2020/07/09 18:09:50 ET
Table 'lets goo' 9-max (Play Money) Seat #9 is the button
Seat 1: dddocky (13059 in chips) 
Seat 2: Duke Croix (17674 in chips) 
Seat 4: Manon947 (1784 in chips) 
Seat 5: RichRick1337 (18436 in chips) 
Seat 8: color_singleton (1580 in chips) 
Seat 9: HighCardJasper (12293 in chips) 
dddocky: posts small blind 50
Duke Croix: posts big blind 100
*** HOLE CARDS ***
Dealt to Duke Croix [3d 7c]
Manon947: calls 100
RichRick1337: calls 100
color_singleton: folds 
HighCardJasper: calls 100
dddocky: calls 50
Duke Croix: checks 
*** FLOP *** [Th 5d 9h]
dddocky: checks 
Duke Croix: checks 
Manon947: checks 
RichRick1337: checks 
HighCardJasper: bets 300
dddocky: folds 
Duke Croix has timed out
Duke Croix: folds 
Manon947: folds 
RichRick1337: folds 
Uncalled bet (300) returned to HighCardJasper
HighCardJasper collected 472 from pot
HighCardJasper: doesn't show hand 
*** SUMMARY ***
Total pot 500 | Rake 28 
Board [Th 5d 9h]
Seat 1: dddocky (small blind) folded on the Flop
Seat 2: Duke Croix (big blind) folded on the Flop
Seat 4: Manon947 folded on the Flop
Seat 5: RichRick1337 folded on the Flop
Seat 8: color_singleton folded before Flop (didn't bet)
Seat 9: HighCardJasper (button) collected (472)



PokerStars Home Game Hand #216253645127: {Club #3225207}  Hold'em No Limit (50/100) - 2020/07/09 18:12:22 ET
Table 'lets goo' 9-max (Play Money) Seat #5 is the button
Seat 1: dddocky (12959 in chips) 
Seat 2: Duke Croix (17574 in chips) 
Seat 4: Manon947 (1634 in chips) 
Seat 5: RichRick1337 (17306 in chips) 
Seat 8: color_singleton (2733 in chips) 
Seat 9: HighCardJasper (12365 in chips) 
color_singleton: posts small blind 50
HighCardJasper: posts big blind 100
Duke Croix: posts small blind 50
*** HOLE CARDS ***
Dealt to Duke Croix [9d 4d]
dddocky: calls 100
Duke Croix: folds 
Manon947: calls 100
RichRick1337: calls 100
color_singleton: raises 100 to 200
HighCardJasper: calls 100
dddocky: calls 100
Manon947: calls 100
RichRick1337: calls 100
*** FLOP *** [Td 6c Th]
color_singleton: checks 
HighCardJasper: checks 
dddocky: checks 
Manon947: bets 496
RichRick1337: folds 
color_singleton: folds 
HighCardJasper: folds 
dddocky: folds 
Uncalled bet (496) returned to Manon947
Manon947 collected 992 from pot
*** SUMMARY ***
Total pot 1050 | Rake 58 
Board [Td 6c Th]
Seat 1: dddocky folded on the Flop
Seat 2: Duke Croix folded before Flop (didn't bet)
Seat 4: Manon947 collected (992)
Seat 5: RichRick1337 (button) folded on the Flop
Seat 8: color_singleton (small blind) folded on the Flop
Seat 9: HighCardJasper (big blind) folded on the Flop



PokerStars Home Game Hand #216253668910: {Club #3225207}  Hold'em No Limit (50/100) - 2020/07/09 18:13:05 ET
Table 'lets goo' 9-max (Play Money) Seat #8 is the button
Seat 1: dddocky (12759 in chips) 
Seat 2: Duke Croix (17524 in chips) 
Seat 4: Manon947 (2426 in chips) 
Seat 5: RichRick1337 (17106 in chips) 
Seat 8: color_singleton (2533 in chips) 
Seat 9: HighCardJasper (12165 in chips) 
HighCardJasper: posts small blind 50
dddocky: posts big blind 100
*** HOLE CARDS ***
Dealt to Duke Croix [9d 2s]
Duke Croix: folds 
Manon947: folds 
RichRick1337: calls 100
color_singleton: folds 
HighCardJasper: calls 50
dddocky: checks 
*** FLOP *** [Kh Js Qs]
HighCardJasper: checks 
dddocky: bets 100
RichRick1337: folds 
HighCardJasper: folds 
Uncalled bet (100) returned to dddocky
dddocky collected 283 from pot
dddocky: doesn't show hand 
*** SUMMARY ***
Total pot 300 | Rake 17 
Board [Kh Js Qs]
Seat 1: dddocky (big blind) collected (283)
Seat 2: Duke Croix folded before Flop (didn't bet)
Seat 4: Manon947 folded before Flop (didn't bet)
Seat 5: RichRick1337 folded on the Flop
Seat 8: color_singleton (button) folded before Flop (didn't bet)
Seat 9: HighCardJasper (small blind) folded on the Flop



PokerStars Home Game Hand #216253683541: {Club #3225207}  Hold'em No Limit (50/100) - 2020/07/09 18:13:33 ET
Table 'lets goo' 9-max (Play Money) Seat #9 is the button
Seat 1: dddocky (12942 in chips) 
Seat 2: Duke Croix (17524 in chips) 
Seat 4: Manon947 (2426 in chips) 
Seat 5: RichRick1337 (17006 in chips) 
Seat 8: color_singleton (2533 in chips) 
Seat 9: HighCardJasper (12065 in chips) 
dddocky: posts small blind 50
Duke Croix: posts big blind 100
*** HOLE CARDS ***
Dealt to Duke Croix [Ah Qc]
Manon947: calls 100
RichRick1337: calls 100
color_singleton: folds 
HighCardJasper: raises 200 to 300
dddocky: calls 250
Duke Croix: calls 200
Manon947: folds 
RichRick1337: calls 200
*** FLOP *** [Qs 6d 7c]
dddocky: checks 
Duke Croix: bets 700
RichRick1337: folds 
HighCardJasper: calls 700
dddocky: calls 700
*** TURN *** [Qs 6d 7c] [Th]
dddocky: bets 100
Duke Croix: raises 1800 to 1900
HighCardJasper: folds 
dddocky: calls 1800
*** RIVER *** [Qs 6d 7c Th] [7d]
dddocky: bets 6804
Duke Croix: calls 6804
*** SHOW DOWN ***
dddocky: shows [Qh 7s] (a full house, Sevens full of Queens)
Duke Croix: mucks hand 
dddocky collected 19664 from pot
*** SUMMARY ***
Total pot 20808 | Rake 1144 
Board [Qs 6d 7c Th 7d]
Seat 1: dddocky (small blind) showed [Qh 7s] and won (19664) with a full house, Sevens full of Queens
Seat 2: Duke Croix (big blind) mucked [Ah Qc]
Seat 4: Manon947 folded before Flop
Seat 5: RichRick1337 folded on the Flop
Seat 8: color_singleton folded before Flop (didn't bet)
Seat 9: HighCardJasper (button) folded on the Turn



PokerStars Home Game Hand #216253723764: {Club #3225207}  Hold'em No Limit (50/100) - 2020/07/09 18:14:47 ET
Table 'lets goo' 9-max (Play Money) Seat #1 is the button
Seat 1: dddocky (22902 in chips) 
Seat 2: Duke Croix (7820 in chips) 
Seat 4: Manon947 (2326 in chips) 
Seat 5: RichRick1337 (16706 in chips) 
Seat 8: color_singleton (2533 in chips) 
Seat 9: HighCardJasper (11065 in chips) 
Duke Croix: posts small blind 50
Manon947: posts big blind 100
*** HOLE CARDS ***
Dealt to Duke Croix [4s 7h]
RichRick1337: calls 100
color_singleton: calls 100
HighCardJasper: calls 100
dddocky: calls 100
Duke Croix: calls 50
Manon947: checks 
*** FLOP *** [5d 9d Qd]
Duke Croix: checks 
Manon947: checks 
RichRick1337: checks 
color_singleton: checks 
HighCardJasper: checks 
dddocky: checks 
*** TURN *** [5d 9d Qd] [7s]
Duke Croix: checks 
Manon947: checks 
RichRick1337: checks 
color_singleton: checks 
HighCardJasper: checks 
dddocky: checks 
*** RIVER *** [5d 9d Qd 7s] [Qs]
Duke Croix: bets 300
Manon947: folds 
RichRick1337: folds 
color_singleton: folds 
HighCardJasper: folds 
dddocky: raises 1167 to 1467
Duke Croix: calls 1167
*** SHOW DOWN ***
dddocky: shows [4h Qc] (three of a kind, Queens)
Duke Croix: mucks hand 
dddocky collected 3340 from pot
*** SUMMARY ***
Total pot 3534 | Rake 194 
Board [5d 9d Qd 7s Qs]
Seat 1: dddocky (button) showed [4h Qc] and won (3340) with three of a kind, Queens
Seat 2: Duke Croix (small blind) mucked [4s 7h]
Seat 4: Manon947 (big blind) folded on the River
Seat 5: RichRick1337 folded on the River
Seat 8: color_singleton folded on the River
Seat 9: HighCardJasper folded on the River



PokerStars Home Game Hand #216253762753: {Club #3225207}  Hold'em No Limit (50/100) - 2020/07/09 18:15:59 ET
Table 'lets goo' 9-max (Play Money) Seat #2 is the button
Seat 1: dddocky (24675 in chips) 
Seat 2: Duke Croix (6253 in chips) 
Seat 4: Manon947 (2226 in chips) 
Seat 5: RichRick1337 (16606 in chips) 
Seat 8: color_singleton (2433 in chips) 
Seat 9: HighCardJasper (10965 in chips) 
Manon947: posts small blind 50
RichRick1337: posts big blind 100
*** HOLE CARDS ***
Dealt to Duke Croix [7d Ad]
color_singleton: folds 
HighCardJasper: calls 100
dddocky: calls 100
Duke Croix: raises 400 to 500
Manon947: folds 
RichRick1337: calls 400
HighCardJasper: folds 
dddocky: folds 
*** FLOP *** [2c Ah 6h]
RichRick1337: checks 
Duke Croix: bets 700
RichRick1337: calls 700
*** TURN *** [2c Ah 6h] [Qh]
RichRick1337: checks 
Duke Croix: checks 
*** RIVER *** [2c Ah 6h Qh] [3s]
RichRick1337: checks 
Duke Croix: bets 1300
RichRick1337: calls 1300
*** SHOW DOWN ***
Duke Croix: shows [7d Ad] (a pair of Aces)
RichRick1337: mucks hand 
Duke Croix collected 4961 from pot
*** SUMMARY ***
Total pot 5250 | Rake 289 
Board [2c Ah 6h Qh 3s]
Seat 1: dddocky folded before Flop
Seat 2: Duke Croix (button) showed [7d Ad] and won (4961) with a pair of Aces
Seat 4: Manon947 (small blind) folded before Flop
Seat 5: RichRick1337 (big blind) mucked [Jd 9s]
Seat 8: color_singleton folded before Flop (didn't bet)
Seat 9: HighCardJasper folded before Flop



PokerStars Home Game Hand #216253783885: {Club #3225207}  Hold'em No Limit (50/100) - 2020/07/09 18:16:39 ET
Table 'lets goo' 9-max (Play Money) Seat #4 is the button
Seat 1: dddocky (24575 in chips) 
Seat 2: Duke Croix (8714 in chips) 
Seat 4: Manon947 (2176 in chips) 
Seat 5: RichRick1337 (14106 in chips) 
Seat 8: color_singleton (2433 in chips) 
Seat 9: HighCardJasper (10865 in chips) 
RichRick1337: posts small blind 50
color_singleton: posts big blind 100
*** HOLE CARDS ***
Dealt to Duke Croix [Ah 8c]
HighCardJasper: calls 100
dddocky: folds 
Duke Croix: raises 300 to 400
Manon947: folds 
RichRick1337: folds 
color_singleton: folds 
HighCardJasper: folds 
Uncalled bet (300) returned to Duke Croix
Duke Croix collected 350 from pot
*** SUMMARY ***
Total pot 350 | Rake 0 
Seat 1: dddocky folded before Flop (didn't bet)
Seat 2: Duke Croix collected (350)
Seat 4: Manon947 (button) folded before Flop (didn't bet)
Seat 5: RichRick1337 (small blind) folded before Flop
Seat 8: color_singleton (big blind) folded before Flop
Seat 9: HighCardJasper folded before Flop



PokerStars Home Game Hand #216253793334: {Club #3225207}  Hold'em No Limit (50/100) - 2020/07/09 18:16:56 ET
Table 'lets goo' 9-max (Play Money) Seat #5 is the button
Seat 1: dddocky (24575 in chips) 
Seat 2: Duke Croix (8964 in chips) 
Seat 4: Manon947 (2176 in chips) 
Seat 5: RichRick1337 (14056 in chips) 
Seat 8: color_singleton (2333 in chips) 
Seat 9: HighCardJasper (10765 in chips) 
color_singleton: posts small blind 50
HighCardJasper: posts big blind 100
*** HOLE CARDS ***
Dealt to Duke Croix [3d 4c]
dddocky: calls 100
Duke Croix: folds 
Manon947: folds 
RichRick1337: raises 100 to 200
color_singleton: folds 
HighCardJasper: calls 100
dddocky: calls 100
*** FLOP *** [Jd Ks 8c]
HighCardJasper: checks 
dddocky: checks 
RichRick1337: bets 307
HighCardJasper: folds 
dddocky: calls 307
*** TURN *** [Jd Ks 8c] [Qd]
dddocky: checks 
RichRick1337: bets 100
dddocky: calls 100
*** RIVER *** [Jd Ks 8c Qd] [Th]
dddocky: checks 
RichRick1337: bets 691
dddocky: calls 691
*** SHOW DOWN ***
RichRick1337: shows [8d 8h] (three of a kind, Eights)
dddocky: mucks hand 
RichRick1337 collected 2689 from pot
*** SUMMARY ***
Total pot 2846 | Rake 157 
Board [Jd Ks 8c Qd Th]
Seat 1: dddocky mucked [6h Kh]
Seat 2: Duke Croix folded before Flop (didn't bet)
Seat 4: Manon947 folded before Flop (didn't bet)
Seat 5: RichRick1337 (button) showed [8d 8h] and won (2689) with three of a kind, Eights
Seat 8: color_singleton (small blind) folded before Flop
Seat 9: HighCardJasper (big blind) folded on the Flop



PokerStars Home Game Hand #216253819335: {Club #3225207}  Hold'em No Limit (50/100) - 2020/07/09 18:17:45 ET
Table 'lets goo' 9-max (Play Money) Seat #8 is the button
Seat 1: dddocky (23277 in chips) 
Seat 2: Duke Croix (8964 in chips) 
Seat 4: Manon947 (2176 in chips) 
Seat 5: RichRick1337 (15447 in chips) 
Seat 8: color_singleton (2283 in chips) 
Seat 9: HighCardJasper (10565 in chips) 
HighCardJasper: posts small blind 50
dddocky: posts big blind 100
*** HOLE CARDS ***
Dealt to Duke Croix [4c 8s]
Duke Croix: folds 
Manon947: calls 100
RichRick1337: calls 100
color_singleton: folds 
HighCardJasper: raises 100 to 200
dddocky: calls 100
Manon947: calls 100
RichRick1337: calls 100
*** FLOP *** [9h 6d 5d]
HighCardJasper: checks 
dddocky: checks 
Manon947: bets 100
RichRick1337: calls 100
HighCardJasper: calls 100
dddocky: folds 
*** TURN *** [9h 6d 5d] [9d]
HighCardJasper: checks 
Manon947: checks 
RichRick1337: bets 519
HighCardJasper: folds 
Manon947: folds 
Uncalled bet (519) returned to RichRick1337
RichRick1337 collected 1039 from pot
RichRick1337: doesn't show hand 
*** SUMMARY ***
Total pot 1100 | Rake 61 
Board [9h 6d 5d 9d]
Seat 1: dddocky (big blind) folded on the Flop
Seat 2: Duke Croix folded before Flop (didn't bet)
Seat 4: Manon947 folded on the Turn
Seat 5: RichRick1337 collected (1039)
Seat 8: color_singleton (button) folded before Flop (didn't bet)
Seat 9: HighCardJasper (small blind) folded on the Turn



PokerStars Home Game Hand #216253854382: {Club #3225207}  Hold'em No Limit (50/100) - 2020/07/09 18:18:51 ET
Table 'lets goo' 9-max (Play Money) Seat #9 is the button
Seat 1: dddocky (23077 in chips) 
Seat 2: Duke Croix (8964 in chips) 
Seat 4: Manon947 (1876 in chips) 
Seat 5: RichRick1337 (16186 in chips) 
Seat 8: color_singleton (2283 in chips) 
Seat 9: HighCardJasper (10265 in chips) 
dddocky: posts small blind 50
Duke Croix: posts big blind 100
*** HOLE CARDS ***
Dealt to Duke Croix [Ah 7h]
Manon947: calls 100
RichRick1337: raises 100 to 200
color_singleton: folds 
HighCardJasper: calls 200
dddocky: folds 
Duke Croix: calls 100
Manon947: calls 100
*** FLOP *** [Tc Jh 5h]
Duke Croix: bets 400
Manon947: folds 
RichRick1337: calls 400
HighCardJasper: folds 
*** TURN *** [Tc Jh 5h] [Js]
Duke Croix: bets 800
RichRick1337: folds 
Uncalled bet (800) returned to Duke Croix
Duke Croix collected 1559 from pot
*** SUMMARY ***
Total pot 1650 | Rake 91 
Board [Tc Jh 5h Js]
Seat 1: dddocky (small blind) folded before Flop
Seat 2: Duke Croix (big blind) collected (1559)
Seat 4: Manon947 folded on the Flop
Seat 5: RichRick1337 folded on the Turn
Seat 8: color_singleton folded before Flop (didn't bet)
Seat 9: HighCardJasper (button) folded on the Flop



PokerStars Home Game Hand #216253889743: {Club #3225207}  Hold'em No Limit (50/100) - 2020/07/09 18:19:41 ET
Table 'lets goo' 9-max (Play Money) Seat #1 is the button
Seat 1: dddocky (23027 in chips) 
Seat 2: Duke Croix (9923 in chips) 
Seat 4: Manon947 (1676 in chips) 
Seat 5: RichRick1337 (15586 in chips) 
Seat 8: color_singleton (2283 in chips) 
Seat 9: HighCardJasper (10065 in chips) 
Duke Croix: posts small blind 50
Manon947: posts big blind 100
*** HOLE CARDS ***
Dealt to Duke Croix [6d 4d]
RichRick1337: calls 100
color_singleton: folds 
HighCardJasper: raises 100 to 200
dddocky: folds 
Duke Croix: calls 150
Manon947: calls 100
RichRick1337: calls 100
*** FLOP *** [Jc Qd 7h]
Duke Croix: checks 
Manon947: bets 378
RichRick1337: calls 378
HighCardJasper: folds 
Duke Croix: folds 
*** TURN *** [Jc Qd 7h] [2h]
Manon947: bets 735
RichRick1337: folds 
Uncalled bet (735) returned to Manon947
Manon947 collected 1470 from pot
*** SUMMARY ***
Total pot 1556 | Rake 86 
Board [Jc Qd 7h 2h]
Seat 1: dddocky (button) folded before Flop (didn't bet)
Seat 2: Duke Croix (small blind) folded on the Flop
Seat 4: Manon947 (big blind) collected (1470)
Seat 5: RichRick1337 folded on the Turn
Seat 8: color_singleton folded before Flop (didn't bet)
Seat 9: HighCardJasper folded on the Flop



PokerStars Home Game Hand #216253917427: {Club #3225207}  Hold'em No Limit (50/100) - 2020/07/09 18:20:33 ET
Table 'lets goo' 9-max (Play Money) Seat #2 is the button
Seat 1: dddocky (23027 in chips) 
Seat 2: Duke Croix (9723 in chips) 
Seat 4: Manon947 (2568 in chips) 
Seat 5: RichRick1337 (15008 in chips) 
Seat 8: color_singleton (2283 in chips) 
Seat 9: HighCardJasper (9865 in chips) 
Manon947: posts small blind 50
RichRick1337: posts big blind 100
*** HOLE CARDS ***
Dealt to Duke Croix [Qh 3h]
color_singleton: folds 
HighCardJasper: raises 200 to 300
dddocky: calls 300
Duke Croix: folds 
Manon947: calls 250
RichRick1337: calls 200
*** FLOP *** [6s Ah 9d]
Manon947: checks 
RichRick1337: checks 
HighCardJasper: checks 
dddocky: bets 100
Manon947: calls 100
RichRick1337: folds 
HighCardJasper: calls 100
*** TURN *** [6s Ah 9d] [4h]
Manon947: checks 
HighCardJasper: bets 200
dddocky: calls 200
Manon947: folds 
*** RIVER *** [6s Ah 9d 4h] [3d]
HighCardJasper: checks 
dddocky: checks 
*** SHOW DOWN ***
HighCardJasper: shows [Th Tc] (a pair of Tens)
dddocky: shows [8s As] (a pair of Aces)
dddocky collected 1795 from pot
*** SUMMARY ***
Total pot 1900 | Rake 105 
Board [6s Ah 9d 4h 3d]
Seat 1: dddocky showed [8s As] and won (1795) with a pair of Aces
Seat 2: Duke Croix (button) folded before Flop (didn't bet)
Seat 4: Manon947 (small blind) folded on the Turn
Seat 5: RichRick1337 (big blind) folded on the Flop
Seat 8: color_singleton folded before Flop (didn't bet)
Seat 9: HighCardJasper showed [Th Tc] and lost with a pair of Tens



PokerStars Home Game Hand #216253953469: {Club #3225207}  Hold'em No Limit (50/100) - 2020/07/09 18:21:41 ET
Table 'lets goo' 9-max (Play Money) Seat #4 is the button
Seat 1: dddocky (24222 in chips) 
Seat 2: Duke Croix (9723 in chips) 
Seat 4: Manon947 (2168 in chips) 
Seat 5: RichRick1337 (14708 in chips) 
Seat 8: color_singleton (2283 in chips) 
Seat 9: HighCardJasper (9265 in chips) 
RichRick1337: posts small blind 50
color_singleton: posts big blind 100
*** HOLE CARDS ***
Dealt to Duke Croix [4s 9h]
HighCardJasper: calls 100
dddocky: calls 100
Duke Croix: folds 
Manon947: calls 100
RichRick1337: calls 50
color_singleton: checks 
*** FLOP *** [Js 4h Ks]
RichRick1337: checks 
color_singleton: bets 236
HighCardJasper: folds 
dddocky: calls 236
Manon947: calls 236
RichRick1337: folds 
*** TURN *** [Js 4h Ks] [Ts]
color_singleton: checks 
dddocky: checks 
Manon947: checks 
*** RIVER *** [Js 4h Ks Ts] [Qs]
color_singleton: checks 
dddocky: checks 
Manon947: checks 
*** SHOW DOWN ***
color_singleton: shows [Kh 7d] (a pair of Kings)
dddocky: shows [Kc 5d] (a pair of Kings)
Manon947: shows [4c Ad] (a straight, Ten to Ace)
Manon947 collected 1142 from pot
*** SUMMARY ***
Total pot 1208 | Rake 66 
Board [Js 4h Ks Ts Qs]
Seat 1: dddocky showed [Kc 5d] and lost with a pair of Kings
Seat 2: Duke Croix folded before Flop (didn't bet)
Seat 4: Manon947 (button) showed [4c Ad] and won (1142) with a straight, Ten to Ace
Seat 5: RichRick1337 (small blind) folded on the Flop
Seat 8: color_singleton (big blind) showed [Kh 7d] and lost with a pair of Kings
Seat 9: HighCardJasper folded on the Flop



PokerStars Home Game Hand #216253984999: {Club #3225207}  Hold'em No Limit (50/100) - 2020/07/09 18:22:41 ET
Table 'lets goo' 9-max (Play Money) Seat #5 is the button
Seat 1: dddocky (23886 in chips) 
Seat 2: Duke Croix (9723 in chips) 
Seat 4: Manon947 (2974 in chips) 
Seat 5: RichRick1337 (14608 in chips) 
Seat 8: color_singleton (1947 in chips) 
Seat 9: HighCardJasper (9165 in chips) 
color_singleton: posts small blind 50
HighCardJasper: posts big blind 100
*** HOLE CARDS ***
Dealt to Duke Croix [Th 5h]
dddocky: calls 100
Duke Croix: folds 
Manon947: calls 100
RichRick1337: raises 100 to 200
color_singleton: folds 
HighCardJasper: calls 100
dddocky: calls 100
Manon947: calls 100
*** FLOP *** [8c Ac Kh]
HighCardJasper: checks 
dddocky: checks 
Manon947: checks 
RichRick1337: bets 401
HighCardJasper: folds 
dddocky: calls 401
Manon947: folds 
*** TURN *** [8c Ac Kh] [3s]
dddocky: bets 100
RichRick1337: calls 100
*** RIVER *** [8c Ac Kh 3s] [8h]
dddocky: bets 1750
RichRick1337: calls 1750
*** SHOW DOWN ***
dddocky: shows [8s 8d] (four of a kind, Eights)
RichRick1337: mucks hand 
dddocky collected 5058 from pot
*** SUMMARY ***
Total pot 5352 | Rake 294 
Board [8c Ac Kh 3s 8h]
Seat 1: dddocky showed [8s 8d] and won (5058) with four of a kind, Eights
Seat 2: Duke Croix folded before Flop (didn't bet)
Seat 4: Manon947 folded on the Flop
Seat 5: RichRick1337 (button) mucked [Ah Qc]
Seat 8: color_singleton (small blind) folded before Flop
Seat 9: HighCardJasper (big blind) folded on the Flop



PokerStars Home Game Hand #216254016316: {Club #3225207}  Hold'em No Limit (50/100) - 2020/07/09 18:23:40 ET
Table 'lets goo' 9-max (Play Money) Seat #8 is the button
Seat 1: dddocky (26493 in chips) 
Seat 2: Duke Croix (9723 in chips) 
Seat 4: Manon947 (2774 in chips) 
Seat 5: RichRick1337 (12157 in chips) 
Seat 8: color_singleton (1897 in chips) 
Seat 9: HighCardJasper (8965 in chips) 
HighCardJasper: posts small blind 50
dddocky: posts big blind 100
*** HOLE CARDS ***
Dealt to Duke Croix [7c Jd]
Duke Croix: folds 
Manon947: calls 100
RichRick1337: calls 100
color_singleton: folds 
HighCardJasper: calls 50
dddocky: checks 
*** FLOP *** [4d 5s 8s]
HighCardJasper: checks 
dddocky: checks 
Manon947: checks 
RichRick1337: checks 
*** TURN *** [4d 5s 8s] [9h]
HighCardJasper: checks 
dddocky: checks 
Manon947: checks 
RichRick1337: checks 
*** RIVER *** [4d 5s 8s 9h] [8c]
HighCardJasper: checks 
dddocky: checks 
Manon947: checks 
RichRick1337: checks 
*** SHOW DOWN ***
HighCardJasper: shows [Tc Ac] (a pair of Eights)
dddocky: mucks hand 
Manon947: shows [Td Ad] (a pair of Eights)
RichRick1337: mucks hand 
HighCardJasper collected 189 from pot
Manon947 collected 189 from pot
*** SUMMARY ***
Total pot 400 | Rake 22 
Board [4d 5s 8s 9h 8c]
Seat 1: dddocky (big blind) mucked [7h Kh]
Seat 2: Duke Croix folded before Flop (didn't bet)
Seat 4: Manon947 showed [Td Ad] and won (189) with a pair of Eights
Seat 5: RichRick1337 mucked [Jc 6h]
Seat 8: color_singleton (button) folded before Flop (didn't bet)
Seat 9: HighCardJasper (small blind) showed [Tc Ac] and won (189) with a pair of Eights



PokerStars Home Game Hand #216254040925: {Club #3225207}  Hold'em No Limit (50/100) - 2020/07/09 18:24:27 ET
Table 'lets goo' 9-max (Play Money) Seat #9 is the button
Seat 1: dddocky (26393 in chips) 
Seat 2: Duke Croix (9723 in chips) 
Seat 4: Manon947 (2863 in chips) 
Seat 5: RichRick1337 (12057 in chips) 
Seat 8: color_singleton (1897 in chips) 
Seat 9: HighCardJasper (9054 in chips) 
dddocky: posts small blind 50
Duke Croix: posts big blind 100
*** HOLE CARDS ***
Dealt to Duke Croix [9h 6d]
Manon947: calls 100
RichRick1337: folds 
color_singleton: raises 100 to 200
HighCardJasper: calls 200
dddocky: calls 150
Duke Croix: folds 
Manon947: calls 100
*** FLOP *** [6h 7d 9d]
dddocky: checks 
Manon947: checks 
color_singleton: checks 
HighCardJasper: bets 300
dddocky: folds 
Manon947: folds 
color_singleton: calls 300
*** TURN *** [6h 7d 9d] [3c]
color_singleton: checks 
HighCardJasper: checks 
*** RIVER *** [6h 7d 9d 3c] [Qh]
color_singleton: checks 
HighCardJasper: bets 300
color_singleton: calls 300
*** SHOW DOWN ***
HighCardJasper: shows [9c 8h] (a pair of Nines)
color_singleton: shows [9s Js] (a pair of Nines - Queen+Jack kicker)
color_singleton collected 1984 from pot
*** SUMMARY ***
Total pot 2100 | Rake 116 
Board [6h 7d 9d 3c Qh]
Seat 1: dddocky (small blind) folded on the Flop
Seat 2: Duke Croix (big blind) folded before Flop
Seat 4: Manon947 folded on the Flop
Seat 5: RichRick1337 folded before Flop (didn't bet)
Seat 8: color_singleton showed [9s Js] and won (1984) with a pair of Nines
Seat 9: HighCardJasper (button) showed [9c 8h] and lost with a pair of Nines



PokerStars Home Game Hand #216254072879: {Club #3225207}  Hold'em No Limit (50/100) - 2020/07/09 18:25:28 ET
Table 'lets goo' 9-max (Play Money) Seat #1 is the button
Seat 1: dddocky (26193 in chips) 
Seat 2: Duke Croix (9623 in chips) 
Seat 4: Manon947 (2663 in chips) 
Seat 5: RichRick1337 (12057 in chips) 
Seat 8: color_singleton (3081 in chips) 
Seat 9: HighCardJasper (8254 in chips) 
Duke Croix: posts small blind 50
Manon947: posts big blind 100
*** HOLE CARDS ***
Dealt to Duke Croix [Ad 3c]
RichRick1337: calls 100
color_singleton: raises 200 to 300
HighCardJasper: raises 200 to 500
dddocky: folds 
Duke Croix: folds 
Manon947: calls 400
RichRick1337: folds 
color_singleton: calls 200
*** FLOP *** [7s 3h 8c]
Manon947: checks 
color_singleton: bets 1559
HighCardJasper: folds 
Manon947: folds 
Uncalled bet (1559) returned to color_singleton
color_singleton collected 1559 from pot
color_singleton: doesn't show hand 
*** SUMMARY ***
Total pot 1650 | Rake 91 
Board [7s 3h 8c]
Seat 1: dddocky (button) folded before Flop (didn't bet)
Seat 2: Duke Croix (small blind) folded before Flop
Seat 4: Manon947 (big blind) folded on the Flop
Seat 5: RichRick1337 folded before Flop
Seat 8: color_singleton collected (1559)
Seat 9: HighCardJasper folded on the Flop



PokerStars Home Game Hand #216254094089: {Club #3225207}  Hold'em No Limit (50/100) - 2020/07/09 18:26:09 ET
Table 'lets goo' 9-max (Play Money) Seat #2 is the button
Seat 1: dddocky (26193 in chips) 
Seat 2: Duke Croix (9573 in chips) 
Seat 4: Manon947 (2163 in chips) 
Seat 5: RichRick1337 (11957 in chips) 
Seat 8: color_singleton (4140 in chips) 
Seat 9: HighCardJasper (7754 in chips) 
Manon947: posts small blind 50
RichRick1337: posts big blind 100
*** HOLE CARDS ***
Dealt to Duke Croix [2h Qc]
color_singleton: folds 
HighCardJasper: calls 100
dddocky: calls 100
Duke Croix: calls 100
Manon947: calls 50
RichRick1337: checks 
*** FLOP *** [5c 6c 6s]
Manon947: checks 
RichRick1337: checks 
HighCardJasper: checks 
dddocky: checks 
Duke Croix: checks 
*** TURN *** [5c 6c 6s] [9d]
Manon947: checks 
RichRick1337: checks 
HighCardJasper: checks 
dddocky: checks 
Duke Croix: checks 
*** RIVER *** [5c 6c 6s 9d] [2s]
Manon947: checks 
RichRick1337: checks 
HighCardJasper: checks 
dddocky: bets 472
Duke Croix: calls 472
Manon947: folds 
RichRick1337: calls 472
HighCardJasper: folds 
*** SHOW DOWN ***
dddocky: shows [5s Ks] (two pair, Sixes and Fives)
Duke Croix: mucks hand 
RichRick1337: mucks hand 
dddocky collected 1811 from pot
*** SUMMARY ***
Total pot 1916 | Rake 105 
Board [5c 6c 6s 9d 2s]
Seat 1: dddocky showed [5s Ks] and won (1811) with two pair, Sixes and Fives
Seat 2: Duke Croix (button) mucked [2h Qc]
Seat 4: Manon947 (small blind) folded on the River
Seat 5: RichRick1337 (big blind) mucked [7h 2c]
Seat 8: color_singleton folded before Flop (didn't bet)
Seat 9: HighCardJasper folded on the River



PokerStars Home Game Hand #216254124176: {Club #3225207}  Hold'em No Limit (50/100) - 2020/07/09 18:27:07 ET
Table 'lets goo' 9-max (Play Money) Seat #4 is the button
Seat 1: dddocky (27432 in chips) 
Seat 2: Duke Croix (9001 in chips) 
Seat 4: Manon947 (2063 in chips) 
Seat 5: RichRick1337 (11385 in chips) 
Seat 8: color_singleton (4140 in chips) 
Seat 9: HighCardJasper (7654 in chips) 
RichRick1337: posts small blind 50
color_singleton: posts big blind 100
*** HOLE CARDS ***
Dealt to Duke Croix [Ah 2d]
HighCardJasper: calls 100
dddocky: folds 
Duke Croix: raises 300 to 400
Manon947: folds 
RichRick1337: folds 
color_singleton: folds 
HighCardJasper: folds 
Uncalled bet (300) returned to Duke Croix
Duke Croix collected 350 from pot
*** SUMMARY ***
Total pot 350 | Rake 0 
Seat 1: dddocky folded before Flop (didn't bet)
Seat 2: Duke Croix collected (350)
Seat 4: Manon947 (button) folded before Flop (didn't bet)
Seat 5: RichRick1337 (small blind) folded before Flop
Seat 8: color_singleton (big blind) folded before Flop
Seat 9: HighCardJasper folded before Flop



PokerStars Home Game Hand #216254136397: {Club #3225207}  Hold'em No Limit (50/100) - 2020/07/09 18:27:31 ET
Table 'lets goo' 9-max (Play Money) Seat #5 is the button
Seat 1: dddocky (27432 in chips) 
Seat 2: Duke Croix (9251 in chips) 
Seat 4: Manon947 (2063 in chips) 
Seat 5: RichRick1337 (11335 in chips) 
Seat 8: color_singleton (4040 in chips) 
Seat 9: HighCardJasper (7554 in chips) 
color_singleton: posts small blind 50
HighCardJasper: posts big blind 100
*** HOLE CARDS ***
Dealt to Duke Croix [5d Ah]
dddocky: calls 100
Duke Croix: raises 300 to 400
Manon947: calls 400
RichRick1337: calls 400
color_singleton: folds 
HighCardJasper: folds 
dddocky: folds 
*** FLOP *** [Th Ts 3s]
Duke Croix: checks 
Manon947: bets 685
RichRick1337: calls 685
Duke Croix: folds 
*** TURN *** [Th Ts 3s] [9h]
Manon947: bets 978 and is all-in
RichRick1337: folds 
Uncalled bet (978) returned to Manon947
Manon947 collected 2665 from pot
*** SUMMARY ***
Total pot 2820 | Rake 155 
Board [Th Ts 3s 9h]
Seat 1: dddocky folded before Flop
Seat 2: Duke Croix folded on the Flop
Seat 4: Manon947 collected (2665)
Seat 5: RichRick1337 (button) folded on the Turn
Seat 8: color_singleton (small blind) folded before Flop
Seat 9: HighCardJasper (big blind) folded before Flop



PokerStars Home Game Hand #216254154465: {Club #3225207}  Hold'em No Limit (50/100) - 2020/07/09 18:28:05 ET
Table 'lets goo' 9-max (Play Money) Seat #8 is the button
Seat 1: dddocky (27332 in chips) 
Seat 2: Duke Croix (8851 in chips) 
Seat 4: Manon947 (3643 in chips) 
Seat 5: RichRick1337 (10250 in chips) 
Seat 8: color_singleton (3990 in chips) 
Seat 9: HighCardJasper (7454 in chips) 
HighCardJasper: posts small blind 50
dddocky: posts big blind 100
*** HOLE CARDS ***
Dealt to Duke Croix [Td Kh]
Duke Croix: raises 300 to 400
Manon947: folds 
RichRick1337: calls 400
color_singleton: folds 
HighCardJasper: calls 350
dddocky: folds 
*** FLOP *** [Ks Qd 6h]
HighCardJasper: bets 300
Duke Croix: raises 500 to 800
RichRick1337: folds 
HighCardJasper: folds 
Uncalled bet (500) returned to Duke Croix
Duke Croix collected 1795 from pot
*** SUMMARY ***
Total pot 1900 | Rake 105 
Board [Ks Qd 6h]
Seat 1: dddocky (big blind) folded before Flop
Seat 2: Duke Croix collected (1795)
Seat 4: Manon947 folded before Flop (didn't bet)
Seat 5: RichRick1337 folded on the Flop
Seat 8: color_singleton (button) folded before Flop (didn't bet)
Seat 9: HighCardJasper (small blind) folded on the Flop



PokerStars Home Game Hand #216254177118: {Club #3225207}  Hold'em No Limit (50/100) - 2020/07/09 18:28:49 ET
Table 'lets goo' 9-max (Play Money) Seat #9 is the button
Seat 1: dddocky (27232 in chips) 
Seat 2: Duke Croix (9946 in chips) 
Seat 4: Manon947 (3643 in chips) 
Seat 5: RichRick1337 (9850 in chips) 
Seat 8: color_singleton (3990 in chips) 
Seat 9: HighCardJasper (6754 in chips) 
dddocky: posts small blind 50
Duke Croix: posts big blind 100
*** HOLE CARDS ***
Dealt to Duke Croix [5d Jd]
Manon947: calls 100
RichRick1337: calls 100
color_singleton: calls 100
HighCardJasper: calls 100
dddocky: calls 50
Duke Croix: checks 
*** FLOP *** [2h Qc Ac]
dddocky: checks 
Duke Croix: checks 
Manon947: checks 
RichRick1337: checks 
color_singleton: checks 
HighCardJasper: checks 
*** TURN *** [2h Qc Ac] [Ah]
dddocky: checks 
Duke Croix: checks 
Manon947: checks 
RichRick1337: checks 
color_singleton: checks 
HighCardJasper: checks 
*** RIVER *** [2h Qc Ac Ah] [Js]
dddocky: checks 
Duke Croix: bets 400
Manon947: folds 
RichRick1337: folds 
color_singleton: folds 
HighCardJasper: raises 400 to 800
dddocky: folds 
Duke Croix: calls 400
*** SHOW DOWN ***
HighCardJasper: shows [Ks Td] (a straight, Ten to Ace)
Duke Croix: mucks hand 
HighCardJasper collected 2079 from pot
*** SUMMARY ***
Total pot 2200 | Rake 121 
Board [2h Qc Ac Ah Js]
Seat 1: dddocky (small blind) folded on the River
Seat 2: Duke Croix (big blind) mucked [5d Jd]
Seat 4: Manon947 folded on the River
Seat 5: RichRick1337 folded on the River
Seat 8: color_singleton folded on the River
Seat 9: HighCardJasper (button) showed [Ks Td] and won (2079) with a straight, Ten to Ace



PokerStars Home Game Hand #216254216135: {Club #3225207}  Hold'em No Limit (50/100) - 2020/07/09 18:30:05 ET
Table 'lets goo' 9-max (Play Money) Seat #1 is the button
Seat 1: dddocky (27132 in chips) 
Seat 2: Duke Croix (9046 in chips) 
Seat 4: Manon947 (3543 in chips) 
Seat 5: RichRick1337 (9750 in chips) 
Seat 8: color_singleton (3890 in chips) 
Seat 9: HighCardJasper (7933 in chips) 
Duke Croix: posts small blind 50
Manon947: posts big blind 100
*** HOLE CARDS ***
Dealt to Duke Croix [2h Kc]
RichRick1337: calls 100
color_singleton: folds 
HighCardJasper: raises 100 to 200
dddocky: folds 
Duke Croix: folds 
Manon947: folds 
RichRick1337: calls 100
*** FLOP *** [4c 5c As]
RichRick1337: checks 
HighCardJasper: checks 
*** TURN *** [4c 5c As] [3d]
RichRick1337: checks 
HighCardJasper: checks 
*** RIVER *** [4c 5c As 3d] [Jh]
RichRick1337: checks 
HighCardJasper: checks 
*** SHOW DOWN ***
RichRick1337: shows [8s 7s] (high card Ace)
HighCardJasper: shows [Td Qd] (high card Ace - Queen kicker)
HighCardJasper collected 520 from pot
*** SUMMARY ***
Total pot 550 | Rake 30 
Board [4c 5c As 3d Jh]
Seat 1: dddocky (button) folded before Flop (didn't bet)
Seat 2: Duke Croix (small blind) folded before Flop
Seat 4: Manon947 (big blind) folded before Flop
Seat 5: RichRick1337 showed [8s 7s] and lost with high card Ace
Seat 8: color_singleton folded before Flop (didn't bet)
Seat 9: HighCardJasper showed [Td Qd] and won (520) with high card Ace



PokerStars Home Game Hand #216254235290: {Club #3225207}  Hold'em No Limit (50/100) - 2020/07/09 18:30:41 ET
Table 'lets goo' 9-max (Play Money) Seat #2 is the button
Seat 1: dddocky (27132 in chips) 
Seat 2: Duke Croix (8996 in chips) 
Seat 4: Manon947 (3443 in chips) 
Seat 5: RichRick1337 (9550 in chips) 
Seat 8: color_singleton (3890 in chips) 
Seat 9: HighCardJasper (8253 in chips) 
Manon947: posts small blind 50
RichRick1337: posts big blind 100
*** HOLE CARDS ***
Dealt to Duke Croix [5s 6d]
color_singleton: folds 
HighCardJasper: raises 200 to 300
dddocky: folds 
Duke Croix: calls 300
Manon947: calls 250
RichRick1337: calls 200
*** FLOP *** [2h 8s 6s]
Manon947: checks 
RichRick1337: checks 
HighCardJasper: checks 
Duke Croix: checks 
*** TURN *** [2h 8s 6s] [4d]
Manon947: checks 
RichRick1337: checks 
HighCardJasper: checks 
Duke Croix: bets 600
Manon947: folds 
RichRick1337: folds 
HighCardJasper: folds 
Uncalled bet (600) returned to Duke Croix
Duke Croix collected 1134 from pot
*** SUMMARY ***
Total pot 1200 | Rake 66 
Board [2h 8s 6s 4d]
Seat 1: dddocky folded before Flop (didn't bet)
Seat 2: Duke Croix (button) collected (1134)
Seat 4: Manon947 (small blind) folded on the Turn
Seat 5: RichRick1337 (big blind) folded on the Turn
Seat 8: color_singleton folded before Flop (didn't bet)
Seat 9: HighCardJasper folded on the Turn



PokerStars Home Game Hand #216254257953: {Club #3225207}  Hold'em No Limit (50/100) - 2020/07/09 18:31:24 ET
Table 'lets goo' 9-max (Play Money) Seat #4 is the button
Seat 1: dddocky (27132 in chips) 
Seat 2: Duke Croix (9830 in chips) 
Seat 4: Manon947 (3143 in chips) 
Seat 5: RichRick1337 (9250 in chips) 
Seat 8: color_singleton (3890 in chips) 
Seat 9: HighCardJasper (7953 in chips) 
RichRick1337: posts small blind 50
color_singleton: posts big blind 100
*** HOLE CARDS ***
Dealt to Duke Croix [7d 9c]
HighCardJasper: calls 100
dddocky: calls 100
Duke Croix: calls 100
Manon947: calls 100
RichRick1337: calls 50
color_singleton: checks 
*** FLOP *** [Qh Kd Js]
RichRick1337: checks 
color_singleton: checks 
HighCardJasper: checks 
dddocky: bets 100
Duke Croix: folds 
Manon947: calls 100
RichRick1337: folds 
color_singleton: calls 100
HighCardJasper: folds 
*** TURN *** [Qh Kd Js] [5c]
color_singleton: checks 
dddocky: checks 
Manon947: bets 425
color_singleton: folds 
dddocky: raises 425 to 850
Manon947: calls 425
*** RIVER *** [Qh Kd Js 5c] [Jh]
dddocky: bets 2457
Manon947: folds 
Uncalled bet (2457) returned to dddocky
dddocky collected 2457 from pot
dddocky: doesn't show hand 
*** SUMMARY ***
Total pot 2600 | Rake 143 
Board [Qh Kd Js 5c Jh]
Seat 1: dddocky collected (2457)
Seat 2: Duke Croix folded on the Flop
Seat 4: Manon947 (button) folded on the River
Seat 5: RichRick1337 (small blind) folded on the Flop
Seat 8: color_singleton (big blind) folded on the Turn
Seat 9: HighCardJasper folded on the Flop



PokerStars Home Game Hand #216254296907: {Club #3225207}  Hold'em No Limit (50/100) - 2020/07/09 18:32:37 ET
Table 'lets goo' 9-max (Play Money) Seat #5 is the button
Seat 1: dddocky (28539 in chips) 
Seat 2: Duke Croix (9730 in chips) 
Seat 4: Manon947 (2093 in chips) 
Seat 5: RichRick1337 (9150 in chips) 
Seat 8: color_singleton (3690 in chips) 
Seat 9: HighCardJasper (7853 in chips) 
color_singleton: posts small blind 50
HighCardJasper: posts big blind 100
*** HOLE CARDS ***
Dealt to Duke Croix [7h 4d]
dddocky: folds 
Duke Croix: folds 
Manon947: calls 100
RichRick1337: calls 100
color_singleton: calls 50
HighCardJasper: raises 200 to 300
Manon947: folds 
RichRick1337: calls 200
color_singleton: calls 200
*** FLOP *** [6h 7c Ad]
color_singleton: checks 
HighCardJasper: checks 
RichRick1337: checks 
*** TURN *** [6h 7c Ad] [8s]
color_singleton: bets 472
HighCardJasper: calls 472
RichRick1337: folds 
*** RIVER *** [6h 7c Ad 8s] [Qc]
color_singleton: bets 918
HighCardJasper: calls 918
*** SHOW DOWN ***
color_singleton: shows [6d Ah] (two pair, Aces and Sixes)
HighCardJasper: shows [8c 8d] (three of a kind, Eights)
HighCardJasper collected 3572 from pot
*** SUMMARY ***
Total pot 3780 | Rake 208 
Board [6h 7c Ad 8s Qc]
Seat 1: dddocky folded before Flop (didn't bet)
Seat 2: Duke Croix folded before Flop (didn't bet)
Seat 4: Manon947 folded before Flop
Seat 5: RichRick1337 (button) folded on the Turn
Seat 8: color_singleton (small blind) showed [6d Ah] and lost with two pair, Aces and Sixes
Seat 9: HighCardJasper (big blind) showed [8c 8d] and won (3572) with three of a kind, Eights



PokerStars Home Game Hand #216254325297: {Club #3225207}  Hold'em No Limit (50/100) - 2020/07/09 18:33:31 ET
Table 'lets goo' 9-max (Play Money) Seat #8 is the button
Seat 1: dddocky (28539 in chips) 
Seat 2: Duke Croix (9730 in chips) 
Seat 4: Manon947 (1993 in chips) 
Seat 5: RichRick1337 (8850 in chips) 
Seat 8: color_singleton (2000 in chips) 
Seat 9: HighCardJasper (9735 in chips) 
HighCardJasper: posts small blind 50
dddocky: posts big blind 100
*** HOLE CARDS ***
Dealt to Duke Croix [2c Ac]
Duke Croix: raises 200 to 300
Manon947: folds 
RichRick1337: calls 300
color_singleton: raises 1050 to 1350
HighCardJasper: folds 
dddocky: folds 
Duke Croix: folds 
RichRick1337: calls 1050
*** FLOP *** [Qc 5h Js]
RichRick1337: checks 
color_singleton: bets 650 and is all-in
RichRick1337: calls 650
*** TURN *** [Qc 5h Js] [As]
*** RIVER *** [Qc 5h Js As] [4h]
*** SHOW DOWN ***
RichRick1337: shows [7c Tc] (high card Ace)
color_singleton: shows [Qh Kd] (a pair of Queens)
color_singleton collected 4205 from pot
*** SUMMARY ***
Total pot 4450 | Rake 245 
Board [Qc 5h Js As 4h]
Seat 1: dddocky (big blind) folded before Flop
Seat 2: Duke Croix folded before Flop
Seat 4: Manon947 folded before Flop (didn't bet)
Seat 5: RichRick1337 showed [7c Tc] and lost with high card Ace
Seat 8: color_singleton (button) showed [Qh Kd] and won (4205) with a pair of Queens
Seat 9: HighCardJasper (small blind) folded before Flop



PokerStars Home Game Hand #216254352223: {Club #3225207}  Hold'em No Limit (50/100) - 2020/07/09 18:34:23 ET
Table 'lets goo' 9-max (Play Money) Seat #9 is the button
Seat 1: dddocky (28439 in chips) 
Seat 2: Duke Croix (9430 in chips) 
Seat 4: Manon947 (1993 in chips) 
Seat 5: RichRick1337 (6850 in chips) 
Seat 8: color_singleton (4205 in chips) 
Seat 9: HighCardJasper (9685 in chips) 
dddocky: posts small blind 50
Duke Croix: posts big blind 100
*** HOLE CARDS ***
Dealt to Duke Croix [8s 6d]
Manon947: calls 100
RichRick1337: calls 100
color_singleton: calls 100
HighCardJasper: calls 100
dddocky: calls 50
Duke Croix: checks 
*** FLOP *** [Ac 2s 6c]
dddocky: checks 
Duke Croix: bets 300
Manon947: folds 
RichRick1337: folds 
color_singleton: folds 
HighCardJasper: folds 
dddocky: folds 
Uncalled bet (300) returned to Duke Croix
Duke Croix collected 567 from pot
*** SUMMARY ***
Total pot 600 | Rake 33 
Board [Ac 2s 6c]
Seat 1: dddocky (small blind) folded on the Flop
Seat 2: Duke Croix (big blind) collected (567)
Seat 4: Manon947 folded on the Flop
Seat 5: RichRick1337 folded on the Flop
Seat 8: color_singleton folded on the Flop
Seat 9: HighCardJasper (button) folded on the Flop



PokerStars Home Game Hand #216254377442: {Club #3225207}  Hold'em No Limit (50/100) - 2020/07/09 18:35:11 ET
Table 'lets goo' 9-max (Play Money) Seat #1 is the button
Seat 1: dddocky (28339 in chips) 
Seat 2: Duke Croix (9897 in chips) 
Seat 4: Manon947 (1893 in chips) 
Seat 5: RichRick1337 (6750 in chips) 
Seat 8: color_singleton (4105 in chips) 
Seat 9: HighCardJasper (9585 in chips) 
Duke Croix: posts small blind 50
Manon947: posts big blind 100
*** HOLE CARDS ***
Dealt to Duke Croix [4c 7s]
RichRick1337: folds 
color_singleton: folds 
HighCardJasper: raises 100 to 200
dddocky: calls 200
Duke Croix: calls 150
Manon947: calls 100
*** FLOP *** [Ts 7h 5d]
Duke Croix: bets 400
Manon947: folds 
HighCardJasper: folds 
dddocky: calls 400
*** TURN *** [Ts 7h 5d] [2h]
Duke Croix: checks 
dddocky: checks 
*** RIVER *** [Ts 7h 5d 2h] [6s]
Duke Croix: checks 
dddocky: bets 100
Duke Croix: calls 100
*** SHOW DOWN ***
dddocky: shows [Ad Ac] (a pair of Aces)
Duke Croix: mucks hand 
dddocky collected 1701 from pot
*** SUMMARY ***
Total pot 1800 | Rake 99 
Board [Ts 7h 5d 2h 6s]
Seat 1: dddocky (button) showed [Ad Ac] and won (1701) with a pair of Aces
Seat 2: Duke Croix (small blind) mucked [4c 7s]
Seat 4: Manon947 (big blind) folded on the Flop
Seat 5: RichRick1337 folded before Flop (didn't bet)
Seat 8: color_singleton folded before Flop (didn't bet)
Seat 9: HighCardJasper folded on the Flop



PokerStars Home Game Hand #216254400870: {Club #3225207}  Hold'em No Limit (50/100) - 2020/07/09 18:35:57 ET
Table 'lets goo' 9-max (Play Money) Seat #2 is the button
Seat 1: dddocky (29340 in chips) 
Seat 2: Duke Croix (9197 in chips) 
Seat 4: Manon947 (1693 in chips) 
Seat 5: RichRick1337 (6750 in chips) 
Seat 8: color_singleton (4105 in chips) 
Seat 9: HighCardJasper (9385 in chips) 
Manon947: posts small blind 50
RichRick1337: posts big blind 100
*** HOLE CARDS ***
Dealt to Duke Croix [2c 7h]
color_singleton: folds 
HighCardJasper: calls 100
dddocky: calls 100
Duke Croix: folds 
Manon947: calls 50
RichRick1337: checks 
*** FLOP *** [6d Kh 9h]
Manon947: checks 
RichRick1337: checks 
HighCardJasper: checks 
dddocky: checks 
*** TURN *** [6d Kh 9h] [Ks]
Manon947: checks 
RichRick1337: bets 378
HighCardJasper: folds 
dddocky: calls 378
Manon947: calls 378
*** RIVER *** [6d Kh 9h Ks] [7c]
Manon947: checks 
RichRick1337: bets 1450
dddocky: folds 
Manon947: folds 
Uncalled bet (1450) returned to RichRick1337
RichRick1337 collected 1450 from pot
RichRick1337: doesn't show hand 
*** SUMMARY ***
Total pot 1534 | Rake 84 
Board [6d Kh 9h Ks 7c]
Seat 1: dddocky folded on the River
Seat 2: Duke Croix (button) folded before Flop (didn't bet)
Seat 4: Manon947 (small blind) folded on the River
Seat 5: RichRick1337 (big blind) collected (1450)
Seat 8: color_singleton folded before Flop (didn't bet)
Seat 9: HighCardJasper folded on the Turn



PokerStars Home Game Hand #216254428223: {Club #3225207}  Hold'em No Limit (50/100) - 2020/07/09 18:36:50 ET
Table 'lets goo' 9-max (Play Money) Seat #4 is the button
Seat 1: dddocky (28862 in chips) 
Seat 2: Duke Croix (9197 in chips) 
Seat 4: Manon947 (1215 in chips) 
Seat 5: RichRick1337 (7722 in chips) 
Seat 8: color_singleton (4105 in chips) 
Seat 9: HighCardJasper (9285 in chips) 
RichRick1337: posts small blind 50
color_singleton: posts big blind 100
*** HOLE CARDS ***
Dealt to Duke Croix [5d 4s]
HighCardJasper: raises 100 to 200
dddocky: folds 
Duke Croix: folds 
Manon947: folds 
RichRick1337: calls 150
color_singleton: calls 100
*** FLOP *** [8d 8h Ts]
RichRick1337: checks 
color_singleton: checks 
HighCardJasper: checks 
*** TURN *** [8d 8h Ts] [6c]
RichRick1337: checks 
color_singleton: checks 
HighCardJasper: checks 
*** RIVER *** [8d 8h Ts 6c] [3d]
RichRick1337: checks 
color_singleton: checks 
HighCardJasper: bets 200
RichRick1337: folds 
color_singleton: folds 
Uncalled bet (200) returned to HighCardJasper
HighCardJasper collected 567 from pot
HighCardJasper: doesn't show hand 
*** SUMMARY ***
Total pot 600 | Rake 33 
Board [8d 8h Ts 6c 3d]
Seat 1: dddocky folded before Flop (didn't bet)
Seat 2: Duke Croix folded before Flop (didn't bet)
Seat 4: Manon947 (button) folded before Flop (didn't bet)
Seat 5: RichRick1337 (small blind) folded on the River
Seat 8: color_singleton (big blind) folded on the River
Seat 9: HighCardJasper collected (567)



PokerStars Home Game Hand #216254454554: {Club #3225207}  Hold'em No Limit (50/100) - 2020/07/09 18:37:35 ET
Table 'lets goo' 9-max (Play Money) Seat #5 is the button
Seat 1: dddocky (28862 in chips) 
Seat 2: Duke Croix (9197 in chips) 
Seat 4: Manon947 (1215 in chips) 
Seat 5: RichRick1337 (7522 in chips) 
Seat 8: color_singleton (3905 in chips) 
Seat 9: HighCardJasper (9652 in chips) 
color_singleton: posts small blind 50
HighCardJasper: posts big blind 100
*** HOLE CARDS ***
Dealt to Duke Croix [2c 5h]
dddocky: calls 100
Duke Croix: folds 
Manon947: calls 100
RichRick1337: calls 100
color_singleton: raises 200 to 300
HighCardJasper: calls 200
dddocky: calls 200
Manon947: calls 200
RichRick1337: calls 200
*** FLOP *** [Tc 4d Jc]
color_singleton: bets 708
HighCardJasper: calls 708
dddocky: calls 708
Manon947: folds 
RichRick1337: calls 708
*** TURN *** [Tc 4d Jc] [4h]
color_singleton: checks 
HighCardJasper: checks 
dddocky: checks 
RichRick1337: bets 500
color_singleton: calls 500
HighCardJasper: calls 500
dddocky: calls 500
*** RIVER *** [Tc 4d Jc 4h] [2d]
color_singleton: bets 2397 and is all-in
HighCardJasper: folds 
dddocky: calls 2397
RichRick1337: calls 2397
*** SHOW DOWN ***
color_singleton: shows [4s Ks] (three of a kind, Fours)
dddocky: mucks hand 
RichRick1337: mucks hand 
color_singleton collected 12779 from pot
*** SUMMARY ***
Total pot 13523 | Rake 744 
Board [Tc 4d Jc 4h 2d]
Seat 1: dddocky mucked [Js 6s]
Seat 2: Duke Croix folded before Flop (didn't bet)
Seat 4: Manon947 folded on the Flop
Seat 5: RichRick1337 (button) mucked [7s 7d]
Seat 8: color_singleton (small blind) showed [4s Ks] and won (12779) with three of a kind, Fours
Seat 9: HighCardJasper (big blind) folded on the River



PokerStars Home Game Hand #216254506776: {Club #3225207}  Hold'em No Limit (50/100) - 2020/07/09 18:39:18 ET
Table 'lets goo' 9-max (Play Money) Seat #8 is the button
Seat 1: dddocky (24957 in chips) 
Seat 2: Duke Croix (9197 in chips) 
Seat 4: Manon947 (915 in chips) 
Seat 5: RichRick1337 (3617 in chips) 
Seat 8: color_singleton (12779 in chips) 
Seat 9: HighCardJasper (8144 in chips) 
HighCardJasper: posts small blind 50
dddocky: posts big blind 100
*** HOLE CARDS ***
Dealt to Duke Croix [Td Ts]
Duke Croix: raises 300 to 400
Manon947: folds 
RichRick1337: folds 
color_singleton: folds 
HighCardJasper: calls 350
dddocky: calls 300
*** FLOP *** [Jh Js Kh]
HighCardJasper: checks 
dddocky: checks 
Duke Croix: bets 700
HighCardJasper: folds 
dddocky: folds 
Uncalled bet (700) returned to Duke Croix
Duke Croix collected 1134 from pot
*** SUMMARY ***
Total pot 1200 | Rake 66 
Board [Jh Js Kh]
Seat 1: dddocky (big blind) folded on the Flop
Seat 2: Duke Croix collected (1134)
Seat 4: Manon947 folded before Flop (didn't bet)
Seat 5: RichRick1337 folded before Flop (didn't bet)
Seat 8: color_singleton (button) folded before Flop (didn't bet)
Seat 9: HighCardJasper (small blind) folded on the Flop



PokerStars Home Game Hand #216254528234: {Club #3225207}  Hold'em No Limit (50/100) - 2020/07/09 18:40:00 ET
Table 'lets goo' 9-max (Play Money) Seat #9 is the button
Seat 1: dddocky (24557 in chips) 
Seat 2: Duke Croix (9931 in chips) 
Seat 4: Manon947 (915 in chips) 
Seat 5: RichRick1337 (3617 in chips) 
Seat 8: color_singleton (12779 in chips) 
Seat 9: HighCardJasper (7744 in chips) 
dddocky: posts small blind 50
Duke Croix: posts big blind 100
*** HOLE CARDS ***
Dealt to Duke Croix [Tc 4d]
Manon947: calls 100
RichRick1337: calls 100
color_singleton: folds 
HighCardJasper: calls 100
dddocky: calls 50
Duke Croix: checks 
*** FLOP *** [3s 5h 8c]
dddocky: checks 
Duke Croix: checks 
Manon947: checks 
RichRick1337: checks 
HighCardJasper: checks 
*** TURN *** [3s 5h 8c] [8h]
dddocky: checks 
Duke Croix: checks 
Manon947: bets 236
RichRick1337: calls 236
HighCardJasper: folds 
dddocky: folds 
Duke Croix: folds 
*** RIVER *** [3s 5h 8c 8h] [Ks]
Manon947: checks 
RichRick1337: checks 
*** SHOW DOWN ***
Manon947: shows [6c 6d] (two pair, Eights and Sixes)
RichRick1337: mucks hand 
Manon947 collected 919 from pot
*** SUMMARY ***
Total pot 972 | Rake 53 
Board [3s 5h 8c 8h Ks]
Seat 1: dddocky (small blind) folded on the Turn
Seat 2: Duke Croix (big blind) folded on the Turn
Seat 4: Manon947 showed [6c 6d] and won (919) with two pair, Eights and Sixes
Seat 5: RichRick1337 mucked [7s Th]
Seat 8: color_singleton folded before Flop (didn't bet)
Seat 9: HighCardJasper (button) folded on the Turn



PokerStars Home Game Hand #216254554224: {Club #3225207}  Hold'em No Limit (50/100) - 2020/07/09 18:40:52 ET
Table 'lets goo' 9-max (Play Money) Seat #1 is the button
Seat 1: dddocky (24457 in chips) 
Seat 2: Duke Croix (9831 in chips) 
Seat 4: Manon947 (1498 in chips) 
Seat 5: RichRick1337 (3281 in chips) 
Seat 8: color_singleton (12779 in chips) 
Seat 9: HighCardJasper (7644 in chips) 
Duke Croix: posts small blind 50
Manon947: posts big blind 100
*** HOLE CARDS ***
Dealt to Duke Croix [6d 3c]
RichRick1337: folds 
color_singleton: folds 
HighCardJasper: calls 100
dddocky: calls 100
Duke Croix: calls 50
Manon947: checks 
*** FLOP *** [Ts Qc Ac]
Duke Croix: checks 
Manon947: checks 
HighCardJasper: checks 
dddocky: checks 
*** TURN *** [Ts Qc Ac] [Jd]
Duke Croix: checks 
Manon947: checks 
HighCardJasper: checks 
dddocky: checks 
*** RIVER *** [Ts Qc Ac Jd] [Qd]
Duke Croix: checks 
Manon947: checks 
HighCardJasper: bets 200
dddocky: folds 
Duke Croix: folds 
Manon947: calls 200
*** SHOW DOWN ***
HighCardJasper: shows [6s Qs] (three of a kind, Queens)
Manon947: mucks hand 
HighCardJasper collected 756 from pot
*** SUMMARY ***
Total pot 800 | Rake 44 
Board [Ts Qc Ac Jd Qd]
Seat 1: dddocky (button) folded on the River
Seat 2: Duke Croix (small blind) folded on the River
Seat 4: Manon947 (big blind) mucked [3d 5d]
Seat 5: RichRick1337 folded before Flop (didn't bet)
Seat 8: color_singleton folded before Flop (didn't bet)
Seat 9: HighCardJasper showed [6s Qs] and won (756) with three of a kind, Queens



PokerStars Home Game Hand #216254581401: {Club #3225207}  Hold'em No Limit (50/100) - 2020/07/09 18:41:45 ET
Table 'lets goo' 9-max (Play Money) Seat #2 is the button
Seat 1: dddocky (24357 in chips) 
Seat 2: Duke Croix (9731 in chips) 
Seat 4: Manon947 (1198 in chips) 
Seat 5: RichRick1337 (3281 in chips) 
Seat 8: color_singleton (12779 in chips) 
Seat 9: HighCardJasper (8100 in chips) 
Manon947: posts small blind 50
RichRick1337: posts big blind 100
*** HOLE CARDS ***
Dealt to Duke Croix [9s 7d]
color_singleton: folds 
HighCardJasper: calls 100
dddocky: calls 100
Duke Croix: calls 100
Manon947: calls 50
RichRick1337: raises 300 to 400
HighCardJasper: folds 
dddocky: calls 300
Duke Croix: calls 300
Manon947: calls 300
*** FLOP *** [3d 3c Qs]
Manon947: checks 
RichRick1337: bets 803
dddocky: folds 
Duke Croix: folds 
Manon947: folds 
Uncalled bet (803) returned to RichRick1337
RichRick1337 collected 1606 from pot
RichRick1337: doesn't show hand 
*** SUMMARY ***
Total pot 1700 | Rake 94 
Board [3d 3c Qs]
Seat 1: dddocky folded on the Flop
Seat 2: Duke Croix (button) folded on the Flop
Seat 4: Manon947 (small blind) folded on the Flop
Seat 5: RichRick1337 (big blind) collected (1606)
Seat 8: color_singleton folded before Flop (didn't bet)
Seat 9: HighCardJasper folded before Flop



PokerStars Home Game Hand #216254603466: {Club #3225207}  Hold'em No Limit (50/100) - 2020/07/09 18:42:29 ET
Table 'lets goo' 9-max (Play Money) Seat #4 is the button
Seat 1: dddocky (23957 in chips) 
Seat 2: Duke Croix (9331 in chips) 
Seat 4: Manon947 (798 in chips) 
Seat 5: RichRick1337 (4487 in chips) 
Seat 8: color_singleton (12779 in chips) 
Seat 9: HighCardJasper (8000 in chips) 
RichRick1337: posts small blind 50
color_singleton: posts big blind 100
*** HOLE CARDS ***
Dealt to Duke Croix [6h Qh]
HighCardJasper: calls 100
dddocky: calls 100
Duke Croix: folds 
Manon947: calls 100
RichRick1337: calls 50
color_singleton: checks 
*** FLOP *** [Js Jd Ks]
RichRick1337: checks 
color_singleton: checks 
HighCardJasper: checks 
dddocky: checks 
Manon947: bets 236
RichRick1337: folds 
color_singleton: calls 236
HighCardJasper: folds 
dddocky: folds 
*** TURN *** [Js Jd Ks] [5h]
color_singleton: bets 459
Manon947: raises 3 to 462 and is all-in
color_singleton: calls 3
*** RIVER *** [Js Jd Ks 5h] [Th]
*** SHOW DOWN ***
color_singleton: shows [9s Kh] (two pair, Kings and Jacks)
Manon947: shows [Jh 8d] (three of a kind, Jacks)
Manon947 collected 1792 from pot
*** SUMMARY ***
Total pot 1896 | Rake 104 
Board [Js Jd Ks 5h Th]
Seat 1: dddocky folded on the Flop
Seat 2: Duke Croix folded before Flop (didn't bet)
Seat 4: Manon947 (button) showed [Jh 8d] and won (1792) with three of a kind, Jacks
Seat 5: RichRick1337 (small blind) folded on the Flop
Seat 8: color_singleton (big blind) showed [9s Kh] and lost with two pair, Kings and Jacks
Seat 9: HighCardJasper folded on the Flop



PokerStars Home Game Hand #216254628140: {Club #3225207}  Hold'em No Limit (50/100) - 2020/07/09 18:43:18 ET
Table 'lets goo' 9-max (Play Money) Seat #5 is the button
Seat 1: dddocky (23857 in chips) 
Seat 2: Duke Croix (9331 in chips) 
Seat 4: Manon947 (1792 in chips) 
Seat 5: RichRick1337 (4387 in chips) 
Seat 8: color_singleton (11981 in chips) 
Seat 9: HighCardJasper (7900 in chips) 
color_singleton: posts small blind 50
HighCardJasper: posts big blind 100
*** HOLE CARDS ***
Dealt to Duke Croix [Kc 3c]
dddocky: folds 
Duke Croix: calls 100
Manon947: calls 100
RichRick1337: calls 100
color_singleton: calls 50
HighCardJasper: checks 
*** FLOP *** [Jd As 2h]
color_singleton: checks 
HighCardJasper: checks 
Duke Croix: checks 
Manon947: checks 
RichRick1337: bets 100
color_singleton: folds 
HighCardJasper: calls 100
Duke Croix: folds 
Manon947: calls 100
*** TURN *** [Jd As 2h] [7c]
HighCardJasper: checks 
Manon947: checks 
RichRick1337: checks 
*** RIVER *** [Jd As 2h 7c] [2c]
HighCardJasper: checks 
Manon947: bets 378
RichRick1337: raises 378 to 756
HighCardJasper: folds 
Manon947: calls 378
*** SHOW DOWN ***
RichRick1337: shows [Ah Tc] (two pair, Aces and Deuces)
Manon947: shows [2s 4c] (three of a kind, Deuces)
Manon947 collected 2185 from pot
*** SUMMARY ***
Total pot 2312 | Rake 127 
Board [Jd As 2h 7c 2c]
Seat 1: dddocky folded before Flop (didn't bet)
Seat 2: Duke Croix folded on the Flop
Seat 4: Manon947 showed [2s 4c] and won (2185) with three of a kind, Deuces
Seat 5: RichRick1337 (button) showed [Ah Tc] and lost with two pair, Aces and Deuces
Seat 8: color_singleton (small blind) folded on the Flop
Seat 9: HighCardJasper (big blind) folded on the River



PokerStars Home Game Hand #216254666250: {Club #3225207}  Hold'em No Limit (50/100) - 2020/07/09 18:44:34 ET
Table 'lets goo' 9-max (Play Money) Seat #8 is the button
Seat 1: dddocky (23857 in chips) 
Seat 2: Duke Croix (9231 in chips) 
Seat 4: Manon947 (3021 in chips) 
Seat 5: RichRick1337 (3431 in chips) 
Seat 8: color_singleton (11881 in chips) 
Seat 9: HighCardJasper (7700 in chips) 
HighCardJasper: posts small blind 50
dddocky: posts big blind 100
*** HOLE CARDS ***
Dealt to Duke Croix [Ts Th]
Duke Croix: raises 300 to 400
Manon947: calls 400
RichRick1337: calls 400
color_singleton: folds 
HighCardJasper: calls 350
dddocky: calls 300
*** FLOP *** [Td Ah 7d]
HighCardJasper: checks 
dddocky: checks 
Duke Croix: bets 800
Manon947: folds 
RichRick1337: folds 
HighCardJasper: folds 
dddocky: folds 
Uncalled bet (800) returned to Duke Croix
Duke Croix collected 1890 from pot
*** SUMMARY ***
Total pot 2000 | Rake 110 
Board [Td Ah 7d]
Seat 1: dddocky (big blind) folded on the Flop
Seat 2: Duke Croix collected (1890)
Seat 4: Manon947 folded on the Flop
Seat 5: RichRick1337 folded on the Flop
Seat 8: color_singleton (button) folded before Flop (didn't bet)
Seat 9: HighCardJasper (small blind) folded on the Flop



PokerStars Home Game Hand #216254686729: {Club #3225207}  Hold'em No Limit (50/100) - 2020/07/09 18:45:15 ET
Table 'lets goo' 9-max (Play Money) Seat #9 is the button
Seat 1: dddocky (23457 in chips) 
Seat 2: Duke Croix (10721 in chips) 
Seat 4: Manon947 (2621 in chips) 
Seat 5: RichRick1337 (3031 in chips) 
Seat 8: color_singleton (11881 in chips) 
Seat 9: HighCardJasper (7300 in chips) 
dddocky: posts small blind 50
Duke Croix: posts big blind 100
*** HOLE CARDS ***
Dealt to Duke Croix [Jh 3s]
Manon947: folds 
RichRick1337: calls 100
color_singleton: folds 
HighCardJasper: calls 100
dddocky: calls 50
Duke Croix: checks 
*** FLOP *** [2c 5h 8d]
dddocky: bets 100
Duke Croix: folds 
RichRick1337: folds 
HighCardJasper: calls 100
*** TURN *** [2c 5h 8d] [Js]
dddocky: checks 
HighCardJasper: checks 
*** RIVER *** [2c 5h 8d Js] [4d]
dddocky: checks 
HighCardJasper: checks 
*** SHOW DOWN ***
dddocky: shows [8s Kd] (a pair of Eights)
HighCardJasper: mucks hand 
dddocky collected 567 from pot
*** SUMMARY ***
Total pot 600 | Rake 33 
Board [2c 5h 8d Js 4d]
Seat 1: dddocky (small blind) showed [8s Kd] and won (567) with a pair of Eights
Seat 2: Duke Croix (big blind) folded on the Flop
Seat 4: Manon947 folded before Flop (didn't bet)
Seat 5: RichRick1337 folded on the Flop
Seat 8: color_singleton folded before Flop (didn't bet)
Seat 9: HighCardJasper (button) mucked [5c Ah]



PokerStars Home Game Hand #216254711250: {Club #3225207}  Hold'em No Limit (50/100) - 2020/07/09 18:46:04 ET
Table 'lets goo' 9-max (Play Money) Seat #1 is the button
Seat 1: dddocky (23824 in chips) 
Seat 2: Duke Croix (10621 in chips) 
Seat 4: Manon947 (2621 in chips) 
Seat 5: RichRick1337 (2931 in chips) 
Seat 8: color_singleton (11881 in chips) 
Seat 9: HighCardJasper (7100 in chips) 
Duke Croix: posts small blind 50
Manon947: posts big blind 100
*** HOLE CARDS ***
Dealt to Duke Croix [5h 3h]
RichRick1337: calls 100
color_singleton: folds 
HighCardJasper: calls 100
dddocky: folds 
Duke Croix: calls 50
Manon947: checks 
*** FLOP *** [Jd Ah Ad]
Duke Croix: checks 
Manon947: checks 
RichRick1337: checks 
HighCardJasper: checks 
*** TURN *** [Jd Ah Ad] [Js]
Duke Croix: checks 
Manon947: checks 
RichRick1337: checks 
HighCardJasper: checks 
*** RIVER *** [Jd Ah Ad Js] [7c]
Duke Croix: checks 
Manon947: checks 
RichRick1337: checks 
HighCardJasper: checks 
*** SHOW DOWN ***
Duke Croix: shows [5h 3h] (two pair, Aces and Jacks)
Manon947: shows [Qh 5d] (two pair, Aces and Jacks - Queen kicker)
RichRick1337: mucks hand 
HighCardJasper: mucks hand 
Manon947 collected 378 from pot
*** SUMMARY ***
Total pot 400 | Rake 22 
Board [Jd Ah Ad Js 7c]
Seat 1: dddocky (button) folded before Flop (didn't bet)
Seat 2: Duke Croix (small blind) showed [5h 3h] and lost with two pair, Aces and Jacks
Seat 4: Manon947 (big blind) showed [Qh 5d] and won (378) with two pair, Aces and Jacks
Seat 5: RichRick1337 mucked [5s 6c]
Seat 8: color_singleton folded before Flop (didn't bet)
Seat 9: HighCardJasper mucked [3d 5c]



PokerStars Home Game Hand #216254733100: {Club #3225207}  Hold'em No Limit (50/100) - 2020/07/09 18:46:48 ET
Table 'lets goo' 9-max (Play Money) Seat #2 is the button
Seat 1: dddocky (23824 in chips) 
Seat 2: Duke Croix (10521 in chips) 
Seat 4: Manon947 (2899 in chips) 
Seat 5: RichRick1337 (2831 in chips) 
Seat 8: color_singleton (11881 in chips) 
Seat 9: HighCardJasper (7000 in chips) 
Manon947: posts small blind 50
RichRick1337: posts big blind 100
*** HOLE CARDS ***
Dealt to Duke Croix [8s 9h]
color_singleton: raises 100 to 200
HighCardJasper: calls 200
dddocky: calls 200
Duke Croix: calls 200
Manon947: calls 150
RichRick1337: folds 
*** FLOP *** [2s 2d 7s]
Manon947: bets 519
color_singleton: folds 
HighCardJasper: folds 
dddocky: calls 519
Duke Croix: folds 
*** TURN *** [2s 2d 7s] [Ah]
Manon947: bets 1010
dddocky: calls 1010
*** RIVER *** [2s 2d 7s Ah] [3c]
Manon947: bets 1170 and is all-in
dddocky: calls 1170
*** SHOW DOWN ***
Manon947: shows [2c 9c] (three of a kind, Deuces)
dddocky: shows [2h Ac] (a full house, Deuces full of Aces)
dddocky collected 6141 from pot
*** SUMMARY ***
Total pot 6498 | Rake 357 
Board [2s 2d 7s Ah 3c]
Seat 1: dddocky showed [2h Ac] and won (6141) with a full house, Deuces full of Aces
Seat 2: Duke Croix (button) folded on the Flop
Seat 4: Manon947 (small blind) showed [2c 9c] and lost with three of a kind, Deuces
Seat 5: RichRick1337 (big blind) folded before Flop
Seat 8: color_singleton folded on the Flop
Seat 9: HighCardJasper folded on the Flop



PokerStars Home Game Hand #216254757768: {Club #3225207}  Hold'em No Limit (50/100) - 2020/07/09 18:47:37 ET
Table 'lets goo' 9-max (Play Money) Seat #5 is the button
Seat 1: dddocky (27066 in chips) 
Seat 2: Duke Croix (10321 in chips) 
Seat 5: RichRick1337 (2731 in chips) 
Seat 8: color_singleton (11681 in chips) 
Seat 9: HighCardJasper (6800 in chips) 
color_singleton: posts small blind 50
HighCardJasper: posts big blind 100
*** HOLE CARDS ***
Dealt to Duke Croix [3s 2s]
dddocky: calls 100
Duke Croix: calls 100
RichRick1337: folds 
color_singleton: calls 50
HighCardJasper: checks 
*** FLOP *** [8c 3c 9s]
color_singleton: checks 
HighCardJasper: checks 
dddocky: checks 
Duke Croix: checks 
*** TURN *** [8c 3c 9s] [Jh]
color_singleton: checks 
HighCardJasper: bets 300
dddocky: folds 
Duke Croix: folds 
color_singleton: folds 
Uncalled bet (300) returned to HighCardJasper
HighCardJasper collected 378 from pot
HighCardJasper: doesn't show hand 
*** SUMMARY ***
Total pot 400 | Rake 22 
Board [8c 3c 9s Jh]
Seat 1: dddocky folded on the Turn
Seat 2: Duke Croix folded on the Turn
Seat 5: RichRick1337 (button) folded before Flop (didn't bet)
Seat 8: color_singleton (small blind) folded on the Turn
Seat 9: HighCardJasper (big blind) collected (378)



PokerStars Home Game Hand #216254785353: {Club #3225207}  Hold'em No Limit (50/100) - 2020/07/09 18:48:28 ET
Table 'lets goo' 9-max (Play Money) Seat #8 is the button
Seat 1: dddocky (26966 in chips) 
Seat 2: Duke Croix (10221 in chips) 
Seat 4: Manon947 (10000 in chips) 
Seat 5: RichRick1337 (2731 in chips) 
Seat 8: color_singleton (11581 in chips) 
Seat 9: HighCardJasper (7078 in chips) 
HighCardJasper: posts small blind 50
dddocky: posts big blind 100
*** HOLE CARDS ***
Dealt to Duke Croix [7s 7c]
Duke Croix: raises 400 to 500
Manon947: folds 
RichRick1337: folds 
color_singleton: folds 
HighCardJasper: folds 
dddocky: folds 
Uncalled bet (400) returned to Duke Croix
Duke Croix collected 250 from pot
*** SUMMARY ***
Total pot 250 | Rake 0 
Seat 1: dddocky (big blind) folded before Flop
Seat 2: Duke Croix collected (250)
Seat 4: Manon947 folded before Flop (didn't bet)
Seat 5: RichRick1337 folded before Flop (didn't bet)
Seat 8: color_singleton (button) folded before Flop (didn't bet)
Seat 9: HighCardJasper (small blind) folded before Flop



PokerStars Home Game Hand #216254794261: {Club #3225207}  Hold'em No Limit (50/100) - 2020/07/09 18:48:46 ET
Table 'lets goo' 9-max (Play Money) Seat #9 is the button
Seat 1: dddocky (26866 in chips) 
Seat 2: Duke Croix (10371 in chips) 
Seat 4: Manon947 (10000 in chips) 
Seat 5: RichRick1337 (2731 in chips) 
Seat 8: color_singleton (11581 in chips) 
Seat 9: HighCardJasper (7028 in chips) 
dddocky: posts small blind 50
Duke Croix: posts big blind 100
*** HOLE CARDS ***
Dealt to Duke Croix [6c 9h]
Manon947: calls 100
RichRick1337: calls 100
color_singleton: folds 
HighCardJasper: calls 100
dddocky: calls 50
Duke Croix: checks 
*** FLOP *** [8s 9d Jc]
dddocky: checks 
Duke Croix: checks 
Manon947: bets 236
RichRick1337: folds 
HighCardJasper: folds 
dddocky: calls 236
Duke Croix: calls 236
*** TURN *** [8s 9d Jc] [8c]
dddocky: checks 
Duke Croix: checks 
Manon947: bets 571
dddocky: calls 571
Duke Croix: calls 571
*** RIVER *** [8s 9d Jc 8c] [As]
dddocky: checks 
Duke Croix: checks 
Manon947: bets 1380
dddocky: folds 
Duke Croix: folds 
Uncalled bet (1380) returned to Manon947
Manon947 collected 2760 from pot
*** SUMMARY ***
Total pot 2921 | Rake 161 
Board [8s 9d Jc 8c As]
Seat 1: dddocky (small blind) folded on the River
Seat 2: Duke Croix (big blind) folded on the River
Seat 4: Manon947 collected (2760)
Seat 5: RichRick1337 folded on the Flop
Seat 8: color_singleton folded before Flop (didn't bet)
Seat 9: HighCardJasper (button) folded on the Flop



PokerStars Home Game Hand #216254838581: {Club #3225207}  Hold'em No Limit (50/100) - 2020/07/09 18:50:15 ET
Table 'lets goo' 9-max (Play Money) Seat #1 is the button
Seat 1: dddocky (25959 in chips) 
Seat 2: Duke Croix (9464 in chips) 
Seat 4: Manon947 (11853 in chips) 
Seat 5: RichRick1337 (2631 in chips) 
Seat 8: color_singleton (11581 in chips) 
Seat 9: HighCardJasper (6928 in chips) 
Duke Croix: posts small blind 50
Manon947: posts big blind 100
*** HOLE CARDS ***
Dealt to Duke Croix [2h 7d]
RichRick1337: calls 100
color_singleton: folds 
HighCardJasper: calls 100
dddocky: folds 
Duke Croix: folds 
Manon947: checks 
*** FLOP *** [4h Qc 5h]
Manon947: bets 165
RichRick1337: folds 
HighCardJasper: calls 165
*** TURN *** [4h Qc 5h] [Td]
Manon947: bets 321
HighCardJasper: folds 
Uncalled bet (321) returned to Manon947
Manon947 collected 643 from pot
*** SUMMARY ***
Total pot 680 | Rake 37 
Board [4h Qc 5h Td]
Seat 1: dddocky (button) folded before Flop (didn't bet)
Seat 2: Duke Croix (small blind) folded before Flop
Seat 4: Manon947 (big blind) collected (643)
Seat 5: RichRick1337 folded on the Flop
Seat 8: color_singleton folded before Flop (didn't bet)
Seat 9: HighCardJasper folded on the Turn



PokerStars Home Game Hand #216254858178: {Club #3225207}  Hold'em No Limit (50/100) - 2020/07/09 18:50:55 ET
Table 'lets goo' 9-max (Play Money) Seat #2 is the button
Seat 1: dddocky (25959 in chips) 
Seat 2: Duke Croix (9414 in chips) 
Seat 4: Manon947 (12231 in chips) 
Seat 5: RichRick1337 (2531 in chips) 
Seat 8: color_singleton (11581 in chips) 
Seat 9: HighCardJasper (6663 in chips) 
Manon947: posts small blind 50
RichRick1337: posts big blind 100
*** HOLE CARDS ***
Dealt to Duke Croix [2c 5s]
color_singleton has timed out
color_singleton: folds 
HighCardJasper: calls 100
dddocky: folds 
Duke Croix: folds 
Manon947: folds 
RichRick1337: checks 
*** FLOP *** [7s Kc Qh]
RichRick1337: checks 
HighCardJasper: bets 200
RichRick1337: folds 
Uncalled bet (200) returned to HighCardJasper
HighCardJasper collected 236 from pot
HighCardJasper: doesn't show hand 
*** SUMMARY ***
Total pot 250 | Rake 14 
Board [7s Kc Qh]
Seat 1: dddocky folded before Flop (didn't bet)
Seat 2: Duke Croix (button) folded before Flop (didn't bet)
Seat 4: Manon947 (small blind) folded before Flop
Seat 5: RichRick1337 (big blind) folded on the Flop
Seat 8: color_singleton folded before Flop (didn't bet)
Seat 9: HighCardJasper collected (236)



PokerStars Home Game Hand #216254882539: {Club #3225207}  Hold'em No Limit (50/100) - 2020/07/09 18:51:45 ET
Table 'lets goo' 9-max (Play Money) Seat #4 is the button
Seat 1: dddocky (25959 in chips) 
Seat 2: Duke Croix (9414 in chips) 
Seat 4: Manon947 (12181 in chips) 
Seat 5: RichRick1337 (2431 in chips) 
Seat 8: color_singleton (11581 in chips) 
Seat 9: HighCardJasper (6799 in chips) 
RichRick1337: posts small blind 50
color_singleton: posts big blind 100
*** HOLE CARDS ***
Dealt to Duke Croix [Th 3c]
HighCardJasper: calls 100
dddocky: folds 
Duke Croix: folds 
Manon947: folds 
RichRick1337: calls 50
color_singleton: raises 100 to 200
HighCardJasper: calls 100
RichRick1337: calls 100
*** FLOP *** [Tc 2s Kh]
RichRick1337: bets 100
color_singleton: raises 383 to 483
HighCardJasper: folds 
RichRick1337: calls 383
*** TURN *** [Tc 2s Kh] [Jh]
RichRick1337: checks 
color_singleton: checks 
*** RIVER *** [Tc 2s Kh Jh] [Ad]
RichRick1337: checks 
color_singleton: bets 1480
RichRick1337: folds 
Uncalled bet (1480) returned to color_singleton
color_singleton collected 1480 from pot
color_singleton: doesn't show hand 
*** SUMMARY ***
Total pot 1566 | Rake 86 
Board [Tc 2s Kh Jh Ad]
Seat 1: dddocky folded before Flop (didn't bet)
Seat 2: Duke Croix folded before Flop (didn't bet)
Seat 4: Manon947 (button) folded before Flop (didn't bet)
Seat 5: RichRick1337 (small blind) folded on the River
Seat 8: color_singleton (big blind) collected (1480)
Seat 9: HighCardJasper folded on the Flop



PokerStars Home Game Hand #216254913542: {Club #3225207}  Hold'em No Limit (50/100) - 2020/07/09 18:52:48 ET
Table 'lets goo' 9-max (Play Money) Seat #5 is the button
Seat 1: dddocky (25959 in chips) 
Seat 2: Duke Croix (9414 in chips) 
Seat 4: Manon947 (12181 in chips) 
Seat 5: RichRick1337 (1748 in chips) 
Seat 8: color_singleton (12378 in chips) 
Seat 9: HighCardJasper (6599 in chips) 
color_singleton: posts small blind 50
HighCardJasper: posts big blind 100
*** HOLE CARDS ***
Dealt to Duke Croix [4s 4c]
dddocky: calls 100
Duke Croix: raises 500 to 600
Manon947: folds 
RichRick1337: folds 
color_singleton: folds 
HighCardJasper: folds 
dddocky: folds 
Uncalled bet (500) returned to Duke Croix
Duke Croix collected 350 from pot
*** SUMMARY ***
Total pot 350 | Rake 0 
Seat 1: dddocky folded before Flop
Seat 2: Duke Croix collected (350)
Seat 4: Manon947 folded before Flop (didn't bet)
Seat 5: RichRick1337 (button) folded before Flop (didn't bet)
Seat 8: color_singleton (small blind) folded before Flop
Seat 9: HighCardJasper (big blind) folded before Flop



PokerStars Home Game Hand #216254921972: {Club #3225207}  Hold'em No Limit (50/100) - 2020/07/09 18:53:06 ET
Table 'lets goo' 9-max (Play Money) Seat #8 is the button
Seat 1: dddocky (25859 in chips) 
Seat 2: Duke Croix (9664 in chips) 
Seat 4: Manon947 (12181 in chips) 
Seat 5: RichRick1337 (1748 in chips) 
Seat 8: color_singleton (12328 in chips) 
Seat 9: HighCardJasper (6499 in chips) 
HighCardJasper: posts small blind 50
dddocky: posts big blind 100
*** HOLE CARDS ***
Dealt to Duke Croix [As 8s]
Duke Croix: calls 100
Manon947: calls 100
RichRick1337: calls 100
color_singleton: folds 
HighCardJasper: calls 50
dddocky: checks 
*** FLOP *** [4h Js 4d]
HighCardJasper: checks 
dddocky: checks 
Duke Croix: bets 400
Manon947: folds 
RichRick1337: folds 
HighCardJasper: folds 
dddocky: folds 
Uncalled bet (400) returned to Duke Croix
Duke Croix collected 472 from pot
*** SUMMARY ***
Total pot 500 | Rake 28 
Board [4h Js 4d]
Seat 1: dddocky (big blind) folded on the Flop
Seat 2: Duke Croix collected (472)
Seat 4: Manon947 folded on the Flop
Seat 5: RichRick1337 folded on the Flop
Seat 8: color_singleton (button) folded before Flop (didn't bet)
Seat 9: HighCardJasper (small blind) folded on the Flop



PokerStars Home Game Hand #216254935509: {Club #3225207}  Hold'em No Limit (50/100) - 2020/07/09 18:53:33 ET
Table 'lets goo' 9-max (Play Money) Seat #9 is the button
Seat 1: dddocky (25759 in chips) 
Seat 2: Duke Croix (10036 in chips) 
Seat 4: Manon947 (12081 in chips) 
Seat 5: RichRick1337 (1648 in chips) 
Seat 8: color_singleton (12328 in chips) 
Seat 9: HighCardJasper (6399 in chips) 
dddocky: posts small blind 50
Duke Croix: posts big blind 100
*** HOLE CARDS ***
Dealt to Duke Croix [Jh 6c]
Manon947: calls 100
RichRick1337: calls 100
color_singleton: raises 100 to 200
HighCardJasper: calls 200
dddocky: calls 150
Duke Croix: calls 100
Manon947: calls 100
RichRick1337: folds 
*** FLOP *** [9h 8d 5c]
dddocky: checks 
Duke Croix: checks 
Manon947: bets 519
color_singleton: folds 
HighCardJasper: folds 
dddocky: folds 
Duke Croix: folds 
Uncalled bet (519) returned to Manon947
Manon947 collected 1039 from pot
*** SUMMARY ***
Total pot 1100 | Rake 61 
Board [9h 8d 5c]
Seat 1: dddocky (small blind) folded on the Flop
Seat 2: Duke Croix (big blind) folded on the Flop
Seat 4: Manon947 collected (1039)
Seat 5: RichRick1337 folded before Flop
Seat 8: color_singleton folded on the Flop
Seat 9: HighCardJasper (button) folded on the Flop



PokerStars Home Game Hand #216254953718: {Club #3225207}  Hold'em No Limit (50/100) - 2020/07/09 18:54:09 ET
Table 'lets goo' 9-max (Play Money) Seat #1 is the button
Seat 1: dddocky (25559 in chips) 
Seat 2: Duke Croix (9836 in chips) 
Seat 4: Manon947 (12920 in chips) 
Seat 5: RichRick1337 (1548 in chips) 
Seat 8: color_singleton (12128 in chips) 
Seat 9: HighCardJasper (6199 in chips) 
Duke Croix: posts small blind 50
Manon947: posts big blind 100
*** HOLE CARDS ***
Dealt to Duke Croix [4h As]
RichRick1337: calls 100
color_singleton: folds 
HighCardJasper: calls 100
dddocky: calls 100
Duke Croix: calls 50
Manon947: checks 
*** FLOP *** [4d Ac 3s]
Duke Croix: checks 
Manon947: checks 
RichRick1337: checks 
HighCardJasper: checks 
dddocky: checks 
*** TURN *** [4d Ac 3s] [6h]
Duke Croix: bets 400
Manon947: folds 
RichRick1337: calls 400
HighCardJasper: folds 
dddocky: calls 400
*** RIVER *** [4d Ac 3s 6h] [2s]
Duke Croix: bets 700
RichRick1337: folds 
dddocky: calls 700
*** SHOW DOWN ***
Duke Croix: shows [4h As] (two pair, Aces and Fours)
dddocky: mucks hand 
Duke Croix collected 2929 from pot
*** SUMMARY ***
Total pot 3100 | Rake 171 
Board [4d Ac 3s 6h 2s]
Seat 1: dddocky (button) mucked [6c 3c]
Seat 2: Duke Croix (small blind) showed [4h As] and won (2929) with two pair, Aces and Fours
Seat 4: Manon947 (big blind) folded on the Turn
Seat 5: RichRick1337 folded on the River
Seat 8: color_singleton folded before Flop (didn't bet)
Seat 9: HighCardJasper folded on the Turn



PokerStars Home Game Hand #216254970481: {Club #3225207}  Hold'em No Limit (50/100) - 2020/07/09 18:54:44 ET
Table 'lets goo' 9-max (Play Money) Seat #2 is the button
Seat 1: dddocky (24359 in chips) 
Seat 2: Duke Croix (11565 in chips) 
Seat 4: Manon947 (12820 in chips) 
Seat 5: RichRick1337 (1048 in chips) 
Seat 8: color_singleton (12128 in chips) 
Seat 9: HighCardJasper (6099 in chips) 
Manon947: posts small blind 50
RichRick1337: posts big blind 100
*** HOLE CARDS ***
Dealt to Duke Croix [Ks Kd]
color_singleton: raises 100 to 200
HighCardJasper: calls 200
dddocky: folds 
Duke Croix: raises 500 to 700
Manon947: folds 
RichRick1337: calls 600
color_singleton: calls 500
HighCardJasper: folds 
*** FLOP *** [8h Kh 2h]
RichRick1337: checks 
color_singleton: checks 
Duke Croix: bets 1700
RichRick1337: calls 348 and is all-in
color_singleton: folds 
Uncalled bet (1352) returned to Duke Croix
*** TURN *** [8h Kh 2h] [2c]
*** RIVER *** [8h Kh 2h 2c] [8d]
*** SHOW DOWN ***
RichRick1337: shows [3d Js] (two pair, Eights and Deuces)
Duke Croix: shows [Ks Kd] (a full house, Kings full of Eights)
Duke Croix collected 2878 from pot
*** SUMMARY ***
Total pot 3046 | Rake 168 
Board [8h Kh 2h 2c 8d]
Seat 1: dddocky folded before Flop (didn't bet)
Seat 2: Duke Croix (button) showed [Ks Kd] and won (2878) with a full house, Kings full of Eights
Seat 4: Manon947 (small blind) folded before Flop
Seat 5: RichRick1337 (big blind) showed [3d Js] and lost with two pair, Eights and Deuces
Seat 8: color_singleton folded on the Flop
Seat 9: HighCardJasper folded before Flop



PokerStars Home Game Hand #216254990489: {Club #3225207}  Hold'em No Limit (50/100) - 2020/07/09 18:55:31 ET
Table 'lets goo' 9-max (Play Money) Seat #4 is the button
Seat 1: dddocky (24359 in chips) 
Seat 2: Duke Croix (13395 in chips) 
Seat 4: Manon947 (12770 in chips) 
Seat 8: color_singleton (11428 in chips) 
Seat 9: HighCardJasper (5899 in chips) 
color_singleton: posts small blind 50
HighCardJasper: posts big blind 100
*** HOLE CARDS ***
Dealt to Duke Croix [4c 6c]
dddocky: calls 100
Duke Croix: calls 100
Manon947: calls 100
RichRick1337 leaves the table
color_singleton: raises 200 to 300
HighCardJasper: calls 200
dddocky: calls 200
Duke Croix: calls 200
Manon947: calls 200
*** FLOP *** [Jh 7h Tc]
color_singleton: checks 
HighCardJasper: checks 
dddocky: checks 
Duke Croix: checks 
Manon947: checks 
*** TURN *** [Jh 7h Tc] [5c]
color_singleton: bets 708
HighCardJasper: folds 
dddocky: folds 
Duke Croix: calls 708
Manon947: folds 
*** RIVER *** [Jh 7h Tc 5c] [Js]
color_singleton: bets 1378
Duke Croix: folds 
Uncalled bet (1378) returned to color_singleton
color_singleton collected 2756 from pot
color_singleton: doesn't show hand 
*** SUMMARY ***
Total pot 2916 | Rake 160 
Board [Jh 7h Tc 5c Js]
Seat 1: dddocky folded on the Turn
Seat 2: Duke Croix folded on the River
Seat 4: Manon947 (button) folded on the Turn
Seat 8: color_singleton (small blind) collected (2756)
Seat 9: HighCardJasper (big blind) folded on the Turn



PokerStars Home Game Hand #216255012365: {Club #3225207}  Hold'em No Limit (50/100) - 2020/07/09 18:56:27 ET
Table 'lets goo' 9-max (Play Money) Seat #8 is the button
Seat 1: dddocky (24059 in chips) 
Seat 2: Duke Croix (12387 in chips) 
Seat 4: Manon947 (12470 in chips) 
Seat 8: color_singleton (13176 in chips) 
Seat 9: HighCardJasper (5599 in chips) 
HighCardJasper: posts small blind 50
dddocky: posts big blind 100
*** HOLE CARDS ***
Dealt to Duke Croix [7s Ks]
Duke Croix: raises 200 to 300
Manon947: calls 300
color_singleton: folds 
HighCardJasper: calls 250
dddocky: folds 
*** FLOP *** [6s 2c Jd]
HighCardJasper: checks 
Duke Croix: checks 
Manon947: checks 
*** TURN *** [6s 2c Jd] [9h]
HighCardJasper: checks 
Duke Croix: checks 
Manon947: checks 
*** RIVER *** [6s 2c Jd 9h] [Qc]
HighCardJasper: checks 
Duke Croix: checks 
Manon947: bets 945
HighCardJasper: folds 
Duke Croix: folds 
Uncalled bet (945) returned to Manon947
Manon947 collected 945 from pot
*** SUMMARY ***
Total pot 1000 | Rake 55 
Board [6s 2c Jd 9h Qc]
Seat 1: dddocky (big blind) folded before Flop
Seat 2: Duke Croix folded on the River
Seat 4: Manon947 collected (945)
Seat 8: color_singleton (button) folded before Flop (didn't bet)
Seat 9: HighCardJasper (small blind) folded on the River



PokerStars Home Game Hand #216255027652: {Club #3225207}  Hold'em No Limit (50/100) - 2020/07/09 18:57:02 ET
Table 'lets goo' 9-max (Play Money) Seat #9 is the button
Seat 1: dddocky (23959 in chips) 
Seat 2: Duke Croix (12087 in chips) 
Seat 4: Manon947 (13115 in chips) 
Seat 8: color_singleton (13176 in chips) 
Seat 9: HighCardJasper (5299 in chips) 
dddocky: posts small blind 50
Duke Croix: posts big blind 100
*** HOLE CARDS ***
Dealt to Duke Croix [9s 8c]
Manon947: calls 100
color_singleton: calls 100
HighCardJasper: calls 100
dddocky: calls 50
Duke Croix: checks 
*** FLOP *** [Qc 8h 2s]
dddocky: checks 
Duke Croix: bets 300
Manon947: folds 
color_singleton: folds 
HighCardJasper: folds 
dddocky: folds 
Uncalled bet (300) returned to Duke Croix
Duke Croix collected 472 from pot
*** SUMMARY ***
Total pot 500 | Rake 28 
Board [Qc 8h 2s]
Seat 1: dddocky (small blind) folded on the Flop
Seat 2: Duke Croix (big blind) collected (472)
Seat 4: Manon947 folded on the Flop
Seat 8: color_singleton folded on the Flop
Seat 9: HighCardJasper (button) folded on the Flop



PokerStars Home Game Hand #216255037706: {Club #3225207}  Hold'em No Limit (50/100) - 2020/07/09 18:57:28 ET
Table 'lets goo' 9-max (Play Money) Seat #1 is the button
Seat 1: dddocky (23859 in chips) 
Seat 2: Duke Croix (12459 in chips) 
Seat 4: Manon947 (13015 in chips) 
Seat 8: color_singleton (13076 in chips) 
Seat 9: HighCardJasper (5199 in chips) 
Duke Croix: posts small blind 50
Manon947: posts big blind 100
*** HOLE CARDS ***
Dealt to Duke Croix [3s Jh]
color_singleton: raises 100 to 200
HighCardJasper: calls 200
dddocky: calls 200
Duke Croix: folds 
Manon947: folds 
*** FLOP *** [2d 2c Jc]
color_singleton: checks 
HighCardJasper: checks 
dddocky: checks 
*** TURN *** [2d 2c Jc] [3c]
color_singleton: checks 
HighCardJasper: bets 200
dddocky: calls 200
color_singleton: folds 
*** RIVER *** [2d 2c Jc 3c] [7s]
HighCardJasper: checks 
dddocky: checks 
*** SHOW DOWN ***
HighCardJasper: shows [Jd 9h] (two pair, Jacks and Deuces)
dddocky: mucks hand 
HighCardJasper collected 1087 from pot
*** SUMMARY ***
Total pot 1150 | Rake 63 
Board [2d 2c Jc 3c 7s]
Seat 1: dddocky (button) mucked [3h Qc]
Seat 2: Duke Croix (small blind) folded before Flop
Seat 4: Manon947 (big blind) folded before Flop
Seat 8: color_singleton folded on the Turn
Seat 9: HighCardJasper showed [Jd 9h] and won (1087) with two pair, Jacks and Deuces



PokerStars Home Game Hand #216255053375: {Club #3225207}  Hold'em No Limit (50/100) - 2020/07/09 18:58:09 ET
Table 'lets goo' 9-max (Play Money) Seat #2 is the button
Seat 1: dddocky (23459 in chips) 
Seat 2: Duke Croix (12409 in chips) 
Seat 4: Manon947 (12915 in chips) 
Seat 8: color_singleton (12876 in chips) 
Seat 9: HighCardJasper (5886 in chips) 
Manon947: posts small blind 50
color_singleton: posts big blind 100
*** HOLE CARDS ***
Dealt to Duke Croix [Td 8h]
HighCardJasper: raises 200 to 300
dddocky: calls 300
Duke Croix: folds 
Manon947: calls 250
color_singleton: calls 200
*** FLOP *** [2h Kc 8s]
Manon947: checks 
color_singleton: checks 
HighCardJasper: checks 
dddocky: checks 
*** TURN *** [2h Kc 8s] [Kd]
Manon947: bets 567
color_singleton: folds 
HighCardJasper: folds 
dddocky: folds 
Uncalled bet (567) returned to Manon947
Manon947 collected 1134 from pot
*** SUMMARY ***
Total pot 1200 | Rake 66 
Board [2h Kc 8s Kd]
Seat 1: dddocky folded on the Turn
Seat 2: Duke Croix (button) folded before Flop (didn't bet)
Seat 4: Manon947 (small blind) collected (1134)
Seat 8: color_singleton (big blind) folded on the Turn
Seat 9: HighCardJasper folded on the Turn



PokerStars Home Game Hand #216255068906: {Club #3225207}  Hold'em No Limit (50/100) - 2020/07/09 18:58:50 ET
Table 'lets goo' 9-max (Play Money) Seat #4 is the button
Seat 1: dddocky (23159 in chips) 
Seat 2: Duke Croix (12409 in chips) 
Seat 4: Manon947 (13749 in chips) 
Seat 8: color_singleton (12576 in chips) 
Seat 9: HighCardJasper (5586 in chips) 
color_singleton: posts small blind 50
HighCardJasper: posts big blind 100
*** HOLE CARDS ***
Dealt to Duke Croix [4h 8d]
dddocky: calls 100
Duke Croix: folds 
Manon947: folds 
color_singleton: calls 50
HighCardJasper: checks 
*** FLOP *** [8c 7s 3s]
color_singleton: checks 
HighCardJasper: checks 
dddocky: checks 
*** TURN *** [8c 7s 3s] [Td]
color_singleton: bets 141
HighCardJasper: folds 
dddocky: folds 
Uncalled bet (141) returned to color_singleton
color_singleton collected 283 from pot
color_singleton: doesn't show hand 
*** SUMMARY ***
Total pot 300 | Rake 17 
Board [8c 7s 3s Td]
Seat 1: dddocky folded on the Turn
Seat 2: Duke Croix folded before Flop (didn't bet)
Seat 4: Manon947 (button) folded before Flop (didn't bet)
Seat 8: color_singleton (small blind) collected (283)
Seat 9: HighCardJasper (big blind) folded on the Turn



PokerStars Home Game Hand #216255081731: {Club #3225207}  Hold'em No Limit (50/100) - 2020/07/09 18:59:24 ET
Table 'lets goo' 9-max (Play Money) Seat #8 is the button
Seat 1: dddocky (23059 in chips) 
Seat 2: Duke Croix (12409 in chips) 
Seat 4: Manon947 (13749 in chips) 
Seat 8: color_singleton (12759 in chips) 
Seat 9: HighCardJasper (5486 in chips) 
HighCardJasper: posts small blind 50
dddocky: posts big blind 100
*** HOLE CARDS ***
Dealt to Duke Croix [Ac 5h]
Duke Croix: raises 200 to 300
Manon947: folds 
color_singleton: folds 
HighCardJasper: folds 
dddocky: calls 200
*** FLOP *** [4s 6s 9d]
dddocky: checks 
Duke Croix: checks 
*** TURN *** [4s 6s 9d] [5d]
dddocky: checks 
Duke Croix: bets 300
dddocky: calls 300
*** RIVER *** [4s 6s 9d 5d] [Th]
dddocky: checks 
Duke Croix: bets 600
dddocky: calls 600
*** SHOW DOWN ***
Duke Croix: shows [Ac 5h] (a pair of Fives)
dddocky: shows [6h Ah] (a pair of Sixes)
dddocky collected 2315 from pot
*** SUMMARY ***
Total pot 2450 | Rake 135 
Board [4s 6s 9d 5d Th]
Seat 1: dddocky (big blind) showed [6h Ah] and won (2315) with a pair of Sixes
Seat 2: Duke Croix showed [Ac 5h] and lost with a pair of Fives
Seat 4: Manon947 folded before Flop (didn't bet)
Seat 8: color_singleton (button) folded before Flop (didn't bet)
Seat 9: HighCardJasper (small blind) folded before Flop



PokerStars Home Game Hand #216255102763: {Club #3225207}  Hold'em No Limit (50/100) - 2020/07/09 19:00:18 ET
Table 'lets goo' 9-max (Play Money) Seat #9 is the button
Seat 1: dddocky (24174 in chips) 
Seat 2: Duke Croix (11209 in chips) 
Seat 4: Manon947 (13749 in chips) 
Seat 8: color_singleton (12759 in chips) 
Seat 9: HighCardJasper (5436 in chips) 
dddocky: posts small blind 50
Duke Croix: posts big blind 100
*** HOLE CARDS ***
Dealt to Duke Croix [Qs Jh]
Manon947: calls 100
color_singleton: folds 
HighCardJasper: calls 100
dddocky: calls 50
Duke Croix: raises 400 to 500
Manon947: calls 400
HighCardJasper: folds 
dddocky: calls 400
*** FLOP *** [Jd Td 8c]
dddocky: checks 
Duke Croix: bets 700
Manon947: calls 700
dddocky: calls 700
*** TURN *** [Jd Td 8c] [Ad]
dddocky: checks 
Duke Croix: checks 
Manon947: bets 1748
dddocky: folds 
Duke Croix: folds 
Uncalled bet (1748) returned to Manon947
Manon947 collected 3496 from pot
*** SUMMARY ***
Total pot 3700 | Rake 204 
Board [Jd Td 8c Ad]
Seat 1: dddocky (small blind) folded on the Turn
Seat 2: Duke Croix (big blind) folded on the Turn
Seat 4: Manon947 collected (3496)
Seat 8: color_singleton folded before Flop (didn't bet)
Seat 9: HighCardJasper (button) folded before Flop



PokerStars Home Game Hand #216255135296: {Club #3225207}  Hold'em No Limit (50/100) - 2020/07/09 19:01:33 ET
Table 'lets goo' 9-max (Play Money) Seat #2 is the button
Seat 2: Duke Croix (10009 in chips) 
Seat 4: Manon947 (16045 in chips) 
Seat 8: color_singleton (12759 in chips) 
Seat 9: HighCardJasper (5336 in chips) 
Manon947: posts small blind 50
color_singleton: posts big blind 100
*** HOLE CARDS ***
Dealt to Duke Croix [8d 2d]
HighCardJasper: calls 100
Duke Croix: folds 
Manon947: folds 
color_singleton: raises 200 to 300
HighCardJasper: folds 
Uncalled bet (200) returned to color_singleton
color_singleton collected 250 from pot
color_singleton: doesn't show hand 
*** SUMMARY ***
Total pot 250 | Rake 0 
Seat 2: Duke Croix (button) folded before Flop (didn't bet)
Seat 4: Manon947 (small blind) folded before Flop
Seat 8: color_singleton (big blind) collected (250)
Seat 9: HighCardJasper folded before Flop



PokerStars Home Game Hand #216255143502: {Club #3225207}  Hold'em No Limit (50/100) - 2020/07/09 19:01:50 ET
Table 'lets goo' 9-max (Play Money) Seat #4 is the button
Seat 2: Duke Croix (10009 in chips) 
Seat 4: Manon947 (15995 in chips) 
Seat 8: color_singleton (12909 in chips) 
Seat 9: HighCardJasper (5236 in chips) 
color_singleton: posts small blind 50
HighCardJasper: posts big blind 100
*** HOLE CARDS ***
Dealt to Duke Croix [6h 2d]
Duke Croix: folds 
Manon947: folds 
color_singleton: calls 50
HighCardJasper: checks 
*** FLOP *** [Qd 8s 3s]
color_singleton: checks 
HighCardJasper: checks 
*** TURN *** [Qd 8s 3s] [Ad]
color_singleton: checks 
HighCardJasper: bets 200
color_singleton: folds 
Uncalled bet (200) returned to HighCardJasper
HighCardJasper collected 189 from pot
HighCardJasper: doesn't show hand 
*** SUMMARY ***
Total pot 200 | Rake 11 
Board [Qd 8s 3s Ad]
Seat 2: Duke Croix folded before Flop (didn't bet)
Seat 4: Manon947 (button) folded before Flop (didn't bet)
Seat 8: color_singleton (small blind) folded on the Turn
Seat 9: HighCardJasper (big blind) collected (189)



PokerStars Home Game Hand #216255167846: {Club #3225207}  Hold'em No Limit (50/100) - 2020/07/09 19:02:27 ET
Table 'lets goo' 9-max (Play Money) Seat #8 is the button
Seat 2: Duke Croix (10009 in chips) 
Seat 4: Manon947 (15995 in chips) 
Seat 8: color_singleton (12809 in chips) 
Seat 9: HighCardJasper (5325 in chips) 
HighCardJasper: posts small blind 50
Duke Croix: posts big blind 100
*** HOLE CARDS ***
Dealt to Duke Croix [Jc 6d]
Manon947: calls 100
color_singleton: raises 200 to 300
HighCardJasper: folds 
Duke Croix: calls 200
Manon947: calls 200
*** FLOP *** [6s 7d 8h]
Duke Croix: checks 
Manon947: checks 
color_singleton: checks 
*** TURN *** [6s 7d 8h] [4s]
Duke Croix: checks 
Manon947: checks 
color_singleton: checks 
*** RIVER *** [6s 7d 8h 4s] [5d]
Duke Croix: checks 
Manon947: bets 898
color_singleton: folds 
Duke Croix: calls 898
*** SHOW DOWN ***
Manon947: shows [Qh 2h] (a straight, Four to Eight)
Duke Croix: shows [Jc 6d] (a straight, Four to Eight)
Duke Croix collected 1298 from pot
Manon947 collected 1297 from pot
*** SUMMARY ***
Total pot 2746 | Rake 151 
Board [6s 7d 8h 4s 5d]
Seat 2: Duke Croix (big blind) showed [Jc 6d] and won (1298) with a straight, Four to Eight
Seat 4: Manon947 showed [Qh 2h] and won (1297) with a straight, Four to Eight
Seat 8: color_singleton (button) folded on the River
Seat 9: HighCardJasper (small blind) folded before Flop



PokerStars Home Game Hand #216255190206: {Club #3225207}  Hold'em No Limit (50/100) - 2020/07/09 19:03:15 ET
Table 'lets goo' 9-max (Play Money) Seat #9 is the button
Seat 2: Duke Croix (10109 in chips) 
Seat 4: Manon947 (16094 in chips) 
Seat 8: color_singleton (12509 in chips) 
Seat 9: HighCardJasper (5275 in chips) 
Duke Croix: posts small blind 50
Manon947: posts big blind 100
*** HOLE CARDS ***
Dealt to Duke Croix [Ac 3c]
color_singleton: raises 100 to 200
HighCardJasper: calls 200
Duke Croix: calls 150
dddocky leaves the table
Manon947: folds 
*** FLOP *** [7c 3s 2c]
Duke Croix: bets 300
color_singleton: calls 300
HighCardJasper: folds 
*** TURN *** [7c 3s 2c] [4d]
Duke Croix: bets 700
color_singleton: calls 700
*** RIVER *** [7c 3s 2c 4d] [3h]
Duke Croix: bets 1500
color_singleton: calls 1500
*** SHOW DOWN ***
Duke Croix: shows [Ac 3c] (three of a kind, Threes)
color_singleton: shows [Ad 5s] (a straight, Ace to Five)
color_singleton collected 5386 from pot
*** SUMMARY ***
Total pot 5700 | Rake 314 
Board [7c 3s 2c 4d 3h]
Seat 2: Duke Croix (small blind) showed [Ac 3c] and lost with three of a kind, Threes
Seat 4: Manon947 (big blind) folded before Flop
Seat 8: color_singleton showed [Ad 5s] and won (5386) with a straight, Ace to Five
Seat 9: HighCardJasper (button) folded on the Flop



PokerStars Home Game Hand #216255207245: {Club #3225207}  Hold'em No Limit (50/100) - 2020/07/09 19:03:51 ET
Table 'lets goo' 9-max (Play Money) Seat #2 is the button
Seat 2: Duke Croix (7409 in chips) 
Seat 4: Manon947 (15994 in chips) 
Seat 8: color_singleton (15195 in chips) 
Seat 9: HighCardJasper (5075 in chips) 
Manon947: posts small blind 50
color_singleton: posts big blind 100
*** HOLE CARDS ***
Dealt to Duke Croix [Jd 7s]
HighCardJasper: raises 200 to 300
Duke Croix: folds 
Manon947: folds 
color_singleton: folds 
Uncalled bet (200) returned to HighCardJasper
HighCardJasper collected 250 from pot
HighCardJasper: doesn't show hand 
*** SUMMARY ***
Total pot 250 | Rake 0 
Seat 2: Duke Croix (button) folded before Flop (didn't bet)
Seat 4: Manon947 (small blind) folded before Flop
Seat 8: color_singleton (big blind) folded before Flop
Seat 9: HighCardJasper collected (250)



PokerStars Home Game Hand #216255217429: {Club #3225207}  Hold'em No Limit (50/100) - 2020/07/09 19:04:12 ET
Table 'lets goo' 9-max (Play Money) Seat #4 is the button
Seat 2: Duke Croix (7409 in chips) 
Seat 4: Manon947 (15944 in chips) 
Seat 8: color_singleton (15095 in chips) 
Seat 9: HighCardJasper (5225 in chips) 
color_singleton: posts small blind 50
HighCardJasper: posts big blind 100
*** HOLE CARDS ***
Dealt to Duke Croix [2s 9h]
Duke Croix: folds 
Manon947: calls 100
color_singleton: raises 200 to 300
HighCardJasper: calls 200
Manon947: folds 
*** FLOP *** [3s Js 5d]
color_singleton: bets 661
HighCardJasper: calls 661
*** TURN *** [3s Js 5d] [Jd]
color_singleton: checks 
HighCardJasper: checks 
*** RIVER *** [3s Js 5d Jd] [Ac]
color_singleton: bets 1911
HighCardJasper: folds 
Uncalled bet (1911) returned to color_singleton
color_singleton collected 1911 from pot
color_singleton: doesn't show hand 
*** SUMMARY ***
Total pot 2022 | Rake 111 
Board [3s Js 5d Jd Ac]
Seat 2: Duke Croix folded before Flop (didn't bet)
Seat 4: Manon947 (button) folded before Flop
Seat 8: color_singleton (small blind) collected (1911)
Seat 9: HighCardJasper (big blind) folded on the River



PokerStars Home Game Hand #216255234643: {Club #3225207}  Hold'em No Limit (50/100) - 2020/07/09 19:04:49 ET
Table 'lets goo' 9-max (Play Money) Seat #8 is the button
Seat 2: Duke Croix (7409 in chips) 
Seat 4: Manon947 (15844 in chips) 
Seat 8: color_singleton (16045 in chips) 
Seat 9: HighCardJasper (4264 in chips) 
HighCardJasper: posts small blind 50
Duke Croix: posts big blind 100
*** HOLE CARDS ***
Dealt to Duke Croix [9d 2h]
Manon947: calls 100
color_singleton: folds 
HighCardJasper: calls 50
Duke Croix: checks 
*** FLOP *** [3d Kh Jh]
HighCardJasper: checks 
Duke Croix: checks 
Manon947: checks 
*** TURN *** [3d Kh Jh] [9h]
HighCardJasper: bets 200
Duke Croix: folds 
Manon947: calls 200
*** RIVER *** [3d Kh Jh 9h] [7s]
HighCardJasper: bets 300
Manon947: calls 300
*** SHOW DOWN ***
HighCardJasper: shows [Kd 8c] (a pair of Kings)
Manon947: mucks hand 
HighCardJasper collected 1228 from pot
*** SUMMARY ***
Total pot 1300 | Rake 72 
Board [3d Kh Jh 9h 7s]
Seat 2: Duke Croix (big blind) folded on the Turn
Seat 4: Manon947 mucked [4c As]
Seat 8: color_singleton (button) folded before Flop (didn't bet)
Seat 9: HighCardJasper (small blind) showed [Kd 8c] and won (1228) with a pair of Kings



PokerStars Home Game Hand #216255252438: {Club #3225207}  Hold'em No Limit (50/100) - 2020/07/09 19:05:26 ET
Table 'lets goo' 9-max (Play Money) Seat #9 is the button
Seat 2: Duke Croix (7309 in chips) 
Seat 4: Manon947 (15244 in chips) 
Seat 8: color_singleton (16045 in chips) 
Seat 9: HighCardJasper (4892 in chips) 
Duke Croix: posts small blind 50
Manon947: posts big blind 100
*** HOLE CARDS ***
Dealt to Duke Croix [Qs 9d]
color_singleton: folds 
HighCardJasper: calls 100
Duke Croix: calls 50
Manon947: checks 
*** FLOP *** [6c As Tc]
Duke Croix: checks 
Manon947: checks 
HighCardJasper: bets 200
Duke Croix: folds 
Manon947: calls 200
*** TURN *** [6c As Tc] [Kc]
Manon947: bets 330
HighCardJasper: calls 330
*** RIVER *** [6c As Tc Kc] [Ah]
Manon947: bets 642
HighCardJasper: raises 642 to 1284
Manon947: calls 642
*** SHOW DOWN ***
HighCardJasper: shows [6s Ac] (a full house, Aces full of Sixes)
Manon947: mucks hand 
HighCardJasper collected 3712 from pot
*** SUMMARY ***
Total pot 3928 | Rake 216 
Board [6c As Tc Kc Ah]
Seat 2: Duke Croix (small blind) folded on the Flop
Seat 4: Manon947 (big blind) mucked [3d Kd]
Seat 8: color_singleton folded before Flop (didn't bet)
Seat 9: HighCardJasper (button) showed [6s Ac] and won (3712) with a full house, Aces full of Sixes



PokerStars Home Game Hand #216255281475: {Club #3225207}  Hold'em No Limit (50/100) - 2020/07/09 19:06:12 ET
Table 'lets goo' 9-max (Play Money) Seat #2 is the button
Seat 2: Duke Croix (7209 in chips) 
Seat 4: Manon947 (13330 in chips) 
Seat 8: color_singleton (16045 in chips) 
Seat 9: HighCardJasper (6690 in chips) 
Manon947: posts small blind 50
color_singleton: posts big blind 100
*** HOLE CARDS ***
Dealt to Duke Croix [6c 3h]
HighCardJasper: calls 100
Duke Croix: folds 
Manon947: folds 
color_singleton: checks 
*** FLOP *** [As 8c Ts]
color_singleton: checks 
HighCardJasper: checks 
*** TURN *** [As 8c Ts] [Jc]
color_singleton: checks 
HighCardJasper: bets 200
color_singleton: folds 
Uncalled bet (200) returned to HighCardJasper
HighCardJasper collected 236 from pot
HighCardJasper: doesn't show hand 
*** SUMMARY ***
Total pot 250 | Rake 14 
Board [As 8c Ts Jc]
Seat 2: Duke Croix (button) folded before Flop (didn't bet)
Seat 4: Manon947 (small blind) folded before Flop
Seat 8: color_singleton (big blind) folded on the Turn
Seat 9: HighCardJasper collected (236)



PokerStars Home Game Hand #216255291593: {Club #3225207}  Hold'em No Limit (50/100) - 2020/07/09 19:06:33 ET
Table 'lets goo' 9-max (Play Money) Seat #4 is the button
Seat 2: Duke Croix (7209 in chips) 
Seat 4: Manon947 (13280 in chips) 
Seat 8: color_singleton (15945 in chips) 
Seat 9: HighCardJasper (6826 in chips) 
color_singleton: posts small blind 50
HighCardJasper: posts big blind 100
*** HOLE CARDS ***
Dealt to Duke Croix [Kd Jd]
Duke Croix: raises 300 to 400
Manon947: folds 
color_singleton: calls 350
HighCardJasper: folds 
*** FLOP *** [2s As 7h]
color_singleton: checks 
Duke Croix: checks 
*** TURN *** [2s As 7h] [7c]
color_singleton: checks 
Duke Croix: checks 
*** RIVER *** [2s As 7h 7c] [Tc]
color_singleton: checks 
Duke Croix: checks 
*** SHOW DOWN ***
color_singleton: shows [Qc Kc] (a pair of Sevens)
Duke Croix: mucks hand 
color_singleton collected 850 from pot
*** SUMMARY ***
Total pot 900 | Rake 50 
Board [2s As 7h 7c Tc]
Seat 2: Duke Croix mucked [Kd Jd]
Seat 4: Manon947 (button) folded before Flop (didn't bet)
Seat 8: color_singleton (small blind) showed [Qc Kc] and won (850) with a pair of Sevens
Seat 9: HighCardJasper (big blind) folded before Flop



PokerStars Home Game Hand #216255306984: {Club #3225207}  Hold'em No Limit (50/100) - 2020/07/09 19:07:06 ET
Table 'lets goo' 9-max (Play Money) Seat #8 is the button
Seat 2: Duke Croix (6809 in chips) 
Seat 4: Manon947 (13280 in chips) 
Seat 8: color_singleton (16395 in chips) 
Seat 9: HighCardJasper (6726 in chips) 
HighCardJasper: posts small blind 50
Duke Croix: posts big blind 100
*** HOLE CARDS ***
Dealt to Duke Croix [5h 4h]
Manon947: folds 
color_singleton: raises 200 to 300
HighCardJasper: calls 250
Duke Croix: calls 200
*** FLOP *** [Td 4s 3h]
HighCardJasper: checks 
Duke Croix: bets 200
color_singleton: calls 200
HighCardJasper: calls 200
*** TURN *** [Td 4s 3h] [Ac]
HighCardJasper: checks 
Duke Croix: bets 600
color_singleton: folds 
HighCardJasper: folds 
Uncalled bet (600) returned to Duke Croix
Duke Croix collected 1417 from pot
*** SUMMARY ***
Total pot 1500 | Rake 83 
Board [Td 4s 3h Ac]
Seat 2: Duke Croix (big blind) collected (1417)
Seat 4: Manon947 folded before Flop (didn't bet)
Seat 8: color_singleton (button) folded on the Turn
Seat 9: HighCardJasper (small blind) folded on the Turn



PokerStars Home Game Hand #216255322584: {Club #3225207}  Hold'em No Limit (50/100) - 2020/07/09 19:07:40 ET
Table 'lets goo' 9-max (Play Money) Seat #9 is the button
Seat 2: Duke Croix (7726 in chips) 
Seat 4: Manon947 (13280 in chips) 
Seat 8: color_singleton (15895 in chips) 
Seat 9: HighCardJasper (6226 in chips) 
Duke Croix: posts small blind 50
Manon947: posts big blind 100
*** HOLE CARDS ***
Dealt to Duke Croix [5d 3c]
color_singleton: folds 
HighCardJasper: calls 100
Duke Croix: calls 50
Manon947: checks 
*** FLOP *** [6s 4h Tc]
Duke Croix: bets 300
Manon947: folds 
HighCardJasper: folds 
Uncalled bet (300) returned to Duke Croix
Duke Croix collected 283 from pot
*** SUMMARY ***
Total pot 300 | Rake 17 
Board [6s 4h Tc]
Seat 2: Duke Croix (small blind) collected (283)
Seat 4: Manon947 (big blind) folded on the Flop
Seat 8: color_singleton folded before Flop (didn't bet)
Seat 9: HighCardJasper (button) folded on the Flop



PokerStars Home Game Hand #216255330937: {Club #3225207}  Hold'em No Limit (50/100) - 2020/07/09 19:07:58 ET
Table 'lets goo' 9-max (Play Money) Seat #2 is the button
Seat 2: Duke Croix (7909 in chips) 
Seat 4: Manon947 (13180 in chips) 
Seat 8: color_singleton (15895 in chips) 
Seat 9: HighCardJasper (6126 in chips) 
Manon947: posts small blind 50
color_singleton: posts big blind 100
*** HOLE CARDS ***
Dealt to Duke Croix [Kd 4c]
HighCardJasper: calls 100
Duke Croix: folds 
Manon947: calls 50
color_singleton: checks 
*** FLOP *** [3h 4h 8d]
Manon947: checks 
color_singleton: checks 
HighCardJasper: checks 
*** TURN *** [3h 4h 8d] [Js]
Manon947: checks 
color_singleton: checks 
HighCardJasper: checks 
*** RIVER *** [3h 4h 8d Js] [7c]
Manon947: bets 141
color_singleton: folds 
HighCardJasper: folds 
Uncalled bet (141) returned to Manon947
Manon947 collected 283 from pot
*** SUMMARY ***
Total pot 300 | Rake 17 
Board [3h 4h 8d Js 7c]
Seat 2: Duke Croix (button) folded before Flop (didn't bet)
Seat 4: Manon947 (small blind) collected (283)
Seat 8: color_singleton (big blind) folded on the River
Seat 9: HighCardJasper folded on the River



PokerStars Home Game Hand #216255345260: {Club #3225207}  Hold'em No Limit (50/100) - 2020/07/09 19:08:28 ET
Table 'lets goo' 9-max (Play Money) Seat #4 is the button
Seat 2: Duke Croix (7909 in chips) 
Seat 4: Manon947 (13363 in chips) 
Seat 8: color_singleton (15795 in chips) 
Seat 9: HighCardJasper (6026 in chips) 
color_singleton: posts small blind 50
HighCardJasper: posts big blind 100
*** HOLE CARDS ***
Dealt to Duke Croix [Td 3s]
Duke Croix: folds 
Manon947: calls 100
color_singleton: raises 200 to 300
HighCardJasper: folds 
Manon947: calls 200
*** FLOP *** [4h 8c 4s]
color_singleton: bets 330
Manon947: folds 
Uncalled bet (330) returned to color_singleton
color_singleton collected 661 from pot
color_singleton: doesn't show hand 
*** SUMMARY ***
Total pot 700 | Rake 39 
Board [4h 8c 4s]
Seat 2: Duke Croix folded before Flop (didn't bet)
Seat 4: Manon947 (button) folded on the Flop
Seat 8: color_singleton (small blind) collected (661)
Seat 9: HighCardJasper (big blind) folded before Flop



PokerStars Home Game Hand #216255358688: {Club #3225207}  Hold'em No Limit (50/100) - 2020/07/09 19:08:58 ET
Table 'lets goo' 9-max (Play Money) Seat #8 is the button
Seat 2: Duke Croix (7909 in chips) 
Seat 4: Manon947 (13063 in chips) 
Seat 8: color_singleton (16156 in chips) 
Seat 9: HighCardJasper (5926 in chips) 
HighCardJasper: posts small blind 50
Duke Croix: posts big blind 100
*** HOLE CARDS ***
Dealt to Duke Croix [3d 4s]
Manon947: calls 100
color_singleton: folds 
HighCardJasper: calls 50
Duke Croix: checks 
*** FLOP *** [Jc Td Js]
HighCardJasper: checks 
Duke Croix: checks 
Manon947: checks 
*** TURN *** [Jc Td Js] [Qc]
HighCardJasper: checks 
Duke Croix: checks 
Manon947: checks 
*** RIVER *** [Jc Td Js Qc] [9c]
HighCardJasper: checks 
Duke Croix: checks 
Manon947: checks 
*** SHOW DOWN ***
HighCardJasper: shows [3c 5h] (a pair of Jacks)
Duke Croix: shows [3d 4s] (a pair of Jacks)
Manon947: shows [7h 5c] (a pair of Jacks)
HighCardJasper collected 95 from pot
Duke Croix collected 94 from pot
Manon947 collected 94 from pot
*** SUMMARY ***
Total pot 300 | Rake 17 
Board [Jc Td Js Qc 9c]
Seat 2: Duke Croix (big blind) showed [3d 4s] and won (94) with a pair of Jacks
Seat 4: Manon947 showed [7h 5c] and won (94) with a pair of Jacks
Seat 8: color_singleton (button) folded before Flop (didn't bet)
Seat 9: HighCardJasper (small blind) showed [3c 5h] and won (95) with a pair of Jacks



PokerStars Home Game Hand #216255372272: {Club #3225207}  Hold'em No Limit (50/100) - 2020/07/09 19:09:27 ET
Table 'lets goo' 9-max (Play Money) Seat #9 is the button
Seat 2: Duke Croix (7903 in chips) 
Seat 4: Manon947 (13057 in chips) 
Seat 8: color_singleton (16156 in chips) 
Seat 9: HighCardJasper (5921 in chips) 
Duke Croix: posts small blind 50
Manon947: posts big blind 100
*** HOLE CARDS ***
Dealt to Duke Croix [7c 6d]
color_singleton: raises 100 to 200
HighCardJasper: folds 
Duke Croix: calls 150
Manon947: calls 100
*** FLOP *** [Kh Tc 4c]
Duke Croix: checks 
Manon947: checks 
color_singleton: bets 283
Duke Croix: folds 
Manon947: calls 283
*** TURN *** [Kh Tc 4c] [Qd]
Manon947: bets 551
color_singleton: calls 551
*** RIVER *** [Kh Tc 4c Qd] [6h]
Manon947: bets 1071
color_singleton: folds 
Uncalled bet (1071) returned to Manon947
Manon947 collected 2143 from pot
*** SUMMARY ***
Total pot 2268 | Rake 125 
Board [Kh Tc 4c Qd 6h]
Seat 2: Duke Croix (small blind) folded on the Flop
Seat 4: Manon947 (big blind) collected (2143)
Seat 8: color_singleton folded on the River
Seat 9: HighCardJasper (button) folded before Flop (didn't bet)



PokerStars Home Game Hand #216255394296: {Club #3225207}  Hold'em No Limit (50/100) - 2020/07/09 19:10:14 ET
Table 'lets goo' 9-max (Play Money) Seat #2 is the button
Seat 2: Duke Croix (7703 in chips) 
Seat 4: Manon947 (14166 in chips) 
Seat 8: color_singleton (15122 in chips) 
Seat 9: HighCardJasper (5921 in chips) 
Manon947: posts small blind 50
color_singleton: posts big blind 100
*** HOLE CARDS ***
Dealt to Duke Croix [Kc Jh]
HighCardJasper: calls 100
Duke Croix: raises 300 to 400
Manon947: calls 350
color_singleton: folds 
HighCardJasper: folds 
*** FLOP *** [Ts Qh 5h]
Manon947: checks 
Duke Croix: bets 500
Manon947: folds 
Uncalled bet (500) returned to Duke Croix
Duke Croix collected 945 from pot
*** SUMMARY ***
Total pot 1000 | Rake 55 
Board [Ts Qh 5h]
Seat 2: Duke Croix (button) collected (945)
Seat 4: Manon947 (small blind) folded on the Flop
Seat 8: color_singleton (big blind) folded before Flop
Seat 9: HighCardJasper folded before Flop



PokerStars Home Game Hand #216255405894: {Club #3225207}  Hold'em No Limit (50/100) - 2020/07/09 19:10:39 ET
Table 'lets goo' 9-max (Play Money) Seat #4 is the button
Seat 2: Duke Croix (8248 in chips) 
Seat 4: Manon947 (13766 in chips) 
Seat 8: color_singleton (15022 in chips) 
Seat 9: HighCardJasper (5821 in chips) 
color_singleton: posts small blind 50
HighCardJasper: posts big blind 100
*** HOLE CARDS ***
Dealt to Duke Croix [Qh 4h]
Duke Croix: calls 100
Manon947: calls 100
color_singleton: calls 50
HighCardJasper: checks 
*** FLOP *** [8d 5d 7s]
color_singleton: checks 
HighCardJasper: checks 
Duke Croix: checks 
Manon947: checks 
*** TURN *** [8d 5d 7s] [Td]
color_singleton: checks 
HighCardJasper: checks 
Duke Croix: checks 
Manon947: checks 
*** RIVER *** [8d 5d 7s Td] [Qs]
color_singleton: checks 
HighCardJasper: checks 
Duke Croix: bets 300
Manon947: raises 300 to 600
color_singleton: folds 
HighCardJasper: folds 
Duke Croix: calls 300
*** SHOW DOWN ***
Manon947: shows [4s Ks] (high card King)
Duke Croix: shows [Qh 4h] (a pair of Queens)
Duke Croix collected 1512 from pot
*** SUMMARY ***
Total pot 1600 | Rake 88 
Board [8d 5d 7s Td Qs]
Seat 2: Duke Croix showed [Qh 4h] and won (1512) with a pair of Queens
Seat 4: Manon947 (button) showed [4s Ks] and lost with high card King
Seat 8: color_singleton (small blind) folded on the River
Seat 9: HighCardJasper (big blind) folded on the River



PokerStars Home Game Hand #216255427082: {Club #3225207}  Hold'em No Limit (50/100) - 2020/07/09 19:11:25 ET
Table 'lets goo' 9-max (Play Money) Seat #8 is the button
Seat 2: Duke Croix (9060 in chips) 
Seat 4: Manon947 (13066 in chips) 
Seat 8: color_singleton (14922 in chips) 
Seat 9: HighCardJasper (5721 in chips) 
HighCardJasper: posts small blind 50
Duke Croix: posts big blind 100
*** HOLE CARDS ***
Dealt to Duke Croix [8h Qc]
Manon947: calls 100
color_singleton: raises 100 to 200
HighCardJasper: folds 
Duke Croix: calls 100
Manon947: calls 100
*** FLOP *** [4d Jh Td]
Duke Croix: checks 
Manon947: checks 
color_singleton: checks 
*** TURN *** [4d Jh Td] [8c]
Duke Croix: bets 300
Manon947: folds 
color_singleton: calls 300
*** RIVER *** [4d Jh Td 8c] [Kd]
Duke Croix: checks 
color_singleton: checks 
*** SHOW DOWN ***
Duke Croix: shows [8h Qc] (a pair of Eights)
color_singleton: shows [8s Qs] (a pair of Eights)
Duke Croix collected 591 from pot
color_singleton collected 590 from pot
*** SUMMARY ***
Total pot 1250 | Rake 69 
Board [4d Jh Td 8c Kd]
Seat 2: Duke Croix (big blind) showed [8h Qc] and won (591) with a pair of Eights
Seat 4: Manon947 folded on the Turn
Seat 8: color_singleton (button) showed [8s Qs] and won (590) with a pair of Eights
Seat 9: HighCardJasper (small blind) folded before Flop



PokerStars Home Game Hand #216255446527: {Club #3225207}  Hold'em No Limit (50/100) - 2020/07/09 19:12:07 ET
Table 'lets goo' 9-max (Play Money) Seat #9 is the button
Seat 2: Duke Croix (9151 in chips) 
Seat 4: Manon947 (12866 in chips) 
Seat 8: color_singleton (15012 in chips) 
Seat 9: HighCardJasper (5671 in chips) 
Duke Croix: posts small blind 50
Manon947: posts big blind 100
*** HOLE CARDS ***
Dealt to Duke Croix [4d Ah]
color_singleton: folds 
HighCardJasper: folds 
Duke Croix: calls 50
Manon947: checks 
*** FLOP *** [As 6h 8c]
Duke Croix: bets 200
Manon947: calls 200
*** TURN *** [As 6h 8c] [Js]
Duke Croix: bets 400
Manon947: folds 
Uncalled bet (400) returned to Duke Croix
Duke Croix collected 567 from pot
*** SUMMARY ***
Total pot 600 | Rake 33 
Board [As 6h 8c Js]
Seat 2: Duke Croix (small blind) collected (567)
Seat 4: Manon947 (big blind) folded on the Turn
Seat 8: color_singleton folded before Flop (didn't bet)
Seat 9: HighCardJasper (button) folded before Flop (didn't bet)



PokerStars Home Game Hand #216255459313: {Club #3225207}  Hold'em No Limit (50/100) - 2020/07/09 19:12:34 ET
Table 'lets goo' 9-max (Play Money) Seat #2 is the button
Seat 2: Duke Croix (9418 in chips) 
Seat 4: Manon947 (12566 in chips) 
Seat 8: color_singleton (15012 in chips) 
Seat 9: HighCardJasper (5671 in chips) 
Manon947: posts small blind 50
color_singleton: posts big blind 100
*** HOLE CARDS ***
Dealt to Duke Croix [Jc Ks]
HighCardJasper: calls 100
Duke Croix: raises 400 to 500
Manon947: calls 450
color_singleton: folds 
HighCardJasper: calls 400
*** FLOP *** [4h 9h 9d]
Manon947: bets 756
HighCardJasper: folds 
Duke Croix: calls 756
*** TURN *** [4h 9h 9d] [Td]
Manon947: bets 1470
Duke Croix: calls 1470
*** RIVER *** [4h 9h 9d Td] [Kd]
Manon947: bets 2859
Duke Croix: calls 2859
*** SHOW DOWN ***
Manon947: shows [Qs Qh] (two pair, Queens and Nines)
Duke Croix: shows [Jc Ks] (two pair, Kings and Nines)
Duke Croix collected 11123 from pot
*** SUMMARY ***
Total pot 11770 | Rake 647 
Board [4h 9h 9d Td Kd]
Seat 2: Duke Croix (button) showed [Jc Ks] and won (11123) with two pair, Kings and Nines
Seat 4: Manon947 (small blind) showed [Qs Qh] and lost with two pair, Queens and Nines
Seat 8: color_singleton (big blind) folded before Flop
Seat 9: HighCardJasper folded on the Flop



PokerStars Home Game Hand #216255484633: {Club #3225207}  Hold'em No Limit (50/100) - 2020/07/09 19:13:29 ET
Table 'lets goo' 9-max (Play Money) Seat #4 is the button
Seat 2: Duke Croix (14956 in chips) 
Seat 4: Manon947 (6981 in chips) 
Seat 8: color_singleton (14912 in chips) 
Seat 9: HighCardJasper (5171 in chips) 
color_singleton: posts small blind 50
HighCardJasper: posts big blind 100
*** HOLE CARDS ***
Dealt to Duke Croix [8c Qc]
Duke Croix: calls 100
Manon947: folds 
color_singleton: raises 200 to 300
HighCardJasper: folds 
Duke Croix: calls 200
*** FLOP *** [3h 2s Th]
color_singleton: bets 330
Duke Croix: folds 
Uncalled bet (330) returned to color_singleton
color_singleton collected 661 from pot
color_singleton: doesn't show hand 
*** SUMMARY ***
Total pot 700 | Rake 39 
Board [3h 2s Th]
Seat 2: Duke Croix folded on the Flop
Seat 4: Manon947 (button) folded before Flop (didn't bet)
Seat 8: color_singleton (small blind) collected (661)
Seat 9: HighCardJasper (big blind) folded before Flop



PokerStars Home Game Hand #216255497563: {Club #3225207}  Hold'em No Limit (50/100) - 2020/07/09 19:13:57 ET
Table 'lets goo' 9-max (Play Money) Seat #8 is the button
Seat 2: Duke Croix (14656 in chips) 
Seat 4: Manon947 (6981 in chips) 
Seat 8: color_singleton (15273 in chips) 
Seat 9: HighCardJasper (5071 in chips) 
HighCardJasper: posts small blind 50
Duke Croix: posts big blind 100
*** HOLE CARDS ***
Dealt to Duke Croix [Qs 4c]
Manon947: calls 100
color_singleton: raises 200 to 300
HighCardJasper: calls 250
Duke Croix: folds 
Manon947: calls 200
*** FLOP *** [Qc 5d 8c]
HighCardJasper: checks 
Manon947: bets 472
color_singleton: folds 
HighCardJasper: folds 
Uncalled bet (472) returned to Manon947
Manon947 collected 945 from pot
*** SUMMARY ***
Total pot 1000 | Rake 55 
Board [Qc 5d 8c]
Seat 2: Duke Croix (big blind) folded before Flop
Seat 4: Manon947 collected (945)
Seat 8: color_singleton (button) folded on the Flop
Seat 9: HighCardJasper (small blind) folded on the Flop



PokerStars Home Game Hand #216255520670: {Club #3225207}  Hold'em No Limit (50/100) - 2020/07/09 19:14:47 ET
Table 'lets goo' 9-max (Play Money) Seat #9 is the button
Seat 2: Duke Croix (14556 in chips) 
Seat 4: Manon947 (7626 in chips) 
Seat 8: color_singleton (14973 in chips) 
Seat 9: HighCardJasper (4771 in chips) 
Duke Croix: posts small blind 50
Manon947: posts big blind 100
*** HOLE CARDS ***
Dealt to Duke Croix [2s 9d]
color_singleton: folds 
HighCardJasper: folds 
Duke Croix: calls 50
Manon947: checks 
*** FLOP *** [2c 5c 6s]
Duke Croix: checks 
Manon947: checks 
*** TURN *** [2c 5c 6s] [Qd]
Duke Croix: checks 
Manon947: checks 
*** RIVER *** [2c 5c 6s Qd] [3s]
Duke Croix: checks 
Manon947: bets 189
Duke Croix: calls 189
*** SHOW DOWN ***
Manon947: shows [4h 6h] (a straight, Deuce to Six)
Duke Croix: mucks hand 
Manon947 collected 546 from pot
*** SUMMARY ***
Total pot 578 | Rake 32 
Board [2c 5c 6s Qd 3s]
Seat 2: Duke Croix (small blind) mucked [2s 9d]
Seat 4: Manon947 (big blind) showed [4h 6h] and won (546) with a straight, Deuce to Six
Seat 8: color_singleton folded before Flop (didn't bet)
Seat 9: HighCardJasper (button) folded before Flop (didn't bet)



PokerStars Home Game Hand #216255539722: {Club #3225207}  Hold'em No Limit (50/100) - 2020/07/09 19:15:29 ET
Table 'lets goo' 9-max (Play Money) Seat #2 is the button
Seat 2: Duke Croix (14267 in chips) 
Seat 4: Manon947 (7883 in chips) 
Seat 8: color_singleton (14973 in chips) 
Seat 9: HighCardJasper (4771 in chips) 
Manon947: posts small blind 50
color_singleton: posts big blind 100
*** HOLE CARDS ***
Dealt to Duke Croix [Ac 2s]
HighCardJasper: raises 100 to 200
Duke Croix: calls 200
Manon947: calls 150
color_singleton: calls 100
*** FLOP *** [5h 3h Qh]
Manon947: bets 378
color_singleton: folds 
HighCardJasper: calls 378
Duke Croix: folds 
*** TURN *** [5h 3h Qh] [9c]
Manon947: checks 
HighCardJasper: checks 
*** RIVER *** [5h 3h Qh 9c] [6h]
Manon947: bets 1470
HighCardJasper: raises 2723 to 4193 and is all-in
Manon947: calls 2723
*** SHOW DOWN ***
HighCardJasper: shows [8c Ah] (a flush, Ace high)
Manon947: shows [7c 7h] (a flush, Queen high)
HighCardJasper collected 9395 from pot
*** SUMMARY ***
Total pot 9942 | Rake 547 
Board [5h 3h Qh 9c 6h]
Seat 2: Duke Croix (button) folded on the Flop
Seat 4: Manon947 (small blind) showed [7c 7h] and lost with a flush, Queen high
Seat 8: color_singleton (big blind) folded on the Flop
Seat 9: HighCardJasper showed [8c Ah] and won (9395) with a flush, Ace high



PokerStars Home Game Hand #216255564039: {Club #3225207}  Hold'em No Limit (50/100) - 2020/07/09 19:16:22 ET
Table 'lets goo' 9-max (Play Money) Seat #4 is the button
Seat 2: Duke Croix (14067 in chips) 
Seat 4: Manon947 (3112 in chips) 
Seat 8: color_singleton (14773 in chips) 
Seat 9: HighCardJasper (9395 in chips) 
color_singleton: posts small blind 50
HighCardJasper: posts big blind 100
*** HOLE CARDS ***
Dealt to Duke Croix [Ad 3h]
Duke Croix: raises 200 to 300
Manon947: folds 
color_singleton: calls 250
HighCardJasper: folds 
*** FLOP *** [5s 4c 4d]
color_singleton: checks 
Duke Croix: checks 
*** TURN *** [5s 4c 4d] [Ts]
color_singleton: checks 
Duke Croix: checks 
*** RIVER *** [5s 4c 4d Ts] [Kh]
color_singleton: checks 
Duke Croix: checks 
*** SHOW DOWN ***
color_singleton: shows [Js 9h] (a pair of Fours)
Duke Croix: shows [Ad 3h] (a pair of Fours - Ace kicker)
Duke Croix collected 661 from pot
*** SUMMARY ***
Total pot 700 | Rake 39 
Board [5s 4c 4d Ts Kh]
Seat 2: Duke Croix showed [Ad 3h] and won (661) with a pair of Fours
Seat 4: Manon947 (button) folded before Flop (didn't bet)
Seat 8: color_singleton (small blind) showed [Js 9h] and lost with a pair of Fours
Seat 9: HighCardJasper (big blind) folded before Flop



PokerStars Home Game Hand #216255576292: {Club #3225207}  Hold'em No Limit (50/100) - 2020/07/09 19:16:49 ET
Table 'lets goo' 9-max (Play Money) Seat #8 is the button
Seat 2: Duke Croix (14428 in chips) 
Seat 4: Manon947 (3112 in chips) 
Seat 8: color_singleton (14473 in chips) 
Seat 9: HighCardJasper (9295 in chips) 
HighCardJasper: posts small blind 50
Duke Croix: posts big blind 100
*** HOLE CARDS ***
Dealt to Duke Croix [8d Qc]
Manon947: folds 
color_singleton: raises 100 to 200
HighCardJasper: calls 150
Duke Croix: calls 100
*** FLOP *** [8s Kd Tc]
HighCardJasper: bets 200
Duke Croix: folds 
color_singleton: calls 200
*** TURN *** [8s Kd Tc] [Td]
HighCardJasper: bets 300
color_singleton: folds 
Uncalled bet (300) returned to HighCardJasper
HighCardJasper collected 945 from pot
HighCardJasper: doesn't show hand 
*** SUMMARY ***
Total pot 1000 | Rake 55 
Board [8s Kd Tc Td]
Seat 2: Duke Croix (big blind) folded on the Flop
Seat 4: Manon947 folded before Flop (didn't bet)
Seat 8: color_singleton (button) folded on the Turn
Seat 9: HighCardJasper (small blind) collected (945)



PokerStars Home Game Hand #216255596529: {Club #3225207}  Hold'em No Limit (50/100) - 2020/07/09 19:17:33 ET
Table 'lets goo' 9-max (Play Money) Seat #9 is the button
Seat 2: Duke Croix (14228 in chips) 
Seat 4: Manon947 (3112 in chips) 
Seat 8: color_singleton (14073 in chips) 
Seat 9: HighCardJasper (9840 in chips) 
Duke Croix: posts small blind 50
Manon947: posts big blind 100
*** HOLE CARDS ***
Dealt to Duke Croix [Jd 3c]
color_singleton: folds 
HighCardJasper: raises 200 to 300
Duke Croix: folds 
Manon947: calls 200
*** FLOP *** [Qs Ah 3d]
Manon947: bets 307
HighCardJasper: calls 307
*** TURN *** [Qs Ah 3d] [8c]
Manon947: bets 597
HighCardJasper: calls 597
*** RIVER *** [Qs Ah 3d 8c] [Tc]
Manon947: bets 1161
HighCardJasper: calls 1161
*** SHOW DOWN ***
Manon947: shows [Qc 3h] (two pair, Queens and Threes)
HighCardJasper: mucks hand 
Manon947 collected 4517 from pot
*** SUMMARY ***
Total pot 4780 | Rake 263 
Board [Qs Ah 3d 8c Tc]
Seat 2: Duke Croix (small blind) folded before Flop
Seat 4: Manon947 (big blind) showed [Qc 3h] and won (4517) with two pair, Queens and Threes
Seat 8: color_singleton folded before Flop (didn't bet)
Seat 9: HighCardJasper (button) mucked [As 7h]



PokerStars Home Game Hand #216255620239: {Club #3225207}  Hold'em No Limit (50/100) - 2020/07/09 19:18:26 ET
Table 'lets goo' 9-max (Play Money) Seat #2 is the button
Seat 2: Duke Croix (14178 in chips) 
Seat 4: Manon947 (5264 in chips) 
Seat 8: color_singleton (14073 in chips) 
Seat 9: HighCardJasper (7475 in chips) 
Manon947: posts small blind 50
color_singleton: posts big blind 100
*** HOLE CARDS ***
Dealt to Duke Croix [6s 6h]
HighCardJasper: calls 100
Duke Croix: raises 400 to 500
Manon947: folds 
color_singleton: folds 
HighCardJasper: folds 
Uncalled bet (400) returned to Duke Croix
Duke Croix collected 350 from pot
*** SUMMARY ***
Total pot 350 | Rake 0 
Seat 2: Duke Croix (button) collected (350)
Seat 4: Manon947 (small blind) folded before Flop
Seat 8: color_singleton (big blind) folded before Flop
Seat 9: HighCardJasper folded before Flop



PokerStars Home Game Hand #216255633599: {Club #3225207}  Hold'em No Limit (50/100) - 2020/07/09 19:18:56 ET
Table 'lets goo' 9-max (Play Money) Seat #4 is the button
Seat 2: Duke Croix (14428 in chips) 
Seat 4: Manon947 (5214 in chips) 
Seat 8: color_singleton (13973 in chips) 
Seat 9: HighCardJasper (7375 in chips) 
color_singleton: posts small blind 50
HighCardJasper: posts big blind 100
*** HOLE CARDS ***
Dealt to Duke Croix [7c Kc]
Duke Croix: raises 300 to 400
Manon947: folds 
color_singleton: calls 350
HighCardJasper: folds 
*** FLOP *** [9s 8h Jh]
color_singleton: bets 425
Duke Croix: folds 
Uncalled bet (425) returned to color_singleton
color_singleton collected 850 from pot
color_singleton: doesn't show hand 
*** SUMMARY ***
Total pot 900 | Rake 50 
Board [9s 8h Jh]
Seat 2: Duke Croix folded on the Flop
Seat 4: Manon947 (button) folded before Flop (didn't bet)
Seat 8: color_singleton (small blind) collected (850)
Seat 9: HighCardJasper (big blind) folded before Flop



PokerStars Home Game Hand #216255647102: {Club #3225207}  Hold'em No Limit (50/100) - 2020/07/09 19:19:26 ET
Table 'lets goo' 9-max (Play Money) Seat #8 is the button
Seat 2: Duke Croix (14028 in chips) 
Seat 4: Manon947 (5214 in chips) 
Seat 8: color_singleton (14423 in chips) 
Seat 9: HighCardJasper (7275 in chips) 
HighCardJasper: posts small blind 50
Duke Croix: posts big blind 100
*** HOLE CARDS ***
Dealt to Duke Croix [8s Qh]
Manon947: calls 100
color_singleton: folds 
HighCardJasper: calls 50
Duke Croix: checks 
*** FLOP *** [5s 9c 8c]
HighCardJasper: checks 
Duke Croix: bets 200
Manon947: folds 
HighCardJasper: folds 
Uncalled bet (200) returned to Duke Croix
Duke Croix collected 283 from pot
*** SUMMARY ***
Total pot 300 | Rake 17 
Board [5s 9c 8c]
Seat 2: Duke Croix (big blind) collected (283)
Seat 4: Manon947 folded on the Flop
Seat 8: color_singleton (button) folded before Flop (didn't bet)
Seat 9: HighCardJasper (small blind) folded on the Flop



PokerStars Home Game Hand #216255663454: {Club #3225207}  Hold'em No Limit (50/100) - 2020/07/09 19:20:01 ET
Table 'lets goo' 9-max (Play Money) Seat #9 is the button
Seat 2: Duke Croix (14211 in chips) 
Seat 4: Manon947 (5114 in chips) 
Seat 8: color_singleton (14423 in chips) 
Seat 9: HighCardJasper (7175 in chips) 
Duke Croix: posts small blind 50
Manon947: posts big blind 100
*** HOLE CARDS ***
Dealt to Duke Croix [Ks 4d]
color_singleton: folds 
HighCardJasper: raises 200 to 300
Duke Croix: folds 
Manon947: calls 200
*** FLOP *** [5h As 9d]
Manon947: checks 
HighCardJasper: bets 200
Manon947: calls 200
*** TURN *** [5h As 9d] [7s]
Manon947: checks 
HighCardJasper: bets 300
Manon947: folds 
Uncalled bet (300) returned to HighCardJasper
HighCardJasper collected 992 from pot
HighCardJasper: doesn't show hand 
*** SUMMARY ***
Total pot 1050 | Rake 58 
Board [5h As 9d 7s]
Seat 2: Duke Croix (small blind) folded before Flop
Seat 4: Manon947 (big blind) folded on the Turn
Seat 8: color_singleton folded before Flop (didn't bet)
Seat 9: HighCardJasper (button) collected (992)



PokerStars Home Game Hand #216255686726: {Club #3225207}  Hold'em No Limit (50/100) - 2020/07/09 19:20:44 ET
Table 'lets goo' 9-max (Play Money) Seat #2 is the button
Seat 2: Duke Croix (14161 in chips) 
Seat 4: Manon947 (4614 in chips) 
Seat 8: color_singleton (14423 in chips) 
Seat 9: HighCardJasper (7667 in chips) 
Manon947: posts small blind 50
color_singleton: posts big blind 100
*** HOLE CARDS ***
Dealt to Duke Croix [Ts Ac]
HighCardJasper: calls 100
Duke Croix: raises 300 to 400
Manon947: folds 
color_singleton: calls 300
HighCardJasper: folds 
*** FLOP *** [4s 6h As]
color_singleton: checks 
Duke Croix: bets 500
color_singleton: raises 500 to 1000
Duke Croix: calls 500
*** TURN *** [4s 6h As] [Kd]
color_singleton: checks 
Duke Croix: checks 
*** RIVER *** [4s 6h As Kd] [4h]
color_singleton: checks 
Duke Croix: checks 
*** SHOW DOWN ***
color_singleton: shows [2c Ah] (two pair, Aces and Fours)
Duke Croix: shows [Ts Ac] (two pair, Aces and Fours)
color_singleton collected 1394 from pot
Duke Croix collected 1394 from pot
*** SUMMARY ***
Total pot 2950 | Rake 162 
Board [4s 6h As Kd 4h]
Seat 2: Duke Croix (button) showed [Ts Ac] and won (1394) with two pair, Aces and Fours
Seat 4: Manon947 (small blind) folded before Flop
Seat 8: color_singleton (big blind) showed [2c Ah] and won (1394) with two pair, Aces and Fours
Seat 9: HighCardJasper folded before Flop



PokerStars Home Game Hand #216255701941: {Club #3225207}  Hold'em No Limit (50/100) - 2020/07/09 19:21:18 ET
Table 'lets goo' 9-max (Play Money) Seat #4 is the button
Seat 2: Duke Croix (14155 in chips) 
Seat 4: Manon947 (4564 in chips) 
Seat 8: color_singleton (14417 in chips) 
Seat 9: HighCardJasper (7567 in chips) 
color_singleton: posts small blind 50
HighCardJasper: posts big blind 100
*** HOLE CARDS ***
Dealt to Duke Croix [2d Qc]
Duke Croix: folds 
Manon947: folds 
color_singleton: folds 
Uncalled bet (50) returned to HighCardJasper
HighCardJasper collected 100 from pot
HighCardJasper: doesn't show hand 
*** SUMMARY ***
Total pot 100 | Rake 0 
Seat 2: Duke Croix folded before Flop (didn't bet)
Seat 4: Manon947 (button) folded before Flop (didn't bet)
Seat 8: color_singleton (small blind) folded before Flop
Seat 9: HighCardJasper (big blind) collected (100)



PokerStars Home Game Hand #216255705983: {Club #3225207}  Hold'em No Limit (50/100) - 2020/07/09 19:21:27 ET
Table 'lets goo' 9-max (Play Money) Seat #8 is the button
Seat 2: Duke Croix (14155 in chips) 
Seat 4: Manon947 (4564 in chips) 
Seat 8: color_singleton (14367 in chips) 
Seat 9: HighCardJasper (7617 in chips) 
HighCardJasper: posts small blind 50
Duke Croix: posts big blind 100
*** HOLE CARDS ***
Dealt to Duke Croix [Kd As]
Manon947: folds 
color_singleton: calls 100
HighCardJasper: calls 50
Duke Croix: raises 400 to 500
color_singleton: folds 
HighCardJasper: folds 
Uncalled bet (400) returned to Duke Croix
Duke Croix collected 300 from pot
*** SUMMARY ***
Total pot 300 | Rake 0 
Seat 2: Duke Croix (big blind) collected (300)
Seat 4: Manon947 folded before Flop (didn't bet)
Seat 8: color_singleton (button) folded before Flop
Seat 9: HighCardJasper (small blind) folded before Flop



PokerStars Home Game Hand #216255717426: {Club #3225207}  Hold'em No Limit (50/100) - 2020/07/09 19:21:52 ET
Table 'lets goo' 9-max (Play Money) Seat #9 is the button
Seat 2: Duke Croix (14355 in chips) 
Seat 4: Manon947 (4564 in chips) 
Seat 8: color_singleton (14267 in chips) 
Seat 9: HighCardJasper (7517 in chips) 
Duke Croix: posts small blind 50
Manon947: posts big blind 100
*** HOLE CARDS ***
Dealt to Duke Croix [Th Js]
color_singleton: folds 
HighCardJasper: calls 100
Duke Croix: raises 300 to 400
Manon947: folds 
HighCardJasper: calls 300
*** FLOP *** [6c Jc 2h]
Duke Croix: bets 400
HighCardJasper: folds 
Uncalled bet (400) returned to Duke Croix
Duke Croix collected 850 from pot
*** SUMMARY ***
Total pot 900 | Rake 50 
Board [6c Jc 2h]
Seat 2: Duke Croix (small blind) collected (850)
Seat 4: Manon947 (big blind) folded before Flop
Seat 8: color_singleton folded before Flop (didn't bet)
Seat 9: HighCardJasper (button) folded on the Flop



PokerStars Home Game Hand #216255727973: {Club #3225207}  Hold'em No Limit (50/100) - 2020/07/09 19:22:16 ET
Table 'lets goo' 9-max (Play Money) Seat #2 is the button
Seat 2: Duke Croix (14805 in chips) 
Seat 4: Manon947 (4464 in chips) 
Seat 8: color_singleton (14267 in chips) 
Seat 9: HighCardJasper (7117 in chips) 
Manon947: posts small blind 50
color_singleton: posts big blind 100
*** HOLE CARDS ***
Dealt to Duke Croix [7d 5h]
HighCardJasper: calls 100
Duke Croix: folds 
Manon947: calls 50
color_singleton: raises 200 to 300
HighCardJasper: folds 
Manon947: calls 200
*** FLOP *** [2d Qd 6h]
Manon947: checks 
color_singleton: checks 
*** TURN *** [2d Qd 6h] [9c]
Manon947: checks 
color_singleton: checks 
*** RIVER *** [2d Qd 6h 9c] [7h]
Manon947: checks 
color_singleton: checks 
*** SHOW DOWN ***
Manon947: shows [Kd 4c] (high card King)
color_singleton: shows [Ad 8s] (high card Ace)
color_singleton collected 661 from pot
*** SUMMARY ***
Total pot 700 | Rake 39 
Board [2d Qd 6h 9c 7h]
Seat 2: Duke Croix (button) folded before Flop (didn't bet)
Seat 4: Manon947 (small blind) showed [Kd 4c] and lost with high card King
Seat 8: color_singleton (big blind) showed [Ad 8s] and won (661) with high card Ace
Seat 9: HighCardJasper folded before Flop



PokerStars Home Game Hand #216255741294: {Club #3225207}  Hold'em No Limit (50/100) - 2020/07/09 19:22:46 ET
Table 'lets goo' 9-max (Play Money) Seat #4 is the button
Seat 2: Duke Croix (14805 in chips) 
Seat 4: Manon947 (4164 in chips) 
Seat 8: color_singleton (14628 in chips) 
Seat 9: HighCardJasper (7017 in chips) 
color_singleton: posts small blind 50
HighCardJasper: posts big blind 100
*** HOLE CARDS ***
Dealt to Duke Croix [7c 5d]
Duke Croix: folds 
Manon947: folds 
color_singleton: calls 50
HighCardJasper: raises 200 to 300
color_singleton: calls 200
*** FLOP *** [Ts Qs 4s]
color_singleton: checks 
HighCardJasper: checks 
*** TURN *** [Ts Qs 4s] [Ac]
color_singleton: checks 
HighCardJasper: bets 200
color_singleton: folds 
Uncalled bet (200) returned to HighCardJasper
HighCardJasper collected 567 from pot
HighCardJasper: doesn't show hand 
*** SUMMARY ***
Total pot 600 | Rake 33 
Board [Ts Qs 4s Ac]
Seat 2: Duke Croix folded before Flop (didn't bet)
Seat 4: Manon947 (button) folded before Flop (didn't bet)
Seat 8: color_singleton (small blind) folded on the Turn
Seat 9: HighCardJasper (big blind) collected (567)



PokerStars Home Game Hand #216255755784: {Club #3225207}  Hold'em No Limit (50/100) - 2020/07/09 19:23:18 ET
Table 'lets goo' 9-max (Play Money) Seat #8 is the button
Seat 2: Duke Croix (14805 in chips) 
Seat 4: Manon947 (4164 in chips) 
Seat 8: color_singleton (14328 in chips) 
Seat 9: HighCardJasper (7284 in chips) 
HighCardJasper: posts small blind 50
Duke Croix: posts big blind 100
*** HOLE CARDS ***
Dealt to Duke Croix [Td 2h]
Manon947: folds 
color_singleton: raises 100 to 200
HighCardJasper: calls 150
Duke Croix: calls 100
*** FLOP *** [Ah Js Qh]
HighCardJasper: checks 
Duke Croix: checks 
color_singleton: checks 
*** TURN *** [Ah Js Qh] [Ad]
HighCardJasper: checks 
Duke Croix: checks 
color_singleton: checks 
*** RIVER *** [Ah Js Qh Ad] [5s]
HighCardJasper: checks 
Duke Croix: checks 
color_singleton: checks 
*** SHOW DOWN ***
HighCardJasper: shows [2s 6s] (a pair of Aces)
Duke Croix: shows [Td 2h] (a pair of Aces - Queen+Jack+Ten kicker)
color_singleton: shows [Jd 9d] (two pair, Aces and Jacks)
color_singleton collected 567 from pot
*** SUMMARY ***
Total pot 600 | Rake 33 
Board [Ah Js Qh Ad 5s]
Seat 2: Duke Croix (big blind) showed [Td 2h] and lost with a pair of Aces
Seat 4: Manon947 folded before Flop (didn't bet)
Seat 8: color_singleton (button) showed [Jd 9d] and won (567) with two pair, Aces and Jacks
Seat 9: HighCardJasper (small blind) showed [2s 6s] and lost with a pair of Aces



PokerStars Home Game Hand #216255771171: {Club #3225207}  Hold'em No Limit (50/100) - 2020/07/09 19:23:53 ET
Table 'lets goo' 9-max (Play Money) Seat #9 is the button
Seat 2: Duke Croix (14605 in chips) 
Seat 4: Manon947 (4164 in chips) 
Seat 8: color_singleton (14695 in chips) 
Seat 9: HighCardJasper (7084 in chips) 
Duke Croix: posts small blind 50
Manon947: posts big blind 100
*** HOLE CARDS ***
Dealt to Duke Croix [6s 5h]
color_singleton: raises 200 to 300
HighCardJasper: calls 300
Duke Croix: folds 
Manon947: folds 
*** FLOP *** [5d 6d Js]
color_singleton: checks 
HighCardJasper: bets 200
color_singleton: calls 200
*** TURN *** [5d 6d Js] [9h]
color_singleton: checks 
HighCardJasper: bets 200
color_singleton: calls 200
*** RIVER *** [5d 6d Js 9h] [7d]
color_singleton: checks 
HighCardJasper: bets 400
color_singleton: folds 
Uncalled bet (400) returned to HighCardJasper
HighCardJasper collected 1465 from pot
HighCardJasper: doesn't show hand 
*** SUMMARY ***
Total pot 1550 | Rake 85 
Board [5d 6d Js 9h 7d]
Seat 2: Duke Croix (small blind) folded before Flop
Seat 4: Manon947 (big blind) folded before Flop
Seat 8: color_singleton folded on the River
Seat 9: HighCardJasper (button) collected (1465)



PokerStars Home Game Hand #216255788404: {Club #3225207}  Hold'em No Limit (50/100) - 2020/07/09 19:24:32 ET
Table 'lets goo' 9-max (Play Money) Seat #2 is the button
Seat 2: Duke Croix (14555 in chips) 
Seat 4: Manon947 (4064 in chips) 
Seat 8: color_singleton (13995 in chips) 
Seat 9: HighCardJasper (7849 in chips) 
Manon947: posts small blind 50
color_singleton: posts big blind 100
*** HOLE CARDS ***
Dealt to Duke Croix [4c 8d]
HighCardJasper: calls 100
Duke Croix: folds 
Manon947: folds 
color_singleton: checks 
*** FLOP *** [9d Ac 6d]
color_singleton: checks 
HighCardJasper: checks 
*** TURN *** [9d Ac 6d] [8s]
color_singleton has timed out
color_singleton: checks 
HighCardJasper: checks 
*** RIVER *** [9d Ac 6d 8s] [3s]
color_singleton: checks 
HighCardJasper: checks 
*** SHOW DOWN ***
color_singleton: shows [Jh 5d] (high card Ace)
HighCardJasper: shows [2h Kd] (high card Ace - King kicker)
HighCardJasper collected 236 from pot
*** SUMMARY ***
Total pot 250 | Rake 14 
Board [9d Ac 6d 8s 3s]
Seat 2: Duke Croix (button) folded before Flop (didn't bet)
Seat 4: Manon947 (small blind) folded before Flop
Seat 8: color_singleton (big blind) showed [Jh 5d] and lost with high card Ace
Seat 9: HighCardJasper showed [2h Kd] and won (236) with high card Ace



PokerStars Home Game Hand #216255810959: {Club #3225207}  Hold'em No Limit (50/100) - 2020/07/09 19:25:22 ET
Table 'lets goo' 9-max (Play Money) Seat #4 is the button
Seat 2: Duke Croix (14555 in chips) 
Seat 4: Manon947 (4014 in chips) 
Seat 8: color_singleton (13895 in chips) 
Seat 9: HighCardJasper (7985 in chips) 
color_singleton: posts small blind 50
HighCardJasper: posts big blind 100
*** HOLE CARDS ***
Dealt to Duke Croix [4c 2h]
Duke Croix: folds 
Manon947: raises 100 to 200
color_singleton: calls 150
HighCardJasper: calls 100
*** FLOP *** [As 3h 4d]
color_singleton: checks 
HighCardJasper: checks 
Manon947: bets 283
color_singleton: calls 283
HighCardJasper: calls 283
*** TURN *** [As 3h 4d] [Kh]
color_singleton: checks 
HighCardJasper: checks 
Manon947: bets 684
color_singleton: calls 684
HighCardJasper: folds 
*** RIVER *** [As 3h 4d Kh] [6c]
color_singleton: checks 
Manon947: bets 1331
color_singleton: folds 
Uncalled bet (1331) returned to Manon947
Manon947 collected 2662 from pot
*** SUMMARY ***
Total pot 2817 | Rake 155 
Board [As 3h 4d Kh 6c]
Seat 2: Duke Croix folded before Flop (didn't bet)
Seat 4: Manon947 (button) collected (2662)
Seat 8: color_singleton (small blind) folded on the River
Seat 9: HighCardJasper (big blind) folded on the Turn



PokerStars Home Game Hand #216255836034: {Club #3225207}  Hold'em No Limit (50/100) - 2020/07/09 19:26:20 ET
Table 'lets goo' 9-max (Play Money) Seat #8 is the button
Seat 2: Duke Croix (14555 in chips) 
Seat 4: Manon947 (5509 in chips) 
Seat 8: color_singleton (12728 in chips) 
Seat 9: HighCardJasper (7502 in chips) 
HighCardJasper: posts small blind 50
Duke Croix: posts big blind 100
*** HOLE CARDS ***
Dealt to Duke Croix [2d 4s]
Manon947: calls 100
color_singleton: folds 
HighCardJasper: calls 50
Duke Croix: checks 
*** FLOP *** [3h 9c Ad]
HighCardJasper: checks 
Duke Croix: bets 200
Manon947: folds 
HighCardJasper: folds 
Uncalled bet (200) returned to Duke Croix
Duke Croix collected 283 from pot
*** SUMMARY ***
Total pot 300 | Rake 17 
Board [3h 9c Ad]
Seat 2: Duke Croix (big blind) collected (283)
Seat 4: Manon947 folded on the Flop
Seat 8: color_singleton (button) folded before Flop (didn't bet)
Seat 9: HighCardJasper (small blind) folded on the Flop



PokerStars Home Game Hand #216255851287: {Club #3225207}  Hold'em No Limit (50/100) - 2020/07/09 19:26:54 ET
Table 'lets goo' 9-max (Play Money) Seat #9 is the button
Seat 2: Duke Croix (14738 in chips) 
Seat 4: Manon947 (5409 in chips) 
Seat 8: color_singleton (12728 in chips) 
Seat 9: HighCardJasper (7402 in chips) 
Duke Croix: posts small blind 50
Manon947: posts big blind 100
*** HOLE CARDS ***
Dealt to Duke Croix [4s As]
color_singleton: raises 200 to 300
HighCardJasper: calls 300
Duke Croix: calls 250
Manon947: folds 
*** FLOP *** [Qd Js 7h]
Duke Croix: checks 
color_singleton: checks 
HighCardJasper: checks 
*** TURN *** [Qd Js 7h] [9h]
Duke Croix: checks 
color_singleton: checks 
HighCardJasper: checks 
*** RIVER *** [Qd Js 7h 9h] [Qh]
Duke Croix: checks 
color_singleton: checks 
HighCardJasper: checks 
*** SHOW DOWN ***
Duke Croix: shows [4s As] (a pair of Queens)
color_singleton: shows [5c Ac] (a pair of Queens)
HighCardJasper: mucks hand 
Duke Croix collected 473 from pot
color_singleton collected 472 from pot
*** SUMMARY ***
Total pot 1000 | Rake 55 
Board [Qd Js 7h 9h Qh]
Seat 2: Duke Croix (small blind) showed [4s As] and won (473) with a pair of Queens
Seat 4: Manon947 (big blind) folded before Flop
Seat 8: color_singleton showed [5c Ac] and won (472) with a pair of Queens
Seat 9: HighCardJasper (button) mucked [Ts 6s]



PokerStars Home Game Hand #216255874594: {Club #3225207}  Hold'em No Limit (50/100) - 2020/07/09 19:27:47 ET
Table 'lets goo' 9-max (Play Money) Seat #2 is the button
Seat 2: Duke Croix (14911 in chips) 
Seat 4: Manon947 (5309 in chips) 
Seat 8: color_singleton (12900 in chips) 
Seat 9: HighCardJasper (7102 in chips) 
Manon947: posts small blind 50
color_singleton: posts big blind 100
*** HOLE CARDS ***
Dealt to Duke Croix [2c 5h]
HighCardJasper: raises 100 to 200
Duke Croix: folds 
Manon947: calls 150
color_singleton: calls 100
*** FLOP *** [6d 2s Th]
Manon947: checks 
color_singleton: checks 
HighCardJasper: checks 
*** TURN *** [6d 2s Th] [8s]
Manon947: bets 283
color_singleton: folds 
HighCardJasper: folds 
Uncalled bet (283) returned to Manon947
Manon947 collected 567 from pot
*** SUMMARY ***
Total pot 600 | Rake 33 
Board [6d 2s Th 8s]
Seat 2: Duke Croix (button) folded before Flop (didn't bet)
Seat 4: Manon947 (small blind) collected (567)
Seat 8: color_singleton (big blind) folded on the Turn
Seat 9: HighCardJasper folded on the Turn



PokerStars Home Game Hand #216255888513: {Club #3225207}  Hold'em No Limit (50/100) - 2020/07/09 19:28:19 ET
Table 'lets goo' 9-max (Play Money) Seat #4 is the button
Seat 2: Duke Croix (14911 in chips) 
Seat 4: Manon947 (5676 in chips) 
Seat 8: color_singleton (12700 in chips) 
Seat 9: HighCardJasper (6902 in chips) 
color_singleton: posts small blind 50
HighCardJasper: posts big blind 100
*** HOLE CARDS ***
Dealt to Duke Croix [5s Ac]
Duke Croix: calls 100
Manon947: calls 100
color_singleton: raises 200 to 300
HighCardJasper: folds 
Duke Croix: calls 200
Manon947: calls 200
*** FLOP *** [2d 7h 7c]
color_singleton: bets 472
Duke Croix: folds 
Manon947: folds 
Uncalled bet (472) returned to color_singleton
color_singleton collected 945 from pot
color_singleton: doesn't show hand 
*** SUMMARY ***
Total pot 1000 | Rake 55 
Board [2d 7h 7c]
Seat 2: Duke Croix folded on the Flop
Seat 4: Manon947 (button) folded on the Flop
Seat 8: color_singleton (small blind) collected (945)
Seat 9: HighCardJasper (big blind) folded before Flop



PokerStars Home Game Hand #216255908481: {Club #3225207}  Hold'em No Limit (50/100) - 2020/07/09 19:29:05 ET
Table 'lets goo' 9-max (Play Money) Seat #8 is the button
Seat 2: Duke Croix (14611 in chips) 
Seat 4: Manon947 (5376 in chips) 
Seat 8: color_singleton (13345 in chips) 
Seat 9: HighCardJasper (6802 in chips) 
HighCardJasper: posts small blind 50
Duke Croix: posts big blind 100
*** HOLE CARDS ***
Dealt to Duke Croix [Qs 4s]
Manon947: calls 100
color_singleton: calls 100
HighCardJasper: calls 50
Duke Croix: checks 
*** FLOP *** [Ac 9c 5s]
HighCardJasper: bets 200
Duke Croix: folds 
Manon947: calls 200
color_singleton: calls 200
*** TURN *** [Ac 9c 5s] [Th]
HighCardJasper: bets 200
Manon947: calls 200
color_singleton: folds 
*** RIVER *** [Ac 9c 5s Th] [7s]
HighCardJasper: checks 
Manon947: checks 
*** SHOW DOWN ***
HighCardJasper: shows [Jc 4c] (high card Ace)
Manon947: shows [Ks Jh] (high card Ace - King kicker)
Manon947 collected 1323 from pot
*** SUMMARY ***
Total pot 1400 | Rake 77 
Board [Ac 9c 5s Th 7s]
Seat 2: Duke Croix (big blind) folded on the Flop
Seat 4: Manon947 showed [Ks Jh] and won (1323) with high card Ace
Seat 8: color_singleton (button) folded on the Turn
Seat 9: HighCardJasper (small blind) showed [Jc 4c] and lost with high card Ace



PokerStars Home Game Hand #216255923533: {Club #3225207}  Hold'em No Limit (50/100) - 2020/07/09 19:29:40 ET
Table 'lets goo' 9-max (Play Money) Seat #9 is the button
Seat 2: Duke Croix (14511 in chips) 
Seat 4: Manon947 (6199 in chips) 
Seat 8: color_singleton (13045 in chips) 
Seat 9: HighCardJasper (6302 in chips) 
Duke Croix: posts small blind 50
Manon947: posts big blind 100
*** HOLE CARDS ***
Dealt to Duke Croix [6c Ac]
color_singleton: raises 100 to 200
HighCardJasper: calls 200
Duke Croix: calls 150
Manon947: calls 100
*** FLOP *** [Ah Ks Jc]
Duke Croix: bets 400
Manon947: calls 400
color_singleton: calls 400
HighCardJasper: folds 
*** TURN *** [Ah Ks Jc] [9d]
Duke Croix: checks 
Manon947: bets 945
color_singleton: calls 945
Duke Croix: calls 945
*** RIVER *** [Ah Ks Jc 9d] [Td]
Duke Croix: checks 
Manon947: bets 2284
color_singleton: calls 2284
Duke Croix: folds 
*** SHOW DOWN ***
Manon947: shows [4c Kh] (a pair of Kings)
color_singleton: shows [Qc Ts] (a straight, Ten to Ace)
color_singleton collected 8886 from pot
*** SUMMARY ***
Total pot 9403 | Rake 517 
Board [Ah Ks Jc 9d Td]
Seat 2: Duke Croix (small blind) folded on the River
Seat 4: Manon947 (big blind) showed [4c Kh] and lost with a pair of Kings
Seat 8: color_singleton showed [Qc Ts] and won (8886) with a straight, Ten to Ace
Seat 9: HighCardJasper (button) folded on the Flop



PokerStars Home Game Hand #216255948289: {Club #3225207}  Hold'em No Limit (50/100) - 2020/07/09 19:30:21 ET
Table 'lets goo' 9-max (Play Money) Seat #2 is the button
Seat 2: Duke Croix (12966 in chips) 
Seat 4: Manon947 (2370 in chips) 
Seat 8: color_singleton (18102 in chips) 
Seat 9: HighCardJasper (6102 in chips) 
Manon947: posts small blind 50
color_singleton: posts big blind 100
*** HOLE CARDS ***
Dealt to Duke Croix [7s 2s]
HighCardJasper: raises 100 to 200
Duke Croix: folds 
Manon947: calls 150
color_singleton: calls 100
*** FLOP *** [Jd 2d Js]
Manon947: checks 
color_singleton: checks 
HighCardJasper: checks 
*** TURN *** [Jd 2d Js] [8h]
Manon947: checks 
color_singleton: bets 283
HighCardJasper: calls 283
Manon947: folds 
*** RIVER *** [Jd 2d Js 8h] [Ad]
color_singleton: bets 551
HighCardJasper: raises 551 to 1102
color_singleton: calls 551
*** SHOW DOWN ***
HighCardJasper: shows [Jh Ks] (three of a kind, Jacks)
color_singleton: mucks hand 
HighCardJasper collected 3185 from pot
*** SUMMARY ***
Total pot 3370 | Rake 185 
Board [Jd 2d Js 8h Ad]
Seat 2: Duke Croix (button) folded before Flop (didn't bet)
Seat 4: Manon947 (small blind) folded on the Turn
Seat 8: color_singleton (big blind) mucked [4d Jc]
Seat 9: HighCardJasper showed [Jh Ks] and won (3185) with three of a kind, Jacks



PokerStars Home Game Hand #216255964749: {Club #3225207}  Hold'em No Limit (50/100) - 2020/07/09 19:30:59 ET
Table 'lets goo' 9-max (Play Money) Seat #4 is the button
Seat 2: Duke Croix (12966 in chips) 
Seat 4: Manon947 (2170 in chips) 
Seat 8: color_singleton (16517 in chips) 
Seat 9: HighCardJasper (7702 in chips) 
color_singleton: posts small blind 50
HighCardJasper: posts big blind 100
*** HOLE CARDS ***
Dealt to Duke Croix [Qd 6s]
Duke Croix: raises 300 to 400
Manon947: calls 400
color_singleton: folds 
HighCardJasper: folds 
*** FLOP *** [5d Kc Td]
Duke Croix: bets 500
Manon947: calls 500
*** TURN *** [5d Kc Td] [Qs]
Duke Croix: checks 
Manon947: bets 921
Duke Croix: raises 1842 to 2763
Manon947: calls 349 and is all-in
Uncalled bet (1493) returned to Duke Croix
*** RIVER *** [5d Kc Td Qs] [Js]
*** SHOW DOWN ***
Duke Croix: shows [Qd 6s] (a pair of Queens)
Manon947: shows [Kd 9h] (a straight, Nine to King)
Manon947 collected 4243 from pot
*** SUMMARY ***
Total pot 4490 | Rake 247 
Board [5d Kc Td Qs Js]
Seat 2: Duke Croix showed [Qd 6s] and lost with a pair of Queens
Seat 4: Manon947 (button) showed [Kd 9h] and won (4243) with a straight, Nine to King
Seat 8: color_singleton (small blind) folded before Flop
Seat 9: HighCardJasper (big blind) folded before Flop



PokerStars Home Game Hand #216255985523: {Club #3225207}  Hold'em No Limit (50/100) - 2020/07/09 19:31:47 ET
Table 'lets goo' 9-max (Play Money) Seat #8 is the button
Seat 2: Duke Croix (10796 in chips) 
Seat 4: Manon947 (4243 in chips) 
Seat 8: color_singleton (16467 in chips) 
Seat 9: HighCardJasper (7602 in chips) 
HighCardJasper: posts small blind 50
Duke Croix: posts big blind 100
*** HOLE CARDS ***
Dealt to Duke Croix [7c 8h]
Manon947: folds 
color_singleton: raises 100 to 200
HighCardJasper: raises 100 to 300
Duke Croix: calls 200
color_singleton: calls 100
*** FLOP *** [3h Js 4d]
HighCardJasper: checks 
Duke Croix: checks 
color_singleton: checks 
*** TURN *** [3h Js 4d] [9s]
HighCardJasper: bets 200
Duke Croix: calls 200
color_singleton: calls 200
*** RIVER *** [3h Js 4d 9s] [Qs]
HighCardJasper: checks 
Duke Croix: checks 
color_singleton: bets 708
HighCardJasper: folds 
Duke Croix: folds 
Uncalled bet (708) returned to color_singleton
color_singleton collected 1417 from pot
color_singleton: doesn't show hand 
*** SUMMARY ***
Total pot 1500 | Rake 83 
Board [3h Js 4d 9s Qs]
Seat 2: Duke Croix (big blind) folded on the River
Seat 4: Manon947 folded before Flop (didn't bet)
Seat 8: color_singleton (button) collected (1417)
Seat 9: HighCardJasper (small blind) folded on the River



PokerStars Home Game Hand #216256003201: {Club #3225207}  Hold'em No Limit (50/100) - 2020/07/09 19:32:28 ET
Table 'lets goo' 9-max (Play Money) Seat #9 is the button
Seat 2: Duke Croix (10296 in chips) 
Seat 4: Manon947 (4243 in chips) 
Seat 8: color_singleton (17384 in chips) 
Seat 9: HighCardJasper (7102 in chips) 
Duke Croix: posts small blind 50
Manon947: posts big blind 100
*** HOLE CARDS ***
Dealt to Duke Croix [Kc 4c]
color_singleton: folds 
HighCardJasper: calls 100
Duke Croix: calls 50
Manon947: checks 
*** FLOP *** [Kd 9d 2s]
Duke Croix: bets 200
Manon947: calls 200
HighCardJasper: raises 200 to 400
Duke Croix: calls 200
Manon947: folds 
*** TURN *** [Kd 9d 2s] [Jh]
Duke Croix: checks 
HighCardJasper: checks 
*** RIVER *** [Kd 9d 2s Jh] [2d]
Duke Croix: bets 600
HighCardJasper: calls 600
*** SHOW DOWN ***
Duke Croix: shows [Kc 4c] (two pair, Kings and Deuces)
HighCardJasper: shows [Td Kh] (two pair, Kings and Deuces)
Duke Croix collected 1181 from pot
HighCardJasper collected 1181 from pot
*** SUMMARY ***
Total pot 2500 | Rake 138 
Board [Kd 9d 2s Jh 2d]
Seat 2: Duke Croix (small blind) showed [Kc 4c] and won (1181) with two pair, Kings and Deuces
Seat 4: Manon947 (big blind) folded on the Flop
Seat 8: color_singleton folded before Flop (didn't bet)
Seat 9: HighCardJasper (button) showed [Td Kh] and won (1181) with two pair, Kings and Deuces



PokerStars Home Game Hand #216256022670: {Club #3225207}  Hold'em No Limit (50/100) - 2020/07/09 19:33:14 ET
Table 'lets goo' 9-max (Play Money) Seat #2 is the button
Seat 2: Duke Croix (10377 in chips) 
Seat 4: Manon947 (3943 in chips) 
Seat 8: color_singleton (17384 in chips) 
Seat 9: HighCardJasper (7183 in chips) 
Manon947: posts small blind 50
color_singleton: posts big blind 100
*** HOLE CARDS ***
Dealt to Duke Croix [7c Kd]
HighCardJasper: calls 100
Duke Croix: calls 100
Manon947: folds 
color_singleton: checks 
*** FLOP *** [Ts Kh Ac]
color_singleton: checks 
HighCardJasper: checks 
Duke Croix: bets 200
color_singleton: folds 
HighCardJasper: folds 
Uncalled bet (200) returned to Duke Croix
Duke Croix collected 331 from pot
*** SUMMARY ***
Total pot 350 | Rake 19 
Board [Ts Kh Ac]
Seat 2: Duke Croix (button) collected (331)
Seat 4: Manon947 (small blind) folded before Flop
Seat 8: color_singleton (big blind) folded on the Flop
Seat 9: HighCardJasper folded on the Flop



PokerStars Home Game Hand #216256034962: {Club #3225207}  Hold'em No Limit (50/100) - 2020/07/09 19:33:43 ET
Table 'lets goo' 9-max (Play Money) Seat #4 is the button
Seat 2: Duke Croix (10608 in chips) 
Seat 4: Manon947 (3893 in chips) 
Seat 8: color_singleton (17284 in chips) 
Seat 9: HighCardJasper (7083 in chips) 
color_singleton: posts small blind 50
HighCardJasper: posts big blind 100
*** HOLE CARDS ***
Dealt to Duke Croix [7c 9c]
Duke Croix: raises 200 to 300
Manon947: folds 
color_singleton: folds 
HighCardJasper: raises 200 to 500
Duke Croix: calls 200
*** FLOP *** [6c 2s Jd]
HighCardJasper: checks 
Duke Croix: bets 500
HighCardJasper: folds 
Uncalled bet (500) returned to Duke Croix
Duke Croix collected 992 from pot
*** SUMMARY ***
Total pot 1050 | Rake 58 
Board [6c 2s Jd]
Seat 2: Duke Croix collected (992)
Seat 4: Manon947 (button) folded before Flop (didn't bet)
Seat 8: color_singleton (small blind) folded before Flop
Seat 9: HighCardJasper (big blind) folded on the Flop



PokerStars Home Game Hand #216256047282: {Club #3225207}  Hold'em No Limit (50/100) - 2020/07/09 19:34:12 ET
Table 'lets goo' 9-max (Play Money) Seat #8 is the button
Seat 2: Duke Croix (11100 in chips) 
Seat 4: Manon947 (3893 in chips) 
Seat 8: color_singleton (17234 in chips) 
Seat 9: HighCardJasper (6583 in chips) 
HighCardJasper: posts small blind 50
Duke Croix: posts big blind 100
*** HOLE CARDS ***
Dealt to Duke Croix [Td Qd]
Manon947: calls 100
color_singleton: raises 100 to 200
HighCardJasper: calls 150
Duke Croix: calls 100
Manon947: calls 100
*** FLOP *** [Tc Qh Ah]
HighCardJasper: checks 
Duke Croix: bets 500
Manon947: calls 500
color_singleton: calls 500
HighCardJasper: calls 500
*** TURN *** [Tc Qh Ah] [4s]
HighCardJasper: checks 
Duke Croix: bets 1600
Manon947: folds 
color_singleton: folds 
HighCardJasper: folds 
Uncalled bet (1600) returned to Duke Croix
Duke Croix collected 2646 from pot
*** SUMMARY ***
Total pot 2800 | Rake 154 
Board [Tc Qh Ah 4s]
Seat 2: Duke Croix (big blind) collected (2646)
Seat 4: Manon947 folded on the Turn
Seat 8: color_singleton (button) folded on the Turn
Seat 9: HighCardJasper (small blind) folded on the Turn



PokerStars Home Game Hand #216256064422: {Club #3225207}  Hold'em No Limit (50/100) - 2020/07/09 19:34:52 ET
Table 'lets goo' 9-max (Play Money) Seat #9 is the button
Seat 2: Duke Croix (13046 in chips) 
Seat 4: Manon947 (3193 in chips) 
Seat 8: color_singleton (16534 in chips) 
Seat 9: HighCardJasper (5883 in chips) 
Duke Croix: posts small blind 50
Manon947: posts big blind 100
*** HOLE CARDS ***
Dealt to Duke Croix [Js Qc]
color_singleton: raises 250 to 350
HighCardJasper: calls 350
Duke Croix: calls 300
Manon947: calls 250
*** FLOP *** [Jd 3h 8c]
Duke Croix: bets 600
Manon947: calls 600
color_singleton: folds 
HighCardJasper: folds 
*** TURN *** [Jd 3h 8c] [3d]
Duke Croix: bets 2300
Manon947: calls 2243 and is all-in
Uncalled bet (57) returned to Duke Croix
*** RIVER *** [Jd 3h 8c 3d] [4c]
*** SHOW DOWN ***
Duke Croix: shows [Js Qc] (two pair, Jacks and Threes)
Manon947: shows [Jc 7d] (two pair, Jacks and Threes - lower kicker)
Duke Croix collected 6696 from pot
*** SUMMARY ***
Total pot 7086 | Rake 390 
Board [Jd 3h 8c 3d 4c]
Seat 2: Duke Croix (small blind) showed [Js Qc] and won (6696) with two pair, Jacks and Threes
Seat 4: Manon947 (big blind) showed [Jc 7d] and lost with two pair, Jacks and Threes
Seat 8: color_singleton folded on the Flop
Seat 9: HighCardJasper (button) folded on the Flop



PokerStars Home Game Hand #216256080460: {Club #3225207}  Hold'em No Limit (50/100) - 2020/07/09 19:35:30 ET
Table 'lets goo' 9-max (Play Money) Seat #2 is the button
Seat 2: Duke Croix (16549 in chips) 
Seat 8: color_singleton (16184 in chips) 
Seat 9: HighCardJasper (5533 in chips) 
color_singleton: posts small blind 50
HighCardJasper: posts big blind 100
*** HOLE CARDS ***
Dealt to Duke Croix [2h Th]
Duke Croix: folds 
color_singleton: raises 100 to 200
HighCardJasper: calls 100
*** FLOP *** [4d 8c 7c]
color_singleton: bets 378
HighCardJasper: folds 
Uncalled bet (378) returned to color_singleton
color_singleton collected 378 from pot
color_singleton: doesn't show hand 
*** SUMMARY ***
Total pot 400 | Rake 22 
Board [4d 8c 7c]
Seat 2: Duke Croix (button) folded before Flop (didn't bet)
Seat 8: color_singleton (small blind) collected (378)
Seat 9: HighCardJasper (big blind) folded on the Flop



