PokerStars Home Game Hand #218757867364: {Club #3225207}  Hold'em No Limit (50/100) - 2020/09/24 14:47:06 ET
Table 'money money' 9-max (Play Money) Seat #1 is the button
Seat 1: MnnM150 (9683 in chips) 
Seat 2: dhduncan (9700 in chips) 
Seat 3: Duke Croix (10000 in chips) 
Seat 8: color_singleton (10544 in chips) 
Seat 9: JeBoyDirk (9983 in chips) 
dhduncan: posts small blind 50
Duke Croix: posts big blind 100
*** HOLE CARDS ***
Dealt to Duke Croix [6d 4h]
color_singleton: folds 
JeBoyDirk: folds 
MnnM150: folds 
dhduncan: folds 
Uncalled bet (50) returned to Duke Croix
Duke Croix collected 100 from pot
*** SUMMARY ***
Total pot 100 | Rake 0 
Seat 1: MnnM150 (button) folded before Flop (didn't bet)
Seat 2: dhduncan (small blind) folded before Flop
Seat 3: Duke Croix (big blind) collected (100)
Seat 8: color_singleton folded before Flop (didn't bet)
Seat 9: JeBoyDirk folded before Flop (didn't bet)



PokerStars Home Game Hand #218757874649: {Club #3225207}  Hold'em No Limit (50/100) - 2020/09/24 14:47:19 ET
Table 'money money' 9-max (Play Money) Seat #2 is the button
Seat 1: MnnM150 (9683 in chips) 
Seat 2: dhduncan (9650 in chips) 
Seat 3: Duke Croix (10050 in chips) 
Seat 8: color_singleton (10544 in chips) 
Seat 9: JeBoyDirk (9983 in chips) 
Duke Croix: posts small blind 50
color_singleton: posts big blind 100
*** HOLE CARDS ***
Dealt to Duke Croix [9s 4h]
JeBoyDirk: folds 
MnnM150: raises 100 to 200
dhduncan: calls 200
Duke Croix: folds 
color_singleton: calls 100
*** FLOP *** [3d Jd Tc]
color_singleton: checks 
MnnM150: bets 307
dhduncan: calls 307
color_singleton: folds 
*** TURN *** [3d Jd Tc] [Jc]
MnnM150: bets 597
dhduncan: calls 597
*** RIVER *** [3d Jd Tc Jc] [As]
MnnM150: bets 2323
dhduncan: calls 2323
*** SHOW DOWN ***
MnnM150: shows [Td Ts] (a full house, Tens full of Jacks)
dhduncan: mucks hand 
MnnM150 collected 6713 from pot
*** SUMMARY ***
Total pot 7104 | Rake 391 
Board [3d Jd Tc Jc As]
Seat 1: MnnM150 showed [Td Ts] and won (6713) with a full house, Tens full of Jacks
Seat 2: dhduncan (button) mucked [Jh Qh]
Seat 3: Duke Croix (small blind) folded before Flop
Seat 8: color_singleton (big blind) folded on the Flop
Seat 9: JeBoyDirk folded before Flop (didn't bet)



PokerStars Home Game Hand #218757901643: {Club #3225207}  Hold'em No Limit (50/100) - 2020/09/24 14:48:09 ET
Table 'money money' 9-max (Play Money) Seat #3 is the button
Seat 1: MnnM150 (12969 in chips) 
Seat 2: dhduncan (6223 in chips) 
Seat 3: Duke Croix (10000 in chips) 
Seat 8: color_singleton (10344 in chips) 
Seat 9: JeBoyDirk (9983 in chips) 
color_singleton: posts small blind 50
JeBoyDirk: posts big blind 100
*** HOLE CARDS ***
Dealt to Duke Croix [5h Ac]
MnnM150: calls 100
dhduncan: calls 100
Duke Croix: calls 100
color_singleton: folds 
JeBoyDirk: checks 
*** FLOP *** [6s 7d 4h]
JeBoyDirk: checks 
MnnM150: checks 
dhduncan: checks 
Duke Croix: bets 300
JeBoyDirk: raises 300 to 600
MnnM150: folds 
dhduncan: calls 600
Duke Croix: calls 300
*** TURN *** [6s 7d 4h] [Jh]
JeBoyDirk: checks 
dhduncan: checks 
Duke Croix: checks 
*** RIVER *** [6s 7d 4h Jh] [4c]
JeBoyDirk: bets 700
dhduncan: calls 700
Duke Croix: folds 
*** SHOW DOWN ***
JeBoyDirk: shows [Ts 7h] (two pair, Sevens and Fours)
dhduncan: shows [Tc Jc] (two pair, Jacks and Fours)
dhduncan collected 3449 from pot
*** SUMMARY ***
Total pot 3650 | Rake 201 
Board [6s 7d 4h Jh 4c]
Seat 1: MnnM150 folded on the Flop
Seat 2: dhduncan showed [Tc Jc] and won (3449) with two pair, Jacks and Fours
Seat 3: Duke Croix (button) folded on the River
Seat 8: color_singleton (small blind) folded before Flop
Seat 9: JeBoyDirk (big blind) showed [Ts 7h] and lost with two pair, Sevens and Fours



PokerStars Home Game Hand #218757944827: {Club #3225207}  Hold'em No Limit (50/100) - 2020/09/24 14:49:28 ET
Table 'money money' 9-max (Play Money) Seat #8 is the button
Seat 1: MnnM150 (12869 in chips) 
Seat 2: dhduncan (8272 in chips) 
Seat 3: Duke Croix (9300 in chips) 
Seat 8: color_singleton (10294 in chips) 
Seat 9: JeBoyDirk (8583 in chips) 
JeBoyDirk: posts small blind 50
MnnM150: posts big blind 100
*** HOLE CARDS ***
Dealt to Duke Croix [Ks 5c]
dhduncan: folds 
Duke Croix: folds 
color_singleton: folds 
JeBoyDirk: folds 
Uncalled bet (50) returned to MnnM150
MnnM150 collected 100 from pot
*** SUMMARY ***
Total pot 100 | Rake 0 
Seat 1: MnnM150 (big blind) collected (100)
Seat 2: dhduncan folded before Flop (didn't bet)
Seat 3: Duke Croix folded before Flop (didn't bet)
Seat 8: color_singleton (button) folded before Flop (didn't bet)
Seat 9: JeBoyDirk (small blind) folded before Flop



PokerStars Home Game Hand #218757952064: {Club #3225207}  Hold'em No Limit (50/100) - 2020/09/24 14:49:41 ET
Table 'money money' 9-max (Play Money) Seat #9 is the button
Seat 1: MnnM150 (12919 in chips) 
Seat 2: dhduncan (8272 in chips) 
Seat 3: Duke Croix (9300 in chips) 
Seat 8: color_singleton (10294 in chips) 
Seat 9: JeBoyDirk (8533 in chips) 
MnnM150: posts small blind 50
dhduncan: posts big blind 100
*** HOLE CARDS ***
Dealt to Duke Croix [Qs 2c]
Duke Croix: folds 
color_singleton: folds 
Klemtonius joins the table at seat #5 
JeBoyDirk: folds 
MnnM150: raises 100 to 200
dhduncan: folds 
Uncalled bet (100) returned to MnnM150
MnnM150 collected 200 from pot
*** SUMMARY ***
Total pot 200 | Rake 0 
Seat 1: MnnM150 (small blind) collected (200)
Seat 2: dhduncan (big blind) folded before Flop
Seat 3: Duke Croix folded before Flop (didn't bet)
Seat 8: color_singleton folded before Flop (didn't bet)
Seat 9: JeBoyDirk (button) folded before Flop (didn't bet)



PokerStars Home Game Hand #218757966286: {Club #3225207}  Hold'em No Limit (50/100) - 2020/09/24 14:50:07 ET
Table 'money money' 9-max (Play Money) Seat #1 is the button
Seat 1: MnnM150 (13019 in chips) 
Seat 2: dhduncan (8172 in chips) 
Seat 3: Duke Croix (9300 in chips) 
Seat 5: Klemtonius (10000 in chips) 
Seat 8: color_singleton (10294 in chips) 
Seat 9: JeBoyDirk (8533 in chips) 
dhduncan: posts small blind 50
Duke Croix: posts big blind 100
Klemtonius: posts big blind 100
*** HOLE CARDS ***
Dealt to Duke Croix [6h 5h]
Klemtonius: raises 700 to 800
color_singleton: folds 
JeBoyDirk: calls 800
MnnM150: calls 800
dhduncan: folds 
Duke Croix: folds 
*** FLOP *** [8d Tc 8h]
Klemtonius: bets 1000
JeBoyDirk: raises 2000 to 3000
MnnM150: folds 
Klemtonius: calls 2000
*** TURN *** [8d Tc 8h] [2d]
Klemtonius: checks 
JeBoyDirk: bets 4733 and is all-in
Klemtonius: calls 4733
*** RIVER *** [8d Tc 8h 2d] [7c]
*** SHOW DOWN ***
Klemtonius: shows [Qh Jd] (a pair of Eights)
JeBoyDirk: shows [Qc Qd] (two pair, Queens and Eights)
JeBoyDirk collected 17025 from pot
*** SUMMARY ***
Total pot 18016 | Rake 991 
Board [8d Tc 8h 2d 7c]
Seat 1: MnnM150 (button) folded on the Flop
Seat 2: dhduncan (small blind) folded before Flop
Seat 3: Duke Croix (big blind) folded before Flop
Seat 5: Klemtonius showed [Qh Jd] and lost with a pair of Eights
Seat 8: color_singleton folded before Flop (didn't bet)
Seat 9: JeBoyDirk showed [Qc Qd] and won (17025) with two pair, Queens and Eights



PokerStars Home Game Hand #218757989733: {Club #3225207}  Hold'em No Limit (50/100) - 2020/09/24 14:50:49 ET
Table 'money money' 9-max (Play Money) Seat #3 is the button
Seat 1: MnnM150 (12219 in chips) 
Seat 3: Duke Croix (9200 in chips) 
Seat 5: Klemtonius (1467 in chips) 
Seat 8: color_singleton (10294 in chips) 
Seat 9: JeBoyDirk (17025 in chips) 
Klemtonius: posts small blind 50
color_singleton: posts big blind 100
*** HOLE CARDS ***
Dealt to Duke Croix [Qh 6s]
JeBoyDirk: folds 
MnnM150: calls 100
Duke Croix: folds 
Klemtonius: raises 1367 to 1467 and is all-in
color_singleton: folds 
MnnM150: calls 1367
*** FLOP *** [3s Qs 7d]
*** TURN *** [3s Qs 7d] [4c]
*** RIVER *** [3s Qs 7d 4c] [2s]
*** SHOW DOWN ***
Klemtonius: shows [Kd 8d] (high card King)
MnnM150: shows [Ac Kc] (high card Ace)
MnnM150 collected 2867 from pot
*** SUMMARY ***
Total pot 3034 | Rake 167 
Board [3s Qs 7d 4c 2s]
Seat 1: MnnM150 showed [Ac Kc] and won (2867) with high card Ace
Seat 3: Duke Croix (button) folded before Flop (didn't bet)
Seat 5: Klemtonius (small blind) showed [Kd 8d] and lost with high card King
Seat 8: color_singleton (big blind) folded before Flop
Seat 9: JeBoyDirk folded before Flop (didn't bet)



PokerStars Home Game Hand #218758010103: {Club #3225207}  Hold'em No Limit (50/100) - 2020/09/24 14:51:26 ET
Table 'money money' 9-max (Play Money) Seat #8 is the button
Seat 1: MnnM150 (13619 in chips) 
Seat 3: Duke Croix (9200 in chips) 
Seat 8: color_singleton (10194 in chips) 
Seat 9: JeBoyDirk (17025 in chips) 
JeBoyDirk: posts small blind 50
MnnM150: posts big blind 100
*** HOLE CARDS ***
Dealt to Duke Croix [5c Ah]
Duke Croix: calls 100
color_singleton: folds 
JeBoyDirk: raises 200 to 300
MnnM150: folds 
Duke Croix: calls 200
*** FLOP *** [4h Qd 4d]
JeBoyDirk: bets 500
Duke Croix: folds 
Uncalled bet (500) returned to JeBoyDirk
JeBoyDirk collected 661 from pot
*** SUMMARY ***
Total pot 700 | Rake 39 
Board [4h Qd 4d]
Seat 1: MnnM150 (big blind) folded before Flop
Seat 3: Duke Croix folded on the Flop
Seat 8: color_singleton (button) folded before Flop (didn't bet)
Seat 9: JeBoyDirk (small blind) collected (661)



PokerStars Home Game Hand #218758027457: {Club #3225207}  Hold'em No Limit (50/100) - 2020/09/24 14:51:58 ET
Table 'money money' 9-max (Play Money) Seat #9 is the button
Seat 1: MnnM150 (13519 in chips) 
Seat 3: Duke Croix (8900 in chips) 
Seat 5: Klemtonius (10000 in chips) 
Seat 8: color_singleton (10194 in chips) 
Seat 9: JeBoyDirk (17386 in chips) 
MnnM150: posts small blind 50
Duke Croix: posts big blind 100
*** HOLE CARDS ***
Dealt to Duke Croix [2s 3s]
Klemtonius: calls 100
color_singleton: folds 
JeBoyDirk: raises 100 to 200
MnnM150: folds 
Duke Croix: calls 100
Klemtonius: calls 100
*** FLOP *** [Jh 7c Ad]
Duke Croix: checks 
Klemtonius: checks 
JeBoyDirk: bets 400
Duke Croix: folds 
Klemtonius: calls 400
*** TURN *** [Jh 7c Ad] [7s]
Klemtonius: checks 
JeBoyDirk: bets 600
Klemtonius: folds 
Uncalled bet (600) returned to JeBoyDirk
JeBoyDirk collected 1370 from pot
*** SUMMARY ***
Total pot 1450 | Rake 80 
Board [Jh 7c Ad 7s]
Seat 1: MnnM150 (small blind) folded before Flop
Seat 3: Duke Croix (big blind) folded on the Flop
Seat 5: Klemtonius folded on the Turn
Seat 8: color_singleton folded before Flop (didn't bet)
Seat 9: JeBoyDirk (button) collected (1370)



PokerStars Home Game Hand #218758050865: {Club #3225207}  Hold'em No Limit (50/100) - 2020/09/24 14:52:40 ET
Table 'money money' 9-max (Play Money) Seat #1 is the button
Seat 1: MnnM150 (13469 in chips) 
Seat 3: Duke Croix (8700 in chips) 
Seat 5: Klemtonius (9400 in chips) 
Seat 8: color_singleton (10194 in chips) 
Seat 9: JeBoyDirk (18156 in chips) 
Duke Croix: posts small blind 50
Klemtonius: posts big blind 100
*** HOLE CARDS ***
Dealt to Duke Croix [7c Ad]
color_singleton: raises 200 to 300
JeBoyDirk: folds 
MnnM150: folds 
Duke Croix: folds 
Klemtonius: folds 
Uncalled bet (200) returned to color_singleton
color_singleton collected 250 from pot
color_singleton: doesn't show hand 
*** SUMMARY ***
Total pot 250 | Rake 0 
Seat 1: MnnM150 (button) folded before Flop (didn't bet)
Seat 3: Duke Croix (small blind) folded before Flop
Seat 5: Klemtonius (big blind) folded before Flop
Seat 8: color_singleton collected (250)
Seat 9: JeBoyDirk folded before Flop (didn't bet)



PokerStars Home Game Hand #218758062681: {Club #3225207}  Hold'em No Limit (50/100) - 2020/09/24 14:53:01 ET
Table 'money money' 9-max (Play Money) Seat #3 is the button
Seat 1: MnnM150 (13469 in chips) 
Seat 2: dhduncan (8122 in chips) 
Seat 3: Duke Croix (8650 in chips) 
Seat 5: Klemtonius (9300 in chips) 
Seat 8: color_singleton (10344 in chips) 
Seat 9: JeBoyDirk (18156 in chips) 
Klemtonius: posts small blind 50
color_singleton: posts big blind 100
dhduncan: posts small & big blinds 150
*** HOLE CARDS ***
Dealt to Duke Croix [6s 2d]
JeBoyDirk: folds 
MnnM150: calls 100
dhduncan: checks 
Duke Croix: folds 
Klemtonius: calls 50
color_singleton: checks 
*** FLOP *** [Ac 8s 9c]
Klemtonius: checks 
color_singleton: checks 
MnnM150: checks 
dhduncan: checks 
*** TURN *** [Ac 8s 9c] [3c]
Klemtonius: checks 
color_singleton: checks 
MnnM150: bets 212
dhduncan: calls 212
Klemtonius: calls 212
color_singleton: folds 
*** RIVER *** [Ac 8s 9c 3c] [7c]
Klemtonius: checks 
MnnM150: bets 1026
dhduncan: folds 
Klemtonius: folds 
Uncalled bet (1026) returned to MnnM150
MnnM150 collected 1026 from pot
*** SUMMARY ***
Total pot 1086 | Rake 60 
Board [Ac 8s 9c 3c 7c]
Seat 1: MnnM150 collected (1026)
Seat 2: dhduncan folded on the River
Seat 3: Duke Croix (button) folded before Flop (didn't bet)
Seat 5: Klemtonius (small blind) folded on the River
Seat 8: color_singleton (big blind) folded on the Turn
Seat 9: JeBoyDirk folded before Flop (didn't bet)



PokerStars Home Game Hand #218758106564: {Club #3225207}  Hold'em No Limit (50/100) - 2020/09/24 14:54:17 ET
Table 'money money' 9-max (Play Money) Seat #5 is the button
Seat 1: MnnM150 (14183 in chips) 
Seat 2: dhduncan (7760 in chips) 
Seat 3: Duke Croix (8650 in chips) 
Seat 5: Klemtonius (8988 in chips) 
Seat 8: color_singleton (10244 in chips) 
Seat 9: JeBoyDirk (18156 in chips) 
color_singleton: posts small blind 50
JeBoyDirk: posts big blind 100
*** HOLE CARDS ***
Dealt to Duke Croix [2d 6c]
MnnM150: calls 100
dhduncan: calls 100
Duke Croix: folds 
Klemtonius: calls 100
color_singleton: raises 200 to 300
JeBoyDirk: calls 200
MnnM150: calls 200
dhduncan: calls 200
Klemtonius: calls 200
*** FLOP *** [4s Qc 4d]
color_singleton: bets 800
JeBoyDirk: folds 
MnnM150: folds 
dhduncan: calls 800
Klemtonius: folds 
*** TURN *** [4s Qc 4d] [7c]
color_singleton: bets 1500
dhduncan: folds 
Uncalled bet (1500) returned to color_singleton
color_singleton collected 2929 from pot
color_singleton: doesn't show hand 
*** SUMMARY ***
Total pot 3100 | Rake 171 
Board [4s Qc 4d 7c]
Seat 1: MnnM150 folded on the Flop
Seat 2: dhduncan folded on the Turn
Seat 3: Duke Croix folded before Flop (didn't bet)
Seat 5: Klemtonius (button) folded on the Flop
Seat 8: color_singleton (small blind) collected (2929)
Seat 9: JeBoyDirk (big blind) folded on the Flop



PokerStars Home Game Hand #218758138264: {Club #3225207}  Hold'em No Limit (50/100) - 2020/09/24 14:55:19 ET
Table 'money money' 9-max (Play Money) Seat #8 is the button
Seat 1: MnnM150 (13883 in chips) 
Seat 2: dhduncan (6660 in chips) 
Seat 3: Duke Croix (8650 in chips) 
Seat 5: Klemtonius (8688 in chips) 
Seat 8: color_singleton (12073 in chips) 
Seat 9: JeBoyDirk (17856 in chips) 
JeBoyDirk: posts small blind 50
MnnM150: posts big blind 100
*** HOLE CARDS ***
Dealt to Duke Croix [6c Td]
dhduncan: calls 100
Duke Croix: folds 
Klemtonius: calls 100
color_singleton: raises 100 to 200
JeBoyDirk: raises 200 to 400
MnnM150: folds 
dhduncan: calls 300
Klemtonius: calls 300
color_singleton: calls 200
*** FLOP *** [5d 9d 5h]
JeBoyDirk: bets 500
dhduncan: folds 
Klemtonius: calls 500
color_singleton: folds 
*** TURN *** [5d 9d 5h] [Th]
JeBoyDirk: bets 2300
Klemtonius: folds 
Uncalled bet (2300) returned to JeBoyDirk
JeBoyDirk collected 2551 from pot
*** SUMMARY ***
Total pot 2700 | Rake 149 
Board [5d 9d 5h Th]
Seat 1: MnnM150 (big blind) folded before Flop
Seat 2: dhduncan folded on the Flop
Seat 3: Duke Croix folded before Flop (didn't bet)
Seat 5: Klemtonius folded on the Turn
Seat 8: color_singleton (button) folded on the Flop
Seat 9: JeBoyDirk (small blind) collected (2551)



PokerStars Home Game Hand #218758161495: {Club #3225207}  Hold'em No Limit (50/100) - 2020/09/24 14:56:13 ET
Table 'money money' 9-max (Play Money) Seat #9 is the button
Seat 1: MnnM150 (13783 in chips) 
Seat 3: Duke Croix (8650 in chips) 
Seat 5: Klemtonius (7788 in chips) 
Seat 8: color_singleton (11673 in chips) 
Seat 9: JeBoyDirk (19507 in chips) 
MnnM150: posts small blind 50
Duke Croix: posts big blind 100
*** HOLE CARDS ***
Dealt to Duke Croix [3h 3d]
Klemtonius: calls 100
color_singleton: raises 200 to 300
JeBoyDirk: calls 300
MnnM150: folds 
Duke Croix: calls 200
Klemtonius: calls 200
*** FLOP *** [5h 2c 8c]
Duke Croix: checks 
Klemtonius: checks 
color_singleton: bets 590
JeBoyDirk: folds 
Duke Croix: folds 
Klemtonius: folds 
Uncalled bet (590) returned to color_singleton
color_singleton collected 1181 from pot
color_singleton: doesn't show hand 
*** SUMMARY ***
Total pot 1250 | Rake 69 
Board [5h 2c 8c]
Seat 1: MnnM150 (small blind) folded before Flop
Seat 3: Duke Croix (big blind) folded on the Flop
Seat 5: Klemtonius folded on the Flop
Seat 8: color_singleton collected (1181)
Seat 9: JeBoyDirk (button) folded on the Flop



PokerStars Home Game Hand #218758182409: {Club #3225207}  Hold'em No Limit (50/100) - 2020/09/24 14:57:02 ET
Table 'money money' 9-max (Play Money) Seat #1 is the button
Seat 1: MnnM150 (13733 in chips) 
Seat 3: Duke Croix (8350 in chips) 
Seat 5: Klemtonius (7488 in chips) 
Seat 8: color_singleton (12554 in chips) 
Seat 9: JeBoyDirk (19207 in chips) 
Duke Croix: posts small blind 50
Klemtonius: posts big blind 100
*** HOLE CARDS ***
Dealt to Duke Croix [2c 9c]
color_singleton: folds 
JeBoyDirk: folds 
MnnM150: calls 100
Duke Croix: calls 50
Klemtonius: checks 
*** FLOP *** [7c 8h 2s]
Duke Croix: checks 
Klemtonius: checks 
MnnM150: checks 
*** TURN *** [7c 8h 2s] [6d]
Duke Croix: checks 
Klemtonius: checks 
MnnM150: checks 
*** RIVER *** [7c 8h 2s 6d] [3s]
Duke Croix: checks 
Klemtonius: bets 100
MnnM150: raises 483 to 583
Duke Croix: folds 
Klemtonius: folds 
Uncalled bet (483) returned to MnnM150
MnnM150 collected 472 from pot
*** SUMMARY ***
Total pot 500 | Rake 28 
Board [7c 8h 2s 6d 3s]
Seat 1: MnnM150 (button) collected (472)
Seat 3: Duke Croix (small blind) folded on the River
Seat 5: Klemtonius (big blind) folded on the River
Seat 8: color_singleton folded before Flop (didn't bet)
Seat 9: JeBoyDirk folded before Flop (didn't bet)



PokerStars Home Game Hand #218758201465: {Club #3225207}  Hold'em No Limit (50/100) - 2020/09/24 14:57:46 ET
Table 'money money' 9-max (Play Money) Seat #3 is the button
Seat 1: MnnM150 (14005 in chips) 
Seat 2: dhduncan (6260 in chips) 
Seat 3: Duke Croix (8250 in chips) 
Seat 5: Klemtonius (7288 in chips) 
Seat 8: color_singleton (12554 in chips) 
Seat 9: JeBoyDirk (19207 in chips) 
Klemtonius: posts small blind 50
color_singleton: posts big blind 100
dhduncan: posts small & big blinds 150
*** HOLE CARDS ***
Dealt to Duke Croix [5s 9s]
JeBoyDirk: folds 
MnnM150: folds 
dhduncan: checks 
Duke Croix: folds 
Klemtonius: calls 50
color_singleton: checks 
*** FLOP *** [3c 6c Td]
Klemtonius: checks 
color_singleton: checks 
dhduncan: checks 
*** TURN *** [3c 6c Td] [Ac]
Klemtonius: checks 
color_singleton: bets 165
dhduncan: folds 
Klemtonius: folds 
Uncalled bet (165) returned to color_singleton
color_singleton collected 331 from pot
color_singleton: doesn't show hand 
*** SUMMARY ***
Total pot 350 | Rake 19 
Board [3c 6c Td Ac]
Seat 1: MnnM150 folded before Flop (didn't bet)
Seat 2: dhduncan folded on the Turn (didn't bet)
Seat 3: Duke Croix (button) folded before Flop (didn't bet)
Seat 5: Klemtonius (small blind) folded on the Turn
Seat 8: color_singleton (big blind) collected (331)
Seat 9: JeBoyDirk folded before Flop (didn't bet)



PokerStars Home Game Hand #218758214273: {Club #3225207}  Hold'em No Limit (50/100) - 2020/09/24 14:58:15 ET
Table 'money money' 9-max (Play Money) Seat #5 is the button
Seat 1: MnnM150 (14005 in chips) 
Seat 2: dhduncan (6110 in chips) 
Seat 3: Duke Croix (8250 in chips) 
Seat 5: Klemtonius (7188 in chips) 
Seat 8: color_singleton (12785 in chips) 
Seat 9: JeBoyDirk (19207 in chips) 
color_singleton: posts small blind 50
JeBoyDirk: posts big blind 100
*** HOLE CARDS ***
Dealt to Duke Croix [Td 2c]
MnnM150: folds 
dhduncan: calls 100
Duke Croix: folds 
Klemtonius: raises 300 to 400
color_singleton: folds 
JeBoyDirk: folds 
dhduncan: calls 300
*** FLOP *** [7d 8c 9h]
dhduncan: checks 
Klemtonius: checks 
*** TURN *** [7d 8c 9h] [7s]
dhduncan: checks 
Klemtonius: bets 300
dhduncan: calls 300
*** RIVER *** [7d 8c 9h 7s] [2h]
dhduncan: checks 
Klemtonius: checks 
*** SHOW DOWN ***
dhduncan: shows [Kd 7c] (three of a kind, Sevens)
Klemtonius: mucks hand 
dhduncan collected 1465 from pot
*** SUMMARY ***
Total pot 1550 | Rake 85 
Board [7d 8c 9h 7s 2h]
Seat 1: MnnM150 folded before Flop (didn't bet)
Seat 2: dhduncan showed [Kd 7c] and won (1465) with three of a kind, Sevens
Seat 3: Duke Croix folded before Flop (didn't bet)
Seat 5: Klemtonius (button) mucked [Qh Kh]
Seat 8: color_singleton (small blind) folded before Flop
Seat 9: JeBoyDirk (big blind) folded before Flop



PokerStars Home Game Hand #218758228574: {Club #3225207}  Hold'em No Limit (50/100) - 2020/09/24 14:58:49 ET
Table 'money money' 9-max (Play Money) Seat #8 is the button
Seat 1: MnnM150 (14005 in chips) 
Seat 2: dhduncan (6875 in chips) 
Seat 3: Duke Croix (8250 in chips) 
Seat 5: Klemtonius (6488 in chips) 
Seat 8: color_singleton (12735 in chips) 
Seat 9: JeBoyDirk (19107 in chips) 
JeBoyDirk: posts small blind 50
MnnM150: posts big blind 100
*** HOLE CARDS ***
Dealt to Duke Croix [7s 2d]
dhduncan: calls 100
Duke Croix: folds 
Klemtonius: calls 100
color_singleton: calls 100
JeBoyDirk: folds 
MnnM150: checks 
*** FLOP *** [6d Kd 2c]
MnnM150: checks 
dhduncan: checks 
Klemtonius: checks 
color_singleton: checks 
*** TURN *** [6d Kd 2c] [Qs]
MnnM150: checks 
dhduncan: checks 
Klemtonius: bets 300
color_singleton: folds 
MnnM150: folds 
dhduncan: folds 
Uncalled bet (300) returned to Klemtonius
Klemtonius collected 425 from pot
Klemtonius: doesn't show hand 
*** SUMMARY ***
Total pot 450 | Rake 25 
Board [6d Kd 2c Qs]
Seat 1: MnnM150 (big blind) folded on the Turn
Seat 2: dhduncan folded on the Turn
Seat 3: Duke Croix folded before Flop (didn't bet)
Seat 5: Klemtonius collected (425)
Seat 8: color_singleton (button) folded on the Turn
Seat 9: JeBoyDirk (small blind) folded before Flop



PokerStars Home Game Hand #218758248305: {Club #3225207}  Hold'em No Limit (50/100) - 2020/09/24 14:59:34 ET
Table 'money money' 9-max (Play Money) Seat #9 is the button
Seat 1: MnnM150 (13905 in chips) 
Seat 2: dhduncan (6775 in chips) 
Seat 3: Duke Croix (8250 in chips) 
Seat 5: Klemtonius (6813 in chips) 
Seat 8: color_singleton (12635 in chips) 
Seat 9: JeBoyDirk (19057 in chips) 
MnnM150: posts small blind 50
dhduncan: posts big blind 100
*** HOLE CARDS ***
Dealt to Duke Croix [9s 5d]
Duke Croix: folds 
Klemtonius: raises 100 to 200
color_singleton: calls 200
JeBoyDirk: calls 200
Duke Croix said, "mobile phone battery died"
MnnM150: calls 150
dhduncan: calls 100
*** FLOP *** [2s Kc 7h]
MnnM150: checks 
dhduncan: checks 
Klemtonius: bets 500
color_singleton: folds 
JeBoyDirk: folds 
MnnM150: folds 
dhduncan: folds 
Uncalled bet (500) returned to Klemtonius
Klemtonius collected 945 from pot
Klemtonius: doesn't show hand 
*** SUMMARY ***
Total pot 1000 | Rake 55 
Board [2s Kc 7h]
Seat 1: MnnM150 (small blind) folded on the Flop
Seat 2: dhduncan (big blind) folded on the Flop
Seat 3: Duke Croix folded before Flop (didn't bet)
Seat 5: Klemtonius collected (945)
Seat 8: color_singleton folded on the Flop
Seat 9: JeBoyDirk (button) folded on the Flop



PokerStars Home Game Hand #218758278676: {Club #3225207}  Hold'em No Limit (50/100) - 2020/09/24 15:00:40 ET
Table 'money money' 9-max (Play Money) Seat #1 is the button
Seat 1: MnnM150 (13705 in chips) 
Seat 2: dhduncan (6575 in chips) 
Seat 3: Duke Croix (8250 in chips) 
Seat 5: Klemtonius (7558 in chips) 
Seat 8: color_singleton (12435 in chips) 
Seat 9: JeBoyDirk (18857 in chips) 
dhduncan: posts small blind 50
Duke Croix: posts big blind 100
*** HOLE CARDS ***
Dealt to Duke Croix [Ad 9s]
Klemtonius: calls 100
color_singleton: raises 100 to 200
JeBoyDirk: calls 200
MnnM150: calls 200
dhduncan: folds 
Duke Croix: calls 100
Klemtonius: calls 100
*** FLOP *** [Tc 3h 5s]
Duke Croix: checks 
Klemtonius: checks 
color_singleton: checks 
JeBoyDirk: checks 
MnnM150: bets 496
Duke Croix: folds 
Klemtonius: folds 
color_singleton: folds 
JeBoyDirk: folds 
Uncalled bet (496) returned to MnnM150
MnnM150 collected 992 from pot
*** SUMMARY ***
Total pot 1050 | Rake 58 
Board [Tc 3h 5s]
Seat 1: MnnM150 (button) collected (992)
Seat 2: dhduncan (small blind) folded before Flop
Seat 3: Duke Croix (big blind) folded on the Flop
Seat 5: Klemtonius folded on the Flop
Seat 8: color_singleton folded on the Flop
Seat 9: JeBoyDirk folded on the Flop



PokerStars Home Game Hand #218758304982: {Club #3225207}  Hold'em No Limit (50/100) - 2020/09/24 15:01:31 ET
Table 'money money' 9-max (Play Money) Seat #2 is the button
Seat 1: MnnM150 (14497 in chips) 
Seat 2: dhduncan (6525 in chips) 
Seat 3: Duke Croix (8050 in chips) 
Seat 5: Klemtonius (7358 in chips) 
Seat 8: color_singleton (12235 in chips) 
Seat 9: JeBoyDirk (18657 in chips) 
Duke Croix: posts small blind 50
Klemtonius: posts big blind 100
*** HOLE CARDS ***
Dealt to Duke Croix [6d Jc]
color_singleton: folds 
JeBoyDirk: folds 
MnnM150: folds 
dhduncan: calls 100
Duke Croix: calls 50
Klemtonius: checks 
*** FLOP *** [Kd Qd As]
Duke Croix: checks 
Klemtonius: bets 100
dhduncan: raises 100 to 200
Duke Croix: folds 
Klemtonius: calls 100
*** TURN *** [Kd Qd As] [9c]
Klemtonius: checks 
dhduncan: checks 
*** RIVER *** [Kd Qd As 9c] [Kh]
Klemtonius: checks 
dhduncan: bets 661
Klemtonius: calls 661
*** SHOW DOWN ***
dhduncan: shows [2c Ks] (three of a kind, Kings)
Klemtonius: mucks hand 
dhduncan collected 1911 from pot
*** SUMMARY ***
Total pot 2022 | Rake 111 
Board [Kd Qd As 9c Kh]
Seat 1: MnnM150 folded before Flop (didn't bet)
Seat 2: dhduncan (button) showed [2c Ks] and won (1911) with three of a kind, Kings
Seat 3: Duke Croix (small blind) folded on the Flop
Seat 5: Klemtonius (big blind) mucked [6s Ac]
Seat 8: color_singleton folded before Flop (didn't bet)
Seat 9: JeBoyDirk folded before Flop (didn't bet)



PokerStars Home Game Hand #218758337000: {Club #3225207}  Hold'em No Limit (50/100) - 2020/09/24 15:02:30 ET
Table 'money money' 9-max (Play Money) Seat #3 is the button
Seat 2: dhduncan (7475 in chips) 
Seat 3: Duke Croix (7950 in chips) 
Seat 5: Klemtonius (6397 in chips) 
Seat 8: color_singleton (12235 in chips) 
Seat 9: JeBoyDirk (18657 in chips) 
Klemtonius: posts small blind 50
color_singleton: posts big blind 100
*** HOLE CARDS ***
Dealt to Duke Croix [2c Tc]
JeBoyDirk: folds 
dhduncan: calls 100
Duke Croix: folds 
Klemtonius: calls 50
color_singleton: checks 
*** FLOP *** [3h 2d 3c]
Klemtonius: checks 
color_singleton: checks 
dhduncan: checks 
*** TURN *** [3h 2d 3c] [9h]
Klemtonius: checks 
color_singleton: checks 
dhduncan: checks 
*** RIVER *** [3h 2d 3c 9h] [7h]
Klemtonius: checks 
color_singleton: checks 
dhduncan: checks 
*** SHOW DOWN ***
Klemtonius: shows [Qd 8h] (a pair of Threes)
color_singleton: mucks hand 
dhduncan: shows [Kc 5s] (a pair of Threes - King kicker)
dhduncan collected 283 from pot
*** SUMMARY ***
Total pot 300 | Rake 17 
Board [3h 2d 3c 9h 7h]
Seat 2: dhduncan showed [Kc 5s] and won (283) with a pair of Threes
Seat 3: Duke Croix (button) folded before Flop (didn't bet)
Seat 5: Klemtonius (small blind) showed [Qd 8h] and lost with a pair of Threes
Seat 8: color_singleton (big blind) mucked [5c 6s]
Seat 9: JeBoyDirk folded before Flop (didn't bet)



PokerStars Home Game Hand #218758354587: {Club #3225207}  Hold'em No Limit (50/100) - 2020/09/24 15:03:01 ET
Table 'money money' 9-max (Play Money) Seat #5 is the button
Seat 2: dhduncan (7658 in chips) 
Seat 3: Duke Croix (7950 in chips) 
Seat 5: Klemtonius (6297 in chips) 
Seat 8: color_singleton (12135 in chips) 
Seat 9: JeBoyDirk (18657 in chips) 
color_singleton: posts small blind 50
JeBoyDirk: posts big blind 100
*** HOLE CARDS ***
Dealt to Duke Croix [3s 5d]
dhduncan: folds 
Duke Croix: folds 
Klemtonius: folds 
color_singleton: folds 
Uncalled bet (50) returned to JeBoyDirk
JeBoyDirk collected 100 from pot
*** SUMMARY ***
Total pot 100 | Rake 0 
Seat 2: dhduncan folded before Flop (didn't bet)
Seat 3: Duke Croix folded before Flop (didn't bet)
Seat 5: Klemtonius (button) folded before Flop (didn't bet)
Seat 8: color_singleton (small blind) folded before Flop
Seat 9: JeBoyDirk (big blind) collected (100)



PokerStars Home Game Hand #218758362917: {Club #3225207}  Hold'em No Limit (50/100) - 2020/09/24 15:03:16 ET
Table 'money money' 9-max (Play Money) Seat #8 is the button
Seat 2: dhduncan (7658 in chips) 
Seat 3: Duke Croix (7950 in chips) 
Seat 5: Klemtonius (6297 in chips) 
Seat 8: color_singleton (12085 in chips) 
Seat 9: JeBoyDirk (18707 in chips) 
JeBoyDirk: posts small blind 50
dhduncan: posts big blind 100
*** HOLE CARDS ***
Dealt to Duke Croix [7c 3s]
Duke Croix: folds 
Klemtonius: raises 332 to 432
color_singleton: calls 432
JeBoyDirk: calls 382
dhduncan: folds 
*** FLOP *** [5s 4h Js]
JeBoyDirk: checks 
Klemtonius: bets 100
color_singleton: calls 100
JeBoyDirk: calls 100
*** TURN *** [5s 4h Js] [Ac]
JeBoyDirk: checks 
Klemtonius: bets 100
color_singleton: calls 100
JeBoyDirk: calls 100
*** RIVER *** [5s 4h Js Ac] [Qc]
JeBoyDirk: checks 
Klemtonius: checks 
color_singleton: checks 
*** SHOW DOWN ***
JeBoyDirk: shows [Jc Qh] (two pair, Queens and Jacks)
Klemtonius: mucks hand 
color_singleton: mucks hand 
JeBoyDirk collected 1886 from pot
*** SUMMARY ***
Total pot 1996 | Rake 110 
Board [5s 4h Js Ac Qc]
Seat 2: dhduncan (big blind) folded before Flop
Seat 3: Duke Croix folded before Flop (didn't bet)
Seat 5: Klemtonius mucked [Kc Ks]
Seat 8: color_singleton (button) mucked [8h Ad]
Seat 9: JeBoyDirk (small blind) showed [Jc Qh] and won (1886) with two pair, Queens and Jacks



PokerStars Home Game Hand #218758386514: {Club #3225207}  Hold'em No Limit (50/100) - 2020/09/24 15:03:58 ET
Table 'money money' 9-max (Play Money) Seat #9 is the button
Seat 2: dhduncan (7558 in chips) 
Seat 3: Duke Croix (7950 in chips) 
Seat 5: Klemtonius (5665 in chips) 
Seat 8: color_singleton (11453 in chips) 
Seat 9: JeBoyDirk (19961 in chips) 
dhduncan: posts small blind 50
Duke Croix: posts big blind 100
*** HOLE CARDS ***
Dealt to Duke Croix [Js Qh]
Klemtonius: raises 100 to 200
color_singleton: folds 
JeBoyDirk: folds 
dhduncan: calls 150
Duke Croix: calls 100
*** FLOP *** [3c 5s As]
dhduncan: checks 
Duke Croix: checks 
Klemtonius: checks 
*** TURN *** [3c 5s As] [9s]
dhduncan: checks 
Duke Croix: bets 300
Klemtonius: folds 
dhduncan: calls 300
*** RIVER *** [3c 5s As 9s] [Ah]
dhduncan: checks 
Duke Croix: bets 600
dhduncan: calls 600
*** SHOW DOWN ***
Duke Croix: shows [Js Qh] (a pair of Aces)
dhduncan: shows [Tc Ac] (three of a kind, Aces)
dhduncan collected 2268 from pot
*** SUMMARY ***
Total pot 2400 | Rake 132 
Board [3c 5s As 9s Ah]
Seat 2: dhduncan (small blind) showed [Tc Ac] and won (2268) with three of a kind, Aces
Seat 3: Duke Croix (big blind) showed [Js Qh] and lost with a pair of Aces
Seat 5: Klemtonius folded on the Turn
Seat 8: color_singleton folded before Flop (didn't bet)
Seat 9: JeBoyDirk (button) folded before Flop (didn't bet)



PokerStars Home Game Hand #218758414732: {Club #3225207}  Hold'em No Limit (50/100) - 2020/09/24 15:04:44 ET
Table 'money money' 9-max (Play Money) Seat #2 is the button
Seat 2: dhduncan (8726 in chips) 
Seat 3: Duke Croix (6850 in chips) 
Seat 5: Klemtonius (5465 in chips) 
Seat 8: color_singleton (11453 in chips) 
Seat 9: JeBoyDirk (19961 in chips) 
Duke Croix: posts small blind 50
Klemtonius: posts big blind 100
*** HOLE CARDS ***
Dealt to Duke Croix [Qs 5d]
color_singleton: folds 
JeBoyDirk: calls 100
dhduncan: calls 100
Duke Croix: calls 50
Klemtonius: raises 100 to 200
JeBoyDirk: calls 100
dhduncan: calls 100
Duke Croix: calls 100
*** FLOP *** [Jh 3h Kc]
Duke Croix: checks 
Klemtonius: bets 756
JeBoyDirk: folds 
dhduncan: folds 
Duke Croix: folds 
Uncalled bet (756) returned to Klemtonius
Klemtonius collected 756 from pot
Klemtonius: doesn't show hand 
*** SUMMARY ***
Total pot 800 | Rake 44 
Board [Jh 3h Kc]
Seat 2: dhduncan (button) folded on the Flop
Seat 3: Duke Croix (small blind) folded on the Flop
Seat 5: Klemtonius (big blind) collected (756)
Seat 8: color_singleton folded before Flop (didn't bet)
Seat 9: JeBoyDirk folded on the Flop



PokerStars Home Game Hand #218758448677: {Club #3225207}  Hold'em No Limit (50/100) - 2020/09/24 15:05:41 ET
Table 'money money' 9-max (Play Money) Seat #3 is the button
Seat 2: dhduncan (8526 in chips) 
Seat 3: Duke Croix (6650 in chips) 
Seat 5: Klemtonius (6021 in chips) 
Seat 8: color_singleton (11453 in chips) 
Seat 9: JeBoyDirk (19761 in chips) 
Klemtonius: posts small blind 50
color_singleton: posts big blind 100
*** HOLE CARDS ***
Dealt to Duke Croix [3h 6c]
JeBoyDirk: folds 
dhduncan: calls 100
Duke Croix: folds 
Klemtonius: calls 50
color_singleton: checks 
*** FLOP *** [3s Qc Kh]
Klemtonius: checks 
color_singleton: bets 141
dhduncan: calls 141
Klemtonius: calls 141
*** TURN *** [3s Qc Kh] [3d]
Klemtonius: checks 
color_singleton: bets 100
dhduncan: calls 100
Klemtonius: calls 100
*** RIVER *** [3s Qc Kh 3d] [2h]
Klemtonius: checks 
color_singleton: checks 
dhduncan: bets 400
Klemtonius: folds 
color_singleton: calls 400
*** SHOW DOWN ***
dhduncan: shows [4h Ks] (two pair, Kings and Threes)
color_singleton: mucks hand 
dhduncan collected 1723 from pot
*** SUMMARY ***
Total pot 1823 | Rake 100 
Board [3s Qc Kh 3d 2h]
Seat 2: dhduncan showed [4h Ks] and won (1723) with two pair, Kings and Threes
Seat 3: Duke Croix (button) folded before Flop (didn't bet)
Seat 5: Klemtonius (small blind) folded on the River
Seat 8: color_singleton (big blind) mucked [7s Qh]
Seat 9: JeBoyDirk folded before Flop (didn't bet)



PokerStars Home Game Hand #218758488091: {Club #3225207}  Hold'em No Limit (50/100) - 2020/09/24 15:06:46 ET
Table 'money money' 9-max (Play Money) Seat #5 is the button
Seat 1: MnnM150 (14497 in chips) 
Seat 2: dhduncan (9508 in chips) 
Seat 3: Duke Croix (6650 in chips) 
Seat 5: Klemtonius (5680 in chips) 
Seat 8: color_singleton (10712 in chips) 
Seat 9: JeBoyDirk (19761 in chips) 
color_singleton: posts small blind 50
JeBoyDirk: posts big blind 100
MnnM150: posts small & big blinds 150
*** HOLE CARDS ***
Dealt to Duke Croix [8s 2h]
MnnM150: checks 
dhduncan: calls 100
Duke Croix: folds 
Klemtonius: calls 100
color_singleton: raises 100 to 200
JeBoyDirk: calls 100
MnnM150: folds 
dhduncan: calls 100
Klemtonius: calls 100
*** FLOP *** [Ks 8h Tc]
color_singleton: checks 
JeBoyDirk: checks 
dhduncan: checks 
Klemtonius: checks 
*** TURN *** [Ks 8h Tc] [4s]
color_singleton: checks 
JeBoyDirk: checks 
dhduncan: checks 
Klemtonius: checks 
*** RIVER *** [Ks 8h Tc 4s] [8c]
color_singleton: checks 
JeBoyDirk: checks 
dhduncan: checks 
Klemtonius: checks 
*** SHOW DOWN ***
color_singleton: shows [6s Ac] (a pair of Eights)
JeBoyDirk: shows [As 3h] (a pair of Eights)
dhduncan: mucks hand 
Klemtonius: shows [Ad 2d] (a pair of Eights)
color_singleton collected 300 from pot
JeBoyDirk collected 299 from pot
Klemtonius collected 299 from pot
*** SUMMARY ***
Total pot 950 | Rake 52 
Board [Ks 8h Tc 4s 8c]
Seat 1: MnnM150 folded before Flop (didn't bet)
Seat 2: dhduncan mucked [9h Qh]
Seat 3: Duke Croix folded before Flop (didn't bet)
Seat 5: Klemtonius (button) showed [Ad 2d] and won (299) with a pair of Eights
Seat 8: color_singleton (small blind) showed [6s Ac] and won (300) with a pair of Eights
Seat 9: JeBoyDirk (big blind) showed [As 3h] and won (299) with a pair of Eights



PokerStars Home Game Hand #218758523669: {Club #3225207}  Hold'em No Limit (50/100) - 2020/09/24 15:07:45 ET
Table 'money money' 9-max (Play Money) Seat #8 is the button
Seat 1: MnnM150 (14347 in chips) 
Seat 2: dhduncan (9308 in chips) 
Seat 3: Duke Croix (6650 in chips) 
Seat 5: Klemtonius (5779 in chips) 
Seat 8: color_singleton (10812 in chips) 
Seat 9: JeBoyDirk (19860 in chips) 
JeBoyDirk: posts small blind 50
MnnM150: posts big blind 100
*** HOLE CARDS ***
Dealt to Duke Croix [Kd Tc]
dhduncan: folds 
Duke Croix: raises 200 to 300
Klemtonius: calls 300
color_singleton: folds 
JeBoyDirk: folds 
MnnM150: folds 
*** FLOP *** [Kh 9h 2d]
Duke Croix: bets 400
Klemtonius: folds 
Uncalled bet (400) returned to Duke Croix
Duke Croix collected 709 from pot
*** SUMMARY ***
Total pot 750 | Rake 41 
Board [Kh 9h 2d]
Seat 1: MnnM150 (big blind) folded before Flop
Seat 2: dhduncan folded before Flop (didn't bet)
Seat 3: Duke Croix collected (709)
Seat 5: Klemtonius folded on the Flop
Seat 8: color_singleton (button) folded before Flop (didn't bet)
Seat 9: JeBoyDirk (small blind) folded before Flop



PokerStars Home Game Hand #218758538387: {Club #3225207}  Hold'em No Limit (50/100) - 2020/09/24 15:08:10 ET
Table 'money money' 9-max (Play Money) Seat #9 is the button
Seat 1: MnnM150 (14247 in chips) 
Seat 2: dhduncan (9308 in chips) 
Seat 3: Duke Croix (7059 in chips) 
Seat 5: Klemtonius (5479 in chips) 
Seat 8: color_singleton (10812 in chips) 
Seat 9: JeBoyDirk (19810 in chips) 
MnnM150: posts small blind 50
dhduncan: posts big blind 100
*** HOLE CARDS ***
Dealt to Duke Croix [6s 4h]
Duke Croix: folds 
Klemtonius: calls 100
color_singleton: folds 
JeBoyDirk: folds 
MnnM150: raises 100 to 200
dhduncan: calls 100
Klemtonius: calls 100
*** FLOP *** [8h 3h 4c]
MnnM150: checks 
dhduncan: checks 
Klemtonius: checks 
*** TURN *** [8h 3h 4c] [2h]
MnnM150: bets 567
dhduncan: folds 
Klemtonius: calls 567
*** RIVER *** [8h 3h 4c 2h] [8s]
MnnM150: bets 1639
Klemtonius: folds 
Uncalled bet (1639) returned to MnnM150
MnnM150 collected 1639 from pot
*** SUMMARY ***
Total pot 1734 | Rake 95 
Board [8h 3h 4c 2h 8s]
Seat 1: MnnM150 (small blind) collected (1639)
Seat 2: dhduncan (big blind) folded on the Turn
Seat 3: Duke Croix folded before Flop (didn't bet)
Seat 5: Klemtonius folded on the River
Seat 8: color_singleton folded before Flop (didn't bet)
Seat 9: JeBoyDirk (button) folded before Flop (didn't bet)



PokerStars Home Game Hand #218758569661: {Club #3225207}  Hold'em No Limit (50/100) - 2020/09/24 15:09:01 ET
Table 'money money' 9-max (Play Money) Seat #1 is the button
Seat 1: MnnM150 (15119 in chips) 
Seat 2: dhduncan (9108 in chips) 
Seat 3: Duke Croix (7059 in chips) 
Seat 5: Klemtonius (4712 in chips) 
Seat 8: color_singleton (10812 in chips) 
Seat 9: JeBoyDirk (19810 in chips) 
dhduncan: posts small blind 50
Duke Croix: posts big blind 100
*** HOLE CARDS ***
Dealt to Duke Croix [5s 2s]
Klemtonius: calls 100
color_singleton: folds 
JeBoyDirk: folds 
MnnM150: calls 100
dhduncan: calls 50
Duke Croix: checks 
*** FLOP *** [6h 4h Js]
dhduncan: checks 
Duke Croix: checks 
Klemtonius: checks 
MnnM150: checks 
*** TURN *** [6h 4h Js] [2c]
dhduncan: checks 
Duke Croix: checks 
Klemtonius: checks 
MnnM150: checks 
*** RIVER *** [6h 4h Js 2c] [Td]
dhduncan: bets 378
Duke Croix: folds 
Klemtonius: folds 
MnnM150: folds 
Uncalled bet (378) returned to dhduncan
dhduncan collected 378 from pot
dhduncan: doesn't show hand 
*** SUMMARY ***
Total pot 400 | Rake 22 
Board [6h 4h Js 2c Td]
Seat 1: MnnM150 (button) folded on the River
Seat 2: dhduncan (small blind) collected (378)
Seat 3: Duke Croix (big blind) folded on the River
Seat 5: Klemtonius folded on the River
Seat 8: color_singleton folded before Flop (didn't bet)
Seat 9: JeBoyDirk folded before Flop (didn't bet)



PokerStars Home Game Hand #218758596755: {Club #3225207}  Hold'em No Limit (50/100) - 2020/09/24 15:09:46 ET
Table 'money money' 9-max (Play Money) Seat #2 is the button
Seat 1: MnnM150 (15019 in chips) 
Seat 2: dhduncan (9386 in chips) 
Seat 3: Duke Croix (6959 in chips) 
Seat 5: Klemtonius (4612 in chips) 
Seat 8: color_singleton (10812 in chips) 
Seat 9: JeBoyDirk (19810 in chips) 
Duke Croix: posts small blind 50
Klemtonius: posts big blind 100
*** HOLE CARDS ***
Dealt to Duke Croix [Th 5h]
color_singleton: folds 
JeBoyDirk: folds 
MnnM150: folds 
dhduncan: calls 100
Duke Croix: calls 50
Klemtonius: checks 
*** FLOP *** [Ad 8c 7d]
Duke Croix: checks 
Klemtonius: bets 100
dhduncan: folds 
Duke Croix: folds 
Uncalled bet (100) returned to Klemtonius
Klemtonius collected 283 from pot
Klemtonius: doesn't show hand 
*** SUMMARY ***
Total pot 300 | Rake 17 
Board [Ad 8c 7d]
Seat 1: MnnM150 folded before Flop (didn't bet)
Seat 2: dhduncan (button) folded on the Flop
Seat 3: Duke Croix (small blind) folded on the Flop
Seat 5: Klemtonius (big blind) collected (283)
Seat 8: color_singleton folded before Flop (didn't bet)
Seat 9: JeBoyDirk folded before Flop (didn't bet)



PokerStars Home Game Hand #218758613607: {Club #3225207}  Hold'em No Limit (50/100) - 2020/09/24 15:10:14 ET
Table 'money money' 9-max (Play Money) Seat #3 is the button
Seat 1: MnnM150 (15019 in chips) 
Seat 2: dhduncan (9286 in chips) 
Seat 3: Duke Croix (6859 in chips) 
Seat 5: Klemtonius (4795 in chips) 
Seat 8: color_singleton (10812 in chips) 
Seat 9: JeBoyDirk (19810 in chips) 
Klemtonius: posts small blind 50
color_singleton: posts big blind 100
*** HOLE CARDS ***
Dealt to Duke Croix [Qs Th]
JeBoyDirk: calls 100
MnnM150: calls 100
dhduncan: folds 
Duke Croix: raises 300 to 400
Klemtonius: folds 
color_singleton: folds 
JeBoyDirk: calls 300
MnnM150: folds 
*** FLOP *** [6s 5d Qd]
JeBoyDirk: checks 
Duke Croix: bets 500
JeBoyDirk: calls 500
*** TURN *** [6s 5d Qd] [3h]
JeBoyDirk: checks 
Duke Croix: bets 1000
JeBoyDirk: calls 1000
*** RIVER *** [6s 5d Qd 3h] [Ad]
JeBoyDirk: checks 
Duke Croix: checks 
*** SHOW DOWN ***
JeBoyDirk: shows [Kc Qc] (a pair of Queens)
Duke Croix: mucks hand 
JeBoyDirk collected 3827 from pot
*** SUMMARY ***
Total pot 4050 | Rake 223 
Board [6s 5d Qd 3h Ad]
Seat 1: MnnM150 folded before Flop
Seat 2: dhduncan folded before Flop (didn't bet)
Seat 3: Duke Croix (button) mucked [Qs Th]
Seat 5: Klemtonius (small blind) folded before Flop
Seat 8: color_singleton (big blind) folded before Flop
Seat 9: JeBoyDirk showed [Kc Qc] and won (3827) with a pair of Queens



PokerStars Home Game Hand #218758643186: {Club #3225207}  Hold'em No Limit (50/100) - 2020/09/24 15:11:04 ET
Table 'money money' 9-max (Play Money) Seat #5 is the button
Seat 1: MnnM150 (14919 in chips) 
Seat 2: dhduncan (9286 in chips) 
Seat 3: Duke Croix (4959 in chips) 
Seat 5: Klemtonius (4745 in chips) 
Seat 8: color_singleton (10712 in chips) 
Seat 9: JeBoyDirk (21737 in chips) 
color_singleton: posts small blind 50
JeBoyDirk: posts big blind 100
*** HOLE CARDS ***
Dealt to Duke Croix [Qd Jc]
MnnM150: folds 
dhduncan: folds 
Duke Croix: raises 200 to 300
Klemtonius: folds 
color_singleton: calls 250
JeBoyDirk: calls 200
*** FLOP *** [9c 7d 3h]
color_singleton: checks 
JeBoyDirk: checks 
Duke Croix: checks 
*** TURN *** [9c 7d 3h] [2h]
color_singleton: checks 
JeBoyDirk: checks 
Duke Croix: checks 
*** RIVER *** [9c 7d 3h 2h] [6c]
color_singleton: checks 
JeBoyDirk: checks 
Duke Croix: checks 
*** SHOW DOWN ***
color_singleton: shows [Kc 4c] (high card King)
JeBoyDirk: shows [Td Ac] (high card Ace)
Duke Croix: mucks hand 
JeBoyDirk collected 850 from pot
*** SUMMARY ***
Total pot 900 | Rake 50 
Board [9c 7d 3h 2h 6c]
Seat 1: MnnM150 folded before Flop (didn't bet)
Seat 2: dhduncan folded before Flop (didn't bet)
Seat 3: Duke Croix mucked [Qd Jc]
Seat 5: Klemtonius (button) folded before Flop (didn't bet)
Seat 8: color_singleton (small blind) showed [Kc 4c] and lost with high card King
Seat 9: JeBoyDirk (big blind) showed [Td Ac] and won (850) with high card Ace



PokerStars Home Game Hand #218758670892: {Club #3225207}  Hold'em No Limit (50/100) - 2020/09/24 15:11:51 ET
Table 'money money' 9-max (Play Money) Seat #8 is the button
Seat 1: MnnM150 (14919 in chips) 
Seat 2: dhduncan (9286 in chips) 
Seat 3: Duke Croix (4659 in chips) 
Seat 5: Klemtonius (4745 in chips) 
Seat 8: color_singleton (10412 in chips) 
Seat 9: JeBoyDirk (22287 in chips) 
JeBoyDirk: posts small blind 50
MnnM150: posts big blind 100
*** HOLE CARDS ***
Dealt to Duke Croix [Ks As]
dhduncan: calls 100
Duke Croix: raises 300 to 400
Klemtonius: calls 400
color_singleton: calls 400
JeBoyDirk: folds 
MnnM150: calls 300
dhduncan: folds 
*** FLOP *** [Tc 5s Ah]
MnnM150: checks 
Duke Croix: bets 900
Klemtonius: folds 
color_singleton: calls 900
MnnM150: folds 
*** TURN *** [Tc 5s Ah] [Th]
Duke Croix: bets 1400
color_singleton: calls 1400
*** RIVER *** [Tc 5s Ah Th] [Ts]
Duke Croix: bets 1959 and is all-in
color_singleton: calls 1959
*** SHOW DOWN ***
Duke Croix: shows [Ks As] (a full house, Tens full of Aces)
color_singleton: shows [Ac 2c] (a full house, Tens full of Aces)
Duke Croix collected 4852 from pot
color_singleton collected 4851 from pot
*** SUMMARY ***
Total pot 10268 | Rake 565 
Board [Tc 5s Ah Th Ts]
Seat 1: MnnM150 (big blind) folded on the Flop
Seat 2: dhduncan folded before Flop
Seat 3: Duke Croix showed [Ks As] and won (4852) with a full house, Tens full of Aces
Seat 5: Klemtonius folded on the Flop
Seat 8: color_singleton (button) showed [Ac 2c] and won (4851) with a full house, Tens full of Aces
Seat 9: JeBoyDirk (small blind) folded before Flop



PokerStars Home Game Hand #218758703846: {Club #3225207}  Hold'em No Limit (50/100) - 2020/09/24 15:12:47 ET
Table 'money money' 9-max (Play Money) Seat #9 is the button
Seat 1: MnnM150 (14519 in chips) 
Seat 2: dhduncan (9186 in chips) 
Seat 3: Duke Croix (4852 in chips) 
Seat 5: Klemtonius (4345 in chips) 
Seat 8: color_singleton (10604 in chips) 
Seat 9: JeBoyDirk (22237 in chips) 
MnnM150: posts small blind 50
dhduncan: posts big blind 100
*** HOLE CARDS ***
Dealt to Duke Croix [5h 4h]
Duke Croix: raises 200 to 300
Klemtonius: folds 
color_singleton: folds 
JeBoyDirk: folds 
MnnM150: folds 
dhduncan: calls 200
*** FLOP *** [9c Td 2s]
dhduncan: bets 100
Duke Croix: folds 
Uncalled bet (100) returned to dhduncan
dhduncan collected 614 from pot
dhduncan: doesn't show hand 
*** SUMMARY ***
Total pot 650 | Rake 36 
Board [9c Td 2s]
Seat 1: MnnM150 (small blind) folded before Flop
Seat 2: dhduncan (big blind) collected (614)
Seat 3: Duke Croix folded on the Flop
Seat 5: Klemtonius folded before Flop (didn't bet)
Seat 8: color_singleton folded before Flop (didn't bet)
Seat 9: JeBoyDirk (button) folded before Flop (didn't bet)



PokerStars Home Game Hand #218758719386: {Club #3225207}  Hold'em No Limit (50/100) - 2020/09/24 15:13:13 ET
Table 'money money' 9-max (Play Money) Seat #1 is the button
Seat 1: MnnM150 (14469 in chips) 
Seat 2: dhduncan (9500 in chips) 
Seat 3: Duke Croix (4552 in chips) 
Seat 5: Klemtonius (4345 in chips) 
Seat 8: color_singleton (10604 in chips) 
Seat 9: JeBoyDirk (22237 in chips) 
dhduncan: posts small blind 50
Duke Croix: posts big blind 100
*** HOLE CARDS ***
Dealt to Duke Croix [7c 3d]
Klemtonius: raises 100 to 200
color_singleton: raises 100 to 300
JeBoyDirk: folds 
MnnM150: calls 300
dhduncan: calls 250
Duke Croix: folds 
Klemtonius: calls 100
*** FLOP *** [6s Jd 2d]
dhduncan: checks 
Klemtonius: checks 
color_singleton: checks 
MnnM150: checks 
*** TURN *** [6s Jd 2d] [4s]
dhduncan: checks 
Klemtonius: bets 1228
color_singleton: folds 
MnnM150: folds 
dhduncan: folds 
Uncalled bet (1228) returned to Klemtonius
Klemtonius collected 1228 from pot
Klemtonius: doesn't show hand 
*** SUMMARY ***
Total pot 1300 | Rake 72 
Board [6s Jd 2d 4s]
Seat 1: MnnM150 (button) folded on the Turn
Seat 2: dhduncan (small blind) folded on the Turn
Seat 3: Duke Croix (big blind) folded before Flop
Seat 5: Klemtonius collected (1228)
Seat 8: color_singleton folded on the Turn
Seat 9: JeBoyDirk folded before Flop (didn't bet)



PokerStars Home Game Hand #218758746730: {Club #3225207}  Hold'em No Limit (50/100) - 2020/09/24 15:14:00 ET
Table 'money money' 9-max (Play Money) Seat #2 is the button
Seat 1: MnnM150 (14169 in chips) 
Seat 2: dhduncan (9200 in chips) 
Seat 3: Duke Croix (4452 in chips) 
Seat 5: Klemtonius (5273 in chips) 
Seat 8: color_singleton (10304 in chips) 
Seat 9: JeBoyDirk (22237 in chips) 
Duke Croix: posts small blind 50
Klemtonius: posts big blind 100
*** HOLE CARDS ***
Dealt to Duke Croix [5d 4d]
color_singleton: folds 
JeBoyDirk: raises 200 to 300
MnnM150: calls 300
dhduncan: folds 
Duke Croix: calls 250
Klemtonius: calls 200
*** FLOP *** [8c Js Ah]
Duke Croix: checks 
Klemtonius: checks 
JeBoyDirk: bets 300
MnnM150: folds 
Duke Croix: folds 
Klemtonius: calls 300
*** TURN *** [8c Js Ah] [Jh]
Klemtonius: checks 
JeBoyDirk: bets 700
Klemtonius: folds 
Uncalled bet (700) returned to JeBoyDirk
JeBoyDirk collected 1701 from pot
*** SUMMARY ***
Total pot 1800 | Rake 99 
Board [8c Js Ah Jh]
Seat 1: MnnM150 folded on the Flop
Seat 2: dhduncan (button) folded before Flop (didn't bet)
Seat 3: Duke Croix (small blind) folded on the Flop
Seat 5: Klemtonius (big blind) folded on the Turn
Seat 8: color_singleton folded before Flop (didn't bet)
Seat 9: JeBoyDirk collected (1701)



PokerStars Home Game Hand #218758789201: {Club #3225207}  Hold'em No Limit (50/100) - 2020/09/24 15:14:57 ET
Table 'money money' 9-max (Play Money) Seat #3 is the button
Seat 1: MnnM150 (13869 in chips) 
Seat 2: dhduncan (9200 in chips) 
Seat 3: Duke Croix (4152 in chips) 
Seat 5: Klemtonius (4673 in chips) 
Seat 8: color_singleton (10304 in chips) 
Seat 9: JeBoyDirk (23338 in chips) 
Klemtonius: posts small blind 50
color_singleton: posts big blind 100
*** HOLE CARDS ***
Dealt to Duke Croix [5d Jh]
JeBoyDirk: folds 
MnnM150: calls 100
dhduncan: calls 100
Duke Croix: folds 
Klemtonius: calls 50
color_singleton: raises 200 to 300
MnnM150: folds 
dhduncan: calls 200
Klemtonius: calls 200
*** FLOP *** [8d Qd Ac]
Klemtonius: checks 
color_singleton: bets 500
dhduncan: calls 500
Klemtonius: folds 
*** TURN *** [8d Qd Ac] [3h]
color_singleton: bets 945
dhduncan: calls 945
*** RIVER *** [8d Qd Ac 3h] [7d]
color_singleton: checks 
dhduncan: checks 
*** SHOW DOWN ***
color_singleton: shows [Kc 4s] (high card Ace)
dhduncan: shows [Ah Js] (a pair of Aces)
dhduncan collected 3676 from pot
*** SUMMARY ***
Total pot 3890 | Rake 214 
Board [8d Qd Ac 3h 7d]
Seat 1: MnnM150 folded before Flop
Seat 2: dhduncan showed [Ah Js] and won (3676) with a pair of Aces
Seat 3: Duke Croix (button) folded before Flop (didn't bet)
Seat 5: Klemtonius (small blind) folded on the Flop
Seat 8: color_singleton (big blind) showed [Kc 4s] and lost with high card Ace
Seat 9: JeBoyDirk folded before Flop (didn't bet)



PokerStars Home Game Hand #218758827991: {Club #3225207}  Hold'em No Limit (50/100) - 2020/09/24 15:16:02 ET
Table 'money money' 9-max (Play Money) Seat #5 is the button
Seat 1: MnnM150 (13769 in chips) 
Seat 2: dhduncan (11131 in chips) 
Seat 3: Duke Croix (4152 in chips) 
Seat 5: Klemtonius (4373 in chips) 
Seat 8: color_singleton (8559 in chips) 
Seat 9: JeBoyDirk (23338 in chips) 
color_singleton: posts small blind 50
JeBoyDirk: posts big blind 100
*** HOLE CARDS ***
Dealt to Duke Croix [Jh 8c]
MnnM150: calls 100
dhduncan: folds 
Duke Croix: folds 
Klemtonius: folds 
color_singleton: folds 
JeBoyDirk: checks 
*** FLOP *** [4d Qh 2d]
JeBoyDirk: checks 
MnnM150: bets 100
JeBoyDirk: folds 
Uncalled bet (100) returned to MnnM150
MnnM150 collected 236 from pot
*** SUMMARY ***
Total pot 250 | Rake 14 
Board [4d Qh 2d]
Seat 1: MnnM150 collected (236)
Seat 2: dhduncan folded before Flop (didn't bet)
Seat 3: Duke Croix folded before Flop (didn't bet)
Seat 5: Klemtonius (button) folded before Flop (didn't bet)
Seat 8: color_singleton (small blind) folded before Flop
Seat 9: JeBoyDirk (big blind) folded on the Flop



PokerStars Home Game Hand #218758844184: {Club #3225207}  Hold'em No Limit (50/100) - 2020/09/24 15:16:29 ET
Table 'money money' 9-max (Play Money) Seat #8 is the button
Seat 1: MnnM150 (13905 in chips) 
Seat 2: dhduncan (11131 in chips) 
Seat 3: Duke Croix (4152 in chips) 
Seat 5: Klemtonius (4373 in chips) 
Seat 8: color_singleton (8509 in chips) 
Seat 9: JeBoyDirk (23238 in chips) 
JeBoyDirk: posts small blind 50
MnnM150: posts big blind 100
*** HOLE CARDS ***
Dealt to Duke Croix [5h Kh]
dhduncan: folds 
Duke Croix: folds 
Klemtonius: calls 100
color_singleton: folds 
JeBoyDirk: calls 50
MnnM150: checks 
*** FLOP *** [7h Th Tc]
JeBoyDirk: checks 
MnnM150: bets 283
Klemtonius: folds 
JeBoyDirk: folds 
Uncalled bet (283) returned to MnnM150
MnnM150 collected 283 from pot
*** SUMMARY ***
Total pot 300 | Rake 17 
Board [7h Th Tc]
Seat 1: MnnM150 (big blind) collected (283)
Seat 2: dhduncan folded before Flop (didn't bet)
Seat 3: Duke Croix folded before Flop (didn't bet)
Seat 5: Klemtonius folded on the Flop
Seat 8: color_singleton (button) folded before Flop (didn't bet)
Seat 9: JeBoyDirk (small blind) folded on the Flop



PokerStars Home Game Hand #218758861830: {Club #3225207}  Hold'em No Limit (50/100) - 2020/09/24 15:16:59 ET
Table 'money money' 9-max (Play Money) Seat #9 is the button
Seat 1: MnnM150 (14088 in chips) 
Seat 2: dhduncan (11131 in chips) 
Seat 3: Duke Croix (4152 in chips) 
Seat 5: Klemtonius (4273 in chips) 
Seat 8: color_singleton (8509 in chips) 
Seat 9: JeBoyDirk (23138 in chips) 
MnnM150: posts small blind 50
dhduncan: posts big blind 100
*** HOLE CARDS ***
Dealt to Duke Croix [3s 9h]
Duke Croix: folds 
Klemtonius: folds 
color_singleton: folds 
JeBoyDirk: calls 100
MnnM150: raises 100 to 200
dhduncan: folds 
JeBoyDirk: calls 100
*** FLOP *** [Qd 7d 3d]
MnnM150: bets 236
JeBoyDirk: calls 236
*** TURN *** [Qd 7d 3d] [Tc]
MnnM150: bets 100
JeBoyDirk: raises 400 to 500
MnnM150: calls 400
*** RIVER *** [Qd 7d 3d Tc] [Qs]
MnnM150: checks 
JeBoyDirk: bets 1300
MnnM150: calls 1300
*** SHOW DOWN ***
JeBoyDirk: shows [Jd Kd] (a flush, King high)
MnnM150: mucks hand 
JeBoyDirk collected 4321 from pot
*** SUMMARY ***
Total pot 4572 | Rake 251 
Board [Qd 7d 3d Tc Qs]
Seat 1: MnnM150 (small blind) mucked [3c Ac]
Seat 2: dhduncan (big blind) folded before Flop
Seat 3: Duke Croix folded before Flop (didn't bet)
Seat 5: Klemtonius folded before Flop (didn't bet)
Seat 8: color_singleton folded before Flop (didn't bet)
Seat 9: JeBoyDirk (button) showed [Jd Kd] and won (4321) with a flush, King high



PokerStars Home Game Hand #218758902080: {Club #3225207}  Hold'em No Limit (50/100) - 2020/09/24 15:18:07 ET
Table 'money money' 9-max (Play Money) Seat #1 is the button
Seat 1: MnnM150 (11852 in chips) 
Seat 2: dhduncan (11031 in chips) 
Seat 3: Duke Croix (4152 in chips) 
Seat 5: Klemtonius (4273 in chips) 
Seat 8: color_singleton (8509 in chips) 
Seat 9: JeBoyDirk (25223 in chips) 
dhduncan: posts small blind 50
Duke Croix: posts big blind 100
*** HOLE CARDS ***
Dealt to Duke Croix [Tc Ts]
Klemtonius: calls 100
color_singleton: folds 
JeBoyDirk: raises 200 to 300
MnnM150: folds 
dhduncan: folds 
Duke Croix: raises 400 to 700
Klemtonius: calls 600
JeBoyDirk: calls 400
*** FLOP *** [6c Kd 2h]
Duke Croix: bets 3452 and is all-in
Klemtonius: folds 
JeBoyDirk: calls 3452
*** TURN *** [6c Kd 2h] [8d]
*** RIVER *** [6c Kd 2h 8d] [3h]
*** SHOW DOWN ***
Duke Croix: shows [Tc Ts] (a pair of Tens)
JeBoyDirk: shows [Jh Jc] (a pair of Jacks)
JeBoyDirk collected 8556 from pot
*** SUMMARY ***
Total pot 9054 | Rake 498 
Board [6c Kd 2h 8d 3h]
Seat 1: MnnM150 (button) folded before Flop (didn't bet)
Seat 2: dhduncan (small blind) folded before Flop
Seat 3: Duke Croix (big blind) showed [Tc Ts] and lost with a pair of Tens
Seat 5: Klemtonius folded on the Flop
Seat 8: color_singleton folded before Flop (didn't bet)
Seat 9: JeBoyDirk showed [Jh Jc] and won (8556) with a pair of Jacks



PokerStars Home Game Hand #218758982355: {Club #3225207}  Hold'em No Limit (50/100) - 2020/09/24 15:20:10 ET
Table 'money money' 9-max (Play Money) Seat #5 is the button
Seat 1: MnnM150 (11844 in chips) 
Seat 2: dhduncan (10781 in chips) 
Seat 3: Duke Croix (10000 in chips) 
Seat 5: Klemtonius (3566 in chips) 
Seat 8: color_singleton (8309 in chips) 
Seat 9: JeBoyDirk (29627 in chips) 
color_singleton: posts small blind 50
JeBoyDirk: posts big blind 100
Duke Croix: posts small blind 50
*** HOLE CARDS ***
Dealt to Duke Croix [3s 8c]
MnnM150: calls 100
dhduncan: calls 100
Duke Croix: folds 
Klemtonius: folds 
color_singleton: calls 50
JeBoyDirk: checks 
*** FLOP *** [2d 6c Qd]
color_singleton: checks 
JeBoyDirk: checks 
MnnM150: checks 
dhduncan: checks 
*** TURN *** [2d 6c Qd] [Jd]
color_singleton: checks 
JeBoyDirk: checks 
MnnM150: checks 
dhduncan: bets 200
color_singleton: folds 
JeBoyDirk: folds 
Duke Croix said, "/"
MnnM150: folds 
Uncalled bet (200) returned to dhduncan
dhduncan collected 425 from pot
dhduncan: doesn't show hand 
*** SUMMARY ***
Total pot 450 | Rake 25 
Board [2d 6c Qd Jd]
Seat 1: MnnM150 folded on the Turn
Seat 2: dhduncan collected (425)
Seat 3: Duke Croix folded before Flop (didn't bet)
Seat 5: Klemtonius (button) folded before Flop (didn't bet)
Seat 8: color_singleton (small blind) folded on the Turn
Seat 9: JeBoyDirk (big blind) folded on the Turn



PokerStars Home Game Hand #218759015006: {Club #3225207}  Hold'em No Limit (50/100) - 2020/09/24 15:21:06 ET
Table 'money money' 9-max (Play Money) Seat #8 is the button
Seat 1: MnnM150 (11744 in chips) 
Seat 2: dhduncan (11106 in chips) 
Seat 3: Duke Croix (9950 in chips) 
Seat 5: Klemtonius (3566 in chips) 
Seat 8: color_singleton (8209 in chips) 
Seat 9: JeBoyDirk (29527 in chips) 
JeBoyDirk: posts small blind 50
MnnM150: posts big blind 100
*** HOLE CARDS ***
Dealt to Duke Croix [8s Kc]
dhduncan: calls 100
Duke Croix: calls 100
Klemtonius: raises 100 to 200
color_singleton: folds 
JeBoyDirk: folds 
MnnM150: folds 
dhduncan: calls 100
Duke Croix: calls 100
*** FLOP *** [2d 6s 9h]
dhduncan: checks 
Duke Croix: checks 
Klemtonius: checks 
*** TURN *** [2d 6s 9h] [Ks]
dhduncan: checks 
Duke Croix: bets 400
Klemtonius: raises 400 to 800
dhduncan: folds 
Duke Croix: calls 400
*** RIVER *** [2d 6s 9h Ks] [2s]
Duke Croix: checks 
Klemtonius: bets 1400
Duke Croix: calls 1400
*** SHOW DOWN ***
Klemtonius: shows [As Qd] (a pair of Deuces)
Duke Croix: shows [8s Kc] (two pair, Kings and Deuces)
Duke Croix collected 4867 from pot
*** SUMMARY ***
Total pot 5150 | Rake 283 
Board [2d 6s 9h Ks 2s]
Seat 1: MnnM150 (big blind) folded before Flop
Seat 2: dhduncan folded on the Turn
Seat 3: Duke Croix showed [8s Kc] and won (4867) with two pair, Kings and Deuces
Seat 5: Klemtonius showed [As Qd] and lost with a pair of Deuces
Seat 8: color_singleton (button) folded before Flop (didn't bet)
Seat 9: JeBoyDirk (small blind) folded before Flop



PokerStars Home Game Hand #218759045495: {Club #3225207}  Hold'em No Limit (50/100) - 2020/09/24 15:21:59 ET
Table 'money money' 9-max (Play Money) Seat #9 is the button
Seat 1: MnnM150 (11644 in chips) 
Seat 2: dhduncan (10906 in chips) 
Seat 3: Duke Croix (12417 in chips) 
Seat 5: Klemtonius (1166 in chips) 
Seat 8: color_singleton (8209 in chips) 
Seat 9: JeBoyDirk (29477 in chips) 
MnnM150: posts small blind 50
dhduncan: posts big blind 100
*** HOLE CARDS ***
Dealt to Duke Croix [Qd 6h]
Duke Croix: folds 
Klemtonius: raises 1066 to 1166 and is all-in
color_singleton: folds 
JeBoyDirk: folds 
MnnM150: folds 
dhduncan: folds 
Uncalled bet (1066) returned to Klemtonius
Klemtonius collected 250 from pot
Klemtonius: doesn't show hand 
*** SUMMARY ***
Total pot 250 | Rake 0 
Seat 1: MnnM150 (small blind) folded before Flop
Seat 2: dhduncan (big blind) folded before Flop
Seat 3: Duke Croix folded before Flop (didn't bet)
Seat 5: Klemtonius collected (250)
Seat 8: color_singleton folded before Flop (didn't bet)
Seat 9: JeBoyDirk (button) folded before Flop (didn't bet)



PokerStars Home Game Hand #218759055695: {Club #3225207}  Hold'em No Limit (50/100) - 2020/09/24 15:22:16 ET
Table 'money money' 9-max (Play Money) Seat #1 is the button
Seat 1: MnnM150 (11594 in chips) 
Seat 2: dhduncan (10806 in chips) 
Seat 3: Duke Croix (12417 in chips) 
Seat 5: Klemtonius (1316 in chips) 
Seat 8: color_singleton (8209 in chips) 
Seat 9: JeBoyDirk (29477 in chips) 
dhduncan: posts small blind 50
Duke Croix: posts big blind 100
*** HOLE CARDS ***
Dealt to Duke Croix [6d 9d]
Klemtonius: calls 100
color_singleton: folds 
JeBoyDirk: folds 
MnnM150: folds 
dhduncan: folds 
Duke Croix: checks 
*** FLOP *** [9s 2d Ad]
Duke Croix: bets 200
Klemtonius: calls 200
*** TURN *** [9s 2d Ad] [Qs]
Duke Croix: bets 400
Klemtonius: folds 
Uncalled bet (400) returned to Duke Croix
Duke Croix collected 614 from pot
*** SUMMARY ***
Total pot 650 | Rake 36 
Board [9s 2d Ad Qs]
Seat 1: MnnM150 (button) folded before Flop (didn't bet)
Seat 2: dhduncan (small blind) folded before Flop
Seat 3: Duke Croix (big blind) collected (614)
Seat 5: Klemtonius folded on the Turn
Seat 8: color_singleton folded before Flop (didn't bet)
Seat 9: JeBoyDirk folded before Flop (didn't bet)



PokerStars Home Game Hand #218759070694: {Club #3225207}  Hold'em No Limit (50/100) - 2020/09/24 15:22:42 ET
Table 'money money' 9-max (Play Money) Seat #2 is the button
Seat 1: MnnM150 (11594 in chips) 
Seat 2: dhduncan (10756 in chips) 
Seat 3: Duke Croix (12731 in chips) 
Seat 5: Klemtonius (1016 in chips) 
Seat 8: color_singleton (8209 in chips) 
Seat 9: JeBoyDirk (29477 in chips) 
Duke Croix: posts small blind 50
Klemtonius: posts big blind 100
*** HOLE CARDS ***
Dealt to Duke Croix [3s As]
color_singleton: folds 
JeBoyDirk: calls 100
MnnM150: calls 100
dhduncan: calls 100
Duke Croix: calls 50
Klemtonius: checks 
*** FLOP *** [9d 6s 3d]
Duke Croix: bets 200
Klemtonius: folds 
JeBoyDirk: folds 
MnnM150: calls 200
dhduncan: folds 
*** TURN *** [9d 6s 3d] [Ts]
Duke Croix: bets 400
MnnM150: folds 
Uncalled bet (400) returned to Duke Croix
Duke Croix collected 850 from pot
*** SUMMARY ***
Total pot 900 | Rake 50 
Board [9d 6s 3d Ts]
Seat 1: MnnM150 folded on the Turn
Seat 2: dhduncan (button) folded on the Flop
Seat 3: Duke Croix (small blind) collected (850)
Seat 5: Klemtonius (big blind) folded on the Flop
Seat 8: color_singleton folded before Flop (didn't bet)
Seat 9: JeBoyDirk folded on the Flop



PokerStars Home Game Hand #218759093312: {Club #3225207}  Hold'em No Limit (50/100) - 2020/09/24 15:23:20 ET
Table 'money money' 9-max (Play Money) Seat #3 is the button
Seat 1: MnnM150 (11294 in chips) 
Seat 2: dhduncan (10656 in chips) 
Seat 3: Duke Croix (13281 in chips) 
Seat 5: Klemtonius (916 in chips) 
Seat 8: color_singleton (8209 in chips) 
Seat 9: JeBoyDirk (29377 in chips) 
Klemtonius: posts small blind 50
color_singleton: posts big blind 100
*** HOLE CARDS ***
Dealt to Duke Croix [9d Js]
JeBoyDirk: folds 
MnnM150: calls 100
dhduncan: calls 100
Duke Croix: folds 
Klemtonius: calls 50
color_singleton: raises 200 to 300
MnnM150: calls 200
dhduncan: calls 200
Klemtonius: calls 200
*** FLOP *** [Ac 5d 9c]
Klemtonius: checks 
color_singleton: checks 
MnnM150: bets 1134
dhduncan: folds 
Klemtonius: calls 616 and is all-in
color_singleton: folds 
Uncalled bet (518) returned to MnnM150
*** TURN *** [Ac 5d 9c] [8d]
*** RIVER *** [Ac 5d 9c 8d] [3c]
*** SHOW DOWN ***
Klemtonius: shows [5c 5s] (three of a kind, Fives)
MnnM150: shows [Jc 9h] (a pair of Nines)
Klemtonius collected 2298 from pot
*** SUMMARY ***
Total pot 2432 | Rake 134 
Board [Ac 5d 9c 8d 3c]
Seat 1: MnnM150 showed [Jc 9h] and lost with a pair of Nines
Seat 2: dhduncan folded on the Flop
Seat 3: Duke Croix (button) folded before Flop (didn't bet)
Seat 5: Klemtonius (small blind) showed [5c 5s] and won (2298) with three of a kind, Fives
Seat 8: color_singleton (big blind) folded on the Flop
Seat 9: JeBoyDirk folded before Flop (didn't bet)



PokerStars Home Game Hand #218759119224: {Club #3225207}  Hold'em No Limit (50/100) - 2020/09/24 15:24:04 ET
Table 'money money' 9-max (Play Money) Seat #5 is the button
Seat 1: MnnM150 (10378 in chips) 
Seat 3: Duke Croix (13281 in chips) 
Seat 5: Klemtonius (2298 in chips) 
Seat 8: color_singleton (7909 in chips) 
Seat 9: JeBoyDirk (29377 in chips) 
color_singleton: posts small blind 50
JeBoyDirk: posts big blind 100
*** HOLE CARDS ***
Dealt to Duke Croix [8c Td]
MnnM150: folds 
Duke Croix: folds 
Klemtonius: calls 100
color_singleton: folds 
JeBoyDirk: checks 
*** FLOP *** [Ts 6d 7c]
JeBoyDirk: checks 
Klemtonius: checks 
*** TURN *** [Ts 6d 7c] [8s]
JeBoyDirk: checks 
Klemtonius: checks 
*** RIVER *** [Ts 6d 7c 8s] [5s]
JeBoyDirk: checks 
Klemtonius: checks 
*** SHOW DOWN ***
JeBoyDirk: shows [6c Kh] (a pair of Sixes)
Klemtonius: mucks hand 
JeBoyDirk collected 236 from pot
*** SUMMARY ***
Total pot 250 | Rake 14 
Board [Ts 6d 7c 8s 5s]
Seat 1: MnnM150 folded before Flop (didn't bet)
Seat 3: Duke Croix folded before Flop (didn't bet)
Seat 5: Klemtonius (button) mucked [Qs 5h]
Seat 8: color_singleton (small blind) folded before Flop
Seat 9: JeBoyDirk (big blind) showed [6c Kh] and won (236) with a pair of Sixes



PokerStars Home Game Hand #218759134854: {Club #3225207}  Hold'em No Limit (50/100) - 2020/09/24 15:24:31 ET
Table 'money money' 9-max (Play Money) Seat #8 is the button
Seat 1: MnnM150 (10378 in chips) 
Seat 3: Duke Croix (13281 in chips) 
Seat 5: Klemtonius (2198 in chips) 
Seat 8: color_singleton (7859 in chips) 
Seat 9: JeBoyDirk (29513 in chips) 
JeBoyDirk: posts small blind 50
MnnM150: posts big blind 100
*** HOLE CARDS ***
Dealt to Duke Croix [Th 2h]
Duke Croix: folds 
Klemtonius: calls 100
color_singleton: folds 
JeBoyDirk: calls 50
MnnM150: checks 
*** FLOP *** [Jd Ks 9s]
JeBoyDirk: checks 
MnnM150: bets 100
Klemtonius: calls 100
JeBoyDirk: folds 
*** TURN *** [Jd Ks 9s] [4h]
MnnM150: bets 100
Klemtonius: folds 
Uncalled bet (100) returned to MnnM150
MnnM150 collected 472 from pot
*** SUMMARY ***
Total pot 500 | Rake 28 
Board [Jd Ks 9s 4h]
Seat 1: MnnM150 (big blind) collected (472)
Seat 3: Duke Croix folded before Flop (didn't bet)
Seat 5: Klemtonius folded on the Turn
Seat 8: color_singleton (button) folded before Flop (didn't bet)
Seat 9: JeBoyDirk (small blind) folded on the Flop



PokerStars Home Game Hand #218759154997: {Club #3225207}  Hold'em No Limit (50/100) - 2020/09/24 15:25:05 ET
Table 'money money' 9-max (Play Money) Seat #9 is the button
Seat 1: MnnM150 (10650 in chips) 
Seat 3: Duke Croix (13281 in chips) 
Seat 5: Klemtonius (1998 in chips) 
Seat 8: color_singleton (7859 in chips) 
Seat 9: JeBoyDirk (29413 in chips) 
MnnM150: posts small blind 50
Duke Croix: posts big blind 100
*** HOLE CARDS ***
Dealt to Duke Croix [Qd 3c]
Klemtonius: raises 100 to 200
color_singleton: folds 
JeBoyDirk: calls 200
MnnM150: calls 150
Duke Croix: calls 100
*** FLOP *** [9s 6s Ah]
MnnM150: checks 
Duke Croix: checks 
Klemtonius: bets 100
JeBoyDirk: folds 
MnnM150: calls 100
Duke Croix: folds 
*** TURN *** [9s 6s Ah] [6h]
MnnM150: checks 
Klemtonius: bets 945
MnnM150: folds 
Uncalled bet (945) returned to Klemtonius
Klemtonius collected 945 from pot
Klemtonius: doesn't show hand 
*** SUMMARY ***
Total pot 1000 | Rake 55 
Board [9s 6s Ah 6h]
Seat 1: MnnM150 (small blind) folded on the Turn
Seat 3: Duke Croix (big blind) folded on the Flop
Seat 5: Klemtonius collected (945)
Seat 8: color_singleton folded before Flop (didn't bet)
Seat 9: JeBoyDirk (button) folded on the Flop



PokerStars Home Game Hand #218759182063: {Club #3225207}  Hold'em No Limit (50/100) - 2020/09/24 15:25:51 ET
Table 'money money' 9-max (Play Money) Seat #1 is the button
Seat 1: MnnM150 (10350 in chips) 
Seat 3: Duke Croix (13081 in chips) 
Seat 5: Klemtonius (2643 in chips) 
Seat 8: color_singleton (7859 in chips) 
Seat 9: JeBoyDirk (29213 in chips) 
Duke Croix: posts small blind 50
Klemtonius: posts big blind 100
*** HOLE CARDS ***
Dealt to Duke Croix [6c Jd]
color_singleton: folds 
JeBoyDirk: folds 
MnnM150: calls 100
Duke Croix: calls 50
Klemtonius: checks 
*** FLOP *** [Jh 9d Ad]
Duke Croix: bets 141
Klemtonius: calls 141
MnnM150: folds 
*** TURN *** [Jh 9d Ad] [Qd]
Duke Croix: bets 200
Klemtonius: folds 
Uncalled bet (200) returned to Duke Croix
Duke Croix collected 550 from pot
*** SUMMARY ***
Total pot 582 | Rake 32 
Board [Jh 9d Ad Qd]
Seat 1: MnnM150 (button) folded on the Flop
Seat 3: Duke Croix (small blind) collected (550)
Seat 5: Klemtonius (big blind) folded on the Turn
Seat 8: color_singleton folded before Flop (didn't bet)
Seat 9: JeBoyDirk folded before Flop (didn't bet)



PokerStars Home Game Hand #218759202525: {Club #3225207}  Hold'em No Limit (50/100) - 2020/09/24 15:26:26 ET
Table 'money money' 9-max (Play Money) Seat #3 is the button
Seat 1: MnnM150 (10250 in chips) 
Seat 3: Duke Croix (13390 in chips) 
Seat 5: Klemtonius (2402 in chips) 
Seat 8: color_singleton (7859 in chips) 
Seat 9: JeBoyDirk (29213 in chips) 
Klemtonius: posts small blind 50
color_singleton: posts big blind 100
*** HOLE CARDS ***
Dealt to Duke Croix [Jc Qc]
JeBoyDirk: raises 100 to 200
MnnM150: calls 200
Duke Croix: calls 200
Klemtonius: calls 150
color_singleton: folds 
*** FLOP *** [9s 8s Ks]
Klemtonius: checks 
JeBoyDirk: checks 
MnnM150: bets 425
Duke Croix: calls 425
Klemtonius: folds 
JeBoyDirk: folds 
*** TURN *** [9s 8s Ks] [9d]
MnnM150: bets 827
Duke Croix: calls 827
*** RIVER *** [9s 8s Ks 9d] [8c]
MnnM150: checks 
Duke Croix: bets 1000
MnnM150: folds 
Uncalled bet (1000) returned to Duke Croix
Duke Croix collected 3217 from pot
*** SUMMARY ***
Total pot 3404 | Rake 187 
Board [9s 8s Ks 9d 8c]
Seat 1: MnnM150 folded on the River
Seat 3: Duke Croix (button) collected (3217)
Seat 5: Klemtonius (small blind) folded on the Flop
Seat 8: color_singleton (big blind) folded before Flop
Seat 9: JeBoyDirk folded on the Flop



PokerStars Home Game Hand #218759234998: {Club #3225207}  Hold'em No Limit (50/100) - 2020/09/24 15:27:21 ET
Table 'money money' 9-max (Play Money) Seat #5 is the button
Seat 1: MnnM150 (8798 in chips) 
Seat 3: Duke Croix (15155 in chips) 
Seat 5: Klemtonius (2202 in chips) 
Seat 8: color_singleton (7759 in chips) 
Seat 9: JeBoyDirk (29013 in chips) 
color_singleton: posts small blind 50
JeBoyDirk: posts big blind 100
*** HOLE CARDS ***
Dealt to Duke Croix [Tc 2d]
MnnM150: calls 100
Duke Croix: folds 
Klemtonius: calls 100
color_singleton: calls 50
JeBoyDirk: checks 
*** FLOP *** [As 3h 3d]
color_singleton: checks 
JeBoyDirk: checks 
MnnM150: bets 100
Klemtonius: calls 100
color_singleton: calls 100
JeBoyDirk: folds 
*** TURN *** [As 3h 3d] [8s]
color_singleton: checks 
MnnM150: bets 330
Klemtonius: calls 330
color_singleton: folds 
*** RIVER *** [As 3h 3d 8s] [6c]
MnnM150: bets 1285
Klemtonius: folds 
Uncalled bet (1285) returned to MnnM150
MnnM150 collected 1285 from pot
*** SUMMARY ***
Total pot 1360 | Rake 75 
Board [As 3h 3d 8s 6c]
Seat 1: MnnM150 collected (1285)
Seat 3: Duke Croix folded before Flop (didn't bet)
Seat 5: Klemtonius (button) folded on the River
Seat 8: color_singleton (small blind) folded on the Turn
Seat 9: JeBoyDirk (big blind) folded on the Flop



PokerStars Home Game Hand #218759280044: {Club #3225207}  Hold'em No Limit (50/100) - 2020/09/24 15:28:38 ET
Table 'money money' 9-max (Play Money) Seat #8 is the button
Seat 1: MnnM150 (9553 in chips) 
Seat 3: Duke Croix (15155 in chips) 
Seat 5: Klemtonius (1672 in chips) 
Seat 8: color_singleton (7559 in chips) 
Seat 9: JeBoyDirk (28913 in chips) 
JeBoyDirk: posts small blind 50
MnnM150: posts big blind 100
*** HOLE CARDS ***
Dealt to Duke Croix [9s 6d]
Duke Croix: folds 
Klemtonius: calls 100
color_singleton: calls 100
JeBoyDirk: folds 
MnnM150: checks 
*** FLOP *** [As Ad Jd]
MnnM150: checks 
Klemtonius: bets 1572 and is all-in
color_singleton: folds 
MnnM150: folds 
Uncalled bet (1572) returned to Klemtonius
Klemtonius collected 331 from pot
Klemtonius: doesn't show hand 
*** SUMMARY ***
Total pot 350 | Rake 19 
Board [As Ad Jd]
Seat 1: MnnM150 (big blind) folded on the Flop
Seat 3: Duke Croix folded before Flop (didn't bet)
Seat 5: Klemtonius collected (331)
Seat 8: color_singleton (button) folded on the Flop
Seat 9: JeBoyDirk (small blind) folded before Flop



PokerStars Home Game Hand #218759298876: {Club #3225207}  Hold'em No Limit (50/100) - 2020/09/24 15:29:10 ET
Table 'money money' 9-max (Play Money) Seat #9 is the button
Seat 1: MnnM150 (9453 in chips) 
Seat 2: dhduncan (10356 in chips) 
Seat 3: Duke Croix (15155 in chips) 
Seat 5: Klemtonius (1903 in chips) 
Seat 8: color_singleton (7459 in chips) 
Seat 9: JeBoyDirk (28863 in chips) 
MnnM150: posts small blind 50
dhduncan: posts big blind 100
*** HOLE CARDS ***
Dealt to Duke Croix [9s 5c]
Duke Croix: folds 
Klemtonius: raises 100 to 200
color_singleton: folds 
JeBoyDirk: folds 
MnnM150: calls 150
dhduncan: folds 
*** FLOP *** [Qh 4d 6d]
MnnM150: checks 
Klemtonius: bets 1703 and is all-in
MnnM150: folds 
Uncalled bet (1703) returned to Klemtonius
Klemtonius collected 472 from pot
Klemtonius: doesn't show hand 
*** SUMMARY ***
Total pot 500 | Rake 28 
Board [Qh 4d 6d]
Seat 1: MnnM150 (small blind) folded on the Flop
Seat 2: dhduncan (big blind) folded before Flop
Seat 3: Duke Croix folded before Flop (didn't bet)
Seat 5: Klemtonius collected (472)
Seat 8: color_singleton folded before Flop (didn't bet)
Seat 9: JeBoyDirk (button) folded before Flop (didn't bet)



PokerStars Home Game Hand #218759314382: {Club #3225207}  Hold'em No Limit (50/100) - 2020/09/24 15:29:36 ET
Table 'money money' 9-max (Play Money) Seat #1 is the button
Seat 1: MnnM150 (9253 in chips) 
Seat 2: dhduncan (10256 in chips) 
Seat 3: Duke Croix (15155 in chips) 
Seat 5: Klemtonius (2175 in chips) 
Seat 8: color_singleton (7459 in chips) 
Seat 9: JeBoyDirk (28863 in chips) 
dhduncan: posts small blind 50
Duke Croix: posts big blind 100
*** HOLE CARDS ***
Dealt to Duke Croix [Th 8h]
Klemtonius: raises 100 to 200
color_singleton: folds 
JeBoyDirk: folds 
MnnM150: folds 
dhduncan: calls 150
Duke Croix: calls 100
*** FLOP *** [5h Jc 3s]
dhduncan: checks 
Duke Croix: checks 
Klemtonius: checks 
*** TURN *** [5h Jc 3s] [5d]
dhduncan: bets 283
Duke Croix: folds 
Klemtonius: folds 
Uncalled bet (283) returned to dhduncan
dhduncan collected 567 from pot
dhduncan: doesn't show hand 
*** SUMMARY ***
Total pot 600 | Rake 33 
Board [5h Jc 3s 5d]
Seat 1: MnnM150 (button) folded before Flop (didn't bet)
Seat 2: dhduncan (small blind) collected (567)
Seat 3: Duke Croix (big blind) folded on the Turn
Seat 5: Klemtonius folded on the Turn
Seat 8: color_singleton folded before Flop (didn't bet)
Seat 9: JeBoyDirk folded before Flop (didn't bet)



PokerStars Home Game Hand #218759338188: {Club #3225207}  Hold'em No Limit (50/100) - 2020/09/24 15:30:17 ET
Table 'money money' 9-max (Play Money) Seat #2 is the button
Seat 1: MnnM150 (9253 in chips) 
Seat 2: dhduncan (10623 in chips) 
Seat 3: Duke Croix (14955 in chips) 
Seat 5: Klemtonius (1975 in chips) 
Seat 8: color_singleton (7459 in chips) 
Seat 9: JeBoyDirk (28863 in chips) 
Duke Croix: posts small blind 50
Klemtonius: posts big blind 100
*** HOLE CARDS ***
Dealt to Duke Croix [5h 4h]
color_singleton: raises 100 to 200
JeBoyDirk: folds 
MnnM150: folds 
dhduncan: folds 
Duke Croix: calls 150
Klemtonius: raises 100 to 300
color_singleton: calls 100
Duke Croix: calls 100
*** FLOP *** [7h 5c 9c]
Duke Croix: checks 
Klemtonius: checks 
color_singleton: checks 
*** TURN *** [7h 5c 9c] [7s]
Duke Croix: bets 400
Klemtonius: raises 400 to 800
color_singleton: folds 
Duke Croix: calls 400
*** RIVER *** [7h 5c 9c 7s] [2h]
Duke Croix: checks 
Klemtonius: bets 875 and is all-in
Duke Croix: calls 875
*** SHOW DOWN ***
Klemtonius: shows [Ks Kh] (two pair, Kings and Sevens)
Duke Croix: shows [5h 4h] (two pair, Sevens and Fives)
Klemtonius collected 4016 from pot
*** SUMMARY ***
Total pot 4250 | Rake 234 
Board [7h 5c 9c 7s 2h]
Seat 1: MnnM150 folded before Flop (didn't bet)
Seat 2: dhduncan (button) folded before Flop (didn't bet)
Seat 3: Duke Croix (small blind) showed [5h 4h] and lost with two pair, Sevens and Fives
Seat 5: Klemtonius (big blind) showed [Ks Kh] and won (4016) with two pair, Kings and Sevens
Seat 8: color_singleton folded on the Turn
Seat 9: JeBoyDirk folded before Flop (didn't bet)



PokerStars Home Game Hand #218759373466: {Club #3225207}  Hold'em No Limit (50/100) - 2020/09/24 15:31:17 ET
Table 'money money' 9-max (Play Money) Seat #3 is the button
Seat 1: MnnM150 (9253 in chips) 
Seat 2: dhduncan (10623 in chips) 
Seat 3: Duke Croix (12980 in chips) 
Seat 5: Klemtonius (4016 in chips) 
Seat 8: color_singleton (7159 in chips) 
Seat 9: JeBoyDirk (28863 in chips) 
Klemtonius: posts small blind 50
color_singleton: posts big blind 100
*** HOLE CARDS ***
Dealt to Duke Croix [4d 4h]
JeBoyDirk: folds 
MnnM150: calls 100
dhduncan: calls 100
Duke Croix: calls 100
Klemtonius: calls 50
color_singleton: checks 
*** FLOP *** [Qd Qs Js]
Klemtonius: bets 472
color_singleton: folds 
MnnM150: folds 
dhduncan: calls 472
Duke Croix: folds 
*** TURN *** [Qd Qs Js] [Th]
Klemtonius: checks 
dhduncan: checks 
*** RIVER *** [Qd Qs Js Th] [4s]
Klemtonius: checks 
dhduncan: checks 
*** SHOW DOWN ***
Klemtonius: shows [8s Jh] (two pair, Queens and Jacks)
dhduncan: shows [Ks Jd] (two pair, Queens and Jacks - King kicker)
dhduncan collected 1365 from pot
*** SUMMARY ***
Total pot 1444 | Rake 79 
Board [Qd Qs Js Th 4s]
Seat 1: MnnM150 folded on the Flop
Seat 2: dhduncan showed [Ks Jd] and won (1365) with two pair, Queens and Jacks
Seat 3: Duke Croix (button) folded on the Flop
Seat 5: Klemtonius (small blind) showed [8s Jh] and lost with two pair, Queens and Jacks
Seat 8: color_singleton (big blind) folded on the Flop
Seat 9: JeBoyDirk folded before Flop (didn't bet)



PokerStars Home Game Hand #218759401554: {Club #3225207}  Hold'em No Limit (50/100) - 2020/09/24 15:32:05 ET
Table 'money money' 9-max (Play Money) Seat #5 is the button
Seat 1: MnnM150 (9153 in chips) 
Seat 2: dhduncan (11416 in chips) 
Seat 3: Duke Croix (12880 in chips) 
Seat 5: Klemtonius (3444 in chips) 
Seat 8: color_singleton (7059 in chips) 
Seat 9: JeBoyDirk (28863 in chips) 
color_singleton: posts small blind 50
JeBoyDirk: posts big blind 100
*** HOLE CARDS ***
Dealt to Duke Croix [Ah 9s]
MnnM150: calls 100
dhduncan: raises 100 to 200
Duke Croix: raises 200 to 400
Klemtonius: calls 400
color_singleton: folds 
JeBoyDirk: folds 
MnnM150: calls 300
dhduncan: calls 200
*** FLOP *** [Qd 2s Qc]
MnnM150: checks 
dhduncan: bets 100
Duke Croix: folds 
Klemtonius: calls 100
MnnM150: calls 100
*** TURN *** [Qd 2s Qc] [Td]
MnnM150: checks 
dhduncan: bets 100
Klemtonius: raises 233 to 333
MnnM150: folds 
dhduncan: calls 233
*** RIVER *** [Qd 2s Qc Td] [Th]
dhduncan: checks 
Klemtonius: bets 555
dhduncan: calls 555
*** SHOW DOWN ***
Klemtonius: shows [Kd Qh] (a full house, Queens full of Tens)
dhduncan: mucks hand 
Klemtonius collected 3616 from pot
*** SUMMARY ***
Total pot 3826 | Rake 210 
Board [Qd 2s Qc Td Th]
Seat 1: MnnM150 folded on the Turn
Seat 2: dhduncan mucked [As Ac]
Seat 3: Duke Croix folded on the Flop
Seat 5: Klemtonius (button) showed [Kd Qh] and won (3616) with a full house, Queens full of Tens
Seat 8: color_singleton (small blind) folded before Flop
Seat 9: JeBoyDirk (big blind) folded before Flop



PokerStars Home Game Hand #218759448934: {Club #3225207}  Hold'em No Limit (50/100) - 2020/09/24 15:33:26 ET
Table 'money money' 9-max (Play Money) Seat #8 is the button
Seat 1: MnnM150 (8653 in chips) 
Seat 2: dhduncan (10028 in chips) 
Seat 3: Duke Croix (12480 in chips) 
Seat 5: Klemtonius (5672 in chips) 
Seat 8: color_singleton (7009 in chips) 
Seat 9: JeBoyDirk (28763 in chips) 
JeBoyDirk: posts small blind 50
MnnM150: posts big blind 100
*** HOLE CARDS ***
Dealt to Duke Croix [3c Ts]
dhduncan: folds 
Duke Croix: folds 
Klemtonius: calls 100
color_singleton: folds 
JeBoyDirk: folds 
MnnM150: checks 
*** FLOP *** [4s 4c Kd]
MnnM150: checks 
Klemtonius: bets 236
MnnM150: folds 
Uncalled bet (236) returned to Klemtonius
Klemtonius collected 236 from pot
Klemtonius: doesn't show hand 
*** SUMMARY ***
Total pot 250 | Rake 14 
Board [4s 4c Kd]
Seat 1: MnnM150 (big blind) folded on the Flop
Seat 2: dhduncan folded before Flop (didn't bet)
Seat 3: Duke Croix folded before Flop (didn't bet)
Seat 5: Klemtonius collected (236)
Seat 8: color_singleton (button) folded before Flop (didn't bet)
Seat 9: JeBoyDirk (small blind) folded before Flop



PokerStars Home Game Hand #218759464723: {Club #3225207}  Hold'em No Limit (50/100) - 2020/09/24 15:33:53 ET
Table 'money money' 9-max (Play Money) Seat #9 is the button
Seat 1: MnnM150 (8553 in chips) 
Seat 3: Duke Croix (12480 in chips) 
Seat 5: Klemtonius (5808 in chips) 
Seat 8: color_singleton (7009 in chips) 
Seat 9: JeBoyDirk (28713 in chips) 
MnnM150: posts small blind 50
Duke Croix: posts big blind 100
*** HOLE CARDS ***
Dealt to Duke Croix [8s 6h]
Klemtonius: raises 100 to 200
color_singleton: calls 200
JeBoyDirk: folds 
MnnM150: folds 
Duke Croix: calls 100
*** FLOP *** [3h Jd Ah]
Duke Croix: checks 
Klemtonius: checks 
color_singleton: checks 
*** TURN *** [3h Jd Ah] [4h]
Duke Croix: checks 
Klemtonius: bets 100
color_singleton: folds 
Duke Croix: folds 
Uncalled bet (100) returned to Klemtonius
Klemtonius collected 614 from pot
Klemtonius: doesn't show hand 
*** SUMMARY ***
Total pot 650 | Rake 36 
Board [3h Jd Ah 4h]
Seat 1: MnnM150 (small blind) folded before Flop
Seat 3: Duke Croix (big blind) folded on the Turn
Seat 5: Klemtonius collected (614)
Seat 8: color_singleton folded on the Turn
Seat 9: JeBoyDirk (button) folded before Flop (didn't bet)



PokerStars Home Game Hand #218759484316: {Club #3225207}  Hold'em No Limit (50/100) - 2020/09/24 15:34:27 ET
Table 'money money' 9-max (Play Money) Seat #1 is the button
Seat 1: MnnM150 (8503 in chips) 
Seat 3: Duke Croix (12280 in chips) 
Seat 5: Klemtonius (6222 in chips) 
Seat 8: color_singleton (6809 in chips) 
Seat 9: JeBoyDirk (28713 in chips) 
Duke Croix: posts small blind 50
Klemtonius: posts big blind 100
*** HOLE CARDS ***
Dealt to Duke Croix [Tc Qs]
color_singleton: folds 
JeBoyDirk: calls 100
MnnM150: folds 
Duke Croix: raises 300 to 400
Klemtonius: calls 300
JeBoyDirk: calls 300
*** FLOP *** [5d 6h 9d]
Duke Croix: checks 
Klemtonius: checks 
JeBoyDirk: checks 
*** TURN *** [5d 6h 9d] [3d]
Duke Croix: checks 
Klemtonius: bets 900
JeBoyDirk: folds 
Duke Croix: folds 
Uncalled bet (900) returned to Klemtonius
Klemtonius collected 1134 from pot
Klemtonius: doesn't show hand 
*** SUMMARY ***
Total pot 1200 | Rake 66 
Board [5d 6h 9d 3d]
Seat 1: MnnM150 (button) folded before Flop (didn't bet)
Seat 3: Duke Croix (small blind) folded on the Turn
Seat 5: Klemtonius (big blind) collected (1134)
Seat 8: color_singleton folded before Flop (didn't bet)
Seat 9: JeBoyDirk folded on the Turn



PokerStars Home Game Hand #218759504901: {Club #3225207}  Hold'em No Limit (50/100) - 2020/09/24 15:35:02 ET
Table 'money money' 9-max (Play Money) Seat #3 is the button
Seat 1: MnnM150 (8503 in chips) 
Seat 3: Duke Croix (11880 in chips) 
Seat 5: Klemtonius (6956 in chips) 
Seat 8: color_singleton (6809 in chips) 
Seat 9: JeBoyDirk (28313 in chips) 
Klemtonius: posts small blind 50
color_singleton: posts big blind 100
*** HOLE CARDS ***
Dealt to Duke Croix [8d Ks]
JeBoyDirk: raises 200 to 300
MnnM150: folds 
Duke Croix: calls 300
Klemtonius: calls 250
color_singleton: calls 200
*** FLOP *** [8c 6d Kh]
Klemtonius: checks 
color_singleton: bets 567
JeBoyDirk: folds 
Duke Croix: calls 567
Klemtonius: calls 567
*** TURN *** [8c 6d Kh] [9c]
Klemtonius: checks 
color_singleton: bets 1370
Duke Croix: calls 1370
Klemtonius: folds 
*** RIVER *** [8c 6d Kh 9c] [9h]
color_singleton: checks 
Duke Croix: checks 
*** SHOW DOWN ***
color_singleton: shows [Tc Kc] (two pair, Kings and Nines)
Duke Croix: mucks hand 
color_singleton collected 5331 from pot
*** SUMMARY ***
Total pot 5641 | Rake 310 
Board [8c 6d Kh 9c 9h]
Seat 1: MnnM150 folded before Flop (didn't bet)
Seat 3: Duke Croix (button) mucked [8d Ks]
Seat 5: Klemtonius (small blind) folded on the Turn
Seat 8: color_singleton (big blind) showed [Tc Kc] and won (5331) with two pair, Kings and Nines
Seat 9: JeBoyDirk folded on the Flop



PokerStars Home Game Hand #218759540741: {Club #3225207}  Hold'em No Limit (50/100) - 2020/09/24 15:36:04 ET
Table 'money money' 9-max (Play Money) Seat #5 is the button
Seat 1: MnnM150 (8503 in chips) 
Seat 3: Duke Croix (9643 in chips) 
Seat 5: Klemtonius (6089 in chips) 
Seat 8: color_singleton (9903 in chips) 
Seat 9: JeBoyDirk (28013 in chips) 
color_singleton: posts small blind 50
JeBoyDirk: posts big blind 100
*** HOLE CARDS ***
Dealt to Duke Croix [8c Qc]
MnnM150: calls 100
Duke Croix: calls 100
Klemtonius: calls 100
color_singleton: raises 200 to 300
JeBoyDirk: calls 200
MnnM150: calls 200
Duke Croix: calls 200
Klemtonius: calls 200
*** FLOP *** [2d 6s Tc]
color_singleton: bets 800
JeBoyDirk: calls 800
MnnM150: folds 
Duke Croix: folds 
Klemtonius: folds 
*** TURN *** [2d 6s Tc] [As]
color_singleton: bets 1464
JeBoyDirk: calls 1464
*** RIVER *** [2d 6s Tc As] [8d]
color_singleton: checks 
JeBoyDirk: bets 2900
color_singleton: folds 
Uncalled bet (2900) returned to JeBoyDirk
JeBoyDirk collected 5696 from pot
*** SUMMARY ***
Total pot 6028 | Rake 332 
Board [2d 6s Tc As 8d]
Seat 1: MnnM150 folded on the Flop
Seat 3: Duke Croix folded on the Flop
Seat 5: Klemtonius (button) folded on the Flop
Seat 8: color_singleton (small blind) folded on the River
Seat 9: JeBoyDirk (big blind) collected (5696)



PokerStars Home Game Hand #218759584106: {Club #3225207}  Hold'em No Limit (50/100) - 2020/09/24 15:37:19 ET
Table 'money money' 9-max (Play Money) Seat #8 is the button
Seat 1: MnnM150 (8203 in chips) 
Seat 3: Duke Croix (9343 in chips) 
Seat 5: Klemtonius (5789 in chips) 
Seat 8: color_singleton (7339 in chips) 
Seat 9: JeBoyDirk (31145 in chips) 
JeBoyDirk: posts small blind 50
MnnM150: posts big blind 100
*** HOLE CARDS ***
Dealt to Duke Croix [2h 2c]
Duke Croix: raises 200 to 300
Klemtonius: folds 
color_singleton: folds 
JeBoyDirk: calls 250
MnnM150: calls 200
*** FLOP *** [Js 6c Qh]
JeBoyDirk: checks 
MnnM150: checks 
Duke Croix: checks 
*** TURN *** [Js 6c Qh] [Ks]
JeBoyDirk: checks 
MnnM150: bets 425
Duke Croix: folds 
JeBoyDirk: folds 
Uncalled bet (425) returned to MnnM150
MnnM150 collected 850 from pot
*** SUMMARY ***
Total pot 900 | Rake 50 
Board [Js 6c Qh Ks]
Seat 1: MnnM150 (big blind) collected (850)
Seat 3: Duke Croix folded on the Turn
Seat 5: Klemtonius folded before Flop (didn't bet)
Seat 8: color_singleton (button) folded before Flop (didn't bet)
Seat 9: JeBoyDirk (small blind) folded on the Turn



PokerStars Home Game Hand #218759599905: {Club #3225207}  Hold'em No Limit (50/100) - 2020/09/24 15:37:46 ET
Table 'money money' 9-max (Play Money) Seat #9 is the button
Seat 1: MnnM150 (8753 in chips) 
Seat 3: Duke Croix (9043 in chips) 
Seat 5: Klemtonius (5789 in chips) 
Seat 8: color_singleton (7339 in chips) 
Seat 9: JeBoyDirk (30845 in chips) 
MnnM150: posts small blind 50
Duke Croix: posts big blind 100
*** HOLE CARDS ***
Dealt to Duke Croix [Qd Qs]
Klemtonius: calls 100
color_singleton: folds 
JeBoyDirk: folds 
MnnM150: calls 50
Duke Croix: raises 300 to 400
Klemtonius: calls 300
MnnM150: folds 
*** FLOP *** [Jh Kh 3d]
Duke Croix: bets 500
Klemtonius: folds 
Uncalled bet (500) returned to Duke Croix
Duke Croix collected 850 from pot
*** SUMMARY ***
Total pot 900 | Rake 50 
Board [Jh Kh 3d]
Seat 1: MnnM150 (small blind) folded before Flop
Seat 3: Duke Croix (big blind) collected (850)
Seat 5: Klemtonius folded on the Flop
Seat 8: color_singleton folded before Flop (didn't bet)
Seat 9: JeBoyDirk (button) folded before Flop (didn't bet)



PokerStars Home Game Hand #218759618684: {Club #3225207}  Hold'em No Limit (50/100) - 2020/09/24 15:38:18 ET
Table 'money money' 9-max (Play Money) Seat #1 is the button
Seat 1: MnnM150 (8653 in chips) 
Seat 3: Duke Croix (9493 in chips) 
Seat 5: Klemtonius (5389 in chips) 
Seat 8: color_singleton (7339 in chips) 
Seat 9: JeBoyDirk (30845 in chips) 
Duke Croix: posts small blind 50
Klemtonius: posts big blind 100
*** HOLE CARDS ***
Dealt to Duke Croix [Jc 9c]
color_singleton: raises 100 to 200
JeBoyDirk has timed out
JeBoyDirk: folds 
MnnM150: calls 200
Duke Croix: calls 150
Klemtonius: calls 100
*** FLOP *** [5h Td 3h]
Duke Croix: checks 
Klemtonius: checks 
color_singleton: checks 
MnnM150: checks 
*** TURN *** [5h Td 3h] [9s]
Duke Croix: bets 400
Klemtonius: folds 
color_singleton: folds 
MnnM150: folds 
Uncalled bet (400) returned to Duke Croix
Duke Croix collected 756 from pot
*** SUMMARY ***
Total pot 800 | Rake 44 
Board [5h Td 3h 9s]
Seat 1: MnnM150 (button) folded on the Turn
Seat 3: Duke Croix (small blind) collected (756)
Seat 5: Klemtonius (big blind) folded on the Turn
Seat 8: color_singleton folded on the Turn
Seat 9: JeBoyDirk folded before Flop (didn't bet)



PokerStars Home Game Hand #218759651360: {Club #3225207}  Hold'em No Limit (50/100) - 2020/09/24 15:39:14 ET
Table 'money money' 9-max (Play Money) Seat #3 is the button
Seat 1: MnnM150 (8453 in chips) 
Seat 3: Duke Croix (10049 in chips) 
Seat 5: Klemtonius (5189 in chips) 
Seat 8: color_singleton (7139 in chips) 
Seat 9: JeBoyDirk (30845 in chips) 
Klemtonius: posts small blind 50
color_singleton: posts big blind 100
*** HOLE CARDS ***
Dealt to Duke Croix [8h Jh]
JeBoyDirk: calls 100
MnnM150: folds 
Duke Croix: calls 100
Klemtonius: calls 50
color_singleton: checks 
*** FLOP *** [7d As Ks]
Klemtonius: checks 
color_singleton: bets 100
JeBoyDirk: calls 100
Duke Croix: folds 
Klemtonius: folds 
*** TURN *** [7d As Ks] [6h]
color_singleton: bets 200
JeBoyDirk: folds 
Uncalled bet (200) returned to color_singleton
color_singleton collected 567 from pot
color_singleton: doesn't show hand 
*** SUMMARY ***
Total pot 600 | Rake 33 
Board [7d As Ks 6h]
Seat 1: MnnM150 folded before Flop (didn't bet)
Seat 3: Duke Croix (button) folded on the Flop
Seat 5: Klemtonius (small blind) folded on the Flop
Seat 8: color_singleton (big blind) collected (567)
Seat 9: JeBoyDirk folded on the Turn



PokerStars Home Game Hand #218759677449: {Club #3225207}  Hold'em No Limit (50/100) - 2020/09/24 15:39:59 ET
Table 'money money' 9-max (Play Money) Seat #5 is the button
Seat 1: MnnM150 (8453 in chips) 
Seat 3: Duke Croix (9949 in chips) 
Seat 5: Klemtonius (5089 in chips) 
Seat 8: color_singleton (7506 in chips) 
Seat 9: JeBoyDirk (30645 in chips) 
color_singleton: posts small blind 50
JeBoyDirk: posts big blind 100
*** HOLE CARDS ***
Dealt to Duke Croix [4h 4s]
MnnM150: calls 100
Duke Croix: raises 200 to 300
Klemtonius: calls 300
color_singleton: calls 250
JeBoyDirk: folds 
MnnM150: calls 200
*** FLOP *** [9d 9h 8h]
color_singleton: checks 
MnnM150: checks 
Duke Croix: checks 
Klemtonius: bets 1228
color_singleton: folds 
MnnM150: folds 
Duke Croix: folds 
Uncalled bet (1228) returned to Klemtonius
Klemtonius collected 1228 from pot
Klemtonius: doesn't show hand 
*** SUMMARY ***
Total pot 1300 | Rake 72 
Board [9d 9h 8h]
Seat 1: MnnM150 folded on the Flop
Seat 3: Duke Croix folded on the Flop
Seat 5: Klemtonius (button) collected (1228)
Seat 8: color_singleton (small blind) folded on the Flop
Seat 9: JeBoyDirk (big blind) folded before Flop



PokerStars Home Game Hand #218759704928: {Club #3225207}  Hold'em No Limit (50/100) - 2020/09/24 15:40:46 ET
Table 'money money' 9-max (Play Money) Seat #8 is the button
Seat 1: MnnM150 (8153 in chips) 
Seat 3: Duke Croix (9649 in chips) 
Seat 5: Klemtonius (6017 in chips) 
Seat 8: color_singleton (7206 in chips) 
Seat 9: JeBoyDirk (30545 in chips) 
JeBoyDirk: posts small blind 50
MnnM150: posts big blind 100
*** HOLE CARDS ***
Dealt to Duke Croix [Th 9c]
Duke Croix: raises 200 to 300
Klemtonius: calls 300
color_singleton: folds 
JeBoyDirk: folds 
MnnM150: calls 200
*** FLOP *** [6c 7s 6s]
MnnM150: checks 
Duke Croix: checks 
Klemtonius: checks 
*** TURN *** [6c 7s 6s] [Kh]
MnnM150: checks 
Duke Croix: checks 
Klemtonius: checks 
*** RIVER *** [6c 7s 6s Kh] [7h]
MnnM150: bets 449
Duke Croix: folds 
Klemtonius: folds 
Uncalled bet (449) returned to MnnM150
MnnM150 collected 898 from pot
*** SUMMARY ***
Total pot 950 | Rake 52 
Board [6c 7s 6s Kh 7h]
Seat 1: MnnM150 (big blind) collected (898)
Seat 3: Duke Croix folded on the River
Seat 5: Klemtonius folded on the River
Seat 8: color_singleton (button) folded before Flop (didn't bet)
Seat 9: JeBoyDirk (small blind) folded before Flop



PokerStars Home Game Hand #218759732950: {Club #3225207}  Hold'em No Limit (50/100) - 2020/09/24 15:41:35 ET
Table 'money money' 9-max (Play Money) Seat #9 is the button
Seat 1: MnnM150 (8751 in chips) 
Seat 3: Duke Croix (9349 in chips) 
Seat 5: Klemtonius (5717 in chips) 
Seat 8: color_singleton (7206 in chips) 
Seat 9: JeBoyDirk (30495 in chips) 
MnnM150: posts small blind 50
Duke Croix: posts big blind 100
*** HOLE CARDS ***
Dealt to Duke Croix [Ks 4d]
Klemtonius: calls 100
color_singleton: raises 100 to 200
JeBoyDirk: folds 
MnnM150: calls 150
Duke Croix: folds 
Klemtonius: calls 100
*** FLOP *** [3h Kd 3c]
MnnM150: checks 
Klemtonius: checks 
color_singleton: bets 330
MnnM150: folds 
Klemtonius: folds 
Uncalled bet (330) returned to color_singleton
color_singleton collected 661 from pot
color_singleton: doesn't show hand 
*** SUMMARY ***
Total pot 700 | Rake 39 
Board [3h Kd 3c]
Seat 1: MnnM150 (small blind) folded on the Flop
Seat 3: Duke Croix (big blind) folded before Flop
Seat 5: Klemtonius folded on the Flop
Seat 8: color_singleton collected (661)
Seat 9: JeBoyDirk (button) folded before Flop (didn't bet)



PokerStars Home Game Hand #218759749906: {Club #3225207}  Hold'em No Limit (50/100) - 2020/09/24 15:42:04 ET
Table 'money money' 9-max (Play Money) Seat #1 is the button
Seat 1: MnnM150 (8551 in chips) 
Seat 3: Duke Croix (9249 in chips) 
Seat 5: Klemtonius (5517 in chips) 
Seat 8: color_singleton (7667 in chips) 
Seat 9: JeBoyDirk (30495 in chips) 
Duke Croix: posts small blind 50
Klemtonius: posts big blind 100
*** HOLE CARDS ***
Dealt to Duke Croix [2h Kc]
color_singleton: folds 
JeBoyDirk: folds 
MnnM150: calls 100
Duke Croix: calls 50
Klemtonius: checks 
*** FLOP *** [7h 7s Ac]
Duke Croix: checks 
Klemtonius: checks 
MnnM150: checks 
*** TURN *** [7h 7s Ac] [Jd]
Duke Croix: checks 
Klemtonius: checks 
MnnM150: checks 
*** RIVER *** [7h 7s Ac Jd] [9c]
Duke Croix: checks 
Klemtonius: bets 300
MnnM150: raises 300 to 600
Duke Croix: folds 
Klemtonius: calls 300
*** SHOW DOWN ***
MnnM150: shows [Qc Ah] (two pair, Aces and Sevens)
Klemtonius: mucks hand 
MnnM150 collected 1417 from pot
*** SUMMARY ***
Total pot 1500 | Rake 83 
Board [7h 7s Ac Jd 9c]
Seat 1: MnnM150 (button) showed [Qc Ah] and won (1417) with two pair, Aces and Sevens
Seat 3: Duke Croix (small blind) folded on the River
Seat 5: Klemtonius (big blind) mucked [8c 9h]
Seat 8: color_singleton folded before Flop (didn't bet)
Seat 9: JeBoyDirk folded before Flop (didn't bet)



PokerStars Home Game Hand #218759775166: {Club #3225207}  Hold'em No Limit (50/100) - 2020/09/24 15:42:48 ET
Table 'money money' 9-max (Play Money) Seat #3 is the button
Seat 1: MnnM150 (9268 in chips) 
Seat 2: dhduncan (10028 in chips) 
Seat 3: Duke Croix (9149 in chips) 
Seat 5: Klemtonius (4817 in chips) 
Seat 8: color_singleton (7667 in chips) 
Seat 9: JeBoyDirk (30495 in chips) 
Klemtonius: posts small blind 50
color_singleton: posts big blind 100
dhduncan: posts small & big blinds 150
*** HOLE CARDS ***
Dealt to Duke Croix [3d Jh]
JeBoyDirk: folds 
MnnM150: calls 100
dhduncan: checks 
Duke Croix: folds 
Klemtonius: calls 50
color_singleton: checks 
*** FLOP *** [7c 2d Js]
Klemtonius: checks 
color_singleton: checks 
MnnM150: checks 
dhduncan: bets 212
Klemtonius: folds 
color_singleton: folds 
MnnM150: folds 
Uncalled bet (212) returned to dhduncan
dhduncan collected 425 from pot
dhduncan: doesn't show hand 
*** SUMMARY ***
Total pot 450 | Rake 25 
Board [7c 2d Js]
Seat 1: MnnM150 folded on the Flop
Seat 2: dhduncan collected (425)
Seat 3: Duke Croix (button) folded before Flop (didn't bet)
Seat 5: Klemtonius (small blind) folded on the Flop
Seat 8: color_singleton (big blind) folded on the Flop
Seat 9: JeBoyDirk folded before Flop (didn't bet)



PokerStars Home Game Hand #218759797579: {Club #3225207}  Hold'em No Limit (50/100) - 2020/09/24 15:43:27 ET
Table 'money money' 9-max (Play Money) Seat #5 is the button
Seat 1: MnnM150 (9168 in chips) 
Seat 2: dhduncan (10303 in chips) 
Seat 3: Duke Croix (9149 in chips) 
Seat 5: Klemtonius (4717 in chips) 
Seat 8: color_singleton (7567 in chips) 
Seat 9: JeBoyDirk (30495 in chips) 
color_singleton: posts small blind 50
JeBoyDirk: posts big blind 100
*** HOLE CARDS ***
Dealt to Duke Croix [2h 8s]
MnnM150: folds 
dhduncan: calls 100
Duke Croix: folds 
Klemtonius: raises 100 to 200
color_singleton: calls 150
JeBoyDirk: folds 
dhduncan: calls 100
*** FLOP *** [6d Qs 9s]
color_singleton: checks 
dhduncan: checks 
Klemtonius: checks 
*** TURN *** [6d Qs 9s] [6s]
color_singleton: checks 
dhduncan: checks 
Klemtonius: bets 661
color_singleton: folds 
dhduncan: folds 
Uncalled bet (661) returned to Klemtonius
Klemtonius collected 661 from pot
Klemtonius: doesn't show hand 
*** SUMMARY ***
Total pot 700 | Rake 39 
Board [6d Qs 9s 6s]
Seat 1: MnnM150 folded before Flop (didn't bet)
Seat 2: dhduncan folded on the Turn
Seat 3: Duke Croix folded before Flop (didn't bet)
Seat 5: Klemtonius (button) collected (661)
Seat 8: color_singleton (small blind) folded on the Turn
Seat 9: JeBoyDirk (big blind) folded before Flop



PokerStars Home Game Hand #218759820928: {Club #3225207}  Hold'em No Limit (50/100) - 2020/09/24 15:44:07 ET
Table 'money money' 9-max (Play Money) Seat #8 is the button
Seat 1: MnnM150 (9168 in chips) 
Seat 2: dhduncan (10103 in chips) 
Seat 3: Duke Croix (9149 in chips) 
Seat 5: Klemtonius (5178 in chips) 
Seat 8: color_singleton (7367 in chips) 
Seat 9: JeBoyDirk (30395 in chips) 
JeBoyDirk: posts small blind 50
MnnM150: posts big blind 100
*** HOLE CARDS ***
Dealt to Duke Croix [6c Qc]
dhduncan: calls 100
Duke Croix: folds 
Klemtonius: calls 100
color_singleton: calls 100
JeBoyDirk: calls 50
MnnM150: checks 
*** FLOP *** [8c Ks 5c]
JeBoyDirk: checks 
MnnM150: checks 
dhduncan: checks 
Klemtonius: checks 
color_singleton: checks 
*** TURN *** [8c Ks 5c] [6h]
JeBoyDirk: checks 
MnnM150: checks 
dhduncan: checks 
Klemtonius: checks 
color_singleton: checks 
*** RIVER *** [8c Ks 5c 6h] [4c]
JeBoyDirk: checks 
MnnM150: checks 
dhduncan: bets 236
Klemtonius: folds 
color_singleton: raises 464 to 700
JeBoyDirk: folds 
MnnM150: calls 700
dhduncan: folds 
*** SHOW DOWN ***
color_singleton: shows [7h 4h] (a straight, Four to Eight)
MnnM150: shows [7d Ts] (a straight, Four to Eight)
MnnM150 collected 1010 from pot
color_singleton collected 1009 from pot
*** SUMMARY ***
Total pot 2136 | Rake 117 
Board [8c Ks 5c 6h 4c]
Seat 1: MnnM150 (big blind) showed [7d Ts] and won (1010) with a straight, Four to Eight
Seat 2: dhduncan folded on the River
Seat 3: Duke Croix folded before Flop (didn't bet)
Seat 5: Klemtonius folded on the River
Seat 8: color_singleton (button) showed [7h 4h] and won (1009) with a straight, Four to Eight
Seat 9: JeBoyDirk (small blind) folded on the River



PokerStars Home Game Hand #218759861035: {Club #3225207}  Hold'em No Limit (50/100) - 2020/09/24 15:45:17 ET
Table 'money money' 9-max (Play Money) Seat #9 is the button
Seat 1: MnnM150 (9378 in chips) 
Seat 2: dhduncan (9767 in chips) 
Seat 3: Duke Croix (9149 in chips) 
Seat 5: Klemtonius (5078 in chips) 
Seat 8: color_singleton (7576 in chips) 
Seat 9: JeBoyDirk (30295 in chips) 
MnnM150: posts small blind 50
dhduncan: posts big blind 100
*** HOLE CARDS ***
Dealt to Duke Croix [Jd 6s]
Duke Croix: folds 
Klemtonius: folds 
color_singleton: folds 
JeBoyDirk: folds 
MnnM150: calls 50
dhduncan: checks 
*** FLOP *** [Js 9s 7d]
MnnM150: checks 
dhduncan: bets 100
MnnM150: calls 100
*** TURN *** [Js 9s 7d] [Ah]
MnnM150: checks 
dhduncan: checks 
*** RIVER *** [Js 9s 7d Ah] [9c]
MnnM150: bets 378
dhduncan: calls 378
*** SHOW DOWN ***
MnnM150: shows [6c Kh] (a pair of Nines)
dhduncan: shows [7h Qh] (two pair, Nines and Sevens)
dhduncan collected 1092 from pot
*** SUMMARY ***
Total pot 1156 | Rake 64 
Board [Js 9s 7d Ah 9c]
Seat 1: MnnM150 (small blind) showed [6c Kh] and lost with a pair of Nines
Seat 2: dhduncan (big blind) showed [7h Qh] and won (1092) with two pair, Nines and Sevens
Seat 3: Duke Croix folded before Flop (didn't bet)
Seat 5: Klemtonius folded before Flop (didn't bet)
Seat 8: color_singleton folded before Flop (didn't bet)
Seat 9: JeBoyDirk (button) folded before Flop (didn't bet)



PokerStars Home Game Hand #218759883625: {Club #3225207}  Hold'em No Limit (50/100) - 2020/09/24 15:45:55 ET
Table 'money money' 9-max (Play Money) Seat #1 is the button
Seat 1: MnnM150 (8800 in chips) 
Seat 2: dhduncan (10281 in chips) 
Seat 3: Duke Croix (9149 in chips) 
Seat 5: Klemtonius (5078 in chips) 
Seat 8: color_singleton (7576 in chips) 
Seat 9: JeBoyDirk (30295 in chips) 
dhduncan: posts small blind 50
Duke Croix: posts big blind 100
*** HOLE CARDS ***
Dealt to Duke Croix [3h Qs]
Klemtonius: raises 100 to 200
color_singleton: calls 200
JeBoyDirk: folds 
MnnM150: calls 200
dhduncan: calls 150
Duke Croix: calls 100
*** FLOP *** [Tc 6s 7h]
dhduncan: checks 
Duke Croix: checks 
Klemtonius: checks 
color_singleton: checks 
MnnM150: checks 
*** TURN *** [Tc 6s 7h] [8c]
dhduncan: checks 
Duke Croix: checks 
Klemtonius: bets 400
color_singleton: calls 400
MnnM150: folds 
dhduncan: folds 
Duke Croix: folds 
*** RIVER *** [Tc 6s 7h 8c] [Qc]
Klemtonius: bets 1000
color_singleton: folds 
Uncalled bet (1000) returned to Klemtonius
Klemtonius collected 1701 from pot
Klemtonius: doesn't show hand 
*** SUMMARY ***
Total pot 1800 | Rake 99 
Board [Tc 6s 7h 8c Qc]
Seat 1: MnnM150 (button) folded on the Turn
Seat 2: dhduncan (small blind) folded on the Turn
Seat 3: Duke Croix (big blind) folded on the Turn
Seat 5: Klemtonius collected (1701)
Seat 8: color_singleton folded on the River
Seat 9: JeBoyDirk folded before Flop (didn't bet)



PokerStars Home Game Hand #218759914293: {Club #3225207}  Hold'em No Limit (50/100) - 2020/09/24 15:46:49 ET
Table 'money money' 9-max (Play Money) Seat #2 is the button
Seat 1: MnnM150 (8600 in chips) 
Seat 2: dhduncan (10081 in chips) 
Seat 3: Duke Croix (8949 in chips) 
Seat 5: Klemtonius (6179 in chips) 
Seat 8: color_singleton (6976 in chips) 
Seat 9: JeBoyDirk (30295 in chips) 
Duke Croix: posts small blind 50
Klemtonius: posts big blind 100
*** HOLE CARDS ***
Dealt to Duke Croix [As 5c]
color_singleton: folds 
JeBoyDirk: folds 
MnnM150: calls 100
dhduncan: folds 
Duke Croix: calls 50
Klemtonius: checks 
*** FLOP *** [5h 8h 7c]
Duke Croix: checks 
Klemtonius: bets 400
MnnM150: calls 400
Duke Croix: folds 
*** TURN *** [5h 8h 7c] [Tc]
Klemtonius: bets 500
MnnM150: folds 
Uncalled bet (500) returned to Klemtonius
Klemtonius collected 1039 from pot
Klemtonius: doesn't show hand 
*** SUMMARY ***
Total pot 1100 | Rake 61 
Board [5h 8h 7c Tc]
Seat 1: MnnM150 folded on the Turn
Seat 2: dhduncan (button) folded before Flop (didn't bet)
Seat 3: Duke Croix (small blind) folded on the Flop
Seat 5: Klemtonius (big blind) collected (1039)
Seat 8: color_singleton folded before Flop (didn't bet)
Seat 9: JeBoyDirk folded before Flop (didn't bet)



PokerStars Home Game Hand #218759931803: {Club #3225207}  Hold'em No Limit (50/100) - 2020/09/24 15:47:19 ET
Table 'money money' 9-max (Play Money) Seat #3 is the button
Seat 1: MnnM150 (8100 in chips) 
Seat 2: dhduncan (10081 in chips) 
Seat 3: Duke Croix (8849 in chips) 
Seat 5: Klemtonius (6718 in chips) 
Seat 8: color_singleton (6976 in chips) 
Seat 9: JeBoyDirk (30295 in chips) 
Klemtonius: posts small blind 50
color_singleton: posts big blind 100
*** HOLE CARDS ***
Dealt to Duke Croix [Kh 3c]
JeBoyDirk: folds 
MnnM150: calls 100
dhduncan: calls 100
Duke Croix: folds 
Klemtonius: calls 50
color_singleton: checks 
*** FLOP *** [Tc Kc 9c]
Klemtonius: checks 
color_singleton: checks 
MnnM150: bets 378
dhduncan: folds 
Klemtonius: folds 
color_singleton: calls 378
*** TURN *** [Tc Kc 9c] [2h]
color_singleton: checks 
MnnM150: bets 546
color_singleton: raises 546 to 1092
MnnM150: folds 
Uncalled bet (546) returned to color_singleton
color_singleton collected 2124 from pot
color_singleton: doesn't show hand 
*** SUMMARY ***
Total pot 2248 | Rake 124 
Board [Tc Kc 9c 2h]
Seat 1: MnnM150 folded on the Turn
Seat 2: dhduncan folded on the Flop
Seat 3: Duke Croix (button) folded before Flop (didn't bet)
Seat 5: Klemtonius (small blind) folded on the Flop
Seat 8: color_singleton (big blind) collected (2124)
Seat 9: JeBoyDirk folded before Flop (didn't bet)



PokerStars Home Game Hand #218759965709: {Club #3225207}  Hold'em No Limit (50/100) - 2020/09/24 15:48:18 ET
Table 'money money' 9-max (Play Money) Seat #5 is the button
Seat 1: MnnM150 (7076 in chips) 
Seat 2: dhduncan (9981 in chips) 
Seat 3: Duke Croix (8849 in chips) 
Seat 5: Klemtonius (6618 in chips) 
Seat 8: color_singleton (8076 in chips) 
Seat 9: JeBoyDirk (30295 in chips) 
color_singleton: posts small blind 50
JeBoyDirk: posts big blind 100
*** HOLE CARDS ***
Dealt to Duke Croix [7h Jc]
MnnM150: folds 
dhduncan: calls 100
Duke Croix: folds 
Klemtonius: calls 100
color_singleton: calls 50
JeBoyDirk: checks 
*** FLOP *** [Js 8d 6s]
color_singleton: bets 189
JeBoyDirk: folds 
dhduncan: calls 189
Klemtonius: folds 
*** TURN *** [Js 8d 6s] [8c]
color_singleton: checks 
dhduncan: checks 
*** RIVER *** [Js 8d 6s 8c] [Th]
color_singleton: checks 
dhduncan: checks 
*** SHOW DOWN ***
color_singleton: shows [6c 4h] (two pair, Eights and Sixes)
dhduncan: mucks hand 
color_singleton collected 735 from pot
*** SUMMARY ***
Total pot 778 | Rake 43 
Board [Js 8d 6s 8c Th]
Seat 1: MnnM150 folded before Flop (didn't bet)
Seat 2: dhduncan mucked [Ad 3s]
Seat 3: Duke Croix folded before Flop (didn't bet)
Seat 5: Klemtonius (button) folded on the Flop
Seat 8: color_singleton (small blind) showed [6c 4h] and won (735) with two pair, Eights and Sixes
Seat 9: JeBoyDirk (big blind) folded on the Flop



PokerStars Home Game Hand #218759991268: {Club #3225207}  Hold'em No Limit (50/100) - 2020/09/24 15:49:03 ET
Table 'money money' 9-max (Play Money) Seat #8 is the button
Seat 1: MnnM150 (7076 in chips) 
Seat 2: dhduncan (9692 in chips) 
Seat 3: Duke Croix (8849 in chips) 
Seat 5: Klemtonius (6518 in chips) 
Seat 8: color_singleton (8522 in chips) 
Seat 9: JeBoyDirk (30195 in chips) 
JeBoyDirk: posts small blind 50
MnnM150: posts big blind 100
*** HOLE CARDS ***
Dealt to Duke Croix [Qd Js]
dhduncan: calls 100
Duke Croix: raises 300 to 400
Klemtonius: calls 400
color_singleton: calls 400
JeBoyDirk: folds 
MnnM150: folds 
dhduncan: calls 300
*** FLOP *** [8h 4h 6s]
dhduncan: checks 
Duke Croix: checks 
Klemtonius: bets 900
color_singleton: calls 900
dhduncan: folds 
Duke Croix: folds 
*** TURN *** [8h 4h 6s] [5s]
Klemtonius: bets 1300
color_singleton: calls 1300
*** RIVER *** [8h 4h 6s 5s] [6c]
Klemtonius: bets 3918 and is all-in
color_singleton: folds 
Uncalled bet (3918) returned to Klemtonius
Klemtonius collected 5812 from pot
Klemtonius: doesn't show hand 
*** SUMMARY ***
Total pot 6150 | Rake 338 
Board [8h 4h 6s 5s 6c]
Seat 1: MnnM150 (big blind) folded before Flop
Seat 2: dhduncan folded on the Flop
Seat 3: Duke Croix folded on the Flop
Seat 5: Klemtonius collected (5812)
Seat 8: color_singleton (button) folded on the River
Seat 9: JeBoyDirk (small blind) folded before Flop



PokerStars Home Game Hand #218760032237: {Club #3225207}  Hold'em No Limit (50/100) - 2020/09/24 15:50:15 ET
Table 'money money' 9-max (Play Money) Seat #9 is the button
Seat 1: MnnM150 (6976 in chips) 
Seat 2: dhduncan (9292 in chips) 
Seat 3: Duke Croix (8449 in chips) 
Seat 5: Klemtonius (9730 in chips) 
Seat 8: color_singleton (5922 in chips) 
Seat 9: JeBoyDirk (30145 in chips) 
MnnM150: posts small blind 50
dhduncan: posts big blind 100
*** HOLE CARDS ***
Dealt to Duke Croix [Qc 6c]
Duke Croix: folds 
Klemtonius: calls 100
color_singleton: calls 100
JeBoyDirk: folds 
MnnM150: calls 50
dhduncan: checks 
*** FLOP *** [Kh 7s 3h]
MnnM150: bets 189
dhduncan: folds 
Klemtonius: calls 189
color_singleton: calls 189
*** TURN *** [Kh 7s 3h] [Ad]
MnnM150: checks 
Klemtonius: checks 
color_singleton: checks 
*** RIVER *** [Kh 7s 3h Ad] [4c]
MnnM150: bets 914
Klemtonius: folds 
color_singleton: folds 
Uncalled bet (914) returned to MnnM150
MnnM150 collected 914 from pot
*** SUMMARY ***
Total pot 967 | Rake 53 
Board [Kh 7s 3h Ad 4c]
Seat 1: MnnM150 (small blind) collected (914)
Seat 2: dhduncan (big blind) folded on the Flop
Seat 3: Duke Croix folded before Flop (didn't bet)
Seat 5: Klemtonius folded on the River
Seat 8: color_singleton folded on the River
Seat 9: JeBoyDirk (button) folded before Flop (didn't bet)



PokerStars Home Game Hand #218760064891: {Club #3225207}  Hold'em No Limit (50/100) - 2020/09/24 15:51:12 ET
Table 'money money' 9-max (Play Money) Seat #1 is the button
Seat 1: MnnM150 (7601 in chips) 
Seat 2: dhduncan (9192 in chips) 
Seat 3: Duke Croix (8449 in chips) 
Seat 5: Klemtonius (9441 in chips) 
Seat 8: color_singleton (5633 in chips) 
Seat 9: JeBoyDirk (30145 in chips) 
dhduncan: posts small blind 50
Duke Croix: posts big blind 100
*** HOLE CARDS ***
Dealt to Duke Croix [7s 9d]
Klemtonius: folds 
color_singleton: folds 
JeBoyDirk: folds 
MnnM150: calls 100
dhduncan: folds 
Duke Croix: checks 
*** FLOP *** [Tc Qh Qd]
Duke Croix: checks 
MnnM150: checks 
*** TURN *** [Tc Qh Qd] [Kc]
Duke Croix: checks 
MnnM150: checks 
*** RIVER *** [Tc Qh Qd Kc] [2h]
Duke Croix: checks 
MnnM150: bets 236
Duke Croix: folds 
Uncalled bet (236) returned to MnnM150
MnnM150 collected 236 from pot
*** SUMMARY ***
Total pot 250 | Rake 14 
Board [Tc Qh Qd Kc 2h]
Seat 1: MnnM150 (button) collected (236)
Seat 2: dhduncan (small blind) folded before Flop
Seat 3: Duke Croix (big blind) folded on the River
Seat 5: Klemtonius folded before Flop (didn't bet)
Seat 8: color_singleton folded before Flop (didn't bet)
Seat 9: JeBoyDirk folded before Flop (didn't bet)



PokerStars Home Game Hand #218760091056: {Club #3225207}  Hold'em No Limit (50/100) - 2020/09/24 15:51:51 ET
Table 'money money' 9-max (Play Money) Seat #2 is the button
Seat 1: MnnM150 (7737 in chips) 
Seat 2: dhduncan (9142 in chips) 
Seat 3: Duke Croix (8349 in chips) 
Seat 5: Klemtonius (9441 in chips) 
Seat 8: color_singleton (5633 in chips) 
Seat 9: JeBoyDirk (30145 in chips) 
Duke Croix: posts small blind 50
Klemtonius: posts big blind 100
*** HOLE CARDS ***
Dealt to Duke Croix [Th 4d]
color_singleton: folds 
JeBoyDirk: folds 
MnnM150: folds 
dhduncan: folds 
Duke Croix: folds 
Uncalled bet (50) returned to Klemtonius
Klemtonius collected 100 from pot
Klemtonius: doesn't show hand 
*** SUMMARY ***
Total pot 100 | Rake 0 
Seat 1: MnnM150 folded before Flop (didn't bet)
Seat 2: dhduncan (button) folded before Flop (didn't bet)
Seat 3: Duke Croix (small blind) folded before Flop
Seat 5: Klemtonius (big blind) collected (100)
Seat 8: color_singleton folded before Flop (didn't bet)
Seat 9: JeBoyDirk folded before Flop (didn't bet)



PokerStars Home Game Hand #218760103661: {Club #3225207}  Hold'em No Limit (50/100) - 2020/09/24 15:52:13 ET
Table 'money money' 9-max (Play Money) Seat #3 is the button
Seat 1: MnnM150 (7737 in chips) 
Seat 2: dhduncan (9142 in chips) 
Seat 3: Duke Croix (8299 in chips) 
Seat 5: Klemtonius (9491 in chips) 
Seat 8: color_singleton (5633 in chips) 
Seat 9: JeBoyDirk (30145 in chips) 
Klemtonius: posts small blind 50
color_singleton: posts big blind 100
*** HOLE CARDS ***
Dealt to Duke Croix [8h Qs]
JeBoyDirk: folds 
MnnM150: calls 100
dhduncan: calls 100
Duke Croix: calls 100
Klemtonius: raises 300 to 400
color_singleton: folds 
MnnM150: calls 300
dhduncan: folds 
Duke Croix: calls 300
*** FLOP *** [7d 3s Qc]
Klemtonius: bets 100
MnnM150: calls 100
Duke Croix: raises 700 to 800
Klemtonius: folds 
MnnM150: calls 700
*** TURN *** [7d 3s Qc] [Qd]
MnnM150: checks 
Duke Croix: bets 1000
MnnM150: calls 1000
*** RIVER *** [7d 3s Qc Qd] [3h]
MnnM150: checks 
Duke Croix: bets 1000
MnnM150: folds 
Uncalled bet (1000) returned to Duke Croix
Duke Croix collected 4819 from pot
*** SUMMARY ***
Total pot 5100 | Rake 281 
Board [7d 3s Qc Qd 3h]
Seat 1: MnnM150 folded on the River
Seat 2: dhduncan folded before Flop
Seat 3: Duke Croix (button) collected (4819)
Seat 5: Klemtonius (small blind) folded on the Flop
Seat 8: color_singleton (big blind) folded before Flop
Seat 9: JeBoyDirk folded before Flop (didn't bet)



PokerStars Home Game Hand #218760143262: {Club #3225207}  Hold'em No Limit (50/100) - 2020/09/24 15:53:22 ET
Table 'money money' 9-max (Play Money) Seat #5 is the button
Seat 1: MnnM150 (5537 in chips) 
Seat 2: dhduncan (9042 in chips) 
Seat 3: Duke Croix (10918 in chips) 
Seat 5: Klemtonius (8991 in chips) 
Seat 8: color_singleton (5533 in chips) 
Seat 9: JeBoyDirk (30145 in chips) 
color_singleton: posts small blind 50
JeBoyDirk: posts big blind 100
*** HOLE CARDS ***
Dealt to Duke Croix [8d 6d]
MnnM150: folds 
dhduncan: calls 100
Duke Croix: calls 100
Klemtonius: folds 
color_singleton has timed out
color_singleton: folds 
JeBoyDirk: checks 
*** FLOP *** [5h 4h 4d]
JeBoyDirk: checks 
dhduncan: bets 331
Duke Croix: folds 
JeBoyDirk: calls 331
*** TURN *** [5h 4h 4d] [8h]
JeBoyDirk: checks 
dhduncan: bets 100
JeBoyDirk: calls 100
*** RIVER *** [5h 4h 4d 8h] [3h]
JeBoyDirk: checks 
dhduncan: checks 
*** SHOW DOWN ***
JeBoyDirk: shows [Ad 5s] (two pair, Fives and Fours)
dhduncan: mucks hand 
JeBoyDirk collected 1145 from pot
*** SUMMARY ***
Total pot 1212 | Rake 67 
Board [5h 4h 4d 8h 3h]
Seat 1: MnnM150 folded before Flop (didn't bet)
Seat 2: dhduncan mucked [5d 7s]
Seat 3: Duke Croix folded on the Flop
Seat 5: Klemtonius (button) folded before Flop (didn't bet)
Seat 8: color_singleton (small blind) folded before Flop
Seat 9: JeBoyDirk (big blind) showed [Ad 5s] and won (1145) with two pair, Fives and Fours



PokerStars Home Game Hand #218760188279: {Club #3225207}  Hold'em No Limit (50/100) - 2020/09/24 15:54:40 ET
Table 'money money' 9-max (Play Money) Seat #8 is the button
Seat 1: MnnM150 (5537 in chips) 
Seat 2: dhduncan (8511 in chips) 
Seat 3: Duke Croix (10818 in chips) 
Seat 5: Klemtonius (8991 in chips) 
Seat 8: color_singleton (5483 in chips) 
Seat 9: JeBoyDirk (30759 in chips) 
JeBoyDirk: posts small blind 50
MnnM150: posts big blind 100
*** HOLE CARDS ***
Dealt to Duke Croix [As 6c]
dhduncan: calls 100
Duke Croix: calls 100
Klemtonius: calls 100
color_singleton: folds 
JeBoyDirk: calls 50
MnnM150: checks 
*** FLOP *** [Kc Qs Ah]
JeBoyDirk: checks 
MnnM150: checks 
dhduncan: bets 472
Duke Croix: calls 472
Klemtonius: raises 472 to 944
JeBoyDirk: folds 
MnnM150: folds 
dhduncan: folds 
Duke Croix: calls 472
*** TURN *** [Kc Qs Ah] [6h]
Duke Croix: checks 
Klemtonius: bets 2703
Duke Croix: calls 2703
*** RIVER *** [Kc Qs Ah 6h] [Tc]
Duke Croix: checks 
Klemtonius: checks 
*** SHOW DOWN ***
Duke Croix: shows [As 6c] (two pair, Aces and Sixes)
Klemtonius: mucks hand 
Duke Croix collected 7811 from pot
*** SUMMARY ***
Total pot 8266 | Rake 455 
Board [Kc Qs Ah 6h Tc]
Seat 1: MnnM150 (big blind) folded on the Flop
Seat 2: dhduncan folded on the Flop
Seat 3: Duke Croix showed [As 6c] and won (7811) with two pair, Aces and Sixes
Seat 5: Klemtonius mucked [8s Ac]
Seat 8: color_singleton (button) folded before Flop (didn't bet)
Seat 9: JeBoyDirk (small blind) folded on the Flop



PokerStars Home Game Hand #218760222138: {Club #3225207}  Hold'em No Limit (50/100) - 2020/09/24 15:55:51 ET
Table 'money money' 9-max (Play Money) Seat #9 is the button
Seat 1: MnnM150 (5437 in chips) 
Seat 2: dhduncan (7939 in chips) 
Seat 3: Duke Croix (14882 in chips) 
Seat 5: Klemtonius (5244 in chips) 
Seat 8: color_singleton (5483 in chips) 
Seat 9: JeBoyDirk (30659 in chips) 
MnnM150: posts small blind 50
dhduncan: posts big blind 100
*** HOLE CARDS ***
Dealt to Duke Croix [2s Js]
Duke Croix: folds 
Klemtonius: folds 
color_singleton: raises 100 to 200
JeBoyDirk: folds 
MnnM150: folds 
dhduncan: folds 
Uncalled bet (100) returned to color_singleton
color_singleton collected 250 from pot
color_singleton: doesn't show hand 
*** SUMMARY ***
Total pot 250 | Rake 0 
Seat 1: MnnM150 (small blind) folded before Flop
Seat 2: dhduncan (big blind) folded before Flop
Seat 3: Duke Croix folded before Flop (didn't bet)
Seat 5: Klemtonius folded before Flop (didn't bet)
Seat 8: color_singleton collected (250)
Seat 9: JeBoyDirk (button) folded before Flop (didn't bet)



PokerStars Home Game Hand #218760229982: {Club #3225207}  Hold'em No Limit (50/100) - 2020/09/24 15:56:09 ET
Table 'money money' 9-max (Play Money) Seat #1 is the button
Seat 1: MnnM150 (5387 in chips) 
Seat 2: dhduncan (7839 in chips) 
Seat 3: Duke Croix (14882 in chips) 
Seat 5: Klemtonius (5244 in chips) 
Seat 8: color_singleton (5633 in chips) 
Seat 9: JeBoyDirk (30659 in chips) 
dhduncan: posts small blind 50
Duke Croix: posts big blind 100
*** HOLE CARDS ***
Dealt to Duke Croix [Ad 6c]
Klemtonius: raises 100 to 200
color_singleton: folds 
JeBoyDirk: folds 
MnnM150: folds 
dhduncan: folds 
Duke Croix: calls 100
*** FLOP *** [Td Jd 5d]
Duke Croix: bets 300
Klemtonius: calls 300
*** TURN *** [Td Jd 5d] [Ks]
Duke Croix: bets 500
Klemtonius: folds 
Uncalled bet (500) returned to Duke Croix
Duke Croix collected 992 from pot
*** SUMMARY ***
Total pot 1050 | Rake 58 
Board [Td Jd 5d Ks]
Seat 1: MnnM150 (button) folded before Flop (didn't bet)
Seat 2: dhduncan (small blind) folded before Flop
Seat 3: Duke Croix (big blind) collected (992)
Seat 5: Klemtonius folded on the Turn
Seat 8: color_singleton folded before Flop (didn't bet)
Seat 9: JeBoyDirk folded before Flop (didn't bet)



PokerStars Home Game Hand #218760242314: {Club #3225207}  Hold'em No Limit (50/100) - 2020/09/24 15:56:36 ET
Table 'money money' 9-max (Play Money) Seat #2 is the button
Seat 1: MnnM150 (5387 in chips) 
Seat 2: dhduncan (7789 in chips) 
Seat 3: Duke Croix (15374 in chips) 
Seat 5: Klemtonius (4744 in chips) 
Seat 8: color_singleton (5633 in chips) 
Seat 9: JeBoyDirk (30659 in chips) 
Duke Croix: posts small blind 50
Klemtonius: posts big blind 100
*** HOLE CARDS ***
Dealt to Duke Croix [Tc 2s]
color_singleton: raises 200 to 300
JeBoyDirk: calls 300
MnnM150: folds 
dhduncan: folds 
Duke Croix: folds 
Klemtonius: folds 
*** FLOP *** [As 7s 6c]
color_singleton: bets 100
JeBoyDirk: raises 200 to 300
color_singleton: raises 700 to 1000
JeBoyDirk: calls 700
*** TURN *** [As 7s 6c] [7c]
color_singleton: bets 2599
JeBoyDirk: calls 2599
*** RIVER *** [As 7s 6c 7c] [6s]
color_singleton: bets 1734 and is all-in
JeBoyDirk: calls 1734
*** SHOW DOWN ***
color_singleton: shows [Qh Ad] (two pair, Aces and Sevens)
JeBoyDirk: shows [Ac Ts] (two pair, Aces and Sevens - lower kicker)
color_singleton collected 10788 from pot
*** SUMMARY ***
Total pot 11416 | Rake 628 
Board [As 7s 6c 7c 6s]
Seat 1: MnnM150 folded before Flop (didn't bet)
Seat 2: dhduncan (button) folded before Flop (didn't bet)
Seat 3: Duke Croix (small blind) folded before Flop
Seat 5: Klemtonius (big blind) folded before Flop
Seat 8: color_singleton showed [Qh Ad] and won (10788) with two pair, Aces and Sevens
Seat 9: JeBoyDirk showed [Ac Ts] and lost with two pair, Aces and Sevens



PokerStars Home Game Hand #218760276825: {Club #3225207}  Hold'em No Limit (50/100) - 2020/09/24 15:57:54 ET
Table 'money money' 9-max (Play Money) Seat #3 is the button
Seat 1: MnnM150 (5387 in chips) 
Seat 2: dhduncan (7789 in chips) 
Seat 3: Duke Croix (15324 in chips) 
Seat 5: Klemtonius (4644 in chips) 
Seat 8: color_singleton (10788 in chips) 
Seat 9: JeBoyDirk (25026 in chips) 
Klemtonius: posts small blind 50
color_singleton: posts big blind 100
*** HOLE CARDS ***
Dealt to Duke Croix [Td 9c]
JeBoyDirk: folds 
MnnM150: folds 
dhduncan: folds 
Duke Croix: raises 200 to 300
Klemtonius: folds 
color_singleton: calls 200
*** FLOP *** [Ac 6s Qd]
color_singleton: checks 
Duke Croix: checks 
*** TURN *** [Ac 6s Qd] [Qh]
color_singleton: bets 307
Duke Croix: folds 
Uncalled bet (307) returned to color_singleton
color_singleton collected 614 from pot
color_singleton: doesn't show hand 
*** SUMMARY ***
Total pot 650 | Rake 36 
Board [Ac 6s Qd Qh]
Seat 1: MnnM150 folded before Flop (didn't bet)
Seat 2: dhduncan folded before Flop (didn't bet)
Seat 3: Duke Croix (button) folded on the Turn
Seat 5: Klemtonius (small blind) folded before Flop
Seat 8: color_singleton (big blind) collected (614)
Seat 9: JeBoyDirk folded before Flop (didn't bet)



PokerStars Home Game Hand #218760290270: {Club #3225207}  Hold'em No Limit (50/100) - 2020/09/24 15:58:24 ET
Table 'money money' 9-max (Play Money) Seat #5 is the button
Seat 1: MnnM150 (5387 in chips) 
Seat 2: dhduncan (7789 in chips) 
Seat 3: Duke Croix (15024 in chips) 
Seat 5: Klemtonius (4594 in chips) 
Seat 8: color_singleton (11102 in chips) 
Seat 9: JeBoyDirk (25026 in chips) 
color_singleton: posts small blind 50
JeBoyDirk: posts big blind 100
*** HOLE CARDS ***
Dealt to Duke Croix [Kd 4d]
MnnM150: calls 100
dhduncan: calls 100
Duke Croix: folds 
Klemtonius: raises 100 to 200
color_singleton: calls 150
JeBoyDirk: folds 
MnnM150: calls 100
dhduncan: calls 100
*** FLOP *** [7c Qc 6s]
color_singleton: checks 
MnnM150: checks 
dhduncan: checks 
Klemtonius: checks 
*** TURN *** [7c Qc 6s] [8h]
color_singleton: bets 425
MnnM150: calls 425
dhduncan: folds 
Klemtonius: folds 
*** RIVER *** [7c Qc 6s 8h] [5h]
color_singleton: bets 827
MnnM150: raises 827 to 1654
color_singleton: calls 827
*** SHOW DOWN ***
MnnM150: shows [Qd 5s] (two pair, Queens and Fives)
color_singleton: shows [Ks 9d] (a straight, Five to Nine)
color_singleton collected 4780 from pot
*** SUMMARY ***
Total pot 5058 | Rake 278 
Board [7c Qc 6s 8h 5h]
Seat 1: MnnM150 showed [Qd 5s] and lost with two pair, Queens and Fives
Seat 2: dhduncan folded on the Turn
Seat 3: Duke Croix folded before Flop (didn't bet)
Seat 5: Klemtonius (button) folded on the Turn
Seat 8: color_singleton (small blind) showed [Ks 9d] and won (4780) with a straight, Five to Nine
Seat 9: JeBoyDirk (big blind) folded before Flop



PokerStars Home Game Hand #218760318328: {Club #3225207}  Hold'em No Limit (50/100) - 2020/09/24 15:59:27 ET
Table 'money money' 9-max (Play Money) Seat #8 is the button
Seat 1: MnnM150 (3108 in chips) 
Seat 2: dhduncan (7589 in chips) 
Seat 3: Duke Croix (15024 in chips) 
Seat 5: Klemtonius (4394 in chips) 
Seat 8: color_singleton (13603 in chips) 
Seat 9: JeBoyDirk (24926 in chips) 
JeBoyDirk: posts small blind 50
MnnM150: posts big blind 100
*** HOLE CARDS ***
Dealt to Duke Croix [7h Jh]
dhduncan: folds 
Duke Croix: folds 
Klemtonius: raises 500 to 600
color_singleton: folds 
JeBoyDirk: folds 
MnnM150: calls 500
*** FLOP *** [Td 4c 4s]
MnnM150: checks 
Klemtonius: checks 
*** TURN *** [Td 4c 4s] [6c]
MnnM150: checks 
Klemtonius: bets 800
MnnM150: folds 
Uncalled bet (800) returned to Klemtonius
Klemtonius collected 1181 from pot
Klemtonius: doesn't show hand 
*** SUMMARY ***
Total pot 1250 | Rake 69 
Board [Td 4c 4s 6c]
Seat 1: MnnM150 (big blind) folded on the Turn
Seat 2: dhduncan folded before Flop (didn't bet)
Seat 3: Duke Croix folded before Flop (didn't bet)
Seat 5: Klemtonius collected (1181)
Seat 8: color_singleton (button) folded before Flop (didn't bet)
Seat 9: JeBoyDirk (small blind) folded before Flop



PokerStars Home Game Hand #218760331334: {Club #3225207}  Hold'em No Limit (50/100) - 2020/09/24 15:59:56 ET
Table 'money money' 9-max (Play Money) Seat #9 is the button
Seat 1: MnnM150 (2508 in chips) 
Seat 2: dhduncan (7589 in chips) 
Seat 3: Duke Croix (15024 in chips) 
Seat 5: Klemtonius (4975 in chips) 
Seat 8: color_singleton (13603 in chips) 
Seat 9: JeBoyDirk (24876 in chips) 
MnnM150: posts small blind 50
dhduncan: posts big blind 100
*** HOLE CARDS ***
Dealt to Duke Croix [Qd Kd]
Duke Croix: raises 200 to 300
Klemtonius: folds 
color_singleton: folds 
JeBoyDirk: calls 300
MnnM150: folds 
dhduncan: folds 
*** FLOP *** [6d Th Tc]
Duke Croix: checks 
JeBoyDirk: checks 
*** TURN *** [6d Th Tc] [7s]
Duke Croix: checks 
JeBoyDirk: checks 
*** RIVER *** [6d Th Tc 7s] [7h]
Duke Croix: checks 
JeBoyDirk: bets 400
Duke Croix: folds 
Uncalled bet (400) returned to JeBoyDirk
JeBoyDirk collected 709 from pot
*** SUMMARY ***
Total pot 750 | Rake 41 
Board [6d Th Tc 7s 7h]
Seat 1: MnnM150 (small blind) folded before Flop
Seat 2: dhduncan (big blind) folded before Flop
Seat 3: Duke Croix folded on the River
Seat 5: Klemtonius folded before Flop (didn't bet)
Seat 8: color_singleton folded before Flop (didn't bet)
Seat 9: JeBoyDirk (button) collected (709)



PokerStars Home Game Hand #218760347353: {Club #3225207}  Hold'em No Limit (50/100) - 2020/09/24 16:00:30 ET
Table 'money money' 9-max (Play Money) Seat #1 is the button
Seat 1: MnnM150 (2458 in chips) 
Seat 2: dhduncan (7489 in chips) 
Seat 3: Duke Croix (14724 in chips) 
Seat 5: Klemtonius (4975 in chips) 
Seat 8: color_singleton (13603 in chips) 
Seat 9: JeBoyDirk (25285 in chips) 
dhduncan: posts small blind 50
Duke Croix: posts big blind 100
*** HOLE CARDS ***
Dealt to Duke Croix [Jh 7s]
Klemtonius: calls 100
color_singleton: folds 
JeBoyDirk: folds 
MnnM150: calls 100
dhduncan: calls 50
Duke Croix: checks 
*** FLOP *** [5s Kc Qd]
dhduncan: bets 378
Duke Croix: folds 
Klemtonius: folds 
MnnM150: folds 
Uncalled bet (378) returned to dhduncan
dhduncan collected 378 from pot
dhduncan: doesn't show hand 
*** SUMMARY ***
Total pot 400 | Rake 22 
Board [5s Kc Qd]
Seat 1: MnnM150 (button) folded on the Flop
Seat 2: dhduncan (small blind) collected (378)
Seat 3: Duke Croix (big blind) folded on the Flop
Seat 5: Klemtonius folded on the Flop
Seat 8: color_singleton folded before Flop (didn't bet)
Seat 9: JeBoyDirk folded before Flop (didn't bet)



PokerStars Home Game Hand #218760360081: {Club #3225207}  Hold'em No Limit (50/100) - 2020/09/24 16:00:56 ET
Table 'money money' 9-max (Play Money) Seat #2 is the button
Seat 1: MnnM150 (2358 in chips) 
Seat 2: dhduncan (7767 in chips) 
Seat 3: Duke Croix (14624 in chips) 
Seat 5: Klemtonius (4875 in chips) 
Seat 8: color_singleton (13603 in chips) 
Seat 9: JeBoyDirk (25285 in chips) 
Duke Croix: posts small blind 50
Klemtonius: posts big blind 100
*** HOLE CARDS ***
Dealt to Duke Croix [Qh Th]
color_singleton: folds 
JeBoyDirk: folds 
MnnM150: calls 100
dhduncan: folds 
Duke Croix: raises 200 to 300
Klemtonius: calls 200
MnnM150: folds 
*** FLOP *** [Js Ac Qs]
Duke Croix: checks 
Klemtonius: checks 
*** TURN *** [Js Ac Qs] [7c]
Duke Croix: bets 300
Klemtonius: folds 
Uncalled bet (300) returned to Duke Croix
Duke Croix collected 661 from pot
*** SUMMARY ***
Total pot 700 | Rake 39 
Board [Js Ac Qs 7c]
Seat 1: MnnM150 folded before Flop
Seat 2: dhduncan (button) folded before Flop (didn't bet)
Seat 3: Duke Croix (small blind) collected (661)
Seat 5: Klemtonius (big blind) folded on the Turn
Seat 8: color_singleton folded before Flop (didn't bet)
Seat 9: JeBoyDirk folded before Flop (didn't bet)



PokerStars Home Game Hand #218760374499: {Club #3225207}  Hold'em No Limit (50/100) - 2020/09/24 16:01:23 ET
Table 'money money' 9-max (Play Money) Seat #3 is the button
Seat 1: MnnM150 (2258 in chips) 
Seat 2: dhduncan (7767 in chips) 
Seat 3: Duke Croix (14985 in chips) 
Seat 5: Klemtonius (4575 in chips) 
Seat 8: color_singleton (13603 in chips) 
Seat 9: JeBoyDirk (25285 in chips) 
Klemtonius: posts small blind 50
color_singleton: posts big blind 100
*** HOLE CARDS ***
Dealt to Duke Croix [Jh As]
JeBoyDirk: folds 
MnnM150: calls 100
dhduncan: folds 
Duke Croix: raises 300 to 400
Klemtonius: calls 350
color_singleton: calls 300
MnnM150: calls 300
*** FLOP *** [6h 5d 2s]
Klemtonius: checks 
color_singleton: checks 
MnnM150: checks 
Duke Croix: checks 
*** TURN *** [6h 5d 2s] [5s]
Klemtonius: checks 
color_singleton: checks 
MnnM150: checks 
Duke Croix: checks 
*** RIVER *** [6h 5d 2s 5s] [5c]
Klemtonius: checks 
color_singleton: checks 
MnnM150: checks 
Duke Croix: checks 
*** SHOW DOWN ***
Klemtonius: shows [Th 9h] (three of a kind, Fives)
color_singleton: shows [Ac 9c] (three of a kind, Fives - Ace kicker)
MnnM150: shows [Ah Qh] (three of a kind, Fives - Ace+Queen kicker)
Duke Croix: mucks hand 
MnnM150 collected 1512 from pot
*** SUMMARY ***
Total pot 1600 | Rake 88 
Board [6h 5d 2s 5s 5c]
Seat 1: MnnM150 showed [Ah Qh] and won (1512) with three of a kind, Fives
Seat 2: dhduncan folded before Flop (didn't bet)
Seat 3: Duke Croix (button) mucked [Jh As]
Seat 5: Klemtonius (small blind) showed [Th 9h] and lost with three of a kind, Fives
Seat 8: color_singleton (big blind) showed [Ac 9c] and lost with three of a kind, Fives
Seat 9: JeBoyDirk folded before Flop (didn't bet)



PokerStars Home Game Hand #218760397980: {Club #3225207}  Hold'em No Limit (50/100) - 2020/09/24 16:02:06 ET
Table 'money money' 9-max (Play Money) Seat #5 is the button
Seat 1: MnnM150 (3370 in chips) 
Seat 2: dhduncan (7767 in chips) 
Seat 3: Duke Croix (14585 in chips) 
Seat 5: Klemtonius (4175 in chips) 
Seat 8: color_singleton (13203 in chips) 
Seat 9: JeBoyDirk (25285 in chips) 
color_singleton: posts small blind 50
JeBoyDirk: posts big blind 100
*** HOLE CARDS ***
Dealt to Duke Croix [6s As]
MnnM150: calls 100
dhduncan: folds 
Duke Croix: raises 300 to 400
Klemtonius: raises 300 to 700
color_singleton: folds 
JeBoyDirk: raises 300 to 1000
MnnM150: folds 
Duke Croix: folds 
Klemtonius: raises 3175 to 4175 and is all-in
JeBoyDirk: calls 3175
*** FLOP *** [2c Qc Tc]
*** TURN *** [2c Qc Tc] [4c]
*** RIVER *** [2c Qc Tc 4c] [9c]
*** SHOW DOWN ***
JeBoyDirk: shows [Kd Kh] (a flush, Queen high)
Klemtonius: shows [Ks Ah] (a flush, Queen high)
JeBoyDirk collected 4205 from pot
Klemtonius collected 4205 from pot
*** SUMMARY ***
Total pot 8900 | Rake 490 
Board [2c Qc Tc 4c 9c]
Seat 1: MnnM150 folded before Flop
Seat 2: dhduncan folded before Flop (didn't bet)
Seat 3: Duke Croix folded before Flop
Seat 5: Klemtonius (button) showed [Ks Ah] and won (4205) with a flush, Queen high
Seat 8: color_singleton (small blind) folded before Flop
Seat 9: JeBoyDirk (big blind) showed [Kd Kh] and won (4205) with a flush, Queen high



PokerStars Home Game Hand #218760417641: {Club #3225207}  Hold'em No Limit (50/100) - 2020/09/24 16:02:41 ET
Table 'money money' 9-max (Play Money) Seat #8 is the button
Seat 1: MnnM150 (3270 in chips) 
Seat 2: dhduncan (7767 in chips) 
Seat 3: Duke Croix (14185 in chips) 
Seat 5: Klemtonius (4205 in chips) 
Seat 8: color_singleton (13153 in chips) 
Seat 9: JeBoyDirk (25315 in chips) 
JeBoyDirk: posts small blind 50
MnnM150: posts big blind 100
*** HOLE CARDS ***
Dealt to Duke Croix [Jc Jd]
dhduncan: folds 
Duke Croix: raises 300 to 400
Klemtonius: calls 400
color_singleton: raises 500 to 900
JeBoyDirk: folds 
MnnM150: folds 
Duke Croix: calls 500
Klemtonius: folds 
*** FLOP *** [9s Qc 2s]
Duke Croix: checks 
color_singleton: checks 
*** TURN *** [9s Qc 2s] [9h]
Duke Croix: checks 
color_singleton: checks 
*** RIVER *** [9s Qc 2s 9h] [As]
Duke Croix: checks 
color_singleton: bets 1110
Duke Croix: folds 
Uncalled bet (1110) returned to color_singleton
color_singleton collected 2221 from pot
color_singleton: doesn't show hand 
*** SUMMARY ***
Total pot 2350 | Rake 129 
Board [9s Qc 2s 9h As]
Seat 1: MnnM150 (big blind) folded before Flop
Seat 2: dhduncan folded before Flop (didn't bet)
Seat 3: Duke Croix folded on the River
Seat 5: Klemtonius folded before Flop
Seat 8: color_singleton (button) collected (2221)
Seat 9: JeBoyDirk (small blind) folded before Flop



PokerStars Home Game Hand #218760455130: {Club #3225207}  Hold'em No Limit (50/100) - 2020/09/24 16:03:46 ET
Table 'money money' 9-max (Play Money) Seat #9 is the button
Seat 1: MnnM150 (3170 in chips) 
Seat 2: dhduncan (7767 in chips) 
Seat 3: Duke Croix (13285 in chips) 
Seat 8: color_singleton (14474 in chips) 
Seat 9: JeBoyDirk (25265 in chips) 
MnnM150: posts small blind 50
dhduncan: posts big blind 100
*** HOLE CARDS ***
Dealt to Duke Croix [Jc Qc]
Duke Croix: raises 200 to 300
color_singleton: calls 300
JeBoyDirk: folds 
MnnM150: folds 
dhduncan: folds 
*** FLOP *** [Kc 7c 8h]
Duke Croix: bets 400
color_singleton: calls 400
*** TURN *** [Kc 7c 8h] [Jh]
Duke Croix: bets 800
color_singleton: folds 
Uncalled bet (800) returned to Duke Croix
Duke Croix collected 1465 from pot
*** SUMMARY ***
Total pot 1550 | Rake 85 
Board [Kc 7c 8h Jh]
Seat 1: MnnM150 (small blind) folded before Flop
Seat 2: dhduncan (big blind) folded before Flop
Seat 3: Duke Croix collected (1465)
Seat 8: color_singleton folded on the Turn
Seat 9: JeBoyDirk (button) folded before Flop (didn't bet)



PokerStars Home Game Hand #218760467510: {Club #3225207}  Hold'em No Limit (50/100) - 2020/09/24 16:04:08 ET
Table 'money money' 9-max (Play Money) Seat #2 is the button
Seat 2: dhduncan (7667 in chips) 
Seat 3: Duke Croix (14050 in chips) 
Seat 8: color_singleton (13774 in chips) 
Seat 9: JeBoyDirk (25265 in chips) 
Duke Croix: posts small blind 50
color_singleton: posts big blind 100
*** HOLE CARDS ***
Dealt to Duke Croix [Jd Qs]
JeBoyDirk: raises 100 to 200
dhduncan: folds 
Duke Croix: calls 150
color_singleton: calls 100
*** FLOP *** [6s Td Qc]
Duke Croix: bets 300
color_singleton: folds 
JeBoyDirk: calls 300
*** TURN *** [6s Td Qc] [3s]
Duke Croix: bets 600
JeBoyDirk: calls 600
*** RIVER *** [6s Td Qc 3s] [6c]
Duke Croix: bets 1200
JeBoyDirk: calls 1200
*** SHOW DOWN ***
Duke Croix: shows [Jd Qs] (two pair, Queens and Sixes)
JeBoyDirk: mucks hand 
Duke Croix collected 4536 from pot
*** SUMMARY ***
Total pot 4800 | Rake 264 
Board [6s Td Qc 3s 6c]
Seat 2: dhduncan (button) folded before Flop (didn't bet)
Seat 3: Duke Croix (small blind) showed [Jd Qs] and won (4536) with two pair, Queens and Sixes
Seat 8: color_singleton (big blind) folded on the Flop
Seat 9: JeBoyDirk mucked [Ks Ah]



PokerStars Home Game Hand #218760487447: {Club #3225207}  Hold'em No Limit (50/100) - 2020/09/24 16:04:43 ET
Table 'money money' 9-max (Play Money) Seat #3 is the button
Seat 2: dhduncan (7667 in chips) 
Seat 3: Duke Croix (16286 in chips) 
Seat 8: color_singleton (13574 in chips) 
Seat 9: JeBoyDirk (22965 in chips) 
color_singleton: posts small blind 50
JeBoyDirk: posts big blind 100
*** HOLE CARDS ***
Dealt to Duke Croix [Tc 5c]
dhduncan: calls 100
Duke Croix: folds 
color_singleton: raises 100 to 200
JeBoyDirk: calls 100
dhduncan: calls 100
*** FLOP *** [Kd 7c 3h]
color_singleton: bets 283
JeBoyDirk: calls 283
dhduncan: folds 
*** TURN *** [Kd 7c 3h] [2h]
color_singleton: bets 551
JeBoyDirk: calls 551
*** RIVER *** [Kd 7c 3h 2h] [5s]
color_singleton: checks 
JeBoyDirk: bets 1700
color_singleton: folds 
Uncalled bet (1700) returned to JeBoyDirk
JeBoyDirk collected 2143 from pot
*** SUMMARY ***
Total pot 2268 | Rake 125 
Board [Kd 7c 3h 2h 5s]
Seat 2: dhduncan folded on the Flop
Seat 3: Duke Croix (button) folded before Flop (didn't bet)
Seat 8: color_singleton (small blind) folded on the River
Seat 9: JeBoyDirk (big blind) collected (2143)



PokerStars Home Game Hand #218760527025: {Club #3225207}  Hold'em No Limit (50/100) - 2020/09/24 16:05:52 ET
Table 'money money' 9-max (Play Money) Seat #8 is the button
Seat 2: dhduncan (7467 in chips) 
Seat 3: Duke Croix (16286 in chips) 
Seat 8: color_singleton (12540 in chips) 
Seat 9: JeBoyDirk (24074 in chips) 
JeBoyDirk: posts small blind 50
dhduncan: posts big blind 100
*** HOLE CARDS ***
Dealt to Duke Croix [7c Js]
Duke Croix: folds 
color_singleton: folds 
JeBoyDirk: calls 50
dhduncan: checks 
*** FLOP *** [Th Ad 5s]
JeBoyDirk: bets 200
dhduncan: folds 
Uncalled bet (200) returned to JeBoyDirk
JeBoyDirk collected 189 from pot
*** SUMMARY ***
Total pot 200 | Rake 11 
Board [Th Ad 5s]
Seat 2: dhduncan (big blind) folded on the Flop
Seat 3: Duke Croix folded before Flop (didn't bet)
Seat 8: color_singleton (button) folded before Flop (didn't bet)
Seat 9: JeBoyDirk (small blind) collected (189)



PokerStars Home Game Hand #218760536407: {Club #3225207}  Hold'em No Limit (50/100) - 2020/09/24 16:06:08 ET
Table 'money money' 9-max (Play Money) Seat #9 is the button
Seat 2: dhduncan (7367 in chips) 
Seat 3: Duke Croix (16286 in chips) 
Seat 8: color_singleton (12540 in chips) 
Seat 9: JeBoyDirk (24163 in chips) 
dhduncan: posts small blind 50
Duke Croix: posts big blind 100
*** HOLE CARDS ***
Dealt to Duke Croix [Kd 7c]
color_singleton: folds 
JeBoyDirk: folds 
dhduncan: calls 50
Duke Croix: checks 
*** FLOP *** [7s 3h Kh]
dhduncan: checks 
Duke Croix: bets 200
dhduncan: folds 
Uncalled bet (200) returned to Duke Croix
Duke Croix collected 189 from pot
*** SUMMARY ***
Total pot 200 | Rake 11 
Board [7s 3h Kh]
Seat 2: dhduncan (small blind) folded on the Flop
Seat 3: Duke Croix (big blind) collected (189)
Seat 8: color_singleton folded before Flop (didn't bet)
Seat 9: JeBoyDirk (button) folded before Flop (didn't bet)



PokerStars Home Game Hand #218760549164: {Club #3225207}  Hold'em No Limit (50/100) - 2020/09/24 16:06:30 ET
Table 'money money' 9-max (Play Money) Seat #2 is the button
Seat 2: dhduncan (7267 in chips) 
Seat 3: Duke Croix (16375 in chips) 
Seat 8: color_singleton (12540 in chips) 
Seat 9: JeBoyDirk (24163 in chips) 
Duke Croix: posts small blind 50
color_singleton: posts big blind 100
*** HOLE CARDS ***
Dealt to Duke Croix [Ac 2c]
JeBoyDirk: folds 
dhduncan: folds 
Duke Croix: raises 200 to 300
color_singleton: folds 
Uncalled bet (200) returned to Duke Croix
Duke Croix collected 200 from pot
*** SUMMARY ***
Total pot 200 | Rake 0 
Seat 2: dhduncan (button) folded before Flop (didn't bet)
Seat 3: Duke Croix (small blind) collected (200)
Seat 8: color_singleton (big blind) folded before Flop
Seat 9: JeBoyDirk folded before Flop (didn't bet)



PokerStars Home Game Hand #218760554651: {Club #3225207}  Hold'em No Limit (50/100) - 2020/09/24 16:06:40 ET
Table 'money money' 9-max (Play Money) Seat #3 is the button
Seat 2: dhduncan (7267 in chips) 
Seat 3: Duke Croix (16475 in chips) 
Seat 8: color_singleton (12440 in chips) 
Seat 9: JeBoyDirk (24163 in chips) 
color_singleton: posts small blind 50
JeBoyDirk: posts big blind 100
*** HOLE CARDS ***
Dealt to Duke Croix [5s 9s]
dhduncan: folds 
Duke Croix: folds 
color_singleton: raises 100 to 200
JeBoyDirk: calls 100
*** FLOP *** [9c Ts 6s]
color_singleton: bets 200
JeBoyDirk: raises 300 to 500
color_singleton: calls 300
*** TURN *** [9c Ts 6s] [9h]
color_singleton: checks 
JeBoyDirk: bets 1000
color_singleton: calls 1000
*** RIVER *** [9c Ts 6s 9h] [3d]
color_singleton: checks 
JeBoyDirk: bets 2300
color_singleton: folds 
Uncalled bet (2300) returned to JeBoyDirk
JeBoyDirk collected 3213 from pot
*** SUMMARY ***
Total pot 3400 | Rake 187 
Board [9c Ts 6s 9h 3d]
Seat 2: dhduncan folded before Flop (didn't bet)
Seat 3: Duke Croix (button) folded before Flop (didn't bet)
Seat 8: color_singleton (small blind) folded on the River
Seat 9: JeBoyDirk (big blind) collected (3213)



PokerStars Home Game Hand #218760587607: {Club #3225207}  Hold'em No Limit (50/100) - 2020/09/24 16:07:37 ET
Table 'money money' 9-max (Play Money) Seat #8 is the button
Seat 1: MnnM150 (3120 in chips) 
Seat 2: dhduncan (7267 in chips) 
Seat 3: Duke Croix (16475 in chips) 
Seat 8: color_singleton (10740 in chips) 
Seat 9: JeBoyDirk (25676 in chips) 
JeBoyDirk: posts small blind 50
MnnM150: posts big blind 100
*** HOLE CARDS ***
Dealt to Duke Croix [Jd 3d]
dhduncan: calls 100
Duke Croix: folds 
color_singleton: folds 
JeBoyDirk: calls 50
MnnM150: checks 
*** FLOP *** [2s 5h Qc]
JeBoyDirk: checks 
MnnM150: checks 
dhduncan: checks 
*** TURN *** [2s 5h Qc] [Ad]
JeBoyDirk: checks 
MnnM150: checks 
dhduncan: checks 
*** RIVER *** [2s 5h Qc Ad] [9s]
JeBoyDirk: checks 
MnnM150: checks 
dhduncan: checks 
*** SHOW DOWN ***
JeBoyDirk: shows [4s 4h] (a pair of Fours)
MnnM150: shows [9c 3h] (a pair of Nines)
dhduncan: mucks hand 
MnnM150 collected 283 from pot
*** SUMMARY ***
Total pot 300 | Rake 17 
Board [2s 5h Qc Ad 9s]
Seat 1: MnnM150 (big blind) showed [9c 3h] and won (283) with a pair of Nines
Seat 2: dhduncan mucked [Ks 8d]
Seat 3: Duke Croix folded before Flop (didn't bet)
Seat 8: color_singleton (button) folded before Flop (didn't bet)
Seat 9: JeBoyDirk (small blind) showed [4s 4h] and lost with a pair of Fours



PokerStars Home Game Hand #218760607490: {Club #3225207}  Hold'em No Limit (50/100) - 2020/09/24 16:08:12 ET
Table 'money money' 9-max (Play Money) Seat #9 is the button
Seat 1: MnnM150 (3303 in chips) 
Seat 2: dhduncan (7167 in chips) 
Seat 3: Duke Croix (16475 in chips) 
Seat 8: color_singleton (10740 in chips) 
Seat 9: JeBoyDirk (25576 in chips) 
MnnM150: posts small blind 50
dhduncan: posts big blind 100
*** HOLE CARDS ***
Dealt to Duke Croix [Tc 7s]
Duke Croix: folds 
color_singleton: raises 100 to 200
JeBoyDirk: calls 200
MnnM150: calls 150
dhduncan: folds 
*** FLOP *** [2s Ah 4s]
MnnM150: checks 
color_singleton: checks 
JeBoyDirk: bets 300
MnnM150: folds 
color_singleton: folds 
Uncalled bet (300) returned to JeBoyDirk
JeBoyDirk collected 661 from pot
*** SUMMARY ***
Total pot 700 | Rake 39 
Board [2s Ah 4s]
Seat 1: MnnM150 (small blind) folded on the Flop
Seat 2: dhduncan (big blind) folded before Flop
Seat 3: Duke Croix folded before Flop (didn't bet)
Seat 8: color_singleton folded on the Flop
Seat 9: JeBoyDirk (button) collected (661)



PokerStars Home Game Hand #218760631792: {Club #3225207}  Hold'em No Limit (50/100) - 2020/09/24 16:08:44 ET
Table 'money money' 9-max (Play Money) Seat #1 is the button
Seat 1: MnnM150 (3103 in chips) 
Seat 2: dhduncan (7067 in chips) 
Seat 3: Duke Croix (16475 in chips) 
Seat 8: color_singleton (10540 in chips) 
Seat 9: JeBoyDirk (26037 in chips) 
dhduncan: posts small blind 50
Duke Croix: posts big blind 100
*** HOLE CARDS ***
Dealt to Duke Croix [8c 7s]
color_singleton: folds 
JeBoyDirk: folds 
MnnM150: folds 
dhduncan: calls 50
Duke Croix: checks 
*** FLOP *** [Ac 9h 2d]
dhduncan: checks 
Duke Croix: checks 
*** TURN *** [Ac 9h 2d] [5s]
dhduncan: checks 
Duke Croix: checks 
*** RIVER *** [Ac 9h 2d 5s] [Tc]
dhduncan: checks 
Duke Croix: checks 
*** SHOW DOWN ***
dhduncan: shows [Ks 4d] (high card Ace)
Duke Croix: mucks hand 
dhduncan collected 189 from pot
*** SUMMARY ***
Total pot 200 | Rake 11 
Board [Ac 9h 2d 5s Tc]
Seat 1: MnnM150 (button) folded before Flop (didn't bet)
Seat 2: dhduncan (small blind) showed [Ks 4d] and won (189) with high card Ace
Seat 3: Duke Croix (big blind) mucked [8c 7s]
Seat 8: color_singleton folded before Flop (didn't bet)
Seat 9: JeBoyDirk folded before Flop (didn't bet)



PokerStars Home Game Hand #218760648034: {Club #3225207}  Hold'em No Limit (50/100) - 2020/09/24 16:09:12 ET
Table 'money money' 9-max (Play Money) Seat #2 is the button
Seat 1: MnnM150 (3103 in chips) 
Seat 2: dhduncan (7156 in chips) 
Seat 3: Duke Croix (16375 in chips) 
Seat 8: color_singleton (10540 in chips) 
Seat 9: JeBoyDirk (26037 in chips) 
Duke Croix: posts small blind 50
color_singleton: posts big blind 100
*** HOLE CARDS ***
Dealt to Duke Croix [3c 6d]
JeBoyDirk: folds 
MnnM150: calls 100
dhduncan: folds 
Duke Croix: calls 50
color_singleton: raises 100 to 200
MnnM150: calls 100
Duke Croix: calls 100
*** FLOP *** [Th Ks Qs]
Duke Croix: checks 
color_singleton: checks 
MnnM150: checks 
*** TURN *** [Th Ks Qs] [8c]
Duke Croix: checks 
color_singleton: checks 
MnnM150: bets 283
Duke Croix: folds 
color_singleton: calls 283
*** RIVER *** [Th Ks Qs 8c] [Kh]
color_singleton: checks 
MnnM150: bets 1102
color_singleton: folds 
Uncalled bet (1102) returned to MnnM150
MnnM150 collected 1102 from pot
*** SUMMARY ***
Total pot 1166 | Rake 64 
Board [Th Ks Qs 8c Kh]
Seat 1: MnnM150 collected (1102)
Seat 2: dhduncan (button) folded before Flop (didn't bet)
Seat 3: Duke Croix (small blind) folded on the Turn
Seat 8: color_singleton (big blind) folded on the River
Seat 9: JeBoyDirk folded before Flop (didn't bet)



PokerStars Home Game Hand #218760673163: {Club #3225207}  Hold'em No Limit (50/100) - 2020/09/24 16:09:57 ET
Table 'money money' 9-max (Play Money) Seat #3 is the button
Seat 1: MnnM150 (3722 in chips) 
Seat 2: dhduncan (7156 in chips) 
Seat 3: Duke Croix (16175 in chips) 
Seat 8: color_singleton (10057 in chips) 
Seat 9: JeBoyDirk (26037 in chips) 
color_singleton: posts small blind 50
JeBoyDirk: posts big blind 100
*** HOLE CARDS ***
Dealt to Duke Croix [4h As]
MnnM150: calls 100
dhduncan: raises 100 to 200
Duke Croix: folds 
color_singleton: folds 
JeBoyDirk: calls 100
MnnM150: calls 100
*** FLOP *** [6h Tc 3s]
JeBoyDirk: checks 
MnnM150: checks 
dhduncan: checks 
*** TURN *** [6h Tc 3s] [3d]
JeBoyDirk: checks 
MnnM150: checks 
dhduncan: checks 
*** RIVER *** [6h Tc 3s 3d] [Td]
JeBoyDirk: bets 200
MnnM150: folds 
dhduncan: folds 
Uncalled bet (200) returned to JeBoyDirk
JeBoyDirk collected 614 from pot
*** SUMMARY ***
Total pot 650 | Rake 36 
Board [6h Tc 3s 3d Td]
Seat 1: MnnM150 folded on the River
Seat 2: dhduncan folded on the River
Seat 3: Duke Croix (button) folded before Flop (didn't bet)
Seat 8: color_singleton (small blind) folded before Flop
Seat 9: JeBoyDirk (big blind) collected (614)



PokerStars Home Game Hand #218760705363: {Club #3225207}  Hold'em No Limit (50/100) - 2020/09/24 16:10:54 ET
Table 'money money' 9-max (Play Money) Seat #8 is the button
Seat 1: MnnM150 (3522 in chips) 
Seat 2: dhduncan (6956 in chips) 
Seat 3: Duke Croix (16175 in chips) 
Seat 5: Klemtonius (3805 in chips) 
Seat 8: color_singleton (10007 in chips) 
Seat 9: JeBoyDirk (26451 in chips) 
JeBoyDirk: posts small blind 50
MnnM150: posts big blind 100
Klemtonius: posts small & big blinds 150
*** HOLE CARDS ***
Dealt to Duke Croix [Jc 3h]
dhduncan: calls 100
Duke Croix: folds 
Klemtonius: raises 100 to 200
color_singleton: calls 200
JeBoyDirk: folds 
MnnM150: folds 
dhduncan: calls 100
*** FLOP *** [8h Qc Kh]
dhduncan: checks 
Klemtonius: bets 100
color_singleton: calls 100
dhduncan: folds 
*** TURN *** [8h Qc Kh] [9s]
Klemtonius: bets 1100
color_singleton: folds 
Uncalled bet (1100) returned to Klemtonius
Klemtonius collected 945 from pot
Klemtonius: doesn't show hand 
*** SUMMARY ***
Total pot 1000 | Rake 55 
Board [8h Qc Kh 9s]
Seat 1: MnnM150 (big blind) folded before Flop
Seat 2: dhduncan folded on the Flop
Seat 3: Duke Croix folded before Flop (didn't bet)
Seat 5: Klemtonius collected (945)
Seat 8: color_singleton (button) folded on the Turn
Seat 9: JeBoyDirk (small blind) folded before Flop



PokerStars Home Game Hand #218760737585: {Club #3225207}  Hold'em No Limit (50/100) - 2020/09/24 16:11:51 ET
Table 'money money' 9-max (Play Money) Seat #9 is the button
Seat 1: MnnM150 (3422 in chips) 
Seat 2: dhduncan (6756 in chips) 
Seat 3: Duke Croix (16175 in chips) 
Seat 5: Klemtonius (4400 in chips) 
Seat 8: color_singleton (9707 in chips) 
Seat 9: JeBoyDirk (26401 in chips) 
MnnM150: posts small blind 50
dhduncan: posts big blind 100
*** HOLE CARDS ***
Dealt to Duke Croix [3c Jd]
Duke Croix: folds 
Klemtonius: calls 100
color_singleton: folds 
JeBoyDirk: folds 
MnnM150: calls 50
dhduncan: checks 
*** FLOP *** [6c Jh 5c]
MnnM150: checks 
dhduncan: bets 100
Klemtonius: folds 
MnnM150: folds 
Uncalled bet (100) returned to dhduncan
dhduncan collected 283 from pot
dhduncan: doesn't show hand 
*** SUMMARY ***
Total pot 300 | Rake 17 
Board [6c Jh 5c]
Seat 1: MnnM150 (small blind) folded on the Flop
Seat 2: dhduncan (big blind) collected (283)
Seat 3: Duke Croix folded before Flop (didn't bet)
Seat 5: Klemtonius folded on the Flop
Seat 8: color_singleton folded before Flop (didn't bet)
Seat 9: JeBoyDirk (button) folded before Flop (didn't bet)



PokerStars Home Game Hand #218760752694: {Club #3225207}  Hold'em No Limit (50/100) - 2020/09/24 16:12:18 ET
Table 'money money' 9-max (Play Money) Seat #1 is the button
Seat 1: MnnM150 (3322 in chips) 
Seat 2: dhduncan (6939 in chips) 
Seat 3: Duke Croix (16175 in chips) 
Seat 5: Klemtonius (4300 in chips) 
Seat 8: color_singleton (9707 in chips) 
Seat 9: JeBoyDirk (26401 in chips) 
dhduncan: posts small blind 50
Duke Croix: posts big blind 100
*** HOLE CARDS ***
Dealt to Duke Croix [9s Js]
Klemtonius: folds 
color_singleton: calls 100
JeBoyDirk: folds 
MnnM150: calls 100
dhduncan: calls 50
Duke Croix: checks 
*** FLOP *** [2h Jh 5c]
dhduncan: checks 
Duke Croix: bets 200
color_singleton: folds 
MnnM150: calls 200
dhduncan: folds 
*** TURN *** [2h Jh 5c] [Ks]
Duke Croix: bets 400
MnnM150: calls 400
*** RIVER *** [2h Jh 5c Ks] [7h]
Duke Croix: checks 
MnnM150: bets 756
Duke Croix: folds 
Uncalled bet (756) returned to MnnM150
MnnM150 collected 1512 from pot
*** SUMMARY ***
Total pot 1600 | Rake 88 
Board [2h Jh 5c Ks 7h]
Seat 1: MnnM150 (button) collected (1512)
Seat 2: dhduncan (small blind) folded on the Flop
Seat 3: Duke Croix (big blind) folded on the River
Seat 5: Klemtonius folded before Flop (didn't bet)
Seat 8: color_singleton folded on the Flop
Seat 9: JeBoyDirk folded before Flop (didn't bet)



PokerStars Home Game Hand #218760785054: {Club #3225207}  Hold'em No Limit (50/100) - 2020/09/24 16:13:16 ET
Table 'money money' 9-max (Play Money) Seat #2 is the button
Seat 1: MnnM150 (4134 in chips) 
Seat 2: dhduncan (6839 in chips) 
Seat 3: Duke Croix (15475 in chips) 
Seat 5: Klemtonius (4300 in chips) 
Seat 8: color_singleton (9607 in chips) 
Seat 9: JeBoyDirk (26401 in chips) 
Duke Croix: posts small blind 50
Klemtonius: posts big blind 100
*** HOLE CARDS ***
Dealt to Duke Croix [Js 8d]
color_singleton: raises 200 to 300
JeBoyDirk: folds 
MnnM150: calls 300
dhduncan: calls 300
Duke Croix: folds 
Klemtonius: calls 200
*** FLOP *** [Jh 7d 8s]
Klemtonius: bets 900
color_singleton: raises 900 to 1800
MnnM150: folds 
dhduncan: folds 
Klemtonius: raises 2200 to 4000 and is all-in
color_singleton: calls 2200
*** TURN *** [Jh 7d 8s] [Ac]
*** RIVER *** [Jh 7d 8s Ac] [7s]
*** SHOW DOWN ***
Klemtonius: shows [Ks 9s] (a pair of Sevens)
color_singleton: shows [Qd Qc] (two pair, Queens and Sevens)
color_singleton collected 8741 from pot
*** SUMMARY ***
Total pot 9250 | Rake 509 
Board [Jh 7d 8s Ac 7s]
Seat 1: MnnM150 folded on the Flop
Seat 2: dhduncan (button) folded on the Flop
Seat 3: Duke Croix (small blind) folded before Flop
Seat 5: Klemtonius (big blind) showed [Ks 9s] and lost with a pair of Sevens
Seat 8: color_singleton showed [Qd Qc] and won (8741) with two pair, Queens and Sevens
Seat 9: JeBoyDirk folded before Flop (didn't bet)



PokerStars Home Game Hand #218760809184: {Club #3225207}  Hold'em No Limit (50/100) - 2020/09/24 16:13:58 ET
Table 'money money' 9-max (Play Money) Seat #3 is the button
Seat 1: MnnM150 (3834 in chips) 
Seat 2: dhduncan (6539 in chips) 
Seat 3: Duke Croix (15425 in chips) 
Seat 8: color_singleton (14048 in chips) 
Seat 9: JeBoyDirk (26401 in chips) 
color_singleton: posts small blind 50
JeBoyDirk: posts big blind 100
*** HOLE CARDS ***
Dealt to Duke Croix [Jd 8c]
MnnM150: folds 
dhduncan: folds 
Duke Croix: folds 
color_singleton: calls 50
JeBoyDirk: checks 
*** FLOP *** [9s 4s 2s]
color_singleton: checks 
JeBoyDirk: checks 
*** TURN *** [9s 4s 2s] [7d]
color_singleton: bets 100
JeBoyDirk: calls 100
*** RIVER *** [9s 4s 2s 7d] [6h]
color_singleton: bets 378
JeBoyDirk: calls 378
*** SHOW DOWN ***
color_singleton: shows [Th 8h] (a straight, Six to Ten)
JeBoyDirk: mucks hand 
color_singleton collected 1092 from pot
*** SUMMARY ***
Total pot 1156 | Rake 64 
Board [9s 4s 2s 7d 6h]
Seat 1: MnnM150 folded before Flop (didn't bet)
Seat 2: dhduncan folded before Flop (didn't bet)
Seat 3: Duke Croix (button) folded before Flop (didn't bet)
Seat 8: color_singleton (small blind) showed [Th 8h] and won (1092) with a straight, Six to Ten
Seat 9: JeBoyDirk (big blind) mucked [7s Ah]



PokerStars Home Game Hand #218760826567: {Club #3225207}  Hold'em No Limit (50/100) - 2020/09/24 16:14:30 ET
Table 'money money' 9-max (Play Money) Seat #8 is the button
Seat 1: MnnM150 (3834 in chips) 
Seat 2: dhduncan (6539 in chips) 
Seat 3: Duke Croix (15425 in chips) 
Seat 5: Klemtonius (10000 in chips) 
Seat 8: color_singleton (14562 in chips) 
Seat 9: JeBoyDirk (25823 in chips) 
JeBoyDirk: posts small blind 50
MnnM150: posts big blind 100
Klemtonius: posts small blind 50
*** HOLE CARDS ***
Dealt to Duke Croix [5h Qc]
dhduncan: folds 
Duke Croix: folds 
Klemtonius: raises 100 to 200
color_singleton: folds 
JeBoyDirk: calls 150
MnnM150: folds 
*** FLOP *** [7d 4d 8s]
JeBoyDirk: checks 
Klemtonius: bets 900
JeBoyDirk: folds 
Uncalled bet (900) returned to Klemtonius
Klemtonius collected 520 from pot
Klemtonius: doesn't show hand 
*** SUMMARY ***
Total pot 550 | Rake 30 
Board [7d 4d 8s]
Seat 1: MnnM150 (big blind) folded before Flop
Seat 2: dhduncan folded before Flop (didn't bet)
Seat 3: Duke Croix folded before Flop (didn't bet)
Seat 5: Klemtonius collected (520)
Seat 8: color_singleton (button) folded before Flop (didn't bet)
Seat 9: JeBoyDirk (small blind) folded on the Flop



PokerStars Home Game Hand #218760845947: {Club #3225207}  Hold'em No Limit (50/100) - 2020/09/24 16:15:03 ET
Table 'money money' 9-max (Play Money) Seat #9 is the button
Seat 1: MnnM150 (3734 in chips) 
Seat 2: dhduncan (6539 in chips) 
Seat 3: Duke Croix (15425 in chips) 
Seat 5: Klemtonius (10270 in chips) 
Seat 8: color_singleton (14562 in chips) 
Seat 9: JeBoyDirk (25623 in chips) 
MnnM150: posts small blind 50
dhduncan: posts big blind 100
*** HOLE CARDS ***
Dealt to Duke Croix [6s 3s]
Duke Croix: calls 100
Klemtonius: calls 100
color_singleton: raises 100 to 200
JeBoyDirk: folds 
MnnM150: folds 
dhduncan: folds 
Duke Croix: calls 100
Klemtonius: folds 
*** FLOP *** [5d 9c 9s]
Duke Croix: checks 
color_singleton: checks 
*** TURN *** [5d 9c 9s] [3h]
Duke Croix: checks 
color_singleton: checks 
*** RIVER *** [5d 9c 9s 3h] [Ah]
Duke Croix: checks 
color_singleton: checks 
*** SHOW DOWN ***
Duke Croix: shows [6s 3s] (two pair, Nines and Threes)
color_singleton: mucks hand 
Duke Croix collected 614 from pot
*** SUMMARY ***
Total pot 650 | Rake 36 
Board [5d 9c 9s 3h Ah]
Seat 1: MnnM150 (small blind) folded before Flop
Seat 2: dhduncan (big blind) folded before Flop
Seat 3: Duke Croix showed [6s 3s] and won (614) with two pair, Nines and Threes
Seat 5: Klemtonius folded before Flop
Seat 8: color_singleton mucked [8s Kh]
Seat 9: JeBoyDirk (button) folded before Flop (didn't bet)



PokerStars Home Game Hand #218760863703: {Club #3225207}  Hold'em No Limit (50/100) - 2020/09/24 16:15:34 ET
Table 'money money' 9-max (Play Money) Seat #1 is the button
Seat 1: MnnM150 (3684 in chips) 
Seat 2: dhduncan (6439 in chips) 
Seat 3: Duke Croix (15839 in chips) 
Seat 5: Klemtonius (10170 in chips) 
Seat 8: color_singleton (14362 in chips) 
Seat 9: JeBoyDirk (25623 in chips) 
dhduncan: posts small blind 50
Duke Croix: posts big blind 100
*** HOLE CARDS ***
Dealt to Duke Croix [Js 3c]
Klemtonius: calls 100
color_singleton: raises 100 to 200
JeBoyDirk: folds 
MnnM150: calls 200
dhduncan: folds 
Duke Croix: folds 
Klemtonius: calls 100
*** FLOP *** [6c 2c Kd]
Klemtonius: checks 
color_singleton: bets 354
MnnM150: calls 354
Klemtonius: folds 
*** TURN *** [6c 2c Kd] [8d]
color_singleton: checks 
MnnM150: checks 
*** RIVER *** [6c 2c Kd 8d] [3d]
color_singleton: checks 
MnnM150: bets 1378
color_singleton: folds 
Uncalled bet (1378) returned to MnnM150
MnnM150 collected 1378 from pot
*** SUMMARY ***
Total pot 1458 | Rake 80 
Board [6c 2c Kd 8d 3d]
Seat 1: MnnM150 (button) collected (1378)
Seat 2: dhduncan (small blind) folded before Flop
Seat 3: Duke Croix (big blind) folded before Flop
Seat 5: Klemtonius folded on the Flop
Seat 8: color_singleton folded on the River
Seat 9: JeBoyDirk folded before Flop (didn't bet)



PokerStars Home Game Hand #218760897505: {Club #3225207}  Hold'em No Limit (50/100) - 2020/09/24 16:16:32 ET
Table 'money money' 9-max (Play Money) Seat #2 is the button
Seat 1: MnnM150 (4508 in chips) 
Seat 2: dhduncan (6389 in chips) 
Seat 3: Duke Croix (15739 in chips) 
Seat 5: Klemtonius (9970 in chips) 
Seat 8: color_singleton (13808 in chips) 
Seat 9: JeBoyDirk (25623 in chips) 
Duke Croix: posts small blind 50
Klemtonius: posts big blind 100
*** HOLE CARDS ***
Dealt to Duke Croix [Jd Ac]
color_singleton: folds 
JeBoyDirk: folds 
MnnM150: folds 
dhduncan: calls 100
Duke Croix: raises 300 to 400
Klemtonius: raises 300 to 700
dhduncan: folds 
Duke Croix: calls 300
*** FLOP *** [4h Js Kc]
Duke Croix: checks 
Klemtonius: checks 
*** TURN *** [4h Js Kc] [9c]
Duke Croix: bets 700
Klemtonius: calls 700
*** RIVER *** [4h Js Kc 9c] [3h]
Duke Croix: checks 
Klemtonius: checks 
*** SHOW DOWN ***
Duke Croix: shows [Jd Ac] (a pair of Jacks)
Klemtonius: mucks hand 
Duke Croix collected 2740 from pot
*** SUMMARY ***
Total pot 2900 | Rake 160 
Board [4h Js Kc 9c 3h]
Seat 1: MnnM150 folded before Flop (didn't bet)
Seat 2: dhduncan (button) folded before Flop
Seat 3: Duke Croix (small blind) showed [Jd Ac] and won (2740) with a pair of Jacks
Seat 5: Klemtonius (big blind) mucked [7h 7s]
Seat 8: color_singleton folded before Flop (didn't bet)
Seat 9: JeBoyDirk folded before Flop (didn't bet)



PokerStars Home Game Hand #218760918352: {Club #3225207}  Hold'em No Limit (50/100) - 2020/09/24 16:17:08 ET
Table 'money money' 9-max (Play Money) Seat #3 is the button
Seat 1: MnnM150 (4508 in chips) 
Seat 2: dhduncan (6289 in chips) 
Seat 3: Duke Croix (17079 in chips) 
Seat 5: Klemtonius (8570 in chips) 
Seat 8: color_singleton (13808 in chips) 
Seat 9: JeBoyDirk (25623 in chips) 
Klemtonius: posts small blind 50
color_singleton: posts big blind 100
*** HOLE CARDS ***
Dealt to Duke Croix [Ad 3h]
JeBoyDirk: folds 
MnnM150: calls 100
dhduncan: calls 100
Duke Croix: folds 
Klemtonius: folds 
color_singleton: checks 
*** FLOP *** [Kd 7s 9d]
color_singleton: checks 
MnnM150: checks 
dhduncan: checks 
*** TURN *** [Kd 7s 9d] [Td]
color_singleton: checks 
MnnM150: bets 165
dhduncan: calls 165
color_singleton: folds 
*** RIVER *** [Kd 7s 9d Td] [Tc]
MnnM150: bets 643
dhduncan: calls 643
*** SHOW DOWN ***
MnnM150: shows [Jd Qd] (a straight flush, Nine to King)
dhduncan: mucks hand 
MnnM150 collected 1858 from pot
*** SUMMARY ***
Total pot 1966 | Rake 108 
Board [Kd 7s 9d Td Tc]
Seat 1: MnnM150 showed [Jd Qd] and won (1858) with a straight flush, Nine to King
Seat 2: dhduncan mucked [Ts 5s]
Seat 3: Duke Croix (button) folded before Flop (didn't bet)
Seat 5: Klemtonius (small blind) folded before Flop
Seat 8: color_singleton (big blind) folded on the Turn
Seat 9: JeBoyDirk folded before Flop (didn't bet)



PokerStars Home Game Hand #218760941241: {Club #3225207}  Hold'em No Limit (50/100) - 2020/09/24 16:17:48 ET
Table 'money money' 9-max (Play Money) Seat #5 is the button
Seat 1: MnnM150 (5458 in chips) 
Seat 2: dhduncan (5381 in chips) 
Seat 3: Duke Croix (17079 in chips) 
Seat 5: Klemtonius (8520 in chips) 
Seat 8: color_singleton (13708 in chips) 
Seat 9: JeBoyDirk (25623 in chips) 
color_singleton: posts small blind 50
JeBoyDirk: posts big blind 100
*** HOLE CARDS ***
Dealt to Duke Croix [Td 3d]
MnnM150: calls 100
dhduncan: folds 
Duke Croix: folds 
Klemtonius: raises 100 to 200
color_singleton: calls 150
JeBoyDirk: calls 100
MnnM150: calls 100
*** FLOP *** [7d Ks 6c]
color_singleton: checks 
JeBoyDirk: checks 
MnnM150: checks 
Klemtonius: checks 
*** TURN *** [7d Ks 6c] [9d]
color_singleton: checks 
JeBoyDirk: checks 
MnnM150: checks 
Klemtonius: bets 145
color_singleton: folds 
JeBoyDirk: folds 
MnnM150: folds 
Uncalled bet (145) returned to Klemtonius
Klemtonius collected 756 from pot
Klemtonius: doesn't show hand 
*** SUMMARY ***
Total pot 800 | Rake 44 
Board [7d Ks 6c 9d]
Seat 1: MnnM150 folded on the Turn
Seat 2: dhduncan folded before Flop (didn't bet)
Seat 3: Duke Croix folded before Flop (didn't bet)
Seat 5: Klemtonius (button) collected (756)
Seat 8: color_singleton (small blind) folded on the Turn
Seat 9: JeBoyDirk (big blind) folded on the Turn



PokerStars Home Game Hand #218760979038: {Club #3225207}  Hold'em No Limit (50/100) - 2020/09/24 16:18:53 ET
Table 'money money' 9-max (Play Money) Seat #8 is the button
Seat 1: MnnM150 (5258 in chips) 
Seat 2: dhduncan (5381 in chips) 
Seat 3: Duke Croix (17079 in chips) 
Seat 5: Klemtonius (9076 in chips) 
Seat 8: color_singleton (13508 in chips) 
Seat 9: JeBoyDirk (25423 in chips) 
JeBoyDirk: posts small blind 50
MnnM150: posts big blind 100
*** HOLE CARDS ***
Dealt to Duke Croix [6h As]
dhduncan: calls 100
Duke Croix: calls 100
Klemtonius: calls 100
color_singleton: calls 100
JeBoyDirk: folds 
MnnM150: checks 
*** FLOP *** [5c 2d Qc]
MnnM150: checks 
dhduncan: checks 
Duke Croix: checks 
Klemtonius: bets 700
color_singleton: folds 
MnnM150: folds 
dhduncan: folds 
Duke Croix: folds 
Uncalled bet (700) returned to Klemtonius
Klemtonius collected 520 from pot
Klemtonius: doesn't show hand 
*** SUMMARY ***
Total pot 550 | Rake 30 
Board [5c 2d Qc]
Seat 1: MnnM150 (big blind) folded on the Flop
Seat 2: dhduncan folded on the Flop
Seat 3: Duke Croix folded on the Flop
Seat 5: Klemtonius collected (520)
Seat 8: color_singleton (button) folded on the Flop
Seat 9: JeBoyDirk (small blind) folded before Flop



PokerStars Home Game Hand #218760998314: {Club #3225207}  Hold'em No Limit (50/100) - 2020/09/24 16:19:27 ET
Table 'money money' 9-max (Play Money) Seat #9 is the button
Seat 1: MnnM150 (5158 in chips) 
Seat 2: dhduncan (5281 in chips) 
Seat 3: Duke Croix (16979 in chips) 
Seat 5: Klemtonius (9496 in chips) 
Seat 8: color_singleton (13408 in chips) 
Seat 9: JeBoyDirk (25373 in chips) 
MnnM150: posts small blind 50
dhduncan: posts big blind 100
*** HOLE CARDS ***
Dealt to Duke Croix [3d 7h]
Duke Croix: folds 
Klemtonius: raises 100 to 200
color_singleton: folds 
JeBoyDirk: folds 
MnnM150: folds 
dhduncan: folds 
Uncalled bet (100) returned to Klemtonius
Klemtonius collected 250 from pot
*** SUMMARY ***
Total pot 250 | Rake 0 
Seat 1: MnnM150 (small blind) folded before Flop
Seat 2: dhduncan (big blind) folded before Flop
Seat 3: Duke Croix folded before Flop (didn't bet)
Seat 5: Klemtonius collected (250)
Seat 8: color_singleton folded before Flop (didn't bet)
Seat 9: JeBoyDirk (button) folded before Flop (didn't bet)



PokerStars Home Game Hand #218761005596: {Club #3225207}  Hold'em No Limit (50/100) - 2020/09/24 16:19:39 ET
Table 'money money' 9-max (Play Money) Seat #1 is the button
Seat 1: MnnM150 (5108 in chips) 
Seat 2: dhduncan (5181 in chips) 
Seat 3: Duke Croix (16979 in chips) 
Seat 5: Klemtonius (9646 in chips) 
Seat 8: color_singleton (13408 in chips) 
Seat 9: JeBoyDirk (25373 in chips) 
dhduncan: posts small blind 50
Duke Croix: posts big blind 100
*** HOLE CARDS ***
Dealt to Duke Croix [Ah 2h]
Klemtonius: calls 100
color_singleton: folds 
JeBoyDirk: calls 100
MnnM150: calls 100
dhduncan: folds 
Duke Croix: checks 
*** FLOP *** [Jc As Kd]
Duke Croix: bets 200
Klemtonius: folds 
JeBoyDirk: folds 
MnnM150: calls 200
*** TURN *** [Jc As Kd] [Jd]
Duke Croix: bets 400
MnnM150: calls 400
*** RIVER *** [Jc As Kd Jd] [5c]
Duke Croix: bets 800
MnnM150: calls 800
*** SHOW DOWN ***
Duke Croix: shows [Ah 2h] (two pair, Aces and Jacks)
MnnM150: shows [Js 2c] (three of a kind, Jacks)
MnnM150 collected 3071 from pot
*** SUMMARY ***
Total pot 3250 | Rake 179 
Board [Jc As Kd Jd 5c]
Seat 1: MnnM150 (button) showed [Js 2c] and won (3071) with three of a kind, Jacks
Seat 2: dhduncan (small blind) folded before Flop
Seat 3: Duke Croix (big blind) showed [Ah 2h] and lost with two pair, Aces and Jacks
Seat 5: Klemtonius folded on the Flop
Seat 8: color_singleton folded before Flop (didn't bet)
Seat 9: JeBoyDirk folded on the Flop



PokerStars Home Game Hand #218761027559: {Club #3225207}  Hold'em No Limit (50/100) - 2020/09/24 16:20:16 ET
Table 'money money' 9-max (Play Money) Seat #2 is the button
Seat 1: MnnM150 (6679 in chips) 
Seat 2: dhduncan (5131 in chips) 
Seat 3: Duke Croix (15479 in chips) 
Seat 5: Klemtonius (9546 in chips) 
Seat 8: color_singleton (13408 in chips) 
Seat 9: JeBoyDirk (25273 in chips) 
Duke Croix: posts small blind 50
Klemtonius: posts big blind 100
*** HOLE CARDS ***
Dealt to Duke Croix [8s Js]
color_singleton: raises 100 to 200
JeBoyDirk: folds 
MnnM150: calls 200
dhduncan: folds 
Duke Croix: calls 150
Klemtonius: calls 100
*** FLOP *** [5h 7h 3c]
Duke Croix: checks 
Klemtonius: checks 
color_singleton: checks 
MnnM150: bets 378
Duke Croix: folds 
Klemtonius: folds 
color_singleton: calls 378
*** TURN *** [5h 7h 3c] [6c]
color_singleton: checks 
MnnM150: bets 735
color_singleton: raises 735 to 1470
MnnM150: calls 735
*** RIVER *** [5h 7h 3c 6c] [5s]
color_singleton: bets 2124
MnnM150: calls 2124
*** SHOW DOWN ***
color_singleton: shows [Ad 4s] (a straight, Three to Seven)
MnnM150: shows [6d 4d] (a straight, Three to Seven)
color_singleton collected 4132 from pot
MnnM150 collected 4131 from pot
*** SUMMARY ***
Total pot 8744 | Rake 481 
Board [5h 7h 3c 6c 5s]
Seat 1: MnnM150 showed [6d 4d] and won (4131) with a straight, Three to Seven
Seat 2: dhduncan (button) folded before Flop (didn't bet)
Seat 3: Duke Croix (small blind) folded on the Flop
Seat 5: Klemtonius (big blind) folded on the Flop
Seat 8: color_singleton showed [Ad 4s] and won (4132) with a straight, Three to Seven
Seat 9: JeBoyDirk folded before Flop (didn't bet)



PokerStars Home Game Hand #218761060477: {Club #3225207}  Hold'em No Limit (50/100) - 2020/09/24 16:21:12 ET
Table 'money money' 9-max (Play Money) Seat #3 is the button
Seat 1: MnnM150 (6638 in chips) 
Seat 2: dhduncan (5131 in chips) 
Seat 3: Duke Croix (15279 in chips) 
Seat 5: Klemtonius (9346 in chips) 
Seat 8: color_singleton (13368 in chips) 
Seat 9: JeBoyDirk (25273 in chips) 
Klemtonius: posts small blind 50
color_singleton: posts big blind 100
*** HOLE CARDS ***
Dealt to Duke Croix [Jh 8c]
JeBoyDirk: folds 
MnnM150: calls 100
dhduncan: calls 100
Duke Croix: calls 100
Klemtonius: calls 50
color_singleton: checks 
*** FLOP *** [Th 7d 8d]
Klemtonius: checks 
color_singleton: bets 236
MnnM150: folds 
dhduncan: folds 
Duke Croix: calls 236
Klemtonius: calls 236
*** TURN *** [Th 7d 8d] [3h]
Klemtonius: checks 
color_singleton: bets 571
Duke Croix: folds 
Klemtonius: folds 
Uncalled bet (571) returned to color_singleton
color_singleton collected 1142 from pot
color_singleton: doesn't show hand 
*** SUMMARY ***
Total pot 1208 | Rake 66 
Board [Th 7d 8d 3h]
Seat 1: MnnM150 folded on the Flop
Seat 2: dhduncan folded on the Flop
Seat 3: Duke Croix (button) folded on the Turn
Seat 5: Klemtonius (small blind) folded on the Turn
Seat 8: color_singleton (big blind) collected (1142)
Seat 9: JeBoyDirk folded before Flop (didn't bet)



PokerStars Home Game Hand #218761090478: {Club #3225207}  Hold'em No Limit (50/100) - 2020/09/24 16:22:04 ET
Table 'money money' 9-max (Play Money) Seat #5 is the button
Seat 1: MnnM150 (6538 in chips) 
Seat 2: dhduncan (5031 in chips) 
Seat 3: Duke Croix (14943 in chips) 
Seat 5: Klemtonius (9010 in chips) 
Seat 8: color_singleton (14174 in chips) 
Seat 9: JeBoyDirk (25273 in chips) 
color_singleton: posts small blind 50
JeBoyDirk: posts big blind 100
*** HOLE CARDS ***
Dealt to Duke Croix [4s 6h]
MnnM150: calls 100
dhduncan: folds 
Duke Croix: folds 
Klemtonius: folds 
color_singleton: calls 50
JeBoyDirk: checks 
*** FLOP *** [Jh Js 8h]
color_singleton: checks 
JeBoyDirk: checks 
MnnM150: checks 
*** TURN *** [Jh Js 8h] [Qc]
color_singleton: checks 
JeBoyDirk: bets 100
MnnM150: calls 100
color_singleton: folds 
*** RIVER *** [Jh Js 8h Qc] [2h]
JeBoyDirk: bets 100
MnnM150: folds 
Uncalled bet (100) returned to JeBoyDirk
JeBoyDirk collected 472 from pot
*** SUMMARY ***
Total pot 500 | Rake 28 
Board [Jh Js 8h Qc 2h]
Seat 1: MnnM150 folded on the River
Seat 2: dhduncan folded before Flop (didn't bet)
Seat 3: Duke Croix folded before Flop (didn't bet)
Seat 5: Klemtonius (button) folded before Flop (didn't bet)
Seat 8: color_singleton (small blind) folded on the Turn
Seat 9: JeBoyDirk (big blind) collected (472)



PokerStars Home Game Hand #218761117517: {Club #3225207}  Hold'em No Limit (50/100) - 2020/09/24 16:22:50 ET
Table 'money money' 9-max (Play Money) Seat #8 is the button
Seat 1: MnnM150 (6338 in chips) 
Seat 2: dhduncan (5031 in chips) 
Seat 3: Duke Croix (14943 in chips) 
Seat 5: Klemtonius (9010 in chips) 
Seat 8: color_singleton (14074 in chips) 
Seat 9: JeBoyDirk (25545 in chips) 
JeBoyDirk: posts small blind 50
MnnM150: posts big blind 100
*** HOLE CARDS ***
Dealt to Duke Croix [Th Ah]
dhduncan: calls 100
Duke Croix: raises 300 to 400
Klemtonius: calls 400
color_singleton: folds 
JeBoyDirk: folds 
MnnM150: folds 
dhduncan: calls 300
*** FLOP *** [2h 4d 5s]
dhduncan: checks 
Duke Croix: checks 
Klemtonius: bets 600
dhduncan: folds 
Duke Croix: folds 
Uncalled bet (600) returned to Klemtonius
Klemtonius collected 1276 from pot
Klemtonius: doesn't show hand 
*** SUMMARY ***
Total pot 1350 | Rake 74 
Board [2h 4d 5s]
Seat 1: MnnM150 (big blind) folded before Flop
Seat 2: dhduncan folded on the Flop
Seat 3: Duke Croix folded on the Flop
Seat 5: Klemtonius collected (1276)
Seat 8: color_singleton (button) folded before Flop (didn't bet)
Seat 9: JeBoyDirk (small blind) folded before Flop



PokerStars Home Game Hand #218761143247: {Club #3225207}  Hold'em No Limit (50/100) - 2020/09/24 16:23:34 ET
Table 'money money' 9-max (Play Money) Seat #9 is the button
Seat 1: MnnM150 (6238 in chips) 
Seat 2: dhduncan (4631 in chips) 
Seat 3: Duke Croix (14543 in chips) 
Seat 5: Klemtonius (9886 in chips) 
Seat 8: color_singleton (14074 in chips) 
Seat 9: JeBoyDirk (25495 in chips) 
MnnM150: posts small blind 50
dhduncan: posts big blind 100
*** HOLE CARDS ***
Dealt to Duke Croix [Ts 9h]
Duke Croix: calls 100
Klemtonius: calls 100
color_singleton: folds 
JeBoyDirk: raises 200 to 300
MnnM150: folds 
dhduncan: folds 
Duke Croix: calls 200
Klemtonius: folds 
*** FLOP *** [2h 4h 2c]
Duke Croix: checks 
JeBoyDirk: bets 400
Duke Croix: folds 
Uncalled bet (400) returned to JeBoyDirk
JeBoyDirk collected 803 from pot
*** SUMMARY ***
Total pot 850 | Rake 47 
Board [2h 4h 2c]
Seat 1: MnnM150 (small blind) folded before Flop
Seat 2: dhduncan (big blind) folded before Flop
Seat 3: Duke Croix folded on the Flop
Seat 5: Klemtonius folded before Flop
Seat 8: color_singleton folded before Flop (didn't bet)
Seat 9: JeBoyDirk (button) collected (803)



PokerStars Home Game Hand #218761159137: {Club #3225207}  Hold'em No Limit (50/100) - 2020/09/24 16:24:01 ET
Table 'money money' 9-max (Play Money) Seat #1 is the button
Seat 1: MnnM150 (6188 in chips) 
Seat 2: dhduncan (4531 in chips) 
Seat 3: Duke Croix (14243 in chips) 
Seat 5: Klemtonius (9786 in chips) 
Seat 8: color_singleton (14074 in chips) 
Seat 9: JeBoyDirk (25998 in chips) 
dhduncan: posts small blind 50
Duke Croix: posts big blind 100
*** HOLE CARDS ***
Dealt to Duke Croix [Ts 4d]
Klemtonius: raises 100 to 200
color_singleton: folds 
JeBoyDirk: folds 
MnnM150: folds 
dhduncan: folds 
Duke Croix: folds 
Uncalled bet (100) returned to Klemtonius
Klemtonius collected 250 from pot
Klemtonius: doesn't show hand 
*** SUMMARY ***
Total pot 250 | Rake 0 
Seat 1: MnnM150 (button) folded before Flop (didn't bet)
Seat 2: dhduncan (small blind) folded before Flop
Seat 3: Duke Croix (big blind) folded before Flop
Seat 5: Klemtonius collected (250)
Seat 8: color_singleton folded before Flop (didn't bet)
Seat 9: JeBoyDirk folded before Flop (didn't bet)



PokerStars Home Game Hand #218761167090: {Club #3225207}  Hold'em No Limit (50/100) - 2020/09/24 16:24:15 ET
Table 'money money' 9-max (Play Money) Seat #2 is the button
Seat 1: MnnM150 (6188 in chips) 
Seat 2: dhduncan (4481 in chips) 
Seat 3: Duke Croix (14143 in chips) 
Seat 5: Klemtonius (9936 in chips) 
Seat 8: color_singleton (14074 in chips) 
Seat 9: JeBoyDirk (25998 in chips) 
Duke Croix: posts small blind 50
Klemtonius: posts big blind 100
*** HOLE CARDS ***
Dealt to Duke Croix [2h Kh]
color_singleton: folds 
JeBoyDirk: folds 
MnnM150: folds 
dhduncan: calls 100
Duke Croix: calls 50
Klemtonius: raises 100 to 200
dhduncan: calls 100
Duke Croix: calls 100
*** FLOP *** [Ah 7c 2s]
Duke Croix: checks 
Klemtonius: bets 100
dhduncan: calls 100
Duke Croix: calls 100
*** TURN *** [Ah 7c 2s] [6h]
Duke Croix: checks 
Klemtonius: bets 425
dhduncan: folds 
Duke Croix: calls 425
*** RIVER *** [Ah 7c 2s 6h] [6s]
Duke Croix: checks 
Klemtonius: bets 1654
Duke Croix: folds 
Uncalled bet (1654) returned to Klemtonius
Klemtonius collected 1654 from pot
Klemtonius: doesn't show hand 
*** SUMMARY ***
Total pot 1750 | Rake 96 
Board [Ah 7c 2s 6h 6s]
Seat 1: MnnM150 folded before Flop (didn't bet)
Seat 2: dhduncan (button) folded on the Turn
Seat 3: Duke Croix (small blind) folded on the River
Seat 5: Klemtonius (big blind) collected (1654)
Seat 8: color_singleton folded before Flop (didn't bet)
Seat 9: JeBoyDirk folded before Flop (didn't bet)



PokerStars Home Game Hand #218761201895: {Club #3225207}  Hold'em No Limit (50/100) - 2020/09/24 16:25:02 ET
Table 'money money' 9-max (Play Money) Seat #3 is the button
Seat 1: MnnM150 (6188 in chips) 
Seat 2: dhduncan (4181 in chips) 
Seat 3: Duke Croix (13418 in chips) 
Seat 5: Klemtonius (10865 in chips) 
Seat 8: color_singleton (14074 in chips) 
Seat 9: JeBoyDirk (25998 in chips) 
Klemtonius: posts small blind 50
color_singleton: posts big blind 100
*** HOLE CARDS ***
Dealt to Duke Croix [6s 8d]
JeBoyDirk: folds 
MnnM150: calls 100
dhduncan: calls 100
Duke Croix: folds 
Klemtonius: calls 50
color_singleton: checks 
*** FLOP *** [6h Tc 3d]
Klemtonius: checks 
color_singleton: checks 
MnnM150: checks 
dhduncan: checks 
*** TURN *** [6h Tc 3d] [Kh]
Klemtonius: checks 
color_singleton: bets 189
MnnM150: folds 
dhduncan: calls 189
Klemtonius: folds 
*** RIVER *** [6h Tc 3d Kh] [6d]
color_singleton: bets 367
dhduncan: folds 
Uncalled bet (367) returned to color_singleton
color_singleton collected 735 from pot
color_singleton: doesn't show hand 
*** SUMMARY ***
Total pot 778 | Rake 43 
Board [6h Tc 3d Kh 6d]
Seat 1: MnnM150 folded on the Turn
Seat 2: dhduncan folded on the River
Seat 3: Duke Croix (button) folded before Flop (didn't bet)
Seat 5: Klemtonius (small blind) folded on the Turn
Seat 8: color_singleton (big blind) collected (735)
Seat 9: JeBoyDirk folded before Flop (didn't bet)



PokerStars Home Game Hand #218761237919: {Club #3225207}  Hold'em No Limit (50/100) - 2020/09/24 16:26:03 ET
Table 'money money' 9-max (Play Money) Seat #5 is the button
Seat 1: MnnM150 (6088 in chips) 
Seat 2: dhduncan (3892 in chips) 
Seat 3: Duke Croix (13418 in chips) 
Seat 5: Klemtonius (10765 in chips) 
Seat 8: color_singleton (14520 in chips) 
Seat 9: JeBoyDirk (25998 in chips) 
color_singleton: posts small blind 50
JeBoyDirk: posts big blind 100
*** HOLE CARDS ***
Dealt to Duke Croix [5c Kd]
MnnM150: folds 
dhduncan: folds 
Duke Croix: folds 
Klemtonius: calls 100
color_singleton: raises 200 to 300
JeBoyDirk: calls 200
Klemtonius: calls 200
*** FLOP *** [2c Th Qc]
color_singleton: checks 
JeBoyDirk: checks 
Klemtonius: checks 
*** TURN *** [2c Th Qc] [7d]
color_singleton: bets 425
JeBoyDirk: folds 
Klemtonius: folds 
Uncalled bet (425) returned to color_singleton
color_singleton collected 850 from pot
color_singleton: doesn't show hand 
*** SUMMARY ***
Total pot 900 | Rake 50 
Board [2c Th Qc 7d]
Seat 1: MnnM150 folded before Flop (didn't bet)
Seat 2: dhduncan folded before Flop (didn't bet)
Seat 3: Duke Croix folded before Flop (didn't bet)
Seat 5: Klemtonius (button) folded on the Turn
Seat 8: color_singleton (small blind) collected (850)
Seat 9: JeBoyDirk (big blind) folded on the Turn



PokerStars Home Game Hand #218761255140: {Club #3225207}  Hold'em No Limit (50/100) - 2020/09/24 16:26:32 ET
Table 'money money' 9-max (Play Money) Seat #8 is the button
Seat 1: MnnM150 (6088 in chips) 
Seat 2: dhduncan (3892 in chips) 
Seat 3: Duke Croix (13418 in chips) 
Seat 5: Klemtonius (10465 in chips) 
Seat 8: color_singleton (15070 in chips) 
Seat 9: JeBoyDirk (25698 in chips) 
JeBoyDirk: posts small blind 50
MnnM150: posts big blind 100
*** HOLE CARDS ***
Dealt to Duke Croix [Ad 2h]
dhduncan: calls 100
Duke Croix: folds 
Klemtonius: calls 100
color_singleton: calls 100
JeBoyDirk: folds 
MnnM150: checks 
*** FLOP *** [7s Js Jc]
MnnM150: checks 
dhduncan: checks 
Klemtonius: checks 
color_singleton: bets 212
MnnM150: calls 212
dhduncan: folds 
Klemtonius: folds 
*** TURN *** [7s Js Jc] [4c]
MnnM150: checks 
color_singleton: bets 413
MnnM150: folds 
Uncalled bet (413) returned to color_singleton
color_singleton collected 826 from pot
color_singleton: doesn't show hand 
*** SUMMARY ***
Total pot 874 | Rake 48 
Board [7s Js Jc 4c]
Seat 1: MnnM150 (big blind) folded on the Turn
Seat 2: dhduncan folded on the Flop
Seat 3: Duke Croix folded before Flop (didn't bet)
Seat 5: Klemtonius folded on the Flop
Seat 8: color_singleton (button) collected (826)
Seat 9: JeBoyDirk (small blind) folded before Flop



PokerStars Home Game Hand #218761280358: {Club #3225207}  Hold'em No Limit (50/100) - 2020/09/24 16:27:16 ET
Table 'money money' 9-max (Play Money) Seat #9 is the button
Seat 1: MnnM150 (5776 in chips) 
Seat 2: dhduncan (3792 in chips) 
Seat 3: Duke Croix (13418 in chips) 
Seat 5: Klemtonius (10365 in chips) 
Seat 8: color_singleton (15584 in chips) 
Seat 9: JeBoyDirk (25648 in chips) 
MnnM150: posts small blind 50
dhduncan: posts big blind 100
*** HOLE CARDS ***
Dealt to Duke Croix [Kh Td]
Duke Croix: raises 200 to 300
Klemtonius: calls 300
color_singleton: folds 
JeBoyDirk: folds 
MnnM150: calls 250
dhduncan: folds 
*** FLOP *** [4d 7d 5c]
MnnM150: checks 
Duke Croix: checks 
Klemtonius: bets 100
MnnM150: calls 100
Duke Croix: calls 100
*** TURN *** [4d 7d 5c] [Jh]
MnnM150: checks 
Duke Croix: checks 
Klemtonius: bets 500
MnnM150: folds 
Duke Croix: folds 
Uncalled bet (500) returned to Klemtonius
Klemtonius collected 1228 from pot
Klemtonius: doesn't show hand 
*** SUMMARY ***
Total pot 1300 | Rake 72 
Board [4d 7d 5c Jh]
Seat 1: MnnM150 (small blind) folded on the Turn
Seat 2: dhduncan (big blind) folded before Flop
Seat 3: Duke Croix folded on the Turn
Seat 5: Klemtonius collected (1228)
Seat 8: color_singleton folded before Flop (didn't bet)
Seat 9: JeBoyDirk (button) folded before Flop (didn't bet)



PokerStars Home Game Hand #218761302000: {Club #3225207}  Hold'em No Limit (50/100) - 2020/09/24 16:27:53 ET
Table 'money money' 9-max (Play Money) Seat #1 is the button
Seat 1: MnnM150 (5376 in chips) 
Seat 2: dhduncan (3692 in chips) 
Seat 3: Duke Croix (13018 in chips) 
Seat 5: Klemtonius (11193 in chips) 
Seat 8: color_singleton (15584 in chips) 
Seat 9: JeBoyDirk (25648 in chips) 
dhduncan: posts small blind 50
Duke Croix: posts big blind 100
*** HOLE CARDS ***
Dealt to Duke Croix [3d 5c]
Klemtonius: raises 100 to 200
color_singleton: folds 
JeBoyDirk: calls 200
MnnM150: folds 
dhduncan: calls 150
Duke Croix: folds 
*** FLOP *** [8d 5d Js]
dhduncan: checks 
Klemtonius: checks 
JeBoyDirk: checks 
*** TURN *** [8d 5d Js] [Qh]
dhduncan: checks 
Klemtonius: checks 
JeBoyDirk: checks 
*** RIVER *** [8d 5d Js Qh] [7c]
dhduncan: checks 
Klemtonius: checks 
JeBoyDirk: bets 300
dhduncan: calls 300
Klemtonius: calls 300
*** SHOW DOWN ***
JeBoyDirk: shows [6c 9c] (a straight, Five to Nine)
dhduncan: mucks hand 
Klemtonius: mucks hand 
JeBoyDirk collected 1512 from pot
*** SUMMARY ***
Total pot 1600 | Rake 88 
Board [8d 5d Js Qh 7c]
Seat 1: MnnM150 (button) folded before Flop (didn't bet)
Seat 2: dhduncan (small blind) mucked [Kd 5s]
Seat 3: Duke Croix (big blind) folded before Flop
Seat 5: Klemtonius mucked [7h Th]
Seat 8: color_singleton folded before Flop (didn't bet)
Seat 9: JeBoyDirk showed [6c 9c] and won (1512) with a straight, Five to Nine



PokerStars Home Game Hand #218761330853: {Club #3225207}  Hold'em No Limit (50/100) - 2020/09/24 16:28:43 ET
Table 'money money' 9-max (Play Money) Seat #2 is the button
Seat 1: MnnM150 (5376 in chips) 
Seat 2: dhduncan (3192 in chips) 
Seat 3: Duke Croix (12918 in chips) 
Seat 5: Klemtonius (10693 in chips) 
Seat 8: color_singleton (15584 in chips) 
Seat 9: JeBoyDirk (26660 in chips) 
Duke Croix: posts small blind 50
Klemtonius: posts big blind 100
*** HOLE CARDS ***
Dealt to Duke Croix [3c 4c]
color_singleton: folds 
JeBoyDirk: folds 
MnnM150: folds 
dhduncan: folds 
Duke Croix: calls 50
Klemtonius: checks 
*** FLOP *** [3h Kc 4h]
Duke Croix: bets 200
Klemtonius: folds 
Uncalled bet (200) returned to Duke Croix
Duke Croix collected 189 from pot
*** SUMMARY ***
Total pot 200 | Rake 11 
Board [3h Kc 4h]
Seat 1: MnnM150 folded before Flop (didn't bet)
Seat 2: dhduncan (button) folded before Flop (didn't bet)
Seat 3: Duke Croix (small blind) collected (189)
Seat 5: Klemtonius (big blind) folded on the Flop
Seat 8: color_singleton folded before Flop (didn't bet)
Seat 9: JeBoyDirk folded before Flop (didn't bet)



PokerStars Home Game Hand #218761344189: {Club #3225207}  Hold'em No Limit (50/100) - 2020/09/24 16:29:06 ET
Table 'money money' 9-max (Play Money) Seat #3 is the button
Seat 1: MnnM150 (5376 in chips) 
Seat 2: dhduncan (3192 in chips) 
Seat 3: Duke Croix (13007 in chips) 
Seat 5: Klemtonius (10593 in chips) 
Seat 8: color_singleton (15584 in chips) 
Seat 9: JeBoyDirk (26660 in chips) 
Klemtonius: posts small blind 50
color_singleton: posts big blind 100
*** HOLE CARDS ***
Dealt to Duke Croix [Jh Ac]
JeBoyDirk: calls 100
MnnM150: calls 100
dhduncan: raises 100 to 200
Duke Croix: raises 300 to 500
Klemtonius: folds 
color_singleton: calls 400
JeBoyDirk: calls 400
MnnM150: calls 400
dhduncan: raises 300 to 800
Duke Croix: calls 300
color_singleton: calls 300
JeBoyDirk: calls 300
MnnM150: calls 300
*** FLOP *** [Js 3s Qs]
color_singleton: checks 
JeBoyDirk: bets 1100
MnnM150: folds 
dhduncan: raises 1292 to 2392 and is all-in
Duke Croix: folds 
color_singleton: folds 
JeBoyDirk: calls 1292
*** TURN *** [Js 3s Qs] [2h]
*** RIVER *** [Js 3s Qs 2h] [Ah]
*** SHOW DOWN ***
JeBoyDirk: shows [7d Qd] (a pair of Queens)
dhduncan: shows [Kh Kd] (a pair of Kings)
dhduncan collected 8348 from pot
*** SUMMARY ***
Total pot 8834 | Rake 486 
Board [Js 3s Qs 2h Ah]
Seat 1: MnnM150 folded on the Flop
Seat 2: dhduncan showed [Kh Kd] and won (8348) with a pair of Kings
Seat 3: Duke Croix (button) folded on the Flop
Seat 5: Klemtonius (small blind) folded before Flop
Seat 8: color_singleton (big blind) folded on the Flop
Seat 9: JeBoyDirk showed [7d Qd] and lost with a pair of Queens



PokerStars Home Game Hand #218761405604: {Club #3225207}  Hold'em No Limit (50/100) - 2020/09/24 16:30:35 ET
Table 'money money' 9-max (Play Money) Seat #5 is the button
Seat 1: MnnM150 (4576 in chips) 
Seat 2: dhduncan (8348 in chips) 
Seat 3: Duke Croix (12207 in chips) 
Seat 5: Klemtonius (10543 in chips) 
Seat 8: color_singleton (14784 in chips) 
Seat 9: JeBoyDirk (23468 in chips) 
color_singleton: posts small blind 50
JeBoyDirk: posts big blind 100
*** HOLE CARDS ***
Dealt to Duke Croix [3c Qs]
MnnM150: calls 100
dhduncan: calls 100
Duke Croix: raises 300 to 400
Klemtonius: folds 
color_singleton: folds 
JeBoyDirk: calls 300
MnnM150: calls 300
dhduncan: calls 300
*** FLOP *** [2d 8h 6c]
JeBoyDirk: checks 
MnnM150: checks 
dhduncan: checks 
Duke Croix: checks 
*** TURN *** [2d 8h 6c] [3h]
JeBoyDirk: bets 400
MnnM150: folds 
dhduncan: folds 
Duke Croix: folds 
Uncalled bet (400) returned to JeBoyDirk
JeBoyDirk collected 1559 from pot
*** SUMMARY ***
Total pot 1650 | Rake 91 
Board [2d 8h 6c 3h]
Seat 1: MnnM150 folded on the Turn
Seat 2: dhduncan folded on the Turn
Seat 3: Duke Croix folded on the Turn
Seat 5: Klemtonius (button) folded before Flop (didn't bet)
Seat 8: color_singleton (small blind) folded before Flop
Seat 9: JeBoyDirk (big blind) collected (1559)



PokerStars Home Game Hand #218761434525: {Club #3225207}  Hold'em No Limit (50/100) - 2020/09/24 16:31:25 ET
Table 'money money' 9-max (Play Money) Seat #8 is the button
Seat 1: MnnM150 (4176 in chips) 
Seat 2: dhduncan (7948 in chips) 
Seat 3: Duke Croix (11807 in chips) 
Seat 5: Klemtonius (10543 in chips) 
Seat 8: color_singleton (14734 in chips) 
Seat 9: JeBoyDirk (24627 in chips) 
JeBoyDirk: posts small blind 50
MnnM150: posts big blind 100
*** HOLE CARDS ***
Dealt to Duke Croix [4h 4d]
dhduncan: folds 
Duke Croix: raises 200 to 300
Klemtonius: calls 300
color_singleton: calls 300
JeBoyDirk: calls 250
MnnM150: folds 
*** FLOP *** [3h Th 9h]
JeBoyDirk: checks 
Duke Croix: checks 
Klemtonius: bets 1300
color_singleton: folds 
JeBoyDirk: calls 1300
Duke Croix: folds 
*** TURN *** [3h Th 9h] [Jh]
JeBoyDirk: checks 
Klemtonius: checks 
*** RIVER *** [3h Th 9h Jh] [Qh]
JeBoyDirk: checks 
Klemtonius: checks 
*** SHOW DOWN ***
JeBoyDirk: shows [Jd Kh] (a straight flush, Nine to King)
Klemtonius: mucks hand 
JeBoyDirk collected 3685 from pot
*** SUMMARY ***
Total pot 3900 | Rake 215 
Board [3h Th 9h Jh Qh]
Seat 1: MnnM150 (big blind) folded before Flop
Seat 2: dhduncan folded before Flop (didn't bet)
Seat 3: Duke Croix folded on the Flop
Seat 5: Klemtonius mucked [2s 4c]
Seat 8: color_singleton (button) folded on the Flop
Seat 9: JeBoyDirk (small blind) showed [Jd Kh] and won (3685) with a straight flush, Nine to King



PokerStars Home Game Hand #218761480015: {Club #3225207}  Hold'em No Limit (50/100) - 2020/09/24 16:32:43 ET
Table 'money money' 9-max (Play Money) Seat #9 is the button
Seat 1: MnnM150 (4076 in chips) 
Seat 2: dhduncan (7948 in chips) 
Seat 3: Duke Croix (11507 in chips) 
Seat 5: Klemtonius (8943 in chips) 
Seat 8: color_singleton (14434 in chips) 
Seat 9: JeBoyDirk (26712 in chips) 
MnnM150: posts small blind 50
dhduncan: posts big blind 100
*** HOLE CARDS ***
Dealt to Duke Croix [Js 6d]
Duke Croix: calls 100
Klemtonius: raises 900 to 1000
color_singleton: folds 
JeBoyDirk: folds 
MnnM150: folds 
dhduncan: folds 
Duke Croix: folds 
Uncalled bet (900) returned to Klemtonius
Klemtonius collected 350 from pot
Klemtonius: doesn't show hand 
*** SUMMARY ***
Total pot 350 | Rake 0 
Seat 1: MnnM150 (small blind) folded before Flop
Seat 2: dhduncan (big blind) folded before Flop
Seat 3: Duke Croix folded before Flop
Seat 5: Klemtonius collected (350)
Seat 8: color_singleton folded before Flop (didn't bet)
Seat 9: JeBoyDirk (button) folded before Flop (didn't bet)



PokerStars Home Game Hand #218761495159: {Club #3225207}  Hold'em No Limit (50/100) - 2020/09/24 16:33:09 ET
Table 'money money' 9-max (Play Money) Seat #1 is the button
Seat 1: MnnM150 (4026 in chips) 
Seat 2: dhduncan (7848 in chips) 
Seat 3: Duke Croix (11407 in chips) 
Seat 5: Klemtonius (9193 in chips) 
Seat 8: color_singleton (14434 in chips) 
Seat 9: JeBoyDirk (26712 in chips) 
dhduncan: posts small blind 50
Duke Croix: posts big blind 100
*** HOLE CARDS ***
Dealt to Duke Croix [8h Qc]
Klemtonius: raises 100 to 200
color_singleton: folds 
JeBoyDirk: folds 
MnnM150: calls 200
dhduncan: calls 150
Duke Croix: calls 100
*** FLOP *** [6h Ah Kd]
dhduncan: bets 100
Duke Croix: folds 
Klemtonius: raises 100 to 200
MnnM150: calls 200
dhduncan: folds 
*** TURN *** [6h Ah Kd] [8s]
Klemtonius: checks 
MnnM150: checks 
*** RIVER *** [6h Ah Kd 8s] [3s]
Klemtonius: bets 600
MnnM150: folds 
Uncalled bet (600) returned to Klemtonius
Klemtonius collected 1228 from pot
Klemtonius: doesn't show hand 
*** SUMMARY ***
Total pot 1300 | Rake 72 
Board [6h Ah Kd 8s 3s]
Seat 1: MnnM150 (button) folded on the River
Seat 2: dhduncan (small blind) folded on the Flop
Seat 3: Duke Croix (big blind) folded on the Flop
Seat 5: Klemtonius collected (1228)
Seat 8: color_singleton folded before Flop (didn't bet)
Seat 9: JeBoyDirk folded before Flop (didn't bet)



PokerStars Home Game Hand #218761534744: {Club #3225207}  Hold'em No Limit (50/100) - 2020/09/24 16:34:17 ET
Table 'money money' 9-max (Play Money) Seat #2 is the button
Seat 1: MnnM150 (3626 in chips) 
Seat 2: dhduncan (7548 in chips) 
Seat 3: Duke Croix (11207 in chips) 
Seat 5: Klemtonius (10021 in chips) 
Seat 8: color_singleton (14434 in chips) 
Seat 9: JeBoyDirk (26712 in chips) 
Duke Croix: posts small blind 50
Klemtonius: posts big blind 100
*** HOLE CARDS ***
Dealt to Duke Croix [Ah 8s]
color_singleton: raises 200 to 300
JeBoyDirk has timed out
JeBoyDirk: folds 
MnnM150: folds 
dhduncan: folds 
Duke Croix: calls 250
Klemtonius: folds 
*** FLOP *** [8d Jh 5c]
Duke Croix: checks 
color_singleton: checks 
*** TURN *** [8d Jh 5c] [Ks]
Duke Croix: checks 
color_singleton: checks 
*** RIVER *** [8d Jh 5c Ks] [6s]
Duke Croix: bets 300
color_singleton: folds 
Uncalled bet (300) returned to Duke Croix
Duke Croix collected 661 from pot
*** SUMMARY ***
Total pot 700 | Rake 39 
Board [8d Jh 5c Ks 6s]
Seat 1: MnnM150 folded before Flop (didn't bet)
Seat 2: dhduncan (button) folded before Flop (didn't bet)
Seat 3: Duke Croix (small blind) collected (661)
Seat 5: Klemtonius (big blind) folded before Flop
Seat 8: color_singleton folded on the River
Seat 9: JeBoyDirk folded before Flop (didn't bet)



PokerStars Home Game Hand #218761558674: {Club #3225207}  Hold'em No Limit (50/100) - 2020/09/24 16:34:58 ET
Table 'money money' 9-max (Play Money) Seat #3 is the button
Seat 1: MnnM150 (3626 in chips) 
Seat 2: dhduncan (7548 in chips) 
Seat 3: Duke Croix (11568 in chips) 
Seat 5: Klemtonius (9921 in chips) 
Seat 8: color_singleton (14134 in chips) 
Klemtonius: posts small blind 50
color_singleton: posts big blind 100
*** HOLE CARDS ***
Dealt to Duke Croix [6h 7c]
MnnM150: calls 100
dhduncan: calls 100
Duke Croix: calls 100
Klemtonius: calls 50
color_singleton: checks 
*** FLOP *** [5c 6c 6d]
Klemtonius: checks 
color_singleton: checks 
MnnM150: checks 
dhduncan: checks 
Duke Croix: bets 300
Klemtonius: calls 300
color_singleton: folds 
MnnM150: folds 
dhduncan: folds 
*** TURN *** [5c 6c 6d] [5s]
Klemtonius: checks 
Duke Croix: bets 500
Klemtonius: calls 500
*** RIVER *** [5c 6c 6d 5s] [8s]
Klemtonius: checks 
Duke Croix: bets 1200
Klemtonius: folds 
Uncalled bet (1200) returned to Duke Croix
Duke Croix collected 1984 from pot
*** SUMMARY ***
Total pot 2100 | Rake 116 
Board [5c 6c 6d 5s 8s]
Seat 1: MnnM150 folded on the Flop
Seat 2: dhduncan folded on the Flop
Seat 3: Duke Croix (button) collected (1984)
Seat 5: Klemtonius (small blind) folded on the River
Seat 8: color_singleton (big blind) folded on the Flop



PokerStars Home Game Hand #218761585009: {Club #3225207}  Hold'em No Limit (50/100) - 2020/09/24 16:35:44 ET
Table 'money money' 9-max (Play Money) Seat #5 is the button
Seat 1: MnnM150 (3526 in chips) 
Seat 2: dhduncan (7448 in chips) 
Seat 3: Duke Croix (12652 in chips) 
Seat 5: Klemtonius (9021 in chips) 
Seat 8: color_singleton (14034 in chips) 
Seat 9: JeBoyDirk (26712 in chips) 
color_singleton: posts small blind 50
JeBoyDirk: posts big blind 100
*** HOLE CARDS ***
Dealt to Duke Croix [9c Th]
MnnM150: calls 100
dhduncan: calls 100
Duke Croix: calls 100
Klemtonius: calls 100
color_singleton: folds 
JeBoyDirk: checks 
*** FLOP *** [Ad 4d 2c]
JeBoyDirk: checks 
MnnM150: checks 
dhduncan: checks 
Duke Croix: checks 
Klemtonius: checks 
*** TURN *** [Ad 4d 2c] [6c]
JeBoyDirk: checks 
MnnM150: checks 
dhduncan: checks 
Duke Croix: checks 
Klemtonius: bets 300
JeBoyDirk: folds 
MnnM150: folds 
dhduncan: folds 
Duke Croix: folds 
Uncalled bet (300) returned to Klemtonius
Klemtonius collected 520 from pot
Klemtonius: doesn't show hand 
*** SUMMARY ***
Total pot 550 | Rake 30 
Board [Ad 4d 2c 6c]
Seat 1: MnnM150 folded on the Turn
Seat 2: dhduncan folded on the Turn
Seat 3: Duke Croix folded on the Turn
Seat 5: Klemtonius (button) collected (520)
Seat 8: color_singleton (small blind) folded before Flop
Seat 9: JeBoyDirk (big blind) folded on the Turn



PokerStars Home Game Hand #218761620287: {Club #3225207}  Hold'em No Limit (50/100) - 2020/09/24 16:36:45 ET
Table 'money money' 9-max (Play Money) Seat #8 is the button
Seat 1: MnnM150 (3426 in chips) 
Seat 2: dhduncan (7348 in chips) 
Seat 3: Duke Croix (12552 in chips) 
Seat 5: Klemtonius (9441 in chips) 
Seat 8: color_singleton (13984 in chips) 
Seat 9: JeBoyDirk (26612 in chips) 
JeBoyDirk: posts small blind 50
MnnM150: posts big blind 100
*** HOLE CARDS ***
Dealt to Duke Croix [9h 3d]
dhduncan: calls 100
Duke Croix: folds 
Klemtonius: calls 100
color_singleton: raises 100 to 200
JeBoyDirk: folds 
MnnM150: calls 100
dhduncan: calls 100
Klemtonius: calls 100
*** FLOP *** [Th 2c 9s]
MnnM150: checks 
dhduncan: checks 
Klemtonius: bets 700
color_singleton: folds 
MnnM150: folds 
dhduncan: folds 
Uncalled bet (700) returned to Klemtonius
Klemtonius collected 803 from pot
Klemtonius: doesn't show hand 
*** SUMMARY ***
Total pot 850 | Rake 47 
Board [Th 2c 9s]
Seat 1: MnnM150 (big blind) folded on the Flop
Seat 2: dhduncan folded on the Flop
Seat 3: Duke Croix folded before Flop (didn't bet)
Seat 5: Klemtonius collected (803)
Seat 8: color_singleton (button) folded on the Flop
Seat 9: JeBoyDirk (small blind) folded before Flop



PokerStars Home Game Hand #218761636653: {Club #3225207}  Hold'em No Limit (50/100) - 2020/09/24 16:37:14 ET
Table 'money money' 9-max (Play Money) Seat #9 is the button
Seat 1: MnnM150 (3226 in chips) 
Seat 2: dhduncan (7148 in chips) 
Seat 3: Duke Croix (12552 in chips) 
Seat 5: Klemtonius (10044 in chips) 
Seat 8: color_singleton (13784 in chips) 
Seat 9: JeBoyDirk (26562 in chips) 
MnnM150: posts small blind 50
dhduncan: posts big blind 100
*** HOLE CARDS ***
Dealt to Duke Croix [3d 6h]
Duke Croix: folds 
Klemtonius: raises 300 to 400
color_singleton: folds 
JeBoyDirk: folds 
MnnM150: calls 350
dhduncan: folds 
*** FLOP *** [8s As Qd]
MnnM150: checks 
Klemtonius: bets 1100
MnnM150: folds 
Uncalled bet (1100) returned to Klemtonius
Klemtonius collected 850 from pot
Klemtonius: doesn't show hand 
*** SUMMARY ***
Total pot 900 | Rake 50 
Board [8s As Qd]
Seat 1: MnnM150 (small blind) folded on the Flop
Seat 2: dhduncan (big blind) folded before Flop
Seat 3: Duke Croix folded before Flop (didn't bet)
Seat 5: Klemtonius collected (850)
Seat 8: color_singleton folded before Flop (didn't bet)
Seat 9: JeBoyDirk (button) folded before Flop (didn't bet)



PokerStars Home Game Hand #218761649352: {Club #3225207}  Hold'em No Limit (50/100) - 2020/09/24 16:37:36 ET
Table 'money money' 9-max (Play Money) Seat #1 is the button
Seat 1: MnnM150 (2826 in chips) 
Seat 2: dhduncan (7048 in chips) 
Seat 3: Duke Croix (12552 in chips) 
Seat 5: Klemtonius (10494 in chips) 
Seat 8: color_singleton (13784 in chips) 
Seat 9: JeBoyDirk (26562 in chips) 
dhduncan: posts small blind 50
Duke Croix: posts big blind 100
*** HOLE CARDS ***
Dealt to Duke Croix [8c 2h]
Klemtonius: folds 
color_singleton: folds 
JeBoyDirk: folds 
MnnM150: calls 100
dhduncan: folds 
Duke Croix has timed out
Duke Croix: checks 
*** FLOP *** [Ks Th 3s]
Duke Croix has timed out
Duke Croix: checks 
MnnM150: bets 236
Duke Croix: folds 
Uncalled bet (236) returned to MnnM150
MnnM150 collected 236 from pot
*** SUMMARY ***
Total pot 250 | Rake 14 
Board [Ks Th 3s]
Seat 1: MnnM150 (button) collected (236)
Seat 2: dhduncan (small blind) folded before Flop
Seat 3: Duke Croix (big blind) folded on the Flop
Seat 5: Klemtonius folded before Flop (didn't bet)
Seat 8: color_singleton folded before Flop (didn't bet)
Seat 9: JeBoyDirk folded before Flop (didn't bet)



PokerStars Home Game Hand #218761682501: {Club #3225207}  Hold'em No Limit (50/100) - 2020/09/24 16:38:34 ET
Table 'money money' 9-max (Play Money) Seat #2 is the button
Seat 1: MnnM150 (2962 in chips) 
Seat 2: dhduncan (6998 in chips) 
Seat 3: Duke Croix (12452 in chips) 
Seat 5: Klemtonius (10494 in chips) 
Seat 8: color_singleton (13784 in chips) 
Seat 9: JeBoyDirk (26562 in chips) 
Duke Croix: posts small blind 50
Klemtonius: posts big blind 100
*** HOLE CARDS ***
Dealt to Duke Croix [Jh 5h]
color_singleton: folds 
JeBoyDirk: calls 100
MnnM150: calls 100
dhduncan: calls 100
Duke Croix: calls 50
Klemtonius: checks 
*** FLOP *** [4s 4d 2s]
Duke Croix: checks 
Klemtonius: checks 
JeBoyDirk: checks 
MnnM150: checks 
dhduncan: checks 
*** TURN *** [4s 4d 2s] [8s]
Duke Croix: checks 
Klemtonius: bets 300
JeBoyDirk: calls 300
MnnM150: folds 
dhduncan: calls 300
Duke Croix: folds 
*** RIVER *** [4s 4d 2s 8s] [4c]
Klemtonius: checks 
JeBoyDirk: bets 800
dhduncan: folds 
Klemtonius: raises 800 to 1600
JeBoyDirk: calls 800
*** SHOW DOWN ***
Klemtonius: shows [4h Kh] (four of a kind, Fours)
JeBoyDirk: mucks hand 
Klemtonius collected 4347 from pot
*** SUMMARY ***
Total pot 4600 | Rake 253 
Board [4s 4d 2s 8s 4c]
Seat 1: MnnM150 folded on the Turn
Seat 2: dhduncan (button) folded on the River
Seat 3: Duke Croix (small blind) folded on the Turn
Seat 5: Klemtonius (big blind) showed [4h Kh] and won (4347) with four of a kind, Fours
Seat 8: color_singleton folded before Flop (didn't bet)
Seat 9: JeBoyDirk mucked [Jd 8d]



PokerStars Home Game Hand #218761734074: {Club #3225207}  Hold'em No Limit (50/100) - 2020/09/24 16:40:05 ET
Table 'money money' 9-max (Play Money) Seat #3 is the button
Seat 1: MnnM150 (2862 in chips) 
Seat 2: dhduncan (6598 in chips) 
Seat 3: Duke Croix (12352 in chips) 
Seat 5: Klemtonius (12841 in chips) 
Seat 8: color_singleton (13784 in chips) 
Seat 9: JeBoyDirk (24562 in chips) 
Klemtonius: posts small blind 50
color_singleton: posts big blind 100
*** HOLE CARDS ***
Dealt to Duke Croix [3c Kc]
JeBoyDirk: folds 
MnnM150: folds 
dhduncan: folds 
Duke Croix: folds 
Klemtonius: calls 50
color_singleton: checks 
*** FLOP *** [7c Jc Td]
Klemtonius: checks 
color_singleton: bets 189
Klemtonius: calls 189
*** TURN *** [7c Jc Td] [6h]
Klemtonius: checks 
color_singleton: bets 273
Klemtonius: folds 
Uncalled bet (273) returned to color_singleton
color_singleton collected 546 from pot
color_singleton: doesn't show hand 
*** SUMMARY ***
Total pot 578 | Rake 32 
Board [7c Jc Td 6h]
Seat 1: MnnM150 folded before Flop (didn't bet)
Seat 2: dhduncan folded before Flop (didn't bet)
Seat 3: Duke Croix (button) folded before Flop (didn't bet)
Seat 5: Klemtonius (small blind) folded on the Turn
Seat 8: color_singleton (big blind) collected (546)
Seat 9: JeBoyDirk folded before Flop (didn't bet)



PokerStars Home Game Hand #218761771747: {Club #3225207}  Hold'em No Limit (50/100) - 2020/09/24 16:41:11 ET
Table 'money money' 9-max (Play Money) Seat #5 is the button
Seat 1: MnnM150 (2862 in chips) 
Seat 2: dhduncan (6598 in chips) 
Seat 3: Duke Croix (12352 in chips) 
Seat 5: Klemtonius (12552 in chips) 
Seat 8: color_singleton (14041 in chips) 
Seat 9: JeBoyDirk (24562 in chips) 
color_singleton: posts small blind 50
JeBoyDirk: posts big blind 100
*** HOLE CARDS ***
Dealt to Duke Croix [4d 9c]
MnnM150: calls 100
dhduncan: calls 100
Duke Croix: folds 
Klemtonius: calls 100
color_singleton: raises 100 to 200
JeBoyDirk: calls 100
MnnM150: calls 100
dhduncan: calls 100
Klemtonius: calls 100
*** FLOP *** [Ks 4h Qc]
color_singleton: bets 472
JeBoyDirk: folds 
MnnM150: folds 
dhduncan: folds 
Klemtonius: folds 
Uncalled bet (472) returned to color_singleton
color_singleton collected 945 from pot
color_singleton: doesn't show hand 
*** SUMMARY ***
Total pot 1000 | Rake 55 
Board [Ks 4h Qc]
Seat 1: MnnM150 folded on the Flop
Seat 2: dhduncan folded on the Flop
Seat 3: Duke Croix folded before Flop (didn't bet)
Seat 5: Klemtonius (button) folded on the Flop
Seat 8: color_singleton (small blind) collected (945)
Seat 9: JeBoyDirk (big blind) folded on the Flop



PokerStars Home Game Hand #218761804497: {Club #3225207}  Hold'em No Limit (50/100) - 2020/09/24 16:42:09 ET
Table 'money money' 9-max (Play Money) Seat #8 is the button
Seat 1: MnnM150 (2662 in chips) 
Seat 2: dhduncan (6398 in chips) 
Seat 3: Duke Croix (12352 in chips) 
Seat 5: Klemtonius (12352 in chips) 
Seat 8: color_singleton (14786 in chips) 
Seat 9: JeBoyDirk (24362 in chips) 
JeBoyDirk: posts small blind 50
MnnM150: posts big blind 100
*** HOLE CARDS ***
Dealt to Duke Croix [5s 5h]
dhduncan: raises 100 to 200
Duke Croix: raises 200 to 400
Klemtonius: folds 
color_singleton: folds 
JeBoyDirk: folds 
MnnM150: folds 
dhduncan: calls 200
*** FLOP *** [8h Js 4c]
dhduncan: checks 
Duke Croix: bets 400
dhduncan: folds 
Uncalled bet (400) returned to Duke Croix
Duke Croix collected 898 from pot
*** SUMMARY ***
Total pot 950 | Rake 52 
Board [8h Js 4c]
Seat 1: MnnM150 (big blind) folded before Flop
Seat 2: dhduncan folded on the Flop
Seat 3: Duke Croix collected (898)
Seat 5: Klemtonius folded before Flop (didn't bet)
Seat 8: color_singleton (button) folded before Flop (didn't bet)
Seat 9: JeBoyDirk (small blind) folded before Flop



PokerStars Home Game Hand #218761822967: {Club #3225207}  Hold'em No Limit (50/100) - 2020/09/24 16:42:42 ET
Table 'money money' 9-max (Play Money) Seat #9 is the button
Seat 1: MnnM150 (2562 in chips) 
Seat 2: dhduncan (5998 in chips) 
Seat 3: Duke Croix (12850 in chips) 
Seat 5: Klemtonius (12352 in chips) 
Seat 8: color_singleton (14786 in chips) 
Seat 9: JeBoyDirk (24312 in chips) 
MnnM150: posts small blind 50
dhduncan: posts big blind 100
*** HOLE CARDS ***
Dealt to Duke Croix [2s 5c]
Duke Croix: folds 
Klemtonius: calls 100
color_singleton: raises 300 to 400
JeBoyDirk: calls 400
MnnM150: folds 
dhduncan: folds 
Klemtonius: calls 300
*** FLOP *** [Ac Jh 3h]
Klemtonius: checks 
color_singleton: checks 
JeBoyDirk: bets 800
Klemtonius: folds 
color_singleton: folds 
Uncalled bet (800) returned to JeBoyDirk
JeBoyDirk collected 1276 from pot
*** SUMMARY ***
Total pot 1350 | Rake 74 
Board [Ac Jh 3h]
Seat 1: MnnM150 (small blind) folded before Flop
Seat 2: dhduncan (big blind) folded before Flop
Seat 3: Duke Croix folded before Flop (didn't bet)
Seat 5: Klemtonius folded on the Flop
Seat 8: color_singleton folded on the Flop
Seat 9: JeBoyDirk (button) collected (1276)



PokerStars Home Game Hand #218761848849: {Club #3225207}  Hold'em No Limit (50/100) - 2020/09/24 16:43:27 ET
Table 'money money' 9-max (Play Money) Seat #1 is the button
Seat 1: MnnM150 (2512 in chips) 
Seat 2: dhduncan (5898 in chips) 
Seat 3: Duke Croix (12850 in chips) 
Seat 5: Klemtonius (11952 in chips) 
Seat 8: color_singleton (14386 in chips) 
Seat 9: JeBoyDirk (25188 in chips) 
dhduncan: posts small blind 50
Duke Croix: posts big blind 100
*** HOLE CARDS ***
Dealt to Duke Croix [Jd 6c]
Klemtonius: calls 100
color_singleton: folds 
JeBoyDirk: folds 
MnnM150: calls 100
dhduncan: folds 
Duke Croix: checks 
*** FLOP *** [3d Td Ac]
Duke Croix: checks 
Klemtonius: bets 165
MnnM150: folds 
Duke Croix: folds 
Uncalled bet (165) returned to Klemtonius
Klemtonius collected 331 from pot
Klemtonius: doesn't show hand 
*** SUMMARY ***
Total pot 350 | Rake 19 
Board [3d Td Ac]
Seat 1: MnnM150 (button) folded on the Flop
Seat 2: dhduncan (small blind) folded before Flop
Seat 3: Duke Croix (big blind) folded on the Flop
Seat 5: Klemtonius collected (331)
Seat 8: color_singleton folded before Flop (didn't bet)
Seat 9: JeBoyDirk folded before Flop (didn't bet)



PokerStars Home Game Hand #218761867013: {Club #3225207}  Hold'em No Limit (50/100) - 2020/09/24 16:44:00 ET
Table 'money money' 9-max (Play Money) Seat #2 is the button
Seat 1: MnnM150 (2412 in chips) 
Seat 2: dhduncan (5848 in chips) 
Seat 3: Duke Croix (12750 in chips) 
Seat 5: Klemtonius (12183 in chips) 
Seat 8: color_singleton (14386 in chips) 
Seat 9: JeBoyDirk (25188 in chips) 
Duke Croix: posts small blind 50
Klemtonius: posts big blind 100
*** HOLE CARDS ***
Dealt to Duke Croix [4d Qc]
color_singleton: folds 
JeBoyDirk: folds 
MnnM150: calls 100
dhduncan: calls 100
Duke Croix: calls 50
Klemtonius: checks 
*** FLOP *** [Ah 2h 5d]
Duke Croix: checks 
Klemtonius: checks 
MnnM150: checks 
dhduncan: checks 
*** TURN *** [Ah 2h 5d] [Ac]
Duke Croix: checks 
Klemtonius: checks 
MnnM150: checks 
dhduncan: checks 
*** RIVER *** [Ah 2h 5d Ac] [Jd]
Duke Croix: checks 
Klemtonius: checks 
MnnM150: bets 378
dhduncan: folds 
Duke Croix: folds 
Klemtonius: folds 
Uncalled bet (378) returned to MnnM150
MnnM150 collected 378 from pot
*** SUMMARY ***
Total pot 400 | Rake 22 
Board [Ah 2h 5d Ac Jd]
Seat 1: MnnM150 collected (378)
Seat 2: dhduncan (button) folded on the River
Seat 3: Duke Croix (small blind) folded on the River
Seat 5: Klemtonius (big blind) folded on the River
Seat 8: color_singleton folded before Flop (didn't bet)
Seat 9: JeBoyDirk folded before Flop (didn't bet)



PokerStars Home Game Hand #218761894135: {Club #3225207}  Hold'em No Limit (50/100) - 2020/09/24 16:44:48 ET
Table 'money money' 9-max (Play Money) Seat #3 is the button
Seat 1: MnnM150 (2690 in chips) 
Seat 2: dhduncan (5748 in chips) 
Seat 3: Duke Croix (12650 in chips) 
Seat 5: Klemtonius (12083 in chips) 
Seat 8: color_singleton (14386 in chips) 
Seat 9: JeBoyDirk (25188 in chips) 
Klemtonius: posts small blind 50
color_singleton: posts big blind 100
*** HOLE CARDS ***
Dealt to Duke Croix [7d 5h]
JeBoyDirk: folds 
MnnM150: folds 
dhduncan: folds 
Duke Croix: folds 
Klemtonius: folds 
Uncalled bet (50) returned to color_singleton
color_singleton collected 100 from pot
color_singleton: doesn't show hand 
*** SUMMARY ***
Total pot 100 | Rake 0 
Seat 1: MnnM150 folded before Flop (didn't bet)
Seat 2: dhduncan folded before Flop (didn't bet)
Seat 3: Duke Croix (button) folded before Flop (didn't bet)
Seat 5: Klemtonius (small blind) folded before Flop
Seat 8: color_singleton (big blind) collected (100)
Seat 9: JeBoyDirk folded before Flop (didn't bet)



PokerStars Home Game Hand #218761899053: {Club #3225207}  Hold'em No Limit (50/100) - 2020/09/24 16:44:57 ET
Table 'money money' 9-max (Play Money) Seat #5 is the button
Seat 1: MnnM150 (2690 in chips) 
Seat 2: dhduncan (5748 in chips) 
Seat 3: Duke Croix (12650 in chips) 
Seat 5: Klemtonius (12033 in chips) 
Seat 8: color_singleton (14436 in chips) 
Seat 9: JeBoyDirk (25188 in chips) 
color_singleton: posts small blind 50
JeBoyDirk: posts big blind 100
*** HOLE CARDS ***
Dealt to Duke Croix [Kc 6d]
MnnM150: calls 100
dhduncan: calls 100
Duke Croix: folds 
Klemtonius: calls 100
color_singleton: calls 50
JeBoyDirk: checks 
*** FLOP *** [Td Qc 7c]
color_singleton: checks 
JeBoyDirk: checks 
MnnM150: checks 
dhduncan: checks 
Klemtonius: checks 
*** TURN *** [Td Qc 7c] [4h]
color_singleton: bets 236
JeBoyDirk: folds 
MnnM150: folds 
dhduncan: folds 
Klemtonius: calls 236
*** RIVER *** [Td Qc 7c 4h] [3h]
color_singleton: checks 
Klemtonius: checks 
*** SHOW DOWN ***
color_singleton: shows [Th 9s] (a pair of Tens)
Klemtonius: mucks hand 
color_singleton collected 919 from pot
*** SUMMARY ***
Total pot 972 | Rake 53 
Board [Td Qc 7c 4h 3h]
Seat 1: MnnM150 folded on the Turn
Seat 2: dhduncan folded on the Turn
Seat 3: Duke Croix folded before Flop (didn't bet)
Seat 5: Klemtonius (button) mucked [As 3s]
Seat 8: color_singleton (small blind) showed [Th 9s] and won (919) with a pair of Tens
Seat 9: JeBoyDirk (big blind) folded on the Turn



PokerStars Home Game Hand #218761926750: {Club #3225207}  Hold'em No Limit (50/100) - 2020/09/24 16:45:46 ET
Table 'money money' 9-max (Play Money) Seat #8 is the button
Seat 1: MnnM150 (2590 in chips) 
Seat 2: dhduncan (5648 in chips) 
Seat 3: Duke Croix (12650 in chips) 
Seat 5: Klemtonius (11697 in chips) 
Seat 8: color_singleton (15019 in chips) 
Seat 9: JeBoyDirk (25088 in chips) 
JeBoyDirk: posts small blind 50
MnnM150: posts big blind 100
*** HOLE CARDS ***
Dealt to Duke Croix [8s 8h]
dhduncan: calls 100
Duke Croix: raises 300 to 400
Klemtonius: calls 400
color_singleton: folds 
JeBoyDirk: calls 350
MnnM150: calls 300
dhduncan: calls 300
*** FLOP *** [5d Th 4h]
JeBoyDirk: checks 
MnnM150: checks 
dhduncan: checks 
Duke Croix: bets 800
Klemtonius: folds 
JeBoyDirk: folds 
MnnM150: folds 
dhduncan: folds 
Uncalled bet (800) returned to Duke Croix
Duke Croix collected 1890 from pot
*** SUMMARY ***
Total pot 2000 | Rake 110 
Board [5d Th 4h]
Seat 1: MnnM150 (big blind) folded on the Flop
Seat 2: dhduncan folded on the Flop
Seat 3: Duke Croix collected (1890)
Seat 5: Klemtonius folded on the Flop
Seat 8: color_singleton (button) folded before Flop (didn't bet)
Seat 9: JeBoyDirk (small blind) folded on the Flop



PokerStars Home Game Hand #218761952153: {Club #3225207}  Hold'em No Limit (50/100) - 2020/09/24 16:46:30 ET
Table 'money money' 9-max (Play Money) Seat #9 is the button
Seat 1: MnnM150 (2190 in chips) 
Seat 2: dhduncan (5248 in chips) 
Seat 3: Duke Croix (14140 in chips) 
Seat 8: color_singleton (15019 in chips) 
Seat 9: JeBoyDirk (24688 in chips) 
MnnM150: posts small blind 50
dhduncan: posts big blind 100
*** HOLE CARDS ***
Dealt to Duke Croix [Kh Kd]
Duke Croix: raises 300 to 400
color_singleton: folds 
JeBoyDirk: folds 
MnnM150: calls 350
dhduncan: folds 
*** FLOP *** [Ks 9d 6h]
MnnM150: checks 
Duke Croix: bets 500
MnnM150: folds 
Uncalled bet (500) returned to Duke Croix
Duke Croix collected 850 from pot
*** SUMMARY ***
Total pot 900 | Rake 50 
Board [Ks 9d 6h]
Seat 1: MnnM150 (small blind) folded on the Flop
Seat 2: dhduncan (big blind) folded before Flop
Seat 3: Duke Croix collected (850)
Seat 8: color_singleton folded before Flop (didn't bet)
Seat 9: JeBoyDirk (button) folded before Flop (didn't bet)



PokerStars Home Game Hand #218761965525: {Club #3225207}  Hold'em No Limit (50/100) - 2020/09/24 16:46:54 ET
Table 'money money' 9-max (Play Money) Seat #1 is the button
Seat 1: MnnM150 (1790 in chips) 
Seat 2: dhduncan (5148 in chips) 
Seat 3: Duke Croix (14590 in chips) 
Seat 8: color_singleton (15019 in chips) 
Seat 9: JeBoyDirk (24688 in chips) 
dhduncan: posts small blind 50
Duke Croix: posts big blind 100
*** HOLE CARDS ***
Dealt to Duke Croix [Qc 6c]
color_singleton: folds 
JeBoyDirk: calls 100
MnnM150: calls 100
dhduncan: calls 50
Duke Croix: checks 
*** FLOP *** [As 7c 5h]
dhduncan: checks 
Duke Croix: checks 
JeBoyDirk: checks 
MnnM150: checks 
*** TURN *** [As 7c 5h] [2c]
dhduncan: checks 
Duke Croix: bets 300
JeBoyDirk: folds 
MnnM150: folds 
dhduncan: folds 
Uncalled bet (300) returned to Duke Croix
Duke Croix collected 378 from pot
*** SUMMARY ***
Total pot 400 | Rake 22 
Board [As 7c 5h 2c]
Seat 1: MnnM150 (button) folded on the Turn
Seat 2: dhduncan (small blind) folded on the Turn
Seat 3: Duke Croix (big blind) collected (378)
Seat 8: color_singleton folded before Flop (didn't bet)
Seat 9: JeBoyDirk folded on the Turn



PokerStars Home Game Hand #218761981245: {Club #3225207}  Hold'em No Limit (50/100) - 2020/09/24 16:47:22 ET
Table 'money money' 9-max (Play Money) Seat #2 is the button
Seat 1: MnnM150 (1690 in chips) 
Seat 2: dhduncan (5048 in chips) 
Seat 3: Duke Croix (14868 in chips) 
Seat 8: color_singleton (15019 in chips) 
Seat 9: JeBoyDirk (24588 in chips) 
Duke Croix: posts small blind 50
color_singleton: posts big blind 100
*** HOLE CARDS ***
Dealt to Duke Croix [Th 5h]
JeBoyDirk: folds 
MnnM150: calls 100
dhduncan: calls 100
Duke Croix: calls 50
color_singleton: checks 
*** FLOP *** [7s Ac 6s]
Duke Croix: checks 
color_singleton: checks 
MnnM150: checks 
dhduncan: bets 200
Duke Croix: folds 
color_singleton: folds 
MnnM150: calls 200
*** TURN *** [7s Ac 6s] [3s]
MnnM150: checks 
dhduncan: bets 100
MnnM150: calls 100
*** RIVER *** [7s Ac 6s 3s] [4s]
MnnM150: bets 945
dhduncan: folds 
Uncalled bet (945) returned to MnnM150
MnnM150 collected 945 from pot
*** SUMMARY ***
Total pot 1000 | Rake 55 
Board [7s Ac 6s 3s 4s]
Seat 1: MnnM150 collected (945)
Seat 2: dhduncan (button) folded on the River
Seat 3: Duke Croix (small blind) folded on the Flop
Seat 8: color_singleton (big blind) folded on the Flop
Seat 9: JeBoyDirk folded before Flop (didn't bet)



PokerStars Home Game Hand #218762010848: {Club #3225207}  Hold'em No Limit (50/100) - 2020/09/24 16:48:13 ET
Table 'money money' 9-max (Play Money) Seat #3 is the button
Seat 1: MnnM150 (2235 in chips) 
Seat 2: dhduncan (4648 in chips) 
Seat 3: Duke Croix (14768 in chips) 
Seat 8: color_singleton (14919 in chips) 
Seat 9: JeBoyDirk (24588 in chips) 
color_singleton: posts small blind 50
JeBoyDirk: posts big blind 100
*** HOLE CARDS ***
Dealt to Duke Croix [Jc Jd]
MnnM150: calls 100
dhduncan: folds 
Duke Croix: raises 400 to 500
color_singleton: folds 
JeBoyDirk: folds 
MnnM150: folds 
Uncalled bet (400) returned to Duke Croix
Duke Croix collected 350 from pot
*** SUMMARY ***
Total pot 350 | Rake 0 
Seat 1: MnnM150 folded before Flop
Seat 2: dhduncan folded before Flop (didn't bet)
Seat 3: Duke Croix (button) collected (350)
Seat 8: color_singleton (small blind) folded before Flop
Seat 9: JeBoyDirk (big blind) folded before Flop



PokerStars Home Game Hand #218762028135: {Club #3225207}  Hold'em No Limit (50/100) - 2020/09/24 16:48:44 ET
Table 'money money' 9-max (Play Money) Seat #8 is the button
Seat 1: MnnM150 (2135 in chips) 
Seat 3: Duke Croix (15018 in chips) 
Seat 5: Klemtonius (11297 in chips) 
Seat 8: color_singleton (14869 in chips) 
Seat 9: JeBoyDirk (24488 in chips) 
JeBoyDirk: posts small blind 50
MnnM150: posts big blind 100
Klemtonius: posts small & big blinds 150
*** HOLE CARDS ***
Dealt to Duke Croix [Qs 2c]
Duke Croix: folds 
Klemtonius: checks 
color_singleton: folds 
JeBoyDirk: calls 50
MnnM150: checks 
*** FLOP *** [2s 4d Qc]
JeBoyDirk: checks 
MnnM150: checks 
Klemtonius: checks 
*** TURN *** [2s 4d Qc] [7c]
JeBoyDirk: checks 
MnnM150: checks 
Klemtonius: bets 3600
JeBoyDirk: folds 
MnnM150: folds 
Uncalled bet (3600) returned to Klemtonius
Klemtonius collected 331 from pot
Klemtonius: doesn't show hand 
*** SUMMARY ***
Total pot 350 | Rake 19 
Board [2s 4d Qc 7c]
Seat 1: MnnM150 (big blind) folded on the Turn
Seat 3: Duke Croix folded before Flop (didn't bet)
Seat 5: Klemtonius collected (331)
Seat 8: color_singleton (button) folded before Flop (didn't bet)
Seat 9: JeBoyDirk (small blind) folded on the Turn



PokerStars Home Game Hand #218762047358: {Club #3225207}  Hold'em No Limit (50/100) - 2020/09/24 16:49:18 ET
Table 'money money' 9-max (Play Money) Seat #9 is the button
Seat 1: MnnM150 (2035 in chips) 
Seat 3: Duke Croix (15018 in chips) 
Seat 5: Klemtonius (11478 in chips) 
Seat 8: color_singleton (14869 in chips) 
Seat 9: JeBoyDirk (24388 in chips) 
MnnM150: posts small blind 50
Duke Croix: posts big blind 100
*** HOLE CARDS ***
Dealt to Duke Croix [Ad Qh]
Klemtonius: calls 100
color_singleton: folds 
JeBoyDirk: folds 
MnnM150: folds 
Duke Croix: raises 400 to 500
Klemtonius: folds 
Uncalled bet (400) returned to Duke Croix
Duke Croix collected 250 from pot
*** SUMMARY ***
Total pot 250 | Rake 0 
Seat 1: MnnM150 (small blind) folded before Flop
Seat 3: Duke Croix (big blind) collected (250)
Seat 5: Klemtonius folded before Flop
Seat 8: color_singleton folded before Flop (didn't bet)
Seat 9: JeBoyDirk (button) folded before Flop (didn't bet)



PokerStars Home Game Hand #218762054609: {Club #3225207}  Hold'em No Limit (50/100) - 2020/09/24 16:49:31 ET
Table 'money money' 9-max (Play Money) Seat #1 is the button
Seat 1: MnnM150 (1985 in chips) 
Seat 3: Duke Croix (15168 in chips) 
Seat 5: Klemtonius (11378 in chips) 
Seat 8: color_singleton (14869 in chips) 
Seat 9: JeBoyDirk (24388 in chips) 
Duke Croix: posts small blind 50
Klemtonius: posts big blind 100
*** HOLE CARDS ***
Dealt to Duke Croix [Jh 8c]
color_singleton: folds 
JeBoyDirk: folds 
MnnM150: folds 
Duke Croix: calls 50
Klemtonius: raises 100 to 200
Duke Croix: calls 100
*** FLOP *** [Qd Qh Qs]
Duke Croix: checks 
Klemtonius: bets 600
Duke Croix: folds 
Uncalled bet (600) returned to Klemtonius
Klemtonius collected 378 from pot
Klemtonius: doesn't show hand 
*** SUMMARY ***
Total pot 400 | Rake 22 
Board [Qd Qh Qs]
Seat 1: MnnM150 (button) folded before Flop (didn't bet)
Seat 3: Duke Croix (small blind) folded on the Flop
Seat 5: Klemtonius (big blind) collected (378)
Seat 8: color_singleton folded before Flop (didn't bet)
Seat 9: JeBoyDirk folded before Flop (didn't bet)



PokerStars Home Game Hand #218762069578: {Club #3225207}  Hold'em No Limit (50/100) - 2020/09/24 16:49:57 ET
Table 'money money' 9-max (Play Money) Seat #3 is the button
Seat 1: MnnM150 (1985 in chips) 
Seat 3: Duke Croix (14968 in chips) 
Seat 5: Klemtonius (11556 in chips) 
Seat 8: color_singleton (14869 in chips) 
Seat 9: JeBoyDirk (24388 in chips) 
Klemtonius: posts small blind 50
color_singleton: posts big blind 100
*** HOLE CARDS ***
Dealt to Duke Croix [3d 2h]
JeBoyDirk: folds 
MnnM150: folds 
Duke Croix: folds 
Klemtonius: raises 100 to 200
color_singleton: folds 
Uncalled bet (100) returned to Klemtonius
Klemtonius collected 200 from pot
Klemtonius: doesn't show hand 
*** SUMMARY ***
Total pot 200 | Rake 0 
Seat 1: MnnM150 folded before Flop (didn't bet)
Seat 3: Duke Croix (button) folded before Flop (didn't bet)
Seat 5: Klemtonius (small blind) collected (200)
Seat 8: color_singleton (big blind) folded before Flop
Seat 9: JeBoyDirk folded before Flop (didn't bet)



PokerStars Home Game Hand #218762080175: {Club #3225207}  Hold'em No Limit (50/100) - 2020/09/24 16:50:16 ET
Table 'money money' 9-max (Play Money) Seat #5 is the button
Seat 1: MnnM150 (1985 in chips) 
Seat 2: dhduncan (4648 in chips) 
Seat 3: Duke Croix (14968 in chips) 
Seat 5: Klemtonius (11656 in chips) 
Seat 8: color_singleton (14769 in chips) 
Seat 9: JeBoyDirk (24388 in chips) 
color_singleton: posts small blind 50
JeBoyDirk: posts big blind 100
dhduncan: posts small & big blinds 150
*** HOLE CARDS ***
Dealt to Duke Croix [Ad Qs]
MnnM150: calls 100
dhduncan: checks 
Duke Croix: raises 300 to 400
Klemtonius: folds 
color_singleton: folds 
JeBoyDirk: calls 300
MnnM150: calls 300
dhduncan: folds 
*** FLOP *** [9h 5s 3c]
JeBoyDirk: bets 500
MnnM150: folds 
Duke Croix: folds 
Uncalled bet (500) returned to JeBoyDirk
JeBoyDirk collected 1323 from pot
*** SUMMARY ***
Total pot 1400 | Rake 77 
Board [9h 5s 3c]
Seat 1: MnnM150 folded on the Flop
Seat 2: dhduncan folded before Flop (didn't bet)
Seat 3: Duke Croix folded on the Flop
Seat 5: Klemtonius (button) folded before Flop (didn't bet)
Seat 8: color_singleton (small blind) folded before Flop
Seat 9: JeBoyDirk (big blind) collected (1323)



PokerStars Home Game Hand #218762096613: {Club #3225207}  Hold'em No Limit (50/100) - 2020/09/24 16:50:45 ET
Table 'money money' 9-max (Play Money) Seat #8 is the button
Seat 1: MnnM150 (1585 in chips) 
Seat 2: dhduncan (4498 in chips) 
Seat 3: Duke Croix (14568 in chips) 
Seat 5: Klemtonius (11656 in chips) 
Seat 8: color_singleton (14719 in chips) 
Seat 9: JeBoyDirk (25311 in chips) 
JeBoyDirk: posts small blind 50
MnnM150: posts big blind 100
*** HOLE CARDS ***
Dealt to Duke Croix [9s 8c]
dhduncan: calls 100
Duke Croix: calls 100
Klemtonius: folds 
color_singleton: folds 
JeBoyDirk: calls 50
MnnM150: checks 
*** FLOP *** [Jc Jd Qs]
JeBoyDirk: checks 
MnnM150: checks 
dhduncan: bets 100
Duke Croix: calls 100
JeBoyDirk: folds 
MnnM150: calls 100
*** TURN *** [Jc Jd Qs] [3h]
MnnM150: checks 
dhduncan: bets 330
Duke Croix: folds 
MnnM150: folds 
Uncalled bet (330) returned to dhduncan
dhduncan collected 661 from pot
dhduncan: doesn't show hand 
*** SUMMARY ***
Total pot 700 | Rake 39 
Board [Jc Jd Qs 3h]
Seat 1: MnnM150 (big blind) folded on the Turn
Seat 2: dhduncan collected (661)
Seat 3: Duke Croix folded on the Turn
Seat 5: Klemtonius folded before Flop (didn't bet)
Seat 8: color_singleton (button) folded before Flop (didn't bet)
Seat 9: JeBoyDirk (small blind) folded on the Flop



PokerStars Home Game Hand #218762131297: {Club #3225207}  Hold'em No Limit (50/100) - 2020/09/24 16:51:46 ET
Table 'money money' 9-max (Play Money) Seat #9 is the button
Seat 1: MnnM150 (1385 in chips) 
Seat 2: dhduncan (4959 in chips) 
Seat 3: Duke Croix (14368 in chips) 
Seat 8: color_singleton (14719 in chips) 
Seat 9: JeBoyDirk (25211 in chips) 
MnnM150: posts small blind 50
dhduncan: posts big blind 100
*** HOLE CARDS ***
Dealt to Duke Croix [Jh 4s]
Duke Croix: folds 
color_singleton: folds 
JeBoyDirk: folds 
MnnM150: calls 50
dhduncan: checks 
*** FLOP *** [Js 7c Ah]
MnnM150: bets 100
dhduncan: folds 
Uncalled bet (100) returned to MnnM150
MnnM150 collected 189 from pot
*** SUMMARY ***
Total pot 200 | Rake 11 
Board [Js 7c Ah]
Seat 1: MnnM150 (small blind) collected (189)
Seat 2: dhduncan (big blind) folded on the Flop
Seat 3: Duke Croix folded before Flop (didn't bet)
Seat 8: color_singleton folded before Flop (didn't bet)
Seat 9: JeBoyDirk (button) folded before Flop (didn't bet)



PokerStars Home Game Hand #218762142062: {Club #3225207}  Hold'em No Limit (50/100) - 2020/09/24 16:52:05 ET
Table 'money money' 9-max (Play Money) Seat #1 is the button
Seat 1: MnnM150 (1474 in chips) 
Seat 2: dhduncan (4859 in chips) 
Seat 3: Duke Croix (14368 in chips) 
Seat 8: color_singleton (14719 in chips) 
Seat 9: JeBoyDirk (25211 in chips) 
dhduncan: posts small blind 50
Duke Croix: posts big blind 100
*** HOLE CARDS ***
Dealt to Duke Croix [3s 3c]
color_singleton: folds 
JeBoyDirk: folds 
MnnM150: calls 100
dhduncan: calls 50
Duke Croix: raises 300 to 400
MnnM150: calls 300
dhduncan: calls 300
*** FLOP *** [9s 5d 7s]
dhduncan: checks 
Duke Croix: checks 
MnnM150: checks 
*** TURN *** [9s 5d 7s] [Qc]
dhduncan: checks 
Duke Croix: checks 
MnnM150: checks 
*** RIVER *** [9s 5d 7s Qc] [Ts]
dhduncan: checks 
Duke Croix: bets 700
MnnM150: folds 
dhduncan: folds 
Uncalled bet (700) returned to Duke Croix
Duke Croix collected 1134 from pot
*** SUMMARY ***
Total pot 1200 | Rake 66 
Board [9s 5d 7s Qc Ts]
Seat 1: MnnM150 (button) folded on the River
Seat 2: dhduncan (small blind) folded on the River
Seat 3: Duke Croix (big blind) collected (1134)
Seat 8: color_singleton folded before Flop (didn't bet)
Seat 9: JeBoyDirk folded before Flop (didn't bet)



PokerStars Home Game Hand #218762168239: {Club #3225207}  Hold'em No Limit (50/100) - 2020/09/24 16:52:52 ET
Table 'money money' 9-max (Play Money) Seat #2 is the button
Seat 1: MnnM150 (1074 in chips) 
Seat 2: dhduncan (4459 in chips) 
Seat 3: Duke Croix (15102 in chips) 
Seat 8: color_singleton (14719 in chips) 
Seat 9: JeBoyDirk (25211 in chips) 
Duke Croix: posts small blind 50
color_singleton: posts big blind 100
*** HOLE CARDS ***
Dealt to Duke Croix [Qs 7s]
JeBoyDirk: calls 100
MnnM150: folds 
dhduncan: folds 
Duke Croix: calls 50
color_singleton: raises 200 to 300
JeBoyDirk: calls 200
Duke Croix: calls 200
*** FLOP *** [Kd Ks Tc]
Duke Croix: checks 
color_singleton: checks 
JeBoyDirk: bets 400
Duke Croix: folds 
color_singleton: calls 400
*** TURN *** [Kd Ks Tc] [9d]
color_singleton: checks 
JeBoyDirk: bets 800
color_singleton: folds 
Uncalled bet (800) returned to JeBoyDirk
JeBoyDirk collected 1606 from pot
*** SUMMARY ***
Total pot 1700 | Rake 94 
Board [Kd Ks Tc 9d]
Seat 1: MnnM150 folded before Flop (didn't bet)
Seat 2: dhduncan (button) folded before Flop (didn't bet)
Seat 3: Duke Croix (small blind) folded on the Flop
Seat 8: color_singleton (big blind) folded on the Turn
Seat 9: JeBoyDirk collected (1606)



PokerStars Home Game Hand #218762191527: {Club #3225207}  Hold'em No Limit (50/100) - 2020/09/24 16:53:34 ET
Table 'money money' 9-max (Play Money) Seat #3 is the button
Seat 1: MnnM150 (1074 in chips) 
Seat 2: dhduncan (4459 in chips) 
Seat 3: Duke Croix (14802 in chips) 
Seat 8: color_singleton (14019 in chips) 
Seat 9: JeBoyDirk (26117 in chips) 
color_singleton: posts small blind 50
JeBoyDirk: posts big blind 100
*** HOLE CARDS ***
Dealt to Duke Croix [Td 6c]
MnnM150: calls 100
dhduncan: folds 
Duke Croix: folds 
color_singleton: raises 100 to 200
JeBoyDirk: folds 
MnnM150: calls 100
*** FLOP *** [Jc As Kd]
color_singleton: checks 
MnnM150: bets 874 and is all-in
color_singleton: calls 874
*** TURN *** [Jc As Kd] [7s]
*** RIVER *** [Jc As Kd 7s] [6s]
*** SHOW DOWN ***
color_singleton: shows [Ac Ah] (three of a kind, Aces)
MnnM150: shows [Jh Qh] (a pair of Jacks)
color_singleton collected 2124 from pot
*** SUMMARY ***
Total pot 2248 | Rake 124 
Board [Jc As Kd 7s 6s]
Seat 1: MnnM150 showed [Jh Qh] and lost with a pair of Jacks
Seat 2: dhduncan folded before Flop (didn't bet)
Seat 3: Duke Croix (button) folded before Flop (didn't bet)
Seat 8: color_singleton (small blind) showed [Ac Ah] and won (2124) with three of a kind, Aces
Seat 9: JeBoyDirk (big blind) folded before Flop



PokerStars Home Game Hand #218762215822: {Club #3225207}  Hold'em No Limit (50/100) - 2020/09/24 16:54:17 ET
Table 'money money' 9-max (Play Money) Seat #8 is the button
Seat 2: dhduncan (4459 in chips) 
Seat 3: Duke Croix (14802 in chips) 
Seat 8: color_singleton (15069 in chips) 
Seat 9: JeBoyDirk (26017 in chips) 
JeBoyDirk: posts small blind 50
dhduncan: posts big blind 100
*** HOLE CARDS ***
Dealt to Duke Croix [4d 2d]
Duke Croix: folds 
color_singleton: raises 200 to 300
JeBoyDirk: folds 
dhduncan: folds 
Uncalled bet (200) returned to color_singleton
color_singleton collected 250 from pot
color_singleton: doesn't show hand 
*** SUMMARY ***
Total pot 250 | Rake 0 
Seat 2: dhduncan (big blind) folded before Flop
Seat 3: Duke Croix folded before Flop (didn't bet)
Seat 8: color_singleton (button) collected (250)
Seat 9: JeBoyDirk (small blind) folded before Flop



PokerStars Home Game Hand #218762223183: {Club #3225207}  Hold'em No Limit (50/100) - 2020/09/24 16:54:30 ET
Table 'money money' 9-max (Play Money) Seat #9 is the button
Seat 2: dhduncan (4359 in chips) 
Seat 3: Duke Croix (14802 in chips) 
Seat 8: color_singleton (15219 in chips) 
Seat 9: JeBoyDirk (25967 in chips) 
dhduncan: posts small blind 50
Duke Croix: posts big blind 100
*** HOLE CARDS ***
Dealt to Duke Croix [7c 8s]
color_singleton: raises 100 to 200
JeBoyDirk: folds 
dhduncan: calls 150
Duke Croix: calls 100
*** FLOP *** [Jh Qd 2c]
dhduncan: checks 
Duke Croix: checks 
color_singleton: checks 
*** TURN *** [Jh Qd 2c] [2h]
dhduncan: checks 
Duke Croix: checks 
color_singleton: checks 
*** RIVER *** [Jh Qd 2c 2h] [9c]
dhduncan: bets 567
Duke Croix: folds 
color_singleton: folds 
Uncalled bet (567) returned to dhduncan
dhduncan collected 567 from pot
dhduncan: doesn't show hand 
*** SUMMARY ***
Total pot 600 | Rake 33 
Board [Jh Qd 2c 2h 9c]
Seat 2: dhduncan (small blind) collected (567)
Seat 3: Duke Croix (big blind) folded on the River
Seat 8: color_singleton folded on the River
Seat 9: JeBoyDirk (button) folded before Flop (didn't bet)



PokerStars Home Game Hand #218762238343: {Club #3225207}  Hold'em No Limit (50/100) - 2020/09/24 16:54:57 ET
Table 'money money' 9-max (Play Money) Seat #2 is the button
Seat 1: MnnM150 (10000 in chips) 
Seat 2: dhduncan (4726 in chips) 
Seat 3: Duke Croix (14602 in chips) 
Seat 8: color_singleton (15019 in chips) 
Seat 9: JeBoyDirk (25967 in chips) 
Duke Croix: posts small blind 50
color_singleton: posts big blind 100
MnnM150: posts small & big blinds 150
*** HOLE CARDS ***
Dealt to Duke Croix [Ad 7d]
JeBoyDirk: folds 
MnnM150: raises 100 to 200
dhduncan: calls 200
Duke Croix: calls 150
color_singleton: calls 100
*** FLOP *** [6c 8d 7c]
Duke Croix: bets 400
color_singleton: calls 400
MnnM150: folds 
dhduncan: folds 
*** TURN *** [6c 8d 7c] [Ah]
Duke Croix: bets 900
color_singleton: folds 
Uncalled bet (900) returned to Duke Croix
Duke Croix collected 1559 from pot
*** SUMMARY ***
Total pot 1650 | Rake 91 
Board [6c 8d 7c Ah]
Seat 1: MnnM150 folded on the Flop
Seat 2: dhduncan (button) folded on the Flop
Seat 3: Duke Croix (small blind) collected (1559)
Seat 8: color_singleton (big blind) folded on the Turn
Seat 9: JeBoyDirk folded before Flop (didn't bet)



PokerStars Home Game Hand #218762258855: {Club #3225207}  Hold'em No Limit (50/100) - 2020/09/24 16:55:46 ET
Table 'money money' 9-max (Play Money) Seat #3 is the button
Seat 1: MnnM150 (9750 in chips) 
Seat 2: dhduncan (4526 in chips) 
Seat 3: Duke Croix (15561 in chips) 
Seat 8: color_singleton (14419 in chips) 
Seat 9: JeBoyDirk (25967 in chips) 
color_singleton: posts small blind 50
JeBoyDirk: posts big blind 100
*** HOLE CARDS ***
Dealt to Duke Croix [2h 3c]
MnnM150: calls 100
dhduncan: calls 100
Duke Croix: folds 
color_singleton: raises 100 to 200
JeBoyDirk: calls 100
MnnM150: calls 100
dhduncan: calls 100
*** FLOP *** [6s 4s Ks]
color_singleton: checks 
JeBoyDirk: checks 
MnnM150: bets 378
dhduncan: folds 
color_singleton: calls 378
JeBoyDirk: folds 
*** TURN *** [6s 4s Ks] [9s]
color_singleton: bets 735
MnnM150: raises 735 to 1470
color_singleton: calls 735
*** RIVER *** [6s 4s Ks 9s] [5h]
color_singleton: checks 
MnnM150: bets 4249
color_singleton: folds 
Uncalled bet (4249) returned to MnnM150
MnnM150 collected 4249 from pot
*** SUMMARY ***
Total pot 4496 | Rake 247 
Board [6s 4s Ks 9s 5h]
Seat 1: MnnM150 collected (4249)
Seat 2: dhduncan folded on the Flop
Seat 3: Duke Croix (button) folded before Flop (didn't bet)
Seat 8: color_singleton (small blind) folded on the River
Seat 9: JeBoyDirk (big blind) folded on the Flop



PokerStars Home Game Hand #218762280666: {Club #3225207}  Hold'em No Limit (50/100) - 2020/09/24 16:56:38 ET
Table 'money money' 9-max (Play Money) Seat #8 is the button
Seat 1: MnnM150 (11951 in chips) 
Seat 2: dhduncan (4326 in chips) 
Seat 3: Duke Croix (15561 in chips) 
Seat 5: Klemtonius (11656 in chips) 
Seat 8: color_singleton (12371 in chips) 
Seat 9: JeBoyDirk (25767 in chips) 
JeBoyDirk: posts small blind 50
MnnM150: posts big blind 100
Klemtonius: posts small & big blinds 150
*** HOLE CARDS ***
Dealt to Duke Croix [8c Jd]
dhduncan: folds 
Duke Croix: folds 
Klemtonius: checks 
color_singleton: calls 100
JeBoyDirk: folds 
MnnM150: checks 
*** FLOP *** [9h 2s 6h]
MnnM150: checks 
Klemtonius: bets 100
color_singleton: folds 
MnnM150: folds 
Uncalled bet (100) returned to Klemtonius
Klemtonius collected 378 from pot
*** SUMMARY ***
Total pot 400 | Rake 22 
Board [9h 2s 6h]
Seat 1: MnnM150 (big blind) folded on the Flop
Seat 2: dhduncan folded before Flop (didn't bet)
Seat 3: Duke Croix folded before Flop (didn't bet)
Seat 5: Klemtonius collected (378)
Seat 8: color_singleton (button) folded on the Flop
Seat 9: JeBoyDirk (small blind) folded before Flop



PokerStars Home Game Hand #218762293565: {Club #3225207}  Hold'em No Limit (50/100) - 2020/09/24 16:57:08 ET
Table 'money money' 9-max (Play Money) Seat #9 is the button
Seat 1: MnnM150 (11851 in chips) 
Seat 2: dhduncan (4326 in chips) 
Seat 3: Duke Croix (15561 in chips) 
Seat 5: Klemtonius (11884 in chips) 
Seat 8: color_singleton (12271 in chips) 
Seat 9: JeBoyDirk (25717 in chips) 
MnnM150: posts small blind 50
dhduncan: posts big blind 100
*** HOLE CARDS ***
Dealt to Duke Croix [Kc Ac]
Duke Croix: raises 300 to 400
Klemtonius: calls 400
color_singleton: calls 400
JeBoyDirk: folds 
MnnM150: folds 
dhduncan: folds 
*** FLOP *** [Qc Ks 7d]
Duke Croix: bets 700
Klemtonius: folds 
color_singleton: folds 
Uncalled bet (700) returned to Duke Croix
Duke Croix collected 1276 from pot
*** SUMMARY ***
Total pot 1350 | Rake 74 
Board [Qc Ks 7d]
Seat 1: MnnM150 (small blind) folded before Flop
Seat 2: dhduncan (big blind) folded before Flop
Seat 3: Duke Croix collected (1276)
Seat 5: Klemtonius folded on the Flop
Seat 8: color_singleton folded on the Flop
Seat 9: JeBoyDirk (button) folded before Flop (didn't bet)



PokerStars Home Game Hand #218762307064: {Club #3225207}  Hold'em No Limit (50/100) - 2020/09/24 16:57:40 ET
Table 'money money' 9-max (Play Money) Seat #1 is the button
Seat 1: MnnM150 (11801 in chips) 
Seat 2: dhduncan (4226 in chips) 
Seat 3: Duke Croix (16437 in chips) 
Seat 5: Klemtonius (11484 in chips) 
Seat 8: color_singleton (11871 in chips) 
Seat 9: JeBoyDirk (25717 in chips) 
dhduncan: posts small blind 50
Duke Croix: posts big blind 100
*** HOLE CARDS ***
Dealt to Duke Croix [8d 2h]
Klemtonius: folds 
color_singleton: folds 
JeBoyDirk: folds 
MnnM150: calls 100
dhduncan: folds 
Duke Croix: checks 
*** FLOP *** [Qd 3d Ts]
Duke Croix: checks 
MnnM150: checks 
*** TURN *** [Qd 3d Ts] [7h]
Duke Croix: checks 
MnnM150: bets 236
Duke Croix: folds 
Uncalled bet (236) returned to MnnM150
MnnM150 collected 236 from pot
*** SUMMARY ***
Total pot 250 | Rake 14 
Board [Qd 3d Ts 7h]
Seat 1: MnnM150 (button) collected (236)
Seat 2: dhduncan (small blind) folded before Flop
Seat 3: Duke Croix (big blind) folded on the Turn
Seat 5: Klemtonius folded before Flop (didn't bet)
Seat 8: color_singleton folded before Flop (didn't bet)
Seat 9: JeBoyDirk folded before Flop (didn't bet)



PokerStars Home Game Hand #218762319181: {Club #3225207}  Hold'em No Limit (50/100) - 2020/09/24 16:58:08 ET
Table 'money money' 9-max (Play Money) Seat #2 is the button
Seat 1: MnnM150 (11937 in chips) 
Seat 2: dhduncan (4176 in chips) 
Seat 3: Duke Croix (16337 in chips) 
Seat 5: Klemtonius (11484 in chips) 
Seat 8: color_singleton (11871 in chips) 
Seat 9: JeBoyDirk (25717 in chips) 
Duke Croix: posts small blind 50
Klemtonius: posts big blind 100
*** HOLE CARDS ***
Dealt to Duke Croix [Jd Ks]
color_singleton: raises 100 to 200
JeBoyDirk: folds 
MnnM150: folds 
dhduncan: calls 200
Duke Croix: calls 150
Klemtonius: calls 100
*** FLOP *** [5c Js 8c]
Duke Croix: bets 400
Klemtonius: folds 
color_singleton: folds 
dhduncan: calls 400
*** TURN *** [5c Js 8c] [Kc]
Duke Croix: bets 800
dhduncan: calls 800
*** RIVER *** [5c Js 8c Kc] [Th]
Duke Croix: checks 
dhduncan: bets 1000
Duke Croix: calls 1000
*** SHOW DOWN ***
dhduncan: shows [Ac 7c] (a flush, Ace high)
Duke Croix: mucks hand 
dhduncan collected 4914 from pot
*** SUMMARY ***
Total pot 5200 | Rake 286 
Board [5c Js 8c Kc Th]
Seat 1: MnnM150 folded before Flop (didn't bet)
Seat 2: dhduncan (button) showed [Ac 7c] and won (4914) with a flush, Ace high
Seat 3: Duke Croix (small blind) mucked [Jd Ks]
Seat 5: Klemtonius (big blind) folded on the Flop
Seat 8: color_singleton folded on the Flop
Seat 9: JeBoyDirk folded before Flop (didn't bet)



PokerStars Home Game Hand #218762340399: {Club #3225207}  Hold'em No Limit (50/100) - 2020/09/24 16:58:58 ET
Table 'money money' 9-max (Play Money) Seat #3 is the button
Seat 1: MnnM150 (11937 in chips) 
Seat 2: dhduncan (6690 in chips) 
Seat 3: Duke Croix (13937 in chips) 
Seat 5: Klemtonius (11284 in chips) 
Seat 8: color_singleton (11671 in chips) 
Seat 9: JeBoyDirk (25717 in chips) 
Klemtonius: posts small blind 50
color_singleton: posts big blind 100
*** HOLE CARDS ***
Dealt to Duke Croix [Ts Kh]
JeBoyDirk: folds 
MnnM150: calls 100
dhduncan: folds 
Duke Croix: raises 300 to 400
Klemtonius: folds 
color_singleton: calls 300
MnnM150: folds 
*** FLOP *** [9d 5h Th]
color_singleton: bets 449
Duke Croix: calls 449
*** TURN *** [9d 5h Th] [7c]
color_singleton: bets 873
Duke Croix: calls 873
*** RIVER *** [9d 5h Th 7c] [6c]
color_singleton: checks 
Duke Croix: bets 1600
color_singleton: folds 
Uncalled bet (1600) returned to Duke Croix
Duke Croix collected 3396 from pot
*** SUMMARY ***
Total pot 3594 | Rake 198 
Board [9d 5h Th 7c 6c]
Seat 1: MnnM150 folded before Flop
Seat 2: dhduncan folded before Flop (didn't bet)
Seat 3: Duke Croix (button) collected (3396)
Seat 5: Klemtonius (small blind) folded before Flop
Seat 8: color_singleton (big blind) folded on the River
Seat 9: JeBoyDirk folded before Flop (didn't bet)



PokerStars Home Game Hand #218762362355: {Club #3225207}  Hold'em No Limit (50/100) - 2020/09/24 16:59:50 ET
Table 'money money' 9-max (Play Money) Seat #5 is the button
Seat 1: MnnM150 (11837 in chips) 
Seat 2: dhduncan (6690 in chips) 
Seat 3: Duke Croix (15611 in chips) 
Seat 5: Klemtonius (11234 in chips) 
Seat 8: color_singleton (9949 in chips) 
Seat 9: JeBoyDirk (25717 in chips) 
color_singleton: posts small blind 50
JeBoyDirk: posts big blind 100
*** HOLE CARDS ***
Dealt to Duke Croix [9h Qc]
MnnM150: calls 100
dhduncan: folds 
Duke Croix: calls 100
Klemtonius: calls 100
color_singleton: folds 
JeBoyDirk: checks 
*** FLOP *** [2s Kh 4h]
JeBoyDirk: checks 
MnnM150: checks 
Duke Croix: checks 
Klemtonius: checks 
*** TURN *** [2s Kh 4h] [Th]
JeBoyDirk: checks 
MnnM150: bets 212
Duke Croix: folds 
Klemtonius: calls 212
JeBoyDirk: folds 
*** RIVER *** [2s Kh 4h Th] [Qh]
MnnM150: bets 826
Klemtonius: folds 
Uncalled bet (826) returned to MnnM150
MnnM150 collected 826 from pot
*** SUMMARY ***
Total pot 874 | Rake 48 
Board [2s Kh 4h Th Qh]
Seat 1: MnnM150 collected (826)
Seat 2: dhduncan folded before Flop (didn't bet)
Seat 3: Duke Croix folded on the Turn
Seat 5: Klemtonius (button) folded on the River
Seat 8: color_singleton (small blind) folded before Flop
Seat 9: JeBoyDirk (big blind) folded on the Turn



PokerStars Home Game Hand #218762389577: {Club #3225207}  Hold'em No Limit (50/100) - 2020/09/24 17:00:51 ET
Table 'money money' 9-max (Play Money) Seat #8 is the button
Seat 1: MnnM150 (12351 in chips) 
Seat 2: dhduncan (6690 in chips) 
Seat 3: Duke Croix (15511 in chips) 
Seat 5: Klemtonius (10922 in chips) 
Seat 8: color_singleton (9899 in chips) 
Seat 9: JeBoyDirk (25617 in chips) 
JeBoyDirk: posts small blind 50
MnnM150: posts big blind 100
*** HOLE CARDS ***
Dealt to Duke Croix [7d 4d]
dhduncan: calls 100
Duke Croix: folds 
Klemtonius: raises 233 to 333
color_singleton: folds 
JeBoyDirk: folds 
MnnM150: folds 
dhduncan: calls 233
*** FLOP *** [2d Ts 6s]
dhduncan: checks 
Klemtonius: checks 
*** TURN *** [2d Ts 6s] [5h]
dhduncan: checks 
Klemtonius: bets 300
dhduncan: folds 
Uncalled bet (300) returned to Klemtonius
Klemtonius collected 771 from pot
Klemtonius: doesn't show hand 
*** SUMMARY ***
Total pot 816 | Rake 45 
Board [2d Ts 6s 5h]
Seat 1: MnnM150 (big blind) folded before Flop
Seat 2: dhduncan folded on the Turn
Seat 3: Duke Croix folded before Flop (didn't bet)
Seat 5: Klemtonius collected (771)
Seat 8: color_singleton (button) folded before Flop (didn't bet)
Seat 9: JeBoyDirk (small blind) folded before Flop



PokerStars Home Game Hand #218762411067: {Club #3225207}  Hold'em No Limit (50/100) - 2020/09/24 17:01:32 ET
Table 'money money' 9-max (Play Money) Seat #9 is the button
Seat 1: MnnM150 (12251 in chips) 
Seat 2: dhduncan (6357 in chips) 
Seat 3: Duke Croix (15511 in chips) 
Seat 5: Klemtonius (11360 in chips) 
Seat 8: color_singleton (9899 in chips) 
Seat 9: JeBoyDirk (25567 in chips) 
MnnM150: posts small blind 50
dhduncan: posts big blind 100
*** HOLE CARDS ***
Dealt to Duke Croix [9s As]
Duke Croix has timed out
Duke Croix: folds 
Klemtonius: calls 100
color_singleton: calls 100
JeBoyDirk: folds 
MnnM150: folds 
dhduncan: checks 
*** FLOP *** [Ac Ks 9h]
dhduncan: checks 
Klemtonius: checks 
color_singleton: checks 
*** TURN *** [Ac Ks 9h] [2s]
dhduncan: bets 100
Klemtonius: calls 100
color_singleton: calls 100
*** RIVER *** [Ac Ks 9h 2s] [8s]
dhduncan: bets 614
Klemtonius: folds 
color_singleton: folds 
Uncalled bet (614) returned to dhduncan
dhduncan collected 614 from pot
dhduncan: doesn't show hand 
*** SUMMARY ***
Total pot 650 | Rake 36 
Board [Ac Ks 9h 2s 8s]
Seat 1: MnnM150 (small blind) folded before Flop
Seat 2: dhduncan (big blind) collected (614)
Seat 3: Duke Croix folded before Flop (didn't bet)
Seat 5: Klemtonius folded on the River
Seat 8: color_singleton folded on the River
Seat 9: JeBoyDirk (button) folded before Flop (didn't bet)



PokerStars Home Game Hand #218762444254: {Club #3225207}  Hold'em No Limit (50/100) - 2020/09/24 17:02:32 ET
Table 'money money' 9-max (Play Money) Seat #1 is the button
Seat 1: MnnM150 (12201 in chips) 
Seat 2: dhduncan (6771 in chips) 
Seat 3: Duke Croix (15511 in chips) 
Seat 5: Klemtonius (11160 in chips) 
Seat 8: color_singleton (9699 in chips) 
Seat 9: JeBoyDirk (25567 in chips) 
dhduncan: posts small blind 50
Duke Croix: posts big blind 100
*** HOLE CARDS ***
Dealt to Duke Croix [Jc 3c]
Klemtonius: calls 100
color_singleton: folds 
JeBoyDirk: folds 
MnnM150: folds 
dhduncan: folds 
Duke Croix: checks 
*** FLOP *** [Ts Kh Qh]
Duke Croix: bets 200
Klemtonius: calls 200
*** TURN *** [Ts Kh Qh] [8s]
Duke Croix: checks 
Klemtonius: checks 
*** RIVER *** [Ts Kh Qh 8s] [2c]
Duke Croix: bets 400
Klemtonius: folds 
Uncalled bet (400) returned to Duke Croix
Duke Croix collected 614 from pot
*** SUMMARY ***
Total pot 650 | Rake 36 
Board [Ts Kh Qh 8s 2c]
Seat 1: MnnM150 (button) folded before Flop (didn't bet)
Seat 2: dhduncan (small blind) folded before Flop
Seat 3: Duke Croix (big blind) collected (614)
Seat 5: Klemtonius folded on the River
Seat 8: color_singleton folded before Flop (didn't bet)
Seat 9: JeBoyDirk folded before Flop (didn't bet)



PokerStars Home Game Hand #218762459049: {Club #3225207}  Hold'em No Limit (50/100) - 2020/09/24 17:02:58 ET
Table 'money money' 9-max (Play Money) Seat #2 is the button
Seat 1: MnnM150 (12201 in chips) 
Seat 2: dhduncan (6721 in chips) 
Seat 3: Duke Croix (15825 in chips) 
Seat 5: Klemtonius (10860 in chips) 
Seat 8: color_singleton (9699 in chips) 
Seat 9: JeBoyDirk (25567 in chips) 
Duke Croix: posts small blind 50
Klemtonius: posts big blind 100
*** HOLE CARDS ***
Dealt to Duke Croix [5h Ad]
color_singleton: raises 200 to 300
JeBoyDirk: folds 
MnnM150: folds 
dhduncan: calls 300
Duke Croix: folds 
Klemtonius: calls 200
*** FLOP *** [9c 6s Jh]
Klemtonius: checks 
color_singleton: checks 
dhduncan: checks 
*** TURN *** [9c 6s Jh] [As]
Klemtonius: checks 
color_singleton: bets 449
dhduncan: folds 
Klemtonius: folds 
Uncalled bet (449) returned to color_singleton
color_singleton collected 898 from pot
color_singleton: doesn't show hand 
*** SUMMARY ***
Total pot 950 | Rake 52 
Board [9c 6s Jh As]
Seat 1: MnnM150 folded before Flop (didn't bet)
Seat 2: dhduncan (button) folded on the Turn
Seat 3: Duke Croix (small blind) folded before Flop
Seat 5: Klemtonius (big blind) folded on the Turn
Seat 8: color_singleton collected (898)
Seat 9: JeBoyDirk folded before Flop (didn't bet)



PokerStars Home Game Hand #218762480173: {Club #3225207}  Hold'em No Limit (50/100) - 2020/09/24 17:03:36 ET
Table 'money money' 9-max (Play Money) Seat #3 is the button
Seat 1: MnnM150 (12201 in chips) 
Seat 2: dhduncan (6421 in chips) 
Seat 3: Duke Croix (15775 in chips) 
Seat 5: Klemtonius (10560 in chips) 
Seat 8: color_singleton (10297 in chips) 
Seat 9: JeBoyDirk (25567 in chips) 
Klemtonius: posts small blind 50
color_singleton: posts big blind 100
*** HOLE CARDS ***
Dealt to Duke Croix [9h 5s]
JeBoyDirk: folds 
MnnM150: calls 100
dhduncan: calls 100
Duke Croix: folds 
Klemtonius: calls 50
color_singleton: checks 
*** FLOP *** [Tc Qh 5d]
Klemtonius: bets 900
color_singleton: folds 
MnnM150: folds 
dhduncan: folds 
Uncalled bet (900) returned to Klemtonius
Klemtonius collected 378 from pot
Klemtonius: doesn't show hand 
*** SUMMARY ***
Total pot 400 | Rake 22 
Board [Tc Qh 5d]
Seat 1: MnnM150 folded on the Flop
Seat 2: dhduncan folded on the Flop
Seat 3: Duke Croix (button) folded before Flop (didn't bet)
Seat 5: Klemtonius (small blind) collected (378)
Seat 8: color_singleton (big blind) folded on the Flop
Seat 9: JeBoyDirk folded before Flop (didn't bet)



PokerStars Home Game Hand #218762495061: {Club #3225207}  Hold'em No Limit (50/100) - 2020/09/24 17:04:02 ET
Table 'money money' 9-max (Play Money) Seat #5 is the button
Seat 1: MnnM150 (12101 in chips) 
Seat 2: dhduncan (6321 in chips) 
Seat 3: Duke Croix (15775 in chips) 
Seat 5: Klemtonius (10838 in chips) 
Seat 8: color_singleton (10197 in chips) 
Seat 9: JeBoyDirk (25567 in chips) 
color_singleton: posts small blind 50
JeBoyDirk: posts big blind 100
*** HOLE CARDS ***
Dealt to Duke Croix [5c Qc]
MnnM150: raises 100 to 200
dhduncan: folds 
Duke Croix: folds 
Klemtonius: calls 200
color_singleton: folds 
JeBoyDirk: folds 
*** FLOP *** [9d 8d Kh]
MnnM150: bets 260
Klemtonius: calls 260
*** TURN *** [9d 8d Kh] [6c]
MnnM150: bets 505
Klemtonius: calls 505
*** RIVER *** [9d 8d Kh 6c] [3d]
MnnM150: bets 1966
Klemtonius: folds 
Uncalled bet (1966) returned to MnnM150
MnnM150 collected 1966 from pot
*** SUMMARY ***
Total pot 2080 | Rake 114 
Board [9d 8d Kh 6c 3d]
Seat 1: MnnM150 collected (1966)
Seat 2: dhduncan folded before Flop (didn't bet)
Seat 3: Duke Croix folded before Flop (didn't bet)
Seat 5: Klemtonius (button) folded on the River
Seat 8: color_singleton (small blind) folded before Flop
Seat 9: JeBoyDirk (big blind) folded before Flop



PokerStars Home Game Hand #218762541555: {Club #3225207}  Hold'em No Limit (50/100) - 2020/09/24 17:05:08 ET
Table 'money money' 9-max (Play Money) Seat #8 is the button
Seat 1: MnnM150 (13102 in chips) 
Seat 2: dhduncan (6321 in chips) 
Seat 3: Duke Croix (15775 in chips) 
Seat 5: Klemtonius (9873 in chips) 
Seat 8: color_singleton (10147 in chips) 
Seat 9: JeBoyDirk (25467 in chips) 
JeBoyDirk: posts small blind 50
MnnM150: posts big blind 100
*** HOLE CARDS ***
Dealt to Duke Croix [2c 6h]
dhduncan: calls 100
Duke Croix: folds 
Klemtonius: raises 344 to 444
color_singleton: folds 
JeBoyDirk: folds 
MnnM150: folds 
dhduncan: folds 
Uncalled bet (344) returned to Klemtonius
Klemtonius collected 350 from pot
Klemtonius: doesn't show hand 
*** SUMMARY ***
Total pot 350 | Rake 0 
Seat 1: MnnM150 (big blind) folded before Flop
Seat 2: dhduncan folded before Flop
Seat 3: Duke Croix folded before Flop (didn't bet)
Seat 5: Klemtonius collected (350)
Seat 8: color_singleton (button) folded before Flop (didn't bet)
Seat 9: JeBoyDirk (small blind) folded before Flop



PokerStars Home Game Hand #218762553098: {Club #3225207}  Hold'em No Limit (50/100) - 2020/09/24 17:05:28 ET
Table 'money money' 9-max (Play Money) Seat #9 is the button
Seat 1: MnnM150 (13002 in chips) 
Seat 2: dhduncan (6221 in chips) 
Seat 3: Duke Croix (15775 in chips) 
Seat 5: Klemtonius (10123 in chips) 
Seat 8: color_singleton (10147 in chips) 
Seat 9: JeBoyDirk (25417 in chips) 
MnnM150: posts small blind 50
dhduncan: posts big blind 100
*** HOLE CARDS ***
Dealt to Duke Croix [6h Qh]
Duke Croix: folds 
Klemtonius: calls 100
color_singleton: calls 100
JeBoyDirk: calls 100
MnnM150: calls 50
dhduncan: checks 
*** FLOP *** [2h 4d 8s]
MnnM150: checks 
dhduncan: checks 
Klemtonius: checks 
color_singleton: checks 
JeBoyDirk: bets 200
MnnM150: calls 200
dhduncan: folds 
Klemtonius: calls 200
color_singleton: folds 
*** TURN *** [2h 4d 8s] [4h]
MnnM150: bets 519
Klemtonius: folds 
JeBoyDirk: calls 519
*** RIVER *** [2h 4d 8s 4h] [Ad]
MnnM150: bets 2020
JeBoyDirk: calls 2020
*** SHOW DOWN ***
MnnM150: shows [4s Jd] (three of a kind, Fours)
JeBoyDirk: mucks hand 
MnnM150 collected 5838 from pot
*** SUMMARY ***
Total pot 6178 | Rake 340 
Board [2h 4d 8s 4h Ad]
Seat 1: MnnM150 (small blind) showed [4s Jd] and won (5838) with three of a kind, Fours
Seat 2: dhduncan (big blind) folded on the Flop
Seat 3: Duke Croix folded before Flop (didn't bet)
Seat 5: Klemtonius folded on the Turn
Seat 8: color_singleton folded on the Flop
Seat 9: JeBoyDirk (button) mucked [8h Ah]



PokerStars Home Game Hand #218762599527: {Club #3225207}  Hold'em No Limit (50/100) - 2020/09/24 17:06:51 ET
Table 'money money' 9-max (Play Money) Seat #1 is the button
Seat 1: MnnM150 (16001 in chips) 
Seat 2: dhduncan (6121 in chips) 
Seat 3: Duke Croix (15775 in chips) 
Seat 5: Klemtonius (9823 in chips) 
Seat 8: color_singleton (10047 in chips) 
Seat 9: JeBoyDirk (22578 in chips) 
dhduncan: posts small blind 50
Duke Croix: posts big blind 100
*** HOLE CARDS ***
Dealt to Duke Croix [2h 4d]
Klemtonius: calls 100
color_singleton: folds 
JeBoyDirk: folds 
MnnM150: calls 100
dhduncan: folds 
Duke Croix: checks 
*** FLOP *** [Ks 5s 3c]
Duke Croix has timed out
Duke Croix: checks 
Klemtonius: checks 
MnnM150: bets 165
Duke Croix: calls 165
Klemtonius: folds 
*** TURN *** [Ks 5s 3c] [3s]
Duke Croix: checks 
MnnM150: bets 321
Duke Croix: folds 
Uncalled bet (321) returned to MnnM150
MnnM150 collected 643 from pot
*** SUMMARY ***
Total pot 680 | Rake 37 
Board [Ks 5s 3c 3s]
Seat 1: MnnM150 (button) collected (643)
Seat 2: dhduncan (small blind) folded before Flop
Seat 3: Duke Croix (big blind) folded on the Turn
Seat 5: Klemtonius folded on the Flop
Seat 8: color_singleton folded before Flop (didn't bet)
Seat 9: JeBoyDirk folded before Flop (didn't bet)



PokerStars Home Game Hand #218762639948: {Club #3225207}  Hold'em No Limit (50/100) - 2020/09/24 17:08:03 ET
Table 'money money' 9-max (Play Money) Seat #2 is the button
Seat 1: MnnM150 (16379 in chips) 
Seat 2: dhduncan (6071 in chips) 
Seat 3: Duke Croix (15510 in chips) 
Seat 5: Klemtonius (9723 in chips) 
Seat 8: color_singleton (10047 in chips) 
Seat 9: JeBoyDirk (22578 in chips) 
Duke Croix: posts small blind 50
Klemtonius: posts big blind 100
*** HOLE CARDS ***
Dealt to Duke Croix [Td Kd]
color_singleton: folds 
JeBoyDirk: folds 
MnnM150: raises 100 to 200
dhduncan: folds 
Duke Croix: calls 150
Klemtonius: calls 100
*** FLOP *** [6s 2h 6c]
Duke Croix: bets 400
Klemtonius: calls 400
MnnM150: folds 
*** TURN *** [6s 2h 6c] [5d]
Duke Croix: checks 
Klemtonius: checks 
*** RIVER *** [6s 2h 6c 5d] [3c]
Duke Croix: checks 
Klemtonius: checks 
*** SHOW DOWN ***
Duke Croix: shows [Td Kd] (a pair of Sixes)
Klemtonius: mucks hand 
Duke Croix collected 1323 from pot
*** SUMMARY ***
Total pot 1400 | Rake 77 
Board [6s 2h 6c 5d 3c]
Seat 1: MnnM150 folded on the Flop
Seat 2: dhduncan (button) folded before Flop (didn't bet)
Seat 3: Duke Croix (small blind) showed [Td Kd] and won (1323) with a pair of Sixes
Seat 5: Klemtonius (big blind) mucked [Qs 9s]
Seat 8: color_singleton folded before Flop (didn't bet)
Seat 9: JeBoyDirk folded before Flop (didn't bet)



PokerStars Home Game Hand #218762667611: {Club #3225207}  Hold'em No Limit (50/100) - 2020/09/24 17:08:53 ET
Table 'money money' 9-max (Play Money) Seat #3 is the button
Seat 1: MnnM150 (16179 in chips) 
Seat 2: dhduncan (6071 in chips) 
Seat 3: Duke Croix (16233 in chips) 
Seat 5: Klemtonius (9123 in chips) 
Seat 8: color_singleton (10047 in chips) 
Seat 9: JeBoyDirk (22578 in chips) 
Klemtonius: posts small blind 50
color_singleton: posts big blind 100
*** HOLE CARDS ***
Dealt to Duke Croix [7h 6c]
JeBoyDirk: calls 100
MnnM150: folds 
dhduncan: folds 
Duke Croix: folds 
Klemtonius: calls 50
color_singleton: checks 
*** FLOP *** [6s Ks 4d]
Klemtonius: bets 500
color_singleton: folds 
JeBoyDirk: folds 
Uncalled bet (500) returned to Klemtonius
Klemtonius collected 283 from pot
Klemtonius: doesn't show hand 
*** SUMMARY ***
Total pot 300 | Rake 17 
Board [6s Ks 4d]
Seat 1: MnnM150 folded before Flop (didn't bet)
Seat 2: dhduncan folded before Flop (didn't bet)
Seat 3: Duke Croix (button) folded before Flop (didn't bet)
Seat 5: Klemtonius (small blind) collected (283)
Seat 8: color_singleton (big blind) folded on the Flop
Seat 9: JeBoyDirk folded on the Flop



PokerStars Home Game Hand #218762683303: {Club #3225207}  Hold'em No Limit (50/100) - 2020/09/24 17:09:21 ET
Table 'money money' 9-max (Play Money) Seat #5 is the button
Seat 1: MnnM150 (16179 in chips) 
Seat 2: dhduncan (6071 in chips) 
Seat 3: Duke Croix (16233 in chips) 
Seat 5: Klemtonius (9306 in chips) 
Seat 8: color_singleton (9947 in chips) 
Seat 9: JeBoyDirk (22478 in chips) 
color_singleton: posts small blind 50
JeBoyDirk: posts big blind 100
*** HOLE CARDS ***
Dealt to Duke Croix [Ad 8s]
MnnM150: calls 100
dhduncan: calls 100
Duke Croix: raises 300 to 400
Klemtonius: calls 400
color_singleton: calls 350
JeBoyDirk: raises 300 to 700
MnnM150: folds 
dhduncan: folds 
Duke Croix: calls 300
Klemtonius: calls 300
color_singleton: calls 300
*** FLOP *** [4s Th 9h]
color_singleton: checks 
JeBoyDirk: bets 1000
Duke Croix: folds 
Klemtonius: folds 
color_singleton: calls 1000
*** TURN *** [4s Th 9h] [As]
color_singleton: checks 
JeBoyDirk: bets 2700
color_singleton: folds 
Uncalled bet (2700) returned to JeBoyDirk
JeBoyDirk collected 4725 from pot
*** SUMMARY ***
Total pot 5000 | Rake 275 
Board [4s Th 9h As]
Seat 1: MnnM150 folded before Flop
Seat 2: dhduncan folded before Flop
Seat 3: Duke Croix folded on the Flop
Seat 5: Klemtonius (button) folded on the Flop
Seat 8: color_singleton (small blind) folded on the Turn
Seat 9: JeBoyDirk (big blind) collected (4725)



PokerStars Home Game Hand #218762716460: {Club #3225207}  Hold'em No Limit (50/100) - 2020/09/24 17:10:20 ET
Table 'money money' 9-max (Play Money) Seat #8 is the button
Seat 1: MnnM150 (16079 in chips) 
Seat 2: dhduncan (5971 in chips) 
Seat 3: Duke Croix (15533 in chips) 
Seat 5: Klemtonius (8606 in chips) 
Seat 8: color_singleton (8247 in chips) 
Seat 9: JeBoyDirk (25503 in chips) 
JeBoyDirk: posts small blind 50
MnnM150: posts big blind 100
*** HOLE CARDS ***
Dealt to Duke Croix [5h 2c]
dhduncan: folds 
Duke Croix: folds 
Klemtonius: calls 100
color_singleton: raises 100 to 200
JeBoyDirk: calls 150
MnnM150: calls 100
Klemtonius: calls 100
*** FLOP *** [Qc 5c Ah]
JeBoyDirk: checks 
MnnM150: checks 
Klemtonius: checks 
color_singleton: checks 
*** TURN *** [Qc 5c Ah] [7c]
JeBoyDirk: checks 
MnnM150: checks 
Klemtonius: checks 
color_singleton: checks 
*** RIVER *** [Qc 5c Ah 7c] [Kc]
JeBoyDirk: checks 
MnnM150: checks 
Klemtonius: checks 
color_singleton: checks 
*** SHOW DOWN ***
JeBoyDirk: shows [Js Qs] (a pair of Queens)
MnnM150: mucks hand 
Klemtonius: mucks hand 
color_singleton: mucks hand 
JeBoyDirk collected 756 from pot
*** SUMMARY ***
Total pot 800 | Rake 44 
Board [Qc 5c Ah 7c Kc]
Seat 1: MnnM150 (big blind) mucked [2d Jd]
Seat 2: dhduncan folded before Flop (didn't bet)
Seat 3: Duke Croix folded before Flop (didn't bet)
Seat 5: Klemtonius mucked [3h 4s]
Seat 8: color_singleton (button) mucked [8d 7s]
Seat 9: JeBoyDirk (small blind) showed [Js Qs] and won (756) with a pair of Queens



PokerStars Home Game Hand #218762747353: {Club #3225207}  Hold'em No Limit (50/100) - 2020/09/24 17:11:16 ET
Table 'money money' 9-max (Play Money) Seat #9 is the button
Seat 1: MnnM150 (15879 in chips) 
Seat 2: dhduncan (5971 in chips) 
Seat 3: Duke Croix (15533 in chips) 
Seat 5: Klemtonius (8406 in chips) 
Seat 8: color_singleton (8047 in chips) 
Seat 9: JeBoyDirk (26059 in chips) 
MnnM150: posts small blind 50
dhduncan: posts big blind 100
*** HOLE CARDS ***
Dealt to Duke Croix [2c 9d]
Duke Croix: folds 
Klemtonius: calls 100
color_singleton: raises 200 to 300
JeBoyDirk: folds 
MnnM150: calls 250
dhduncan: calls 200
Klemtonius: calls 200
*** FLOP *** [4s 6s 6d]
MnnM150: bets 567
dhduncan: folds 
Klemtonius: raises 567 to 1134
color_singleton: calls 1134
MnnM150: calls 567
*** TURN *** [4s 6s 6d] [Jh]
MnnM150: checks 
Klemtonius: checks 
color_singleton: bets 2174
MnnM150: folds 
Klemtonius: folds 
Uncalled bet (2174) returned to color_singleton
color_singleton collected 4349 from pot
color_singleton: doesn't show hand 
*** SUMMARY ***
Total pot 4602 | Rake 253 
Board [4s 6s 6d Jh]
Seat 1: MnnM150 (small blind) folded on the Turn
Seat 2: dhduncan (big blind) folded on the Flop
Seat 3: Duke Croix folded before Flop (didn't bet)
Seat 5: Klemtonius folded on the Turn
Seat 8: color_singleton collected (4349)
Seat 9: JeBoyDirk (button) folded before Flop (didn't bet)



PokerStars Home Game Hand #218762789247: {Club #3225207}  Hold'em No Limit (50/100) - 2020/09/24 17:12:33 ET
Table 'money money' 9-max (Play Money) Seat #1 is the button
Seat 1: MnnM150 (14445 in chips) 
Seat 2: dhduncan (5671 in chips) 
Seat 3: Duke Croix (15533 in chips) 
Seat 5: Klemtonius (6972 in chips) 
Seat 8: color_singleton (10962 in chips) 
Seat 9: JeBoyDirk (26059 in chips) 
dhduncan: posts small blind 50
Duke Croix: posts big blind 100
*** HOLE CARDS ***
Dealt to Duke Croix [9c 8c]
Klemtonius: folds 
color_singleton: raises 100 to 200
JeBoyDirk: folds 
MnnM150: folds 
dhduncan: folds 
Duke Croix: raises 200 to 400
color_singleton: calls 200
*** FLOP *** [9s Jc 2h]
Duke Croix: bets 400
color_singleton: calls 400
*** TURN *** [9s Jc 2h] [Td]
Duke Croix: checks 
color_singleton: checks 
*** RIVER *** [9s Jc 2h Td] [6h]
Duke Croix: bets 800
color_singleton: calls 800
*** SHOW DOWN ***
Duke Croix: shows [9c 8c] (a pair of Nines)
color_singleton: shows [Qh Th] (a pair of Tens)
color_singleton collected 3071 from pot
*** SUMMARY ***
Total pot 3250 | Rake 179 
Board [9s Jc 2h Td 6h]
Seat 1: MnnM150 (button) folded before Flop (didn't bet)
Seat 2: dhduncan (small blind) folded before Flop
Seat 3: Duke Croix (big blind) showed [9c 8c] and lost with a pair of Nines
Seat 5: Klemtonius folded before Flop (didn't bet)
Seat 8: color_singleton showed [Qh Th] and won (3071) with a pair of Tens
Seat 9: JeBoyDirk folded before Flop (didn't bet)



PokerStars Home Game Hand #218762810131: {Club #3225207}  Hold'em No Limit (50/100) - 2020/09/24 17:13:10 ET
Table 'money money' 9-max (Play Money) Seat #2 is the button
Seat 1: MnnM150 (14445 in chips) 
Seat 2: dhduncan (5621 in chips) 
Seat 3: Duke Croix (13933 in chips) 
Seat 5: Klemtonius (6972 in chips) 
Seat 8: color_singleton (12433 in chips) 
Seat 9: JeBoyDirk (26059 in chips) 
Duke Croix: posts small blind 50
Klemtonius: posts big blind 100
*** HOLE CARDS ***
Dealt to Duke Croix [3h Tc]
color_singleton: raises 100 to 200
JeBoyDirk: folds 
MnnM150: calls 200
dhduncan: calls 200
Duke Croix: folds 
Klemtonius: folds 
*** FLOP *** [2d As 7h]
color_singleton: checks 
MnnM150: bets 354
dhduncan: folds 
color_singleton: folds 
Uncalled bet (354) returned to MnnM150
MnnM150 collected 709 from pot
*** SUMMARY ***
Total pot 750 | Rake 41 
Board [2d As 7h]
Seat 1: MnnM150 collected (709)
Seat 2: dhduncan (button) folded on the Flop
Seat 3: Duke Croix (small blind) folded before Flop
Seat 5: Klemtonius (big blind) folded before Flop
Seat 8: color_singleton folded on the Flop
Seat 9: JeBoyDirk folded before Flop (didn't bet)



PokerStars Home Game Hand #218762822483: {Club #3225207}  Hold'em No Limit (50/100) - 2020/09/24 17:13:32 ET
Table 'money money' 9-max (Play Money) Seat #3 is the button
Seat 1: MnnM150 (14954 in chips) 
Seat 2: dhduncan (5421 in chips) 
Seat 3: Duke Croix (13883 in chips) 
Seat 5: Klemtonius (6872 in chips) 
Seat 8: color_singleton (12233 in chips) 
Seat 9: JeBoyDirk (26059 in chips) 
Klemtonius: posts small blind 50
color_singleton: posts big blind 100
*** HOLE CARDS ***
Dealt to Duke Croix [Jc Kd]
JeBoyDirk: folds 
MnnM150: raises 100 to 200
dhduncan: calls 200
Duke Croix: raises 400 to 600
Klemtonius: calls 550
color_singleton: folds 
MnnM150: calls 400
dhduncan: folds 
*** FLOP *** [8h 8s 3h]
Klemtonius: bets 1984
MnnM150: folds 
Duke Croix: folds 
Uncalled bet (1984) returned to Klemtonius
Klemtonius collected 1984 from pot
Klemtonius: doesn't show hand 
*** SUMMARY ***
Total pot 2100 | Rake 116 
Board [8h 8s 3h]
Seat 1: MnnM150 folded on the Flop
Seat 2: dhduncan folded before Flop
Seat 3: Duke Croix (button) folded on the Flop
Seat 5: Klemtonius (small blind) collected (1984)
Seat 8: color_singleton (big blind) folded before Flop
Seat 9: JeBoyDirk folded before Flop (didn't bet)



PokerStars Home Game Hand #218762848208: {Club #3225207}  Hold'em No Limit (50/100) - 2020/09/24 17:14:19 ET
Table 'money money' 9-max (Play Money) Seat #5 is the button
Seat 1: MnnM150 (14354 in chips) 
Seat 2: dhduncan (5221 in chips) 
Seat 3: Duke Croix (13283 in chips) 
Seat 5: Klemtonius (8256 in chips) 
Seat 8: color_singleton (12133 in chips) 
Seat 9: JeBoyDirk (26059 in chips) 
color_singleton: posts small blind 50
JeBoyDirk: posts big blind 100
*** HOLE CARDS ***
Dealt to Duke Croix [Kd Js]
MnnM150: folds 
dhduncan: calls 100
Duke Croix: raises 300 to 400
Klemtonius: calls 400
color_singleton: calls 350
JeBoyDirk: calls 300
dhduncan: calls 300
*** FLOP *** [9c As 2s]
color_singleton: checks 
JeBoyDirk: checks 
dhduncan: checks 
Duke Croix: checks 
Klemtonius: bets 100
color_singleton: calls 100
JeBoyDirk: raises 300 to 400
dhduncan: calls 400
Duke Croix: folds 
Klemtonius: raises 300 to 700
color_singleton: calls 600
JeBoyDirk: raises 1000 to 1700
dhduncan: folds 
Klemtonius: raises 1000 to 2700
color_singleton: folds 
JeBoyDirk: raises 22959 to 25659 and is all-in
Klemtonius: calls 5156 and is all-in
Uncalled bet (17803) returned to JeBoyDirk
*** TURN *** [9c As 2s] [7h]
*** RIVER *** [9c As 2s 7h] [9s]
*** SHOW DOWN ***
JeBoyDirk: shows [9h 9d] (four of a kind, Nines)
Klemtonius: shows [2d Ac] (two pair, Aces and Nines)
JeBoyDirk collected 17777 from pot
*** SUMMARY ***
Total pot 18812 | Rake 1035 
Board [9c As 2s 7h 9s]
Seat 1: MnnM150 folded before Flop (didn't bet)
Seat 2: dhduncan folded on the Flop
Seat 3: Duke Croix folded on the Flop
Seat 5: Klemtonius (button) showed [2d Ac] and lost with two pair, Aces and Nines
Seat 8: color_singleton (small blind) folded on the Flop
Seat 9: JeBoyDirk (big blind) showed [9h 9d] and won (17777) with four of a kind, Nines



PokerStars Home Game Hand #218762884834: {Club #3225207}  Hold'em No Limit (50/100) - 2020/09/24 17:15:25 ET
Table 'money money' 9-max (Play Money) Seat #8 is the button
Seat 1: MnnM150 (14354 in chips) 
Seat 2: dhduncan (4421 in chips) 
Seat 3: Duke Croix (12883 in chips) 
Seat 8: color_singleton (11033 in chips) 
Seat 9: JeBoyDirk (35580 in chips) 
JeBoyDirk: posts small blind 50
MnnM150: posts big blind 100
*** HOLE CARDS ***
Dealt to Duke Croix [9s Jh]
dhduncan: folds 
Duke Croix: calls 100
color_singleton: raises 100 to 200
JeBoyDirk: calls 150
MnnM150: calls 100
Duke Croix: calls 100
*** FLOP *** [7d Js 2c]
JeBoyDirk: checks 
MnnM150: bets 378
Duke Croix: raises 422 to 800
color_singleton: folds 
JeBoyDirk: folds 
MnnM150: calls 422
*** TURN *** [7d Js 2c] [Ts]
MnnM150: checks 
Duke Croix: bets 1100
MnnM150: folds 
Uncalled bet (1100) returned to Duke Croix
Duke Croix collected 2268 from pot
*** SUMMARY ***
Total pot 2400 | Rake 132 
Board [7d Js 2c Ts]
Seat 1: MnnM150 (big blind) folded on the Turn
Seat 2: dhduncan folded before Flop (didn't bet)
Seat 3: Duke Croix collected (2268)
Seat 8: color_singleton (button) folded on the Flop
Seat 9: JeBoyDirk (small blind) folded on the Flop



PokerStars Home Game Hand #218762914045: {Club #3225207}  Hold'em No Limit (50/100) - 2020/09/24 17:16:18 ET
Table 'money money' 9-max (Play Money) Seat #9 is the button
Seat 1: MnnM150 (13354 in chips) 
Seat 2: dhduncan (4421 in chips) 
Seat 3: Duke Croix (14151 in chips) 
Seat 5: Klemtonius (10000 in chips) 
Seat 8: color_singleton (10833 in chips) 
Seat 9: JeBoyDirk (35380 in chips) 
MnnM150: posts small blind 50
dhduncan: posts big blind 100
*** HOLE CARDS ***
Dealt to Duke Croix [5h Kd]
Duke Croix: folds 
Klemtonius: calls 100
color_singleton: folds 
JeBoyDirk: folds 
MnnM150: calls 50
dhduncan: checks 
*** FLOP *** [Ks 4s 9h]
MnnM150: checks 
dhduncan: checks 
Klemtonius: checks 
*** TURN *** [Ks 4s 9h] [Td]
MnnM150: bets 141
dhduncan: calls 141
Klemtonius: calls 141
*** RIVER *** [Ks 4s 9h Td] [3d]
MnnM150: bets 341
dhduncan: calls 341
Klemtonius: folds 
*** SHOW DOWN ***
MnnM150: shows [Th 9s] (two pair, Tens and Nines)
dhduncan: mucks hand 
MnnM150 collected 1328 from pot
*** SUMMARY ***
Total pot 1405 | Rake 77 
Board [Ks 4s 9h Td 3d]
Seat 1: MnnM150 (small blind) showed [Th 9s] and won (1328) with two pair, Tens and Nines
Seat 2: dhduncan (big blind) mucked [7d Kc]
Seat 3: Duke Croix folded before Flop (didn't bet)
Seat 5: Klemtonius folded on the River
Seat 8: color_singleton folded before Flop (didn't bet)
Seat 9: JeBoyDirk (button) folded before Flop (didn't bet)



PokerStars Home Game Hand #218762938438: {Club #3225207}  Hold'em No Limit (50/100) - 2020/09/24 17:17:02 ET
Table 'money money' 9-max (Play Money) Seat #1 is the button
Seat 1: MnnM150 (14100 in chips) 
Seat 2: dhduncan (3839 in chips) 
Seat 3: Duke Croix (14151 in chips) 
Seat 5: Klemtonius (9759 in chips) 
Seat 8: color_singleton (10833 in chips) 
Seat 9: JeBoyDirk (35380 in chips) 
dhduncan: posts small blind 50
Duke Croix: posts big blind 100
*** HOLE CARDS ***
Dealt to Duke Croix [Jd 3c]
Klemtonius: raises 100 to 200
color_singleton: calls 200
JeBoyDirk: calls 200
MnnM150: folds 
dhduncan: folds 
Duke Croix: calls 100
*** FLOP *** [9h 5h 2c]
Duke Croix: checks 
Klemtonius: checks 
color_singleton: checks 
JeBoyDirk: checks 
*** TURN *** [9h 5h 2c] [8c]
Duke Croix: checks 
Klemtonius: checks 
color_singleton: checks 
JeBoyDirk: checks 
*** RIVER *** [9h 5h 2c 8c] [Jh]
Duke Croix: bets 800
Klemtonius: folds 
color_singleton: calls 800
JeBoyDirk: calls 800
*** SHOW DOWN ***
Duke Croix: shows [Jd 3c] (a pair of Jacks)
color_singleton: shows [Js Qs] (a pair of Jacks - Queen kicker)
JeBoyDirk: shows [Kh 6h] (a flush, King high)
JeBoyDirk collected 3071 from pot
*** SUMMARY ***
Total pot 3250 | Rake 179 
Board [9h 5h 2c 8c Jh]
Seat 1: MnnM150 (button) folded before Flop (didn't bet)
Seat 2: dhduncan (small blind) folded before Flop
Seat 3: Duke Croix (big blind) showed [Jd 3c] and lost with a pair of Jacks
Seat 5: Klemtonius folded on the River
Seat 8: color_singleton showed [Js Qs] and lost with a pair of Jacks
Seat 9: JeBoyDirk showed [Kh 6h] and won (3071) with a flush, King high



PokerStars Home Game Hand #218762966392: {Club #3225207}  Hold'em No Limit (50/100) - 2020/09/24 17:17:53 ET
Table 'money money' 9-max (Play Money) Seat #2 is the button
Seat 1: MnnM150 (14100 in chips) 
Seat 2: dhduncan (3789 in chips) 
Seat 3: Duke Croix (13151 in chips) 
Seat 5: Klemtonius (9559 in chips) 
Seat 8: color_singleton (9833 in chips) 
Seat 9: JeBoyDirk (37451 in chips) 
Duke Croix: posts small blind 50
Klemtonius: posts big blind 100
*** HOLE CARDS ***
Dealt to Duke Croix [Kc 6h]
color_singleton: folds 
JeBoyDirk: calls 100
MnnM150: calls 100
dhduncan: raises 100 to 200
Duke Croix: folds 
Klemtonius: calls 100
JeBoyDirk: calls 100
MnnM150: calls 100
*** FLOP *** [Ks 9s Tc]
Klemtonius: checks 
JeBoyDirk: bets 400
MnnM150: folds 
dhduncan: calls 400
Klemtonius: folds 
*** TURN *** [Ks 9s Tc] [8d]
JeBoyDirk: bets 700
dhduncan: raises 2489 to 3189 and is all-in
JeBoyDirk: folds 
Uncalled bet (2489) returned to dhduncan
dhduncan collected 2882 from pot
dhduncan: doesn't show hand 
*** SUMMARY ***
Total pot 3050 | Rake 168 
Board [Ks 9s Tc 8d]
Seat 1: MnnM150 folded on the Flop
Seat 2: dhduncan (button) collected (2882)
Seat 3: Duke Croix (small blind) folded before Flop
Seat 5: Klemtonius (big blind) folded on the Flop
Seat 8: color_singleton folded before Flop (didn't bet)
Seat 9: JeBoyDirk folded on the Turn



PokerStars Home Game Hand #218763008413: {Club #3225207}  Hold'em No Limit (50/100) - 2020/09/24 17:19:09 ET
Table 'money money' 9-max (Play Money) Seat #3 is the button
Seat 1: MnnM150 (13900 in chips) 
Seat 2: dhduncan (5371 in chips) 
Seat 3: Duke Croix (13101 in chips) 
Seat 5: Klemtonius (9359 in chips) 
Seat 8: color_singleton (9833 in chips) 
Seat 9: JeBoyDirk (36151 in chips) 
Klemtonius: posts small blind 50
color_singleton: posts big blind 100
*** HOLE CARDS ***
Dealt to Duke Croix [3c Qc]
JeBoyDirk: calls 100
MnnM150: folds 
dhduncan: folds 
Duke Croix: calls 100
Klemtonius: calls 50
color_singleton: checks 
*** FLOP *** [3d 8c 9h]
Klemtonius: checks 
color_singleton: checks 
JeBoyDirk: checks 
Duke Croix: checks 
*** TURN *** [3d 8c 9h] [6c]
Klemtonius: checks 
color_singleton: checks 
JeBoyDirk: checks 
Duke Croix: bets 300
Klemtonius: calls 300
color_singleton: folds 
JeBoyDirk: folds 
*** RIVER *** [3d 8c 9h 6c] [8s]
Klemtonius: checks 
Duke Croix: bets 700
Klemtonius: folds 
Uncalled bet (700) returned to Duke Croix
Duke Croix collected 945 from pot
*** SUMMARY ***
Total pot 1000 | Rake 55 
Board [3d 8c 9h 6c 8s]
Seat 1: MnnM150 folded before Flop (didn't bet)
Seat 2: dhduncan folded before Flop (didn't bet)
Seat 3: Duke Croix (button) collected (945)
Seat 5: Klemtonius (small blind) folded on the River
Seat 8: color_singleton (big blind) folded on the Turn
Seat 9: JeBoyDirk folded on the Turn



PokerStars Home Game Hand #218763046668: {Club #3225207}  Hold'em No Limit (50/100) - 2020/09/24 17:20:20 ET
Table 'money money' 9-max (Play Money) Seat #5 is the button
Seat 1: MnnM150 (13900 in chips) 
Seat 2: dhduncan (5371 in chips) 
Seat 3: Duke Croix (13646 in chips) 
Seat 5: Klemtonius (8959 in chips) 
Seat 8: color_singleton (9733 in chips) 
Seat 9: JeBoyDirk (36051 in chips) 
color_singleton: posts small blind 50
JeBoyDirk: posts big blind 100
*** HOLE CARDS ***
Dealt to Duke Croix [Ts 5d]
MnnM150: folds 
dhduncan: folds 
Duke Croix: folds 
Klemtonius: calls 100
color_singleton: calls 50
JeBoyDirk: checks 
*** FLOP *** [Qd 9c As]
color_singleton: checks 
JeBoyDirk: bets 200
Klemtonius: calls 200
color_singleton: folds 
*** TURN *** [Qd 9c As] [3c]
JeBoyDirk: bets 200
Klemtonius: folds 
Uncalled bet (200) returned to JeBoyDirk
JeBoyDirk collected 661 from pot
*** SUMMARY ***
Total pot 700 | Rake 39 
Board [Qd 9c As 3c]
Seat 1: MnnM150 folded before Flop (didn't bet)
Seat 2: dhduncan folded before Flop (didn't bet)
Seat 3: Duke Croix folded before Flop (didn't bet)
Seat 5: Klemtonius (button) folded on the Turn
Seat 8: color_singleton (small blind) folded on the Flop
Seat 9: JeBoyDirk (big blind) collected (661)



PokerStars Home Game Hand #218763067466: {Club #3225207}  Hold'em No Limit (50/100) - 2020/09/24 17:20:58 ET
Table 'money money' 9-max (Play Money) Seat #8 is the button
Seat 1: MnnM150 (13900 in chips) 
Seat 2: dhduncan (5371 in chips) 
Seat 3: Duke Croix (13646 in chips) 
Seat 5: Klemtonius (8659 in chips) 
Seat 8: color_singleton (9633 in chips) 
Seat 9: JeBoyDirk (36412 in chips) 
JeBoyDirk: posts small blind 50
MnnM150: posts big blind 100
*** HOLE CARDS ***
Dealt to Duke Croix [5h Qh]
dhduncan: raises 100 to 200
Duke Croix: folds 
Klemtonius: calls 200
color_singleton: calls 200
JeBoyDirk: folds 
MnnM150: folds 
*** FLOP *** [9s 8d 8h]
dhduncan has timed out
dhduncan: checks 
Klemtonius: checks 
color_singleton: checks 
*** TURN *** [9s 8d 8h] [4s]
dhduncan: checks 
Klemtonius: bets 100
color_singleton: calls 100
dhduncan: folds 
*** RIVER *** [9s 8d 8h 4s] [Qd]
Klemtonius: checks 
color_singleton: checks 
*** SHOW DOWN ***
Klemtonius: shows [Qc 8s] (a full house, Eights full of Queens)
color_singleton: mucks hand 
Klemtonius collected 898 from pot
*** SUMMARY ***
Total pot 950 | Rake 52 
Board [9s 8d 8h 4s Qd]
Seat 1: MnnM150 (big blind) folded before Flop
Seat 2: dhduncan folded on the Turn
Seat 3: Duke Croix folded before Flop (didn't bet)
Seat 5: Klemtonius showed [Qc 8s] and won (898) with a full house, Eights full of Queens
Seat 8: color_singleton (button) mucked [7d Jd]
Seat 9: JeBoyDirk (small blind) folded before Flop



PokerStars Home Game Hand #218763107745: {Club #3225207}  Hold'em No Limit (50/100) - 2020/09/24 17:22:13 ET
Table 'money money' 9-max (Play Money) Seat #9 is the button
Seat 1: MnnM150 (13800 in chips) 
Seat 2: dhduncan (5171 in chips) 
Seat 3: Duke Croix (13646 in chips) 
Seat 5: Klemtonius (9257 in chips) 
Seat 8: color_singleton (9333 in chips) 
Seat 9: JeBoyDirk (36362 in chips) 
MnnM150: posts small blind 50
dhduncan: posts big blind 100
*** HOLE CARDS ***
Dealt to Duke Croix [8s 6h]
Duke Croix: folds 
Klemtonius: calls 100
color_singleton: folds 
JeBoyDirk: folds 
MnnM150: folds 
dhduncan: checks 
*** FLOP *** [7c Kh 7h]
dhduncan: bets 100
Klemtonius: folds 
Uncalled bet (100) returned to dhduncan
dhduncan collected 236 from pot
dhduncan: doesn't show hand 
*** SUMMARY ***
Total pot 250 | Rake 14 
Board [7c Kh 7h]
Seat 1: MnnM150 (small blind) folded before Flop
Seat 2: dhduncan (big blind) collected (236)
Seat 3: Duke Croix folded before Flop (didn't bet)
Seat 5: Klemtonius folded on the Flop
Seat 8: color_singleton folded before Flop (didn't bet)
Seat 9: JeBoyDirk (button) folded before Flop (didn't bet)



