PokerStars Home Game Hand #219631601940: {Club #3225207}  Hold'em No Limit (50/100) - 2020/10/22 14:44:03 ET
Table 'VU_table_tonight' 9-max (Play Money) Seat #1 is the button
Seat 1: color_singleton (9239 in chips) 
Seat 2: MnnM150 (9700 in chips) 
Seat 3: Duke Croix (10000 in chips) 
Seat 9: JeBoyDirk (10846 in chips) 
MnnM150: posts small blind 50
Duke Croix: posts big blind 100
*** HOLE CARDS ***
Dealt to Duke Croix [3c 6c]
JeBoyDirk: folds 
color_singleton: folds 
MnnM150: calls 50
Duke Croix: checks 
*** FLOP *** [8h 7d 6s]
MnnM150: checks 
Duke Croix: bets 200
MnnM150: folds 
Uncalled bet (200) returned to Duke Croix
Duke Croix collected 189 from pot
*** SUMMARY ***
Total pot 200 | Rake 11 
Board [8h 7d 6s]
Seat 1: color_singleton (button) folded before Flop (didn't bet)
Seat 2: MnnM150 (small blind) folded on the Flop
Seat 3: Duke Croix (big blind) collected (189)
Seat 9: JeBoyDirk folded before Flop (didn't bet)



PokerStars Home Game Hand #219631616102: {Club #3225207}  Hold'em No Limit (50/100) - 2020/10/22 14:44:29 ET
Table 'VU_table_tonight' 9-max (Play Money) Seat #2 is the button
Seat 1: color_singleton (9239 in chips) 
Seat 2: MnnM150 (9600 in chips) 
Seat 3: Duke Croix (10089 in chips) 
Seat 9: JeBoyDirk (10846 in chips) 
Duke Croix: posts small blind 50
JeBoyDirk: posts big blind 100
*** HOLE CARDS ***
Dealt to Duke Croix [9s 2d]
color_singleton: folds 
MnnM150: folds 
Duke Croix has timed out
Duke Croix: folds 
Uncalled bet (50) returned to JeBoyDirk
JeBoyDirk collected 100 from pot
*** SUMMARY ***
Total pot 100 | Rake 0 
Seat 1: color_singleton folded before Flop (didn't bet)
Seat 2: MnnM150 (button) folded before Flop (didn't bet)
Seat 3: Duke Croix (small blind) folded before Flop
Seat 9: JeBoyDirk (big blind) collected (100)



PokerStars Home Game Hand #219631642011: {Club #3225207}  Hold'em No Limit (50/100) - 2020/10/22 14:45:15 ET
Table 'VU_table_tonight' 9-max (Play Money) Seat #1 is the button
Seat 1: color_singleton (9339 in chips) 
Seat 2: MnnM150 (9500 in chips) 
Seat 3: Duke Croix (10039 in chips) 
Seat 9: JeBoyDirk (10896 in chips) 
MnnM150: posts small blind 50
Duke Croix: posts big blind 100
*** HOLE CARDS ***
Dealt to Duke Croix [9h 6d]
JeBoyDirk: raises 200 to 300
color_singleton: folds 
MnnM150: folds 
Duke Croix: calls 200
*** FLOP *** [Jh Qd Ad]
Duke Croix has timed out
Duke Croix: checks 
JeBoyDirk: bets 400
Duke Croix: folds 
Uncalled bet (400) returned to JeBoyDirk
JeBoyDirk collected 614 from pot
*** SUMMARY ***
Total pot 650 | Rake 36 
Board [Jh Qd Ad]
Seat 1: color_singleton (button) folded before Flop (didn't bet)
Seat 2: MnnM150 (small blind) folded before Flop
Seat 3: Duke Croix (big blind) folded on the Flop
Seat 9: JeBoyDirk collected (614)



PokerStars Home Game Hand #219631672335: {Club #3225207}  Hold'em No Limit (50/100) - 2020/10/22 14:46:10 ET
Table 'VU_table_tonight' 9-max (Play Money) Seat #2 is the button
Seat 1: color_singleton (9339 in chips) 
Seat 2: MnnM150 (9450 in chips) 
Seat 3: Duke Croix (9739 in chips) 
Seat 9: JeBoyDirk (11210 in chips) 
Duke Croix: posts small blind 50
JeBoyDirk: posts big blind 100
*** HOLE CARDS ***
Dealt to Duke Croix [9c Ks]
color_singleton: raises 200 to 300
MnnM150: folds 
Duke Croix: calls 250
JeBoyDirk: folds 
*** FLOP *** [5d 7c 3h]
Duke Croix: checks 
color_singleton: bets 330
Duke Croix: folds 
Uncalled bet (330) returned to color_singleton
color_singleton collected 661 from pot
color_singleton: doesn't show hand 
*** SUMMARY ***
Total pot 700 | Rake 39 
Board [5d 7c 3h]
Seat 1: color_singleton collected (661)
Seat 2: MnnM150 (button) folded before Flop (didn't bet)
Seat 3: Duke Croix (small blind) folded on the Flop
Seat 9: JeBoyDirk (big blind) folded before Flop



PokerStars Home Game Hand #219631687318: {Club #3225207}  Hold'em No Limit (50/100) - 2020/10/22 14:46:36 ET
Table 'VU_table_tonight' 9-max (Play Money) Seat #3 is the button
Seat 1: color_singleton (9700 in chips) 
Seat 2: MnnM150 (9450 in chips) 
Seat 3: Duke Croix (9439 in chips) 
Seat 9: JeBoyDirk (11110 in chips) 
JeBoyDirk: posts small blind 50
color_singleton: posts big blind 100
*** HOLE CARDS ***
Dealt to Duke Croix [2d 8c]
MnnM150: calls 100
Duke Croix: folds 
JeBoyDirk: folds 
color_singleton: raises 200 to 300
MnnM150: calls 200
*** FLOP *** [8s 6d Tc]
color_singleton: checks 
MnnM150: checks 
*** TURN *** [8s 6d Tc] [Qs]
color_singleton: bets 307
MnnM150: raises 307 to 614
color_singleton: calls 307
*** RIVER *** [8s 6d Tc Qs] [Qh]
color_singleton: checks 
MnnM150: bets 1775
color_singleton: folds 
Uncalled bet (1775) returned to MnnM150
MnnM150 collected 1775 from pot
*** SUMMARY ***
Total pot 1878 | Rake 103 
Board [8s 6d Tc Qs Qh]
Seat 1: color_singleton (big blind) folded on the River
Seat 2: MnnM150 collected (1775)
Seat 3: Duke Croix (button) folded before Flop (didn't bet)
Seat 9: JeBoyDirk (small blind) folded before Flop



PokerStars Home Game Hand #219631712821: {Club #3225207}  Hold'em No Limit (50/100) - 2020/10/22 14:47:22 ET
Table 'VU_table_tonight' 9-max (Play Money) Seat #9 is the button
Seat 1: color_singleton (8786 in chips) 
Seat 2: MnnM150 (10311 in chips) 
Seat 3: Duke Croix (9439 in chips) 
Seat 9: JeBoyDirk (11060 in chips) 
color_singleton: posts small blind 50
MnnM150: posts big blind 100
*** HOLE CARDS ***
Dealt to Duke Croix [8h 9c]
Duke Croix: calls 100
JeBoyDirk: folds 
color_singleton: raises 200 to 300
MnnM150: calls 200
Duke Croix: calls 200
*** FLOP *** [8c Qs 4h]
color_singleton: bets 425
MnnM150: folds 
Duke Croix: folds 
Uncalled bet (425) returned to color_singleton
color_singleton collected 850 from pot
color_singleton: doesn't show hand 
*** SUMMARY ***
Total pot 900 | Rake 50 
Board [8c Qs 4h]
Seat 1: color_singleton (small blind) collected (850)
Seat 2: MnnM150 (big blind) folded on the Flop
Seat 3: Duke Croix folded on the Flop
Seat 9: JeBoyDirk (button) folded before Flop (didn't bet)



PokerStars Home Game Hand #219631728553: {Club #3225207}  Hold'em No Limit (50/100) - 2020/10/22 14:47:50 ET
Table 'VU_table_tonight' 9-max (Play Money) Seat #1 is the button
Seat 1: color_singleton (9336 in chips) 
Seat 2: MnnM150 (10011 in chips) 
Seat 3: Duke Croix (9139 in chips) 
Seat 9: JeBoyDirk (11060 in chips) 
MnnM150: posts small blind 50
Duke Croix: posts big blind 100
*** HOLE CARDS ***
Dealt to Duke Croix [As 5h]
JeBoyDirk: raises 200 to 300
color_singleton: folds 
MnnM150: folds 
Duke Croix: calls 200
*** FLOP *** [3s Td 2d]
Duke Croix: bets 400
JeBoyDirk: raises 400 to 800
Duke Croix: folds 
Uncalled bet (400) returned to JeBoyDirk
JeBoyDirk collected 1370 from pot
*** SUMMARY ***
Total pot 1450 | Rake 80 
Board [3s Td 2d]
Seat 1: color_singleton (button) folded before Flop (didn't bet)
Seat 2: MnnM150 (small blind) folded before Flop
Seat 3: Duke Croix (big blind) folded on the Flop
Seat 9: JeBoyDirk collected (1370)



PokerStars Home Game Hand #219631744899: {Club #3225207}  Hold'em No Limit (50/100) - 2020/10/22 14:48:19 ET
Table 'VU_table_tonight' 9-max (Play Money) Seat #2 is the button
Seat 1: color_singleton (9336 in chips) 
Seat 2: MnnM150 (9961 in chips) 
Seat 3: Duke Croix (8439 in chips) 
Seat 9: JeBoyDirk (11730 in chips) 
Duke Croix: posts small blind 50
JeBoyDirk: posts big blind 100
*** HOLE CARDS ***
Dealt to Duke Croix [Jh 5h]
color_singleton: folds 
MnnM150: folds 
Duke Croix: calls 50
JeBoyDirk: checks 
*** FLOP *** [2c Kc 8d]
Duke Croix: checks 
JeBoyDirk: checks 
*** TURN *** [2c Kc 8d] [9s]
Duke Croix: checks 
JeBoyDirk: checks 
*** RIVER *** [2c Kc 8d 9s] [5d]
Duke Croix: checks 
JeBoyDirk: checks 
*** SHOW DOWN ***
Duke Croix: shows [Jh 5h] (a pair of Fives)
JeBoyDirk: mucks hand 
Duke Croix collected 189 from pot
*** SUMMARY ***
Total pot 200 | Rake 11 
Board [2c Kc 8d 9s 5d]
Seat 1: color_singleton folded before Flop (didn't bet)
Seat 2: MnnM150 (button) folded before Flop (didn't bet)
Seat 3: Duke Croix (small blind) showed [Jh 5h] and won (189) with a pair of Fives
Seat 9: JeBoyDirk (big blind) mucked [7s Ah]



PokerStars Home Game Hand #219631759092: {Club #3225207}  Hold'em No Limit (50/100) - 2020/10/22 14:48:44 ET
Table 'VU_table_tonight' 9-max (Play Money) Seat #3 is the button
Seat 1: color_singleton (9336 in chips) 
Seat 2: MnnM150 (9961 in chips) 
Seat 3: Duke Croix (8528 in chips) 
Seat 9: JeBoyDirk (11630 in chips) 
JeBoyDirk: posts small blind 50
color_singleton: posts big blind 100
*** HOLE CARDS ***
Dealt to Duke Croix [8c 8s]
MnnM150: calls 100
Duke Croix: raises 300 to 400
JeBoyDirk: folds 
color_singleton: calls 300
MnnM150: folds 
*** FLOP *** [3c 5c 7s]
color_singleton: checks 
Duke Croix: bets 500
color_singleton: calls 500
*** TURN *** [3c 5c 7s] [6c]
color_singleton: checks 
Duke Croix: bets 800
color_singleton: calls 800
*** RIVER *** [3c 5c 7s 6c] [Ah]
color_singleton: checks 
Duke Croix: checks 
*** SHOW DOWN ***
color_singleton: shows [Qs Kc] (high card Ace)
Duke Croix: shows [8c 8s] (a pair of Eights)
Duke Croix collected 3355 from pot
*** SUMMARY ***
Total pot 3550 | Rake 195 
Board [3c 5c 7s 6c Ah]
Seat 1: color_singleton (big blind) showed [Qs Kc] and lost with high card Ace
Seat 2: MnnM150 folded before Flop
Seat 3: Duke Croix (button) showed [8c 8s] and won (3355) with a pair of Eights
Seat 9: JeBoyDirk (small blind) folded before Flop



PokerStars Home Game Hand #219631782219: {Club #3225207}  Hold'em No Limit (50/100) - 2020/10/22 14:49:25 ET
Table 'VU_table_tonight' 9-max (Play Money) Seat #9 is the button
Seat 1: color_singleton (7636 in chips) 
Seat 2: MnnM150 (9861 in chips) 
Seat 3: Duke Croix (10183 in chips) 
Seat 9: JeBoyDirk (11580 in chips) 
color_singleton: posts small blind 50
MnnM150: posts big blind 100
*** HOLE CARDS ***
Dealt to Duke Croix [Jc 2d]
Duke Croix: folds 
JeBoyDirk: raises 200 to 300
color_singleton: folds 
MnnM150: folds 
Uncalled bet (200) returned to JeBoyDirk
JeBoyDirk collected 250 from pot
*** SUMMARY ***
Total pot 250 | Rake 0 
Seat 1: color_singleton (small blind) folded before Flop
Seat 2: MnnM150 (big blind) folded before Flop
Seat 3: Duke Croix folded before Flop (didn't bet)
Seat 9: JeBoyDirk (button) collected (250)



PokerStars Home Game Hand #219631786885: {Club #3225207}  Hold'em No Limit (50/100) - 2020/10/22 14:49:33 ET
Table 'VU_table_tonight' 9-max (Play Money) Seat #1 is the button
Seat 1: color_singleton (7586 in chips) 
Seat 2: MnnM150 (9761 in chips) 
Seat 3: Duke Croix (10183 in chips) 
Seat 9: JeBoyDirk (11730 in chips) 
MnnM150: posts small blind 50
Duke Croix: posts big blind 100
*** HOLE CARDS ***
Dealt to Duke Croix [Ts 8c]
JeBoyDirk: folds 
color_singleton: folds 
MnnM150: folds 
Uncalled bet (50) returned to Duke Croix
Duke Croix collected 100 from pot
*** SUMMARY ***
Total pot 100 | Rake 0 
Seat 1: color_singleton (button) folded before Flop (didn't bet)
Seat 2: MnnM150 (small blind) folded before Flop
Seat 3: Duke Croix (big blind) collected (100)
Seat 9: JeBoyDirk folded before Flop (didn't bet)



PokerStars Home Game Hand #219631791550: {Club #3225207}  Hold'em No Limit (50/100) - 2020/10/22 14:49:42 ET
Table 'VU_table_tonight' 9-max (Play Money) Seat #2 is the button
Seat 1: color_singleton (7586 in chips) 
Seat 2: MnnM150 (9711 in chips) 
Seat 3: Duke Croix (10233 in chips) 
Seat 9: JeBoyDirk (11730 in chips) 
Duke Croix: posts small blind 50
JeBoyDirk: posts big blind 100
*** HOLE CARDS ***
Dealt to Duke Croix [3c Td]
color_singleton: raises 100 to 200
MnnM150: folds 
Duke Croix: folds 
JeBoyDirk: calls 100
*** FLOP *** [Th 6s 7d]
JeBoyDirk: checks 
color_singleton: checks 
*** TURN *** [Th 6s 7d] [Js]
JeBoyDirk: checks 
color_singleton: bets 212
JeBoyDirk: folds 
Uncalled bet (212) returned to color_singleton
color_singleton collected 425 from pot
color_singleton: doesn't show hand 
*** SUMMARY ***
Total pot 450 | Rake 25 
Board [Th 6s 7d Js]
Seat 1: color_singleton collected (425)
Seat 2: MnnM150 (button) folded before Flop (didn't bet)
Seat 3: Duke Croix (small blind) folded before Flop
Seat 9: JeBoyDirk (big blind) folded on the Turn



PokerStars Home Game Hand #219631803390: {Club #3225207}  Hold'em No Limit (50/100) - 2020/10/22 14:50:03 ET
Table 'VU_table_tonight' 9-max (Play Money) Seat #3 is the button
Seat 1: color_singleton (7811 in chips) 
Seat 2: MnnM150 (9711 in chips) 
Seat 3: Duke Croix (10183 in chips) 
Seat 9: JeBoyDirk (11530 in chips) 
JeBoyDirk: posts small blind 50
color_singleton: posts big blind 100
*** HOLE CARDS ***
Dealt to Duke Croix [8h 2c]
MnnM150: calls 100
Duke Croix: folds 
JeBoyDirk: folds 
color_singleton: checks 
*** FLOP *** [Td 9h Ah]
color_singleton: bets 118
MnnM150: calls 118
*** TURN *** [Td 9h Ah] [Kd]
color_singleton: checks 
MnnM150: bets 229
color_singleton: calls 229
*** RIVER *** [Td 9h Ah Kd] [Js]
color_singleton: checks 
MnnM150: bets 446
color_singleton: calls 446
*** SHOW DOWN ***
MnnM150: shows [Kh 8s] (a pair of Kings)
color_singleton: mucks hand 
MnnM150 collected 1735 from pot
*** SUMMARY ***
Total pot 1836 | Rake 101 
Board [Td 9h Ah Kd Js]
Seat 1: color_singleton (big blind) mucked [Jh 7s]
Seat 2: MnnM150 showed [Kh 8s] and won (1735) with a pair of Kings
Seat 3: Duke Croix (button) folded before Flop (didn't bet)
Seat 9: JeBoyDirk (small blind) folded before Flop



PokerStars Home Game Hand #219631825086: {Club #3225207}  Hold'em No Limit (50/100) - 2020/10/22 14:50:41 ET
Table 'VU_table_tonight' 9-max (Play Money) Seat #9 is the button
Seat 1: color_singleton (6918 in chips) 
Seat 2: MnnM150 (10553 in chips) 
Seat 3: Duke Croix (10183 in chips) 
Seat 9: JeBoyDirk (11480 in chips) 
color_singleton: posts small blind 50
MnnM150: posts big blind 100
*** HOLE CARDS ***
Dealt to Duke Croix [4c 8h]
Duke Croix: folds 
JeBoyDirk: raises 100 to 200
color_singleton: folds 
MnnM150: calls 100
*** FLOP *** [Ac 5d 6s]
MnnM150: checks 
JeBoyDirk: bets 300
MnnM150: folds 
Uncalled bet (300) returned to JeBoyDirk
JeBoyDirk collected 425 from pot
*** SUMMARY ***
Total pot 450 | Rake 25 
Board [Ac 5d 6s]
Seat 1: color_singleton (small blind) folded before Flop
Seat 2: MnnM150 (big blind) folded on the Flop
Seat 3: Duke Croix folded before Flop (didn't bet)
Seat 9: JeBoyDirk (button) collected (425)



PokerStars Home Game Hand #219631837898: {Club #3225207}  Hold'em No Limit (50/100) - 2020/10/22 14:51:03 ET
Table 'VU_table_tonight' 9-max (Play Money) Seat #1 is the button
Seat 1: color_singleton (6868 in chips) 
Seat 2: MnnM150 (10353 in chips) 
Seat 3: Duke Croix (10183 in chips) 
Seat 9: JeBoyDirk (11705 in chips) 
MnnM150: posts small blind 50
Duke Croix: posts big blind 100
*** HOLE CARDS ***
Dealt to Duke Croix [6h 3s]
JeBoyDirk: raises 100 to 200
color_singleton: folds 
MnnM150: folds 
Duke Croix: folds 
Uncalled bet (100) returned to JeBoyDirk
JeBoyDirk collected 250 from pot
*** SUMMARY ***
Total pot 250 | Rake 0 
Seat 1: color_singleton (button) folded before Flop (didn't bet)
Seat 2: MnnM150 (small blind) folded before Flop
Seat 3: Duke Croix (big blind) folded before Flop
Seat 9: JeBoyDirk collected (250)



PokerStars Home Game Hand #219631843683: {Club #3225207}  Hold'em No Limit (50/100) - 2020/10/22 14:51:13 ET
Table 'VU_table_tonight' 9-max (Play Money) Seat #2 is the button
Seat 1: color_singleton (6868 in chips) 
Seat 2: MnnM150 (10303 in chips) 
Seat 3: Duke Croix (10083 in chips) 
Seat 9: JeBoyDirk (11855 in chips) 
Duke Croix: posts small blind 50
JeBoyDirk: posts big blind 100
*** HOLE CARDS ***
Dealt to Duke Croix [6h 7c]
color_singleton: folds 
MnnM150: folds 
Duke Croix: calls 50
JeBoyDirk: checks 
*** FLOP *** [As 8d 6s]
Duke Croix: bets 200
JeBoyDirk: folds 
Uncalled bet (200) returned to Duke Croix
Duke Croix collected 189 from pot
*** SUMMARY ***
Total pot 200 | Rake 11 
Board [As 8d 6s]
Seat 1: color_singleton folded before Flop (didn't bet)
Seat 2: MnnM150 (button) folded before Flop (didn't bet)
Seat 3: Duke Croix (small blind) collected (189)
Seat 9: JeBoyDirk (big blind) folded on the Flop



PokerStars Home Game Hand #219631851061: {Club #3225207}  Hold'em No Limit (50/100) - 2020/10/22 14:51:26 ET
Table 'VU_table_tonight' 9-max (Play Money) Seat #3 is the button
Seat 1: color_singleton (6868 in chips) 
Seat 2: MnnM150 (10303 in chips) 
Seat 3: Duke Croix (10172 in chips) 
Seat 9: JeBoyDirk (11755 in chips) 
JeBoyDirk: posts small blind 50
color_singleton: posts big blind 100
*** HOLE CARDS ***
Dealt to Duke Croix [Jh Ad]
MnnM150: raises 100 to 200
Duke Croix: raises 300 to 500
JeBoyDirk: folds 
color_singleton: folds 
MnnM150: calls 300
*** FLOP *** [7h Qd Ah]
MnnM150: bets 543
Duke Croix: calls 543
*** TURN *** [7h Qd Ah] [9c]
MnnM150: bets 1056
Duke Croix: calls 1056
*** RIVER *** [7h Qd Ah 9c] [2s]
MnnM150: bets 2054
Duke Croix: folds 
Uncalled bet (2054) returned to MnnM150
MnnM150 collected 4109 from pot
*** SUMMARY ***
Total pot 4348 | Rake 239 
Board [7h Qd Ah 9c 2s]
Seat 1: color_singleton (big blind) folded before Flop
Seat 2: MnnM150 collected (4109)
Seat 3: Duke Croix (button) folded on the River
Seat 9: JeBoyDirk (small blind) folded before Flop



PokerStars Home Game Hand #219631880351: {Club #3225207}  Hold'em No Limit (50/100) - 2020/10/22 14:52:18 ET
Table 'VU_table_tonight' 9-max (Play Money) Seat #9 is the button
Seat 1: color_singleton (6768 in chips) 
Seat 2: MnnM150 (12313 in chips) 
Seat 3: Duke Croix (8073 in chips) 
Seat 9: JeBoyDirk (11705 in chips) 
color_singleton: posts small blind 50
MnnM150: posts big blind 100
*** HOLE CARDS ***
Dealt to Duke Croix [8d Jd]
Duke Croix: folds 
JeBoyDirk: calls 100
color_singleton: calls 50
MnnM150: checks 
*** FLOP *** [8c Ad 2d]
color_singleton: checks 
MnnM150: checks 
JeBoyDirk: checks 
*** TURN *** [8c Ad 2d] [5c]
color_singleton: checks 
MnnM150: checks 
JeBoyDirk: bets 200
color_singleton: calls 200
MnnM150: folds 
*** RIVER *** [8c Ad 2d 5c] [Jh]
color_singleton: checks 
JeBoyDirk: checks 
*** SHOW DOWN ***
color_singleton: shows [Qh 2s] (a pair of Deuces)
JeBoyDirk: mucks hand 
color_singleton collected 661 from pot
*** SUMMARY ***
Total pot 700 | Rake 39 
Board [8c Ad 2d 5c Jh]
Seat 1: color_singleton (small blind) showed [Qh 2s] and won (661) with a pair of Deuces
Seat 2: MnnM150 (big blind) folded on the Turn
Seat 3: Duke Croix folded before Flop (didn't bet)
Seat 9: JeBoyDirk (button) mucked [Td Qd]



PokerStars Home Game Hand #219631899301: {Club #3225207}  Hold'em No Limit (50/100) - 2020/10/22 14:52:51 ET
Table 'VU_table_tonight' 9-max (Play Money) Seat #1 is the button
Seat 1: color_singleton (7129 in chips) 
Seat 2: MnnM150 (12213 in chips) 
Seat 3: Duke Croix (8073 in chips) 
Seat 9: JeBoyDirk (11405 in chips) 
MnnM150: posts small blind 50
Duke Croix: posts big blind 100
*** HOLE CARDS ***
Dealt to Duke Croix [8c As]
JeBoyDirk: folds 
color_singleton: raises 100 to 200
MnnM150: calls 150
Duke Croix: calls 100
*** FLOP *** [9h 3s Kh]
MnnM150: checks 
Duke Croix: checks 
color_singleton: checks 
*** TURN *** [9h 3s Kh] [5s]
MnnM150: checks 
Duke Croix: checks 
color_singleton: checks 
*** RIVER *** [9h 3s Kh 5s] [Ac]
MnnM150: checks 
Duke Croix: bets 300
color_singleton: folds 
MnnM150: folds 
Uncalled bet (300) returned to Duke Croix
Duke Croix collected 567 from pot
*** SUMMARY ***
Total pot 600 | Rake 33 
Board [9h 3s Kh 5s Ac]
Seat 1: color_singleton (button) folded on the River
Seat 2: MnnM150 (small blind) folded on the River
Seat 3: Duke Croix (big blind) collected (567)
Seat 9: JeBoyDirk folded before Flop (didn't bet)



PokerStars Home Game Hand #219631920473: {Club #3225207}  Hold'em No Limit (50/100) - 2020/10/22 14:53:29 ET
Table 'VU_table_tonight' 9-max (Play Money) Seat #2 is the button
Seat 1: color_singleton (6929 in chips) 
Seat 2: MnnM150 (12013 in chips) 
Seat 3: Duke Croix (8440 in chips) 
Seat 9: JeBoyDirk (11405 in chips) 
Duke Croix: posts small blind 50
JeBoyDirk: posts big blind 100
*** HOLE CARDS ***
Dealt to Duke Croix [4c 7d]
color_singleton: folds 
MnnM150: calls 100
Duke Croix: folds 
JeBoyDirk: checks 
*** FLOP *** [6c 8c 5h]
JeBoyDirk: checks 
MnnM150: bets 118
JeBoyDirk: calls 118
*** TURN *** [6c 8c 5h] [Jc]
JeBoyDirk: checks 
MnnM150: bets 229
JeBoyDirk: calls 229
*** RIVER *** [6c 8c 5h Jc] [3c]
JeBoyDirk: checks 
MnnM150: bets 446
JeBoyDirk: folds 
Uncalled bet (446) returned to MnnM150
MnnM150 collected 892 from pot
*** SUMMARY ***
Total pot 944 | Rake 52 
Board [6c 8c 5h Jc 3c]
Seat 1: color_singleton folded before Flop (didn't bet)
Seat 2: MnnM150 (button) collected (892)
Seat 3: Duke Croix (small blind) folded before Flop
Seat 9: JeBoyDirk (big blind) folded on the River



PokerStars Home Game Hand #219631938637: {Club #3225207}  Hold'em No Limit (50/100) - 2020/10/22 14:54:01 ET
Table 'VU_table_tonight' 9-max (Play Money) Seat #3 is the button
Seat 1: color_singleton (6929 in chips) 
Seat 2: MnnM150 (12458 in chips) 
Seat 3: Duke Croix (8390 in chips) 
Seat 9: JeBoyDirk (10958 in chips) 
JeBoyDirk: posts small blind 50
color_singleton: posts big blind 100
*** HOLE CARDS ***
Dealt to Duke Croix [7h 8h]
MnnM150: calls 100
Duke Croix: raises 300 to 400
JeBoyDirk: folds 
color_singleton: folds 
MnnM150: calls 300
*** FLOP *** [3s 9d 4s]
MnnM150: checks 
Duke Croix: checks 
*** TURN *** [3s 9d 4s] [Ts]
MnnM150: checks 
Duke Croix: checks 
*** RIVER *** [3s 9d 4s Ts] [Ah]
MnnM150: bets 898
Duke Croix: folds 
Uncalled bet (898) returned to MnnM150
MnnM150 collected 898 from pot
*** SUMMARY ***
Total pot 950 | Rake 52 
Board [3s 9d 4s Ts Ah]
Seat 1: color_singleton (big blind) folded before Flop
Seat 2: MnnM150 collected (898)
Seat 3: Duke Croix (button) folded on the River
Seat 9: JeBoyDirk (small blind) folded before Flop



PokerStars Home Game Hand #219631959443: {Club #3225207}  Hold'em No Limit (50/100) - 2020/10/22 14:54:38 ET
Table 'VU_table_tonight' 9-max (Play Money) Seat #9 is the button
Seat 1: color_singleton (6829 in chips) 
Seat 2: MnnM150 (12956 in chips) 
Seat 3: Duke Croix (7990 in chips) 
Seat 9: JeBoyDirk (10908 in chips) 
color_singleton: posts small blind 50
MnnM150: posts big blind 100
*** HOLE CARDS ***
Dealt to Duke Croix [Ah 3h]
Duke Croix: folds 
JeBoyDirk: folds 
color_singleton: raises 100 to 200
MnnM150: folds 
Uncalled bet (100) returned to color_singleton
color_singleton collected 200 from pot
color_singleton: doesn't show hand 
*** SUMMARY ***
Total pot 200 | Rake 0 
Seat 1: color_singleton (small blind) collected (200)
Seat 2: MnnM150 (big blind) folded before Flop
Seat 3: Duke Croix folded before Flop (didn't bet)
Seat 9: JeBoyDirk (button) folded before Flop (didn't bet)



PokerStars Home Game Hand #219631967084: {Club #3225207}  Hold'em No Limit (50/100) - 2020/10/22 14:54:51 ET
Table 'VU_table_tonight' 9-max (Play Money) Seat #1 is the button
Seat 1: color_singleton (6929 in chips) 
Seat 2: MnnM150 (12856 in chips) 
Seat 3: Duke Croix (7990 in chips) 
Seat 9: JeBoyDirk (10908 in chips) 
MnnM150: posts small blind 50
Duke Croix: posts big blind 100
*** HOLE CARDS ***
Dealt to Duke Croix [2s 2d]
JeBoyDirk: raises 100 to 200
color_singleton: calls 200
MnnM150: folds 
Duke Croix: calls 100
*** FLOP *** [8h 3h 9d]
Duke Croix: checks 
JeBoyDirk: bets 300
color_singleton: calls 300
Duke Croix: folds 
*** TURN *** [8h 3h 9d] [Jd]
JeBoyDirk: bets 700
color_singleton: calls 700
*** RIVER *** [8h 3h 9d Jd] [5d]
JeBoyDirk: bets 500
color_singleton: calls 500
*** SHOW DOWN ***
JeBoyDirk: shows [8c Kc] (a pair of Eights)
color_singleton: shows [8s Ac] (a pair of Eights - Ace kicker)
color_singleton collected 3449 from pot
*** SUMMARY ***
Total pot 3650 | Rake 201 
Board [8h 3h 9d Jd 5d]
Seat 1: color_singleton (button) showed [8s Ac] and won (3449) with a pair of Eights
Seat 2: MnnM150 (small blind) folded before Flop
Seat 3: Duke Croix (big blind) folded on the Flop
Seat 9: JeBoyDirk showed [8c Kc] and lost with a pair of Eights



PokerStars Home Game Hand #219631990611: {Club #3225207}  Hold'em No Limit (50/100) - 2020/10/22 14:55:39 ET
Table 'VU_table_tonight' 9-max (Play Money) Seat #2 is the button
Seat 1: color_singleton (8678 in chips) 
Seat 2: MnnM150 (12806 in chips) 
Seat 3: Duke Croix (7790 in chips) 
Seat 9: JeBoyDirk (9208 in chips) 
Duke Croix: posts small blind 50
JeBoyDirk: posts big blind 100
*** HOLE CARDS ***
Dealt to Duke Croix [8h Ks]
color_singleton: folds 
MnnM150: folds 
Duke Croix: calls 50
JeBoyDirk: checks 
*** FLOP *** [3h 5h Jc]
Duke Croix: checks 
JeBoyDirk: checks 
*** TURN *** [3h 5h Jc] [Th]
Duke Croix: bets 100
JeBoyDirk: raises 100 to 200
Duke Croix: calls 100
*** RIVER *** [3h 5h Jc Th] [4h]
Duke Croix: bets 300
JeBoyDirk: calls 300
*** SHOW DOWN ***
Duke Croix: shows [8h Ks] (a flush, Ten high)
JeBoyDirk: mucks hand 
Duke Croix collected 1134 from pot
*** SUMMARY ***
Total pot 1200 | Rake 66 
Board [3h 5h Jc Th 4h]
Seat 1: color_singleton folded before Flop (didn't bet)
Seat 2: MnnM150 (button) folded before Flop (didn't bet)
Seat 3: Duke Croix (small blind) showed [8h Ks] and won (1134) with a flush, Ten high
Seat 9: JeBoyDirk (big blind) mucked [Tc Ad]



PokerStars Home Game Hand #219632005573: {Club #3225207}  Hold'em No Limit (50/100) - 2020/10/22 14:56:14 ET
Table 'VU_table_tonight' 9-max (Play Money) Seat #3 is the button
Seat 1: color_singleton (8678 in chips) 
Seat 2: MnnM150 (12806 in chips) 
Seat 3: Duke Croix (8324 in chips) 
Seat 9: JeBoyDirk (8608 in chips) 
JeBoyDirk: posts small blind 50
color_singleton: posts big blind 100
*** HOLE CARDS ***
Dealt to Duke Croix [2d 5s]
MnnM150: calls 100
Duke Croix: folds 
JeBoyDirk: calls 50
color_singleton: checks 
*** FLOP *** [Kh 5h 3c]
JeBoyDirk: checks 
color_singleton: checks 
MnnM150: bets 141
JeBoyDirk: folds 
color_singleton: folds 
Uncalled bet (141) returned to MnnM150
MnnM150 collected 283 from pot
*** SUMMARY ***
Total pot 300 | Rake 17 
Board [Kh 5h 3c]
Seat 1: color_singleton (big blind) folded on the Flop
Seat 2: MnnM150 collected (283)
Seat 3: Duke Croix (button) folded before Flop (didn't bet)
Seat 9: JeBoyDirk (small blind) folded on the Flop



PokerStars Home Game Hand #219632016590: {Club #3225207}  Hold'em No Limit (50/100) - 2020/10/22 14:56:40 ET
Table 'VU_table_tonight' 9-max (Play Money) Seat #9 is the button
Seat 1: color_singleton (8578 in chips) 
Seat 2: MnnM150 (12989 in chips) 
Seat 3: Duke Croix (8324 in chips) 
Seat 9: JeBoyDirk (8508 in chips) 
color_singleton: posts small blind 50
MnnM150: posts big blind 100
*** HOLE CARDS ***
Dealt to Duke Croix [Jh 8c]
Duke Croix: calls 100
JeBoyDirk: folds 
color_singleton: calls 50
MnnM150: checks 
*** FLOP *** [7d 6c Kd]
color_singleton: checks 
MnnM150: checks 
Duke Croix: checks 
*** TURN *** [7d 6c Kd] [Qs]
color_singleton: checks 
MnnM150: checks 
Duke Croix: checks 
*** RIVER *** [7d 6c Kd Qs] [2h]
color_singleton: bets 141
MnnM150: folds 
Duke Croix: folds 
Uncalled bet (141) returned to color_singleton
color_singleton collected 283 from pot
color_singleton: doesn't show hand 
*** SUMMARY ***
Total pot 300 | Rake 17 
Board [7d 6c Kd Qs 2h]
Seat 1: color_singleton (small blind) collected (283)
Seat 2: MnnM150 (big blind) folded on the River
Seat 3: Duke Croix folded on the River
Seat 9: JeBoyDirk (button) folded before Flop (didn't bet)



PokerStars Home Game Hand #219632033877: {Club #3225207}  Hold'em No Limit (50/100) - 2020/10/22 14:57:20 ET
Table 'VU_table_tonight' 9-max (Play Money) Seat #1 is the button
Seat 1: color_singleton (8761 in chips) 
Seat 2: MnnM150 (12889 in chips) 
Seat 3: Duke Croix (8224 in chips) 
Seat 9: JeBoyDirk (8508 in chips) 
MnnM150: posts small blind 50
Duke Croix: posts big blind 100
*** HOLE CARDS ***
Dealt to Duke Croix [Qh 2d]
JeBoyDirk: folds 
color_singleton: folds 
MnnM150: calls 50
Duke Croix: checks 
*** FLOP *** [6s 5s Tc]
MnnM150: checks 
Duke Croix: checks 
*** TURN *** [6s 5s Tc] [5c]
MnnM150: bets 189
Duke Croix: folds 
Uncalled bet (189) returned to MnnM150
MnnM150 collected 189 from pot
*** SUMMARY ***
Total pot 200 | Rake 11 
Board [6s 5s Tc 5c]
Seat 1: color_singleton (button) folded before Flop (didn't bet)
Seat 2: MnnM150 (small blind) collected (189)
Seat 3: Duke Croix (big blind) folded on the Turn
Seat 9: JeBoyDirk folded before Flop (didn't bet)



PokerStars Home Game Hand #219632043307: {Club #3225207}  Hold'em No Limit (50/100) - 2020/10/22 14:57:42 ET
Table 'VU_table_tonight' 9-max (Play Money) Seat #2 is the button
Seat 1: color_singleton (8761 in chips) 
Seat 2: MnnM150 (12978 in chips) 
Seat 3: Duke Croix (8124 in chips) 
Seat 9: JeBoyDirk (8508 in chips) 
Duke Croix: posts small blind 50
JeBoyDirk: posts big blind 100
*** HOLE CARDS ***
Dealt to Duke Croix [9d 3s]
color_singleton: raises 100 to 200
MnnM150: folds 
Duke Croix: folds 
JeBoyDirk: calls 100
*** FLOP *** [Kh 5s 7s]
JeBoyDirk: checks 
color_singleton: checks 
*** TURN *** [Kh 5s 7s] [Ad]
JeBoyDirk: checks 
color_singleton: checks 
*** RIVER *** [Kh 5s 7s Ad] [5h]
JeBoyDirk: checks 
color_singleton: bets 425
JeBoyDirk: calls 425
*** SHOW DOWN ***
color_singleton: shows [5d 4d] (three of a kind, Fives)
JeBoyDirk: mucks hand 
color_singleton collected 1228 from pot
*** SUMMARY ***
Total pot 1300 | Rake 72 
Board [Kh 5s 7s Ad 5h]
Seat 1: color_singleton showed [5d 4d] and won (1228) with three of a kind, Fives
Seat 2: MnnM150 (button) folded before Flop (didn't bet)
Seat 3: Duke Croix (small blind) folded before Flop
Seat 9: JeBoyDirk (big blind) mucked [7h 8h]



PokerStars Home Game Hand #219632055923: {Club #3225207}  Hold'em No Limit (50/100) - 2020/10/22 14:58:11 ET
Table 'VU_table_tonight' 9-max (Play Money) Seat #3 is the button
Seat 1: color_singleton (9364 in chips) 
Seat 2: MnnM150 (12978 in chips) 
Seat 3: Duke Croix (8074 in chips) 
Seat 9: JeBoyDirk (7883 in chips) 
JeBoyDirk: posts small blind 50
color_singleton: posts big blind 100
*** HOLE CARDS ***
Dealt to Duke Croix [Jd 6s]
MnnM150: folds 
Duke Croix: folds 
JeBoyDirk: folds 
Uncalled bet (50) returned to color_singleton
color_singleton collected 100 from pot
color_singleton: doesn't show hand 
*** SUMMARY ***
Total pot 100 | Rake 0 
Seat 1: color_singleton (big blind) collected (100)
Seat 2: MnnM150 folded before Flop (didn't bet)
Seat 3: Duke Croix (button) folded before Flop (didn't bet)
Seat 9: JeBoyDirk (small blind) folded before Flop



PokerStars Home Game Hand #219632059798: {Club #3225207}  Hold'em No Limit (50/100) - 2020/10/22 14:58:20 ET
Table 'VU_table_tonight' 9-max (Play Money) Seat #9 is the button
Seat 1: color_singleton (9414 in chips) 
Seat 2: MnnM150 (12978 in chips) 
Seat 3: Duke Croix (8074 in chips) 
Seat 9: JeBoyDirk (7833 in chips) 
color_singleton: posts small blind 50
MnnM150: posts big blind 100
*** HOLE CARDS ***
Dealt to Duke Croix [8h Jh]
Duke Croix: calls 100
JeBoyDirk: calls 100
color_singleton: folds 
MnnM150: checks 
*** FLOP *** [7h 5s 9c]
MnnM150: checks 
Duke Croix: checks 
JeBoyDirk: checks 
*** TURN *** [7h 5s 9c] [Ks]
MnnM150: checks 
Duke Croix: checks 
JeBoyDirk: checks 
*** RIVER *** [7h 5s 9c Ks] [7s]
MnnM150: checks 
Duke Croix: checks 
JeBoyDirk: checks 
*** SHOW DOWN ***
MnnM150: shows [6d 3s] (a pair of Sevens)
Duke Croix: shows [8h Jh] (a pair of Sevens - King+Jack kicker)
JeBoyDirk: shows [Th Qs] (a pair of Sevens - King+Queen kicker)
JeBoyDirk collected 331 from pot
*** SUMMARY ***
Total pot 350 | Rake 19 
Board [7h 5s 9c Ks 7s]
Seat 1: color_singleton (small blind) folded before Flop
Seat 2: MnnM150 (big blind) showed [6d 3s] and lost with a pair of Sevens
Seat 3: Duke Croix showed [8h Jh] and lost with a pair of Sevens
Seat 9: JeBoyDirk (button) showed [Th Qs] and won (331) with a pair of Sevens



PokerStars Home Game Hand #219632079382: {Club #3225207}  Hold'em No Limit (50/100) - 2020/10/22 14:59:05 ET
Table 'VU_table_tonight' 9-max (Play Money) Seat #1 is the button
Seat 1: color_singleton (9364 in chips) 
Seat 2: MnnM150 (12878 in chips) 
Seat 3: Duke Croix (7974 in chips) 
Seat 9: JeBoyDirk (8064 in chips) 
MnnM150: posts small blind 50
Duke Croix: posts big blind 100
*** HOLE CARDS ***
Dealt to Duke Croix [3h 4h]
JeBoyDirk: folds 
color_singleton: raises 100 to 200
MnnM150: folds 
Duke Croix: calls 100
*** FLOP *** [As Kc 8h]
Duke Croix: checks 
color_singleton: checks 
*** TURN *** [As Kc 8h] [Qc]
Duke Croix: checks 
color_singleton: checks 
*** RIVER *** [As Kc 8h Qc] [8s]
Duke Croix: checks 
color_singleton: checks 
*** SHOW DOWN ***
Duke Croix: shows [3h 4h] (a pair of Eights)
color_singleton: shows [6s Ts] (a pair of Eights)
Duke Croix collected 213 from pot
color_singleton collected 212 from pot
*** SUMMARY ***
Total pot 450 | Rake 25 
Board [As Kc 8h Qc 8s]
Seat 1: color_singleton (button) showed [6s Ts] and won (212) with a pair of Eights
Seat 2: MnnM150 (small blind) folded before Flop
Seat 3: Duke Croix (big blind) showed [3h 4h] and won (213) with a pair of Eights
Seat 9: JeBoyDirk folded before Flop (didn't bet)



PokerStars Home Game Hand #219632094559: {Club #3225207}  Hold'em No Limit (50/100) - 2020/10/22 14:59:39 ET
Table 'VU_table_tonight' 9-max (Play Money) Seat #2 is the button
Seat 1: color_singleton (9376 in chips) 
Seat 2: MnnM150 (12828 in chips) 
Seat 3: Duke Croix (7987 in chips) 
Seat 9: JeBoyDirk (8064 in chips) 
Duke Croix: posts small blind 50
JeBoyDirk: posts big blind 100
*** HOLE CARDS ***
Dealt to Duke Croix [2d 7s]
color_singleton: folds 
MnnM150: folds 
Duke Croix: folds 
Uncalled bet (50) returned to JeBoyDirk
JeBoyDirk collected 100 from pot
*** SUMMARY ***
Total pot 100 | Rake 0 
Seat 1: color_singleton folded before Flop (didn't bet)
Seat 2: MnnM150 (button) folded before Flop (didn't bet)
Seat 3: Duke Croix (small blind) folded before Flop
Seat 9: JeBoyDirk (big blind) collected (100)



PokerStars Home Game Hand #219632099435: {Club #3225207}  Hold'em No Limit (50/100) - 2020/10/22 14:59:51 ET
Table 'VU_table_tonight' 9-max (Play Money) Seat #3 is the button
Seat 1: color_singleton (9376 in chips) 
Seat 2: MnnM150 (12828 in chips) 
Seat 3: Duke Croix (7937 in chips) 
Seat 9: JeBoyDirk (8114 in chips) 
JeBoyDirk: posts small blind 50
color_singleton: posts big blind 100
*** HOLE CARDS ***
Dealt to Duke Croix [4s 4h]
MnnM150: folds 
Duke Croix: raises 300 to 400
JeBoyDirk: folds 
color_singleton: calls 300
*** FLOP *** [Ad Kc 7c]
color_singleton: checks 
Duke Croix: checks 
*** TURN *** [Ad Kc 7c] [5d]
color_singleton: checks 
Duke Croix: checks 
*** RIVER *** [Ad Kc 7c 5d] [2s]
color_singleton: checks 
Duke Croix: checks 
*** SHOW DOWN ***
color_singleton: shows [9h Jh] (high card Ace)
Duke Croix: shows [4s 4h] (a pair of Fours)
Duke Croix collected 803 from pot
*** SUMMARY ***
Total pot 850 | Rake 47 
Board [Ad Kc 7c 5d 2s]
Seat 1: color_singleton (big blind) showed [9h Jh] and lost with high card Ace
Seat 2: MnnM150 folded before Flop (didn't bet)
Seat 3: Duke Croix (button) showed [4s 4h] and won (803) with a pair of Fours
Seat 9: JeBoyDirk (small blind) folded before Flop



PokerStars Home Game Hand #219632108935: {Club #3225207}  Hold'em No Limit (50/100) - 2020/10/22 15:00:11 ET
Table 'VU_table_tonight' 9-max (Play Money) Seat #9 is the button
Seat 1: color_singleton (8976 in chips) 
Seat 2: MnnM150 (12828 in chips) 
Seat 3: Duke Croix (8340 in chips) 
Seat 9: JeBoyDirk (8064 in chips) 
color_singleton: posts small blind 50
MnnM150: posts big blind 100
*** HOLE CARDS ***
Dealt to Duke Croix [2s 8s]
Duke Croix: folds 
JeBoyDirk: folds 
color_singleton: raises 200 to 300
MnnM150: calls 200
*** FLOP *** [Tc 5d 2c]
color_singleton: checks 
MnnM150: checks 
*** TURN *** [Tc 5d 2c] [2d]
color_singleton: bets 283
MnnM150: folds 
Uncalled bet (283) returned to color_singleton
color_singleton collected 567 from pot
color_singleton: doesn't show hand 
*** SUMMARY ***
Total pot 600 | Rake 33 
Board [Tc 5d 2c 2d]
Seat 1: color_singleton (small blind) collected (567)
Seat 2: MnnM150 (big blind) folded on the Turn
Seat 3: Duke Croix folded before Flop (didn't bet)
Seat 9: JeBoyDirk (button) folded before Flop (didn't bet)



PokerStars Home Game Hand #219632128645: {Club #3225207}  Hold'em No Limit (50/100) - 2020/10/22 15:00:53 ET
Table 'VU_table_tonight' 9-max (Play Money) Seat #1 is the button
Seat 1: color_singleton (9243 in chips) 
Seat 2: MnnM150 (12528 in chips) 
Seat 3: Duke Croix (8340 in chips) 
Seat 9: JeBoyDirk (8064 in chips) 
MnnM150: posts small blind 50
Duke Croix: posts big blind 100
*** HOLE CARDS ***
Dealt to Duke Croix [3s 2c]
JeBoyDirk: folds 
color_singleton: folds 
MnnM150: folds 
Uncalled bet (50) returned to Duke Croix
Duke Croix collected 100 from pot
*** SUMMARY ***
Total pot 100 | Rake 0 
Seat 1: color_singleton (button) folded before Flop (didn't bet)
Seat 2: MnnM150 (small blind) folded before Flop
Seat 3: Duke Croix (big blind) collected (100)
Seat 9: JeBoyDirk folded before Flop (didn't bet)



PokerStars Home Game Hand #219632132780: {Club #3225207}  Hold'em No Limit (50/100) - 2020/10/22 15:01:01 ET
Table 'VU_table_tonight' 9-max (Play Money) Seat #2 is the button
Seat 1: color_singleton (9243 in chips) 
Seat 2: MnnM150 (12478 in chips) 
Seat 3: Duke Croix (8390 in chips) 
Seat 9: JeBoyDirk (8064 in chips) 
Duke Croix: posts small blind 50
JeBoyDirk: posts big blind 100
*** HOLE CARDS ***
Dealt to Duke Croix [4c 9s]
color_singleton: folds 
MnnM150: calls 100
Duke Croix: folds 
JeBoyDirk: checks 
*** FLOP *** [Kc 6h 4h]
JeBoyDirk: checks 
MnnM150: checks 
*** TURN *** [Kc 6h 4h] [Jd]
JeBoyDirk: checks 
MnnM150: checks 
*** RIVER *** [Kc 6h 4h Jd] [Kd]
JeBoyDirk: checks 
MnnM150: bets 236
JeBoyDirk: folds 
Uncalled bet (236) returned to MnnM150
MnnM150 collected 236 from pot
*** SUMMARY ***
Total pot 250 | Rake 14 
Board [Kc 6h 4h Jd Kd]
Seat 1: color_singleton folded before Flop (didn't bet)
Seat 2: MnnM150 (button) collected (236)
Seat 3: Duke Croix (small blind) folded before Flop
Seat 9: JeBoyDirk (big blind) folded on the River



PokerStars Home Game Hand #219632149419: {Club #3225207}  Hold'em No Limit (50/100) - 2020/10/22 15:01:33 ET
Table 'VU_table_tonight' 9-max (Play Money) Seat #3 is the button
Seat 1: color_singleton (9243 in chips) 
Seat 2: MnnM150 (12614 in chips) 
Seat 3: Duke Croix (8340 in chips) 
Seat 9: JeBoyDirk (7964 in chips) 
JeBoyDirk: posts small blind 50
color_singleton: posts big blind 100
*** HOLE CARDS ***
Dealt to Duke Croix [Qh 8s]
MnnM150: calls 100
Duke Croix: folds 
JeBoyDirk: raises 100 to 200
color_singleton: calls 100
MnnM150: folds 
*** FLOP *** [2s 7d Qd]
JeBoyDirk: bets 200
color_singleton: calls 200
*** TURN *** [2s 7d Qd] [8c]
JeBoyDirk: bets 400
color_singleton: calls 400
*** RIVER *** [2s 7d Qd 8c] [2h]
JeBoyDirk: checks 
color_singleton: checks 
*** SHOW DOWN ***
JeBoyDirk: shows [Ah Kh] (a pair of Deuces)
color_singleton: shows [6s 7s] (two pair, Sevens and Deuces)
color_singleton collected 1606 from pot
*** SUMMARY ***
Total pot 1700 | Rake 94 
Board [2s 7d Qd 8c 2h]
Seat 1: color_singleton (big blind) showed [6s 7s] and won (1606) with two pair, Sevens and Deuces
Seat 2: MnnM150 folded before Flop
Seat 3: Duke Croix (button) folded before Flop (didn't bet)
Seat 9: JeBoyDirk (small blind) showed [Ah Kh] and lost with a pair of Deuces



PokerStars Home Game Hand #219632168429: {Club #3225207}  Hold'em No Limit (50/100) - 2020/10/22 15:02:08 ET
Table 'VU_table_tonight' 9-max (Play Money) Seat #9 is the button
Seat 1: color_singleton (10049 in chips) 
Seat 2: MnnM150 (12514 in chips) 
Seat 3: Duke Croix (8340 in chips) 
Seat 9: JeBoyDirk (7164 in chips) 
color_singleton: posts small blind 50
MnnM150: posts big blind 100
*** HOLE CARDS ***
Dealt to Duke Croix [Jd 9d]
Duke Croix: calls 100
JeBoyDirk: folds 
color_singleton: folds 
MnnM150: checks 
*** FLOP *** [9c 5c 4c]
MnnM150: checks 
Duke Croix: bets 200
MnnM150: calls 200
*** TURN *** [9c 5c 4c] [5d]
MnnM150: bets 307
Duke Croix: calls 307
*** RIVER *** [9c 5c 4c 5d] [Js]
MnnM150: checks 
Duke Croix: bets 1000
MnnM150: folds 
Uncalled bet (1000) returned to Duke Croix
Duke Croix collected 1194 from pot
*** SUMMARY ***
Total pot 1264 | Rake 70 
Board [9c 5c 4c 5d Js]
Seat 1: color_singleton (small blind) folded before Flop
Seat 2: MnnM150 (big blind) folded on the River
Seat 3: Duke Croix collected (1194)
Seat 9: JeBoyDirk (button) folded before Flop (didn't bet)



PokerStars Home Game Hand #219632195156: {Club #3225207}  Hold'em No Limit (50/100) - 2020/10/22 15:02:55 ET
Table 'VU_table_tonight' 9-max (Play Money) Seat #1 is the button
Seat 1: color_singleton (9999 in chips) 
Seat 2: MnnM150 (11907 in chips) 
Seat 3: Duke Croix (8927 in chips) 
Seat 9: JeBoyDirk (7164 in chips) 
MnnM150: posts small blind 50
Duke Croix: posts big blind 100
*** HOLE CARDS ***
Dealt to Duke Croix [4s 8s]
JeBoyDirk: calls 100
color_singleton: folds 
MnnM150: calls 50
Duke Croix: checks 
*** FLOP *** [3s Jh 9c]
MnnM150: checks 
Duke Croix: checks 
JeBoyDirk: checks 
*** TURN *** [3s Jh 9c] [Ah]
MnnM150: checks 
Duke Croix: checks 
JeBoyDirk: bets 200
MnnM150: folds 
Duke Croix: folds 
Uncalled bet (200) returned to JeBoyDirk
JeBoyDirk collected 283 from pot
*** SUMMARY ***
Total pot 300 | Rake 17 
Board [3s Jh 9c Ah]
Seat 1: color_singleton (button) folded before Flop (didn't bet)
Seat 2: MnnM150 (small blind) folded on the Turn
Seat 3: Duke Croix (big blind) folded on the Turn
Seat 9: JeBoyDirk collected (283)



PokerStars Home Game Hand #219632210334: {Club #3225207}  Hold'em No Limit (50/100) - 2020/10/22 15:03:21 ET
Table 'VU_table_tonight' 9-max (Play Money) Seat #2 is the button
Seat 1: color_singleton (9999 in chips) 
Seat 2: MnnM150 (11807 in chips) 
Seat 3: Duke Croix (8827 in chips) 
Seat 9: JeBoyDirk (7347 in chips) 
Duke Croix: posts small blind 50
JeBoyDirk: posts big blind 100
*** HOLE CARDS ***
Dealt to Duke Croix [9c Ks]
color_singleton: raises 100 to 200
MnnM150: folds 
Duke Croix: folds 
JeBoyDirk: raises 200 to 400
color_singleton: calls 200
*** FLOP *** [9d Th Ts]
JeBoyDirk: bets 400
color_singleton: raises 400 to 800
JeBoyDirk: calls 400
*** TURN *** [9d Th Ts] [Td]
JeBoyDirk: bets 1000
color_singleton: calls 1000
*** RIVER *** [9d Th Ts Td] [2s]
JeBoyDirk: bets 5147 and is all-in
color_singleton: calls 5147
*** SHOW DOWN ***
JeBoyDirk: shows [Qd Qh] (a full house, Tens full of Queens)
color_singleton: shows [9s Jd] (a full house, Tens full of Nines)
JeBoyDirk collected 13933 from pot
*** SUMMARY ***
Total pot 14744 | Rake 811 
Board [9d Th Ts Td 2s]
Seat 1: color_singleton showed [9s Jd] and lost with a full house, Tens full of Nines
Seat 2: MnnM150 (button) folded before Flop (didn't bet)
Seat 3: Duke Croix (small blind) folded before Flop
Seat 9: JeBoyDirk (big blind) showed [Qd Qh] and won (13933) with a full house, Tens full of Queens



PokerStars Home Game Hand #219632242626: {Club #3225207}  Hold'em No Limit (50/100) - 2020/10/22 15:04:16 ET
Table 'VU_table_tonight' 9-max (Play Money) Seat #3 is the button
Seat 1: color_singleton (2652 in chips) 
Seat 2: MnnM150 (11807 in chips) 
Seat 3: Duke Croix (8777 in chips) 
Seat 9: JeBoyDirk (13933 in chips) 
JeBoyDirk: posts small blind 50
color_singleton: posts big blind 100
*** HOLE CARDS ***
Dealt to Duke Croix [2s Jh]
MnnM150: calls 100
Duke Croix: folds 
JeBoyDirk: calls 50
color_singleton: checks 
*** FLOP *** [Ks 7c 4d]
JeBoyDirk: checks 
color_singleton: checks 
MnnM150: bets 141
JeBoyDirk: folds 
color_singleton: folds 
Uncalled bet (141) returned to MnnM150
MnnM150 collected 283 from pot
*** SUMMARY ***
Total pot 300 | Rake 17 
Board [Ks 7c 4d]
Seat 1: color_singleton (big blind) folded on the Flop
Seat 2: MnnM150 collected (283)
Seat 3: Duke Croix (button) folded before Flop (didn't bet)
Seat 9: JeBoyDirk (small blind) folded on the Flop



PokerStars Home Game Hand #219632257424: {Club #3225207}  Hold'em No Limit (50/100) - 2020/10/22 15:04:41 ET
Table 'VU_table_tonight' 9-max (Play Money) Seat #9 is the button
Seat 1: color_singleton (2552 in chips) 
Seat 2: MnnM150 (11990 in chips) 
Seat 3: Duke Croix (8777 in chips) 
Seat 9: JeBoyDirk (13833 in chips) 
color_singleton: posts small blind 50
MnnM150: posts big blind 100
*** HOLE CARDS ***
Dealt to Duke Croix [8s 6s]
Duke Croix: calls 100
JeBoyDirk: calls 100
color_singleton: raises 200 to 300
MnnM150: folds 
Duke Croix: calls 200
JeBoyDirk: calls 200
*** FLOP *** [8h Kd 2d]
color_singleton: bets 472
Duke Croix: folds 
JeBoyDirk: folds 
Uncalled bet (472) returned to color_singleton
color_singleton collected 945 from pot
color_singleton: doesn't show hand 
*** SUMMARY ***
Total pot 1000 | Rake 55 
Board [8h Kd 2d]
Seat 1: color_singleton (small blind) collected (945)
Seat 2: MnnM150 (big blind) folded before Flop
Seat 3: Duke Croix folded on the Flop
Seat 9: JeBoyDirk (button) folded on the Flop



PokerStars Home Game Hand #219632285645: {Club #3225207}  Hold'em No Limit (50/100) - 2020/10/22 15:05:28 ET
Table 'VU_table_tonight' 9-max (Play Money) Seat #1 is the button
Seat 1: color_singleton (3197 in chips) 
Seat 2: MnnM150 (11890 in chips) 
Seat 3: Duke Croix (8477 in chips) 
Seat 9: JeBoyDirk (13533 in chips) 
MnnM150: posts small blind 50
Duke Croix: posts big blind 100
*** HOLE CARDS ***
Dealt to Duke Croix [5s Jc]
JeBoyDirk: calls 100
color_singleton: folds 
MnnM150: calls 50
Duke Croix: checks 
*** FLOP *** [Qc 6c Jh]
MnnM150: checks 
Duke Croix: checks 
JeBoyDirk: checks 
*** TURN *** [Qc 6c Jh] [8h]
MnnM150: checks 
Duke Croix: bets 200
JeBoyDirk: calls 200
MnnM150: folds 
*** RIVER *** [Qc 6c Jh 8h] [Qh]
Duke Croix: bets 500
JeBoyDirk: calls 500
*** SHOW DOWN ***
Duke Croix: shows [5s Jc] (two pair, Queens and Jacks)
JeBoyDirk: shows [Jd 7d] (two pair, Queens and Jacks)
Duke Croix collected 803 from pot
JeBoyDirk collected 803 from pot
*** SUMMARY ***
Total pot 1700 | Rake 94 
Board [Qc 6c Jh 8h Qh]
Seat 1: color_singleton (button) folded before Flop (didn't bet)
Seat 2: MnnM150 (small blind) folded on the Turn
Seat 3: Duke Croix (big blind) showed [5s Jc] and won (803) with two pair, Queens and Jacks
Seat 9: JeBoyDirk showed [Jd 7d] and won (803) with two pair, Queens and Jacks



PokerStars Home Game Hand #219632308245: {Club #3225207}  Hold'em No Limit (50/100) - 2020/10/22 15:06:05 ET
Table 'VU_table_tonight' 9-max (Play Money) Seat #2 is the button
Seat 1: color_singleton (3197 in chips) 
Seat 2: MnnM150 (11790 in chips) 
Seat 3: Duke Croix (8480 in chips) 
Seat 9: JeBoyDirk (13536 in chips) 
Duke Croix: posts small blind 50
JeBoyDirk: posts big blind 100
*** HOLE CARDS ***
Dealt to Duke Croix [Jc 4d]
color_singleton: folds 
MnnM150: calls 100
Duke Croix: calls 50
JeBoyDirk: checks 
*** FLOP *** [6c Js Kh]
Duke Croix: checks 
JeBoyDirk: checks 
MnnM150: bets 141
Duke Croix: folds 
JeBoyDirk: calls 141
*** TURN *** [6c Js Kh] [Jh]
JeBoyDirk: checks 
MnnM150: bets 275
JeBoyDirk: calls 275
*** RIVER *** [6c Js Kh Jh] [3h]
JeBoyDirk: bets 500
MnnM150: calls 500
*** SHOW DOWN ***
JeBoyDirk: shows [Kc 3c] (two pair, Kings and Jacks)
MnnM150: shows [Ks 8d] (two pair, Kings and Jacks - Eight kicker)
MnnM150 collected 2015 from pot
*** SUMMARY ***
Total pot 2132 | Rake 117 
Board [6c Js Kh Jh 3h]
Seat 1: color_singleton folded before Flop (didn't bet)
Seat 2: MnnM150 (button) showed [Ks 8d] and won (2015) with two pair, Kings and Jacks
Seat 3: Duke Croix (small blind) folded on the Flop
Seat 9: JeBoyDirk (big blind) showed [Kc 3c] and lost with two pair, Kings and Jacks



PokerStars Home Game Hand #219632331402: {Club #3225207}  Hold'em No Limit (50/100) - 2020/10/22 15:06:43 ET
Table 'VU_table_tonight' 9-max (Play Money) Seat #3 is the button
Seat 1: color_singleton (3197 in chips) 
Seat 2: MnnM150 (12789 in chips) 
Seat 3: Duke Croix (8380 in chips) 
Seat 9: JeBoyDirk (12520 in chips) 
JeBoyDirk: posts small blind 50
color_singleton: posts big blind 100
*** HOLE CARDS ***
Dealt to Duke Croix [Jc 2h]
MnnM150: calls 100
Duke Croix: folds 
JeBoyDirk: calls 50
color_singleton: checks 
*** FLOP *** [3c Js 2s]
JeBoyDirk: checks 
color_singleton: checks 
MnnM150: checks 
*** TURN *** [3c Js 2s] [As]
JeBoyDirk: bets 200
color_singleton: folds 
MnnM150: calls 200
*** RIVER *** [3c Js 2s As] [5c]
JeBoyDirk: checks 
MnnM150: checks 
*** SHOW DOWN ***
JeBoyDirk: shows [Ah 2c] (two pair, Aces and Deuces)
MnnM150: mucks hand 
JeBoyDirk collected 661 from pot
*** SUMMARY ***
Total pot 700 | Rake 39 
Board [3c Js 2s As 5c]
Seat 1: color_singleton (big blind) folded on the Turn
Seat 2: MnnM150 mucked [Qh 9s]
Seat 3: Duke Croix (button) folded before Flop (didn't bet)
Seat 9: JeBoyDirk (small blind) showed [Ah 2c] and won (661) with two pair, Aces and Deuces



PokerStars Home Game Hand #219632350201: {Club #3225207}  Hold'em No Limit (50/100) - 2020/10/22 15:07:14 ET
Table 'VU_table_tonight' 9-max (Play Money) Seat #9 is the button
Seat 1: color_singleton (3097 in chips) 
Seat 2: MnnM150 (12489 in chips) 
Seat 3: Duke Croix (8380 in chips) 
Seat 9: JeBoyDirk (12881 in chips) 
color_singleton: posts small blind 50
MnnM150: posts big blind 100
*** HOLE CARDS ***
Dealt to Duke Croix [3c Js]
Duke Croix: folds 
JeBoyDirk: folds 
color_singleton: calls 50
MnnM150: checks 
*** FLOP *** [Jc 3d Kd]
color_singleton: checks 
MnnM150: checks 
*** TURN *** [Jc 3d Kd] [Tc]
color_singleton: bets 189
MnnM150: calls 189
*** RIVER *** [Jc 3d Kd Tc] [4s]
color_singleton: checks 
MnnM150: checks 
*** SHOW DOWN ***
color_singleton: shows [2c 3s] (a pair of Threes)
MnnM150: shows [6d 6s] (a pair of Sixes)
MnnM150 collected 546 from pot
*** SUMMARY ***
Total pot 578 | Rake 32 
Board [Jc 3d Kd Tc 4s]
Seat 1: color_singleton (small blind) showed [2c 3s] and lost with a pair of Threes
Seat 2: MnnM150 (big blind) showed [6d 6s] and won (546) with a pair of Sixes
Seat 3: Duke Croix folded before Flop (didn't bet)
Seat 9: JeBoyDirk (button) folded before Flop (didn't bet)



PokerStars Home Game Hand #219632373898: {Club #3225207}  Hold'em No Limit (50/100) - 2020/10/22 15:07:52 ET
Table 'VU_table_tonight' 9-max (Play Money) Seat #1 is the button
Seat 1: color_singleton (2808 in chips) 
Seat 2: MnnM150 (12746 in chips) 
Seat 3: Duke Croix (8380 in chips) 
Seat 9: JeBoyDirk (12881 in chips) 
MnnM150: posts small blind 50
Duke Croix: posts big blind 100
*** HOLE CARDS ***
Dealt to Duke Croix [Qs Qh]
JeBoyDirk: folds 
color_singleton: folds 
MnnM150: calls 50
Duke Croix: raises 300 to 400
MnnM150: folds 
Uncalled bet (300) returned to Duke Croix
Duke Croix collected 200 from pot
*** SUMMARY ***
Total pot 200 | Rake 0 
Seat 1: color_singleton (button) folded before Flop (didn't bet)
Seat 2: MnnM150 (small blind) folded before Flop
Seat 3: Duke Croix (big blind) collected (200)
Seat 9: JeBoyDirk folded before Flop (didn't bet)



PokerStars Home Game Hand #219632395933: {Club #3225207}  Hold'em No Limit (50/100) - 2020/10/22 15:08:29 ET
Table 'VU_table_tonight' 9-max (Play Money) Seat #2 is the button
Seat 1: color_singleton (2808 in chips) 
Seat 2: MnnM150 (12646 in chips) 
Seat 3: Duke Croix (8480 in chips) 
Seat 9: JeBoyDirk (12881 in chips) 
Duke Croix: posts small blind 50
JeBoyDirk: posts big blind 100
*** HOLE CARDS ***
Dealt to Duke Croix [8d 5d]
color_singleton: raises 200 to 300
MnnM150: calls 300
Duke Croix: folds 
JeBoyDirk: folds 
*** FLOP *** [Qh Th 9s]
color_singleton: bets 354
MnnM150: calls 354
*** TURN *** [Qh Th 9s] [Jh]
color_singleton: bets 689
MnnM150: calls 689
*** RIVER *** [Qh Th 9s Jh] [Kd]
color_singleton: bets 1465 and is all-in
MnnM150: calls 1465
*** SHOW DOWN ***
color_singleton: shows [As Js] (a straight, Ten to Ace)
MnnM150: shows [Qs Ah] (a straight, Ten to Ace)
color_singleton collected 2725 from pot
MnnM150 collected 2724 from pot
*** SUMMARY ***
Total pot 5766 | Rake 317 
Board [Qh Th 9s Jh Kd]
Seat 1: color_singleton showed [As Js] and won (2725) with a straight, Ten to Ace
Seat 2: MnnM150 (button) showed [Qs Ah] and won (2724) with a straight, Ten to Ace
Seat 3: Duke Croix (small blind) folded before Flop
Seat 9: JeBoyDirk (big blind) folded before Flop



PokerStars Home Game Hand #219632415871: {Club #3225207}  Hold'em No Limit (50/100) - 2020/10/22 15:09:01 ET
Table 'VU_table_tonight' 9-max (Play Money) Seat #3 is the button
Seat 1: color_singleton (2725 in chips) 
Seat 2: MnnM150 (12562 in chips) 
Seat 3: Duke Croix (8430 in chips) 
Seat 9: JeBoyDirk (12781 in chips) 
JeBoyDirk: posts small blind 50
color_singleton: posts big blind 100
*** HOLE CARDS ***
Dealt to Duke Croix [6h 6s]
MnnM150: calls 100
Duke Croix: raises 300 to 400
JeBoyDirk: folds 
color_singleton: folds 
MnnM150: folds 
Uncalled bet (300) returned to Duke Croix
Duke Croix collected 350 from pot
*** SUMMARY ***
Total pot 350 | Rake 0 
Seat 1: color_singleton (big blind) folded before Flop
Seat 2: MnnM150 folded before Flop
Seat 3: Duke Croix (button) collected (350)
Seat 9: JeBoyDirk (small blind) folded before Flop



PokerStars Home Game Hand #219632424844: {Club #3225207}  Hold'em No Limit (50/100) - 2020/10/22 15:09:16 ET
Table 'VU_table_tonight' 9-max (Play Money) Seat #9 is the button
Seat 1: color_singleton (2625 in chips) 
Seat 2: MnnM150 (12462 in chips) 
Seat 3: Duke Croix (8680 in chips) 
Seat 9: JeBoyDirk (12731 in chips) 
color_singleton: posts small blind 50
MnnM150: posts big blind 100
*** HOLE CARDS ***
Dealt to Duke Croix [9d 6h]
Duke Croix: folds 
JeBoyDirk: raises 100 to 200
color_singleton: folds 
MnnM150: folds 
Uncalled bet (100) returned to JeBoyDirk
JeBoyDirk collected 250 from pot
*** SUMMARY ***
Total pot 250 | Rake 0 
Seat 1: color_singleton (small blind) folded before Flop
Seat 2: MnnM150 (big blind) folded before Flop
Seat 3: Duke Croix folded before Flop (didn't bet)
Seat 9: JeBoyDirk (button) collected (250)



PokerStars Home Game Hand #219632429597: {Club #3225207}  Hold'em No Limit (50/100) - 2020/10/22 15:09:24 ET
Table 'VU_table_tonight' 9-max (Play Money) Seat #1 is the button
Seat 1: color_singleton (2575 in chips) 
Seat 2: MnnM150 (12362 in chips) 
Seat 3: Duke Croix (8680 in chips) 
Seat 9: JeBoyDirk (12881 in chips) 
MnnM150: posts small blind 50
Duke Croix: posts big blind 100
*** HOLE CARDS ***
Dealt to Duke Croix [8s Ad]
JeBoyDirk: folds 
color_singleton: folds 
MnnM150: folds 
Uncalled bet (50) returned to Duke Croix
Duke Croix collected 100 from pot
*** SUMMARY ***
Total pot 100 | Rake 0 
Seat 1: color_singleton (button) folded before Flop (didn't bet)
Seat 2: MnnM150 (small blind) folded before Flop
Seat 3: Duke Croix (big blind) collected (100)
Seat 9: JeBoyDirk folded before Flop (didn't bet)



PokerStars Home Game Hand #219632434873: {Club #3225207}  Hold'em No Limit (50/100) - 2020/10/22 15:09:32 ET
Table 'VU_table_tonight' 9-max (Play Money) Seat #2 is the button
Seat 1: color_singleton (2575 in chips) 
Seat 2: MnnM150 (12312 in chips) 
Seat 3: Duke Croix (8730 in chips) 
Seat 9: JeBoyDirk (12881 in chips) 
Duke Croix: posts small blind 50
JeBoyDirk: posts big blind 100
*** HOLE CARDS ***
Dealt to Duke Croix [Ac 9s]
color_singleton: folds 
MnnM150: calls 100
Duke Croix: raises 300 to 400
JeBoyDirk: calls 300
MnnM150: calls 300
*** FLOP *** [Kd 4s 9c]
Duke Croix: bets 600
JeBoyDirk: folds 
MnnM150: calls 600
*** TURN *** [Kd 4s 9c] [8s]
Duke Croix: bets 1200
MnnM150: calls 1200
*** RIVER *** [Kd 4s 9c 8s] [3s]
Duke Croix: checks 
MnnM150: checks 
*** SHOW DOWN ***
Duke Croix: shows [Ac 9s] (a pair of Nines)
MnnM150: shows [8d Ks] (two pair, Kings and Eights)
MnnM150 collected 4536 from pot
*** SUMMARY ***
Total pot 4800 | Rake 264 
Board [Kd 4s 9c 8s 3s]
Seat 1: color_singleton folded before Flop (didn't bet)
Seat 2: MnnM150 (button) showed [8d Ks] and won (4536) with two pair, Kings and Eights
Seat 3: Duke Croix (small blind) showed [Ac 9s] and lost with a pair of Nines
Seat 9: JeBoyDirk (big blind) folded on the Flop



PokerStars Home Game Hand #219632461998: {Club #3225207}  Hold'em No Limit (50/100) - 2020/10/22 15:10:09 ET
Table 'VU_table_tonight' 9-max (Play Money) Seat #3 is the button
Seat 1: color_singleton (2575 in chips) 
Seat 2: MnnM150 (14648 in chips) 
Seat 3: Duke Croix (6530 in chips) 
Seat 9: JeBoyDirk (12481 in chips) 
JeBoyDirk: posts small blind 50
color_singleton: posts big blind 100
*** HOLE CARDS ***
Dealt to Duke Croix [3c 2s]
MnnM150: calls 100
Duke Croix: folds 
JeBoyDirk: calls 50
color_singleton: raises 300 to 400
MnnM150: calls 300
JeBoyDirk: calls 300
*** FLOP *** [4c 9h 8d]
JeBoyDirk: checks 
color_singleton: bets 600
MnnM150: folds 
JeBoyDirk: folds 
Uncalled bet (600) returned to color_singleton
color_singleton collected 1134 from pot
color_singleton: doesn't show hand 
*** SUMMARY ***
Total pot 1200 | Rake 66 
Board [4c 9h 8d]
Seat 1: color_singleton (big blind) collected (1134)
Seat 2: MnnM150 folded on the Flop
Seat 3: Duke Croix (button) folded before Flop (didn't bet)
Seat 9: JeBoyDirk (small blind) folded on the Flop



PokerStars Home Game Hand #219632489250: {Club #3225207}  Hold'em No Limit (50/100) - 2020/10/22 15:10:54 ET
Table 'VU_table_tonight' 9-max (Play Money) Seat #9 is the button
Seat 1: color_singleton (3309 in chips) 
Seat 2: MnnM150 (14248 in chips) 
Seat 3: Duke Croix (6530 in chips) 
Seat 9: JeBoyDirk (12081 in chips) 
color_singleton: posts small blind 50
MnnM150: posts big blind 100
*** HOLE CARDS ***
Dealt to Duke Croix [Jh Qc]
Duke Croix: raises 200 to 300
JeBoyDirk: calls 300
color_singleton: folds 
MnnM150: calls 200
*** FLOP *** [Kc 2c Qs]
MnnM150: bets 898
Duke Croix: folds 
JeBoyDirk: folds 
Uncalled bet (898) returned to MnnM150
MnnM150 collected 898 from pot
*** SUMMARY ***
Total pot 950 | Rake 52 
Board [Kc 2c Qs]
Seat 1: color_singleton (small blind) folded before Flop
Seat 2: MnnM150 (big blind) collected (898)
Seat 3: Duke Croix folded on the Flop
Seat 9: JeBoyDirk (button) folded on the Flop



PokerStars Home Game Hand #219632505083: {Club #3225207}  Hold'em No Limit (50/100) - 2020/10/22 15:11:20 ET
Table 'VU_table_tonight' 9-max (Play Money) Seat #1 is the button
Seat 1: color_singleton (3259 in chips) 
Seat 2: MnnM150 (14846 in chips) 
Seat 3: Duke Croix (6230 in chips) 
Seat 9: JeBoyDirk (11781 in chips) 
MnnM150: posts small blind 50
Duke Croix: posts big blind 100
*** HOLE CARDS ***
Dealt to Duke Croix [Kd 7s]
JeBoyDirk: folds 
color_singleton: raises 200 to 300
MnnM150: folds 
Duke Croix: calls 200
*** FLOP *** [2d Ah Ts]
Duke Croix: checks 
color_singleton: bets 307
Duke Croix: folds 
Uncalled bet (307) returned to color_singleton
color_singleton collected 614 from pot
color_singleton: doesn't show hand 
*** SUMMARY ***
Total pot 650 | Rake 36 
Board [2d Ah Ts]
Seat 1: color_singleton (button) collected (614)
Seat 2: MnnM150 (small blind) folded before Flop
Seat 3: Duke Croix (big blind) folded on the Flop
Seat 9: JeBoyDirk folded before Flop (didn't bet)



PokerStars Home Game Hand #219632521270: {Club #3225207}  Hold'em No Limit (50/100) - 2020/10/22 15:11:46 ET
Table 'VU_table_tonight' 9-max (Play Money) Seat #2 is the button
Seat 1: color_singleton (3573 in chips) 
Seat 2: MnnM150 (14796 in chips) 
Seat 3: Duke Croix (5930 in chips) 
Seat 9: JeBoyDirk (11781 in chips) 
Duke Croix: posts small blind 50
JeBoyDirk: posts big blind 100
*** HOLE CARDS ***
Dealt to Duke Croix [7c 3h]
color_singleton: folds 
MnnM150: folds 
Duke Croix: folds 
Uncalled bet (50) returned to JeBoyDirk
JeBoyDirk collected 100 from pot
*** SUMMARY ***
Total pot 100 | Rake 0 
Seat 1: color_singleton folded before Flop (didn't bet)
Seat 2: MnnM150 (button) folded before Flop (didn't bet)
Seat 3: Duke Croix (small blind) folded before Flop
Seat 9: JeBoyDirk (big blind) collected (100)



PokerStars Home Game Hand #219632524765: {Club #3225207}  Hold'em No Limit (50/100) - 2020/10/22 15:11:52 ET
Table 'VU_table_tonight' 9-max (Play Money) Seat #3 is the button
Seat 1: color_singleton (3573 in chips) 
Seat 2: MnnM150 (14796 in chips) 
Seat 3: Duke Croix (5880 in chips) 
Seat 9: JeBoyDirk (11831 in chips) 
JeBoyDirk: posts small blind 50
color_singleton: posts big blind 100
*** HOLE CARDS ***
Dealt to Duke Croix [9s 7s]
MnnM150: calls 100
Duke Croix: calls 100
JeBoyDirk: calls 50
color_singleton: raises 200 to 300
MnnM150: calls 200
Duke Croix: calls 200
JeBoyDirk: folds 
*** FLOP *** [5c 3d 9d]
color_singleton: checks 
MnnM150: checks 
Duke Croix: bets 500
color_singleton: calls 500
MnnM150: folds 
*** TURN *** [5c 3d 9d] [2h]
color_singleton: checks 
Duke Croix: bets 700
color_singleton: calls 700
*** RIVER *** [5c 3d 9d 2h] [9h]
color_singleton: checks 
Duke Croix: bets 1500
color_singleton: folds 
Uncalled bet (1500) returned to Duke Croix
Duke Croix collected 3213 from pot
*** SUMMARY ***
Total pot 3400 | Rake 187 
Board [5c 3d 9d 2h 9h]
Seat 1: color_singleton (big blind) folded on the River
Seat 2: MnnM150 folded on the Flop
Seat 3: Duke Croix (button) collected (3213)
Seat 9: JeBoyDirk (small blind) folded before Flop



PokerStars Home Game Hand #219632559056: {Club #3225207}  Hold'em No Limit (50/100) - 2020/10/22 15:12:49 ET
Table 'VU_table_tonight' 9-max (Play Money) Seat #9 is the button
Seat 1: color_singleton (2073 in chips) 
Seat 2: MnnM150 (14496 in chips) 
Seat 3: Duke Croix (7593 in chips) 
Seat 9: JeBoyDirk (11731 in chips) 
color_singleton: posts small blind 50
MnnM150: posts big blind 100
*** HOLE CARDS ***
Dealt to Duke Croix [8h 4h]
Duke Croix: folds 
JeBoyDirk: calls 100
color_singleton: raises 300 to 400
MnnM150: folds 
JeBoyDirk: calls 300
*** FLOP *** [8d 9s 3h]
color_singleton: bets 850
JeBoyDirk: raises 850 to 1700
color_singleton: calls 823 and is all-in
Uncalled bet (27) returned to JeBoyDirk
*** TURN *** [8d 9s 3h] [5s]
*** RIVER *** [8d 9s 3h 5s] [9h]
*** SHOW DOWN ***
color_singleton: shows [Kh Qc] (a pair of Nines)
JeBoyDirk: shows [9d 6d] (three of a kind, Nines)
JeBoyDirk collected 4012 from pot
*** SUMMARY ***
Total pot 4246 | Rake 234 
Board [8d 9s 3h 5s 9h]
Seat 1: color_singleton (small blind) showed [Kh Qc] and lost with a pair of Nines
Seat 2: MnnM150 (big blind) folded before Flop
Seat 3: Duke Croix folded before Flop (didn't bet)
Seat 9: JeBoyDirk (button) showed [9d 6d] and won (4012) with three of a kind, Nines



PokerStars Home Game Hand #219632579406: {Club #3225207}  Hold'em No Limit (50/100) - 2020/10/22 15:13:22 ET
Table 'VU_table_tonight' 9-max (Play Money) Seat #2 is the button
Seat 2: MnnM150 (14396 in chips) 
Seat 3: Duke Croix (7593 in chips) 
Seat 9: JeBoyDirk (13670 in chips) 
Duke Croix: posts small blind 50
JeBoyDirk: posts big blind 100
*** HOLE CARDS ***
Dealt to Duke Croix [5h Th]
MnnM150: folds 
Duke Croix: calls 50
JeBoyDirk: checks 
*** FLOP *** [2s 8c 8h]
Duke Croix: checks 
JeBoyDirk: checks 
*** TURN *** [2s 8c 8h] [2d]
Duke Croix: checks 
JeBoyDirk: checks 
*** RIVER *** [2s 8c 8h 2d] [Kh]
Duke Croix: checks 
JeBoyDirk: checks 
*** SHOW DOWN ***
Duke Croix: shows [5h Th] (two pair, Eights and Deuces)
JeBoyDirk: shows [3s Jc] (two pair, Eights and Deuces)
Duke Croix collected 95 from pot
JeBoyDirk collected 94 from pot
*** SUMMARY ***
Total pot 200 | Rake 11 
Board [2s 8c 8h 2d Kh]
Seat 2: MnnM150 (button) folded before Flop (didn't bet)
Seat 3: Duke Croix (small blind) showed [5h Th] and won (95) with two pair, Eights and Deuces
Seat 9: JeBoyDirk (big blind) showed [3s Jc] and won (94) with two pair, Eights and Deuces



PokerStars Home Game Hand #219632596997: {Club #3225207}  Hold'em No Limit (50/100) - 2020/10/22 15:13:52 ET
Table 'VU_table_tonight' 9-max (Play Money) Seat #3 is the button
Seat 1: color_singleton (10000 in chips) 
Seat 2: MnnM150 (14396 in chips) 
Seat 3: Duke Croix (7588 in chips) 
Seat 9: JeBoyDirk (13664 in chips) 
JeBoyDirk: posts small blind 50
color_singleton: posts big blind 100
*** HOLE CARDS ***
Dealt to Duke Croix [8s 2s]
MnnM150: folds 
Duke Croix: folds 
JeBoyDirk: folds 
Uncalled bet (50) returned to color_singleton
color_singleton collected 100 from pot
color_singleton: doesn't show hand 
*** SUMMARY ***
Total pot 100 | Rake 0 
Seat 1: color_singleton (big blind) collected (100)
Seat 2: MnnM150 folded before Flop (didn't bet)
Seat 3: Duke Croix (button) folded before Flop (didn't bet)
Seat 9: JeBoyDirk (small blind) folded before Flop



PokerStars Home Game Hand #219632607175: {Club #3225207}  Hold'em No Limit (50/100) - 2020/10/22 15:14:09 ET
Table 'VU_table_tonight' 9-max (Play Money) Seat #9 is the button
Seat 1: color_singleton (10050 in chips) 
Seat 2: MnnM150 (14396 in chips) 
Seat 3: Duke Croix (7588 in chips) 
Seat 9: JeBoyDirk (13614 in chips) 
color_singleton: posts small blind 50
MnnM150: posts big blind 100
*** HOLE CARDS ***
Dealt to Duke Croix [2s 6s]
Duke Croix: folds 
JeBoyDirk: folds 
color_singleton: raises 100 to 200
MnnM150: folds 
Uncalled bet (100) returned to color_singleton
color_singleton collected 200 from pot
color_singleton: doesn't show hand 
*** SUMMARY ***
Total pot 200 | Rake 0 
Seat 1: color_singleton (small blind) collected (200)
Seat 2: MnnM150 (big blind) folded before Flop
Seat 3: Duke Croix folded before Flop (didn't bet)
Seat 9: JeBoyDirk (button) folded before Flop (didn't bet)



PokerStars Home Game Hand #219632614159: {Club #3225207}  Hold'em No Limit (50/100) - 2020/10/22 15:14:21 ET
Table 'VU_table_tonight' 9-max (Play Money) Seat #1 is the button
Seat 1: color_singleton (10150 in chips) 
Seat 2: MnnM150 (14296 in chips) 
Seat 3: Duke Croix (7588 in chips) 
Seat 9: JeBoyDirk (13614 in chips) 
MnnM150: posts small blind 50
Duke Croix: posts big blind 100
*** HOLE CARDS ***
Dealt to Duke Croix [4c 3h]
JeBoyDirk: raises 100 to 200
color_singleton: folds 
MnnM150: calls 150
Duke Croix: folds 
*** FLOP *** [Qs 3d 9s]
MnnM150: checks 
JeBoyDirk: checks 
*** TURN *** [Qs 3d 9s] [Qh]
MnnM150: checks 
JeBoyDirk: checks 
*** RIVER *** [Qs 3d 9s Qh] [Jd]
MnnM150: checks 
JeBoyDirk: bets 400
MnnM150: calls 400
*** SHOW DOWN ***
JeBoyDirk: shows [7c As] (a pair of Queens)
MnnM150: shows [Ad 8d] (a pair of Queens)
MnnM150 collected 614 from pot
JeBoyDirk collected 614 from pot
*** SUMMARY ***
Total pot 1300 | Rake 72 
Board [Qs 3d 9s Qh Jd]
Seat 1: color_singleton (button) folded before Flop (didn't bet)
Seat 2: MnnM150 (small blind) showed [Ad 8d] and won (614) with a pair of Queens
Seat 3: Duke Croix (big blind) folded before Flop
Seat 9: JeBoyDirk showed [7c As] and won (614) with a pair of Queens



PokerStars Home Game Hand #219632637025: {Club #3225207}  Hold'em No Limit (50/100) - 2020/10/22 15:14:59 ET
Table 'VU_table_tonight' 9-max (Play Money) Seat #2 is the button
Seat 1: color_singleton (10150 in chips) 
Seat 2: MnnM150 (14310 in chips) 
Seat 3: Duke Croix (7488 in chips) 
Seat 9: JeBoyDirk (13628 in chips) 
Duke Croix: posts small blind 50
JeBoyDirk: posts big blind 100
*** HOLE CARDS ***
Dealt to Duke Croix [3c 9d]
color_singleton: folds 
MnnM150: calls 100
Duke Croix: calls 50
JeBoyDirk: checks 
*** FLOP *** [2d 4c Qs]
Duke Croix: checks 
JeBoyDirk: bets 200
MnnM150: calls 200
Duke Croix: folds 
*** TURN *** [2d 4c Qs] [8h]
JeBoyDirk: bets 500
MnnM150: folds 
Uncalled bet (500) returned to JeBoyDirk
JeBoyDirk collected 661 from pot
*** SUMMARY ***
Total pot 700 | Rake 39 
Board [2d 4c Qs 8h]
Seat 1: color_singleton folded before Flop (didn't bet)
Seat 2: MnnM150 (button) folded on the Turn
Seat 3: Duke Croix (small blind) folded on the Flop
Seat 9: JeBoyDirk (big blind) collected (661)



PokerStars Home Game Hand #219632659415: {Club #3225207}  Hold'em No Limit (50/100) - 2020/10/22 15:15:35 ET
Table 'VU_table_tonight' 9-max (Play Money) Seat #3 is the button
Seat 1: color_singleton (10150 in chips) 
Seat 2: MnnM150 (14010 in chips) 
Seat 3: Duke Croix (7388 in chips) 
Seat 9: JeBoyDirk (13989 in chips) 
JeBoyDirk: posts small blind 50
color_singleton: posts big blind 100
*** HOLE CARDS ***
Dealt to Duke Croix [5c 5h]
MnnM150: calls 100
Duke Croix: raises 200 to 300
JeBoyDirk: folds 
color_singleton: calls 200
MnnM150: calls 200
*** FLOP *** [7d 8h 4c]
color_singleton: checks 
MnnM150: checks 
Duke Croix: bets 400
color_singleton: calls 400
MnnM150: calls 400
*** TURN *** [7d 8h 4c] [7h]
color_singleton: checks 
MnnM150: checks 
Duke Croix: bets 1000
color_singleton: folds 
MnnM150: folds 
Uncalled bet (1000) returned to Duke Croix
Duke Croix collected 2032 from pot
*** SUMMARY ***
Total pot 2150 | Rake 118 
Board [7d 8h 4c 7h]
Seat 1: color_singleton (big blind) folded on the Turn
Seat 2: MnnM150 folded on the Turn
Seat 3: Duke Croix (button) collected (2032)
Seat 9: JeBoyDirk (small blind) folded before Flop



PokerStars Home Game Hand #219632692533: {Club #3225207}  Hold'em No Limit (50/100) - 2020/10/22 15:16:28 ET
Table 'VU_table_tonight' 9-max (Play Money) Seat #9 is the button
Seat 1: color_singleton (9450 in chips) 
Seat 2: MnnM150 (13310 in chips) 
Seat 3: Duke Croix (8720 in chips) 
Seat 9: JeBoyDirk (13939 in chips) 
color_singleton: posts small blind 50
MnnM150: posts big blind 100
*** HOLE CARDS ***
Dealt to Duke Croix [As 4d]
Duke Croix: raises 200 to 300
JeBoyDirk: folds 
color_singleton: folds 
MnnM150: folds 
Uncalled bet (200) returned to Duke Croix
Duke Croix collected 250 from pot
*** SUMMARY ***
Total pot 250 | Rake 0 
Seat 1: color_singleton (small blind) folded before Flop
Seat 2: MnnM150 (big blind) folded before Flop
Seat 3: Duke Croix collected (250)
Seat 9: JeBoyDirk (button) folded before Flop (didn't bet)



PokerStars Home Game Hand #219632696538: {Club #3225207}  Hold'em No Limit (50/100) - 2020/10/22 15:16:35 ET
Table 'VU_table_tonight' 9-max (Play Money) Seat #1 is the button
Seat 1: color_singleton (9400 in chips) 
Seat 2: MnnM150 (13210 in chips) 
Seat 3: Duke Croix (8870 in chips) 
Seat 9: JeBoyDirk (13939 in chips) 
MnnM150: posts small blind 50
Duke Croix: posts big blind 100
*** HOLE CARDS ***
Dealt to Duke Croix [8c Jd]
appositive joins the table at seat #8 
JeBoyDirk: folds 
color_singleton: folds 
MnnM150: calls 50
Duke Croix: checks 
*** FLOP *** [As Td 8s]
MnnM150: checks 
Duke Croix: checks 
*** TURN *** [As Td 8s] [4h]
MnnM150: checks 
Duke Croix: checks 
*** RIVER *** [As Td 8s 4h] [9h]
MnnM150: checks 
Duke Croix: checks 
*** SHOW DOWN ***
MnnM150: shows [3h 7h] (high card Ace)
Duke Croix: shows [8c Jd] (a pair of Eights)
Duke Croix collected 189 from pot
*** SUMMARY ***
Total pot 200 | Rake 11 
Board [As Td 8s 4h 9h]
Seat 1: color_singleton (button) folded before Flop (didn't bet)
Seat 2: MnnM150 (small blind) showed [3h 7h] and lost with high card Ace
Seat 3: Duke Croix (big blind) showed [8c Jd] and won (189) with a pair of Eights
Seat 9: JeBoyDirk folded before Flop (didn't bet)



PokerStars Home Game Hand #219632709267: {Club #3225207}  Hold'em No Limit (50/100) - 2020/10/22 15:16:55 ET
Table 'VU_table_tonight' 9-max (Play Money) Seat #2 is the button
Seat 1: color_singleton (9400 in chips) 
Seat 2: MnnM150 (13110 in chips) 
Seat 3: Duke Croix (8959 in chips) 
Seat 8: appositive (10000 in chips) 
Seat 9: JeBoyDirk (13939 in chips) 
Duke Croix: posts small blind 50
appositive: posts big blind 100
*** HOLE CARDS ***
Dealt to Duke Croix [5h 9d]
JeBoyDirk: calls 100
color_singleton: folds 
MnnM150: folds 
Duke Croix: calls 50
appositive: checks 
*** FLOP *** [Qs 2d 9h]
Duke Croix: bets 200
appositive: calls 200
JeBoyDirk: calls 200
*** TURN *** [Qs 2d 9h] [3h]
Duke Croix: bets 500
appositive: folds 
JeBoyDirk: calls 500
*** RIVER *** [Qs 2d 9h 3h] [4s]
Duke Croix: checks 
JeBoyDirk: checks 
*** SHOW DOWN ***
Duke Croix: shows [5h 9d] (a pair of Nines)
JeBoyDirk: mucks hand 
Duke Croix collected 1795 from pot
*** SUMMARY ***
Total pot 1900 | Rake 105 
Board [Qs 2d 9h 3h 4s]
Seat 1: color_singleton folded before Flop (didn't bet)
Seat 2: MnnM150 (button) folded before Flop (didn't bet)
Seat 3: Duke Croix (small blind) showed [5h 9d] and won (1795) with a pair of Nines
Seat 8: appositive (big blind) folded on the Turn
Seat 9: JeBoyDirk mucked [Jd Td]



PokerStars Home Game Hand #219632731138: {Club #3225207}  Hold'em No Limit (50/100) - 2020/10/22 15:17:31 ET
Table 'VU_table_tonight' 9-max (Play Money) Seat #3 is the button
Seat 1: color_singleton (9400 in chips) 
Seat 2: MnnM150 (13110 in chips) 
Seat 3: Duke Croix (9954 in chips) 
Seat 8: appositive (9700 in chips) 
Seat 9: JeBoyDirk (13139 in chips) 
appositive: posts small blind 50
JeBoyDirk: posts big blind 100
*** HOLE CARDS ***
Dealt to Duke Croix [8d 3d]
color_singleton: raises 100 to 200
MnnM150: calls 200
Duke Croix: folds 
appositive: calls 150
JeBoyDirk: calls 100
*** FLOP *** [5d 3c Qc]
appositive: bets 300
JeBoyDirk: folds 
color_singleton: folds 
MnnM150: calls 300
*** TURN *** [5d 3c Qc] [6h]
appositive: bets 700
MnnM150: folds 
Uncalled bet (700) returned to appositive
appositive collected 1323 from pot
appositive: doesn't show hand 
*** SUMMARY ***
Total pot 1400 | Rake 77 
Board [5d 3c Qc 6h]
Seat 1: color_singleton folded on the Flop
Seat 2: MnnM150 folded on the Turn
Seat 3: Duke Croix (button) folded before Flop (didn't bet)
Seat 8: appositive (small blind) collected (1323)
Seat 9: JeBoyDirk (big blind) folded on the Flop



PokerStars Home Game Hand #219632761344: {Club #3225207}  Hold'em No Limit (50/100) - 2020/10/22 15:18:14 ET
Table 'VU_table_tonight' 9-max (Play Money) Seat #8 is the button
Seat 1: color_singleton (9200 in chips) 
Seat 2: MnnM150 (12610 in chips) 
Seat 3: Duke Croix (9954 in chips) 
Seat 8: appositive (10523 in chips) 
Seat 9: JeBoyDirk (12939 in chips) 
JeBoyDirk: posts small blind 50
color_singleton: posts big blind 100
*** HOLE CARDS ***
Dealt to Duke Croix [9d Ac]
MnnM150: calls 100
Duke Croix: raises 300 to 400
appositive: calls 400
JeBoyDirk: folds 
color_singleton: folds 
MnnM150: calls 300
*** FLOP *** [3h Qh 4d]
MnnM150: checks 
Duke Croix: checks 
appositive: bets 600
MnnM150: folds 
Duke Croix: folds 
Uncalled bet (600) returned to appositive
appositive collected 1276 from pot
appositive: doesn't show hand 
*** SUMMARY ***
Total pot 1350 | Rake 74 
Board [3h Qh 4d]
Seat 1: color_singleton (big blind) folded before Flop
Seat 2: MnnM150 folded on the Flop
Seat 3: Duke Croix folded on the Flop
Seat 8: appositive (button) collected (1276)
Seat 9: JeBoyDirk (small blind) folded before Flop



PokerStars Home Game Hand #219632782086: {Club #3225207}  Hold'em No Limit (50/100) - 2020/10/22 15:18:48 ET
Table 'VU_table_tonight' 9-max (Play Money) Seat #9 is the button
Seat 1: color_singleton (9100 in chips) 
Seat 2: MnnM150 (12210 in chips) 
Seat 3: Duke Croix (9554 in chips) 
Seat 8: appositive (11399 in chips) 
Seat 9: JeBoyDirk (12889 in chips) 
color_singleton: posts small blind 50
MnnM150: posts big blind 100
*** HOLE CARDS ***
Dealt to Duke Croix [Jh 9c]
Duke Croix: calls 100
appositive: calls 100
JeBoyDirk: calls 100
color_singleton: raises 200 to 300
MnnM150: folds 
Duke Croix: calls 200
appositive: calls 200
JeBoyDirk: calls 200
*** FLOP *** [Td Jd Kd]
color_singleton: bets 614
Duke Croix: folds 
appositive: calls 614
JeBoyDirk: calls 614
*** TURN *** [Td Jd Kd] [As]
color_singleton: bets 2969
appositive: calls 2969
JeBoyDirk: folds 
*** RIVER *** [Td Jd Kd As] [4h]
color_singleton: checks 
appositive: bets 7516 and is all-in
color_singleton: folds 
Uncalled bet (7516) returned to appositive
appositive collected 8581 from pot
appositive: doesn't show hand 
*** SUMMARY ***
Total pot 9080 | Rake 499 
Board [Td Jd Kd As 4h]
Seat 1: color_singleton (small blind) folded on the River
Seat 2: MnnM150 (big blind) folded before Flop
Seat 3: Duke Croix folded on the Flop
Seat 8: appositive collected (8581)
Seat 9: JeBoyDirk (button) folded on the Turn



PokerStars Home Game Hand #219632822725: {Club #3225207}  Hold'em No Limit (50/100) - 2020/10/22 15:19:54 ET
Table 'VU_table_tonight' 9-max (Play Money) Seat #1 is the button
Seat 1: color_singleton (5217 in chips) 
Seat 2: MnnM150 (12110 in chips) 
Seat 3: Duke Croix (9254 in chips) 
Seat 8: appositive (16097 in chips) 
Seat 9: JeBoyDirk (11975 in chips) 
MnnM150: posts small blind 50
Duke Croix: posts big blind 100
*** HOLE CARDS ***
Dealt to Duke Croix [Qc 4c]
appositive: calls 100
JeBoyDirk: folds 
color_singleton: calls 100
MnnM150: folds 
Duke Croix: checks 
*** FLOP *** [Qh 5c 5h]
Duke Croix: bets 300
appositive: calls 300
color_singleton: folds 
*** TURN *** [Qh 5c 5h] [7d]
Duke Croix: bets 500
appositive: calls 500
*** RIVER *** [Qh 5c 5h 7d] [5d]
Duke Croix: bets 1700
appositive: calls 1700
*** SHOW DOWN ***
Duke Croix: shows [Qc 4c] (a full house, Fives full of Queens)
appositive: mucks hand 
Duke Croix collected 5056 from pot
*** SUMMARY ***
Total pot 5350 | Rake 294 
Board [Qh 5c 5h 7d 5d]
Seat 1: color_singleton (button) folded on the Flop
Seat 2: MnnM150 (small blind) folded before Flop
Seat 3: Duke Croix (big blind) showed [Qc 4c] and won (5056) with a full house, Fives full of Queens
Seat 8: appositive mucked [4d 4h]
Seat 9: JeBoyDirk folded before Flop (didn't bet)



PokerStars Home Game Hand #219632848415: {Club #3225207}  Hold'em No Limit (50/100) - 2020/10/22 15:20:35 ET
Table 'VU_table_tonight' 9-max (Play Money) Seat #2 is the button
Seat 1: color_singleton (5117 in chips) 
Seat 2: MnnM150 (12060 in chips) 
Seat 3: Duke Croix (11710 in chips) 
Seat 8: appositive (13497 in chips) 
Seat 9: JeBoyDirk (11975 in chips) 
Duke Croix: posts small blind 50
appositive: posts big blind 100
*** HOLE CARDS ***
Dealt to Duke Croix [Tc 5c]
JeBoyDirk: folds 
color_singleton: folds 
MnnM150: calls 100
Duke Croix: calls 50
appositive: raises 100 to 200
MnnM150: calls 100
Duke Croix: calls 100
*** FLOP *** [3c 3d 9c]
Duke Croix: bets 400
appositive: raises 600 to 1000
MnnM150: folds 
Duke Croix: calls 600
*** TURN *** [3c 3d 9c] [Ts]
Duke Croix: checks 
appositive: bets 2000
Duke Croix: calls 2000
*** RIVER *** [3c 3d 9c Ts] [Ad]
Duke Croix: checks 
appositive: bets 2300
Duke Croix: folds 
Uncalled bet (2300) returned to appositive
appositive collected 6237 from pot
appositive: doesn't show hand 
*** SUMMARY ***
Total pot 6600 | Rake 363 
Board [3c 3d 9c Ts Ad]
Seat 1: color_singleton folded before Flop (didn't bet)
Seat 2: MnnM150 (button) folded on the Flop
Seat 3: Duke Croix (small blind) folded on the River
Seat 8: appositive (big blind) collected (6237)
Seat 9: JeBoyDirk folded before Flop (didn't bet)



PokerStars Home Game Hand #219632888472: {Club #3225207}  Hold'em No Limit (50/100) - 2020/10/22 15:21:39 ET
Table 'VU_table_tonight' 9-max (Play Money) Seat #3 is the button
Seat 1: color_singleton (5117 in chips) 
Seat 2: MnnM150 (11860 in chips) 
Seat 3: Duke Croix (8510 in chips) 
Seat 8: appositive (16534 in chips) 
Seat 9: JeBoyDirk (11975 in chips) 
appositive: posts small blind 50
JeBoyDirk: posts big blind 100
*** HOLE CARDS ***
Dealt to Duke Croix [Th 9s]
color_singleton: folds 
MnnM150: calls 100
Duke Croix: folds 
appositive: calls 50
JeBoyDirk: checks 
*** FLOP *** [Qc Kc Qs]
appositive: checks 
JeBoyDirk: checks 
MnnM150: checks 
*** TURN *** [Qc Kc Qs] [4c]
appositive: checks 
JeBoyDirk: checks 
MnnM150: checks 
*** RIVER *** [Qc Kc Qs 4c] [8h]
appositive: checks 
JeBoyDirk: checks 
MnnM150: checks 
*** SHOW DOWN ***
appositive: shows [Tc 5h] (a pair of Queens)
JeBoyDirk: shows [Ad 8s] (two pair, Queens and Eights)
MnnM150: mucks hand 
JeBoyDirk collected 283 from pot
*** SUMMARY ***
Total pot 300 | Rake 17 
Board [Qc Kc Qs 4c 8h]
Seat 1: color_singleton folded before Flop (didn't bet)
Seat 2: MnnM150 mucked [Jh 3h]
Seat 3: Duke Croix (button) folded before Flop (didn't bet)
Seat 8: appositive (small blind) showed [Tc 5h] and lost with a pair of Queens
Seat 9: JeBoyDirk (big blind) showed [Ad 8s] and won (283) with two pair, Queens and Eights



PokerStars Home Game Hand #219632911970: {Club #3225207}  Hold'em No Limit (50/100) - 2020/10/22 15:22:17 ET
Table 'VU_table_tonight' 9-max (Play Money) Seat #8 is the button
Seat 1: color_singleton (5117 in chips) 
Seat 2: MnnM150 (11760 in chips) 
Seat 3: Duke Croix (8510 in chips) 
Seat 8: appositive (16434 in chips) 
Seat 9: JeBoyDirk (12158 in chips) 
JeBoyDirk: posts small blind 50
color_singleton: posts big blind 100
*** HOLE CARDS ***
Dealt to Duke Croix [4s Jc]
MnnM150: calls 100
Duke Croix: folds 
appositive: folds 
JeBoyDirk: calls 50
color_singleton: checks 
*** FLOP *** [Td As Qs]
JeBoyDirk: checks 
color_singleton: checks 
MnnM150: checks 
*** TURN *** [Td As Qs] [8c]
JeBoyDirk: bets 200
color_singleton: calls 200
MnnM150: calls 200
*** RIVER *** [Td As Qs 8c] [8d]
JeBoyDirk: bets 800
color_singleton: calls 800
MnnM150: calls 800
*** SHOW DOWN ***
JeBoyDirk: shows [8h Th] (a full house, Eights full of Tens)
color_singleton: mucks hand 
MnnM150: mucks hand 
JeBoyDirk collected 3118 from pot
*** SUMMARY ***
Total pot 3300 | Rake 182 
Board [Td As Qs 8c 8d]
Seat 1: color_singleton (big blind) mucked [Ts 2c]
Seat 2: MnnM150 mucked [6d 6h]
Seat 3: Duke Croix folded before Flop (didn't bet)
Seat 8: appositive (button) folded before Flop (didn't bet)
Seat 9: JeBoyDirk (small blind) showed [8h Th] and won (3118) with a full house, Eights full of Tens



PokerStars Home Game Hand #219632955930: {Club #3225207}  Hold'em No Limit (50/100) - 2020/10/22 15:23:28 ET
Table 'VU_table_tonight' 9-max (Play Money) Seat #9 is the button
Seat 1: color_singleton (4017 in chips) 
Seat 2: MnnM150 (10660 in chips) 
Seat 3: Duke Croix (8510 in chips) 
Seat 8: appositive (16434 in chips) 
Seat 9: JeBoyDirk (14176 in chips) 
color_singleton: posts small blind 50
MnnM150: posts big blind 100
*** HOLE CARDS ***
Dealt to Duke Croix [Ah Ts]
Duke Croix: raises 300 to 400
appositive: folds 
JeBoyDirk: folds 
color_singleton: folds 
MnnM150: folds 
Uncalled bet (300) returned to Duke Croix
Duke Croix collected 250 from pot
*** SUMMARY ***
Total pot 250 | Rake 0 
Seat 1: color_singleton (small blind) folded before Flop
Seat 2: MnnM150 (big blind) folded before Flop
Seat 3: Duke Croix collected (250)
Seat 8: appositive folded before Flop (didn't bet)
Seat 9: JeBoyDirk (button) folded before Flop (didn't bet)



PokerStars Home Game Hand #219632966561: {Club #3225207}  Hold'em No Limit (50/100) - 2020/10/22 15:23:45 ET
Table 'VU_table_tonight' 9-max (Play Money) Seat #1 is the button
Seat 1: color_singleton (3967 in chips) 
Seat 2: MnnM150 (10560 in chips) 
Seat 3: Duke Croix (8660 in chips) 
Seat 8: appositive (16434 in chips) 
Seat 9: JeBoyDirk (14176 in chips) 
MnnM150: posts small blind 50
Duke Croix: posts big blind 100
*** HOLE CARDS ***
Dealt to Duke Croix [7h 8s]
appositive: folds 
JeBoyDirk: calls 100
color_singleton: raises 100 to 200
MnnM150: calls 150
Duke Croix: calls 100
JeBoyDirk: calls 100
*** FLOP *** [9s 5s Jc]
MnnM150: checks 
Duke Croix: checks 
JeBoyDirk: bets 400
color_singleton: folds 
MnnM150: folds 
Duke Croix: calls 400
*** TURN *** [9s 5s Jc] [Ah]
Duke Croix: checks 
JeBoyDirk: bets 800
Duke Croix: calls 800
*** RIVER *** [9s 5s Jc Ah] [3c]
Duke Croix: checks 
JeBoyDirk: checks 
*** SHOW DOWN ***
Duke Croix: shows [7h 8s] (high card Ace)
JeBoyDirk: shows [Kh Jd] (a pair of Jacks)
JeBoyDirk collected 3024 from pot
*** SUMMARY ***
Total pot 3200 | Rake 176 
Board [9s 5s Jc Ah 3c]
Seat 1: color_singleton (button) folded on the Flop
Seat 2: MnnM150 (small blind) folded on the Flop
Seat 3: Duke Croix (big blind) showed [7h 8s] and lost with high card Ace
Seat 8: appositive folded before Flop (didn't bet)
Seat 9: JeBoyDirk showed [Kh Jd] and won (3024) with a pair of Jacks



PokerStars Home Game Hand #219633008600: {Club #3225207}  Hold'em No Limit (50/100) - 2020/10/22 15:24:53 ET
Table 'VU_table_tonight' 9-max (Play Money) Seat #2 is the button
Seat 1: color_singleton (3767 in chips) 
Seat 2: MnnM150 (10360 in chips) 
Seat 3: Duke Croix (7260 in chips) 
Seat 9: JeBoyDirk (15800 in chips) 
Duke Croix: posts small blind 50
JeBoyDirk: posts big blind 100
*** HOLE CARDS ***
Dealt to Duke Croix [Th 2h]
color_singleton: folds 
MnnM150: calls 100
Duke Croix: calls 50
JeBoyDirk: checks 
*** FLOP *** [5d 2d Js]
Duke Croix: checks 
JeBoyDirk: checks 
MnnM150: checks 
*** TURN *** [5d 2d Js] [7d]
Duke Croix: checks 
JeBoyDirk: checks 
MnnM150: checks 
*** RIVER *** [5d 2d Js 7d] [Kc]
Duke Croix: checks 
JeBoyDirk: checks 
MnnM150: bets 283
Duke Croix: folds 
JeBoyDirk: folds 
Uncalled bet (283) returned to MnnM150
MnnM150 collected 283 from pot
*** SUMMARY ***
Total pot 300 | Rake 17 
Board [5d 2d Js 7d Kc]
Seat 1: color_singleton folded before Flop (didn't bet)
Seat 2: MnnM150 (button) collected (283)
Seat 3: Duke Croix (small blind) folded on the River
Seat 9: JeBoyDirk (big blind) folded on the River



PokerStars Home Game Hand #219633031779: {Club #3225207}  Hold'em No Limit (50/100) - 2020/10/22 15:25:31 ET
Table 'VU_table_tonight' 9-max (Play Money) Seat #3 is the button
Seat 1: color_singleton (3767 in chips) 
Seat 2: MnnM150 (10543 in chips) 
Seat 3: Duke Croix (7160 in chips) 
Seat 9: JeBoyDirk (15700 in chips) 
JeBoyDirk: posts small blind 50
color_singleton: posts big blind 100
*** HOLE CARDS ***
Dealt to Duke Croix [8c Jc]
MnnM150: calls 100
Duke Croix: calls 100
JeBoyDirk: folds 
color_singleton: raises 200 to 300
MnnM150: folds 
Duke Croix: calls 200
*** FLOP *** [Ad 9d Qd]
color_singleton: checks 
Duke Croix: checks 
*** TURN *** [Ad 9d Qd] [Jd]
color_singleton: bets 354
Duke Croix: folds 
Uncalled bet (354) returned to color_singleton
color_singleton collected 709 from pot
color_singleton: doesn't show hand 
*** SUMMARY ***
Total pot 750 | Rake 41 
Board [Ad 9d Qd Jd]
Seat 1: color_singleton (big blind) collected (709)
Seat 2: MnnM150 folded before Flop
Seat 3: Duke Croix (button) folded on the Turn
Seat 9: JeBoyDirk (small blind) folded before Flop



PokerStars Home Game Hand #219633050843: {Club #3225207}  Hold'em No Limit (50/100) - 2020/10/22 15:26:01 ET
Table 'VU_table_tonight' 9-max (Play Money) Seat #9 is the button
Seat 1: color_singleton (4176 in chips) 
Seat 2: MnnM150 (10443 in chips) 
Seat 3: Duke Croix (6860 in chips) 
Seat 9: JeBoyDirk (15650 in chips) 
color_singleton: posts small blind 50
MnnM150: posts big blind 100
*** HOLE CARDS ***
Dealt to Duke Croix [As Kc]
Duke Croix: raises 300 to 400
JeBoyDirk: calls 400
color_singleton: folds 
MnnM150: folds 
*** FLOP *** [6d Th 2s]
Duke Croix: checks 
JeBoyDirk: checks 
*** TURN *** [6d Th 2s] [3d]
Duke Croix: checks 
JeBoyDirk: bets 500
Duke Croix: calls 500
*** RIVER *** [6d Th 2s 3d] [7d]
Duke Croix: checks 
JeBoyDirk: checks 
*** SHOW DOWN ***
Duke Croix: shows [As Kc] (high card Ace)
JeBoyDirk: shows [6h Ah] (a pair of Sixes)
JeBoyDirk collected 1843 from pot
*** SUMMARY ***
Total pot 1950 | Rake 107 
Board [6d Th 2s 3d 7d]
Seat 1: color_singleton (small blind) folded before Flop
Seat 2: MnnM150 (big blind) folded before Flop
Seat 3: Duke Croix showed [As Kc] and lost with high card Ace
Seat 9: JeBoyDirk (button) showed [6h Ah] and won (1843) with a pair of Sixes



PokerStars Home Game Hand #219633075041: {Club #3225207}  Hold'em No Limit (50/100) - 2020/10/22 15:26:40 ET
Table 'VU_table_tonight' 9-max (Play Money) Seat #1 is the button
Seat 1: color_singleton (4126 in chips) 
Seat 2: MnnM150 (10343 in chips) 
Seat 3: Duke Croix (5960 in chips) 
Seat 8: appositive (16434 in chips) 
Seat 9: JeBoyDirk (16593 in chips) 
MnnM150: posts small blind 50
Duke Croix: posts big blind 100
appositive: posts small & big blinds 150
*** HOLE CARDS ***
Dealt to Duke Croix [9h 3c]
appositive: checks 
JeBoyDirk: calls 100
color_singleton: calls 100
MnnM150: folds 
Duke Croix: checks 
*** FLOP *** [7s Qs Ad]
Duke Croix: checks 
appositive: checks 
JeBoyDirk: checks 
color_singleton: checks 
*** TURN *** [7s Qs Ad] [9s]
Duke Croix: checks 
appositive: checks 
JeBoyDirk: checks 
color_singleton: checks 
*** RIVER *** [7s Qs Ad 9s] [6d]
Duke Croix: checks 
appositive: checks 
JeBoyDirk: checks 
color_singleton: checks 
*** SHOW DOWN ***
Duke Croix: shows [9h 3c] (a pair of Nines)
appositive: mucks hand 
JeBoyDirk: mucks hand 
color_singleton: mucks hand 
Duke Croix collected 472 from pot
*** SUMMARY ***
Total pot 500 | Rake 28 
Board [7s Qs Ad 9s 6d]
Seat 1: color_singleton (button) mucked [Jh 8c]
Seat 2: MnnM150 (small blind) folded before Flop
Seat 3: Duke Croix (big blind) showed [9h 3c] and won (472) with a pair of Nines
Seat 8: appositive mucked [8s 7h]
Seat 9: JeBoyDirk mucked [Kc 6c]



PokerStars Home Game Hand #219633102352: {Club #3225207}  Hold'em No Limit (50/100) - 2020/10/22 15:27:16 ET
Table 'VU_table_tonight' 9-max (Play Money) Seat #2 is the button
Seat 1: color_singleton (4026 in chips) 
Seat 2: MnnM150 (10293 in chips) 
Seat 3: Duke Croix (6332 in chips) 
Seat 8: appositive (16284 in chips) 
Seat 9: JeBoyDirk (16493 in chips) 
Duke Croix: posts small blind 50
appositive: posts big blind 100
*** HOLE CARDS ***
Dealt to Duke Croix [7c Th]
JeBoyDirk: folds 
color_singleton: folds 
MnnM150: calls 100
Duke Croix: calls 50
appositive: checks 
*** FLOP *** [Jc Qh 8c]
Duke Croix: checks 
appositive: checks 
MnnM150: bets 141
Duke Croix: calls 141
appositive: calls 141
*** TURN *** [Jc Qh 8c] [3s]
Duke Croix: checks 
appositive: bets 200
MnnM150: raises 200 to 400
Duke Croix: folds 
appositive: raises 200 to 600
MnnM150: calls 200
*** RIVER *** [Jc Qh 8c 3s] [2h]
appositive: bets 2000
MnnM150: folds 
Uncalled bet (2000) returned to appositive
appositive collected 1817 from pot
appositive: doesn't show hand 
*** SUMMARY ***
Total pot 1923 | Rake 106 
Board [Jc Qh 8c 3s 2h]
Seat 1: color_singleton folded before Flop (didn't bet)
Seat 2: MnnM150 (button) folded on the River
Seat 3: Duke Croix (small blind) folded on the Turn
Seat 8: appositive (big blind) collected (1817)
Seat 9: JeBoyDirk folded before Flop (didn't bet)



PokerStars Home Game Hand #219633151812: {Club #3225207}  Hold'em No Limit (50/100) - 2020/10/22 15:28:37 ET
Table 'VU_table_tonight' 9-max (Play Money) Seat #3 is the button
Seat 1: color_singleton (4026 in chips) 
Seat 2: MnnM150 (9452 in chips) 
Seat 3: Duke Croix (6091 in chips) 
Seat 8: appositive (17260 in chips) 
Seat 9: JeBoyDirk (16493 in chips) 
appositive: posts small blind 50
JeBoyDirk: posts big blind 100
*** HOLE CARDS ***
Dealt to Duke Croix [7c Ts]
color_singleton: folds 
MnnM150: folds 
Duke Croix: raises 100 to 200
appositive: calls 150
JeBoyDirk: folds 
*** FLOP *** [5d 8c Ah]
appositive: checks 
Duke Croix: checks 
*** TURN *** [5d 8c Ah] [4c]
appositive: checks 
Duke Croix: checks 
*** RIVER *** [5d 8c Ah 4c] [Jc]
appositive: bets 200
Duke Croix: folds 
Uncalled bet (200) returned to appositive
appositive collected 472 from pot
appositive: doesn't show hand 
*** SUMMARY ***
Total pot 500 | Rake 28 
Board [5d 8c Ah 4c Jc]
Seat 1: color_singleton folded before Flop (didn't bet)
Seat 2: MnnM150 folded before Flop (didn't bet)
Seat 3: Duke Croix (button) folded on the River
Seat 8: appositive (small blind) collected (472)
Seat 9: JeBoyDirk (big blind) folded before Flop



PokerStars Home Game Hand #219633175045: {Club #3225207}  Hold'em No Limit (50/100) - 2020/10/22 15:29:15 ET
Table 'VU_table_tonight' 9-max (Play Money) Seat #8 is the button
Seat 1: color_singleton (4026 in chips) 
Seat 2: MnnM150 (9452 in chips) 
Seat 3: Duke Croix (5891 in chips) 
Seat 8: appositive (17532 in chips) 
Seat 9: JeBoyDirk (16393 in chips) 
JeBoyDirk: posts small blind 50
color_singleton: posts big blind 100
*** HOLE CARDS ***
Dealt to Duke Croix [Qd Jd]
MnnM150: folds 
Duke Croix: raises 300 to 400
appositive: calls 400
JeBoyDirk: calls 350
color_singleton: calls 300
*** FLOP *** [5d 7h 2h]
JeBoyDirk: checks 
color_singleton: checks 
Duke Croix: bets 800
appositive: calls 800
JeBoyDirk: folds 
color_singleton: folds 
*** TURN *** [5d 7h 2h] [Jc]
Duke Croix: bets 1500
appositive: folds 
Uncalled bet (1500) returned to Duke Croix
Duke Croix collected 3024 from pot
*** SUMMARY ***
Total pot 3200 | Rake 176 
Board [5d 7h 2h Jc]
Seat 1: color_singleton (big blind) folded on the Flop
Seat 2: MnnM150 folded before Flop (didn't bet)
Seat 3: Duke Croix collected (3024)
Seat 8: appositive (button) folded on the Turn
Seat 9: JeBoyDirk (small blind) folded on the Flop



PokerStars Home Game Hand #219633206565: {Club #3225207}  Hold'em No Limit (50/100) - 2020/10/22 15:30:06 ET
Table 'VU_table_tonight' 9-max (Play Money) Seat #9 is the button
Seat 1: color_singleton (3626 in chips) 
Seat 2: MnnM150 (9452 in chips) 
Seat 3: Duke Croix (7715 in chips) 
Seat 8: appositive (16332 in chips) 
Seat 9: JeBoyDirk (15993 in chips) 
color_singleton: posts small blind 50
MnnM150: posts big blind 100
*** HOLE CARDS ***
Dealt to Duke Croix [6d 7s]
Duke Croix: folds 
appositive: folds 
JeBoyDirk: calls 100
color_singleton: calls 50
MnnM150: checks 
*** FLOP *** [4h 5h Ac]
color_singleton: checks 
MnnM150: bets 100
JeBoyDirk: folds 
color_singleton: folds 
Uncalled bet (100) returned to MnnM150
MnnM150 collected 283 from pot
*** SUMMARY ***
Total pot 300 | Rake 17 
Board [4h 5h Ac]
Seat 1: color_singleton (small blind) folded on the Flop
Seat 2: MnnM150 (big blind) collected (283)
Seat 3: Duke Croix folded before Flop (didn't bet)
Seat 8: appositive folded before Flop (didn't bet)
Seat 9: JeBoyDirk (button) folded on the Flop



PokerStars Home Game Hand #219633227098: {Club #3225207}  Hold'em No Limit (50/100) - 2020/10/22 15:30:40 ET
Table 'VU_table_tonight' 9-max (Play Money) Seat #1 is the button
Seat 1: color_singleton (3526 in chips) 
Seat 2: MnnM150 (9635 in chips) 
Seat 3: Duke Croix (7715 in chips) 
Seat 8: appositive (16332 in chips) 
Seat 9: JeBoyDirk (15893 in chips) 
MnnM150: posts small blind 50
Duke Croix: posts big blind 100
*** HOLE CARDS ***
Dealt to Duke Croix [Qh 8d]
appositive: folds 
JeBoyDirk: folds 
color_singleton: raises 200 to 300
MnnM150: calls 250
Duke Croix: calls 200
*** FLOP *** [Td As Ah]
MnnM150: checks 
Duke Croix: checks 
color_singleton: bets 425
MnnM150: folds 
Duke Croix: folds 
Uncalled bet (425) returned to color_singleton
color_singleton collected 850 from pot
color_singleton: doesn't show hand 
*** SUMMARY ***
Total pot 900 | Rake 50 
Board [Td As Ah]
Seat 1: color_singleton (button) collected (850)
Seat 2: MnnM150 (small blind) folded on the Flop
Seat 3: Duke Croix (big blind) folded on the Flop
Seat 8: appositive folded before Flop (didn't bet)
Seat 9: JeBoyDirk folded before Flop (didn't bet)



PokerStars Home Game Hand #219633252414: {Club #3225207}  Hold'em No Limit (50/100) - 2020/10/22 15:31:21 ET
Table 'VU_table_tonight' 9-max (Play Money) Seat #2 is the button
Seat 1: color_singleton (4076 in chips) 
Seat 2: MnnM150 (9335 in chips) 
Seat 3: Duke Croix (7415 in chips) 
Seat 8: appositive (16332 in chips) 
Seat 9: JeBoyDirk (15893 in chips) 
Duke Croix: posts small blind 50
appositive: posts big blind 100
*** HOLE CARDS ***
Dealt to Duke Croix [Kh Ah]
JeBoyDirk: folds 
color_singleton: raises 200 to 300
MnnM150: folds 
Duke Croix: raises 500 to 800
appositive: folds 
color_singleton: folds 
Uncalled bet (500) returned to Duke Croix
Duke Croix collected 700 from pot
*** SUMMARY ***
Total pot 700 | Rake 0 
Seat 1: color_singleton folded before Flop
Seat 2: MnnM150 (button) folded before Flop (didn't bet)
Seat 3: Duke Croix (small blind) collected (700)
Seat 8: appositive (big blind) folded before Flop
Seat 9: JeBoyDirk folded before Flop (didn't bet)



PokerStars Home Game Hand #219633262735: {Club #3225207}  Hold'em No Limit (50/100) - 2020/10/22 15:31:38 ET
Table 'VU_table_tonight' 9-max (Play Money) Seat #3 is the button
Seat 1: color_singleton (3776 in chips) 
Seat 2: MnnM150 (9335 in chips) 
Seat 3: Duke Croix (7815 in chips) 
Seat 8: appositive (16232 in chips) 
Seat 9: JeBoyDirk (15893 in chips) 
appositive: posts small blind 50
JeBoyDirk: posts big blind 100
*** HOLE CARDS ***
Dealt to Duke Croix [2c 7s]
color_singleton: folds 
MnnM150: calls 100
Duke Croix: folds 
appositive: folds 
JeBoyDirk: checks 
*** FLOP *** [5d 5s Ad]
JeBoyDirk: checks 
MnnM150: checks 
*** TURN *** [5d 5s Ad] [2d]
JeBoyDirk: checks 
MnnM150: checks 
*** RIVER *** [5d 5s Ad 2d] [4h]
JeBoyDirk: checks 
MnnM150: checks 
*** SHOW DOWN ***
JeBoyDirk: shows [Ks 8h] (a pair of Fives)
MnnM150: mucks hand 
JeBoyDirk collected 236 from pot
*** SUMMARY ***
Total pot 250 | Rake 14 
Board [5d 5s Ad 2d 4h]
Seat 1: color_singleton folded before Flop (didn't bet)
Seat 2: MnnM150 mucked [9d Qh]
Seat 3: Duke Croix (button) folded before Flop (didn't bet)
Seat 8: appositive (small blind) folded before Flop
Seat 9: JeBoyDirk (big blind) showed [Ks 8h] and won (236) with a pair of Fives



PokerStars Home Game Hand #219633276980: {Club #3225207}  Hold'em No Limit (50/100) - 2020/10/22 15:32:02 ET
Table 'VU_table_tonight' 9-max (Play Money) Seat #8 is the button
Seat 1: color_singleton (3776 in chips) 
Seat 2: MnnM150 (9235 in chips) 
Seat 3: Duke Croix (7815 in chips) 
Seat 8: appositive (16182 in chips) 
Seat 9: JeBoyDirk (16029 in chips) 
JeBoyDirk: posts small blind 50
color_singleton: posts big blind 100
*** HOLE CARDS ***
Dealt to Duke Croix [7h 5h]
MnnM150: calls 100
Duke Croix: folds 
appositive: calls 100
JeBoyDirk: calls 50
color_singleton: checks 
*** FLOP *** [4s 3h Kh]
JeBoyDirk: checks 
color_singleton: checks 
MnnM150: checks 
appositive: checks 
*** TURN *** [4s 3h Kh] [Jh]
JeBoyDirk: checks 
color_singleton: bets 189
MnnM150: calls 189
appositive: raises 711 to 900
JeBoyDirk: folds 
color_singleton: calls 711
MnnM150: folds 
*** RIVER *** [4s 3h Kh Jh] [2d]
color_singleton: checks 
appositive: bets 1400
color_singleton: calls 1400
*** SHOW DOWN ***
appositive: shows [Th Js] (a pair of Jacks)
color_singleton: shows [Ks 3c] (two pair, Kings and Threes)
color_singleton collected 4904 from pot
*** SUMMARY ***
Total pot 5189 | Rake 285 
Board [4s 3h Kh Jh 2d]
Seat 1: color_singleton (big blind) showed [Ks 3c] and won (4904) with two pair, Kings and Threes
Seat 2: MnnM150 folded on the Turn
Seat 3: Duke Croix folded before Flop (didn't bet)
Seat 8: appositive (button) showed [Th Js] and lost with a pair of Jacks
Seat 9: JeBoyDirk (small blind) folded on the Turn



PokerStars Home Game Hand #219633307447: {Club #3225207}  Hold'em No Limit (50/100) - 2020/10/22 15:32:51 ET
Table 'VU_table_tonight' 9-max (Play Money) Seat #9 is the button
Seat 1: color_singleton (6280 in chips) 
Seat 2: MnnM150 (8946 in chips) 
Seat 3: Duke Croix (7815 in chips) 
Seat 8: appositive (13782 in chips) 
Seat 9: JeBoyDirk (15929 in chips) 
color_singleton: posts small blind 50
MnnM150: posts big blind 100
*** HOLE CARDS ***
Dealt to Duke Croix [9h Js]
Duke Croix: folds 
appositive: folds 
JeBoyDirk: folds 
color_singleton: calls 50
MnnM150: checks 
*** FLOP *** [Td Jc Ah]
color_singleton: checks 
MnnM150: checks 
*** TURN *** [Td Jc Ah] [9d]
color_singleton: checks 
MnnM150: checks 
*** RIVER *** [Td Jc Ah 9d] [Ts]
color_singleton: checks 
MnnM150: bets 189
color_singleton: folds 
Uncalled bet (189) returned to MnnM150
MnnM150 collected 189 from pot
*** SUMMARY ***
Total pot 200 | Rake 11 
Board [Td Jc Ah 9d Ts]
Seat 1: color_singleton (small blind) folded on the River
Seat 2: MnnM150 (big blind) collected (189)
Seat 3: Duke Croix folded before Flop (didn't bet)
Seat 8: appositive folded before Flop (didn't bet)
Seat 9: JeBoyDirk (button) folded before Flop (didn't bet)



PokerStars Home Game Hand #219633336877: {Club #3225207}  Hold'em No Limit (50/100) - 2020/10/22 15:33:40 ET
Table 'VU_table_tonight' 9-max (Play Money) Seat #1 is the button
Seat 1: color_singleton (6180 in chips) 
Seat 2: MnnM150 (9035 in chips) 
Seat 3: Duke Croix (7815 in chips) 
Seat 8: appositive (13782 in chips) 
Seat 9: JeBoyDirk (15929 in chips) 
MnnM150: posts small blind 50
Duke Croix: posts big blind 100
*** HOLE CARDS ***
Dealt to Duke Croix [8d 3d]
appositive: folds 
JeBoyDirk: raises 100 to 200
color_singleton: calls 200
MnnM150: folds 
Duke Croix: calls 100
*** FLOP *** [6d Kc 3h]
Duke Croix: checks 
JeBoyDirk: bets 300
color_singleton: folds 
Duke Croix: calls 300
*** TURN *** [6d Kc 3h] [Jh]
Duke Croix: checks 
JeBoyDirk: checks 
*** RIVER *** [6d Kc 3h Jh] [Js]
Duke Croix: bets 600
JeBoyDirk: calls 600
*** SHOW DOWN ***
Duke Croix: shows [8d 3d] (two pair, Jacks and Threes)
JeBoyDirk: shows [5c 5d] (two pair, Jacks and Fives)
JeBoyDirk collected 2315 from pot
*** SUMMARY ***
Total pot 2450 | Rake 135 
Board [6d Kc 3h Jh Js]
Seat 1: color_singleton (button) folded on the Flop
Seat 2: MnnM150 (small blind) folded before Flop
Seat 3: Duke Croix (big blind) showed [8d 3d] and lost with two pair, Jacks and Threes
Seat 8: appositive folded before Flop (didn't bet)
Seat 9: JeBoyDirk showed [5c 5d] and won (2315) with two pair, Jacks and Fives



PokerStars Home Game Hand #219633359002: {Club #3225207}  Hold'em No Limit (50/100) - 2020/10/22 15:34:16 ET
Table 'VU_table_tonight' 9-max (Play Money) Seat #2 is the button
Seat 1: color_singleton (5980 in chips) 
Seat 2: MnnM150 (8985 in chips) 
Seat 3: Duke Croix (6715 in chips) 
Seat 8: appositive (13782 in chips) 
Seat 9: JeBoyDirk (17144 in chips) 
Duke Croix: posts small blind 50
appositive: posts big blind 100
*** HOLE CARDS ***
Dealt to Duke Croix [Jd Ks]
JeBoyDirk: folds 
color_singleton: raises 100 to 200
MnnM150: folds 
Duke Croix: calls 150
appositive: folds 
*** FLOP *** [Jh 8h 8d]
Duke Croix: bets 300
color_singleton: calls 300
*** TURN *** [Jh 8h 8d] [9h]
Duke Croix: bets 600
color_singleton: folds 
Uncalled bet (600) returned to Duke Croix
Duke Croix collected 1039 from pot
*** SUMMARY ***
Total pot 1100 | Rake 61 
Board [Jh 8h 8d 9h]
Seat 1: color_singleton folded on the Turn
Seat 2: MnnM150 (button) folded before Flop (didn't bet)
Seat 3: Duke Croix (small blind) collected (1039)
Seat 8: appositive (big blind) folded before Flop
Seat 9: JeBoyDirk folded before Flop (didn't bet)



PokerStars Home Game Hand #219633372950: {Club #3225207}  Hold'em No Limit (50/100) - 2020/10/22 15:34:39 ET
Table 'VU_table_tonight' 9-max (Play Money) Seat #3 is the button
Seat 1: color_singleton (5480 in chips) 
Seat 2: MnnM150 (8985 in chips) 
Seat 3: Duke Croix (7254 in chips) 
Seat 8: appositive (13682 in chips) 
Seat 9: JeBoyDirk (17144 in chips) 
appositive: posts small blind 50
JeBoyDirk: posts big blind 100
*** HOLE CARDS ***
Dealt to Duke Croix [Kh 5c]
color_singleton: raises 200 to 300
MnnM150: folds 
Duke Croix: folds 
appositive: calls 250
JeBoyDirk: folds 
*** FLOP *** [Ks 9c 7h]
appositive: bets 200
color_singleton: calls 200
*** TURN *** [Ks 9c 7h] [Jh]
appositive: bets 500
color_singleton: folds 
Uncalled bet (500) returned to appositive
appositive collected 1039 from pot
appositive: doesn't show hand 
*** SUMMARY ***
Total pot 1100 | Rake 61 
Board [Ks 9c 7h Jh]
Seat 1: color_singleton folded on the Turn
Seat 2: MnnM150 folded before Flop (didn't bet)
Seat 3: Duke Croix (button) folded before Flop (didn't bet)
Seat 8: appositive (small blind) collected (1039)
Seat 9: JeBoyDirk (big blind) folded before Flop



PokerStars Home Game Hand #219633395719: {Club #3225207}  Hold'em No Limit (50/100) - 2020/10/22 15:35:15 ET
Table 'VU_table_tonight' 9-max (Play Money) Seat #8 is the button
Seat 1: color_singleton (4980 in chips) 
Seat 2: MnnM150 (8985 in chips) 
Seat 3: Duke Croix (7254 in chips) 
Seat 8: appositive (14221 in chips) 
Seat 9: JeBoyDirk (17044 in chips) 
JeBoyDirk: posts small blind 50
color_singleton: posts big blind 100
*** HOLE CARDS ***
Dealt to Duke Croix [5s 4d]
MnnM150: folds 
Duke Croix: folds 
appositive: calls 100
JeBoyDirk: calls 50
color_singleton: checks 
*** FLOP *** [2h Kh Qd]
JeBoyDirk: checks 
color_singleton: checks 
appositive: checks 
*** TURN *** [2h Kh Qd] [Ah]
JeBoyDirk: checks 
color_singleton: checks 
appositive: checks 
*** RIVER *** [2h Kh Qd Ah] [3d]
JeBoyDirk: bets 300
color_singleton: folds 
appositive: folds 
Uncalled bet (300) returned to JeBoyDirk
JeBoyDirk collected 283 from pot
*** SUMMARY ***
Total pot 300 | Rake 17 
Board [2h Kh Qd Ah 3d]
Seat 1: color_singleton (big blind) folded on the River
Seat 2: MnnM150 folded before Flop (didn't bet)
Seat 3: Duke Croix folded before Flop (didn't bet)
Seat 8: appositive (button) folded on the River
Seat 9: JeBoyDirk (small blind) collected (283)



PokerStars Home Game Hand #219633418906: {Club #3225207}  Hold'em No Limit (50/100) - 2020/10/22 15:35:53 ET
Table 'VU_table_tonight' 9-max (Play Money) Seat #9 is the button
Seat 1: color_singleton (4880 in chips) 
Seat 2: MnnM150 (8985 in chips) 
Seat 3: Duke Croix (7254 in chips) 
Seat 8: appositive (14121 in chips) 
Seat 9: JeBoyDirk (17227 in chips) 
color_singleton: posts small blind 50
MnnM150: posts big blind 100
*** HOLE CARDS ***
Dealt to Duke Croix [Qs 8d]
Duke Croix: raises 200 to 300
appositive: folds 
JeBoyDirk: calls 300
color_singleton: folds 
MnnM150: folds 
*** FLOP *** [2d 2h Ac]
Duke Croix: checks 
JeBoyDirk: checks 
*** TURN *** [2d 2h Ac] [Jc]
Duke Croix: checks 
JeBoyDirk: checks 
*** RIVER *** [2d 2h Ac Jc] [9d]
Duke Croix: checks 
JeBoyDirk: checks 
*** SHOW DOWN ***
Duke Croix: shows [Qs 8d] (a pair of Deuces)
JeBoyDirk: shows [Jh Ks] (two pair, Jacks and Deuces)
JeBoyDirk collected 709 from pot
*** SUMMARY ***
Total pot 750 | Rake 41 
Board [2d 2h Ac Jc 9d]
Seat 1: color_singleton (small blind) folded before Flop
Seat 2: MnnM150 (big blind) folded before Flop
Seat 3: Duke Croix showed [Qs 8d] and lost with a pair of Deuces
Seat 8: appositive folded before Flop (didn't bet)
Seat 9: JeBoyDirk (button) showed [Jh Ks] and won (709) with two pair, Jacks and Deuces



PokerStars Home Game Hand #219633432977: {Club #3225207}  Hold'em No Limit (50/100) - 2020/10/22 15:36:16 ET
Table 'VU_table_tonight' 9-max (Play Money) Seat #1 is the button
Seat 1: color_singleton (4830 in chips) 
Seat 2: MnnM150 (8885 in chips) 
Seat 3: Duke Croix (6954 in chips) 
Seat 8: appositive (14121 in chips) 
Seat 9: JeBoyDirk (17636 in chips) 
MnnM150: posts small blind 50
Duke Croix: posts big blind 100
*** HOLE CARDS ***
Dealt to Duke Croix [Jh 5s]
appositive: folds 
JeBoyDirk: calls 100
color_singleton: calls 100
MnnM150: calls 50
Duke Croix: checks 
*** FLOP *** [6h 3h 6s]
MnnM150: checks 
Duke Croix: checks 
JeBoyDirk: checks 
color_singleton: checks 
*** TURN *** [6h 3h 6s] [7d]
MnnM150: bets 189
Duke Croix: folds 
JeBoyDirk: calls 189
color_singleton: folds 
*** RIVER *** [6h 3h 6s 7d] [7s]
MnnM150: bets 735
JeBoyDirk: folds 
Uncalled bet (735) returned to MnnM150
MnnM150 collected 735 from pot
*** SUMMARY ***
Total pot 778 | Rake 43 
Board [6h 3h 6s 7d 7s]
Seat 1: color_singleton (button) folded on the Turn
Seat 2: MnnM150 (small blind) collected (735)
Seat 3: Duke Croix (big blind) folded on the Turn
Seat 8: appositive folded before Flop (didn't bet)
Seat 9: JeBoyDirk folded on the River



PokerStars Home Game Hand #219633453721: {Club #3225207}  Hold'em No Limit (50/100) - 2020/10/22 15:36:50 ET
Table 'VU_table_tonight' 9-max (Play Money) Seat #2 is the button
Seat 1: color_singleton (4730 in chips) 
Seat 2: MnnM150 (9331 in chips) 
Seat 3: Duke Croix (6854 in chips) 
Seat 8: appositive (14121 in chips) 
Seat 9: JeBoyDirk (17347 in chips) 
Duke Croix: posts small blind 50
appositive: posts big blind 100
*** HOLE CARDS ***
Dealt to Duke Croix [9s 7s]
JeBoyDirk: folds 
color_singleton: raises 200 to 300
MnnM150: calls 300
Duke Croix: folds 
appositive: folds 
*** FLOP *** [Qs 4d Kh]
color_singleton: checks 
MnnM150: checks 
*** TURN *** [Qs 4d Kh] [4h]
color_singleton: checks 
MnnM150: bets 354
color_singleton: calls 354
*** RIVER *** [Qs 4d Kh 4h] [Ad]
color_singleton: checks 
MnnM150: bets 689
color_singleton: folds 
Uncalled bet (689) returned to MnnM150
MnnM150 collected 1378 from pot
*** SUMMARY ***
Total pot 1458 | Rake 80 
Board [Qs 4d Kh 4h Ad]
Seat 1: color_singleton folded on the River
Seat 2: MnnM150 (button) collected (1378)
Seat 3: Duke Croix (small blind) folded before Flop
Seat 8: appositive (big blind) folded before Flop
Seat 9: JeBoyDirk folded before Flop (didn't bet)



PokerStars Home Game Hand #219633479646: {Club #3225207}  Hold'em No Limit (50/100) - 2020/10/22 15:37:32 ET
Table 'VU_table_tonight' 9-max (Play Money) Seat #3 is the button
Seat 1: color_singleton (4076 in chips) 
Seat 2: MnnM150 (10055 in chips) 
Seat 3: Duke Croix (6804 in chips) 
Seat 8: appositive (14021 in chips) 
Seat 9: JeBoyDirk (17347 in chips) 
appositive: posts small blind 50
JeBoyDirk: posts big blind 100
*** HOLE CARDS ***
Dealt to Duke Croix [Qd 5c]
color_singleton: folds 
MnnM150: calls 100
Duke Croix: folds 
appositive: calls 50
JeBoyDirk: checks 
*** FLOP *** [2d 9h Qs]
appositive: bets 400
JeBoyDirk: folds 
MnnM150: folds 
Uncalled bet (400) returned to appositive
appositive collected 283 from pot
appositive: doesn't show hand 
*** SUMMARY ***
Total pot 300 | Rake 17 
Board [2d 9h Qs]
Seat 1: color_singleton folded before Flop (didn't bet)
Seat 2: MnnM150 folded on the Flop
Seat 3: Duke Croix (button) folded before Flop (didn't bet)
Seat 8: appositive (small blind) collected (283)
Seat 9: JeBoyDirk (big blind) folded on the Flop



PokerStars Home Game Hand #219633494121: {Club #3225207}  Hold'em No Limit (50/100) - 2020/10/22 15:37:56 ET
Table 'VU_table_tonight' 9-max (Play Money) Seat #8 is the button
Seat 1: color_singleton (4076 in chips) 
Seat 2: MnnM150 (9955 in chips) 
Seat 3: Duke Croix (6804 in chips) 
Seat 8: appositive (14204 in chips) 
Seat 9: JeBoyDirk (17247 in chips) 
JeBoyDirk: posts small blind 50
color_singleton: posts big blind 100
*** HOLE CARDS ***
Dealt to Duke Croix [3h Ah]
MnnM150: calls 100
Duke Croix: raises 300 to 400
appositive: calls 400
JeBoyDirk: calls 350
color_singleton: calls 300
MnnM150: folds 
*** FLOP *** [8s 2d 7c]
JeBoyDirk: checks 
color_singleton: bets 1606
Duke Croix: folds 
appositive: folds 
JeBoyDirk: folds 
Uncalled bet (1606) returned to color_singleton
color_singleton collected 1606 from pot
color_singleton: doesn't show hand 
*** SUMMARY ***
Total pot 1700 | Rake 94 
Board [8s 2d 7c]
Seat 1: color_singleton (big blind) collected (1606)
Seat 2: MnnM150 folded before Flop
Seat 3: Duke Croix folded on the Flop
Seat 8: appositive (button) folded on the Flop
Seat 9: JeBoyDirk (small blind) folded on the Flop



PokerStars Home Game Hand #219633510550: {Club #3225207}  Hold'em No Limit (50/100) - 2020/10/22 15:38:23 ET
Table 'VU_table_tonight' 9-max (Play Money) Seat #9 is the button
Seat 1: color_singleton (5282 in chips) 
Seat 2: MnnM150 (9855 in chips) 
Seat 3: Duke Croix (6404 in chips) 
Seat 8: appositive (13804 in chips) 
Seat 9: JeBoyDirk (16847 in chips) 
color_singleton: posts small blind 50
MnnM150: posts big blind 100
*** HOLE CARDS ***
Dealt to Duke Croix [6d 2s]
Duke Croix: folds 
appositive: folds 
JeBoyDirk: folds 
color_singleton: raises 100 to 200
MnnM150: calls 100
*** FLOP *** [Ac 9s 3s]
color_singleton: bets 189
MnnM150: raises 189 to 378
color_singleton: folds 
Uncalled bet (189) returned to MnnM150
MnnM150 collected 735 from pot
*** SUMMARY ***
Total pot 778 | Rake 43 
Board [Ac 9s 3s]
Seat 1: color_singleton (small blind) folded on the Flop
Seat 2: MnnM150 (big blind) collected (735)
Seat 3: Duke Croix folded before Flop (didn't bet)
Seat 8: appositive folded before Flop (didn't bet)
Seat 9: JeBoyDirk (button) folded before Flop (didn't bet)



PokerStars Home Game Hand #219633529089: {Club #3225207}  Hold'em No Limit (50/100) - 2020/10/22 15:38:53 ET
Table 'VU_table_tonight' 9-max (Play Money) Seat #1 is the button
Seat 1: color_singleton (4893 in chips) 
Seat 2: MnnM150 (10201 in chips) 
Seat 3: Duke Croix (6404 in chips) 
Seat 8: appositive (13804 in chips) 
Seat 9: JeBoyDirk (16847 in chips) 
MnnM150: posts small blind 50
Duke Croix: posts big blind 100
*** HOLE CARDS ***
Dealt to Duke Croix [8s 7h]
appositive: calls 100
JeBoyDirk: folds 
color_singleton: folds 
MnnM150: calls 50
Duke Croix: checks 
*** FLOP *** [Js 8d 7c]
MnnM150: checks 
Duke Croix: bets 300
appositive: calls 300
MnnM150: folds 
*** TURN *** [Js 8d 7c] [Qh]
Duke Croix: bets 500
appositive: folds 
Uncalled bet (500) returned to Duke Croix
Duke Croix collected 850 from pot
*** SUMMARY ***
Total pot 900 | Rake 50 
Board [Js 8d 7c Qh]
Seat 1: color_singleton (button) folded before Flop (didn't bet)
Seat 2: MnnM150 (small blind) folded on the Flop
Seat 3: Duke Croix (big blind) collected (850)
Seat 8: appositive folded on the Turn
Seat 9: JeBoyDirk folded before Flop (didn't bet)



PokerStars Home Game Hand #219633544715: {Club #3225207}  Hold'em No Limit (50/100) - 2020/10/22 15:39:18 ET
Table 'VU_table_tonight' 9-max (Play Money) Seat #2 is the button
Seat 1: color_singleton (4893 in chips) 
Seat 2: MnnM150 (10101 in chips) 
Seat 3: Duke Croix (6854 in chips) 
Seat 8: appositive (13404 in chips) 
Seat 9: JeBoyDirk (16847 in chips) 
Duke Croix: posts small blind 50
appositive: posts big blind 100
*** HOLE CARDS ***
Dealt to Duke Croix [Kc 9d]
JeBoyDirk: folds 
color_singleton: folds 
MnnM150: calls 100
Duke Croix: calls 50
appositive: checks 
*** FLOP *** [Ac 4s Kh]
Duke Croix: bets 200
appositive: folds 
MnnM150: calls 200
*** TURN *** [Ac 4s Kh] [8h]
Duke Croix: bets 400
MnnM150: calls 400
*** RIVER *** [Ac 4s Kh 8h] [2c]
Duke Croix: bets 800
MnnM150: calls 800
*** SHOW DOWN ***
Duke Croix: shows [Kc 9d] (a pair of Kings)
MnnM150: shows [Ad Th] (a pair of Aces)
MnnM150 collected 2929 from pot
*** SUMMARY ***
Total pot 3100 | Rake 171 
Board [Ac 4s Kh 8h 2c]
Seat 1: color_singleton folded before Flop (didn't bet)
Seat 2: MnnM150 (button) showed [Ad Th] and won (2929) with a pair of Aces
Seat 3: Duke Croix (small blind) showed [Kc 9d] and lost with a pair of Kings
Seat 8: appositive (big blind) folded on the Flop
Seat 9: JeBoyDirk folded before Flop (didn't bet)



PokerStars Home Game Hand #219633564700: {Club #3225207}  Hold'em No Limit (50/100) - 2020/10/22 15:39:51 ET
Table 'VU_table_tonight' 9-max (Play Money) Seat #3 is the button
Seat 1: color_singleton (4893 in chips) 
Seat 2: MnnM150 (11530 in chips) 
Seat 3: Duke Croix (5354 in chips) 
Seat 8: appositive (13304 in chips) 
Seat 9: JeBoyDirk (16847 in chips) 
appositive: posts small blind 50
JeBoyDirk: posts big blind 100
*** HOLE CARDS ***
Dealt to Duke Croix [5c 4d]
color_singleton: raises 200 to 300
MnnM150: calls 300
Duke Croix: folds 
appositive: folds 
JeBoyDirk: calls 200
*** FLOP *** [9c Ts 5s]
JeBoyDirk: checks 
color_singleton: checks 
MnnM150: checks 
*** TURN *** [9c Ts 5s] [3h]
JeBoyDirk: checks 
color_singleton: checks 
MnnM150: bets 449
JeBoyDirk: folds 
color_singleton: folds 
Uncalled bet (449) returned to MnnM150
MnnM150 collected 898 from pot
*** SUMMARY ***
Total pot 950 | Rake 52 
Board [9c Ts 5s 3h]
Seat 1: color_singleton folded on the Turn
Seat 2: MnnM150 collected (898)
Seat 3: Duke Croix (button) folded before Flop (didn't bet)
Seat 8: appositive (small blind) folded before Flop
Seat 9: JeBoyDirk (big blind) folded on the Turn



PokerStars Home Game Hand #219633584062: {Club #3225207}  Hold'em No Limit (50/100) - 2020/10/22 15:40:22 ET
Table 'VU_table_tonight' 9-max (Play Money) Seat #8 is the button
Seat 1: color_singleton (4593 in chips) 
Seat 2: MnnM150 (12128 in chips) 
Seat 3: Duke Croix (5354 in chips) 
Seat 8: appositive (13254 in chips) 
Seat 9: JeBoyDirk (16547 in chips) 
JeBoyDirk: posts small blind 50
color_singleton: posts big blind 100
*** HOLE CARDS ***
Dealt to Duke Croix [4c Ah]
MnnM150: calls 100
Duke Croix: calls 100
appositive: calls 100
JeBoyDirk: calls 50
color_singleton: checks 
*** FLOP *** [9s 8c Jc]
JeBoyDirk: checks 
color_singleton: checks 
MnnM150: checks 
Duke Croix: checks 
appositive: bets 200
JeBoyDirk: calls 200
color_singleton: folds 
MnnM150: calls 200
Duke Croix: folds 
*** TURN *** [9s 8c Jc] [Qs]
JeBoyDirk: checks 
MnnM150: bets 519
appositive: raises 1119 to 1638
JeBoyDirk: folds 
MnnM150: folds 
Uncalled bet (1119) returned to appositive
appositive collected 2020 from pot
appositive: doesn't show hand 
*** SUMMARY ***
Total pot 2138 | Rake 118 
Board [9s 8c Jc Qs]
Seat 1: color_singleton (big blind) folded on the Flop
Seat 2: MnnM150 folded on the Turn
Seat 3: Duke Croix folded on the Flop
Seat 8: appositive (button) collected (2020)
Seat 9: JeBoyDirk (small blind) folded on the Turn



PokerStars Home Game Hand #219633622623: {Club #3225207}  Hold'em No Limit (50/100) - 2020/10/22 15:41:26 ET
Table 'VU_table_tonight' 9-max (Play Money) Seat #9 is the button
Seat 1: color_singleton (4493 in chips) 
Seat 2: MnnM150 (11309 in chips) 
Seat 3: Duke Croix (5254 in chips) 
Seat 8: appositive (14455 in chips) 
Seat 9: JeBoyDirk (16247 in chips) 
color_singleton: posts small blind 50
MnnM150: posts big blind 100
*** HOLE CARDS ***
Dealt to Duke Croix [Js 3s]
Duke Croix: folds 
appositive: folds 
JeBoyDirk: folds 
color_singleton: raises 200 to 300
MnnM150: folds 
Uncalled bet (200) returned to color_singleton
color_singleton collected 200 from pot
color_singleton: doesn't show hand 
*** SUMMARY ***
Total pot 200 | Rake 0 
Seat 1: color_singleton (small blind) collected (200)
Seat 2: MnnM150 (big blind) folded before Flop
Seat 3: Duke Croix folded before Flop (didn't bet)
Seat 8: appositive folded before Flop (didn't bet)
Seat 9: JeBoyDirk (button) folded before Flop (didn't bet)



PokerStars Home Game Hand #219633633347: {Club #3225207}  Hold'em No Limit (50/100) - 2020/10/22 15:41:43 ET
Table 'VU_table_tonight' 9-max (Play Money) Seat #1 is the button
Seat 1: color_singleton (4593 in chips) 
Seat 2: MnnM150 (11209 in chips) 
Seat 3: Duke Croix (5254 in chips) 
Seat 8: appositive (14455 in chips) 
Seat 9: JeBoyDirk (16247 in chips) 
MnnM150: posts small blind 50
Duke Croix: posts big blind 100
*** HOLE CARDS ***
Dealt to Duke Croix [6s Jh]
appositive: calls 100
JeBoyDirk: folds 
color_singleton: raises 200 to 300
MnnM150: folds 
Duke Croix: folds 
appositive: calls 200
*** FLOP *** [2c Ts 4h]
appositive: checks 
color_singleton: checks 
*** TURN *** [2c Ts 4h] [As]
appositive: bets 400
color_singleton: calls 400
*** RIVER *** [2c Ts 4h As] [5h]
appositive: bets 1465
color_singleton: calls 1465
*** SHOW DOWN ***
appositive: shows [6h Ah] (a pair of Aces)
color_singleton: shows [5c Ac] (two pair, Aces and Fives)
color_singleton collected 4234 from pot
*** SUMMARY ***
Total pot 4480 | Rake 246 
Board [2c Ts 4h As 5h]
Seat 1: color_singleton (button) showed [5c Ac] and won (4234) with two pair, Aces and Fives
Seat 2: MnnM150 (small blind) folded before Flop
Seat 3: Duke Croix (big blind) folded before Flop
Seat 8: appositive showed [6h Ah] and lost with a pair of Aces
Seat 9: JeBoyDirk folded before Flop (didn't bet)



PokerStars Home Game Hand #219633665910: {Club #3225207}  Hold'em No Limit (50/100) - 2020/10/22 15:42:37 ET
Table 'VU_table_tonight' 9-max (Play Money) Seat #2 is the button
Seat 1: color_singleton (6662 in chips) 
Seat 2: MnnM150 (11159 in chips) 
Seat 3: Duke Croix (5154 in chips) 
Seat 8: appositive (12290 in chips) 
Seat 9: JeBoyDirk (16247 in chips) 
Duke Croix: posts small blind 50
appositive: posts big blind 100
*** HOLE CARDS ***
Dealt to Duke Croix [Ac 8s]
JeBoyDirk: folds 
color_singleton: folds 
MnnM150: calls 100
Duke Croix: calls 50
appositive: checks 
*** FLOP *** [6d 2s 8c]
Duke Croix: bets 200
appositive: folds 
MnnM150: folds 
Uncalled bet (200) returned to Duke Croix
Duke Croix collected 283 from pot
*** SUMMARY ***
Total pot 300 | Rake 17 
Board [6d 2s 8c]
Seat 1: color_singleton folded before Flop (didn't bet)
Seat 2: MnnM150 (button) folded on the Flop
Seat 3: Duke Croix (small blind) collected (283)
Seat 8: appositive (big blind) folded on the Flop
Seat 9: JeBoyDirk folded before Flop (didn't bet)



PokerStars Home Game Hand #219633690317: {Club #3225207}  Hold'em No Limit (50/100) - 2020/10/22 15:43:18 ET
Table 'VU_table_tonight' 9-max (Play Money) Seat #3 is the button
Seat 1: color_singleton (6662 in chips) 
Seat 2: MnnM150 (11059 in chips) 
Seat 3: Duke Croix (5337 in chips) 
Seat 8: appositive (12190 in chips) 
Seat 9: JeBoyDirk (16247 in chips) 
appositive: posts small blind 50
JeBoyDirk: posts big blind 100
*** HOLE CARDS ***
Dealt to Duke Croix [Kh Jc]
color_singleton: folds 
MnnM150: folds 
Duke Croix: raises 300 to 400
appositive: calls 350
JeBoyDirk: folds 
*** FLOP *** [2d 3c 9h]
appositive: checks 
Duke Croix: bets 400
appositive: folds 
Uncalled bet (400) returned to Duke Croix
Duke Croix collected 850 from pot
*** SUMMARY ***
Total pot 900 | Rake 50 
Board [2d 3c 9h]
Seat 1: color_singleton folded before Flop (didn't bet)
Seat 2: MnnM150 folded before Flop (didn't bet)
Seat 3: Duke Croix (button) collected (850)
Seat 8: appositive (small blind) folded on the Flop
Seat 9: JeBoyDirk (big blind) folded before Flop



PokerStars Home Game Hand #219633714079: {Club #3225207}  Hold'em No Limit (50/100) - 2020/10/22 15:43:57 ET
Table 'VU_table_tonight' 9-max (Play Money) Seat #8 is the button
Seat 1: color_singleton (6662 in chips) 
Seat 2: MnnM150 (11059 in chips) 
Seat 3: Duke Croix (5787 in chips) 
Seat 8: appositive (11790 in chips) 
Seat 9: JeBoyDirk (16147 in chips) 
JeBoyDirk: posts small blind 50
color_singleton: posts big blind 100
*** HOLE CARDS ***
Dealt to Duke Croix [7d Jh]
MnnM150: folds 
Duke Croix: folds 
appositive: folds 
JeBoyDirk: raises 200 to 300
color_singleton: calls 200
*** FLOP *** [9c Kh 5s]
JeBoyDirk: bets 300
color_singleton: raises 300 to 600
JeBoyDirk: folds 
Uncalled bet (300) returned to color_singleton
color_singleton collected 1134 from pot
color_singleton: doesn't show hand 
*** SUMMARY ***
Total pot 1200 | Rake 66 
Board [9c Kh 5s]
Seat 1: color_singleton (big blind) collected (1134)
Seat 2: MnnM150 folded before Flop (didn't bet)
Seat 3: Duke Croix folded before Flop (didn't bet)
Seat 8: appositive (button) folded before Flop (didn't bet)
Seat 9: JeBoyDirk (small blind) folded on the Flop



PokerStars Home Game Hand #219633729483: {Club #3225207}  Hold'em No Limit (50/100) - 2020/10/22 15:44:22 ET
Table 'VU_table_tonight' 9-max (Play Money) Seat #9 is the button
Seat 1: color_singleton (7196 in chips) 
Seat 2: MnnM150 (11059 in chips) 
Seat 3: Duke Croix (5787 in chips) 
Seat 8: appositive (11790 in chips) 
Seat 9: JeBoyDirk (15547 in chips) 
color_singleton: posts small blind 50
MnnM150: posts big blind 100
*** HOLE CARDS ***
Dealt to Duke Croix [Ts 9s]
Duke Croix: raises 200 to 300
appositive: folds 
JeBoyDirk: folds 
color_singleton: folds 
MnnM150: folds 
Uncalled bet (200) returned to Duke Croix
Duke Croix collected 250 from pot
*** SUMMARY ***
Total pot 250 | Rake 0 
Seat 1: color_singleton (small blind) folded before Flop
Seat 2: MnnM150 (big blind) folded before Flop
Seat 3: Duke Croix collected (250)
Seat 8: appositive folded before Flop (didn't bet)
Seat 9: JeBoyDirk (button) folded before Flop (didn't bet)



PokerStars Home Game Hand #219633737708: {Club #3225207}  Hold'em No Limit (50/100) - 2020/10/22 15:44:36 ET
Table 'VU_table_tonight' 9-max (Play Money) Seat #1 is the button
Seat 1: color_singleton (7146 in chips) 
Seat 2: MnnM150 (10959 in chips) 
Seat 3: Duke Croix (5937 in chips) 
Seat 8: appositive (11790 in chips) 
Seat 9: JeBoyDirk (15547 in chips) 
MnnM150: posts small blind 50
Duke Croix: posts big blind 100
*** HOLE CARDS ***
Dealt to Duke Croix [3c Qs]
appositive: calls 100
JeBoyDirk: folds 
color_singleton: calls 100
MnnM150: calls 50
Duke Croix: checks 
*** FLOP *** [Jh Ac 7s]
MnnM150: checks 
Duke Croix: checks 
appositive: bets 189
color_singleton: calls 189
MnnM150: calls 189
Duke Croix: folds 
*** TURN *** [Jh Ac 7s] [Ks]
MnnM150: checks 
appositive: bets 914
color_singleton: folds 
MnnM150: folds 
Uncalled bet (914) returned to appositive
appositive collected 914 from pot
appositive: doesn't show hand 
*** SUMMARY ***
Total pot 967 | Rake 53 
Board [Jh Ac 7s Ks]
Seat 1: color_singleton (button) folded on the Turn
Seat 2: MnnM150 (small blind) folded on the Turn
Seat 3: Duke Croix (big blind) folded on the Flop
Seat 8: appositive collected (914)
Seat 9: JeBoyDirk folded before Flop (didn't bet)



PokerStars Home Game Hand #219633762948: {Club #3225207}  Hold'em No Limit (50/100) - 2020/10/22 15:45:18 ET
Table 'VU_table_tonight' 9-max (Play Money) Seat #2 is the button
Seat 1: color_singleton (6857 in chips) 
Seat 2: MnnM150 (10670 in chips) 
Seat 3: Duke Croix (5837 in chips) 
Seat 8: appositive (12415 in chips) 
Seat 9: JeBoyDirk (15547 in chips) 
Duke Croix: posts small blind 50
appositive: posts big blind 100
*** HOLE CARDS ***
Dealt to Duke Croix [5s Qd]
JeBoyDirk: raises 200 to 300
color_singleton: folds 
MnnM150: folds 
Duke Croix: folds 
appositive: folds 
Uncalled bet (200) returned to JeBoyDirk
JeBoyDirk collected 250 from pot
*** SUMMARY ***
Total pot 250 | Rake 0 
Seat 1: color_singleton folded before Flop (didn't bet)
Seat 2: MnnM150 (button) folded before Flop (didn't bet)
Seat 3: Duke Croix (small blind) folded before Flop
Seat 8: appositive (big blind) folded before Flop
Seat 9: JeBoyDirk collected (250)



PokerStars Home Game Hand #219633770880: {Club #3225207}  Hold'em No Limit (50/100) - 2020/10/22 15:45:31 ET
Table 'VU_table_tonight' 9-max (Play Money) Seat #3 is the button
Seat 1: color_singleton (6857 in chips) 
Seat 2: MnnM150 (10670 in chips) 
Seat 3: Duke Croix (5787 in chips) 
Seat 8: appositive (12315 in chips) 
Seat 9: JeBoyDirk (15697 in chips) 
appositive: posts small blind 50
JeBoyDirk: posts big blind 100
*** HOLE CARDS ***
Dealt to Duke Croix [9h Jh]
color_singleton: raises 200 to 300
MnnM150: calls 300
Duke Croix: calls 300
appositive: folds 
JeBoyDirk: calls 200
*** FLOP *** [2h 9c 4d]
JeBoyDirk: checks 
color_singleton: checks 
MnnM150: checks 
Duke Croix: bets 650
JeBoyDirk: calls 650
color_singleton: folds 
MnnM150: folds 
*** TURN *** [2h 9c 4d] [5s]
JeBoyDirk: checks 
Duke Croix: checks 
*** RIVER *** [2h 9c 4d 5s] [Kd]
JeBoyDirk: bets 1000
Duke Croix: calls 1000
*** SHOW DOWN ***
JeBoyDirk: shows [Ad Kh] (a pair of Kings)
Duke Croix: mucks hand 
JeBoyDirk collected 4300 from pot
*** SUMMARY ***
Total pot 4550 | Rake 250 
Board [2h 9c 4d 5s Kd]
Seat 1: color_singleton folded on the Flop
Seat 2: MnnM150 folded on the Flop
Seat 3: Duke Croix (button) mucked [9h Jh]
Seat 8: appositive (small blind) folded before Flop
Seat 9: JeBoyDirk (big blind) showed [Ad Kh] and won (4300) with a pair of Kings



PokerStars Home Game Hand #219633799690: {Club #3225207}  Hold'em No Limit (50/100) - 2020/10/22 15:46:19 ET
Table 'VU_table_tonight' 9-max (Play Money) Seat #8 is the button
Seat 1: color_singleton (6557 in chips) 
Seat 2: MnnM150 (10370 in chips) 
Seat 3: Duke Croix (3837 in chips) 
Seat 8: appositive (12265 in chips) 
Seat 9: JeBoyDirk (18047 in chips) 
JeBoyDirk: posts small blind 50
color_singleton: posts big blind 100
*** HOLE CARDS ***
Dealt to Duke Croix [2h Ah]
MnnM150: calls 100
Duke Croix: calls 100
appositive: calls 100
JeBoyDirk: calls 50
color_singleton: checks 
*** FLOP *** [Ad 9h 4c]
JeBoyDirk: checks 
color_singleton: checks 
MnnM150: checks 
Duke Croix: bets 400
appositive: raises 400 to 800
JeBoyDirk: folds 
color_singleton: folds 
MnnM150: folds 
Duke Croix: calls 400
*** TURN *** [Ad 9h 4c] [Jh]
Duke Croix: bets 2937 and is all-in
appositive: calls 2937
*** RIVER *** [Ad 9h 4c Jh] [3s]
*** SHOW DOWN ***
Duke Croix: shows [2h Ah] (a pair of Aces)
appositive: shows [9c Ac] (two pair, Aces and Nines)
appositive collected 7535 from pot
*** SUMMARY ***
Total pot 7974 | Rake 439 
Board [Ad 9h 4c Jh 3s]
Seat 1: color_singleton (big blind) folded on the Flop
Seat 2: MnnM150 folded on the Flop
Seat 3: Duke Croix showed [2h Ah] and lost with a pair of Aces
Seat 8: appositive (button) showed [9c Ac] and won (7535) with two pair, Aces and Nines
Seat 9: JeBoyDirk (small blind) folded on the Flop



PokerStars Home Game Hand #219633841131: {Club #3225207}  Hold'em No Limit (50/100) - 2020/10/22 15:47:27 ET
Table 'VU_table_tonight' 9-max (Play Money) Seat #1 is the button
Seat 1: color_singleton (6357 in chips) 
Seat 2: MnnM150 (10359 in chips) 
Seat 3: Duke Croix (10000 in chips) 
Seat 8: appositive (15963 in chips) 
Seat 9: JeBoyDirk (17947 in chips) 
MnnM150: posts small blind 50
Duke Croix: posts big blind 100
*** HOLE CARDS ***
Dealt to Duke Croix [2d 3c]
appositive: folds 
JeBoyDirk: calls 100
color_singleton: folds 
MnnM150: calls 50
Duke Croix: checks 
*** FLOP *** [Qh 9c 6h]
MnnM150: checks 
Duke Croix: checks 
JeBoyDirk: checks 
*** TURN *** [Qh 9c 6h] [8s]
MnnM150: checks 
Duke Croix: checks 
JeBoyDirk: checks 
*** RIVER *** [Qh 9c 6h 8s] [9s]
MnnM150: checks 
Duke Croix: checks 
JeBoyDirk: checks 
*** SHOW DOWN ***
MnnM150: shows [5d 5h] (two pair, Nines and Fives)
Duke Croix: mucks hand 
JeBoyDirk: shows [6c 7c] (two pair, Nines and Sixes)
JeBoyDirk collected 283 from pot
*** SUMMARY ***
Total pot 300 | Rake 17 
Board [Qh 9c 6h 8s 9s]
Seat 1: color_singleton (button) folded before Flop (didn't bet)
Seat 2: MnnM150 (small blind) showed [5d 5h] and lost with two pair, Nines and Fives
Seat 3: Duke Croix (big blind) mucked [2d 3c]
Seat 8: appositive folded before Flop (didn't bet)
Seat 9: JeBoyDirk showed [6c 7c] and won (283) with two pair, Nines and Sixes



PokerStars Home Game Hand #219633858602: {Club #3225207}  Hold'em No Limit (50/100) - 2020/10/22 15:47:56 ET
Table 'VU_table_tonight' 9-max (Play Money) Seat #2 is the button
Seat 1: color_singleton (6357 in chips) 
Seat 2: MnnM150 (10259 in chips) 
Seat 3: Duke Croix (9900 in chips) 
Seat 8: appositive (15963 in chips) 
Seat 9: JeBoyDirk (18130 in chips) 
Duke Croix: posts small blind 50
appositive: posts big blind 100
*** HOLE CARDS ***
Dealt to Duke Croix [6h 9h]
JeBoyDirk: folds 
color_singleton: raises 200 to 300
MnnM150: folds 
Duke Croix: folds 
appositive: folds 
Uncalled bet (200) returned to color_singleton
color_singleton collected 250 from pot
color_singleton: doesn't show hand 
*** SUMMARY ***
Total pot 250 | Rake 0 
Seat 1: color_singleton collected (250)
Seat 2: MnnM150 (button) folded before Flop (didn't bet)
Seat 3: Duke Croix (small blind) folded before Flop
Seat 8: appositive (big blind) folded before Flop
Seat 9: JeBoyDirk folded before Flop (didn't bet)



PokerStars Home Game Hand #219633865362: {Club #3225207}  Hold'em No Limit (50/100) - 2020/10/22 15:48:07 ET
Table 'VU_table_tonight' 9-max (Play Money) Seat #3 is the button
Seat 1: color_singleton (6507 in chips) 
Seat 2: MnnM150 (10259 in chips) 
Seat 3: Duke Croix (9850 in chips) 
Seat 8: appositive (15863 in chips) 
Seat 9: JeBoyDirk (18130 in chips) 
appositive: posts small blind 50
JeBoyDirk: posts big blind 100
*** HOLE CARDS ***
Dealt to Duke Croix [Ts 4s]
color_singleton: folds 
MnnM150: calls 100
Duke Croix: folds 
appositive: calls 50
JeBoyDirk: checks 
*** FLOP *** [4h As Ac]
appositive: checks 
JeBoyDirk: checks 
MnnM150: checks 
*** TURN *** [4h As Ac] [7s]
appositive: checks 
JeBoyDirk: checks 
MnnM150: checks 
*** RIVER *** [4h As Ac 7s] [5c]
appositive: checks 
JeBoyDirk: checks 
MnnM150: checks 
*** SHOW DOWN ***
appositive: shows [Th Qc] (a pair of Aces)
JeBoyDirk: shows [Kh 4c] (two pair, Aces and Fours)
MnnM150: mucks hand 
JeBoyDirk collected 283 from pot
*** SUMMARY ***
Total pot 300 | Rake 17 
Board [4h As Ac 7s 5c]
Seat 1: color_singleton folded before Flop (didn't bet)
Seat 2: MnnM150 mucked [Qd 3d]
Seat 3: Duke Croix (button) folded before Flop (didn't bet)
Seat 8: appositive (small blind) showed [Th Qc] and lost with a pair of Aces
Seat 9: JeBoyDirk (big blind) showed [Kh 4c] and won (283) with two pair, Aces and Fours



PokerStars Home Game Hand #219633885589: {Club #3225207}  Hold'em No Limit (50/100) - 2020/10/22 15:48:41 ET
Table 'VU_table_tonight' 9-max (Play Money) Seat #8 is the button
Seat 1: color_singleton (6507 in chips) 
Seat 2: MnnM150 (10159 in chips) 
Seat 3: Duke Croix (9850 in chips) 
Seat 8: appositive (15763 in chips) 
Seat 9: JeBoyDirk (18313 in chips) 
JeBoyDirk: posts small blind 50
color_singleton: posts big blind 100
*** HOLE CARDS ***
Dealt to Duke Croix [Qd 2s]
MnnM150: folds 
Duke Croix: folds 
appositive: calls 100
JeBoyDirk: folds 
color_singleton has timed out
color_singleton: checks 
*** FLOP *** [Kc Jd Ks]
color_singleton has timed out
color_singleton: checks 
appositive: bets 600
color_singleton: calls 600
*** TURN *** [Kc Jd Ks] [Td]
color_singleton: checks 
appositive: bets 1200
color_singleton: folds 
Uncalled bet (1200) returned to appositive
appositive collected 1370 from pot
appositive: doesn't show hand 
*** SUMMARY ***
Total pot 1450 | Rake 80 
Board [Kc Jd Ks Td]
Seat 1: color_singleton (big blind) folded on the Turn
Seat 2: MnnM150 folded before Flop (didn't bet)
Seat 3: Duke Croix folded before Flop (didn't bet)
Seat 8: appositive (button) collected (1370)
Seat 9: JeBoyDirk (small blind) folded before Flop



PokerStars Home Game Hand #219633954020: {Club #3225207}  Hold'em No Limit (50/100) - 2020/10/22 15:50:20 ET
Table 'VU_table_tonight' 9-max (Play Money) Seat #9 is the button
Seat 1: color_singleton (5807 in chips) 
Seat 2: MnnM150 (10159 in chips) 
Seat 3: Duke Croix (9850 in chips) 
Seat 8: appositive (16433 in chips) 
Seat 9: JeBoyDirk (18263 in chips) 
color_singleton: posts small blind 50
MnnM150: posts big blind 100
*** HOLE CARDS ***
Dealt to Duke Croix [6c 4c]
Duke Croix: calls 100
appositive: folds 
JeBoyDirk: folds 
color_singleton: calls 50
MnnM150: checks 
*** FLOP *** [7d Td Ks]
color_singleton: checks 
MnnM150: checks 
Duke Croix: checks 
*** TURN *** [7d Td Ks] [Th]
color_singleton: bets 141
MnnM150: calls 141
Duke Croix: folds 
*** RIVER *** [7d Td Ks Th] [Ac]
color_singleton: checks 
MnnM150: bets 550
color_singleton: folds 
Uncalled bet (550) returned to MnnM150
MnnM150 collected 550 from pot
*** SUMMARY ***
Total pot 582 | Rake 32 
Board [7d Td Ks Th Ac]
Seat 1: color_singleton (small blind) folded on the River
Seat 2: MnnM150 (big blind) collected (550)
Seat 3: Duke Croix folded on the Turn
Seat 8: appositive folded before Flop (didn't bet)
Seat 9: JeBoyDirk (button) folded before Flop (didn't bet)



PokerStars Home Game Hand #219633979309: {Club #3225207}  Hold'em No Limit (50/100) - 2020/10/22 15:51:02 ET
Table 'VU_table_tonight' 9-max (Play Money) Seat #1 is the button
Seat 1: color_singleton (5566 in chips) 
Seat 2: MnnM150 (10468 in chips) 
Seat 3: Duke Croix (9750 in chips) 
Seat 8: appositive (16433 in chips) 
Seat 9: JeBoyDirk (18263 in chips) 
MnnM150: posts small blind 50
Duke Croix: posts big blind 100
*** HOLE CARDS ***
Dealt to Duke Croix [4d 2h]
appositive: calls 100
JeBoyDirk: folds 
color_singleton: raises 200 to 300
MnnM150: calls 250
Duke Croix: folds 
appositive: calls 200
*** FLOP *** [5d Th 9d]
MnnM150: checks 
appositive: checks 
color_singleton: bets 945
MnnM150: folds 
appositive: folds 
Uncalled bet (945) returned to color_singleton
color_singleton collected 945 from pot
color_singleton: doesn't show hand 
*** SUMMARY ***
Total pot 1000 | Rake 55 
Board [5d Th 9d]
Seat 1: color_singleton (button) collected (945)
Seat 2: MnnM150 (small blind) folded on the Flop
Seat 3: Duke Croix (big blind) folded before Flop
Seat 8: appositive folded on the Flop
Seat 9: JeBoyDirk folded before Flop (didn't bet)



PokerStars Home Game Hand #219634006251: {Club #3225207}  Hold'em No Limit (50/100) - 2020/10/22 15:51:46 ET
Table 'VU_table_tonight' 9-max (Play Money) Seat #2 is the button
Seat 1: color_singleton (6211 in chips) 
Seat 2: MnnM150 (10168 in chips) 
Seat 3: Duke Croix (9650 in chips) 
Seat 8: appositive (16133 in chips) 
Seat 9: JeBoyDirk (18263 in chips) 
Duke Croix: posts small blind 50
appositive: posts big blind 100
*** HOLE CARDS ***
Dealt to Duke Croix [9s 3h]
JeBoyDirk: raises 200 to 300
color_singleton: folds 
MnnM150: calls 300
Duke Croix: folds 
appositive: folds 
*** FLOP *** [Qh Qc Qs]
JeBoyDirk: bets 400
MnnM150: raises 400 to 800
JeBoyDirk: folds 
Uncalled bet (400) returned to MnnM150
MnnM150 collected 1465 from pot
*** SUMMARY ***
Total pot 1550 | Rake 85 
Board [Qh Qc Qs]
Seat 1: color_singleton folded before Flop (didn't bet)
Seat 2: MnnM150 (button) collected (1465)
Seat 3: Duke Croix (small blind) folded before Flop
Seat 8: appositive (big blind) folded before Flop
Seat 9: JeBoyDirk folded on the Flop



PokerStars Home Game Hand #219634029015: {Club #3225207}  Hold'em No Limit (50/100) - 2020/10/22 15:52:24 ET
Table 'VU_table_tonight' 9-max (Play Money) Seat #3 is the button
Seat 1: color_singleton (6211 in chips) 
Seat 2: MnnM150 (10933 in chips) 
Seat 3: Duke Croix (9600 in chips) 
Seat 8: appositive (16033 in chips) 
Seat 9: JeBoyDirk (17563 in chips) 
appositive: posts small blind 50
JeBoyDirk: posts big blind 100
*** HOLE CARDS ***
Dealt to Duke Croix [Kh Kc]
color_singleton: folds 
MnnM150: calls 100
Duke Croix: raises 400 to 500
appositive: folds 
JeBoyDirk: folds 
MnnM150: folds 
Uncalled bet (400) returned to Duke Croix
Duke Croix collected 350 from pot
*** SUMMARY ***
Total pot 350 | Rake 0 
Seat 1: color_singleton folded before Flop (didn't bet)
Seat 2: MnnM150 folded before Flop
Seat 3: Duke Croix (button) collected (350)
Seat 8: appositive (small blind) folded before Flop
Seat 9: JeBoyDirk (big blind) folded before Flop



PokerStars Home Game Hand #219634036088: {Club #3225207}  Hold'em No Limit (50/100) - 2020/10/22 15:52:36 ET
Table 'VU_table_tonight' 9-max (Play Money) Seat #8 is the button
Seat 1: color_singleton (6211 in chips) 
Seat 2: MnnM150 (10833 in chips) 
Seat 3: Duke Croix (9850 in chips) 
Seat 8: appositive (15983 in chips) 
Seat 9: JeBoyDirk (17463 in chips) 
JeBoyDirk: posts small blind 50
color_singleton: posts big blind 100
*** HOLE CARDS ***
Dealt to Duke Croix [Ts 7d]
MnnM150: calls 100
Duke Croix: folds 
appositive: folds 
JeBoyDirk: calls 50
color_singleton: checks 
*** FLOP *** [Qc Td Jc]
JeBoyDirk: checks 
color_singleton: checks 
MnnM150: checks 
*** TURN *** [Qc Td Jc] [2h]
JeBoyDirk: checks 
color_singleton: bets 141
MnnM150: calls 141
JeBoyDirk: calls 141
*** RIVER *** [Qc Td Jc 2h] [6c]
JeBoyDirk: checks 
color_singleton: checks 
MnnM150: bets 683
JeBoyDirk: raises 717 to 1400
color_singleton: folds 
MnnM150: folds 
Uncalled bet (717) returned to JeBoyDirk
JeBoyDirk collected 1974 from pot
*** SUMMARY ***
Total pot 2089 | Rake 115 
Board [Qc Td Jc 2h 6c]
Seat 1: color_singleton (big blind) folded on the River
Seat 2: MnnM150 folded on the River
Seat 3: Duke Croix folded before Flop (didn't bet)
Seat 8: appositive (button) folded before Flop (didn't bet)
Seat 9: JeBoyDirk (small blind) collected (1974)



PokerStars Home Game Hand #219634066084: {Club #3225207}  Hold'em No Limit (50/100) - 2020/10/22 15:53:26 ET
Table 'VU_table_tonight' 9-max (Play Money) Seat #9 is the button
Seat 1: color_singleton (5970 in chips) 
Seat 2: MnnM150 (9909 in chips) 
Seat 3: Duke Croix (9850 in chips) 
Seat 8: appositive (15983 in chips) 
Seat 9: JeBoyDirk (18513 in chips) 
color_singleton: posts small blind 50
MnnM150: posts big blind 100
*** HOLE CARDS ***
Dealt to Duke Croix [8d 5s]
Duke Croix: folds 
appositive: calls 100
JeBoyDirk: folds 
color_singleton: calls 50
MnnM150: checks 
*** FLOP *** [7d 4h 9h]
color_singleton: checks 
MnnM150: bets 141
appositive: calls 141
color_singleton: folds 
*** TURN *** [7d 4h 9h] [8s]
MnnM150: checks 
appositive: bets 550
MnnM150: calls 550
*** RIVER *** [7d 4h 9h 8s] [Jh]
MnnM150: bets 1589
appositive: calls 1589
*** SHOW DOWN ***
MnnM150: shows [Tc Th] (a straight, Seven to Jack)
appositive: mucks hand 
MnnM150 collected 4593 from pot
*** SUMMARY ***
Total pot 4860 | Rake 267 
Board [7d 4h 9h 8s Jh]
Seat 1: color_singleton (small blind) folded on the Flop
Seat 2: MnnM150 (big blind) showed [Tc Th] and won (4593) with a straight, Seven to Jack
Seat 3: Duke Croix folded before Flop (didn't bet)
Seat 8: appositive mucked [8c 7s]
Seat 9: JeBoyDirk (button) folded before Flop (didn't bet)



PokerStars Home Game Hand #219634113316: {Club #3225207}  Hold'em No Limit (50/100) - 2020/10/22 15:54:28 ET
Table 'VU_table_tonight' 9-max (Play Money) Seat #1 is the button
Seat 1: color_singleton (5870 in chips) 
Seat 2: MnnM150 (12122 in chips) 
Seat 3: Duke Croix (9850 in chips) 
Seat 8: appositive (13603 in chips) 
Seat 9: JeBoyDirk (18513 in chips) 
MnnM150: posts small blind 50
Duke Croix: posts big blind 100
*** HOLE CARDS ***
Dealt to Duke Croix [2s 2c]
appositive: folds 
JeBoyDirk: calls 100
color_singleton: calls 100
MnnM150: calls 50
Duke Croix: checks 
*** FLOP *** [Jc As 3c]
MnnM150: checks 
Duke Croix: checks 
JeBoyDirk: checks 
color_singleton: checks 
*** TURN *** [Jc As 3c] [7c]
MnnM150: checks 
Duke Croix: checks 
JeBoyDirk: checks 
color_singleton: bets 200
MnnM150: raises 200 to 400
Duke Croix: folds 
JeBoyDirk: folds 
color_singleton: calls 200
*** RIVER *** [Jc As 3c 7c] [Td]
MnnM150: bets 567
color_singleton: calls 567
*** SHOW DOWN ***
MnnM150: shows [Kc 9c] (a flush, King high)
color_singleton: mucks hand 
MnnM150 collected 2206 from pot
*** SUMMARY ***
Total pot 2334 | Rake 128 
Board [Jc As 3c 7c Td]
Seat 1: color_singleton (button) mucked [Ad 2h]
Seat 2: MnnM150 (small blind) showed [Kc 9c] and won (2206) with a flush, King high
Seat 3: Duke Croix (big blind) folded on the Turn
Seat 8: appositive folded before Flop (didn't bet)
Seat 9: JeBoyDirk folded on the Turn



PokerStars Home Game Hand #219634143159: {Club #3225207}  Hold'em No Limit (50/100) - 2020/10/22 15:55:18 ET
Table 'VU_table_tonight' 9-max (Play Money) Seat #2 is the button
Seat 1: color_singleton (4803 in chips) 
Seat 2: MnnM150 (13261 in chips) 
Seat 3: Duke Croix (9750 in chips) 
Seat 8: appositive (13603 in chips) 
Seat 9: JeBoyDirk (18413 in chips) 
Duke Croix: posts small blind 50
appositive: posts big blind 100
*** HOLE CARDS ***
Dealt to Duke Croix [4c 5c]
JeBoyDirk: calls 100
color_singleton: folds 
MnnM150: calls 100
Duke Croix: calls 50
appositive: checks 
*** FLOP *** [2h Kh 4d]
Duke Croix: checks 
appositive: checks 
JeBoyDirk: checks 
MnnM150: checks 
*** TURN *** [2h Kh 4d] [9s]
Duke Croix: bets 200
appositive: folds 
JeBoyDirk: folds 
MnnM150: folds 
Uncalled bet (200) returned to Duke Croix
Duke Croix collected 378 from pot
*** SUMMARY ***
Total pot 400 | Rake 22 
Board [2h Kh 4d 9s]
Seat 1: color_singleton folded before Flop (didn't bet)
Seat 2: MnnM150 (button) folded on the Turn
Seat 3: Duke Croix (small blind) collected (378)
Seat 8: appositive (big blind) folded on the Turn
Seat 9: JeBoyDirk folded on the Turn



PokerStars Home Game Hand #219634161158: {Club #3225207}  Hold'em No Limit (50/100) - 2020/10/22 15:55:58 ET
Table 'VU_table_tonight' 9-max (Play Money) Seat #3 is the button
Seat 1: color_singleton (4803 in chips) 
Seat 2: MnnM150 (13161 in chips) 
Seat 3: Duke Croix (10028 in chips) 
Seat 8: appositive (13503 in chips) 
Seat 9: JeBoyDirk (18313 in chips) 
appositive: posts small blind 50
JeBoyDirk: posts big blind 100
*** HOLE CARDS ***
Dealt to Duke Croix [7s 2s]
color_singleton: folds 
MnnM150: folds 
Duke Croix: folds 
appositive: folds 
Uncalled bet (50) returned to JeBoyDirk
JeBoyDirk collected 100 from pot
*** SUMMARY ***
Total pot 100 | Rake 0 
Seat 1: color_singleton folded before Flop (didn't bet)
Seat 2: MnnM150 folded before Flop (didn't bet)
Seat 3: Duke Croix (button) folded before Flop (didn't bet)
Seat 8: appositive (small blind) folded before Flop
Seat 9: JeBoyDirk (big blind) collected (100)



PokerStars Home Game Hand #219634168948: {Club #3225207}  Hold'em No Limit (50/100) - 2020/10/22 15:56:15 ET
Table 'VU_table_tonight' 9-max (Play Money) Seat #8 is the button
Seat 1: color_singleton (4803 in chips) 
Seat 2: MnnM150 (13161 in chips) 
Seat 3: Duke Croix (10028 in chips) 
Seat 8: appositive (13453 in chips) 
Seat 9: JeBoyDirk (18363 in chips) 
JeBoyDirk: posts small blind 50
color_singleton: posts big blind 100
*** HOLE CARDS ***
Dealt to Duke Croix [7c 8c]
MnnM150: calls 100
Duke Croix: raises 300 to 400
appositive: folds 
JeBoyDirk: folds 
color_singleton: calls 300
MnnM150: calls 300
*** FLOP *** [9h 2d 8s]
color_singleton: checks 
MnnM150: checks 
Duke Croix: bets 700
color_singleton: folds 
MnnM150: folds 
Uncalled bet (700) returned to Duke Croix
Duke Croix collected 1181 from pot
*** SUMMARY ***
Total pot 1250 | Rake 69 
Board [9h 2d 8s]
Seat 1: color_singleton (big blind) folded on the Flop
Seat 2: MnnM150 folded on the Flop
Seat 3: Duke Croix collected (1181)
Seat 8: appositive (button) folded before Flop (didn't bet)
Seat 9: JeBoyDirk (small blind) folded before Flop



PokerStars Home Game Hand #219634183958: {Club #3225207}  Hold'em No Limit (50/100) - 2020/10/22 15:56:48 ET
Table 'VU_table_tonight' 9-max (Play Money) Seat #9 is the button
Seat 1: color_singleton (4403 in chips) 
Seat 2: MnnM150 (12761 in chips) 
Seat 3: Duke Croix (10809 in chips) 
Seat 8: appositive (13453 in chips) 
Seat 9: JeBoyDirk (18313 in chips) 
color_singleton: posts small blind 50
MnnM150: posts big blind 100
*** HOLE CARDS ***
Dealt to Duke Croix [6s 2d]
Duke Croix: folds 
appositive: calls 100
JeBoyDirk: calls 100
color_singleton: raises 300 to 400
MnnM150: folds 
appositive: folds 
JeBoyDirk: folds 
Uncalled bet (300) returned to color_singleton
color_singleton collected 400 from pot
color_singleton: doesn't show hand 
*** SUMMARY ***
Total pot 400 | Rake 0 
Seat 1: color_singleton (small blind) collected (400)
Seat 2: MnnM150 (big blind) folded before Flop
Seat 3: Duke Croix folded before Flop (didn't bet)
Seat 8: appositive folded before Flop
Seat 9: JeBoyDirk (button) folded before Flop



PokerStars Home Game Hand #219634195727: {Club #3225207}  Hold'em No Limit (50/100) - 2020/10/22 15:57:14 ET
Table 'VU_table_tonight' 9-max (Play Money) Seat #1 is the button
Seat 1: color_singleton (4703 in chips) 
Seat 2: MnnM150 (12661 in chips) 
Seat 3: Duke Croix (10809 in chips) 
Seat 8: appositive (13353 in chips) 
Seat 9: JeBoyDirk (18213 in chips) 
MnnM150: posts small blind 50
Duke Croix: posts big blind 100
*** HOLE CARDS ***
Dealt to Duke Croix [4c 2s]
appositive: calls 100
JeBoyDirk: calls 100
color_singleton: calls 100
MnnM150: calls 50
Duke Croix: checks 
*** FLOP *** [Jc 5d 7h]
MnnM150: checks 
Duke Croix: checks 
appositive: checks 
JeBoyDirk: checks 
color_singleton: bets 472
MnnM150: folds 
Duke Croix: folds 
appositive: folds 
JeBoyDirk: folds 
Uncalled bet (472) returned to color_singleton
color_singleton collected 472 from pot
color_singleton: doesn't show hand 
*** SUMMARY ***
Total pot 500 | Rake 28 
Board [Jc 5d 7h]
Seat 1: color_singleton (button) collected (472)
Seat 2: MnnM150 (small blind) folded on the Flop
Seat 3: Duke Croix (big blind) folded on the Flop
Seat 8: appositive folded on the Flop
Seat 9: JeBoyDirk folded on the Flop



PokerStars Home Game Hand #219634209208: {Club #3225207}  Hold'em No Limit (50/100) - 2020/10/22 15:57:43 ET
Table 'VU_table_tonight' 9-max (Play Money) Seat #2 is the button
Seat 1: color_singleton (5075 in chips) 
Seat 2: MnnM150 (12561 in chips) 
Seat 3: Duke Croix (10709 in chips) 
Seat 8: appositive (13253 in chips) 
Seat 9: JeBoyDirk (18113 in chips) 
Duke Croix: posts small blind 50
appositive: posts big blind 100
*** HOLE CARDS ***
Dealt to Duke Croix [Ts 6d]
JeBoyDirk: folds 
color_singleton: folds 
MnnM150: calls 100
Duke Croix: calls 50
appositive: checks 
*** FLOP *** [5s Ks Ah]
Duke Croix: checks 
appositive: checks 
MnnM150: bets 141
Duke Croix: folds 
appositive: folds 
Uncalled bet (141) returned to MnnM150
MnnM150 collected 283 from pot
*** SUMMARY ***
Total pot 300 | Rake 17 
Board [5s Ks Ah]
Seat 1: color_singleton folded before Flop (didn't bet)
Seat 2: MnnM150 (button) collected (283)
Seat 3: Duke Croix (small blind) folded on the Flop
Seat 8: appositive (big blind) folded on the Flop
Seat 9: JeBoyDirk folded before Flop (didn't bet)



PokerStars Home Game Hand #219634228049: {Club #3225207}  Hold'em No Limit (50/100) - 2020/10/22 15:58:25 ET
Table 'VU_table_tonight' 9-max (Play Money) Seat #3 is the button
Seat 1: color_singleton (5075 in chips) 
Seat 2: MnnM150 (12744 in chips) 
Seat 3: Duke Croix (10609 in chips) 
Seat 8: appositive (13153 in chips) 
Seat 9: JeBoyDirk (18113 in chips) 
appositive: posts small blind 50
JeBoyDirk: posts big blind 100
*** HOLE CARDS ***
Dealt to Duke Croix [8c 5c]
color_singleton: folds 
MnnM150: calls 100
Duke Croix: folds 
appositive: calls 50
JeBoyDirk: checks 
*** FLOP *** [Td Qs Kc]
appositive: checks 
JeBoyDirk: bets 100
MnnM150: raises 100 to 200
appositive: calls 200
JeBoyDirk: calls 100
*** TURN *** [Td Qs Kc] [4s]
appositive: checks 
JeBoyDirk: checks 
MnnM150: bets 850
appositive: folds 
JeBoyDirk: folds 
Uncalled bet (850) returned to MnnM150
MnnM150 collected 850 from pot
*** SUMMARY ***
Total pot 900 | Rake 50 
Board [Td Qs Kc 4s]
Seat 1: color_singleton folded before Flop (didn't bet)
Seat 2: MnnM150 collected (850)
Seat 3: Duke Croix (button) folded before Flop (didn't bet)
Seat 8: appositive (small blind) folded on the Turn
Seat 9: JeBoyDirk (big blind) folded on the Turn



PokerStars Home Game Hand #219634260018: {Club #3225207}  Hold'em No Limit (50/100) - 2020/10/22 15:59:35 ET
Table 'VU_table_tonight' 9-max (Play Money) Seat #8 is the button
Seat 1: color_singleton (5075 in chips) 
Seat 2: MnnM150 (13294 in chips) 
Seat 3: Duke Croix (10609 in chips) 
Seat 8: appositive (12853 in chips) 
Seat 9: JeBoyDirk (17813 in chips) 
JeBoyDirk: posts small blind 50
color_singleton: posts big blind 100
*** HOLE CARDS ***
Dealt to Duke Croix [3d 9d]
MnnM150: calls 100
Duke Croix: folds 
appositive: calls 100
JeBoyDirk: calls 50
color_singleton: checks 
*** FLOP *** [5s Td 6d]
JeBoyDirk: checks 
color_singleton: bets 378
MnnM150: folds 
appositive: calls 378
JeBoyDirk: calls 378
*** TURN *** [5s Td 6d] [Jh]
JeBoyDirk: checks 
color_singleton: bets 725
appositive: calls 725
JeBoyDirk: raises 1375 to 2100
color_singleton: folds 
appositive: folds 
Uncalled bet (1375) returned to JeBoyDirk
JeBoyDirk collected 3505 from pot
*** SUMMARY ***
Total pot 3709 | Rake 204 
Board [5s Td 6d Jh]
Seat 1: color_singleton (big blind) folded on the Turn
Seat 2: MnnM150 folded on the Flop
Seat 3: Duke Croix folded before Flop (didn't bet)
Seat 8: appositive (button) folded on the Turn
Seat 9: JeBoyDirk (small blind) collected (3505)



PokerStars Home Game Hand #219634285714: {Club #3225207}  Hold'em No Limit (50/100) - 2020/10/22 16:00:30 ET
Table 'VU_table_tonight' 9-max (Play Money) Seat #9 is the button
Seat 1: color_singleton (3872 in chips) 
Seat 2: MnnM150 (13194 in chips) 
Seat 3: Duke Croix (10609 in chips) 
Seat 8: appositive (11650 in chips) 
Seat 9: JeBoyDirk (20115 in chips) 
color_singleton: posts small blind 50
MnnM150: posts big blind 100
*** HOLE CARDS ***
Dealt to Duke Croix [4c 7d]
Duke Croix: folds 
appositive: raises 100 to 200
JeBoyDirk: calls 200
color_singleton: calls 150
MnnM150: folds 
*** FLOP *** [4s 7c 5d]
color_singleton: bets 661
appositive: calls 661
JeBoyDirk: folds 
*** TURN *** [4s 7c 5d] [3c]
color_singleton: bets 1911
appositive: calls 1911
*** RIVER *** [4s 7c 5d 3c] [Ks]
color_singleton: bets 1100 and is all-in
appositive: folds 
Uncalled bet (1100) returned to color_singleton
color_singleton collected 5523 from pot
color_singleton: doesn't show hand 
*** SUMMARY ***
Total pot 5844 | Rake 321 
Board [4s 7c 5d 3c Ks]
Seat 1: color_singleton (small blind) collected (5523)
Seat 2: MnnM150 (big blind) folded before Flop
Seat 3: Duke Croix folded before Flop (didn't bet)
Seat 8: appositive folded on the River
Seat 9: JeBoyDirk (button) folded on the Flop



PokerStars Home Game Hand #219634311794: {Club #3225207}  Hold'em No Limit (50/100) - 2020/10/22 16:01:22 ET
Table 'VU_table_tonight' 9-max (Play Money) Seat #1 is the button
Seat 1: color_singleton (6623 in chips) 
Seat 2: MnnM150 (13094 in chips) 
Seat 3: Duke Croix (10609 in chips) 
Seat 8: appositive (8878 in chips) 
Seat 9: JeBoyDirk (19915 in chips) 
MnnM150: posts small blind 50
Duke Croix: posts big blind 100
*** HOLE CARDS ***
Dealt to Duke Croix [7s Kh]
appositive: raises 100 to 200
JeBoyDirk: folds 
color_singleton: folds 
MnnM150: folds 
Duke Croix: calls 100
*** FLOP *** [Jd Jh 2d]
Duke Croix: checks 
appositive: checks 
*** TURN *** [Jd Jh 2d] [8h]
Duke Croix: checks 
appositive: bets 212
Duke Croix: calls 212
*** RIVER *** [Jd Jh 2d 8h] [3h]
Duke Croix: checks 
appositive: bets 826
Duke Croix: folds 
Uncalled bet (826) returned to appositive
appositive collected 826 from pot
appositive: doesn't show hand 
*** SUMMARY ***
Total pot 874 | Rake 48 
Board [Jd Jh 2d 8h 3h]
Seat 1: color_singleton (button) folded before Flop (didn't bet)
Seat 2: MnnM150 (small blind) folded before Flop
Seat 3: Duke Croix (big blind) folded on the River
Seat 8: appositive collected (826)
Seat 9: JeBoyDirk folded before Flop (didn't bet)



PokerStars Home Game Hand #219634339666: {Club #3225207}  Hold'em No Limit (50/100) - 2020/10/22 16:02:10 ET
Table 'VU_table_tonight' 9-max (Play Money) Seat #2 is the button
Seat 1: color_singleton (6623 in chips) 
Seat 2: MnnM150 (13044 in chips) 
Seat 3: Duke Croix (10197 in chips) 
Seat 8: appositive (9292 in chips) 
Seat 9: JeBoyDirk (19915 in chips) 
Duke Croix: posts small blind 50
appositive: posts big blind 100
*** HOLE CARDS ***
Dealt to Duke Croix [9d Jh]
JeBoyDirk: calls 100
color_singleton: folds 
MnnM150: folds 
Duke Croix: calls 50
appositive: checks 
*** FLOP *** [5c 6d Kd]
Duke Croix: checks 
appositive: checks 
JeBoyDirk: checks 
*** TURN *** [5c 6d Kd] [Jd]
Duke Croix: bets 200
appositive: raises 200 to 400
JeBoyDirk: folds 
Duke Croix: calls 200
*** RIVER *** [5c 6d Kd Jd] [3d]
Duke Croix: bets 700
appositive: raises 700 to 1400
Duke Croix: calls 700
*** SHOW DOWN ***
appositive: shows [Ts Kc] (a pair of Kings)
Duke Croix: shows [9d Jh] (a flush, King high)
Duke Croix collected 3685 from pot
*** SUMMARY ***
Total pot 3900 | Rake 215 
Board [5c 6d Kd Jd 3d]
Seat 1: color_singleton folded before Flop (didn't bet)
Seat 2: MnnM150 (button) folded before Flop (didn't bet)
Seat 3: Duke Croix (small blind) showed [9d Jh] and won (3685) with a flush, King high
Seat 8: appositive (big blind) showed [Ts Kc] and lost with a pair of Kings
Seat 9: JeBoyDirk folded on the Turn



PokerStars Home Game Hand #219634358010: {Club #3225207}  Hold'em No Limit (50/100) - 2020/10/22 16:02:42 ET
Table 'VU_table_tonight' 9-max (Play Money) Seat #3 is the button
Seat 1: color_singleton (6623 in chips) 
Seat 2: MnnM150 (13044 in chips) 
Seat 3: Duke Croix (11982 in chips) 
Seat 8: appositive (7392 in chips) 
Seat 9: JeBoyDirk (19815 in chips) 
appositive: posts small blind 50
JeBoyDirk: posts big blind 100
*** HOLE CARDS ***
Dealt to Duke Croix [2s 3h]
color_singleton: raises 100 to 200
MnnM150: calls 200
Duke Croix: folds 
appositive: calls 150
JeBoyDirk: calls 100
*** FLOP *** [Qd 4h 2d]
appositive: checks 
JeBoyDirk: checks 
color_singleton: checks 
MnnM150: checks 
*** TURN *** [Qd 4h 2d] [Qh]
appositive: checks 
JeBoyDirk: checks 
color_singleton: checks 
MnnM150: checks 
*** RIVER *** [Qd 4h 2d Qh] [7d]
appositive: checks 
JeBoyDirk: checks 
color_singleton: checks 
MnnM150: checks 
*** SHOW DOWN ***
appositive: shows [Ah 8c] (a pair of Queens)
JeBoyDirk: mucks hand 
color_singleton: mucks hand 
MnnM150: mucks hand 
appositive collected 756 from pot
*** SUMMARY ***
Total pot 800 | Rake 44 
Board [Qd 4h 2d Qh 7d]
Seat 1: color_singleton mucked [Js 9h]
Seat 2: MnnM150 mucked [9s Jd]
Seat 3: Duke Croix (button) folded before Flop (didn't bet)
Seat 8: appositive (small blind) showed [Ah 8c] and won (756) with a pair of Queens
Seat 9: JeBoyDirk (big blind) mucked [Th 8h]



PokerStars Home Game Hand #219634389358: {Club #3225207}  Hold'em No Limit (50/100) - 2020/10/22 16:03:34 ET
Table 'VU_table_tonight' 9-max (Play Money) Seat #8 is the button
Seat 1: color_singleton (6423 in chips) 
Seat 2: MnnM150 (12844 in chips) 
Seat 3: Duke Croix (11982 in chips) 
Seat 8: appositive (7948 in chips) 
Seat 9: JeBoyDirk (19615 in chips) 
JeBoyDirk: posts small blind 50
color_singleton: posts big blind 100
*** HOLE CARDS ***
Dealt to Duke Croix [9c 4s]
MnnM150: calls 100
Duke Croix: folds 
appositive: calls 100
JeBoyDirk: folds 
color_singleton: checks 
*** FLOP *** [Th 6d Ks]
color_singleton: bets 165
MnnM150: calls 165
appositive: calls 165
*** TURN *** [Th 6d Ks] [Qc]
color_singleton: checks 
MnnM150: checks 
appositive: checks 
*** RIVER *** [Th 6d Ks Qc] [7h]
color_singleton: checks 
MnnM150: bets 799
appositive: folds 
color_singleton: folds 
Uncalled bet (799) returned to MnnM150
MnnM150 collected 799 from pot
*** SUMMARY ***
Total pot 845 | Rake 46 
Board [Th 6d Ks Qc 7h]
Seat 1: color_singleton (big blind) folded on the River
Seat 2: MnnM150 collected (799)
Seat 3: Duke Croix folded before Flop (didn't bet)
Seat 8: appositive (button) folded on the River
Seat 9: JeBoyDirk (small blind) folded before Flop



PokerStars Home Game Hand #219634411398: {Club #3225207}  Hold'em No Limit (50/100) - 2020/10/22 16:04:10 ET
Table 'VU_table_tonight' 9-max (Play Money) Seat #9 is the button
Seat 1: color_singleton (6158 in chips) 
Seat 2: MnnM150 (13378 in chips) 
Seat 3: Duke Croix (11982 in chips) 
Seat 8: appositive (7683 in chips) 
Seat 9: JeBoyDirk (19565 in chips) 
color_singleton: posts small blind 50
MnnM150: posts big blind 100
*** HOLE CARDS ***
Dealt to Duke Croix [9d 9c]
Duke Croix: raises 300 to 400
appositive: calls 400
JeBoyDirk: folds 
color_singleton: folds 
MnnM150: calls 300
*** FLOP *** [Jc 8h Jh]
MnnM150: checks 
Duke Croix: bets 700
appositive: calls 700
MnnM150: folds 
*** TURN *** [Jc 8h Jh] [4s]
Duke Croix: checks 
appositive: bets 900
Duke Croix: calls 900
*** RIVER *** [Jc 8h Jh 4s] [6d]
Duke Croix: checks 
appositive: checks 
*** SHOW DOWN ***
Duke Croix: shows [9d 9c] (two pair, Jacks and Nines)
appositive: mucks hand 
Duke Croix collected 4205 from pot
*** SUMMARY ***
Total pot 4450 | Rake 245 
Board [Jc 8h Jh 4s 6d]
Seat 1: color_singleton (small blind) folded before Flop
Seat 2: MnnM150 (big blind) folded on the Flop
Seat 3: Duke Croix showed [9d 9c] and won (4205) with two pair, Jacks and Nines
Seat 8: appositive mucked [Ac 7c]
Seat 9: JeBoyDirk (button) folded before Flop (didn't bet)



PokerStars Home Game Hand #219634441142: {Club #3225207}  Hold'em No Limit (50/100) - 2020/10/22 16:05:00 ET
Table 'VU_table_tonight' 9-max (Play Money) Seat #1 is the button
Seat 1: color_singleton (6108 in chips) 
Seat 2: MnnM150 (12978 in chips) 
Seat 3: Duke Croix (14187 in chips) 
Seat 8: appositive (5683 in chips) 
Seat 9: JeBoyDirk (19565 in chips) 
MnnM150: posts small blind 50
Duke Croix: posts big blind 100
*** HOLE CARDS ***
Dealt to Duke Croix [4c Qh]
appositive: calls 100
JeBoyDirk: calls 100
color_singleton: calls 100
MnnM150: calls 50
Duke Croix: checks 
*** FLOP *** [5d 3c 5c]
MnnM150: checks 
Duke Croix: checks 
appositive: bets 200
JeBoyDirk: folds 
color_singleton: calls 200
MnnM150: calls 200
Duke Croix: folds 
*** TURN *** [5d 3c 5c] [9s]
MnnM150: checks 
appositive: checks 
color_singleton: bets 519
MnnM150: calls 519
appositive: folds 
*** RIVER *** [5d 3c 5c 9s] [Qd]
MnnM150: checks 
color_singleton: bets 1200
MnnM150: folds 
Uncalled bet (1200) returned to color_singleton
color_singleton collected 2020 from pot
color_singleton: doesn't show hand 
*** SUMMARY ***
Total pot 2138 | Rake 118 
Board [5d 3c 5c 9s Qd]
Seat 1: color_singleton (button) collected (2020)
Seat 2: MnnM150 (small blind) folded on the River
Seat 3: Duke Croix (big blind) folded on the Flop
Seat 8: appositive folded on the Turn
Seat 9: JeBoyDirk folded on the Flop



PokerStars Home Game Hand #219634481140: {Club #3225207}  Hold'em No Limit (50/100) - 2020/10/22 16:06:06 ET
Table 'VU_table_tonight' 9-max (Play Money) Seat #2 is the button
Seat 1: color_singleton (7309 in chips) 
Seat 2: MnnM150 (12159 in chips) 
Seat 3: Duke Croix (14087 in chips) 
Seat 8: appositive (5383 in chips) 
Seat 9: JeBoyDirk (19465 in chips) 
Duke Croix: posts small blind 50
appositive: posts big blind 100
*** HOLE CARDS ***
Dealt to Duke Croix [9c 2s]
JeBoyDirk: folds 
color_singleton: folds 
MnnM150: calls 100
Duke Croix: folds 
appositive: checks 
*** FLOP *** [6d 7s 4h]
appositive: checks 
MnnM150: checks 
*** TURN *** [6d 7s 4h] [Td]
appositive: checks 
MnnM150: checks 
*** RIVER *** [6d 7s 4h Td] [Jc]
appositive: bets 200
MnnM150: folds 
Uncalled bet (200) returned to appositive
appositive collected 236 from pot
appositive: doesn't show hand 
*** SUMMARY ***
Total pot 250 | Rake 14 
Board [6d 7s 4h Td Jc]
Seat 1: color_singleton folded before Flop (didn't bet)
Seat 2: MnnM150 (button) folded on the River
Seat 3: Duke Croix (small blind) folded before Flop
Seat 8: appositive (big blind) collected (236)
Seat 9: JeBoyDirk folded before Flop (didn't bet)



PokerStars Home Game Hand #219634510115: {Club #3225207}  Hold'em No Limit (50/100) - 2020/10/22 16:06:53 ET
Table 'VU_table_tonight' 9-max (Play Money) Seat #3 is the button
Seat 1: color_singleton (7309 in chips) 
Seat 2: MnnM150 (12059 in chips) 
Seat 3: Duke Croix (14037 in chips) 
Seat 8: appositive (5519 in chips) 
Seat 9: JeBoyDirk (19465 in chips) 
appositive: posts small blind 50
JeBoyDirk: posts big blind 100
*** HOLE CARDS ***
Dealt to Duke Croix [Ks Th]
color_singleton: folds 
MnnM150: folds 
Duke Croix: raises 400 to 500
appositive: calls 450
JeBoyDirk: folds 
*** FLOP *** [5c 7c 2h]
appositive: checks 
Duke Croix: checks 
*** TURN *** [5c 7c 2h] [6c]
appositive: checks 
Duke Croix: checks 
*** RIVER *** [5c 7c 2h 6c] [4s]
appositive: bets 300
Duke Croix: folds 
Uncalled bet (300) returned to appositive
appositive collected 1039 from pot
appositive: doesn't show hand 
*** SUMMARY ***
Total pot 1100 | Rake 61 
Board [5c 7c 2h 6c 4s]
Seat 1: color_singleton folded before Flop (didn't bet)
Seat 2: MnnM150 folded before Flop (didn't bet)
Seat 3: Duke Croix (button) folded on the River
Seat 8: appositive (small blind) collected (1039)
Seat 9: JeBoyDirk (big blind) folded before Flop



PokerStars Home Game Hand #219634529731: {Club #3225207}  Hold'em No Limit (50/100) - 2020/10/22 16:07:26 ET
Table 'VU_table_tonight' 9-max (Play Money) Seat #8 is the button
Seat 1: color_singleton (7309 in chips) 
Seat 2: MnnM150 (12059 in chips) 
Seat 3: Duke Croix (13537 in chips) 
Seat 8: appositive (6058 in chips) 
Seat 9: JeBoyDirk (19365 in chips) 
JeBoyDirk: posts small blind 50
color_singleton: posts big blind 100
*** HOLE CARDS ***
Dealt to Duke Croix [5s Tc]
MnnM150: folds 
Duke Croix: folds 
appositive: folds 
JeBoyDirk: folds 
Uncalled bet (50) returned to color_singleton
color_singleton collected 100 from pot
color_singleton: doesn't show hand 
*** SUMMARY ***
Total pot 100 | Rake 0 
Seat 1: color_singleton (big blind) collected (100)
Seat 2: MnnM150 folded before Flop (didn't bet)
Seat 3: Duke Croix folded before Flop (didn't bet)
Seat 8: appositive (button) folded before Flop (didn't bet)
Seat 9: JeBoyDirk (small blind) folded before Flop



PokerStars Home Game Hand #219634541541: {Club #3225207}  Hold'em No Limit (50/100) - 2020/10/22 16:07:46 ET
Table 'VU_table_tonight' 9-max (Play Money) Seat #9 is the button
Seat 1: color_singleton (7359 in chips) 
Seat 2: MnnM150 (12059 in chips) 
Seat 3: Duke Croix (13537 in chips) 
Seat 8: appositive (6058 in chips) 
Seat 9: JeBoyDirk (19315 in chips) 
color_singleton: posts small blind 50
MnnM150: posts big blind 100
*** HOLE CARDS ***
Dealt to Duke Croix [5d Tc]
Duke Croix: folds 
appositive: calls 100
JeBoyDirk: folds 
color_singleton: raises 100 to 200
MnnM150: calls 100
appositive: raises 300 to 500
color_singleton: calls 300
MnnM150: calls 300
*** FLOP *** [7c Qd Kc]
color_singleton: checks 
MnnM150: checks 
appositive: bets 1000
color_singleton: raises 1000 to 2000
MnnM150: folds 
appositive: calls 1000
*** TURN *** [7c Qd Kc] [7d]
color_singleton: bets 4859 and is all-in
appositive: calls 3558 and is all-in
Uncalled bet (1301) returned to color_singleton
*** RIVER *** [7c Qd Kc 7d] [3d]
*** SHOW DOWN ***
color_singleton: shows [Ks 9h] (two pair, Kings and Sevens)
appositive: shows [Ah Ad] (two pair, Aces and Sevens)
appositive collected 11922 from pot
*** SUMMARY ***
Total pot 12616 | Rake 694 
Board [7c Qd Kc 7d 3d]
Seat 1: color_singleton (small blind) showed [Ks 9h] and lost with two pair, Kings and Sevens
Seat 2: MnnM150 (big blind) folded on the Flop
Seat 3: Duke Croix folded before Flop (didn't bet)
Seat 8: appositive showed [Ah Ad] and won (11922) with two pair, Aces and Sevens
Seat 9: JeBoyDirk (button) folded before Flop (didn't bet)



PokerStars Home Game Hand #219634575020: {Club #3225207}  Hold'em No Limit (50/100) - 2020/10/22 16:08:41 ET
Table 'VU_table_tonight' 9-max (Play Money) Seat #1 is the button
Seat 1: color_singleton (1301 in chips) 
Seat 2: MnnM150 (11559 in chips) 
Seat 3: Duke Croix (13537 in chips) 
Seat 8: appositive (11922 in chips) 
Seat 9: JeBoyDirk (19315 in chips) 
MnnM150: posts small blind 50
Duke Croix: posts big blind 100
*** HOLE CARDS ***
Dealt to Duke Croix [5c 2c]
appositive: raises 100 to 200
JeBoyDirk: calls 200
color_singleton: folds 
MnnM150: calls 150
Duke Croix: calls 100
*** FLOP *** [9d 6d 6h]
MnnM150: bets 378
Duke Croix: folds 
appositive: calls 378
JeBoyDirk: calls 378
*** TURN *** [9d 6d 6h] [5d]
MnnM150: checks 
HighCardJasper joins the table at seat #7 
appositive: checks 
JeBoyDirk: bets 900
MnnM150: calls 900
appositive: calls 900
*** RIVER *** [9d 6d 6h 5d] [Ks]
MnnM150: checks 
appositive: checks 
JeBoyDirk: bets 2200
MnnM150: folds 
appositive: folds 
Uncalled bet (2200) returned to JeBoyDirk
JeBoyDirk collected 4379 from pot
*** SUMMARY ***
Total pot 4634 | Rake 255 
Board [9d 6d 6h 5d Ks]
Seat 1: color_singleton (button) folded before Flop (didn't bet)
Seat 2: MnnM150 (small blind) folded on the River
Seat 3: Duke Croix (big blind) folded on the Flop
Seat 8: appositive folded on the River
Seat 9: JeBoyDirk collected (4379)



PokerStars Home Game Hand #219634627234: {Club #3225207}  Hold'em No Limit (50/100) - 2020/10/22 16:10:07 ET
Table 'VU_table_tonight' 9-max (Play Money) Seat #2 is the button
Seat 1: color_singleton (1301 in chips) 
Seat 2: MnnM150 (10081 in chips) 
Seat 3: Duke Croix (13337 in chips) 
Seat 7: HighCardJasper (10000 in chips) 
Seat 8: appositive (10444 in chips) 
Seat 9: JeBoyDirk (22216 in chips) 
Duke Croix: posts small blind 50
HighCardJasper: posts big blind 100
*** HOLE CARDS ***
Dealt to Duke Croix [Jd 5c]
appositive: calls 100
JeBoyDirk: folds 
color_singleton: folds 
MnnM150: calls 100
Duke Croix: calls 50
HighCardJasper: checks 
*** FLOP *** [8d 4c Kc]
Duke Croix: checks 
HighCardJasper: checks 
appositive: checks 
MnnM150: checks 
*** TURN *** [8d 4c Kc] [9s]
Duke Croix: checks 
HighCardJasper: checks 
appositive: checks 
MnnM150: checks 
*** RIVER *** [8d 4c Kc 9s] [5s]
Duke Croix: bets 200
HighCardJasper: folds 
appositive: folds 
MnnM150: folds 
Uncalled bet (200) returned to Duke Croix
Duke Croix collected 378 from pot
*** SUMMARY ***
Total pot 400 | Rake 22 
Board [8d 4c Kc 9s 5s]
Seat 1: color_singleton folded before Flop (didn't bet)
Seat 2: MnnM150 (button) folded on the River
Seat 3: Duke Croix (small blind) collected (378)
Seat 7: HighCardJasper (big blind) folded on the River
Seat 8: appositive folded on the River
Seat 9: JeBoyDirk folded before Flop (didn't bet)



PokerStars Home Game Hand #219634669060: {Club #3225207}  Hold'em No Limit (50/100) - 2020/10/22 16:11:17 ET
Table 'VU_table_tonight' 9-max (Play Money) Seat #3 is the button
Seat 1: color_singleton (1301 in chips) 
Seat 2: MnnM150 (9981 in chips) 
Seat 3: Duke Croix (13615 in chips) 
Seat 7: HighCardJasper (9900 in chips) 
Seat 8: appositive (10344 in chips) 
Seat 9: JeBoyDirk (22216 in chips) 
HighCardJasper: posts small blind 50
appositive: posts big blind 100
*** HOLE CARDS ***
Dealt to Duke Croix [Kd Qd]
JeBoyDirk: raises 100 to 200
color_singleton: folds 
MnnM150: calls 200
Duke Croix: raises 400 to 600
HighCardJasper: folds 
appositive: calls 500
JeBoyDirk: calls 400
MnnM150: calls 400
*** FLOP *** [9c Jc 8c]
appositive: bets 300
JeBoyDirk: folds 
MnnM150: calls 300
Duke Croix: calls 300
*** TURN *** [9c Jc 8c] [9s]
appositive: bets 800
MnnM150: calls 800
Duke Croix: folds 
*** RIVER *** [9c Jc 8c 9s] [6h]
appositive: bets 2800
MnnM150: folds 
Uncalled bet (2800) returned to appositive
appositive collected 4678 from pot
appositive: doesn't show hand 
*** SUMMARY ***
Total pot 4950 | Rake 272 
Board [9c Jc 8c 9s 6h]
Seat 1: color_singleton folded before Flop (didn't bet)
Seat 2: MnnM150 folded on the River
Seat 3: Duke Croix (button) folded on the Turn
Seat 7: HighCardJasper (small blind) folded before Flop
Seat 8: appositive (big blind) collected (4678)
Seat 9: JeBoyDirk folded on the Flop



PokerStars Home Game Hand #219634709969: {Club #3225207}  Hold'em No Limit (50/100) - 2020/10/22 16:12:25 ET
Table 'VU_table_tonight' 9-max (Play Money) Seat #7 is the button
Seat 1: color_singleton (1301 in chips) 
Seat 3: Duke Croix (12715 in chips) 
Seat 7: HighCardJasper (9850 in chips) 
Seat 8: appositive (13322 in chips) 
Seat 9: JeBoyDirk (21616 in chips) 
appositive: posts small blind 50
JeBoyDirk: posts big blind 100
*** HOLE CARDS ***
Dealt to Duke Croix [Qd As]
color_singleton: folds 
Duke Croix: raises 300 to 400
HighCardJasper: folds 
appositive: calls 350
JeBoyDirk: folds 
*** FLOP *** [9c 6c 7s]
appositive: checks 
Duke Croix: checks 
*** TURN *** [9c 6c 7s] [Js]
appositive: checks 
Duke Croix: bets 600
appositive: calls 600
*** RIVER *** [9c 6c 7s Js] [7c]
appositive: checks 
Duke Croix: bets 1600
appositive: folds 
Uncalled bet (1600) returned to Duke Croix
Duke Croix collected 1984 from pot
*** SUMMARY ***
Total pot 2100 | Rake 116 
Board [9c 6c 7s Js 7c]
Seat 1: color_singleton folded before Flop (didn't bet)
Seat 3: Duke Croix collected (1984)
Seat 7: HighCardJasper (button) folded before Flop (didn't bet)
Seat 8: appositive (small blind) folded on the River
Seat 9: JeBoyDirk (big blind) folded before Flop



PokerStars Home Game Hand #219634744217: {Club #3225207}  Hold'em No Limit (50/100) - 2020/10/22 16:13:23 ET
Table 'VU_table_tonight' 9-max (Play Money) Seat #8 is the button
Seat 1: color_singleton (1301 in chips) 
Seat 3: Duke Croix (13699 in chips) 
Seat 7: HighCardJasper (9850 in chips) 
Seat 8: appositive (12322 in chips) 
Seat 9: JeBoyDirk (21516 in chips) 
JeBoyDirk: posts small blind 50
color_singleton: posts big blind 100
*** HOLE CARDS ***
Dealt to Duke Croix [Ad Kc]
Duke Croix: raises 300 to 400
HighCardJasper: folds 
appositive: calls 400
JeBoyDirk: folds 
color_singleton: folds 
*** FLOP *** [6s 5c 9c]
Duke Croix: checks 
appositive: checks 
*** TURN *** [6s 5c 9c] [Kh]
Duke Croix: bets 500
appositive: calls 500
*** RIVER *** [6s 5c 9c Kh] [Kd]
Duke Croix: bets 1400
appositive: folds 
Uncalled bet (1400) returned to Duke Croix
Duke Croix collected 1843 from pot
*** SUMMARY ***
Total pot 1950 | Rake 107 
Board [6s 5c 9c Kh Kd]
Seat 1: color_singleton (big blind) folded before Flop
Seat 3: Duke Croix collected (1843)
Seat 7: HighCardJasper folded before Flop (didn't bet)
Seat 8: appositive (button) folded on the River
Seat 9: JeBoyDirk (small blind) folded before Flop



PokerStars Home Game Hand #219634765916: {Club #3225207}  Hold'em No Limit (50/100) - 2020/10/22 16:13:59 ET
Table 'VU_table_tonight' 9-max (Play Money) Seat #9 is the button
Seat 1: color_singleton (1201 in chips) 
Seat 3: Duke Croix (14642 in chips) 
Seat 7: HighCardJasper (9850 in chips) 
Seat 8: appositive (11422 in chips) 
Seat 9: JeBoyDirk (21466 in chips) 
color_singleton: posts small blind 50
Duke Croix: posts big blind 100
*** HOLE CARDS ***
Dealt to Duke Croix [Qs 7d]
HighCardJasper: calls 100
appositive: folds 
JeBoyDirk: folds 
color_singleton: folds 
Duke Croix: checks 
*** FLOP *** [7s Js 6d]
Duke Croix: bets 200
HighCardJasper: folds 
Uncalled bet (200) returned to Duke Croix
Duke Croix collected 236 from pot
*** SUMMARY ***
Total pot 250 | Rake 14 
Board [7s Js 6d]
Seat 1: color_singleton (small blind) folded before Flop
Seat 3: Duke Croix (big blind) collected (236)
Seat 7: HighCardJasper folded on the Flop
Seat 8: appositive folded before Flop (didn't bet)
Seat 9: JeBoyDirk (button) folded before Flop (didn't bet)



PokerStars Home Game Hand #219634779979: {Club #3225207}  Hold'em No Limit (50/100) - 2020/10/22 16:14:23 ET
Table 'VU_table_tonight' 9-max (Play Money) Seat #1 is the button
Seat 1: color_singleton (1151 in chips) 
Seat 3: Duke Croix (14778 in chips) 
Seat 7: HighCardJasper (9750 in chips) 
Seat 8: appositive (11422 in chips) 
Seat 9: JeBoyDirk (21466 in chips) 
Duke Croix: posts small blind 50
HighCardJasper: posts big blind 100
*** HOLE CARDS ***
Dealt to Duke Croix [7d 3h]
appositive: folds 
JeBoyDirk: folds 
color_singleton: calls 100
Duke Croix: folds 
HighCardJasper: checks 
*** FLOP *** [As Ah 3c]
HighCardJasper: checks 
color_singleton: bets 236
HighCardJasper: folds 
Uncalled bet (236) returned to color_singleton
color_singleton collected 236 from pot
color_singleton: doesn't show hand 
*** SUMMARY ***
Total pot 250 | Rake 14 
Board [As Ah 3c]
Seat 1: color_singleton (button) collected (236)
Seat 3: Duke Croix (small blind) folded before Flop
Seat 7: HighCardJasper (big blind) folded on the Flop
Seat 8: appositive folded before Flop (didn't bet)
Seat 9: JeBoyDirk folded before Flop (didn't bet)



PokerStars Home Game Hand #219634797749: {Club #3225207}  Hold'em No Limit (50/100) - 2020/10/22 16:14:53 ET
Table 'VU_table_tonight' 9-max (Play Money) Seat #3 is the button
Seat 1: color_singleton (1287 in chips) 
Seat 3: Duke Croix (14728 in chips) 
Seat 7: HighCardJasper (9650 in chips) 
Seat 8: appositive (11422 in chips) 
Seat 9: JeBoyDirk (21466 in chips) 
HighCardJasper: posts small blind 50
appositive: posts big blind 100
*** HOLE CARDS ***
Dealt to Duke Croix [7d Tc]
JeBoyDirk: folds 
color_singleton: folds 
Duke Croix: raises 200 to 300
HighCardJasper: calls 250
appositive: folds 
*** FLOP *** [6h Ts Qs]
HighCardJasper: checks 
Duke Croix: bets 400
HighCardJasper: calls 400
*** TURN *** [6h Ts Qs] [8h]
HighCardJasper: checks 
Duke Croix: bets 1000
HighCardJasper: calls 1000
*** RIVER *** [6h Ts Qs 8h] [4h]
HighCardJasper: checks 
Duke Croix: bets 2000
HighCardJasper: calls 2000
*** SHOW DOWN ***
Duke Croix: shows [7d Tc] (a pair of Tens)
HighCardJasper: shows [Kd Qc] (a pair of Queens)
HighCardJasper collected 7087 from pot
*** SUMMARY ***
Total pot 7500 | Rake 413 
Board [6h Ts Qs 8h 4h]
Seat 1: color_singleton folded before Flop (didn't bet)
Seat 3: Duke Croix (button) showed [7d Tc] and lost with a pair of Tens
Seat 7: HighCardJasper (small blind) showed [Kd Qc] and won (7087) with a pair of Queens
Seat 8: appositive (big blind) folded before Flop
Seat 9: JeBoyDirk folded before Flop (didn't bet)



PokerStars Home Game Hand #219634843296: {Club #3225207}  Hold'em No Limit (50/100) - 2020/10/22 16:16:07 ET
Table 'VU_table_tonight' 9-max (Play Money) Seat #7 is the button
Seat 1: color_singleton (1287 in chips) 
Seat 2: MnnM150 (8281 in chips) 
Seat 3: Duke Croix (11028 in chips) 
Seat 7: HighCardJasper (13037 in chips) 
Seat 8: appositive (11322 in chips) 
Seat 9: JeBoyDirk (21466 in chips) 
appositive: posts small blind 50
JeBoyDirk: posts big blind 100
MnnM150: posts small & big blinds 150
*** HOLE CARDS ***
Dealt to Duke Croix [6s Ts]
color_singleton: raises 200 to 300
MnnM150: calls 200
Duke Croix: folds 
HighCardJasper: folds 
appositive: folds 
JeBoyDirk: calls 200
*** FLOP *** [5h Ks Ad]
JeBoyDirk: checks 
color_singleton: bets 987 and is all-in
MnnM150: folds 
JeBoyDirk: calls 987
*** TURN *** [5h Ks Ad] [Qs]
*** RIVER *** [5h Ks Ad Qs] [Ah]
*** SHOW DOWN ***
JeBoyDirk: shows [Tc Kc] (two pair, Aces and Kings)
color_singleton: shows [As Jh] (three of a kind, Aces)
color_singleton collected 2810 from pot
*** SUMMARY ***
Total pot 2974 | Rake 164 
Board [5h Ks Ad Qs Ah]
Seat 1: color_singleton showed [As Jh] and won (2810) with three of a kind, Aces
Seat 2: MnnM150 folded on the Flop
Seat 3: Duke Croix folded before Flop (didn't bet)
Seat 7: HighCardJasper (button) folded before Flop (didn't bet)
Seat 8: appositive (small blind) folded before Flop
Seat 9: JeBoyDirk (big blind) showed [Tc Kc] and lost with two pair, Aces and Kings



PokerStars Home Game Hand #219634866867: {Club #3225207}  Hold'em No Limit (50/100) - 2020/10/22 16:16:46 ET
Table 'VU_table_tonight' 9-max (Play Money) Seat #8 is the button
Seat 1: color_singleton (2810 in chips) 
Seat 2: MnnM150 (7931 in chips) 
Seat 3: Duke Croix (11028 in chips) 
Seat 7: HighCardJasper (13037 in chips) 
Seat 8: appositive (11272 in chips) 
Seat 9: JeBoyDirk (20179 in chips) 
JeBoyDirk: posts small blind 50
color_singleton: posts big blind 100
*** HOLE CARDS ***
Dealt to Duke Croix [4h As]
MnnM150: calls 100
Duke Croix has timed out
Duke Croix: folds 
HighCardJasper: raises 100 to 200
appositive: folds 
JeBoyDirk: folds 
color_singleton: calls 100
MnnM150: calls 100
*** FLOP *** [3d 8d 7d]
color_singleton: checks 
MnnM150: checks 
HighCardJasper: bets 100
color_singleton: folds 
MnnM150: calls 100
*** TURN *** [3d 8d 7d] [2h]
MnnM150: checks 
HighCardJasper: checks 
*** RIVER *** [3d 8d 7d 2h] [5d]
MnnM150: bets 803
HighCardJasper: raises 803 to 1606
MnnM150 has timed out
MnnM150: folds 
Uncalled bet (803) returned to HighCardJasper
HighCardJasper collected 2321 from pot
HighCardJasper: doesn't show hand 
*** SUMMARY ***
Total pot 2456 | Rake 135 
Board [3d 8d 7d 2h 5d]
Seat 1: color_singleton (big blind) folded on the Flop
Seat 2: MnnM150 folded on the River
Seat 3: Duke Croix folded before Flop (didn't bet)
Seat 7: HighCardJasper collected (2321)
Seat 8: appositive (button) folded before Flop (didn't bet)
Seat 9: JeBoyDirk (small blind) folded before Flop



PokerStars Home Game Hand #219634914585: {Club #3225207}  Hold'em No Limit (50/100) - 2020/10/22 16:18:03 ET
Table 'VU_table_tonight' 9-max (Play Money) Seat #9 is the button
Seat 1: color_singleton (2610 in chips) 
Seat 3: Duke Croix (11028 in chips) 
Seat 7: HighCardJasper (14255 in chips) 
Seat 8: appositive (11272 in chips) 
Seat 9: JeBoyDirk (20129 in chips) 
color_singleton: posts small blind 50
Duke Croix: posts big blind 100
*** HOLE CARDS ***
Dealt to Duke Croix [9s 5c]
HighCardJasper: calls 100
appositive: folds 
JeBoyDirk: folds 
color_singleton: calls 50
Duke Croix: checks 
*** FLOP *** [5d Kd As]
color_singleton: checks 
Duke Croix: checks 
HighCardJasper: checks 
*** TURN *** [5d Kd As] [6d]
color_singleton: checks 
Duke Croix: checks 
HighCardJasper: bets 100
color_singleton: calls 100
Duke Croix: calls 100
*** RIVER *** [5d Kd As 6d] [Td]
color_singleton: checks 
Duke Croix: bets 600
HighCardJasper: folds 
color_singleton: folds 
Uncalled bet (600) returned to Duke Croix
Duke Croix collected 567 from pot
*** SUMMARY ***
Total pot 600 | Rake 33 
Board [5d Kd As 6d Td]
Seat 1: color_singleton (small blind) folded on the River
Seat 3: Duke Croix (big blind) collected (567)
Seat 7: HighCardJasper folded on the River
Seat 8: appositive folded before Flop (didn't bet)
Seat 9: JeBoyDirk (button) folded before Flop (didn't bet)



PokerStars Home Game Hand #219634949827: {Club #3225207}  Hold'em No Limit (50/100) - 2020/10/22 16:19:00 ET
Table 'VU_table_tonight' 9-max (Play Money) Seat #1 is the button
Seat 1: color_singleton (2410 in chips) 
Seat 3: Duke Croix (11395 in chips) 
Seat 7: HighCardJasper (14055 in chips) 
Seat 8: appositive (11272 in chips) 
Seat 9: JeBoyDirk (20129 in chips) 
Duke Croix: posts small blind 50
HighCardJasper: posts big blind 100
*** HOLE CARDS ***
Dealt to Duke Croix [2s 5c]
appositive: folds 
JeBoyDirk: folds 
color_singleton: raises 200 to 300
Duke Croix: folds 
HighCardJasper: folds 
Uncalled bet (200) returned to color_singleton
color_singleton collected 250 from pot
color_singleton: doesn't show hand 
*** SUMMARY ***
Total pot 250 | Rake 0 
Seat 1: color_singleton (button) collected (250)
Seat 3: Duke Croix (small blind) folded before Flop
Seat 7: HighCardJasper (big blind) folded before Flop
Seat 8: appositive folded before Flop (didn't bet)
Seat 9: JeBoyDirk folded before Flop (didn't bet)



PokerStars Home Game Hand #219634959797: {Club #3225207}  Hold'em No Limit (50/100) - 2020/10/22 16:19:17 ET
Table 'VU_table_tonight' 9-max (Play Money) Seat #3 is the button
Seat 1: color_singleton (2560 in chips) 
Seat 2: MnnM150 (6828 in chips) 
Seat 3: Duke Croix (11345 in chips) 
Seat 7: HighCardJasper (13955 in chips) 
Seat 8: appositive (11272 in chips) 
Seat 9: JeBoyDirk (20129 in chips) 
HighCardJasper: posts small blind 50
appositive: posts big blind 100
MnnM150: posts small & big blinds 150
*** HOLE CARDS ***
Dealt to Duke Croix [Js 3s]
JeBoyDirk: folds 
color_singleton: raises 200 to 300
MnnM150: folds 
Duke Croix: folds 
HighCardJasper: calls 250
appositive: calls 200
*** FLOP *** [8h 3c Td]
HighCardJasper: checks 
appositive: checks 
color_singleton: checks 
*** TURN *** [8h 3c Td] [Ah]
HighCardJasper: checks 
appositive: bets 600
color_singleton: raises 600 to 1200
HighCardJasper: folds 
appositive: calls 600
*** RIVER *** [8h 3c Td Ah] [Th]
appositive: bets 2200
color_singleton: calls 1060 and is all-in
Uncalled bet (1140) returned to appositive
*** SHOW DOWN ***
appositive: shows [Jd Tc] (three of a kind, Tens)
color_singleton: shows [8s Ts] (a full house, Tens full of Eights)
color_singleton collected 5264 from pot
*** SUMMARY ***
Total pot 5570 | Rake 306 
Board [8h 3c Td Ah Th]
Seat 1: color_singleton showed [8s Ts] and won (5264) with a full house, Tens full of Eights
Seat 2: MnnM150 folded before Flop (didn't bet)
Seat 3: Duke Croix (button) folded before Flop (didn't bet)
Seat 7: HighCardJasper (small blind) folded on the Turn
Seat 8: appositive (big blind) showed [Jd Tc] and lost with three of a kind, Tens
Seat 9: JeBoyDirk folded before Flop (didn't bet)



PokerStars Home Game Hand #219635008385: {Club #3225207}  Hold'em No Limit (50/100) - 2020/10/22 16:20:36 ET
Table 'VU_table_tonight' 9-max (Play Money) Seat #7 is the button
Seat 1: color_singleton (5264 in chips) 
Seat 2: MnnM150 (6678 in chips) 
Seat 3: Duke Croix (11345 in chips) 
Seat 7: HighCardJasper (13655 in chips) 
Seat 8: appositive (8712 in chips) 
Seat 9: JeBoyDirk (20129 in chips) 
appositive: posts small blind 50
JeBoyDirk: posts big blind 100
*** HOLE CARDS ***
Dealt to Duke Croix [Qd 6c]
color_singleton: raises 200 to 300
MnnM150: calls 300
Duke Croix: folds 
HighCardJasper: calls 300
appositive: folds 
JeBoyDirk: calls 200
*** FLOP *** [3d 5h 8h]
JeBoyDirk: checks 
color_singleton: checks 
MnnM150: bets 590
HighCardJasper: folds 
JeBoyDirk: folds 
color_singleton: calls 590
*** TURN *** [3d 5h 8h] [Jh]
color_singleton: checks 
MnnM150: bets 2296
color_singleton: raises 2078 to 4374 and is all-in
MnnM150 has timed out
MnnM150: folds 
Uncalled bet (2078) returned to color_singleton
color_singleton collected 6636 from pot
color_singleton: doesn't show hand 
*** SUMMARY ***
Total pot 7022 | Rake 386 
Board [3d 5h 8h Jh]
Seat 1: color_singleton collected (6636)
Seat 2: MnnM150 folded on the Turn
Seat 3: Duke Croix folded before Flop (didn't bet)
Seat 7: HighCardJasper (button) folded on the Flop
Seat 8: appositive (small blind) folded before Flop
Seat 9: JeBoyDirk (big blind) folded on the Flop



PokerStars Home Game Hand #219635046262: {Club #3225207}  Hold'em No Limit (50/100) - 2020/10/22 16:21:38 ET
Table 'VU_table_tonight' 9-max (Play Money) Seat #8 is the button
Seat 1: color_singleton (8714 in chips) 
Seat 2: MnnM150 (3492 in chips) 
Seat 3: Duke Croix (11345 in chips) 
Seat 7: HighCardJasper (13355 in chips) 
Seat 8: appositive (8662 in chips) 
Seat 9: JeBoyDirk (19829 in chips) 
JeBoyDirk: posts small blind 50
color_singleton: posts big blind 100
*** HOLE CARDS ***
Dealt to Duke Croix [4s Ts]
MnnM150: calls 100
Duke Croix: calls 100
HighCardJasper: calls 100
appositive: calls 100
JeBoyDirk: calls 50
color_singleton: raises 300 to 400
MnnM150: calls 300
Duke Croix: folds 
HighCardJasper: calls 300
appositive: calls 300
JeBoyDirk: folds 
*** FLOP *** [Jd 9s 2c]
color_singleton: checks 
MnnM150: checks 
HighCardJasper: checks 
appositive: checks 
*** TURN *** [Jd 9s 2c] [5h]
color_singleton: checks 
MnnM150: checks 
HighCardJasper: checks 
appositive: checks 
*** RIVER *** [Jd 9s 2c 5h] [6d]
color_singleton: checks 
MnnM150: checks 
HighCardJasper: checks 
appositive: checks 
*** SHOW DOWN ***
color_singleton: shows [Kh Ah] (high card Ace)
MnnM150: shows [Js Qd] (a pair of Jacks)
HighCardJasper: mucks hand 
appositive: mucks hand 
MnnM150 collected 1701 from pot
*** SUMMARY ***
Total pot 1800 | Rake 99 
Board [Jd 9s 2c 5h 6d]
Seat 1: color_singleton (big blind) showed [Kh Ah] and lost with high card Ace
Seat 2: MnnM150 showed [Js Qd] and won (1701) with a pair of Jacks
Seat 3: Duke Croix folded before Flop
Seat 7: HighCardJasper mucked [Qh 2h]
Seat 8: appositive (button) mucked [8s Ks]
Seat 9: JeBoyDirk (small blind) folded before Flop



PokerStars Home Game Hand #219635080107: {Club #3225207}  Hold'em No Limit (50/100) - 2020/10/22 16:22:33 ET
Table 'VU_table_tonight' 9-max (Play Money) Seat #9 is the button
Seat 1: color_singleton (8314 in chips) 
Seat 2: MnnM150 (4793 in chips) 
Seat 3: Duke Croix (11245 in chips) 
Seat 7: HighCardJasper (12955 in chips) 
Seat 8: appositive (8262 in chips) 
Seat 9: JeBoyDirk (19729 in chips) 
color_singleton: posts small blind 50
MnnM150: posts big blind 100
*** HOLE CARDS ***
Dealt to Duke Croix [4d 9c]
Duke Croix: folds 
HighCardJasper: raises 200 to 300
appositive: folds 
JeBoyDirk: folds 
color_singleton: folds 
MnnM150: folds 
Uncalled bet (200) returned to HighCardJasper
HighCardJasper collected 250 from pot
HighCardJasper: doesn't show hand 
*** SUMMARY ***
Total pot 250 | Rake 0 
Seat 1: color_singleton (small blind) folded before Flop
Seat 2: MnnM150 (big blind) folded before Flop
Seat 3: Duke Croix folded before Flop (didn't bet)
Seat 7: HighCardJasper collected (250)
Seat 8: appositive folded before Flop (didn't bet)
Seat 9: JeBoyDirk (button) folded before Flop (didn't bet)



PokerStars Home Game Hand #219635089057: {Club #3225207}  Hold'em No Limit (50/100) - 2020/10/22 16:22:48 ET
Table 'VU_table_tonight' 9-max (Play Money) Seat #1 is the button
Seat 1: color_singleton (8264 in chips) 
Seat 2: MnnM150 (4693 in chips) 
Seat 3: Duke Croix (11245 in chips) 
Seat 7: HighCardJasper (13105 in chips) 
Seat 8: appositive (8262 in chips) 
Seat 9: JeBoyDirk (19729 in chips) 
MnnM150: posts small blind 50
Duke Croix: posts big blind 100
*** HOLE CARDS ***
Dealt to Duke Croix [9s 2s]
HighCardJasper: calls 100
appositive: calls 100
JeBoyDirk: folds 
color_singleton: calls 100
MnnM150: folds 
Duke Croix: checks 
*** FLOP *** [Ad Th 4h]
Duke Croix: checks 
HighCardJasper: checks 
appositive: bets 200
color_singleton: folds 
Duke Croix: folds 
HighCardJasper: folds 
Uncalled bet (200) returned to appositive
appositive collected 425 from pot
appositive: doesn't show hand 
*** SUMMARY ***
Total pot 450 | Rake 25 
Board [Ad Th 4h]
Seat 1: color_singleton (button) folded on the Flop
Seat 2: MnnM150 (small blind) folded before Flop
Seat 3: Duke Croix (big blind) folded on the Flop
Seat 7: HighCardJasper folded on the Flop
Seat 8: appositive collected (425)
Seat 9: JeBoyDirk folded before Flop (didn't bet)



PokerStars Home Game Hand #219635109905: {Club #3225207}  Hold'em No Limit (50/100) - 2020/10/22 16:23:23 ET
Table 'VU_table_tonight' 9-max (Play Money) Seat #2 is the button
Seat 1: color_singleton (8164 in chips) 
Seat 2: MnnM150 (4643 in chips) 
Seat 3: Duke Croix (11145 in chips) 
Seat 7: HighCardJasper (13005 in chips) 
Seat 8: appositive (8587 in chips) 
Seat 9: JeBoyDirk (19729 in chips) 
Duke Croix: posts small blind 50
HighCardJasper: posts big blind 100
*** HOLE CARDS ***
Dealt to Duke Croix [5s 6c]
appositive: calls 100
JeBoyDirk: folds 
color_singleton: calls 100
MnnM150: folds 
Duke Croix: calls 50
HighCardJasper: raises 200 to 300
appositive: calls 200
color_singleton: calls 200
Duke Croix: calls 200
*** FLOP *** [Kc 2d Td]
Duke Croix: checks 
HighCardJasper: checks 
appositive: checks 
color_singleton: bets 1134
Duke Croix: folds 
HighCardJasper: calls 1134
appositive: folds 
*** TURN *** [Kc 2d Td] [2h]
HighCardJasper: checks 
color_singleton: bets 1638
HighCardJasper: folds 
Uncalled bet (1638) returned to color_singleton
color_singleton collected 3277 from pot
color_singleton: doesn't show hand 
*** SUMMARY ***
Total pot 3468 | Rake 191 
Board [Kc 2d Td 2h]
Seat 1: color_singleton collected (3277)
Seat 2: MnnM150 (button) folded before Flop (didn't bet)
Seat 3: Duke Croix (small blind) folded on the Flop
Seat 7: HighCardJasper (big blind) folded on the Turn
Seat 8: appositive folded on the Flop
Seat 9: JeBoyDirk folded before Flop (didn't bet)



PokerStars Home Game Hand #219635143120: {Club #3225207}  Hold'em No Limit (50/100) - 2020/10/22 16:24:18 ET
Table 'VU_table_tonight' 9-max (Play Money) Seat #3 is the button
Seat 1: color_singleton (10007 in chips) 
Seat 2: MnnM150 (4643 in chips) 
Seat 3: Duke Croix (10845 in chips) 
Seat 7: HighCardJasper (11571 in chips) 
Seat 8: appositive (8287 in chips) 
Seat 9: JeBoyDirk (19729 in chips) 
HighCardJasper: posts small blind 50
appositive: posts big blind 100
*** HOLE CARDS ***
Dealt to Duke Croix [5s Jd]
JeBoyDirk: folds 
color_singleton: raises 200 to 300
MnnM150: folds 
Duke Croix: folds 
HighCardJasper: calls 250
appositive: calls 200
*** FLOP *** [9s As 5c]
HighCardJasper: bets 300
appositive: calls 300
color_singleton: calls 300
*** TURN *** [9s As 5c] [Th]
HighCardJasper: bets 300
appositive: folds 
color_singleton: calls 300
*** RIVER *** [9s As 5c Th] [7h]
HighCardJasper: bets 1000
color_singleton: calls 1000
*** SHOW DOWN ***
HighCardJasper: shows [Ad Tc] (two pair, Aces and Tens)
color_singleton: mucks hand 
HighCardJasper collected 4158 from pot
*** SUMMARY ***
Total pot 4400 | Rake 242 
Board [9s As 5c Th 7h]
Seat 1: color_singleton mucked [Kh Kc]
Seat 2: MnnM150 folded before Flop (didn't bet)
Seat 3: Duke Croix (button) folded before Flop (didn't bet)
Seat 7: HighCardJasper (small blind) showed [Ad Tc] and won (4158) with two pair, Aces and Tens
Seat 8: appositive (big blind) folded on the Turn
Seat 9: JeBoyDirk folded before Flop (didn't bet)



PokerStars Home Game Hand #219635183296: {Club #3225207}  Hold'em No Limit (50/100) - 2020/10/22 16:25:24 ET
Table 'VU_table_tonight' 9-max (Play Money) Seat #7 is the button
Seat 1: color_singleton (8107 in chips) 
Seat 2: MnnM150 (4643 in chips) 
Seat 3: Duke Croix (10845 in chips) 
Seat 7: HighCardJasper (13829 in chips) 
Seat 8: appositive (7687 in chips) 
Seat 9: JeBoyDirk (19729 in chips) 
appositive: posts small blind 50
JeBoyDirk: posts big blind 100
*** HOLE CARDS ***
Dealt to Duke Croix [Ah 4c]
color_singleton: folds 
MnnM150: calls 100
Duke Croix: calls 100
HighCardJasper: calls 100
appositive: folds 
JeBoyDirk: checks 
*** FLOP *** [5h Ks Qd]
JeBoyDirk: checks 
MnnM150: bets 212
Duke Croix: folds 
HighCardJasper: folds 
JeBoyDirk: folds 
Uncalled bet (212) returned to MnnM150
MnnM150 collected 425 from pot
*** SUMMARY ***
Total pot 450 | Rake 25 
Board [5h Ks Qd]
Seat 1: color_singleton folded before Flop (didn't bet)
Seat 2: MnnM150 collected (425)
Seat 3: Duke Croix folded on the Flop
Seat 7: HighCardJasper (button) folded on the Flop
Seat 8: appositive (small blind) folded before Flop
Seat 9: JeBoyDirk (big blind) folded on the Flop



PokerStars Home Game Hand #219635206913: {Club #3225207}  Hold'em No Limit (50/100) - 2020/10/22 16:25:59 ET
Table 'VU_table_tonight' 9-max (Play Money) Seat #8 is the button
Seat 1: color_singleton (8107 in chips) 
Seat 2: MnnM150 (4968 in chips) 
Seat 3: Duke Croix (10745 in chips) 
Seat 7: HighCardJasper (13729 in chips) 
Seat 8: appositive (7637 in chips) 
Seat 9: JeBoyDirk (19629 in chips) 
JeBoyDirk: posts small blind 50
color_singleton: posts big blind 100
*** HOLE CARDS ***
Dealt to Duke Croix [Qd 4h]
MnnM150: calls 100
Duke Croix: folds 
HighCardJasper: folds 
appositive: calls 100
JeBoyDirk: calls 50
color_singleton: checks 
*** FLOP *** [9d As 3s]
JeBoyDirk: bets 200
color_singleton: folds 
MnnM150: calls 200
appositive: folds 
*** TURN *** [9d As 3s] [6h]
JeBoyDirk: bets 400
MnnM150: folds 
Uncalled bet (400) returned to JeBoyDirk
JeBoyDirk collected 756 from pot
*** SUMMARY ***
Total pot 800 | Rake 44 
Board [9d As 3s 6h]
Seat 1: color_singleton (big blind) folded on the Flop
Seat 2: MnnM150 folded on the Turn
Seat 3: Duke Croix folded before Flop (didn't bet)
Seat 7: HighCardJasper folded before Flop (didn't bet)
Seat 8: appositive (button) folded on the Flop
Seat 9: JeBoyDirk (small blind) collected (756)



PokerStars Home Game Hand #219635225728: {Club #3225207}  Hold'em No Limit (50/100) - 2020/10/22 16:26:31 ET
Table 'VU_table_tonight' 9-max (Play Money) Seat #9 is the button
Seat 1: color_singleton (8007 in chips) 
Seat 2: MnnM150 (4668 in chips) 
Seat 3: Duke Croix (10745 in chips) 
Seat 7: HighCardJasper (13729 in chips) 
Seat 8: appositive (7537 in chips) 
Seat 9: JeBoyDirk (20085 in chips) 
color_singleton: posts small blind 50
MnnM150: posts big blind 100
*** HOLE CARDS ***
Dealt to Duke Croix [Jc Qh]
Duke Croix: raises 200 to 300
HighCardJasper: calls 300
appositive: folds 
JeBoyDirk: folds 
color_singleton: calls 250
MnnM150: calls 200
*** FLOP *** [6c 6s 4h]
color_singleton: checks 
MnnM150: checks 
Duke Croix: checks 
HighCardJasper: checks 
*** TURN *** [6c 6s 4h] [Kd]
color_singleton: checks 
MnnM150: bets 1134
Duke Croix: folds 
HighCardJasper: folds 
color_singleton: folds 
Uncalled bet (1134) returned to MnnM150
MnnM150 collected 1134 from pot
*** SUMMARY ***
Total pot 1200 | Rake 66 
Board [6c 6s 4h Kd]
Seat 1: color_singleton (small blind) folded on the Turn
Seat 2: MnnM150 (big blind) collected (1134)
Seat 3: Duke Croix folded on the Turn
Seat 7: HighCardJasper folded on the Turn
Seat 8: appositive folded before Flop (didn't bet)
Seat 9: JeBoyDirk (button) folded before Flop (didn't bet)



PokerStars Home Game Hand #219635251762: {Club #3225207}  Hold'em No Limit (50/100) - 2020/10/22 16:27:14 ET
Table 'VU_table_tonight' 9-max (Play Money) Seat #1 is the button
Seat 1: color_singleton (7707 in chips) 
Seat 2: MnnM150 (5502 in chips) 
Seat 3: Duke Croix (10445 in chips) 
Seat 7: HighCardJasper (13429 in chips) 
Seat 8: appositive (7537 in chips) 
Seat 9: JeBoyDirk (20085 in chips) 
MnnM150: posts small blind 50
Duke Croix: posts big blind 100
*** HOLE CARDS ***
Dealt to Duke Croix [Jd 7s]
HighCardJasper: folds 
appositive: calls 100
JeBoyDirk: folds 
color_singleton: raises 100 to 200
MnnM150: calls 150
Duke Croix: calls 100
appositive: calls 100
*** FLOP *** [5c 9s 4h]
MnnM150: checks 
Duke Croix: checks 
appositive: checks 
color_singleton: checks 
*** TURN *** [5c 9s 4h] [9h]
MnnM150: bets 378
Duke Croix: folds 
appositive: folds 
color_singleton: folds 
Uncalled bet (378) returned to MnnM150
MnnM150 collected 756 from pot
*** SUMMARY ***
Total pot 800 | Rake 44 
Board [5c 9s 4h 9h]
Seat 1: color_singleton (button) folded on the Turn
Seat 2: MnnM150 (small blind) collected (756)
Seat 3: Duke Croix (big blind) folded on the Turn
Seat 7: HighCardJasper folded before Flop (didn't bet)
Seat 8: appositive folded on the Turn
Seat 9: JeBoyDirk folded before Flop (didn't bet)



PokerStars Home Game Hand #219635292771: {Club #3225207}  Hold'em No Limit (50/100) - 2020/10/22 16:28:22 ET
Table 'VU_table_tonight' 9-max (Play Money) Seat #2 is the button
Seat 1: color_singleton (7507 in chips) 
Seat 2: MnnM150 (6058 in chips) 
Seat 3: Duke Croix (10245 in chips) 
Seat 7: HighCardJasper (13429 in chips) 
Seat 8: appositive (7337 in chips) 
Seat 9: JeBoyDirk (20085 in chips) 
Duke Croix: posts small blind 50
HighCardJasper: posts big blind 100
*** HOLE CARDS ***
Dealt to Duke Croix [9d Ad]
appositive: folds 
JeBoyDirk: calls 100
color_singleton: folds 
MnnM150: calls 100
Duke Croix: raises 400 to 500
HighCardJasper: calls 400
JeBoyDirk: folds 
MnnM150: calls 400
*** FLOP *** [8d 6s 3s]
Duke Croix: bets 700
HighCardJasper: calls 700
MnnM150: folds 
*** TURN *** [8d 6s 3s] [4c]
Duke Croix: checks 
HighCardJasper: bets 1000
Duke Croix: folds 
Uncalled bet (1000) returned to HighCardJasper
HighCardJasper collected 2835 from pot
HighCardJasper: doesn't show hand 
*** SUMMARY ***
Total pot 3000 | Rake 165 
Board [8d 6s 3s 4c]
Seat 1: color_singleton folded before Flop (didn't bet)
Seat 2: MnnM150 (button) folded on the Flop
Seat 3: Duke Croix (small blind) folded on the Turn
Seat 7: HighCardJasper (big blind) collected (2835)
Seat 8: appositive folded before Flop (didn't bet)
Seat 9: JeBoyDirk folded before Flop



PokerStars Home Game Hand #219635323945: {Club #3225207}  Hold'em No Limit (50/100) - 2020/10/22 16:29:13 ET
Table 'VU_table_tonight' 9-max (Play Money) Seat #3 is the button
Seat 1: color_singleton (7507 in chips) 
Seat 2: MnnM150 (5558 in chips) 
Seat 3: Duke Croix (9045 in chips) 
Seat 7: HighCardJasper (15064 in chips) 
Seat 8: appositive (7337 in chips) 
Seat 9: JeBoyDirk (19985 in chips) 
HighCardJasper: posts small blind 50
appositive: posts big blind 100
*** HOLE CARDS ***
Dealt to Duke Croix [2d 6d]
JeBoyDirk: folds 
color_singleton: raises 100 to 200
MnnM150: calls 200
Duke Croix: folds 
HighCardJasper: calls 150
appositive: folds 
*** FLOP *** [5h 2s Ks]
HighCardJasper: checks 
color_singleton: bets 500
MnnM150: folds 
HighCardJasper: folds 
Uncalled bet (500) returned to color_singleton
color_singleton collected 661 from pot
color_singleton: doesn't show hand 
*** SUMMARY ***
Total pot 700 | Rake 39 
Board [5h 2s Ks]
Seat 1: color_singleton collected (661)
Seat 2: MnnM150 folded on the Flop
Seat 3: Duke Croix (button) folded before Flop (didn't bet)
Seat 7: HighCardJasper (small blind) folded on the Flop
Seat 8: appositive (big blind) folded before Flop
Seat 9: JeBoyDirk folded before Flop (didn't bet)



PokerStars Home Game Hand #219635340954: {Club #3225207}  Hold'em No Limit (50/100) - 2020/10/22 16:29:42 ET
Table 'VU_table_tonight' 9-max (Play Money) Seat #7 is the button
Seat 1: color_singleton (7968 in chips) 
Seat 2: MnnM150 (5358 in chips) 
Seat 3: Duke Croix (9045 in chips) 
Seat 7: HighCardJasper (14864 in chips) 
Seat 8: appositive (7237 in chips) 
Seat 9: JeBoyDirk (19985 in chips) 
appositive: posts small blind 50
JeBoyDirk: posts big blind 100
*** HOLE CARDS ***
Dealt to Duke Croix [As 5d]
color_singleton: folds 
MnnM150: raises 100 to 200
Duke Croix: raises 100 to 300
HighCardJasper: folds 
appositive: folds 
JeBoyDirk: folds 
MnnM150: calls 100
*** FLOP *** [2s 7c 4c]
MnnM150: checks 
Duke Croix: checks 
*** TURN *** [2s 7c 4c] [6h]
MnnM150: checks 
Duke Croix: bets 400
MnnM150: calls 400
*** RIVER *** [2s 7c 4c 6h] [5s]
MnnM150: bets 1465
Duke Croix: folds 
Uncalled bet (1465) returned to MnnM150
MnnM150 collected 1465 from pot
*** SUMMARY ***
Total pot 1550 | Rake 85 
Board [2s 7c 4c 6h 5s]
Seat 1: color_singleton folded before Flop (didn't bet)
Seat 2: MnnM150 collected (1465)
Seat 3: Duke Croix folded on the River
Seat 7: HighCardJasper (button) folded before Flop (didn't bet)
Seat 8: appositive (small blind) folded before Flop
Seat 9: JeBoyDirk (big blind) folded before Flop



PokerStars Home Game Hand #219635368241: {Club #3225207}  Hold'em No Limit (50/100) - 2020/10/22 16:30:27 ET
Table 'VU_table_tonight' 9-max (Play Money) Seat #8 is the button
Seat 1: color_singleton (7968 in chips) 
Seat 2: MnnM150 (6123 in chips) 
Seat 3: Duke Croix (8345 in chips) 
Seat 7: HighCardJasper (14864 in chips) 
Seat 8: appositive (7187 in chips) 
Seat 9: JeBoyDirk (19885 in chips) 
JeBoyDirk: posts small blind 50
color_singleton: posts big blind 100
*** HOLE CARDS ***
Dealt to Duke Croix [Ts 3d]
MnnM150: folds 
Duke Croix: folds 
HighCardJasper: calls 100
appositive: folds 
JeBoyDirk: folds 
color_singleton: raises 300 to 400
HighCardJasper: folds 
Uncalled bet (300) returned to color_singleton
color_singleton collected 250 from pot
color_singleton: doesn't show hand 
*** SUMMARY ***
Total pot 250 | Rake 0 
Seat 1: color_singleton (big blind) collected (250)
Seat 2: MnnM150 folded before Flop (didn't bet)
Seat 3: Duke Croix folded before Flop (didn't bet)
Seat 7: HighCardJasper folded before Flop
Seat 8: appositive (button) folded before Flop (didn't bet)
Seat 9: JeBoyDirk (small blind) folded before Flop



PokerStars Home Game Hand #219635381683: {Club #3225207}  Hold'em No Limit (50/100) - 2020/10/22 16:30:50 ET
Table 'VU_table_tonight' 9-max (Play Money) Seat #9 is the button
Seat 1: color_singleton (8118 in chips) 
Seat 2: MnnM150 (6123 in chips) 
Seat 3: Duke Croix (8345 in chips) 
Seat 7: HighCardJasper (14764 in chips) 
Seat 8: appositive (7187 in chips) 
Seat 9: JeBoyDirk (19835 in chips) 
color_singleton: posts small blind 50
MnnM150: posts big blind 100
*** HOLE CARDS ***
Dealt to Duke Croix [Jc 7d]
Duke Croix: calls 100
HighCardJasper: calls 100
appositive: calls 100
JeBoyDirk: folds 
color_singleton: folds 
MnnM150: checks 
*** FLOP *** [Jh 2d Qs]
MnnM150: bets 212
Duke Croix: calls 212
HighCardJasper: calls 212
appositive: folds 
*** TURN *** [Jh 2d Qs] [8h]
MnnM150: bets 513
Duke Croix: calls 513
HighCardJasper: calls 513
*** RIVER *** [Jh 2d Qs 8h] [As]
MnnM150: bets 1240
Duke Croix: folds 
HighCardJasper: calls 1240
*** SHOW DOWN ***
MnnM150: shows [Qd Jd] (two pair, Queens and Jacks)
HighCardJasper: mucks hand 
MnnM150 collected 4824 from pot
*** SUMMARY ***
Total pot 5105 | Rake 281 
Board [Jh 2d Qs 8h As]
Seat 1: color_singleton (small blind) folded before Flop
Seat 2: MnnM150 (big blind) showed [Qd Jd] and won (4824) with two pair, Queens and Jacks
Seat 3: Duke Croix folded on the River
Seat 7: HighCardJasper mucked [Qc 3c]
Seat 8: appositive folded on the Flop
Seat 9: JeBoyDirk (button) folded before Flop (didn't bet)



PokerStars Home Game Hand #219635414764: {Club #3225207}  Hold'em No Limit (50/100) - 2020/10/22 16:31:45 ET
Table 'VU_table_tonight' 9-max (Play Money) Seat #1 is the button
Seat 1: color_singleton (8068 in chips) 
Seat 2: MnnM150 (8882 in chips) 
Seat 3: Duke Croix (7520 in chips) 
Seat 7: HighCardJasper (12699 in chips) 
Seat 8: appositive (7087 in chips) 
Seat 9: JeBoyDirk (19835 in chips) 
MnnM150: posts small blind 50
Duke Croix: posts big blind 100
*** HOLE CARDS ***
Dealt to Duke Croix [6h 7h]
HighCardJasper: calls 100
appositive: folds 
JeBoyDirk: raises 200 to 300
color_singleton: folds 
MnnM150: folds 
Duke Croix: calls 200
HighCardJasper: calls 200
*** FLOP *** [6c Kd 9s]
Duke Croix: checks 
HighCardJasper: checks 
JeBoyDirk: checks 
*** TURN *** [6c Kd 9s] [8c]
Duke Croix: bets 500
HighCardJasper: calls 500
JeBoyDirk: folds 
*** RIVER *** [6c Kd 9s 8c] [4h]
Duke Croix: checks 
HighCardJasper: checks 
*** SHOW DOWN ***
Duke Croix: shows [6h 7h] (a pair of Sixes)
HighCardJasper: shows [7c 9c] (a pair of Nines)
HighCardJasper collected 1843 from pot
*** SUMMARY ***
Total pot 1950 | Rake 107 
Board [6c Kd 9s 8c 4h]
Seat 1: color_singleton (button) folded before Flop (didn't bet)
Seat 2: MnnM150 (small blind) folded before Flop
Seat 3: Duke Croix (big blind) showed [6h 7h] and lost with a pair of Sixes
Seat 7: HighCardJasper showed [7c 9c] and won (1843) with a pair of Nines
Seat 8: appositive folded before Flop (didn't bet)
Seat 9: JeBoyDirk folded on the Turn



PokerStars Home Game Hand #219635434252: {Club #3225207}  Hold'em No Limit (50/100) - 2020/10/22 16:32:18 ET
Table 'VU_table_tonight' 9-max (Play Money) Seat #2 is the button
Seat 1: color_singleton (8068 in chips) 
Seat 2: MnnM150 (8832 in chips) 
Seat 3: Duke Croix (6720 in chips) 
Seat 7: HighCardJasper (13742 in chips) 
Seat 8: appositive (7087 in chips) 
Seat 9: JeBoyDirk (19535 in chips) 
Duke Croix: posts small blind 50
HighCardJasper: posts big blind 100
*** HOLE CARDS ***
Dealt to Duke Croix [4c 2c]
appositive: folds 
JeBoyDirk: folds 
color_singleton: raises 200 to 300
MnnM150: folds 
Duke Croix: calls 250
HighCardJasper: calls 200
*** FLOP *** [4d 4s 9d]
Duke Croix: checks 
HighCardJasper: checks 
color_singleton: checks 
*** TURN *** [4d 4s 9d] [Td]
Duke Croix: bets 500
HighCardJasper: calls 500
color_singleton: folds 
*** RIVER *** [4d 4s 9d Td] [7h]
Duke Croix: bets 900
HighCardJasper: calls 900
*** SHOW DOWN ***
Duke Croix: shows [4c 2c] (three of a kind, Fours)
HighCardJasper: shows [4h Kc] (three of a kind, Fours - King kicker)
HighCardJasper collected 3496 from pot
*** SUMMARY ***
Total pot 3700 | Rake 204 
Board [4d 4s 9d Td 7h]
Seat 1: color_singleton folded on the Turn
Seat 2: MnnM150 (button) folded before Flop (didn't bet)
Seat 3: Duke Croix (small blind) showed [4c 2c] and lost with three of a kind, Fours
Seat 7: HighCardJasper (big blind) showed [4h Kc] and won (3496) with three of a kind, Fours
Seat 8: appositive folded before Flop (didn't bet)
Seat 9: JeBoyDirk folded before Flop (didn't bet)



PokerStars Home Game Hand #219635454708: {Club #3225207}  Hold'em No Limit (50/100) - 2020/10/22 16:32:52 ET
Table 'VU_table_tonight' 9-max (Play Money) Seat #3 is the button
Seat 1: color_singleton (7768 in chips) 
Seat 2: MnnM150 (8832 in chips) 
Seat 3: Duke Croix (5020 in chips) 
Seat 7: HighCardJasper (15538 in chips) 
Seat 8: appositive (7087 in chips) 
Seat 9: JeBoyDirk (19535 in chips) 
HighCardJasper: posts small blind 50
appositive: posts big blind 100
*** HOLE CARDS ***
Dealt to Duke Croix [2d Kc]
JeBoyDirk: folds 
color_singleton: folds 
MnnM150: calls 100
Duke Croix: folds 
HighCardJasper: calls 50
appositive: checks 
*** FLOP *** [2c 4d 5d]
HighCardJasper: checks 
appositive: bets 300
MnnM150: folds 
HighCardJasper: folds 
Uncalled bet (300) returned to appositive
appositive collected 283 from pot
appositive: doesn't show hand 
*** SUMMARY ***
Total pot 300 | Rake 17 
Board [2c 4d 5d]
Seat 1: color_singleton folded before Flop (didn't bet)
Seat 2: MnnM150 folded on the Flop
Seat 3: Duke Croix (button) folded before Flop (didn't bet)
Seat 7: HighCardJasper (small blind) folded on the Flop
Seat 8: appositive (big blind) collected (283)
Seat 9: JeBoyDirk folded before Flop (didn't bet)



PokerStars Home Game Hand #219635481873: {Club #3225207}  Hold'em No Limit (50/100) - 2020/10/22 16:33:38 ET
Table 'VU_table_tonight' 9-max (Play Money) Seat #7 is the button
Seat 1: color_singleton (7768 in chips) 
Seat 2: MnnM150 (8732 in chips) 
Seat 3: Duke Croix (5020 in chips) 
Seat 7: HighCardJasper (15438 in chips) 
Seat 8: appositive (7270 in chips) 
Seat 9: JeBoyDirk (19535 in chips) 
appositive: posts small blind 50
JeBoyDirk: posts big blind 100
*** HOLE CARDS ***
Dealt to Duke Croix [9c Ad]
color_singleton: raises 200 to 300
MnnM150: folds 
Duke Croix: calls 300
HighCardJasper: calls 300
appositive: folds 
JeBoyDirk: calls 200
*** FLOP *** [2d 4h Td]
JeBoyDirk: bets 500
color_singleton: folds 
Duke Croix: folds 
HighCardJasper: folds 
Uncalled bet (500) returned to JeBoyDirk
JeBoyDirk collected 1181 from pot
*** SUMMARY ***
Total pot 1250 | Rake 69 
Board [2d 4h Td]
Seat 1: color_singleton folded on the Flop
Seat 2: MnnM150 folded before Flop (didn't bet)
Seat 3: Duke Croix folded on the Flop
Seat 7: HighCardJasper (button) folded on the Flop
Seat 8: appositive (small blind) folded before Flop
Seat 9: JeBoyDirk (big blind) collected (1181)



PokerStars Home Game Hand #219635510024: {Club #3225207}  Hold'em No Limit (50/100) - 2020/10/22 16:34:19 ET
Table 'VU_table_tonight' 9-max (Play Money) Seat #8 is the button
Seat 1: color_singleton (7468 in chips) 
Seat 2: MnnM150 (8732 in chips) 
Seat 3: Duke Croix (4720 in chips) 
Seat 7: HighCardJasper (15138 in chips) 
Seat 8: appositive (7220 in chips) 
Seat 9: JeBoyDirk (20416 in chips) 
JeBoyDirk: posts small blind 50
color_singleton: posts big blind 100
*** HOLE CARDS ***
Dealt to Duke Croix [6h 8h]
MnnM150: calls 100
Duke Croix: calls 100
HighCardJasper: calls 100
appositive: folds 
JeBoyDirk: calls 50
color_singleton: raises 400 to 500
MnnM150: calls 400
Duke Croix: folds 
HighCardJasper: folds 
JeBoyDirk: folds 
*** FLOP *** [6s 4s Jc]
color_singleton: bets 1228
MnnM150: calls 1228
*** TURN *** [6s 4s Jc] [2c]
color_singleton: bets 1774
MnnM150: calls 1774
*** RIVER *** [6s 4s Jc 2c] [Kd]
color_singleton: checks 
MnnM150: bets 5230 and is all-in
color_singleton: calls 3966 and is all-in
Uncalled bet (1264) returned to MnnM150
*** SHOW DOWN ***
MnnM150: shows [As Ad] (a pair of Aces)
color_singleton: shows [Ah Js] (a pair of Jacks)
MnnM150 collected 14398 from pot
*** SUMMARY ***
Total pot 15236 | Rake 838 
Board [6s 4s Jc 2c Kd]
Seat 1: color_singleton (big blind) showed [Ah Js] and lost with a pair of Jacks
Seat 2: MnnM150 showed [As Ad] and won (14398) with a pair of Aces
Seat 3: Duke Croix folded before Flop
Seat 7: HighCardJasper folded before Flop
Seat 8: appositive (button) folded before Flop (didn't bet)
Seat 9: JeBoyDirk (small blind) folded before Flop



PokerStars Home Game Hand #219635542648: {Club #3225207}  Hold'em No Limit (50/100) - 2020/10/22 16:35:14 ET
Table 'VU_table_tonight' 9-max (Play Money) Seat #9 is the button
Seat 2: MnnM150 (15662 in chips) 
Seat 3: Duke Croix (4620 in chips) 
Seat 7: HighCardJasper (15038 in chips) 
Seat 8: appositive (7220 in chips) 
Seat 9: JeBoyDirk (20316 in chips) 
MnnM150: posts small blind 50
Duke Croix: posts big blind 100
*** HOLE CARDS ***
Dealt to Duke Croix [9h Jd]
HighCardJasper: calls 100
appositive: folds 
JeBoyDirk: folds 
MnnM150: calls 50
Duke Croix: checks 
*** FLOP *** [4c 2d Jh]
MnnM150: checks 
Duke Croix: bets 200
HighCardJasper: folds 
MnnM150: calls 200
*** TURN *** [4c 2d Jh] [Kd]
MnnM150: checks 
Duke Croix: bets 500
MnnM150: calls 500
*** RIVER *** [4c 2d Jh Kd] [Js]
MnnM150: bets 1606
Duke Croix: raises 2214 to 3820 and is all-in
MnnM150: calls 2214
*** SHOW DOWN ***
Duke Croix: shows [9h Jd] (three of a kind, Jacks)
MnnM150: shows [Jc 3h] (three of a kind, Jacks - lower kicker)
Duke Croix collected 8826 from pot
*** SUMMARY ***
Total pot 9340 | Rake 514 
Board [4c 2d Jh Kd Js]
Seat 2: MnnM150 (small blind) showed [Jc 3h] and lost with three of a kind, Jacks
Seat 3: Duke Croix (big blind) showed [9h Jd] and won (8826) with three of a kind, Jacks
Seat 7: HighCardJasper folded on the Flop
Seat 8: appositive folded before Flop (didn't bet)
Seat 9: JeBoyDirk (button) folded before Flop (didn't bet)



PokerStars Home Game Hand #219635571567: {Club #3225207}  Hold'em No Limit (50/100) - 2020/10/22 16:36:03 ET
Table 'VU_table_tonight' 9-max (Play Money) Seat #2 is the button
Seat 2: MnnM150 (11042 in chips) 
Seat 3: Duke Croix (8826 in chips) 
Seat 7: HighCardJasper (14938 in chips) 
Seat 8: appositive (7220 in chips) 
Seat 9: JeBoyDirk (20316 in chips) 
Duke Croix: posts small blind 50
HighCardJasper: posts big blind 100
*** HOLE CARDS ***
Dealt to Duke Croix [6d 9d]
appositive: folds 
JeBoyDirk: calls 100
MnnM150: calls 100
Duke Croix: calls 50
HighCardJasper: checks 
*** FLOP *** [6h Ah 8d]
Duke Croix: checks 
HighCardJasper: checks 
JeBoyDirk: checks 
MnnM150: checks 
*** TURN *** [6h Ah 8d] [Td]
Duke Croix: bets 300
HighCardJasper: calls 300
JeBoyDirk: calls 300
MnnM150: folds 
*** RIVER *** [6h Ah 8d Td] [5d]
Duke Croix: bets 700
HighCardJasper: folds 
JeBoyDirk: folds 
Uncalled bet (700) returned to Duke Croix
Duke Croix collected 1228 from pot
*** SUMMARY ***
Total pot 1300 | Rake 72 
Board [6h Ah 8d Td 5d]
Seat 2: MnnM150 (button) folded on the Turn
Seat 3: Duke Croix (small blind) collected (1228)
Seat 7: HighCardJasper (big blind) folded on the River
Seat 8: appositive folded before Flop (didn't bet)
Seat 9: JeBoyDirk folded on the River



PokerStars Home Game Hand #219635596735: {Club #3225207}  Hold'em No Limit (50/100) - 2020/10/22 16:36:46 ET
Table 'VU_table_tonight' 9-max (Play Money) Seat #3 is the button
Seat 1: color_singleton (10000 in chips) 
Seat 2: MnnM150 (10942 in chips) 
Seat 3: Duke Croix (9654 in chips) 
Seat 7: HighCardJasper (14538 in chips) 
Seat 8: appositive (7220 in chips) 
Seat 9: JeBoyDirk (19916 in chips) 
HighCardJasper: posts small blind 50
appositive: posts big blind 100
color_singleton: posts small blind 50
*** HOLE CARDS ***
Dealt to Duke Croix [Ad Ah]
JeBoyDirk: folds 
color_singleton: raises 200 to 300
MnnM150: folds 
Duke Croix: raises 500 to 800
HighCardJasper: folds 
appositive: folds 
color_singleton: calls 500
*** FLOP *** [Js 5s 8h]
color_singleton: bets 1701
Duke Croix: raises 1899 to 3600
color_singleton: raises 1899 to 5499
Duke Croix: raises 3355 to 8854 and is all-in
color_singleton: calls 3355
*** TURN *** [Js 5s 8h] [Qh]
*** RIVER *** [Js 5s 8h Qh] [Jh]
*** SHOW DOWN ***
color_singleton: shows [9d 9h] (two pair, Jacks and Nines)
Duke Croix: shows [Ad Ah] (two pair, Aces and Jacks)
Duke Croix collected 18435 from pot
*** SUMMARY ***
Total pot 19508 | Rake 1073 
Board [Js 5s 8h Qh Jh]
Seat 1: color_singleton showed [9d 9h] and lost with two pair, Jacks and Nines
Seat 2: MnnM150 folded before Flop (didn't bet)
Seat 3: Duke Croix (button) showed [Ad Ah] and won (18435) with two pair, Aces and Jacks
Seat 7: HighCardJasper (small blind) folded before Flop
Seat 8: appositive (big blind) folded before Flop
Seat 9: JeBoyDirk folded before Flop (didn't bet)



PokerStars Home Game Hand #219635625230: {Club #3225207}  Hold'em No Limit (50/100) - 2020/10/22 16:37:34 ET
Table 'VU_table_tonight' 9-max (Play Money) Seat #7 is the button
Seat 1: color_singleton (296 in chips) 
Seat 2: MnnM150 (10942 in chips) 
Seat 3: Duke Croix (18435 in chips) 
Seat 7: HighCardJasper (14488 in chips) 
Seat 8: appositive (7120 in chips) 
Seat 9: JeBoyDirk (19916 in chips) 
appositive: posts small blind 50
JeBoyDirk: posts big blind 100
*** HOLE CARDS ***
Dealt to Duke Croix [Jh Jc]
color_singleton: folds 
MnnM150: calls 100
Duke Croix: raises 300 to 400
HighCardJasper: folds 
appositive: calls 350
JeBoyDirk: folds 
MnnM150: calls 300
*** FLOP *** [6d Kc 4s]
appositive: checks 
MnnM150: bets 614
Duke Croix: calls 614
appositive: calls 614
*** TURN *** [6d Kc 4s] [8c]
appositive: checks 
MnnM150: bets 1484
Duke Croix: calls 1484
appositive: folds 
*** RIVER *** [6d Kc 4s 8c] [Qc]
MnnM150: bets 2887
Duke Croix: folds 
Uncalled bet (2887) returned to MnnM150
MnnM150 collected 5774 from pot
*** SUMMARY ***
Total pot 6110 | Rake 336 
Board [6d Kc 4s 8c Qc]
Seat 1: color_singleton folded before Flop (didn't bet)
Seat 2: MnnM150 collected (5774)
Seat 3: Duke Croix folded on the River
Seat 7: HighCardJasper (button) folded before Flop (didn't bet)
Seat 8: appositive (small blind) folded on the Turn
Seat 9: JeBoyDirk (big blind) folded before Flop



PokerStars Home Game Hand #219635663608: {Club #3225207}  Hold'em No Limit (50/100) - 2020/10/22 16:38:40 ET
Table 'VU_table_tonight' 9-max (Play Money) Seat #8 is the button
Seat 1: color_singleton (296 in chips) 
Seat 2: MnnM150 (14218 in chips) 
Seat 3: Duke Croix (15937 in chips) 
Seat 7: HighCardJasper (14488 in chips) 
Seat 8: appositive (6106 in chips) 
Seat 9: JeBoyDirk (19816 in chips) 
JeBoyDirk: posts small blind 50
color_singleton: posts big blind 100
*** HOLE CARDS ***
Dealt to Duke Croix [Ac 2d]
MnnM150: calls 100
Duke Croix: folds 
HighCardJasper: calls 100
appositive: calls 100
JeBoyDirk: calls 50
color_singleton: raises 196 to 296 and is all-in
MnnM150: calls 196
HighCardJasper: calls 196
appositive: calls 196
JeBoyDirk: calls 196
*** FLOP *** [8h 8d Kc]
JeBoyDirk: checks 
MnnM150: bets 699
HighCardJasper: folds 
appositive: folds 
JeBoyDirk: calls 699
*** TURN *** [8h 8d Kc] [Jh]
JeBoyDirk: checks 
MnnM150: bets 1360
JeBoyDirk: calls 1360
*** RIVER *** [8h 8d Kc Jh] [5s]
JeBoyDirk: checks 
MnnM150: bets 2645
JeBoyDirk: calls 2645
*** SHOW DOWN ***
MnnM150: shows [Kd Qs] (two pair, Kings and Eights)
JeBoyDirk: shows [2c 8c] (three of a kind, Eights)
JeBoyDirk collected 8890 from side pot
color_singleton: mucks hand 
JeBoyDirk collected 1399 from main pot
*** SUMMARY ***
Total pot 10888 Main pot 1399. Side pot 8890. | Rake 599 
Board [8h 8d Kc Jh 5s]
Seat 1: color_singleton (big blind) mucked [9s 3s]
Seat 2: MnnM150 showed [Kd Qs] and lost with two pair, Kings and Eights
Seat 3: Duke Croix folded before Flop (didn't bet)
Seat 7: HighCardJasper folded on the Flop
Seat 8: appositive (button) folded on the Flop
Seat 9: JeBoyDirk (small blind) showed [2c 8c] and won (10289) with three of a kind, Eights



PokerStars Home Game Hand #219635693986: {Club #3225207}  Hold'em No Limit (50/100) - 2020/10/22 16:39:31 ET
Table 'VU_table_tonight' 9-max (Play Money) Seat #9 is the button
Seat 2: MnnM150 (9218 in chips) 
Seat 3: Duke Croix (15937 in chips) 
Seat 7: HighCardJasper (14192 in chips) 
Seat 8: appositive (5810 in chips) 
Seat 9: JeBoyDirk (25105 in chips) 
MnnM150: posts small blind 50
Duke Croix: posts big blind 100
*** HOLE CARDS ***
Dealt to Duke Croix [2h 5d]
HighCardJasper: calls 100
appositive: calls 100
JeBoyDirk: folds 
MnnM150: calls 50
Duke Croix: checks 
*** FLOP *** [3c 8h 4s]
MnnM150: checks 
Duke Croix: checks 
HighCardJasper: checks 
appositive: checks 
*** TURN *** [3c 8h 4s] [Kd]
MnnM150: bets 189
Duke Croix: calls 189
HighCardJasper: calls 189
appositive: folds 
*** RIVER *** [3c 8h 4s Kd] [Td]
MnnM150: bets 457
Duke Croix: folds 
HighCardJasper: folds 
Uncalled bet (457) returned to MnnM150
MnnM150 collected 914 from pot
*** SUMMARY ***
Total pot 967 | Rake 53 
Board [3c 8h 4s Kd Td]
Seat 2: MnnM150 (small blind) collected (914)
Seat 3: Duke Croix (big blind) folded on the River
Seat 7: HighCardJasper folded on the River
Seat 8: appositive folded on the Turn
Seat 9: JeBoyDirk (button) folded before Flop (didn't bet)



PokerStars Home Game Hand #219635714848: {Club #3225207}  Hold'em No Limit (50/100) - 2020/10/22 16:40:06 ET
Table 'VU_table_tonight' 9-max (Play Money) Seat #2 is the button
Seat 1: color_singleton (10000 in chips) 
Seat 2: MnnM150 (9843 in chips) 
Seat 3: Duke Croix (15648 in chips) 
Seat 7: HighCardJasper (13903 in chips) 
Seat 8: appositive (5710 in chips) 
Seat 9: JeBoyDirk (25105 in chips) 
Duke Croix: posts small blind 50
HighCardJasper: posts big blind 100
color_singleton: posts small blind 50
*** HOLE CARDS ***
Dealt to Duke Croix [3h Jc]
appositive: calls 100
JeBoyDirk: calls 100
color_singleton: folds 
MnnM150: folds 
Duke Croix: folds 
HighCardJasper: checks 
*** FLOP *** [4h 7h Qh]
HighCardJasper: bets 100
appositive: calls 100
JeBoyDirk: folds 
*** TURN *** [4h 7h Qh] [2h]
HighCardJasper: checks 
appositive: bets 500
HighCardJasper: folds 
Uncalled bet (500) returned to appositive
appositive collected 567 from pot
appositive: doesn't show hand 
*** SUMMARY ***
Total pot 600 | Rake 33 
Board [4h 7h Qh 2h]
Seat 1: color_singleton folded before Flop (didn't bet)
Seat 2: MnnM150 (button) folded before Flop (didn't bet)
Seat 3: Duke Croix (small blind) folded before Flop
Seat 7: HighCardJasper (big blind) folded on the Turn
Seat 8: appositive collected (567)
Seat 9: JeBoyDirk folded on the Flop



PokerStars Home Game Hand #219635737895: {Club #3225207}  Hold'em No Limit (50/100) - 2020/10/22 16:40:45 ET
Table 'VU_table_tonight' 9-max (Play Money) Seat #3 is the button
Seat 1: color_singleton (9950 in chips) 
Seat 2: MnnM150 (9843 in chips) 
Seat 3: Duke Croix (15598 in chips) 
Seat 7: HighCardJasper (13703 in chips) 
Seat 8: appositive (6077 in chips) 
Seat 9: JeBoyDirk (25005 in chips) 
HighCardJasper: posts small blind 50
appositive: posts big blind 100
*** HOLE CARDS ***
Dealt to Duke Croix [4d 6d]
JeBoyDirk: folds 
color_singleton: folds 
MnnM150: folds 
Duke Croix: raises 200 to 300
HighCardJasper: calls 250
appositive: folds 
*** FLOP *** [8d 9s 2s]
HighCardJasper: checks 
Duke Croix: bets 300
HighCardJasper: calls 300
*** TURN *** [8d 9s 2s] [6s]
HighCardJasper: checks 
Duke Croix: bets 600
HighCardJasper: calls 600
*** RIVER *** [8d 9s 2s 6s] [Kc]
HighCardJasper: checks 
Duke Croix: checks 
*** SHOW DOWN ***
HighCardJasper: shows [8c 6c] (two pair, Eights and Sixes)
Duke Croix: mucks hand 
HighCardJasper collected 2362 from pot
*** SUMMARY ***
Total pot 2500 | Rake 138 
Board [8d 9s 2s 6s Kc]
Seat 1: color_singleton folded before Flop (didn't bet)
Seat 2: MnnM150 folded before Flop (didn't bet)
Seat 3: Duke Croix (button) mucked [4d 6d]
Seat 7: HighCardJasper (small blind) showed [8c 6c] and won (2362) with two pair, Eights and Sixes
Seat 8: appositive (big blind) folded before Flop
Seat 9: JeBoyDirk folded before Flop (didn't bet)



PokerStars Home Game Hand #219635761084: {Club #3225207}  Hold'em No Limit (50/100) - 2020/10/22 16:41:25 ET
Table 'VU_table_tonight' 9-max (Play Money) Seat #7 is the button
Seat 1: color_singleton (9950 in chips) 
Seat 2: MnnM150 (9843 in chips) 
Seat 3: Duke Croix (14398 in chips) 
Seat 7: HighCardJasper (14865 in chips) 
Seat 8: appositive (5977 in chips) 
Seat 9: JeBoyDirk (25005 in chips) 
appositive: posts small blind 50
JeBoyDirk: posts big blind 100
*** HOLE CARDS ***
Dealt to Duke Croix [Qs 5s]
color_singleton: raises 100 to 200
MnnM150: calls 200
Duke Croix: folds 
HighCardJasper: calls 200
appositive: calls 150
JeBoyDirk: folds 
*** FLOP *** [Jd 3s Jh]
appositive: checks 
color_singleton: checks 
MnnM150: checks 
dddocky joins the table at seat #4 
HighCardJasper: checks 
*** TURN *** [Jd 3s Jh] [9d]
appositive: checks 
color_singleton: checks 
MnnM150: checks 
HighCardJasper: checks 
*** RIVER *** [Jd 3s Jh 9d] [7d]
appositive: bets 500
color_singleton: folds 
MnnM150: calls 500
HighCardJasper: folds 
*** SHOW DOWN ***
appositive: shows [2s 3c] (two pair, Jacks and Threes)
MnnM150: shows [As 7h] (two pair, Jacks and Sevens)
MnnM150 collected 1795 from pot
*** SUMMARY ***
Total pot 1900 | Rake 105 
Board [Jd 3s Jh 9d 7d]
Seat 1: color_singleton folded on the River
Seat 2: MnnM150 showed [As 7h] and won (1795) with two pair, Jacks and Sevens
Seat 3: Duke Croix folded before Flop (didn't bet)
Seat 7: HighCardJasper (button) folded on the River
Seat 8: appositive (small blind) showed [2s 3c] and lost with two pair, Jacks and Threes
Seat 9: JeBoyDirk (big blind) folded before Flop



PokerStars Home Game Hand #219635794538: {Club #3225207}  Hold'em No Limit (50/100) - 2020/10/22 16:42:23 ET
Table 'VU_table_tonight' 9-max (Play Money) Seat #8 is the button
Seat 1: color_singleton (9750 in chips) 
Seat 2: MnnM150 (10938 in chips) 
Seat 3: Duke Croix (14398 in chips) 
Seat 4: dddocky (10000 in chips) 
Seat 7: HighCardJasper (14665 in chips) 
Seat 8: appositive (5277 in chips) 
Seat 9: JeBoyDirk (24905 in chips) 
JeBoyDirk: posts small blind 50
color_singleton: posts big blind 100
dddocky: posts big blind 100
*** HOLE CARDS ***
Dealt to Duke Croix [6c Ks]
MnnM150: calls 100
Duke Croix: folds 
dddocky: checks 
HighCardJasper: calls 100
appositive: folds 
JeBoyDirk: calls 50
color_singleton: checks 
*** FLOP *** [7h 2h Td]
JeBoyDirk: checks 
color_singleton: bets 472
MnnM150: folds 
dddocky: folds 
HighCardJasper: folds 
JeBoyDirk: folds 
Uncalled bet (472) returned to color_singleton
color_singleton collected 472 from pot
color_singleton: doesn't show hand 
*** SUMMARY ***
Total pot 500 | Rake 28 
Board [7h 2h Td]
Seat 1: color_singleton (big blind) collected (472)
Seat 2: MnnM150 folded on the Flop
Seat 3: Duke Croix folded before Flop (didn't bet)
Seat 4: dddocky folded on the Flop (didn't bet)
Seat 7: HighCardJasper folded on the Flop
Seat 8: appositive (button) folded before Flop (didn't bet)
Seat 9: JeBoyDirk (small blind) folded on the Flop



PokerStars Home Game Hand #219635820743: {Club #3225207}  Hold'em No Limit (50/100) - 2020/10/22 16:43:08 ET
Table 'VU_table_tonight' 9-max (Play Money) Seat #9 is the button
Seat 1: color_singleton (10122 in chips) 
Seat 2: MnnM150 (10838 in chips) 
Seat 3: Duke Croix (14398 in chips) 
Seat 4: dddocky (9900 in chips) 
Seat 7: HighCardJasper (14565 in chips) 
Seat 8: appositive (5277 in chips) 
Seat 9: JeBoyDirk (24805 in chips) 
color_singleton: posts small blind 50
MnnM150: posts big blind 100
*** HOLE CARDS ***
Dealt to Duke Croix [9c 7h]
Duke Croix: folds 
dddocky: calls 100
HighCardJasper: calls 100
appositive: folds 
JeBoyDirk: raises 200 to 300
color_singleton: calls 250
MnnM150: calls 200
dddocky: calls 200
HighCardJasper: calls 200
*** FLOP *** [7c 3c Ah]
color_singleton: bets 708
MnnM150: calls 708
dddocky: folds 
HighCardJasper: folds 
JeBoyDirk: folds 
*** TURN *** [7c 3c Ah] [8c]
color_singleton: bets 1378
MnnM150: folds 
Uncalled bet (1378) returned to color_singleton
color_singleton collected 2756 from pot
color_singleton: doesn't show hand 
*** SUMMARY ***
Total pot 2916 | Rake 160 
Board [7c 3c Ah 8c]
Seat 1: color_singleton (small blind) collected (2756)
Seat 2: MnnM150 (big blind) folded on the Turn
Seat 3: Duke Croix folded before Flop (didn't bet)
Seat 4: dddocky folded on the Flop
Seat 7: HighCardJasper folded on the Flop
Seat 8: appositive folded before Flop (didn't bet)
Seat 9: JeBoyDirk (button) folded on the Flop



PokerStars Home Game Hand #219635846977: {Club #3225207}  Hold'em No Limit (50/100) - 2020/10/22 16:43:53 ET
Table 'VU_table_tonight' 9-max (Play Money) Seat #1 is the button
Seat 1: color_singleton (11870 in chips) 
Seat 2: MnnM150 (9830 in chips) 
Seat 3: Duke Croix (14398 in chips) 
Seat 4: dddocky (9600 in chips) 
Seat 7: HighCardJasper (14265 in chips) 
Seat 8: appositive (5277 in chips) 
Seat 9: JeBoyDirk (24505 in chips) 
MnnM150: posts small blind 50
Duke Croix: posts big blind 100
*** HOLE CARDS ***
Dealt to Duke Croix [Ac Th]
dddocky: folds 
HighCardJasper: calls 100
appositive: calls 100
JeBoyDirk: folds 
color_singleton: raises 300 to 400
MnnM150: folds 
Duke Croix: folds 
HighCardJasper: folds 
appositive: folds 
Uncalled bet (300) returned to color_singleton
color_singleton collected 450 from pot
color_singleton: doesn't show hand 
*** SUMMARY ***
Total pot 450 | Rake 0 
Seat 1: color_singleton (button) collected (450)
Seat 2: MnnM150 (small blind) folded before Flop
Seat 3: Duke Croix (big blind) folded before Flop
Seat 4: dddocky folded before Flop (didn't bet)
Seat 7: HighCardJasper folded before Flop
Seat 8: appositive folded before Flop
Seat 9: JeBoyDirk folded before Flop (didn't bet)



PokerStars Home Game Hand #219635859467: {Club #3225207}  Hold'em No Limit (50/100) - 2020/10/22 16:44:15 ET
Table 'VU_table_tonight' 9-max (Play Money) Seat #2 is the button
Seat 1: color_singleton (12220 in chips) 
Seat 2: MnnM150 (9780 in chips) 
Seat 3: Duke Croix (14298 in chips) 
Seat 4: dddocky (9600 in chips) 
Seat 7: HighCardJasper (14165 in chips) 
Seat 8: appositive (5177 in chips) 
Seat 9: JeBoyDirk (24505 in chips) 
Duke Croix: posts small blind 50
dddocky: posts big blind 100
*** HOLE CARDS ***
Dealt to Duke Croix [9s Qh]
HighCardJasper: calls 100
appositive: folds 
JeBoyDirk: folds 
color_singleton: folds 
MnnM150: calls 100
Duke Croix: calls 50
dddocky: checks 
*** FLOP *** [Ks 8s Tc]
Duke Croix: checks 
dddocky: bets 189
HighCardJasper: calls 189
MnnM150: folds 
Duke Croix: calls 189
*** TURN *** [Ks 8s Tc] [Jh]
Duke Croix: bets 500
dddocky: calls 500
HighCardJasper: calls 500
*** RIVER *** [Ks 8s Tc Jh] [Kd]
Duke Croix: bets 1600
dddocky: calls 1600
HighCardJasper: folds 
*** SHOW DOWN ***
Duke Croix: shows [9s Qh] (a straight, Nine to King)
dddocky: mucks hand 
Duke Croix collected 5355 from pot
*** SUMMARY ***
Total pot 5667 | Rake 312 
Board [Ks 8s Tc Jh Kd]
Seat 1: color_singleton folded before Flop (didn't bet)
Seat 2: MnnM150 (button) folded on the Flop
Seat 3: Duke Croix (small blind) showed [9s Qh] and won (5355) with a straight, Nine to King
Seat 4: dddocky (big blind) mucked [Kh Ac]
Seat 7: HighCardJasper folded on the River
Seat 8: appositive folded before Flop (didn't bet)
Seat 9: JeBoyDirk folded before Flop (didn't bet)



PokerStars Home Game Hand #219635896981: {Club #3225207}  Hold'em No Limit (50/100) - 2020/10/22 16:45:19 ET
Table 'VU_table_tonight' 9-max (Play Money) Seat #3 is the button
Seat 1: color_singleton (12220 in chips) 
Seat 2: MnnM150 (9680 in chips) 
Seat 3: Duke Croix (17264 in chips) 
Seat 4: dddocky (7211 in chips) 
Seat 7: HighCardJasper (13376 in chips) 
Seat 8: appositive (5177 in chips) 
Seat 9: JeBoyDirk (24505 in chips) 
dddocky: posts small blind 50
HighCardJasper: posts big blind 100
*** HOLE CARDS ***
Dealt to Duke Croix [7c 8c]
appositive: folds 
JeBoyDirk: folds 
color_singleton: raises 200 to 300
MnnM150: folds 
Duke Croix: calls 300
dddocky: calls 250
HighCardJasper: calls 200
*** FLOP *** [2c 2h Js]
dddocky: checks 
HighCardJasper: checks 
color_singleton: checks 
Duke Croix: checks 
*** TURN *** [2c 2h Js] [2s]
dddocky: checks 
HighCardJasper: bets 200
color_singleton: calls 200
Duke Croix: folds 
dddocky: folds 
*** RIVER *** [2c 2h Js 2s] [Ac]
HighCardJasper: checks 
color_singleton: checks 
*** SHOW DOWN ***
HighCardJasper: shows [Jc Ks] (a full house, Deuces full of Jacks)
color_singleton: mucks hand 
HighCardJasper collected 1512 from pot
*** SUMMARY ***
Total pot 1600 | Rake 88 
Board [2c 2h Js 2s Ac]
Seat 1: color_singleton mucked [Kc Tc]
Seat 2: MnnM150 folded before Flop (didn't bet)
Seat 3: Duke Croix (button) folded on the Turn
Seat 4: dddocky (small blind) folded on the Turn
Seat 7: HighCardJasper (big blind) showed [Jc Ks] and won (1512) with a full house, Deuces full of Jacks
Seat 8: appositive folded before Flop (didn't bet)
Seat 9: JeBoyDirk folded before Flop (didn't bet)



PokerStars Home Game Hand #219635925508: {Club #3225207}  Hold'em No Limit (50/100) - 2020/10/22 16:46:07 ET
Table 'VU_table_tonight' 9-max (Play Money) Seat #4 is the button
Seat 1: color_singleton (11720 in chips) 
Seat 2: MnnM150 (9680 in chips) 
Seat 3: Duke Croix (16964 in chips) 
Seat 4: dddocky (6911 in chips) 
Seat 7: HighCardJasper (14388 in chips) 
Seat 8: appositive (5177 in chips) 
Seat 9: JeBoyDirk (24505 in chips) 
HighCardJasper: posts small blind 50
appositive: posts big blind 100
*** HOLE CARDS ***
Dealt to Duke Croix [Td 7s]
JeBoyDirk: folds 
color_singleton: folds 
MnnM150: folds 
Duke Croix: folds 
dddocky: folds 
HighCardJasper: calls 50
appositive: checks 
*** FLOP *** [Tc 7h 9c]
HighCardJasper: checks 
appositive: checks 
*** TURN *** [Tc 7h 9c] [5h]
HighCardJasper: checks 
appositive: checks 
*** RIVER *** [Tc 7h 9c 5h] [Kh]
HighCardJasper: checks 
appositive: bets 400
HighCardJasper: folds 
Uncalled bet (400) returned to appositive
appositive collected 189 from pot
appositive: doesn't show hand 
*** SUMMARY ***
Total pot 200 | Rake 11 
Board [Tc 7h 9c 5h Kh]
Seat 1: color_singleton folded before Flop (didn't bet)
Seat 2: MnnM150 folded before Flop (didn't bet)
Seat 3: Duke Croix folded before Flop (didn't bet)
Seat 4: dddocky (button) folded before Flop (didn't bet)
Seat 7: HighCardJasper (small blind) folded on the River
Seat 8: appositive (big blind) collected (189)
Seat 9: JeBoyDirk folded before Flop (didn't bet)



PokerStars Home Game Hand #219635945235: {Club #3225207}  Hold'em No Limit (50/100) - 2020/10/22 16:46:40 ET
Table 'VU_table_tonight' 9-max (Play Money) Seat #7 is the button
Seat 1: color_singleton (11720 in chips) 
Seat 2: MnnM150 (9680 in chips) 
Seat 3: Duke Croix (16964 in chips) 
Seat 4: dddocky (6911 in chips) 
Seat 7: HighCardJasper (14288 in chips) 
Seat 8: appositive (5266 in chips) 
Seat 9: JeBoyDirk (24505 in chips) 
appositive: posts small blind 50
JeBoyDirk: posts big blind 100
*** HOLE CARDS ***
Dealt to Duke Croix [Ks 6d]
color_singleton: folds 
MnnM150: calls 100
Duke Croix: folds 
dddocky: calls 100
HighCardJasper: calls 100
appositive: calls 50
JeBoyDirk: checks 
*** FLOP *** [8h 4s 5c]
appositive: checks 
JeBoyDirk: bets 200
MnnM150: calls 200
dddocky: calls 200
HighCardJasper: calls 200
appositive: folds 
*** TURN *** [8h 4s 5c] [7d]
JeBoyDirk: bets 300
MnnM150: folds 
dddocky: calls 300
HighCardJasper: calls 300
*** RIVER *** [8h 4s 5c 7d] [Qh]
JeBoyDirk: bets 900
dddocky: folds 
HighCardJasper: raises 900 to 1800
JeBoyDirk: calls 900
*** SHOW DOWN ***
HighCardJasper: shows [2s 6c] (a straight, Four to Eight)
JeBoyDirk: mucks hand 
HighCardJasper collected 5481 from pot
*** SUMMARY ***
Total pot 5800 | Rake 319 
Board [8h 4s 5c 7d Qh]
Seat 1: color_singleton folded before Flop (didn't bet)
Seat 2: MnnM150 folded on the Turn
Seat 3: Duke Croix folded before Flop (didn't bet)
Seat 4: dddocky folded on the River
Seat 7: HighCardJasper (button) showed [2s 6c] and won (5481) with a straight, Four to Eight
Seat 8: appositive (small blind) folded on the Flop
Seat 9: JeBoyDirk (big blind) mucked [Qc 8c]



PokerStars Home Game Hand #219635991649: {Club #3225207}  Hold'em No Limit (50/100) - 2020/10/22 16:47:55 ET
Table 'VU_table_tonight' 9-max (Play Money) Seat #8 is the button
Seat 1: color_singleton (11720 in chips) 
Seat 2: MnnM150 (9380 in chips) 
Seat 3: Duke Croix (16964 in chips) 
Seat 4: dddocky (6311 in chips) 
Seat 7: HighCardJasper (17369 in chips) 
Seat 8: appositive (5166 in chips) 
Seat 9: JeBoyDirk (22105 in chips) 
JeBoyDirk: posts small blind 50
color_singleton: posts big blind 100
*** HOLE CARDS ***
Dealt to Duke Croix [9h 9s]
MnnM150: calls 100
Duke Croix: raises 300 to 400
dddocky has timed out
dddocky: folds 
HighCardJasper: folds 
appositive: calls 400
JeBoyDirk: folds 
color_singleton: calls 300
MnnM150: calls 300
*** FLOP *** [9c 3c Qd]
color_singleton: checks 
MnnM150: checks 
Duke Croix: checks 
appositive: checks 
*** TURN *** [9c 3c Qd] [8s]
color_singleton: checks 
MnnM150: checks 
Duke Croix: bets 900
appositive: folds 
color_singleton: folds 
MnnM150: folds 
Uncalled bet (900) returned to Duke Croix
Duke Croix collected 1559 from pot
*** SUMMARY ***
Total pot 1650 | Rake 91 
Board [9c 3c Qd 8s]
Seat 1: color_singleton (big blind) folded on the Turn
Seat 2: MnnM150 folded on the Turn
Seat 3: Duke Croix collected (1559)
Seat 4: dddocky folded before Flop (didn't bet)
Seat 7: HighCardJasper folded before Flop (didn't bet)
Seat 8: appositive (button) folded on the Turn
Seat 9: JeBoyDirk (small blind) folded before Flop



PokerStars Home Game Hand #219636022465: {Club #3225207}  Hold'em No Limit (50/100) - 2020/10/22 16:48:47 ET
Table 'VU_table_tonight' 9-max (Play Money) Seat #9 is the button
Seat 1: color_singleton (11320 in chips) 
Seat 2: MnnM150 (8980 in chips) 
Seat 3: Duke Croix (18123 in chips) 
Seat 4: dddocky (6311 in chips) 
Seat 7: HighCardJasper (17369 in chips) 
Seat 8: appositive (4766 in chips) 
Seat 9: JeBoyDirk (22055 in chips) 
color_singleton: posts small blind 50
MnnM150: posts big blind 100
*** HOLE CARDS ***
Dealt to Duke Croix [6s 7h]
Duke Croix: calls 100
dddocky: calls 100
HighCardJasper: calls 100
appositive: calls 100
JeBoyDirk: raises 300 to 400
color_singleton: calls 350
MnnM150: folds 
Duke Croix: calls 300
dddocky: calls 300
HighCardJasper: calls 300
appositive: calls 300
*** FLOP *** [Kh 5h 8c]
color_singleton: checks 
Duke Croix: bets 1200
dddocky: calls 1200
HighCardJasper: folds 
appositive: folds 
JeBoyDirk: folds 
color_singleton: folds 
*** TURN *** [Kh 5h 8c] [2d]
Duke Croix: bets 2000
dddocky: calls 2000
*** RIVER *** [Kh 5h 8c 2d] [4c]
Duke Croix: bets 14523 and is all-in
dddocky: calls 2711 and is all-in
Uncalled bet (11812) returned to Duke Croix
*** SHOW DOWN ***
Duke Croix: shows [6s 7h] (a straight, Four to Eight)
dddocky: shows [7s Kc] (a pair of Kings)
Duke Croix collected 13534 from pot
*** SUMMARY ***
Total pot 14322 | Rake 788 
Board [Kh 5h 8c 2d 4c]
Seat 1: color_singleton (small blind) folded on the Flop
Seat 2: MnnM150 (big blind) folded before Flop
Seat 3: Duke Croix showed [6s 7h] and won (13534) with a straight, Four to Eight
Seat 4: dddocky showed [7s Kc] and lost with a pair of Kings
Seat 7: HighCardJasper folded on the Flop
Seat 8: appositive folded on the Flop
Seat 9: JeBoyDirk (button) folded on the Flop



PokerStars Home Game Hand #219636065440: {Club #3225207}  Hold'em No Limit (50/100) - 2020/10/22 16:50:00 ET
Table 'VU_table_tonight' 9-max (Play Money) Seat #1 is the button
Seat 1: color_singleton (10920 in chips) 
Seat 2: MnnM150 (8880 in chips) 
Seat 3: Duke Croix (25346 in chips) 
Seat 7: HighCardJasper (16969 in chips) 
Seat 8: appositive (4366 in chips) 
Seat 9: JeBoyDirk (21655 in chips) 
MnnM150: posts small blind 50
Duke Croix: posts big blind 100
*** HOLE CARDS ***
Dealt to Duke Croix [Ad Ah]
HighCardJasper: calls 100
appositive: folds 
JeBoyDirk: calls 100
color_singleton: folds 
MnnM150: calls 50
Duke Croix: raises 300 to 400
HighCardJasper: calls 300
JeBoyDirk: calls 300
MnnM150: calls 300
*** FLOP *** [3d Qc 6d]
MnnM150: checks 
Duke Croix: bets 1000
HighCardJasper: calls 1000
JeBoyDirk: raises 1900 to 2900
MnnM150: folds 
Duke Croix: calls 1900
HighCardJasper: folds 
*** TURN *** [3d Qc 6d] [4c]
Duke Croix: checks 
RichRick1337 joins the table at seat #6 
JeBoyDirk: bets 3000
Duke Croix: calls 3000
*** RIVER *** [3d Qc 6d 4c] [8h]
Duke Croix: checks 
JeBoyDirk: checks 
*** SHOW DOWN ***
Duke Croix: shows [Ad Ah] (a pair of Aces)
JeBoyDirk: mucks hand 
Duke Croix collected 13608 from pot
*** SUMMARY ***
Total pot 14400 | Rake 792 
Board [3d Qc 6d 4c 8h]
Seat 1: color_singleton (button) folded before Flop (didn't bet)
Seat 2: MnnM150 (small blind) folded on the Flop
Seat 3: Duke Croix (big blind) showed [Ad Ah] and won (13608) with a pair of Aces
Seat 7: HighCardJasper folded on the Flop
Seat 8: appositive folded before Flop (didn't bet)
Seat 9: JeBoyDirk mucked [Tc Qh]



PokerStars Home Game Hand #219636113209: {Club #3225207}  Hold'em No Limit (50/100) - 2020/10/22 16:51:22 ET
Table 'VU_table_tonight' 9-max (Play Money) Seat #2 is the button
Seat 1: color_singleton (10920 in chips) 
Seat 2: MnnM150 (8480 in chips) 
Seat 3: Duke Croix (32654 in chips) 
Seat 4: dddocky (10000 in chips) 
Seat 6: RichRick1337 (10000 in chips) 
Seat 7: HighCardJasper (15569 in chips) 
Seat 8: appositive (4366 in chips) 
Seat 9: JeBoyDirk (15355 in chips) 
Duke Croix: posts small blind 50
dddocky: posts big blind 100
RichRick1337: posts big blind 100
*** HOLE CARDS ***
Dealt to Duke Croix [Jd Qs]
RichRick1337: checks 
HighCardJasper: calls 100
appositive: folds 
JeBoyDirk: calls 100
color_singleton: raises 200 to 300
MnnM150: calls 300
Duke Croix: calls 250
dddocky: folds 
RichRick1337: calls 200
HighCardJasper: calls 200
JeBoyDirk: calls 200
*** FLOP *** [2h Kc 6h]
Duke Croix: checks 
RichRick1337: checks 
HighCardJasper: checks 
JeBoyDirk: checks 
color_singleton: checks 
MnnM150: checks 
*** TURN *** [2h Kc 6h] [7c]
Duke Croix: checks 
RichRick1337: checks 
HighCardJasper: checks 
JeBoyDirk: checks 
color_singleton: checks 
MnnM150: checks 
*** RIVER *** [2h Kc 6h 7c] [3h]
Duke Croix: checks 
RichRick1337: checks 
HighCardJasper: checks 
JeBoyDirk: checks 
color_singleton: checks 
MnnM150: checks 
*** SHOW DOWN ***
Duke Croix: shows [Jd Qs] (high card King)
RichRick1337: mucks hand 
HighCardJasper: shows [Ad 3s] (a pair of Threes)
JeBoyDirk: mucks hand 
color_singleton: shows [7s Ac] (a pair of Sevens)
MnnM150: mucks hand 
color_singleton collected 1795 from pot
*** SUMMARY ***
Total pot 1900 | Rake 105 
Board [2h Kc 6h 7c 3h]
Seat 1: color_singleton showed [7s Ac] and won (1795) with a pair of Sevens
Seat 2: MnnM150 (button) mucked [Qh Td]
Seat 3: Duke Croix (small blind) showed [Jd Qs] and lost with high card King
Seat 4: dddocky (big blind) folded before Flop
Seat 6: RichRick1337 mucked [5s Js]
Seat 7: HighCardJasper showed [Ad 3s] and lost with a pair of Threes
Seat 8: appositive folded before Flop (didn't bet)
Seat 9: JeBoyDirk mucked [5c As]



PokerStars Home Game Hand #219636153371: {Club #3225207}  Hold'em No Limit (50/100) - 2020/10/22 16:52:31 ET
Table 'VU_table_tonight' 9-max (Play Money) Seat #3 is the button
Seat 1: color_singleton (12415 in chips) 
Seat 2: MnnM150 (8180 in chips) 
Seat 3: Duke Croix (32354 in chips) 
Seat 4: dddocky (9900 in chips) 
Seat 6: RichRick1337 (9700 in chips) 
Seat 7: HighCardJasper (15269 in chips) 
Seat 8: appositive (4366 in chips) 
Seat 9: JeBoyDirk (15055 in chips) 
dddocky: posts small blind 50
RichRick1337: posts big blind 100
*** HOLE CARDS ***
Dealt to Duke Croix [Js Ah]
HighCardJasper: calls 100
appositive: folds 
JeBoyDirk: folds 
color_singleton: folds 
MnnM150: folds 
Duke Croix: raises 300 to 400
dddocky: calls 350
RichRick1337: calls 300
HighCardJasper: folds 
*** FLOP *** [4c 3c Jh]
dddocky: bets 614
RichRick1337: folds 
Duke Croix: calls 614
*** TURN *** [4c 3c Jh] [Ac]
dddocky: bets 2389
Duke Croix: calls 2389
*** RIVER *** [4c 3c Jh Ac] [8s]
dddocky: checks 
Duke Croix: bets 3500
dddocky: calls 3500
*** SHOW DOWN ***
Duke Croix: shows [Js Ah] (two pair, Aces and Jacks)
dddocky: mucks hand 
Duke Croix collected 13519 from pot
*** SUMMARY ***
Total pot 14306 | Rake 787 
Board [4c 3c Jh Ac 8s]
Seat 1: color_singleton folded before Flop (didn't bet)
Seat 2: MnnM150 folded before Flop (didn't bet)
Seat 3: Duke Croix (button) showed [Js Ah] and won (13519) with two pair, Aces and Jacks
Seat 4: dddocky (small blind) mucked [Jc Th]
Seat 6: RichRick1337 (big blind) folded on the Flop
Seat 7: HighCardJasper folded before Flop
Seat 8: appositive folded before Flop (didn't bet)
Seat 9: JeBoyDirk folded before Flop (didn't bet)



PokerStars Home Game Hand #219636181155: {Club #3225207}  Hold'em No Limit (50/100) - 2020/10/22 16:53:18 ET
Table 'VU_table_tonight' 9-max (Play Money) Seat #4 is the button
Seat 1: color_singleton (12415 in chips) 
Seat 2: MnnM150 (8180 in chips) 
Seat 3: Duke Croix (38970 in chips) 
Seat 4: dddocky (2997 in chips) 
Seat 6: RichRick1337 (9300 in chips) 
Seat 7: HighCardJasper (15169 in chips) 
Seat 8: appositive (4366 in chips) 
Seat 9: JeBoyDirk (15055 in chips) 
RichRick1337: posts small blind 50
HighCardJasper: posts big blind 100
*** HOLE CARDS ***
Dealt to Duke Croix [8h 5s]
appositive: folds 
JeBoyDirk: folds 
color_singleton: raises 200 to 300
MnnM150: folds 
Duke Croix: folds 
dddocky: folds 
RichRick1337: calls 250
HighCardJasper: calls 200
*** FLOP *** [Ts 7h 4h]
RichRick1337: checks 
HighCardJasper: checks 
color_singleton: bets 425
RichRick1337: folds 
HighCardJasper: calls 425
*** TURN *** [Ts 7h 4h] [6d]
HighCardJasper: checks 
color_singleton: checks 
*** RIVER *** [Ts 7h 4h 6d] [Qs]
HighCardJasper: checks 
color_singleton: checks 
*** SHOW DOWN ***
HighCardJasper: shows [Jc As] (high card Ace)
color_singleton: mucks hand 
HighCardJasper collected 1654 from pot
*** SUMMARY ***
Total pot 1750 | Rake 96 
Board [Ts 7h 4h 6d Qs]
Seat 1: color_singleton mucked [Ah 3h]
Seat 2: MnnM150 folded before Flop (didn't bet)
Seat 3: Duke Croix folded before Flop (didn't bet)
Seat 4: dddocky (button) folded before Flop (didn't bet)
Seat 6: RichRick1337 (small blind) folded on the Flop
Seat 7: HighCardJasper (big blind) showed [Jc As] and won (1654) with high card Ace
Seat 8: appositive folded before Flop (didn't bet)
Seat 9: JeBoyDirk folded before Flop (didn't bet)



PokerStars Home Game Hand #219636206698: {Club #3225207}  Hold'em No Limit (50/100) - 2020/10/22 16:54:03 ET
Table 'VU_table_tonight' 9-max (Play Money) Seat #6 is the button
Seat 1: color_singleton (11690 in chips) 
Seat 2: MnnM150 (8180 in chips) 
Seat 3: Duke Croix (38970 in chips) 
Seat 4: dddocky (2997 in chips) 
Seat 6: RichRick1337 (9000 in chips) 
Seat 7: HighCardJasper (16098 in chips) 
Seat 8: appositive (4366 in chips) 
Seat 9: JeBoyDirk (15055 in chips) 
HighCardJasper: posts small blind 50
appositive: posts big blind 100
*** HOLE CARDS ***
Dealt to Duke Croix [6s Qc]
JeBoyDirk: folds 
color_singleton: folds 
MnnM150: calls 100
Duke Croix: folds 
dddocky: calls 100
RichRick1337: calls 100
HighCardJasper: calls 50
appositive: checks 
*** FLOP *** [8d 3d 4d]
HighCardJasper: bets 200
appositive: calls 200
MnnM150: calls 200
dddocky: folds 
RichRick1337: raises 200 to 400
HighCardJasper: calls 200
appositive: folds 
MnnM150: folds 
*** TURN *** [8d 3d 4d] [7h]
HighCardJasper: checks 
RichRick1337: bets 100
HighCardJasper: calls 100
*** RIVER *** [8d 3d 4d 7h] [Kc]
HighCardJasper: bets 600
RichRick1337: calls 600
*** SHOW DOWN ***
HighCardJasper: shows [Jh Kd] (a pair of Kings)
RichRick1337: mucks hand 
HighCardJasper collected 2929 from pot
*** SUMMARY ***
Total pot 3100 | Rake 171 
Board [8d 3d 4d 7h Kc]
Seat 1: color_singleton folded before Flop (didn't bet)
Seat 2: MnnM150 folded on the Flop
Seat 3: Duke Croix folded before Flop (didn't bet)
Seat 4: dddocky folded on the Flop
Seat 6: RichRick1337 (button) mucked [Jd 3h]
Seat 7: HighCardJasper (small blind) showed [Jh Kd] and won (2929) with a pair of Kings
Seat 8: appositive (big blind) folded on the Flop
Seat 9: JeBoyDirk folded before Flop (didn't bet)



PokerStars Home Game Hand #219636236459: {Club #3225207}  Hold'em No Limit (50/100) - 2020/10/22 16:54:54 ET
Table 'VU_table_tonight' 9-max (Play Money) Seat #7 is the button
Seat 1: color_singleton (11690 in chips) 
Seat 2: MnnM150 (7880 in chips) 
Seat 3: Duke Croix (38970 in chips) 
Seat 4: dddocky (2897 in chips) 
Seat 6: RichRick1337 (7800 in chips) 
Seat 7: HighCardJasper (17827 in chips) 
Seat 8: appositive (4066 in chips) 
Seat 9: JeBoyDirk (15055 in chips) 
appositive: posts small blind 50
JeBoyDirk: posts big blind 100
*** HOLE CARDS ***
Dealt to Duke Croix [Jc 9d]
color_singleton: folds 
MnnM150: calls 100
Duke Croix has timed out
Duke Croix: folds 
dddocky: calls 100
RichRick1337: calls 100
HighCardJasper: raises 200 to 300
appositive: folds 
JeBoyDirk: folds 
MnnM150: calls 200
dddocky: folds 
RichRick1337: calls 200
*** FLOP *** [4h 3s 5s]
MnnM150: checks 
RichRick1337: checks 
HighCardJasper: bets 300
MnnM150: folds 
RichRick1337: calls 300
*** TURN *** [4h 3s 5s] [9c]
RichRick1337: checks 
HighCardJasper: bets 600
RichRick1337: calls 600
*** RIVER *** [4h 3s 5s 9c] [6c]
RichRick1337: checks 
HighCardJasper: checks 
*** SHOW DOWN ***
RichRick1337: shows [Kh 3h] (a pair of Threes)
HighCardJasper: shows [Jd Jh] (a pair of Jacks)
HighCardJasper collected 2788 from pot
*** SUMMARY ***
Total pot 2950 | Rake 162 
Board [4h 3s 5s 9c 6c]
Seat 1: color_singleton folded before Flop (didn't bet)
Seat 2: MnnM150 folded on the Flop
Seat 3: Duke Croix folded before Flop (didn't bet)
Seat 4: dddocky folded before Flop
Seat 6: RichRick1337 showed [Kh 3h] and lost with a pair of Threes
Seat 7: HighCardJasper (button) showed [Jd Jh] and won (2788) with a pair of Jacks
Seat 8: appositive (small blind) folded before Flop
Seat 9: JeBoyDirk (big blind) folded before Flop



PokerStars Home Game Hand #219636275642: {Club #3225207}  Hold'em No Limit (50/100) - 2020/10/22 16:56:17 ET
Table 'VU_table_tonight' 9-max (Play Money) Seat #8 is the button
Seat 1: color_singleton (11690 in chips) 
Seat 2: MnnM150 (7580 in chips) 
Seat 3: Duke Croix (38970 in chips) 
Seat 4: dddocky (2797 in chips) 
Seat 6: RichRick1337 (6600 in chips) 
Seat 7: HighCardJasper (19415 in chips) 
Seat 8: appositive (4016 in chips) 
Seat 9: JeBoyDirk (14955 in chips) 
JeBoyDirk: posts small blind 50
color_singleton: posts big blind 100
*** HOLE CARDS ***
Dealt to Duke Croix [5s Js]
MnnM150: calls 100
Duke Croix: folds 
dddocky: folds 
RichRick1337: calls 100
HighCardJasper: calls 100
appositive: calls 100
JeBoyDirk: calls 50
color_singleton: raises 300 to 400
MnnM150: folds 
RichRick1337: calls 300
HighCardJasper: calls 300
appositive: calls 300
JeBoyDirk: calls 300
*** FLOP *** [Ah 4s 9d]
JeBoyDirk: checks 
color_singleton: bets 992
RichRick1337: folds 
HighCardJasper: folds 
appositive: calls 992
JeBoyDirk: folds 
*** TURN *** [Ah 4s 9d] [Th]
color_singleton: bets 1929
appositive: raises 695 to 2624 and is all-in
color_singleton: calls 695
*** RIVER *** [Ah 4s 9d Th] [As]
*** SHOW DOWN ***
color_singleton: shows [Ts Tc] (a full house, Tens full of Aces)
appositive: shows [6c Ac] (three of a kind, Aces)
color_singleton collected 8819 from pot
*** SUMMARY ***
Total pot 9332 | Rake 513 
Board [Ah 4s 9d Th As]
Seat 1: color_singleton (big blind) showed [Ts Tc] and won (8819) with a full house, Tens full of Aces
Seat 2: MnnM150 folded before Flop
Seat 3: Duke Croix folded before Flop (didn't bet)
Seat 4: dddocky folded before Flop (didn't bet)
Seat 6: RichRick1337 folded on the Flop
Seat 7: HighCardJasper folded on the Flop
Seat 8: appositive (button) showed [6c Ac] and lost with three of a kind, Aces
Seat 9: JeBoyDirk (small blind) folded on the Flop



PokerStars Home Game Hand #219636311671: {Club #3225207}  Hold'em No Limit (50/100) - 2020/10/22 16:57:22 ET
Table 'VU_table_tonight' 9-max (Play Money) Seat #9 is the button
Seat 1: color_singleton (16493 in chips) 
Seat 2: MnnM150 (7480 in chips) 
Seat 3: Duke Croix (38970 in chips) 
Seat 4: dddocky (2797 in chips) 
Seat 6: RichRick1337 (6200 in chips) 
Seat 7: HighCardJasper (19015 in chips) 
Seat 9: JeBoyDirk (14555 in chips) 
color_singleton: posts small blind 50
MnnM150: posts big blind 100
*** HOLE CARDS ***
Dealt to Duke Croix [7h Ad]
Duke Croix: folds 
dddocky: folds 
RichRick1337: folds 
HighCardJasper: calls 100
JeBoyDirk: folds 
color_singleton: raises 100 to 200
MnnM150: calls 100
HighCardJasper: calls 100
*** FLOP *** [Ts 5c Ks]
color_singleton: checks 
MnnM150: checks 
HighCardJasper: checks 
*** TURN *** [Ts 5c Ks] [3c]
color_singleton: bets 283
MnnM150: folds 
HighCardJasper: folds 
Uncalled bet (283) returned to color_singleton
color_singleton collected 567 from pot
color_singleton: doesn't show hand 
*** SUMMARY ***
Total pot 600 | Rake 33 
Board [Ts 5c Ks 3c]
Seat 1: color_singleton (small blind) collected (567)
Seat 2: MnnM150 (big blind) folded on the Turn
Seat 3: Duke Croix folded before Flop (didn't bet)
Seat 4: dddocky folded before Flop (didn't bet)
Seat 6: RichRick1337 folded before Flop (didn't bet)
Seat 7: HighCardJasper folded on the Turn
Seat 9: JeBoyDirk (button) folded before Flop (didn't bet)



PokerStars Home Game Hand #219636331252: {Club #3225207}  Hold'em No Limit (50/100) - 2020/10/22 16:58:07 ET
Table 'VU_table_tonight' 9-max (Play Money) Seat #1 is the button
Seat 1: color_singleton (16860 in chips) 
Seat 2: MnnM150 (7280 in chips) 
Seat 3: Duke Croix (38970 in chips) 
Seat 4: dddocky (2797 in chips) 
Seat 6: RichRick1337 (6200 in chips) 
Seat 7: HighCardJasper (18815 in chips) 
Seat 9: JeBoyDirk (14555 in chips) 
MnnM150: posts small blind 50
Duke Croix: posts big blind 100
*** HOLE CARDS ***
Dealt to Duke Croix [3d 4s]
dddocky: folds 
RichRick1337: folds 
HighCardJasper: calls 100
JeBoyDirk: raises 200 to 300
color_singleton: folds 
MnnM150: calls 250
Duke Croix: calls 200
HighCardJasper: calls 200
*** FLOP *** [Qs Kh 8d]
MnnM150: bets 567
Duke Croix: folds 
HighCardJasper: calls 567
JeBoyDirk: raises 567 to 1134
MnnM150: calls 567
HighCardJasper: calls 567
*** TURN *** [Qs Kh 8d] [8s]
MnnM150: checks 
HighCardJasper: checks 
JeBoyDirk: bets 2100
MnnM150: folds 
HighCardJasper: folds 
Uncalled bet (2100) returned to JeBoyDirk
JeBoyDirk collected 4349 from pot
*** SUMMARY ***
Total pot 4602 | Rake 253 
Board [Qs Kh 8d 8s]
Seat 1: color_singleton (button) folded before Flop (didn't bet)
Seat 2: MnnM150 (small blind) folded on the Turn
Seat 3: Duke Croix (big blind) folded on the Flop
Seat 4: dddocky folded before Flop (didn't bet)
Seat 6: RichRick1337 folded before Flop (didn't bet)
Seat 7: HighCardJasper folded on the Turn
Seat 9: JeBoyDirk collected (4349)



PokerStars Home Game Hand #219636364868: {Club #3225207}  Hold'em No Limit (50/100) - 2020/10/22 16:59:23 ET
Table 'VU_table_tonight' 9-max (Play Money) Seat #2 is the button
Seat 1: color_singleton (16860 in chips) 
Seat 2: MnnM150 (5846 in chips) 
Seat 3: Duke Croix (38670 in chips) 
Seat 4: dddocky (2797 in chips) 
Seat 6: RichRick1337 (6200 in chips) 
Seat 7: HighCardJasper (17381 in chips) 
Seat 8: appositive (10000 in chips) 
Seat 9: JeBoyDirk (17470 in chips) 
Duke Croix: posts small blind 50
dddocky: posts big blind 100
*** HOLE CARDS ***
Dealt to Duke Croix [3s 8c]
RichRick1337: calls 100
HighCardJasper: calls 100
appositive: folds 
JeBoyDirk: folds 
color_singleton: folds 
MnnM150: calls 100
Duke Croix: folds 
dddocky: checks 
*** FLOP *** [Qc Tc Qh]
dddocky: checks 
RichRick1337: bets 200
HighCardJasper: folds 
MnnM150: calls 200
dddocky: calls 200
*** TURN *** [Qc Tc Qh] [9s]
dddocky: checks 
RichRick1337: checks 
MnnM150: bets 992
dddocky: folds 
RichRick1337: folds 
Uncalled bet (992) returned to MnnM150
MnnM150 collected 992 from pot
*** SUMMARY ***
Total pot 1050 | Rake 58 
Board [Qc Tc Qh 9s]
Seat 1: color_singleton folded before Flop (didn't bet)
Seat 2: MnnM150 (button) collected (992)
Seat 3: Duke Croix (small blind) folded before Flop
Seat 4: dddocky (big blind) folded on the Turn
Seat 6: RichRick1337 folded on the Turn
Seat 7: HighCardJasper folded on the Flop
Seat 8: appositive folded before Flop (didn't bet)
Seat 9: JeBoyDirk folded before Flop (didn't bet)



PokerStars Home Game Hand #219636389053: {Club #3225207}  Hold'em No Limit (50/100) - 2020/10/22 17:00:17 ET
Table 'VU_table_tonight' 9-max (Play Money) Seat #3 is the button
Seat 1: color_singleton (16860 in chips) 
Seat 2: MnnM150 (6538 in chips) 
Seat 3: Duke Croix (38620 in chips) 
Seat 4: dddocky (2497 in chips) 
Seat 6: RichRick1337 (5900 in chips) 
Seat 7: HighCardJasper (17281 in chips) 
Seat 8: appositive (10000 in chips) 
Seat 9: JeBoyDirk (17470 in chips) 
dddocky: posts small blind 50
RichRick1337: posts big blind 100
*** HOLE CARDS ***
Dealt to Duke Croix [Qs 2s]
HighCardJasper: calls 100
appositive: folds 
JeBoyDirk: calls 100
color_singleton: folds 
MnnM150: folds 
Duke Croix: folds 
dddocky: calls 50
RichRick1337: checks 
*** FLOP *** [Kc 9s Th]
dddocky: bets 100
RichRick1337: calls 100
HighCardJasper: calls 100
JeBoyDirk: calls 100
*** TURN *** [Kc 9s Th] [6h]
dddocky: bets 100
RichRick1337: calls 100
HighCardJasper: raises 100 to 200
JeBoyDirk: raises 100 to 300
dddocky: calls 200
RichRick1337: calls 200
HighCardJasper: calls 100
*** RIVER *** [Kc 9s Th 6h] [8s]
dddocky: checks 
RichRick1337: checks 
HighCardJasper: checks 
JeBoyDirk: bets 500
dddocky: calls 500
RichRick1337: calls 500
HighCardJasper: folds 
*** SHOW DOWN ***
JeBoyDirk: shows [8h 7c] (a straight, Six to Ten)
dddocky: mucks hand 
RichRick1337: mucks hand 
JeBoyDirk collected 3307 from pot
*** SUMMARY ***
Total pot 3500 | Rake 193 
Board [Kc 9s Th 6h 8s]
Seat 1: color_singleton folded before Flop (didn't bet)
Seat 2: MnnM150 folded before Flop (didn't bet)
Seat 3: Duke Croix (button) folded before Flop (didn't bet)
Seat 4: dddocky (small blind) mucked [Kh Qh]
Seat 6: RichRick1337 (big blind) mucked [5s Tc]
Seat 7: HighCardJasper folded on the River
Seat 8: appositive folded before Flop (didn't bet)
Seat 9: JeBoyDirk showed [8h 7c] and won (3307) with a straight, Six to Ten



PokerStars Home Game Hand #219636432400: {Club #3225207}  Hold'em No Limit (50/100) - 2020/10/22 17:01:43 ET
Table 'VU_table_tonight' 9-max (Play Money) Seat #4 is the button
Seat 1: color_singleton (16860 in chips) 
Seat 2: MnnM150 (6538 in chips) 
Seat 3: Duke Croix (38620 in chips) 
Seat 4: dddocky (1497 in chips) 
Seat 6: RichRick1337 (4900 in chips) 
Seat 7: HighCardJasper (16781 in chips) 
Seat 8: appositive (10000 in chips) 
Seat 9: JeBoyDirk (19777 in chips) 
RichRick1337: posts small blind 50
HighCardJasper: posts big blind 100
*** HOLE CARDS ***
Dealt to Duke Croix [6s 2s]
appositive: calls 100
JeBoyDirk: folds 
color_singleton: calls 100
MnnM150: folds 
Duke Croix: folds 
dddocky: calls 100
RichRick1337: calls 50
HighCardJasper: checks 
*** FLOP *** [9c 5s 3d]
RichRick1337: bets 100
HighCardJasper: calls 100
appositive: folds 
color_singleton: calls 100
dddocky: raises 100 to 200
RichRick1337: calls 100
HighCardJasper: calls 100
color_singleton: calls 100
*** TURN *** [9c 5s 3d] [Kc]
RichRick1337: checks 
HighCardJasper: checks 
color_singleton: checks 
dddocky: checks 
*** RIVER *** [9c 5s 3d Kc] [4s]
RichRick1337: bets 100
HighCardJasper: calls 100
color_singleton: calls 100
dddocky: calls 100
*** SHOW DOWN ***
RichRick1337: shows [As 3h] (a pair of Threes)
HighCardJasper: shows [5d 8s] (a pair of Fives)
color_singleton: shows [Tc 9d] (a pair of Nines)
dddocky: shows [9h Qd] (a pair of Nines - King+Queen kicker)
dddocky collected 1606 from pot
*** SUMMARY ***
Total pot 1700 | Rake 94 
Board [9c 5s 3d Kc 4s]
Seat 1: color_singleton showed [Tc 9d] and lost with a pair of Nines
Seat 2: MnnM150 folded before Flop (didn't bet)
Seat 3: Duke Croix folded before Flop (didn't bet)
Seat 4: dddocky (button) showed [9h Qd] and won (1606) with a pair of Nines
Seat 6: RichRick1337 (small blind) showed [As 3h] and lost with a pair of Threes
Seat 7: HighCardJasper (big blind) showed [5d 8s] and lost with a pair of Fives
Seat 8: appositive folded on the Flop
Seat 9: JeBoyDirk folded before Flop (didn't bet)



PokerStars Home Game Hand #219636470023: {Club #3225207}  Hold'em No Limit (50/100) - 2020/10/22 17:02:49 ET
Table 'VU_table_tonight' 9-max (Play Money) Seat #6 is the button
Seat 1: color_singleton (16460 in chips) 
Seat 2: MnnM150 (6538 in chips) 
Seat 3: Duke Croix (38620 in chips) 
Seat 4: dddocky (2703 in chips) 
Seat 6: RichRick1337 (4500 in chips) 
Seat 7: HighCardJasper (16381 in chips) 
Seat 8: appositive (9900 in chips) 
Seat 9: JeBoyDirk (19777 in chips) 
HighCardJasper: posts small blind 50
appositive: posts big blind 100
*** HOLE CARDS ***
Dealt to Duke Croix [7h 4s]
JeBoyDirk: folds 
color_singleton: folds 
MnnM150: calls 100
Duke Croix: folds 
dddocky: folds 
RichRick1337: folds 
HighCardJasper: calls 50
appositive: checks 
*** FLOP *** [3s Kd Qc]
HighCardJasper: checks 
appositive: checks 
MnnM150: checks 
*** TURN *** [3s Kd Qc] [Ac]
HighCardJasper: checks 
appositive: checks 
MnnM150: bets 100
HighCardJasper: calls 100
appositive: calls 100
*** RIVER *** [3s Kd Qc Ac] [3d]
HighCardJasper: checks 
appositive: checks 
MnnM150: bets 567
HighCardJasper: folds 
appositive: folds 
Uncalled bet (567) returned to MnnM150
MnnM150 collected 567 from pot
*** SUMMARY ***
Total pot 600 | Rake 33 
Board [3s Kd Qc Ac 3d]
Seat 1: color_singleton folded before Flop (didn't bet)
Seat 2: MnnM150 collected (567)
Seat 3: Duke Croix folded before Flop (didn't bet)
Seat 4: dddocky folded before Flop (didn't bet)
Seat 6: RichRick1337 (button) folded before Flop (didn't bet)
Seat 7: HighCardJasper (small blind) folded on the River
Seat 8: appositive (big blind) folded on the River
Seat 9: JeBoyDirk folded before Flop (didn't bet)



PokerStars Home Game Hand #219636494238: {Club #3225207}  Hold'em No Limit (50/100) - 2020/10/22 17:03:31 ET
Table 'VU_table_tonight' 9-max (Play Money) Seat #7 is the button
Seat 1: color_singleton (16460 in chips) 
Seat 2: MnnM150 (6905 in chips) 
Seat 3: Duke Croix (38620 in chips) 
Seat 4: dddocky (2703 in chips) 
Seat 6: RichRick1337 (4500 in chips) 
Seat 7: HighCardJasper (16181 in chips) 
Seat 8: appositive (9700 in chips) 
Seat 9: JeBoyDirk (19777 in chips) 
appositive: posts small blind 50
JeBoyDirk: posts big blind 100
*** HOLE CARDS ***
Dealt to Duke Croix [3c 7d]
color_singleton: folds 
MnnM150: calls 100
Duke Croix: folds 
dddocky: raises 100 to 200
RichRick1337: calls 200
HighCardJasper: calls 200
appositive: folds 
JeBoyDirk: folds 
MnnM150: calls 100
*** FLOP *** [Jh 2d 9d]
MnnM150: checks 
dddocky: bets 100
RichRick1337: raises 100 to 200
HighCardJasper: calls 200
MnnM150: calls 200
dddocky: raises 100 to 300
RichRick1337: raises 100 to 400
HighCardJasper: calls 200
MnnM150: folds 
dddocky: raises 100 to 500
RichRick1337: calls 100
HighCardJasper: calls 100
*** TURN *** [Jh 2d 9d] [6h]
dddocky: bets 100
RichRick1337: raises 100 to 200
HighCardJasper: calls 200
dddocky: calls 100
*** RIVER *** [Jh 2d 9d 6h] [Qs]
dddocky: checks 
RichRick1337: bets 300
HighCardJasper: calls 300
dddocky: calls 300
*** SHOW DOWN ***
RichRick1337: shows [Jd 6d] (two pair, Jacks and Sixes)
HighCardJasper: mucks hand 
dddocky: mucks hand 
RichRick1337 collected 3922 from pot
*** SUMMARY ***
Total pot 4150 | Rake 228 
Board [Jh 2d 9d 6h Qs]
Seat 1: color_singleton folded before Flop (didn't bet)
Seat 2: MnnM150 folded on the Flop
Seat 3: Duke Croix folded before Flop (didn't bet)
Seat 4: dddocky mucked [Ad Ah]
Seat 6: RichRick1337 showed [Jd 6d] and won (3922) with two pair, Jacks and Sixes
Seat 7: HighCardJasper (button) mucked [9h Th]
Seat 8: appositive (small blind) folded before Flop
Seat 9: JeBoyDirk (big blind) folded before Flop



PokerStars Home Game Hand #219636533131: {Club #3225207}  Hold'em No Limit (50/100) - 2020/10/22 17:04:37 ET
Table 'VU_table_tonight' 9-max (Play Money) Seat #8 is the button
Seat 1: color_singleton (16460 in chips) 
Seat 2: MnnM150 (6505 in chips) 
Seat 3: Duke Croix (38620 in chips) 
Seat 4: dddocky (1503 in chips) 
Seat 6: RichRick1337 (7222 in chips) 
Seat 7: HighCardJasper (14981 in chips) 
Seat 8: appositive (9650 in chips) 
Seat 9: JeBoyDirk (19677 in chips) 
JeBoyDirk: posts small blind 50
color_singleton: posts big blind 100
*** HOLE CARDS ***
Dealt to Duke Croix [6c 4h]
MnnM150: calls 100
Duke Croix: folds 
dddocky: calls 100
RichRick1337: folds 
HighCardJasper: calls 100
appositive: folds 
JeBoyDirk: calls 50
color_singleton: checks 
*** FLOP *** [5h 8h 7s]
JeBoyDirk: checks 
color_singleton: checks 
MnnM150: checks 
dddocky: checks 
HighCardJasper: checks 
*** TURN *** [5h 8h 7s] [Qs]
JeBoyDirk: checks 
color_singleton: bets 300
MnnM150: folds 
dddocky: folds 
HighCardJasper: calls 300
JeBoyDirk: folds 
*** RIVER *** [5h 8h 7s Qs] [Kh]
color_singleton: bets 519
HighCardJasper: raises 519 to 1038
color_singleton: folds 
Uncalled bet (519) returned to HighCardJasper
HighCardJasper collected 2020 from pot
HighCardJasper: doesn't show hand 
*** SUMMARY ***
Total pot 2138 | Rake 118 
Board [5h 8h 7s Qs Kh]
Seat 1: color_singleton (big blind) folded on the River
Seat 2: MnnM150 folded on the Turn
Seat 3: Duke Croix folded before Flop (didn't bet)
Seat 4: dddocky folded on the Turn
Seat 6: RichRick1337 folded before Flop (didn't bet)
Seat 7: HighCardJasper collected (2020)
Seat 8: appositive (button) folded before Flop (didn't bet)
Seat 9: JeBoyDirk (small blind) folded on the Turn



PokerStars Home Game Hand #219636563229: {Club #3225207}  Hold'em No Limit (50/100) - 2020/10/22 17:05:28 ET
Table 'VU_table_tonight' 9-max (Play Money) Seat #9 is the button
Seat 1: color_singleton (15541 in chips) 
Seat 2: MnnM150 (6405 in chips) 
Seat 3: Duke Croix (38620 in chips) 
Seat 4: dddocky (1403 in chips) 
Seat 6: RichRick1337 (7222 in chips) 
Seat 7: HighCardJasper (16082 in chips) 
Seat 8: appositive (9650 in chips) 
Seat 9: JeBoyDirk (19577 in chips) 
color_singleton: posts small blind 50
MnnM150: posts big blind 100
*** HOLE CARDS ***
Dealt to Duke Croix [3c Kh]
Duke Croix: folds 
dddocky: calls 100
RichRick1337: raises 100 to 200
HighCardJasper: calls 200
appositive: folds 
JeBoyDirk: folds 
color_singleton: folds 
MnnM150: calls 100
dddocky: raises 100 to 300
RichRick1337: calls 100
HighCardJasper: folds 
MnnM150: calls 100
*** FLOP *** [2c 4s 6d]
MnnM150: checks 
dddocky: checks 
RichRick1337: checks 
*** TURN *** [2c 4s 6d] [2d]
MnnM150: checks 
dddocky: checks 
RichRick1337: checks 
*** RIVER *** [2c 4s 6d 2d] [6c]
MnnM150: checks 
dddocky: checks 
RichRick1337: checks 
*** SHOW DOWN ***
MnnM150: shows [Qh Kc] (two pair, Sixes and Deuces)
dddocky: shows [Js Ah] (two pair, Sixes and Deuces - Ace kicker)
RichRick1337: shows [Ad 7d] (two pair, Sixes and Deuces)
dddocky collected 544 from pot
RichRick1337 collected 543 from pot
*** SUMMARY ***
Total pot 1150 | Rake 63 
Board [2c 4s 6d 2d 6c]
Seat 1: color_singleton (small blind) folded before Flop
Seat 2: MnnM150 (big blind) showed [Qh Kc] and lost with two pair, Sixes and Deuces
Seat 3: Duke Croix folded before Flop (didn't bet)
Seat 4: dddocky showed [Js Ah] and won (544) with two pair, Sixes and Deuces
Seat 6: RichRick1337 showed [Ad 7d] and won (543) with two pair, Sixes and Deuces
Seat 7: HighCardJasper folded before Flop
Seat 8: appositive folded before Flop (didn't bet)
Seat 9: JeBoyDirk (button) folded before Flop (didn't bet)



PokerStars Home Game Hand #219636584349: {Club #3225207}  Hold'em No Limit (50/100) - 2020/10/22 17:06:04 ET
Table 'VU_table_tonight' 9-max (Play Money) Seat #1 is the button
Seat 1: color_singleton (15491 in chips) 
Seat 2: MnnM150 (6105 in chips) 
Seat 3: Duke Croix (38620 in chips) 
Seat 4: dddocky (1647 in chips) 
Seat 6: RichRick1337 (7465 in chips) 
Seat 7: HighCardJasper (15882 in chips) 
Seat 8: appositive (9650 in chips) 
Seat 9: JeBoyDirk (19577 in chips) 
MnnM150: posts small blind 50
Duke Croix: posts big blind 100
*** HOLE CARDS ***
Dealt to Duke Croix [5d 7c]
dddocky: folds 
RichRick1337: folds 
HighCardJasper: calls 100
appositive: folds 
JeBoyDirk: calls 100
color_singleton: raises 200 to 300
MnnM150: calls 250
Duke Croix: folds 
HighCardJasper: folds 
JeBoyDirk: calls 200
*** FLOP *** [3d Ac 9h]
MnnM150: checks 
JeBoyDirk: checks 
color_singleton: checks 
*** TURN *** [3d Ac 9h] [4h]
MnnM150: checks 
JeBoyDirk: checks 
color_singleton: checks 
*** RIVER *** [3d Ac 9h 4h] [7h]
MnnM150: checks 
JeBoyDirk: checks 
color_singleton: checks 
*** SHOW DOWN ***
MnnM150: shows [Js Kd] (high card Ace)
JeBoyDirk: mucks hand 
color_singleton: shows [Ts Td] (a pair of Tens)
color_singleton collected 1039 from pot
*** SUMMARY ***
Total pot 1100 | Rake 61 
Board [3d Ac 9h 4h 7h]
Seat 1: color_singleton (button) showed [Ts Td] and won (1039) with a pair of Tens
Seat 2: MnnM150 (small blind) showed [Js Kd] and lost with high card Ace
Seat 3: Duke Croix (big blind) folded before Flop
Seat 4: dddocky folded before Flop (didn't bet)
Seat 6: RichRick1337 folded before Flop (didn't bet)
Seat 7: HighCardJasper folded before Flop
Seat 8: appositive folded before Flop (didn't bet)
Seat 9: JeBoyDirk mucked [Jd Th]



PokerStars Home Game Hand #219636613209: {Club #3225207}  Hold'em No Limit (50/100) - 2020/10/22 17:06:54 ET
Table 'VU_table_tonight' 9-max (Play Money) Seat #2 is the button
Seat 1: color_singleton (16230 in chips) 
Seat 2: MnnM150 (5805 in chips) 
Seat 3: Duke Croix (38520 in chips) 
Seat 4: dddocky (1647 in chips) 
Seat 6: RichRick1337 (7465 in chips) 
Seat 7: HighCardJasper (15782 in chips) 
Seat 8: appositive (9650 in chips) 
Seat 9: JeBoyDirk (19277 in chips) 
Duke Croix: posts small blind 50
dddocky: posts big blind 100
*** HOLE CARDS ***
Dealt to Duke Croix [8d 3c]
RichRick1337: calls 100
HighCardJasper: calls 100
appositive: raises 100 to 200
JeBoyDirk: folds 
color_singleton: folds 
MnnM150: folds 
Duke Croix: folds 
dddocky: folds 
RichRick1337: calls 100
HighCardJasper: calls 100
*** FLOP *** [8s 2s Tc]
RichRick1337: checks 
HighCardJasper: bets 300
appositive: calls 300
RichRick1337: calls 300
*** TURN *** [8s 2s Tc] [Jc]
RichRick1337: checks 
HighCardJasper: bets 300
appositive: calls 300
RichRick1337: calls 300
*** RIVER *** [8s 2s Tc Jc] [4c]
RichRick1337: checks 
HighCardJasper: bets 1000
appositive: raises 1400 to 2400
RichRick1337: folds 
HighCardJasper: calls 1400
*** SHOW DOWN ***
appositive: shows [Ad Ks] (high card Ace)
HighCardJasper: shows [8h 2c] (two pair, Eights and Deuces)
HighCardJasper collected 6946 from pot
*** SUMMARY ***
Total pot 7350 | Rake 404 
Board [8s 2s Tc Jc 4c]
Seat 1: color_singleton folded before Flop (didn't bet)
Seat 2: MnnM150 (button) folded before Flop (didn't bet)
Seat 3: Duke Croix (small blind) folded before Flop
Seat 4: dddocky (big blind) folded before Flop
Seat 6: RichRick1337 folded on the River
Seat 7: HighCardJasper showed [8h 2c] and won (6946) with two pair, Eights and Deuces
Seat 8: appositive showed [Ad Ks] and lost with high card Ace
Seat 9: JeBoyDirk folded before Flop (didn't bet)



PokerStars Home Game Hand #219636658579: {Club #3225207}  Hold'em No Limit (50/100) - 2020/10/22 17:08:11 ET
Table 'VU_table_tonight' 9-max (Play Money) Seat #3 is the button
Seat 1: color_singleton (16230 in chips) 
Seat 2: MnnM150 (5805 in chips) 
Seat 3: Duke Croix (38470 in chips) 
Seat 4: dddocky (1547 in chips) 
Seat 6: RichRick1337 (6665 in chips) 
Seat 7: HighCardJasper (19528 in chips) 
Seat 8: appositive (6450 in chips) 
Seat 9: JeBoyDirk (19277 in chips) 
dddocky: posts small blind 50
RichRick1337: posts big blind 100
*** HOLE CARDS ***
Dealt to Duke Croix [5d Th]
HighCardJasper: calls 100
appositive: calls 100
JeBoyDirk: calls 100
color_singleton: folds 
MnnM150: calls 100
Duke Croix: folds 
dddocky: calls 50
RichRick1337: raises 100 to 200
HighCardJasper: calls 100
appositive: calls 100
JeBoyDirk: calls 100
MnnM150: calls 100
dddocky: calls 100
*** FLOP *** [8c 9d 4d]
dddocky: checks 
RichRick1337: checks 
HighCardJasper: checks 
appositive: bets 400
JeBoyDirk: folds 
MnnM150: folds 
dddocky: folds 
RichRick1337: calls 400
HighCardJasper: folds 
*** TURN *** [8c 9d 4d] [Kd]
RichRick1337: checks 
appositive: bets 945
RichRick1337: calls 945
*** RIVER *** [8c 9d 4d Kd] [6d]
RichRick1337: checks 
appositive: bets 3676
RichRick1337: folds 
Uncalled bet (3676) returned to appositive
appositive collected 3676 from pot
appositive: doesn't show hand 
*** SUMMARY ***
Total pot 3890 | Rake 214 
Board [8c 9d 4d Kd 6d]
Seat 1: color_singleton folded before Flop (didn't bet)
Seat 2: MnnM150 folded on the Flop
Seat 3: Duke Croix (button) folded before Flop (didn't bet)
Seat 4: dddocky (small blind) folded on the Flop
Seat 6: RichRick1337 (big blind) folded on the River
Seat 7: HighCardJasper folded on the Flop
Seat 8: appositive collected (3676)
Seat 9: JeBoyDirk folded on the Flop



PokerStars Home Game Hand #219636704215: {Club #3225207}  Hold'em No Limit (50/100) - 2020/10/22 17:09:29 ET
Table 'VU_table_tonight' 9-max (Play Money) Seat #4 is the button
Seat 1: color_singleton (16230 in chips) 
Seat 2: MnnM150 (5605 in chips) 
Seat 3: Duke Croix (38470 in chips) 
Seat 4: dddocky (1347 in chips) 
Seat 6: RichRick1337 (5120 in chips) 
Seat 7: HighCardJasper (19328 in chips) 
Seat 8: appositive (8581 in chips) 
Seat 9: JeBoyDirk (19077 in chips) 
RichRick1337: posts small blind 50
HighCardJasper: posts big blind 100
*** HOLE CARDS ***
Dealt to Duke Croix [2s As]
appositive: calls 100
JeBoyDirk: folds 
color_singleton: folds 
MnnM150: calls 100
Duke Croix: raises 300 to 400
dddocky: folds 
RichRick1337: calls 350
HighCardJasper: calls 300
appositive: calls 300
MnnM150: calls 300
*** FLOP *** [Ah Tc Qs]
RichRick1337: checks 
HighCardJasper: checks 
appositive: checks 
MnnM150: bets 945
Duke Croix: calls 945
RichRick1337: folds 
HighCardJasper: folds 
appositive: folds 
*** TURN *** [Ah Tc Qs] [6h]
MnnM150: bets 1838
Duke Croix: folds 
Uncalled bet (1838) returned to MnnM150
MnnM150 collected 3676 from pot
*** SUMMARY ***
Total pot 3890 | Rake 214 
Board [Ah Tc Qs 6h]
Seat 1: color_singleton folded before Flop (didn't bet)
Seat 2: MnnM150 collected (3676)
Seat 3: Duke Croix folded on the Turn
Seat 4: dddocky (button) folded before Flop (didn't bet)
Seat 6: RichRick1337 (small blind) folded on the Flop
Seat 7: HighCardJasper (big blind) folded on the Flop
Seat 8: appositive folded on the Flop
Seat 9: JeBoyDirk folded before Flop (didn't bet)



PokerStars Home Game Hand #219636744575: {Club #3225207}  Hold'em No Limit (50/100) - 2020/10/22 17:10:38 ET
Table 'VU_table_tonight' 9-max (Play Money) Seat #6 is the button
Seat 1: color_singleton (16230 in chips) 
Seat 2: MnnM150 (7936 in chips) 
Seat 3: Duke Croix (37125 in chips) 
Seat 4: dddocky (1347 in chips) 
Seat 6: RichRick1337 (4720 in chips) 
Seat 7: HighCardJasper (18928 in chips) 
Seat 8: appositive (8181 in chips) 
Seat 9: JeBoyDirk (19077 in chips) 
HighCardJasper: posts small blind 50
appositive: posts big blind 100
*** HOLE CARDS ***
Dealt to Duke Croix [Tc 8s]
JeBoyDirk: calls 100
color_singleton is disconnected 
color_singleton has timed out while disconnected
color_singleton: folds 
MnnM150: calls 100
Duke Croix: folds 
dddocky: calls 100
RichRick1337: folds 
HighCardJasper: calls 50
appositive: checks 
*** FLOP *** [9d 5s Kc]
HighCardJasper: checks 
appositive: checks 
JeBoyDirk: checks 
MnnM150: checks 
dddocky: checks 
*** TURN *** [9d 5s Kc] [8d]
HighCardJasper: checks 
appositive: checks 
JeBoyDirk: checks 
MnnM150: checks 
dddocky: checks 
*** RIVER *** [9d 5s Kc 8d] [2d]
HighCardJasper: checks 
appositive: checks 
JeBoyDirk: checks 
MnnM150: bets 472
dddocky: folds 
HighCardJasper: folds 
appositive: folds 
JeBoyDirk: folds 
Uncalled bet (472) returned to MnnM150
MnnM150 collected 472 from pot
*** SUMMARY ***
Total pot 500 | Rake 28 
Board [9d 5s Kc 8d 2d]
Seat 1: color_singleton folded before Flop (didn't bet)
Seat 2: MnnM150 collected (472)
Seat 3: Duke Croix folded before Flop (didn't bet)
Seat 4: dddocky folded on the River
Seat 6: RichRick1337 (button) folded before Flop (didn't bet)
Seat 7: HighCardJasper (small blind) folded on the River
Seat 8: appositive (big blind) folded on the River
Seat 9: JeBoyDirk folded on the River



PokerStars Home Game Hand #219636784431: {Club #3225207}  Hold'em No Limit (50/100) - 2020/10/22 17:11:46 ET
Table 'VU_table_tonight' 9-max (Play Money) Seat #7 is the button
Seat 2: MnnM150 (8308 in chips) 
Seat 3: Duke Croix (37125 in chips) 
Seat 4: dddocky (1247 in chips) 
Seat 6: RichRick1337 (4720 in chips) 
Seat 7: HighCardJasper (18828 in chips) 
Seat 8: appositive (8081 in chips) 
Seat 9: JeBoyDirk (18977 in chips) 
appositive: posts small blind 50
JeBoyDirk: posts big blind 100
*** HOLE CARDS ***
Dealt to Duke Croix [7h Qh]
MnnM150: calls 100
Duke Croix: folds 
dddocky: calls 100
RichRick1337: raises 100 to 200
HighCardJasper: raises 100 to 300
appositive: folds 
JeBoyDirk: folds 
MnnM150: calls 200
dddocky: calls 200
RichRick1337: raises 100 to 400
HighCardJasper: raises 100 to 500
MnnM150: calls 200
dddocky: folds 
RichRick1337: calls 100
*** FLOP *** [6d 3h As]
MnnM150: checks 
RichRick1337: bets 300
HighCardJasper: calls 300
MnnM150: folds 
*** TURN *** [6d 3h As] [7c]
RichRick1337: bets 300
HighCardJasper: raises 300 to 600
RichRick1337: calls 300
*** RIVER *** [6d 3h As 7c] [Kh]
RichRick1337: checks 
HighCardJasper: bets 1000
RichRick1337: calls 1000
*** SHOW DOWN ***
HighCardJasper: shows [Ah Ac] (three of a kind, Aces)
RichRick1337: mucks hand 
HighCardJasper collected 5434 from pot
*** SUMMARY ***
Total pot 5750 | Rake 316 
Board [6d 3h As 7c Kh]
Seat 2: MnnM150 folded on the Flop
Seat 3: Duke Croix folded before Flop (didn't bet)
Seat 4: dddocky folded before Flop
Seat 6: RichRick1337 mucked [Jd Ad]
Seat 7: HighCardJasper (button) showed [Ah Ac] and won (5434) with three of a kind, Aces
Seat 8: appositive (small blind) folded before Flop
Seat 9: JeBoyDirk (big blind) folded before Flop



PokerStars Home Game Hand #219636827968: {Club #3225207}  Hold'em No Limit (50/100) - 2020/10/22 17:13:01 ET
Table 'VU_table_tonight' 9-max (Play Money) Seat #8 is the button
Seat 2: MnnM150 (7808 in chips) 
Seat 3: Duke Croix (37125 in chips) 
Seat 4: dddocky (947 in chips) 
Seat 6: RichRick1337 (2320 in chips) 
Seat 7: HighCardJasper (21862 in chips) 
Seat 8: appositive (8031 in chips) 
Seat 9: JeBoyDirk (18877 in chips) 
JeBoyDirk: posts small blind 50
MnnM150: posts big blind 100
*** HOLE CARDS ***
Dealt to Duke Croix [5s 8c]
Duke Croix: folds 
dddocky: raises 847 to 947 and is all-in
RichRick1337: folds 
HighCardJasper: folds 
appositive: folds 
JeBoyDirk: calls 897
MnnM150: folds 
*** FLOP *** [Qc Jc As]
*** TURN *** [Qc Jc As] [Jd]
*** RIVER *** [Qc Jc As Jd] [Js]
*** SHOW DOWN ***
JeBoyDirk: shows [Qd Ad] (a full house, Jacks full of Aces)
dddocky: shows [Ah Kd] (a full house, Jacks full of Aces)
JeBoyDirk collected 942 from pot
dddocky collected 942 from pot
*** SUMMARY ***
Total pot 1994 | Rake 110 
Board [Qc Jc As Jd Js]
Seat 2: MnnM150 (big blind) folded before Flop
Seat 3: Duke Croix folded before Flop (didn't bet)
Seat 4: dddocky showed [Ah Kd] and won (942) with a full house, Jacks full of Aces
Seat 6: RichRick1337 folded before Flop (didn't bet)
Seat 7: HighCardJasper folded before Flop (didn't bet)
Seat 8: appositive (button) folded before Flop (didn't bet)
Seat 9: JeBoyDirk (small blind) showed [Qd Ad] and won (942) with a full house, Jacks full of Aces



PokerStars Home Game Hand #219636848856: {Club #3225207}  Hold'em No Limit (50/100) - 2020/10/22 17:13:37 ET
Table 'VU_table_tonight' 9-max (Play Money) Seat #9 is the button
Seat 2: MnnM150 (7708 in chips) 
Seat 3: Duke Croix (37125 in chips) 
Seat 4: dddocky (942 in chips) 
Seat 6: RichRick1337 (2320 in chips) 
Seat 7: HighCardJasper (21862 in chips) 
Seat 8: appositive (8031 in chips) 
Seat 9: JeBoyDirk (18872 in chips) 
MnnM150: posts small blind 50
Duke Croix: posts big blind 100
*** HOLE CARDS ***
Dealt to Duke Croix [Ah Kd]
dddocky: folds 
RichRick1337: folds 
HighCardJasper: calls 100
appositive: raises 100 to 200
JeBoyDirk: calls 200
MnnM150: folds 
Duke Croix: raises 500 to 700
HighCardJasper: folds 
appositive: calls 500
JeBoyDirk: folds 
*** FLOP *** [6c Kh 5h]
Duke Croix: bets 1000
appositive: calls 1000
*** TURN *** [6c Kh 5h] [Js]
Duke Croix: bets 1600
appositive: folds 
Uncalled bet (1600) returned to Duke Croix
Duke Croix collected 3544 from pot
*** SUMMARY ***
Total pot 3750 | Rake 206 
Board [6c Kh 5h Js]
Seat 2: MnnM150 (small blind) folded before Flop
Seat 3: Duke Croix (big blind) collected (3544)
Seat 4: dddocky folded before Flop (didn't bet)
Seat 6: RichRick1337 folded before Flop (didn't bet)
Seat 7: HighCardJasper folded before Flop
Seat 8: appositive folded on the Turn
Seat 9: JeBoyDirk (button) folded before Flop



PokerStars Home Game Hand #219636887857: {Club #3225207}  Hold'em No Limit (50/100) - 2020/10/22 17:14:45 ET
Table 'VU_table_tonight' 9-max (Play Money) Seat #2 is the button
Seat 1: color_singleton (16230 in chips) 
Seat 2: MnnM150 (7658 in chips) 
Seat 3: Duke Croix (38969 in chips) 
Seat 4: dddocky (942 in chips) 
Seat 6: RichRick1337 (2320 in chips) 
Seat 7: HighCardJasper (21762 in chips) 
Seat 8: appositive (6331 in chips) 
Seat 9: JeBoyDirk (18672 in chips) 
Duke Croix: posts small blind 50
dddocky: posts big blind 100
color_singleton: posts small & big blinds 150
*** HOLE CARDS ***
Dealt to Duke Croix [Kh 6c]
RichRick1337: calls 100
HighCardJasper: calls 100
appositive: folds 
JeBoyDirk: folds 
color_singleton: raises 200 to 300
MnnM150: folds 
Duke Croix: folds 
dddocky: raises 200 to 500
RichRick1337: calls 400
HighCardJasper: folds 
color_singleton: calls 200
*** FLOP *** [5d 8h 3s]
dddocky: bets 442 and is all-in
RichRick1337: folds 
color_singleton: calls 442
*** TURN *** [5d 8h 3s] [9d]
*** RIVER *** [5d 8h 3s 9d] [3c]
*** SHOW DOWN ***
dddocky: shows [Ad As] (two pair, Aces and Threes)
color_singleton: shows [Th Ah] (a pair of Threes)
dddocky collected 2442 from pot
*** SUMMARY ***
Total pot 2584 | Rake 142 
Board [5d 8h 3s 9d 3c]
Seat 1: color_singleton showed [Th Ah] and lost with a pair of Threes
Seat 2: MnnM150 (button) folded before Flop (didn't bet)
Seat 3: Duke Croix (small blind) folded before Flop
Seat 4: dddocky (big blind) showed [Ad As] and won (2442) with two pair, Aces and Threes
Seat 6: RichRick1337 folded on the Flop
Seat 7: HighCardJasper folded before Flop
Seat 8: appositive folded before Flop (didn't bet)
Seat 9: JeBoyDirk folded before Flop (didn't bet)



PokerStars Home Game Hand #219636916081: {Club #3225207}  Hold'em No Limit (50/100) - 2020/10/22 17:15:33 ET
Table 'VU_table_tonight' 9-max (Play Money) Seat #3 is the button
Seat 1: color_singleton (15238 in chips) 
Seat 2: MnnM150 (7658 in chips) 
Seat 3: Duke Croix (38919 in chips) 
Seat 4: dddocky (2442 in chips) 
Seat 6: RichRick1337 (1820 in chips) 
Seat 7: HighCardJasper (21662 in chips) 
Seat 8: appositive (6331 in chips) 
Seat 9: JeBoyDirk (18672 in chips) 
dddocky: posts small blind 50
RichRick1337: posts big blind 100
*** HOLE CARDS ***
Dealt to Duke Croix [As 2h]
HighCardJasper: raises 100 to 200
appositive: folds 
JeBoyDirk: calls 200
color_singleton: calls 200
MnnM150: calls 200
Duke Croix: folds 
dddocky: folds 
RichRick1337: calls 100
*** FLOP *** [Ad Jc 8d]
RichRick1337: bets 200
HighCardJasper: folds 
JeBoyDirk: folds 
color_singleton: calls 200
MnnM150: calls 200
*** TURN *** [Ad Jc 8d] [5d]
RichRick1337: bets 100
color_singleton: calls 100
MnnM150: calls 100
*** RIVER *** [Ad Jc 8d 5d] [2d]
RichRick1337: bets 200
color_singleton: calls 200
MnnM150: folds 
*** SHOW DOWN ***
RichRick1337: shows [Ac Qc] (a pair of Aces)
color_singleton: shows [Ah Td] (a flush, Ace high)
color_singleton collected 2221 from pot
*** SUMMARY ***
Total pot 2350 | Rake 129 
Board [Ad Jc 8d 5d 2d]
Seat 1: color_singleton showed [Ah Td] and won (2221) with a flush, Ace high
Seat 2: MnnM150 folded on the River
Seat 3: Duke Croix (button) folded before Flop (didn't bet)
Seat 4: dddocky (small blind) folded before Flop
Seat 6: RichRick1337 (big blind) showed [Ac Qc] and lost with a pair of Aces
Seat 7: HighCardJasper folded on the Flop
Seat 8: appositive folded before Flop (didn't bet)
Seat 9: JeBoyDirk folded on the Flop



PokerStars Home Game Hand #219636941258: {Club #3225207}  Hold'em No Limit (50/100) - 2020/10/22 17:16:17 ET
Table 'VU_table_tonight' 9-max (Play Money) Seat #4 is the button
Seat 1: color_singleton (16759 in chips) 
Seat 2: MnnM150 (7158 in chips) 
Seat 3: Duke Croix (38919 in chips) 
Seat 4: dddocky (2392 in chips) 
Seat 6: RichRick1337 (1120 in chips) 
Seat 7: HighCardJasper (21462 in chips) 
Seat 8: appositive (6331 in chips) 
Seat 9: JeBoyDirk (18472 in chips) 
RichRick1337: posts small blind 50
HighCardJasper: posts big blind 100
*** HOLE CARDS ***
Dealt to Duke Croix [Js 6d]
appositive: calls 100
JeBoyDirk: folds 
color_singleton: folds 
MnnM150: calls 100
Duke Croix: folds 
dddocky: folds 
RichRick1337: calls 50
HighCardJasper: checks 
*** FLOP *** [9s Tc 4c]
RichRick1337: checks 
HighCardJasper: checks 
appositive: checks 
MnnM150: checks 
*** TURN *** [9s Tc 4c] [6c]
RichRick1337: checks 
HighCardJasper: checks 
appositive: checks 
MnnM150: bets 189
RichRick1337: calls 189
HighCardJasper: folds 
appositive: calls 189
*** RIVER *** [9s Tc 4c 6c] [Ts]
RichRick1337: checks 
appositive: checks 
MnnM150: checks 
*** SHOW DOWN ***
RichRick1337: shows [Kh 2h] (a pair of Tens)
appositive: shows [As Qd] (a pair of Tens - Ace kicker)
MnnM150: shows [4d 3d] (two pair, Tens and Fours)
MnnM150 collected 914 from pot
*** SUMMARY ***
Total pot 967 | Rake 53 
Board [9s Tc 4c 6c Ts]
Seat 1: color_singleton folded before Flop (didn't bet)
Seat 2: MnnM150 showed [4d 3d] and won (914) with two pair, Tens and Fours
Seat 3: Duke Croix folded before Flop (didn't bet)
Seat 4: dddocky (button) folded before Flop (didn't bet)
Seat 6: RichRick1337 (small blind) showed [Kh 2h] and lost with a pair of Tens
Seat 7: HighCardJasper (big blind) folded on the Turn
Seat 8: appositive showed [As Qd] and lost with a pair of Tens
Seat 9: JeBoyDirk folded before Flop (didn't bet)



PokerStars Home Game Hand #219636978598: {Club #3225207}  Hold'em No Limit (50/100) - 2020/10/22 17:17:22 ET
Table 'VU_table_tonight' 9-max (Play Money) Seat #6 is the button
Seat 1: color_singleton (16759 in chips) 
Seat 2: MnnM150 (7783 in chips) 
Seat 3: Duke Croix (38919 in chips) 
Seat 4: dddocky (2392 in chips) 
Seat 6: RichRick1337 (831 in chips) 
Seat 7: HighCardJasper (21362 in chips) 
Seat 8: appositive (6042 in chips) 
Seat 9: JeBoyDirk (18472 in chips) 
HighCardJasper: posts small blind 50
appositive: posts big blind 100
*** HOLE CARDS ***
Dealt to Duke Croix [Td 2h]
JeBoyDirk: folds 
color_singleton: raises 100 to 200
MnnM150: calls 200
Duke Croix: folds 
dddocky: folds 
RichRick1337: raises 100 to 300
HighCardJasper: calls 250
appositive: folds 
color_singleton: calls 100
MnnM150: calls 100
*** FLOP *** [Ts 3d 3h]
HighCardJasper: checks 
color_singleton: bets 1228
MnnM150: folds 
RichRick1337: calls 531 and is all-in
HighCardJasper: folds 
Uncalled bet (697) returned to color_singleton
*** TURN *** [Ts 3d 3h] [7h]
*** RIVER *** [Ts 3d 3h 7h] [6d]
*** SHOW DOWN ***
color_singleton: shows [Th 7s] (two pair, Tens and Sevens)
RichRick1337: shows [Ah Ad] (two pair, Aces and Threes)
RichRick1337 collected 2232 from pot
*** SUMMARY ***
Total pot 2362 | Rake 130 
Board [Ts 3d 3h 7h 6d]
Seat 1: color_singleton showed [Th 7s] and lost with two pair, Tens and Sevens
Seat 2: MnnM150 folded on the Flop
Seat 3: Duke Croix folded before Flop (didn't bet)
Seat 4: dddocky folded before Flop (didn't bet)
Seat 6: RichRick1337 (button) showed [Ah Ad] and won (2232) with two pair, Aces and Threes
Seat 7: HighCardJasper (small blind) folded on the Flop
Seat 8: appositive (big blind) folded before Flop
Seat 9: JeBoyDirk folded before Flop (didn't bet)



PokerStars Home Game Hand #219637008188: {Club #3225207}  Hold'em No Limit (50/100) - 2020/10/22 17:18:13 ET
Table 'VU_table_tonight' 9-max (Play Money) Seat #7 is the button
Seat 1: color_singleton (15928 in chips) 
Seat 2: MnnM150 (7483 in chips) 
Seat 3: Duke Croix (38919 in chips) 
Seat 6: RichRick1337 (2232 in chips) 
Seat 7: HighCardJasper (21062 in chips) 
Seat 8: appositive (5942 in chips) 
Seat 9: JeBoyDirk (18472 in chips) 
appositive: posts small blind 50
JeBoyDirk: posts big blind 100
*** HOLE CARDS ***
Dealt to Duke Croix [7h 7d]
color_singleton: raises 100 to 200
MnnM150: folds 
Duke Croix: raises 300 to 500
RichRick1337: folds 
HighCardJasper: folds 
appositive: folds 
JeBoyDirk: calls 400
color_singleton: calls 300
*** FLOP *** [Kd 9s 8s]
JeBoyDirk: checks 
color_singleton: bets 732
Duke Croix: folds 
JeBoyDirk: calls 732
*** TURN *** [Kd 9s 8s] [2s]
JeBoyDirk: checks 
color_singleton: bets 1424
JeBoyDirk: folds 
Uncalled bet (1424) returned to color_singleton
color_singleton collected 2848 from pot
color_singleton: doesn't show hand 
*** SUMMARY ***
Total pot 3014 | Rake 166 
Board [Kd 9s 8s 2s]
Seat 1: color_singleton collected (2848)
Seat 2: MnnM150 folded before Flop (didn't bet)
Seat 3: Duke Croix folded on the Flop
Seat 6: RichRick1337 folded before Flop (didn't bet)
Seat 7: HighCardJasper (button) folded before Flop (didn't bet)
Seat 8: appositive (small blind) folded before Flop
Seat 9: JeBoyDirk (big blind) folded on the Turn



PokerStars Home Game Hand #219637042926: {Club #3225207}  Hold'em No Limit (50/100) - 2020/10/22 17:19:14 ET
Table 'VU_table_tonight' 9-max (Play Money) Seat #8 is the button
Seat 1: color_singleton (17544 in chips) 
Seat 2: MnnM150 (7483 in chips) 
Seat 3: Duke Croix (38419 in chips) 
Seat 4: dddocky (2392 in chips) 
Seat 6: RichRick1337 (2232 in chips) 
Seat 7: HighCardJasper (21062 in chips) 
Seat 8: appositive (5892 in chips) 
Seat 9: JeBoyDirk (17240 in chips) 
JeBoyDirk: posts small blind 50
color_singleton: posts big blind 100
*** HOLE CARDS ***
Dealt to Duke Croix [Qh 7d]
MnnM150: folds 
Duke Croix: raises 200 to 300
dddocky: folds 
RichRick1337: folds 
HighCardJasper: calls 300
appositive: folds 
JeBoyDirk: folds 
color_singleton: calls 200
*** FLOP *** [5h 3c Ad]
color_singleton: checks 
Duke Croix: checks 
HighCardJasper: bets 300
color_singleton: folds 
Duke Croix: folds 
Uncalled bet (300) returned to HighCardJasper
HighCardJasper collected 898 from pot
HighCardJasper: doesn't show hand 
*** SUMMARY ***
Total pot 950 | Rake 52 
Board [5h 3c Ad]
Seat 1: color_singleton (big blind) folded on the Flop
Seat 2: MnnM150 folded before Flop (didn't bet)
Seat 3: Duke Croix folded on the Flop
Seat 4: dddocky folded before Flop (didn't bet)
Seat 6: RichRick1337 folded before Flop (didn't bet)
Seat 7: HighCardJasper collected (898)
Seat 8: appositive (button) folded before Flop (didn't bet)
Seat 9: JeBoyDirk (small blind) folded before Flop



PokerStars Home Game Hand #219637060591: {Club #3225207}  Hold'em No Limit (50/100) - 2020/10/22 17:19:45 ET
Table 'VU_table_tonight' 9-max (Play Money) Seat #9 is the button
Seat 1: color_singleton (17244 in chips) 
Seat 2: MnnM150 (7483 in chips) 
Seat 3: Duke Croix (38119 in chips) 
Seat 4: dddocky (2392 in chips) 
Seat 6: RichRick1337 (2232 in chips) 
Seat 7: HighCardJasper (21660 in chips) 
Seat 8: appositive (5892 in chips) 
Seat 9: JeBoyDirk (17190 in chips) 
color_singleton: posts small blind 50
MnnM150: posts big blind 100
*** HOLE CARDS ***
Dealt to Duke Croix [Qh Th]
Duke Croix: raises 200 to 300
dddocky: folds 
RichRick1337: folds 
HighCardJasper: folds 
appositive: folds 
JeBoyDirk: folds 
color_singleton has timed out
color_singleton: folds 
MnnM150: calls 200
*** FLOP *** [8d 2c Jh]
color_singleton is disconnected 
MnnM150: checks 
Duke Croix: checks 
*** TURN *** [8d 2c Jh] [9c]
MnnM150: checks 
Duke Croix: bets 600
MnnM150: folds 
Uncalled bet (600) returned to Duke Croix
Duke Croix collected 614 from pot
*** SUMMARY ***
Total pot 650 | Rake 36 
Board [8d 2c Jh 9c]
Seat 1: color_singleton (small blind) folded before Flop
Seat 2: MnnM150 (big blind) folded on the Turn
Seat 3: Duke Croix collected (614)
Seat 4: dddocky folded before Flop (didn't bet)
Seat 6: RichRick1337 folded before Flop (didn't bet)
Seat 7: HighCardJasper folded before Flop (didn't bet)
Seat 8: appositive folded before Flop (didn't bet)
Seat 9: JeBoyDirk (button) folded before Flop (didn't bet)



PokerStars Home Game Hand #219637093433: {Club #3225207}  Hold'em No Limit (50/100) - 2020/10/22 17:20:42 ET
Table 'VU_table_tonight' 9-max (Play Money) Seat #2 is the button
Seat 2: MnnM150 (7183 in chips) 
Seat 3: Duke Croix (38433 in chips) 
Seat 4: dddocky (2392 in chips) 
Seat 6: RichRick1337 (2232 in chips) 
Seat 7: HighCardJasper (21660 in chips) 
Seat 8: appositive (5892 in chips) 
Seat 9: JeBoyDirk (17190 in chips) 
Duke Croix: posts small blind 50
dddocky: posts big blind 100
*** HOLE CARDS ***
Dealt to Duke Croix [Ad 5s]
RichRick1337: calls 100
HighCardJasper: raises 100 to 200
appositive: folds 
JeBoyDirk: folds 
MnnM150: calls 200
Duke Croix: folds 
dddocky: folds 
RichRick1337: calls 100
*** FLOP *** [9d 4c Qh]
RichRick1337: bets 100
HighCardJasper: calls 100
MnnM150: calls 100
*** TURN *** [9d 4c Qh] [4d]
RichRick1337: bets 300
HighCardJasper: calls 300
MnnM150: calls 300
*** RIVER *** [9d 4c Qh 4d] [2s]
RichRick1337: checks 
HighCardJasper: checks 
MnnM150: checks 
*** SHOW DOWN ***
RichRick1337: shows [8d 9s] (two pair, Nines and Fours)
HighCardJasper: shows [Qs Kc] (two pair, Queens and Fours)
MnnM150: mucks hand 
HighCardJasper collected 1843 from pot
*** SUMMARY ***
Total pot 1950 | Rake 107 
Board [9d 4c Qh 4d 2s]
Seat 2: MnnM150 (button) mucked [Jd Kh]
Seat 3: Duke Croix (small blind) folded before Flop
Seat 4: dddocky (big blind) folded before Flop
Seat 6: RichRick1337 showed [8d 9s] and lost with two pair, Nines and Fours
Seat 7: HighCardJasper showed [Qs Kc] and won (1843) with two pair, Queens and Fours
Seat 8: appositive folded before Flop (didn't bet)
Seat 9: JeBoyDirk folded before Flop (didn't bet)



PokerStars Home Game Hand #219637126946: {Club #3225207}  Hold'em No Limit (50/100) - 2020/10/22 17:21:24 ET
Table 'VU_table_tonight' 9-max (Play Money) Seat #3 is the button
Seat 2: MnnM150 (6583 in chips) 
Seat 3: Duke Croix (38383 in chips) 
Seat 4: dddocky (2292 in chips) 
Seat 6: RichRick1337 (1632 in chips) 
Seat 7: HighCardJasper (22903 in chips) 
Seat 8: appositive (5892 in chips) 
Seat 9: JeBoyDirk (17190 in chips) 
dddocky: posts small blind 50
RichRick1337: posts big blind 100
*** HOLE CARDS ***
Dealt to Duke Croix [5c 3d]
HighCardJasper: folds 
appositive: calls 100
JeBoyDirk: folds 
MnnM150: folds 
Duke Croix: folds 
dddocky: calls 50
RichRick1337: checks 
*** FLOP *** [5d Ad Th]
dddocky: bets 141
RichRick1337: calls 141
appositive: calls 141
*** TURN *** [5d Ad Th] [Ts]
dddocky: checks 
RichRick1337: checks 
appositive: checks 
*** RIVER *** [5d Ad Th Ts] [2d]
dddocky: checks 
RichRick1337: checks 
appositive: bets 300
dddocky: folds 
RichRick1337: calls 300
*** SHOW DOWN ***
appositive: shows [7c Kc] (a pair of Tens)
RichRick1337: shows [Kh 8s] (a pair of Tens - Ace+King+Eight kicker)
RichRick1337 collected 1250 from pot
*** SUMMARY ***
Total pot 1323 | Rake 73 
Board [5d Ad Th Ts 2d]
Seat 2: MnnM150 folded before Flop (didn't bet)
Seat 3: Duke Croix (button) folded before Flop (didn't bet)
Seat 4: dddocky (small blind) folded on the River
Seat 6: RichRick1337 (big blind) showed [Kh 8s] and won (1250) with a pair of Tens
Seat 7: HighCardJasper folded before Flop (didn't bet)
Seat 8: appositive showed [7c Kc] and lost with a pair of Tens
Seat 9: JeBoyDirk folded before Flop (didn't bet)



PokerStars Home Game Hand #219637155277: {Club #3225207}  Hold'em No Limit (50/100) - 2020/10/22 17:22:14 ET
Table 'VU_table_tonight' 9-max (Play Money) Seat #4 is the button
Seat 2: MnnM150 (6583 in chips) 
Seat 3: Duke Croix (38383 in chips) 
Seat 4: dddocky (2051 in chips) 
Seat 6: RichRick1337 (2341 in chips) 
Seat 7: HighCardJasper (22903 in chips) 
Seat 8: appositive (5351 in chips) 
Seat 9: JeBoyDirk (17190 in chips) 
RichRick1337: posts small blind 50
HighCardJasper: posts big blind 100
*** HOLE CARDS ***
Dealt to Duke Croix [9c Qs]
appositive: folds 
JeBoyDirk: calls 100
MnnM150: calls 100
Duke Croix: calls 100
dddocky: calls 100
RichRick1337: calls 50
HighCardJasper has timed out
HighCardJasper: checks 
*** FLOP *** [8c 8h 3h]
RichRick1337: checks 
HighCardJasper: checks 
JeBoyDirk: checks 
MnnM150: checks 
Duke Croix: checks 
dddocky: checks 
*** TURN *** [8c 8h 3h] [Js]
RichRick1337: checks 
HighCardJasper: checks 
JeBoyDirk: checks 
MnnM150: checks 
Duke Croix: checks 
dddocky: checks 
*** RIVER *** [8c 8h 3h Js] [Ks]
RichRick1337: checks 
HighCardJasper: checks 
JeBoyDirk: checks 
MnnM150: bets 567
Duke Croix: folds 
dddocky: folds 
RichRick1337: folds 
HighCardJasper: folds 
JeBoyDirk: folds 
Uncalled bet (567) returned to MnnM150
MnnM150 collected 567 from pot
*** SUMMARY ***
Total pot 600 | Rake 33 
Board [8c 8h 3h Js Ks]
Seat 2: MnnM150 collected (567)
Seat 3: Duke Croix folded on the River
Seat 4: dddocky (button) folded on the River
Seat 6: RichRick1337 (small blind) folded on the River
Seat 7: HighCardJasper (big blind) folded on the River
Seat 8: appositive folded before Flop (didn't bet)
Seat 9: JeBoyDirk folded on the River



PokerStars Home Game Hand #219637208409: {Club #3225207}  Hold'em No Limit (50/100) - 2020/10/22 17:23:48 ET
Table 'VU_table_tonight' 9-max (Play Money) Seat #6 is the button
Seat 1: color_singleton (17194 in chips) 
Seat 2: MnnM150 (7050 in chips) 
Seat 3: Duke Croix (38283 in chips) 
Seat 4: dddocky (1951 in chips) 
Seat 6: RichRick1337 (2241 in chips) 
Seat 7: HighCardJasper (22803 in chips) 
Seat 8: appositive (5351 in chips) 
Seat 9: JeBoyDirk (17090 in chips) 
HighCardJasper: posts small blind 50
appositive: posts big blind 100
*** HOLE CARDS ***
Dealt to Duke Croix [6d 8s]
JeBoyDirk: calls 100
color_singleton: folds 
MnnM150: calls 100
Duke Croix: folds 
dddocky: folds 
RichRick1337: raises 100 to 200
HighCardJasper: calls 150
appositive: folds 
JeBoyDirk: calls 100
MnnM150: calls 100
*** FLOP *** [Js 9c 3c]
HighCardJasper: checks 
JeBoyDirk: checks 
MnnM150: checks 
RichRick1337: checks 
*** TURN *** [Js 9c 3c] [8d]
HighCardJasper: checks 
JeBoyDirk: checks 
MnnM150: checks 
RichRick1337: checks 
*** RIVER *** [Js 9c 3c 8d] [4d]
HighCardJasper: checks 
JeBoyDirk: checks 
MnnM150: bets 850
RichRick1337: folds 
HighCardJasper: folds 
JeBoyDirk: calls 850
*** SHOW DOWN ***
MnnM150: shows [Ac 4h] (a pair of Fours)
JeBoyDirk: shows [9d As] (a pair of Nines)
JeBoyDirk collected 2457 from pot
*** SUMMARY ***
Total pot 2600 | Rake 143 
Board [Js 9c 3c 8d 4d]
Seat 1: color_singleton folded before Flop (didn't bet)
Seat 2: MnnM150 showed [Ac 4h] and lost with a pair of Fours
Seat 3: Duke Croix folded before Flop (didn't bet)
Seat 4: dddocky folded before Flop (didn't bet)
Seat 6: RichRick1337 (button) folded on the River
Seat 7: HighCardJasper (small blind) folded on the River
Seat 8: appositive (big blind) folded before Flop
Seat 9: JeBoyDirk showed [9d As] and won (2457) with a pair of Nines



PokerStars Home Game Hand #219637244603: {Club #3225207}  Hold'em No Limit (50/100) - 2020/10/22 17:24:38 ET
Table 'VU_table_tonight' 9-max (Play Money) Seat #7 is the button
Seat 1: color_singleton (17194 in chips) 
Seat 2: MnnM150 (6000 in chips) 
Seat 3: Duke Croix (38283 in chips) 
Seat 4: dddocky (1951 in chips) 
Seat 6: RichRick1337 (2041 in chips) 
Seat 7: HighCardJasper (22603 in chips) 
Seat 8: appositive (5251 in chips) 
Seat 9: JeBoyDirk (18497 in chips) 
appositive: posts small blind 50
JeBoyDirk: posts big blind 100
*** HOLE CARDS ***
Dealt to Duke Croix [4c Jc]
color_singleton: calls 100
MnnM150: calls 100
Duke Croix: folds 
dddocky: calls 100
RichRick1337: calls 100
HighCardJasper: calls 100
appositive: calls 50
JeBoyDirk: checks 
*** FLOP *** [8s 3c Kc]
appositive: checks 
JeBoyDirk: checks 
color_singleton: checks 
MnnM150: bets 330
dddocky: calls 330
RichRick1337: folds 
HighCardJasper: folds 
appositive: calls 330
JeBoyDirk: folds 
color_singleton: folds 
*** TURN *** [8s 3c Kc] [9d]
appositive: checks 
MnnM150: checks 
dddocky: checks 
*** RIVER *** [8s 3c Kc 9d] [3d]
appositive: bets 300
MnnM150: raises 300 to 600
dddocky: calls 600
appositive: folds 
*** SHOW DOWN ***
MnnM150: shows [Kd 7h] (two pair, Kings and Threes)
dddocky: shows [Ks Td] (two pair, Kings and Threes - Ten kicker)
dddocky collected 3015 from pot
*** SUMMARY ***
Total pot 3190 | Rake 175 
Board [8s 3c Kc 9d 3d]
Seat 1: color_singleton folded on the Flop
Seat 2: MnnM150 showed [Kd 7h] and lost with two pair, Kings and Threes
Seat 3: Duke Croix folded before Flop (didn't bet)
Seat 4: dddocky showed [Ks Td] and won (3015) with two pair, Kings and Threes
Seat 6: RichRick1337 folded on the Flop
Seat 7: HighCardJasper (button) folded on the Flop
Seat 8: appositive (small blind) folded on the River
Seat 9: JeBoyDirk (big blind) folded on the Flop



PokerStars Home Game Hand #219637284700: {Club #3225207}  Hold'em No Limit (50/100) - 2020/10/22 17:25:49 ET
Table 'VU_table_tonight' 9-max (Play Money) Seat #8 is the button
Seat 2: MnnM150 (4970 in chips) 
Seat 3: Duke Croix (38283 in chips) 
Seat 4: dddocky (3936 in chips) 
Seat 6: RichRick1337 (1941 in chips) 
Seat 7: HighCardJasper (22503 in chips) 
Seat 8: appositive (4521 in chips) 
Seat 9: JeBoyDirk (18397 in chips) 
JeBoyDirk: posts small blind 50
color_singleton has timed out
color_singleton: is sitting out 
MnnM150: posts big blind 100
*** HOLE CARDS ***
Dealt to Duke Croix [5d Kd]
Duke Croix: folds 
color_singleton is disconnected 
dddocky: calls 100
RichRick1337: calls 100
HighCardJasper: folds 
appositive: calls 100
JeBoyDirk: raises 300 to 400
MnnM150: calls 300
dddocky: folds 
RichRick1337: calls 300
appositive: calls 300
*** FLOP *** [8h Qc 3h]
JeBoyDirk: checks 
MnnM150: checks 
RichRick1337: checks 
appositive: checks 
*** TURN *** [8h Qc 3h] [Ts]
JeBoyDirk: checks 
MnnM150: checks 
RichRick1337: checks 
appositive: bets 600
JeBoyDirk: calls 600
MnnM150: calls 600
RichRick1337: folds 
*** RIVER *** [8h Qc 3h Ts] [5h]
JeBoyDirk: checks 
MnnM150: checks 
appositive: bets 1000
JeBoyDirk: folds 
MnnM150: calls 1000
*** SHOW DOWN ***
appositive: shows [Ad 5c] (a pair of Fives)
MnnM150: shows [9c 9d] (a pair of Nines)
MnnM150 collected 5197 from pot
*** SUMMARY ***
Total pot 5500 | Rake 303 
Board [8h Qc 3h Ts 5h]
Seat 2: MnnM150 (big blind) showed [9c 9d] and won (5197) with a pair of Nines
Seat 3: Duke Croix folded before Flop (didn't bet)
Seat 4: dddocky folded before Flop
Seat 6: RichRick1337 folded on the Turn
Seat 7: HighCardJasper folded before Flop (didn't bet)
Seat 8: appositive (button) showed [Ad 5c] and lost with a pair of Fives
Seat 9: JeBoyDirk (small blind) folded on the River



PokerStars Home Game Hand #219637338876: {Club #3225207}  Hold'em No Limit (50/100) - 2020/10/22 17:27:25 ET
Table 'VU_table_tonight' 9-max (Play Money) Seat #9 is the button
Seat 2: MnnM150 (8167 in chips) 
Seat 3: Duke Croix (38283 in chips) 
Seat 4: dddocky (3836 in chips) 
Seat 6: RichRick1337 (1541 in chips) 
Seat 7: HighCardJasper (22503 in chips) 
Seat 8: appositive (2521 in chips) 
Seat 9: JeBoyDirk (17397 in chips) 
MnnM150: posts small blind 50
Duke Croix: posts big blind 100
*** HOLE CARDS ***
Dealt to Duke Croix [4h Jd]
dddocky: folds 
RichRick1337: folds 
HighCardJasper: raises 100 to 200
appositive: folds 
JeBoyDirk: folds 
MnnM150: calls 150
Duke Croix: folds 
*** FLOP *** [9s 3c 8d]
MnnM150: checks 
HighCardJasper: checks 
*** TURN *** [9s 3c 8d] [9h]
MnnM150: checks 
HighCardJasper: checks 
*** RIVER *** [9s 3c 8d 9h] [Td]
MnnM150: bets 236
HighCardJasper: folds 
Uncalled bet (236) returned to MnnM150
MnnM150 collected 472 from pot
*** SUMMARY ***
Total pot 500 | Rake 28 
Board [9s 3c 8d 9h Td]
Seat 2: MnnM150 (small blind) collected (472)
Seat 3: Duke Croix (big blind) folded before Flop
Seat 4: dddocky folded before Flop (didn't bet)
Seat 6: RichRick1337 folded before Flop (didn't bet)
Seat 7: HighCardJasper folded on the River
Seat 8: appositive folded before Flop (didn't bet)
Seat 9: JeBoyDirk (button) folded before Flop (didn't bet)



PokerStars Home Game Hand #219637358437: {Club #3225207}  Hold'em No Limit (50/100) - 2020/10/22 17:28:00 ET
Table 'VU_table_tonight' 9-max (Play Money) Seat #2 is the button
Seat 1: color_singleton (17094 in chips) 
Seat 2: MnnM150 (8439 in chips) 
Seat 3: Duke Croix (38183 in chips) 
Seat 4: dddocky (3836 in chips) 
Seat 6: RichRick1337 (1541 in chips) 
Seat 7: HighCardJasper (22303 in chips) 
Seat 8: appositive (2521 in chips) 
Seat 9: JeBoyDirk (17397 in chips) 
Duke Croix: posts small blind 50
dddocky: posts big blind 100
color_singleton: posts small & big blinds 150
*** HOLE CARDS ***
Dealt to Duke Croix [Qd 7s]
RichRick1337: calls 100
HighCardJasper: calls 100
appositive: folds 
JeBoyDirk: folds 
color_singleton: checks 
MnnM150: calls 100
Duke Croix: calls 50
dddocky: checks 
*** FLOP *** [9d 9c Qs]
Duke Croix: bets 400
dddocky: folds 
RichRick1337: folds 
HighCardJasper: folds 
color_singleton: folds 
MnnM150: calls 400
*** TURN *** [9d 9c Qs] [Jh]
Duke Croix: bets 800
MnnM150: calls 800
*** RIVER *** [9d 9c Qs Jh] [Kc]
Duke Croix: checks 
MnnM150: checks 
*** SHOW DOWN ***
Duke Croix: shows [Qd 7s] (two pair, Queens and Nines)
MnnM150: shows [Qh 5h] (two pair, Queens and Nines)
Duke Croix collected 1441 from pot
MnnM150 collected 1441 from pot
*** SUMMARY ***
Total pot 3050 | Rake 168 
Board [9d 9c Qs Jh Kc]
Seat 1: color_singleton folded on the Flop (didn't bet)
Seat 2: MnnM150 (button) showed [Qh 5h] and won (1441) with two pair, Queens and Nines
Seat 3: Duke Croix (small blind) showed [Qd 7s] and won (1441) with two pair, Queens and Nines
Seat 4: dddocky (big blind) folded on the Flop
Seat 6: RichRick1337 folded on the Flop
Seat 7: HighCardJasper folded on the Flop
Seat 8: appositive folded before Flop (didn't bet)
Seat 9: JeBoyDirk folded before Flop (didn't bet)



PokerStars Home Game Hand #219637388795: {Club #3225207}  Hold'em No Limit (50/100) - 2020/10/22 17:28:55 ET
Table 'VU_table_tonight' 9-max (Play Money) Seat #3 is the button
Seat 1: color_singleton (16944 in chips) 
Seat 2: MnnM150 (8580 in chips) 
Seat 3: Duke Croix (38324 in chips) 
Seat 4: dddocky (3736 in chips) 
Seat 6: RichRick1337 (1441 in chips) 
Seat 7: HighCardJasper (22203 in chips) 
Seat 8: appositive (2521 in chips) 
Seat 9: JeBoyDirk (17397 in chips) 
dddocky: posts small blind 50
RichRick1337: posts big blind 100
*** HOLE CARDS ***
Dealt to Duke Croix [7s Kc]
HighCardJasper: folds 
appositive: calls 100
JeBoyDirk: calls 100
color_singleton: folds 
MnnM150: calls 100
Duke Croix: calls 100
dddocky: folds 
RichRick1337: checks 
*** FLOP *** [5d Ks 6h]
RichRick1337: bets 100
appositive: calls 100
JeBoyDirk: folds 
MnnM150: calls 100
Duke Croix: raises 300 to 400
RichRick1337: calls 300
appositive: calls 300
MnnM150: folds 
*** TURN *** [5d Ks 6h] [Jc]
RichRick1337: checks 
appositive: checks 
Duke Croix: bets 1000
RichRick1337: folds 
appositive: folds 
Uncalled bet (1000) returned to Duke Croix
Duke Croix collected 1748 from pot
*** SUMMARY ***
Total pot 1850 | Rake 102 
Board [5d Ks 6h Jc]
Seat 1: color_singleton folded before Flop (didn't bet)
Seat 2: MnnM150 folded on the Flop
Seat 3: Duke Croix (button) collected (1748)
Seat 4: dddocky (small blind) folded before Flop
Seat 6: RichRick1337 (big blind) folded on the Turn
Seat 7: HighCardJasper folded before Flop (didn't bet)
Seat 8: appositive folded on the Turn
Seat 9: JeBoyDirk folded on the Flop



PokerStars Home Game Hand #219637425628: {Club #3225207}  Hold'em No Limit (50/100) - 2020/10/22 17:30:01 ET
Table 'VU_table_tonight' 9-max (Play Money) Seat #4 is the button
Seat 1: color_singleton (16944 in chips) 
Seat 2: MnnM150 (8380 in chips) 
Seat 3: Duke Croix (39572 in chips) 
Seat 4: dddocky (3686 in chips) 
Seat 6: RichRick1337 (941 in chips) 
Seat 7: HighCardJasper (22203 in chips) 
Seat 8: appositive (2021 in chips) 
Seat 9: JeBoyDirk (17297 in chips) 
RichRick1337: posts small blind 50
HighCardJasper: posts big blind 100
*** HOLE CARDS ***
Dealt to Duke Croix [6h 5h]
appositive: folds 
JeBoyDirk: calls 100
color_singleton: folds 
MnnM150: calls 100
Duke Croix: raises 400 to 500
dddocky: folds 
RichRick1337: folds 
HighCardJasper: folds 
JeBoyDirk: calls 400
MnnM150: folds 
*** FLOP *** [8h Th Qc]
JeBoyDirk: checks 
Duke Croix: bets 700
JeBoyDirk: folds 
Uncalled bet (700) returned to Duke Croix
Duke Croix collected 1181 from pot
*** SUMMARY ***
Total pot 1250 | Rake 69 
Board [8h Th Qc]
Seat 1: color_singleton folded before Flop (didn't bet)
Seat 2: MnnM150 folded before Flop
Seat 3: Duke Croix collected (1181)
Seat 4: dddocky (button) folded before Flop (didn't bet)
Seat 6: RichRick1337 (small blind) folded before Flop
Seat 7: HighCardJasper (big blind) folded before Flop
Seat 8: appositive folded before Flop (didn't bet)
Seat 9: JeBoyDirk folded on the Flop



PokerStars Home Game Hand #219637448560: {Club #3225207}  Hold'em No Limit (50/100) - 2020/10/22 17:30:42 ET
Table 'VU_table_tonight' 9-max (Play Money) Seat #6 is the button
Seat 1: color_singleton (16944 in chips) 
Seat 2: MnnM150 (8280 in chips) 
Seat 3: Duke Croix (40253 in chips) 
Seat 4: dddocky (3686 in chips) 
Seat 6: RichRick1337 (891 in chips) 
Seat 7: HighCardJasper (22103 in chips) 
Seat 8: appositive (2021 in chips) 
Seat 9: JeBoyDirk (16797 in chips) 
HighCardJasper: posts small blind 50
appositive: posts big blind 100
*** HOLE CARDS ***
Dealt to Duke Croix [Jh 5s]
JeBoyDirk has timed out
JeBoyDirk: folds 
color_singleton: folds 
MnnM150: raises 100 to 200
Duke Croix: folds 
dddocky: folds 
RichRick1337: calls 200
HighCardJasper: calls 150
appositive: folds 
*** FLOP *** [4c 7h Qc]
HighCardJasper: checks 
MnnM150: checks 
RichRick1337: bets 200
HighCardJasper: folds 
MnnM150: calls 200
*** TURN *** [4c 7h Qc] [6h]
MnnM150: checks 
RichRick1337: checks 
*** RIVER *** [4c 7h Qc 6h] [Qs]
MnnM150: checks 
RichRick1337: bets 100
MnnM150: calls 100
*** SHOW DOWN ***
RichRick1337: shows [Ah 7c] (two pair, Queens and Sevens)
MnnM150: mucks hand 
RichRick1337 collected 1228 from pot
*** SUMMARY ***
Total pot 1300 | Rake 72 
Board [4c 7h Qc 6h Qs]
Seat 1: color_singleton folded before Flop (didn't bet)
Seat 2: MnnM150 mucked [Jc Ac]
Seat 3: Duke Croix folded before Flop (didn't bet)
Seat 4: dddocky folded before Flop (didn't bet)
Seat 6: RichRick1337 (button) showed [Ah 7c] and won (1228) with two pair, Queens and Sevens
Seat 7: HighCardJasper (small blind) folded on the Flop
Seat 8: appositive (big blind) folded before Flop
Seat 9: JeBoyDirk folded before Flop (didn't bet)



PokerStars Home Game Hand #219637480150: {Club #3225207}  Hold'em No Limit (50/100) - 2020/10/22 17:31:39 ET
Table 'VU_table_tonight' 9-max (Play Money) Seat #7 is the button
Seat 1: color_singleton (16944 in chips) 
Seat 2: MnnM150 (7780 in chips) 
Seat 3: Duke Croix (40253 in chips) 
Seat 4: dddocky (3686 in chips) 
Seat 6: RichRick1337 (1619 in chips) 
Seat 7: HighCardJasper (21903 in chips) 
Seat 8: appositive (1921 in chips) 
Seat 9: JeBoyDirk (16797 in chips) 
appositive: posts small blind 50
JeBoyDirk: posts big blind 100
*** HOLE CARDS ***
Dealt to Duke Croix [Tc 2s]
color_singleton: raises 200 to 300
MnnM150: folds 
Duke Croix: folds 
dddocky: folds 
RichRick1337: folds 
HighCardJasper: folds 
appositive: folds 
JeBoyDirk: folds 
Uncalled bet (200) returned to color_singleton
color_singleton collected 250 from pot
color_singleton: doesn't show hand 
*** SUMMARY ***
Total pot 250 | Rake 0 
Seat 1: color_singleton collected (250)
Seat 2: MnnM150 folded before Flop (didn't bet)
Seat 3: Duke Croix folded before Flop (didn't bet)
Seat 4: dddocky folded before Flop (didn't bet)
Seat 6: RichRick1337 folded before Flop (didn't bet)
Seat 7: HighCardJasper (button) folded before Flop (didn't bet)
Seat 8: appositive (small blind) folded before Flop
Seat 9: JeBoyDirk (big blind) folded before Flop



PokerStars Home Game Hand #219637490893: {Club #3225207}  Hold'em No Limit (50/100) - 2020/10/22 17:31:58 ET
Table 'VU_table_tonight' 9-max (Play Money) Seat #8 is the button
Seat 1: color_singleton (17094 in chips) 
Seat 2: MnnM150 (7780 in chips) 
Seat 3: Duke Croix (40253 in chips) 
Seat 4: dddocky (3686 in chips) 
Seat 6: RichRick1337 (1619 in chips) 
Seat 7: HighCardJasper (21903 in chips) 
Seat 8: appositive (1871 in chips) 
Seat 9: JeBoyDirk (16697 in chips) 
JeBoyDirk: posts small blind 50
color_singleton: posts big blind 100
*** HOLE CARDS ***
Dealt to Duke Croix [8h Qh]
MnnM150: calls 100
Duke Croix: raises 300 to 400
dddocky: calls 400
RichRick1337: folds 
HighCardJasper: folds 
appositive: folds 
JeBoyDirk: folds 
color_singleton: calls 300
MnnM150: calls 300
*** FLOP *** [Ac 6d Td]
color_singleton: checks 
MnnM150: bets 779
Duke Croix: folds 
dddocky: folds 
color_singleton: folds 
Uncalled bet (779) returned to MnnM150
MnnM150 collected 1559 from pot
*** SUMMARY ***
Total pot 1650 | Rake 91 
Board [Ac 6d Td]
Seat 1: color_singleton (big blind) folded on the Flop
Seat 2: MnnM150 collected (1559)
Seat 3: Duke Croix folded on the Flop
Seat 4: dddocky folded on the Flop
Seat 6: RichRick1337 folded before Flop (didn't bet)
Seat 7: HighCardJasper folded before Flop (didn't bet)
Seat 8: appositive (button) folded before Flop (didn't bet)
Seat 9: JeBoyDirk (small blind) folded before Flop



PokerStars Home Game Hand #219637509051: {Club #3225207}  Hold'em No Limit (50/100) - 2020/10/22 17:32:31 ET
Table 'VU_table_tonight' 9-max (Play Money) Seat #9 is the button
Seat 1: color_singleton (16694 in chips) 
Seat 2: MnnM150 (8939 in chips) 
Seat 3: Duke Croix (39853 in chips) 
Seat 4: dddocky (3286 in chips) 
Seat 6: RichRick1337 (1619 in chips) 
Seat 7: HighCardJasper (21903 in chips) 
Seat 8: appositive (1871 in chips) 
Seat 9: JeBoyDirk (16647 in chips) 
color_singleton: posts small blind 50
MnnM150: posts big blind 100
*** HOLE CARDS ***
Dealt to Duke Croix [8h 2s]
Duke Croix: folds 
dddocky: folds 
RichRick1337: raises 100 to 200
HighCardJasper: folds 
appositive: folds 
JeBoyDirk: calls 200
color_singleton: calls 150
MnnM150: calls 100
*** FLOP *** [Qc Kh 5h]
color_singleton has timed out
color_singleton: checks 
MnnM150: checks 
RichRick1337: bets 400
JeBoyDirk: folds 
color_singleton: folds 
MnnM150: folds 
Uncalled bet (400) returned to RichRick1337
RichRick1337 collected 756 from pot
RichRick1337: doesn't show hand 
*** SUMMARY ***
Total pot 800 | Rake 44 
Board [Qc Kh 5h]
Seat 1: color_singleton (small blind) folded on the Flop
Seat 2: MnnM150 (big blind) folded on the Flop
Seat 3: Duke Croix folded before Flop (didn't bet)
Seat 4: dddocky folded before Flop (didn't bet)
Seat 6: RichRick1337 collected (756)
Seat 7: HighCardJasper folded before Flop (didn't bet)
Seat 8: appositive folded before Flop (didn't bet)
Seat 9: JeBoyDirk (button) folded on the Flop



PokerStars Home Game Hand #219637541849: {Club #3225207}  Hold'em No Limit (50/100) - 2020/10/22 17:33:31 ET
Table 'VU_table_tonight' 9-max (Play Money) Seat #1 is the button
Seat 1: color_singleton (16494 in chips) 
Seat 2: MnnM150 (8739 in chips) 
Seat 3: Duke Croix (39853 in chips) 
Seat 4: dddocky (3286 in chips) 
Seat 6: RichRick1337 (2175 in chips) 
Seat 7: HighCardJasper (21903 in chips) 
Seat 8: appositive (1871 in chips) 
Seat 9: JeBoyDirk (16447 in chips) 
MnnM150: posts small blind 50
Duke Croix: posts big blind 100
*** HOLE CARDS ***
Dealt to Duke Croix [Qc 5h]
dddocky: folds 
RichRick1337: calls 100
HighCardJasper: folds 
appositive: folds 
JeBoyDirk: folds 
color_singleton: folds 
MnnM150: folds 
Duke Croix: checks 
*** FLOP *** [7d Ah 6d]
Duke Croix: checks 
RichRick1337: checks 
*** TURN *** [7d Ah 6d] [Ts]
Duke Croix: checks 
RichRick1337: checks 
*** RIVER *** [7d Ah 6d Ts] [7c]
Duke Croix: checks 
RichRick1337: bets 400
Duke Croix: folds 
Uncalled bet (400) returned to RichRick1337
RichRick1337 collected 236 from pot
RichRick1337: doesn't show hand 
*** SUMMARY ***
Total pot 250 | Rake 14 
Board [7d Ah 6d Ts 7c]
Seat 1: color_singleton (button) folded before Flop (didn't bet)
Seat 2: MnnM150 (small blind) folded before Flop
Seat 3: Duke Croix (big blind) folded on the River
Seat 4: dddocky folded before Flop (didn't bet)
Seat 6: RichRick1337 collected (236)
Seat 7: HighCardJasper folded before Flop (didn't bet)
Seat 8: appositive folded before Flop (didn't bet)
Seat 9: JeBoyDirk folded before Flop (didn't bet)



PokerStars Home Game Hand #219637562788: {Club #3225207}  Hold'em No Limit (50/100) - 2020/10/22 17:34:09 ET
Table 'VU_table_tonight' 9-max (Play Money) Seat #2 is the button
Seat 1: color_singleton (16494 in chips) 
Seat 2: MnnM150 (8689 in chips) 
Seat 3: Duke Croix (39753 in chips) 
Seat 4: dddocky (3286 in chips) 
Seat 6: RichRick1337 (2311 in chips) 
Seat 7: HighCardJasper (21903 in chips) 
Seat 8: appositive (1871 in chips) 
Seat 9: JeBoyDirk (16447 in chips) 
Duke Croix: posts small blind 50
dddocky: posts big blind 100
*** HOLE CARDS ***
Dealt to Duke Croix [Ah Kd]
RichRick1337: calls 100
HighCardJasper: folds 
appositive: calls 100
JeBoyDirk: folds 
color_singleton: raises 400 to 500
MnnM150: folds 
Duke Croix: calls 450
dddocky: calls 400
RichRick1337: folds 
appositive: raises 400 to 900
color_singleton: raises 1500 to 2400
Duke Croix: folds 
dddocky: folds 
appositive: calls 971 and is all-in
Uncalled bet (529) returned to color_singleton
*** FLOP *** [2c As 4h]
*** TURN *** [2c As 4h] [6h]
*** RIVER *** [2c As 4h 6h] [3c]
*** SHOW DOWN ***
appositive: shows [Ad Qs] (a pair of Aces)
color_singleton: shows [Kh Kc] (a pair of Kings)
appositive collected 4576 from pot
*** SUMMARY ***
Total pot 4842 | Rake 266 
Board [2c As 4h 6h 3c]
Seat 1: color_singleton showed [Kh Kc] and lost with a pair of Kings
Seat 2: MnnM150 (button) folded before Flop (didn't bet)
Seat 3: Duke Croix (small blind) folded before Flop
Seat 4: dddocky (big blind) folded before Flop
Seat 6: RichRick1337 folded before Flop
Seat 7: HighCardJasper folded before Flop (didn't bet)
Seat 8: appositive showed [Ad Qs] and won (4576) with a pair of Aces
Seat 9: JeBoyDirk folded before Flop (didn't bet)



PokerStars Home Game Hand #219637588875: {Club #3225207}  Hold'em No Limit (50/100) - 2020/10/22 17:34:57 ET
Table 'VU_table_tonight' 9-max (Play Money) Seat #3 is the button
Seat 1: color_singleton (14623 in chips) 
Seat 2: MnnM150 (8689 in chips) 
Seat 3: Duke Croix (39253 in chips) 
Seat 4: dddocky (2786 in chips) 
Seat 6: RichRick1337 (2211 in chips) 
Seat 7: HighCardJasper (21903 in chips) 
Seat 8: appositive (4576 in chips) 
Seat 9: JeBoyDirk (16447 in chips) 
dddocky: posts small blind 50
RichRick1337: posts big blind 100
*** HOLE CARDS ***
Dealt to Duke Croix [Jc 7c]
HighCardJasper: calls 100
appositive: calls 100
JeBoyDirk: folds 
color_singleton: folds 
MnnM150: raises 100 to 200
Duke Croix: folds 
dddocky: calls 150
RichRick1337: folds 
HighCardJasper: calls 100
appositive: calls 100
*** FLOP *** [Td Js 2h]
dddocky: checks 
HighCardJasper: checks 
appositive: bets 200
MnnM150: raises 200 to 400
dddocky: folds 
HighCardJasper: folds 
appositive: calls 200
*** TURN *** [Td Js 2h] [Ts]
appositive: bets 800
MnnM150: raises 800 to 1600
appositive: raises 2376 to 3976 and is all-in
MnnM150: calls 2376
*** RIVER *** [Td Js 2h Ts] [4c]
*** SHOW DOWN ***
appositive: shows [9h Tc] (three of a kind, Tens)
MnnM150: shows [Ks Kh] (two pair, Kings and Tens)
appositive collected 9121 from pot
*** SUMMARY ***
Total pot 9652 | Rake 531 
Board [Td Js 2h Ts 4c]
Seat 1: color_singleton folded before Flop (didn't bet)
Seat 2: MnnM150 showed [Ks Kh] and lost with two pair, Kings and Tens
Seat 3: Duke Croix (button) folded before Flop (didn't bet)
Seat 4: dddocky (small blind) folded on the Flop
Seat 6: RichRick1337 (big blind) folded before Flop
Seat 7: HighCardJasper folded on the Flop
Seat 8: appositive showed [9h Tc] and won (9121) with three of a kind, Tens
Seat 9: JeBoyDirk folded before Flop (didn't bet)



PokerStars Home Game Hand #219637624652: {Club #3225207}  Hold'em No Limit (50/100) - 2020/10/22 17:36:02 ET
Table 'VU_table_tonight' 9-max (Play Money) Seat #4 is the button
Seat 1: color_singleton (14623 in chips) 
Seat 2: MnnM150 (4113 in chips) 
Seat 3: Duke Croix (39253 in chips) 
Seat 4: dddocky (2586 in chips) 
Seat 6: RichRick1337 (2111 in chips) 
Seat 7: HighCardJasper (21703 in chips) 
Seat 8: appositive (9121 in chips) 
Seat 9: JeBoyDirk (16447 in chips) 
RichRick1337: posts small blind 50
HighCardJasper: posts big blind 100
*** HOLE CARDS ***
Dealt to Duke Croix [5c Kc]
appositive: folds 
JeBoyDirk: raises 100 to 200
color_singleton: calls 200
MnnM150: calls 200
Duke Croix: folds 
dddocky: calls 200
RichRick1337: calls 150
HighCardJasper: calls 100
*** FLOP *** [Td 8h 9c]
RichRick1337: checks 
HighCardJasper: checks 
JeBoyDirk: checks 
color_singleton: checks 
MnnM150: bets 100
dddocky: calls 100
RichRick1337: calls 100
HighCardJasper: calls 100
JeBoyDirk: calls 100
color_singleton: raises 200 to 300
MnnM150: calls 200
dddocky: folds 
RichRick1337: folds 
HighCardJasper: calls 200
JeBoyDirk: calls 200
*** TURN *** [Td 8h 9c] [6h]
HighCardJasper: checks 
JeBoyDirk: checks 
color_singleton: checks 
MnnM150: checks 
*** RIVER *** [Td 8h 9c 6h] [7d]
HighCardJasper: checks 
JeBoyDirk: bets 400
color_singleton: raises 1628 to 2028
MnnM150: folds 
HighCardJasper: folds 
JeBoyDirk: folds 
Uncalled bet (1628) returned to color_singleton
color_singleton collected 3213 from pot
color_singleton: doesn't show hand 
*** SUMMARY ***
Total pot 3400 | Rake 187 
Board [Td 8h 9c 6h 7d]
Seat 1: color_singleton collected (3213)
Seat 2: MnnM150 folded on the River
Seat 3: Duke Croix folded before Flop (didn't bet)
Seat 4: dddocky (button) folded on the Flop
Seat 6: RichRick1337 (small blind) folded on the Flop
Seat 7: HighCardJasper (big blind) folded on the River
Seat 8: appositive folded before Flop (didn't bet)
Seat 9: JeBoyDirk folded on the River



PokerStars Home Game Hand #219637669666: {Club #3225207}  Hold'em No Limit (50/100) - 2020/10/22 17:37:24 ET
Table 'VU_table_tonight' 9-max (Play Money) Seat #6 is the button
Seat 1: color_singleton (16936 in chips) 
Seat 2: MnnM150 (3613 in chips) 
Seat 3: Duke Croix (39253 in chips) 
Seat 4: dddocky (2286 in chips) 
Seat 6: RichRick1337 (1811 in chips) 
Seat 7: HighCardJasper (21203 in chips) 
Seat 8: appositive (9121 in chips) 
Seat 9: JeBoyDirk (15547 in chips) 
HighCardJasper: posts small blind 50
appositive: posts big blind 100
*** HOLE CARDS ***
Dealt to Duke Croix [8c Kc]
JeBoyDirk: calls 100
color_singleton: folds 
MnnM150: folds 
Duke Croix: calls 100
dddocky: folds 
RichRick1337: folds 
HighCardJasper: raises 100 to 200
appositive: folds 
JeBoyDirk: calls 100
Duke Croix: calls 100
*** FLOP *** [3c Qc 3s]
HighCardJasper: checks 
JeBoyDirk: bets 200
Duke Croix: raises 300 to 500
HighCardJasper: folds 
JeBoyDirk: calls 300
*** TURN *** [3c Qc 3s] [9h]
JeBoyDirk: checks 
Duke Croix: bets 1000
JeBoyDirk: calls 1000
*** RIVER *** [3c Qc 3s 9h] [4d]
JeBoyDirk: checks 
Duke Croix: bets 2000
JeBoyDirk: calls 2000
*** SHOW DOWN ***
Duke Croix: shows [8c Kc] (a pair of Threes)
JeBoyDirk: shows [Td Qd] (two pair, Queens and Threes)
JeBoyDirk collected 7276 from pot
*** SUMMARY ***
Total pot 7700 | Rake 424 
Board [3c Qc 3s 9h 4d]
Seat 1: color_singleton folded before Flop (didn't bet)
Seat 2: MnnM150 folded before Flop (didn't bet)
Seat 3: Duke Croix showed [8c Kc] and lost with a pair of Threes
Seat 4: dddocky folded before Flop (didn't bet)
Seat 6: RichRick1337 (button) folded before Flop (didn't bet)
Seat 7: HighCardJasper (small blind) folded on the Flop
Seat 8: appositive (big blind) folded before Flop
Seat 9: JeBoyDirk showed [Td Qd] and won (7276) with two pair, Queens and Threes



PokerStars Home Game Hand #219637708427: {Club #3225207}  Hold'em No Limit (50/100) - 2020/10/22 17:38:35 ET
Table 'VU_table_tonight' 9-max (Play Money) Seat #7 is the button
Seat 1: color_singleton (16936 in chips) 
Seat 2: MnnM150 (3613 in chips) 
Seat 3: Duke Croix (35553 in chips) 
Seat 4: dddocky (2286 in chips) 
Seat 6: RichRick1337 (1811 in chips) 
Seat 7: HighCardJasper (21003 in chips) 
Seat 8: appositive (9021 in chips) 
Seat 9: JeBoyDirk (19123 in chips) 
appositive: posts small blind 50
JeBoyDirk: posts big blind 100
*** HOLE CARDS ***
Dealt to Duke Croix [Jh 3c]
color_singleton: folds 
MnnM150: calls 100
Duke Croix: folds 
dddocky: folds 
RichRick1337: calls 100
HighCardJasper: folds 
appositive has timed out
appositive: folds 
JeBoyDirk: checks 
*** FLOP *** [Js 5c 2s]
JeBoyDirk: checks 
MnnM150: bets 165
RichRick1337: calls 165
JeBoyDirk: calls 165
*** TURN *** [Js 5c 2s] [7c]
JeBoyDirk: checks 
MnnM150: bets 399
RichRick1337: calls 399
JeBoyDirk: calls 399
*** RIVER *** [Js 5c 2s 7c] [Kd]
JeBoyDirk: checks 
MnnM150: bets 1930
RichRick1337: folds 
JeBoyDirk: folds 
Uncalled bet (1930) returned to MnnM150
MnnM150 collected 1930 from pot
*** SUMMARY ***
Total pot 2042 | Rake 112 
Board [Js 5c 2s 7c Kd]
Seat 1: color_singleton folded before Flop (didn't bet)
Seat 2: MnnM150 collected (1930)
Seat 3: Duke Croix folded before Flop (didn't bet)
Seat 4: dddocky folded before Flop (didn't bet)
Seat 6: RichRick1337 folded on the River
Seat 7: HighCardJasper (button) folded before Flop (didn't bet)
Seat 8: appositive (small blind) folded before Flop
Seat 9: JeBoyDirk (big blind) folded on the River



PokerStars Home Game Hand #219637750566: {Club #3225207}  Hold'em No Limit (50/100) - 2020/10/22 17:39:53 ET
Table 'VU_table_tonight' 9-max (Play Money) Seat #9 is the button
Seat 1: color_singleton (16936 in chips) 
Seat 2: MnnM150 (4879 in chips) 
Seat 3: Duke Croix (35553 in chips) 
Seat 4: dddocky (2286 in chips) 
Seat 6: RichRick1337 (1147 in chips) 
Seat 7: HighCardJasper (21003 in chips) 
Seat 9: JeBoyDirk (18459 in chips) 
color_singleton: posts small blind 50
MnnM150: posts big blind 100
*** HOLE CARDS ***
Dealt to Duke Croix [6d 6h]
Duke Croix: raises 200 to 300
dddocky: folds 
RichRick1337: folds 
HighCardJasper: folds 
JeBoyDirk: calls 300
color_singleton: folds 
MnnM150: calls 200
*** FLOP *** [3d 5c Ad]
MnnM150: checks 
Duke Croix: bets 500
JeBoyDirk: folds 
MnnM150: folds 
Uncalled bet (500) returned to Duke Croix
Duke Croix collected 898 from pot
*** SUMMARY ***
Total pot 950 | Rake 52 
Board [3d 5c Ad]
Seat 1: color_singleton (small blind) folded before Flop
Seat 2: MnnM150 (big blind) folded on the Flop
Seat 3: Duke Croix collected (898)
Seat 4: dddocky folded before Flop (didn't bet)
Seat 6: RichRick1337 folded before Flop (didn't bet)
Seat 7: HighCardJasper folded before Flop (didn't bet)
Seat 9: JeBoyDirk (button) folded on the Flop



PokerStars Home Game Hand #219637766229: {Club #3225207}  Hold'em No Limit (50/100) - 2020/10/22 17:40:23 ET
Table 'VU_table_tonight' 9-max (Play Money) Seat #1 is the button
Seat 1: color_singleton (16886 in chips) 
Seat 2: MnnM150 (4579 in chips) 
Seat 3: Duke Croix (36151 in chips) 
Seat 4: dddocky (2286 in chips) 
Seat 6: RichRick1337 (1147 in chips) 
Seat 7: HighCardJasper (21003 in chips) 
Seat 9: JeBoyDirk (18159 in chips) 
MnnM150: posts small blind 50
Duke Croix: posts big blind 100
*** HOLE CARDS ***
Dealt to Duke Croix [2c 9h]
dddocky: folds 
RichRick1337: raises 100 to 200
HighCardJasper: folds 
JeBoyDirk: folds 
color_singleton: calls 200
MnnM150: calls 150
Duke Croix: folds 
*** FLOP *** [Ah 5d 5s]
MnnM150: bets 330
RichRick1337: folds 
color_singleton: raises 330 to 660
MnnM150: calls 330
*** TURN *** [Ah 5d 5s] [6h]
MnnM150: bets 954
color_singleton: calls 954
*** RIVER *** [Ah 5d 5s 6h] [7c]
MnnM150: checks 
color_singleton: checks 
*** SHOW DOWN ***
MnnM150: shows [As Tc] (two pair, Aces and Fives)
color_singleton: mucks hand 
MnnM150 collected 3712 from pot
*** SUMMARY ***
Total pot 3928 | Rake 216 
Board [Ah 5d 5s 6h 7c]
Seat 1: color_singleton (button) mucked [2s Ac]
Seat 2: MnnM150 (small blind) showed [As Tc] and won (3712) with two pair, Aces and Fives
Seat 3: Duke Croix (big blind) folded before Flop
Seat 4: dddocky folded before Flop (didn't bet)
Seat 6: RichRick1337 folded on the Flop
Seat 7: HighCardJasper folded before Flop (didn't bet)
Seat 9: JeBoyDirk folded before Flop (didn't bet)



PokerStars Home Game Hand #219637793056: {Club #3225207}  Hold'em No Limit (50/100) - 2020/10/22 17:41:13 ET
Table 'VU_table_tonight' 9-max (Play Money) Seat #2 is the button
Seat 1: color_singleton (15072 in chips) 
Seat 2: MnnM150 (6477 in chips) 
Seat 3: Duke Croix (36051 in chips) 
Seat 4: dddocky (2286 in chips) 
Seat 6: RichRick1337 (947 in chips) 
Seat 7: HighCardJasper (21003 in chips) 
Seat 9: JeBoyDirk (18159 in chips) 
Duke Croix: posts small blind 50
dddocky: posts big blind 100
*** HOLE CARDS ***
Dealt to Duke Croix [9s Tc]
RichRick1337: calls 100
HighCardJasper: calls 100
JeBoyDirk: folds 
color_singleton: raises 100 to 200
MnnM150: calls 200
Duke Croix: calls 150
dddocky: calls 100
RichRick1337: calls 100
HighCardJasper: calls 100
*** FLOP *** [3c 6d 4h]
Duke Croix: checks 
dddocky: checks 
RichRick1337: bets 200
HighCardJasper: calls 200
color_singleton: calls 200
MnnM150: calls 200
Duke Croix: folds 
dddocky: calls 200
*** TURN *** [3c 6d 4h] [As]
dddocky: checks 
RichRick1337: checks 
HighCardJasper: checks 
color_singleton: checks 
MnnM150: bets 1039
dddocky: folds 
RichRick1337: folds 
HighCardJasper: folds 
color_singleton: folds 
Uncalled bet (1039) returned to MnnM150
MnnM150 collected 2079 from pot
*** SUMMARY ***
Total pot 2200 | Rake 121 
Board [3c 6d 4h As]
Seat 1: color_singleton folded on the Turn
Seat 2: MnnM150 (button) collected (2079)
Seat 3: Duke Croix (small blind) folded on the Flop
Seat 4: dddocky (big blind) folded on the Turn
Seat 6: RichRick1337 folded on the Turn
Seat 7: HighCardJasper folded on the Turn
Seat 9: JeBoyDirk folded before Flop (didn't bet)



PokerStars Home Game Hand #219637821923: {Club #3225207}  Hold'em No Limit (50/100) - 2020/10/22 17:42:06 ET
Table 'VU_table_tonight' 9-max (Play Money) Seat #3 is the button
Seat 1: color_singleton (14672 in chips) 
Seat 2: MnnM150 (8156 in chips) 
Seat 3: Duke Croix (35851 in chips) 
Seat 4: dddocky (1886 in chips) 
Seat 6: RichRick1337 (547 in chips) 
Seat 7: HighCardJasper (20603 in chips) 
Seat 8: appositive (8971 in chips) 
Seat 9: JeBoyDirk (18159 in chips) 
dddocky: posts small blind 50
RichRick1337: posts big blind 100
*** HOLE CARDS ***
Dealt to Duke Croix [4d Js]
HighCardJasper: folds 
appositive: folds 
JeBoyDirk: folds 
color_singleton: calls 100
MnnM150: raises 100 to 200
Duke Croix: folds 
dddocky: folds 
RichRick1337: folds 
color_singleton: calls 100
*** FLOP *** [Ad Qh 4c]
color_singleton: checks 
MnnM150: bets 260
color_singleton: calls 260
*** TURN *** [Ad Qh 4c] [3d]
color_singleton: checks 
MnnM150: bets 505
color_singleton: calls 505
*** RIVER *** [Ad Qh 4c 3d] [5c]
color_singleton: checks 
MnnM150: bets 983
color_singleton: folds 
Uncalled bet (983) returned to MnnM150
MnnM150 collected 1966 from pot
*** SUMMARY ***
Total pot 2080 | Rake 114 
Board [Ad Qh 4c 3d 5c]
Seat 1: color_singleton folded on the River
Seat 2: MnnM150 collected (1966)
Seat 3: Duke Croix (button) folded before Flop (didn't bet)
Seat 4: dddocky (small blind) folded before Flop
Seat 6: RichRick1337 (big blind) folded before Flop
Seat 7: HighCardJasper folded before Flop (didn't bet)
Seat 8: appositive folded before Flop (didn't bet)
Seat 9: JeBoyDirk folded before Flop (didn't bet)



PokerStars Home Game Hand #219637842204: {Club #3225207}  Hold'em No Limit (50/100) - 2020/10/22 17:42:44 ET
Table 'VU_table_tonight' 9-max (Play Money) Seat #4 is the button
Seat 1: color_singleton (13707 in chips) 
Seat 2: MnnM150 (9157 in chips) 
Seat 3: Duke Croix (35851 in chips) 
Seat 4: dddocky (1836 in chips) 
Seat 6: RichRick1337 (447 in chips) 
Seat 7: HighCardJasper (20603 in chips) 
Seat 8: appositive (8971 in chips) 
Seat 9: JeBoyDirk (18159 in chips) 
RichRick1337: posts small blind 50
HighCardJasper: posts big blind 100
*** HOLE CARDS ***
Dealt to Duke Croix [Ah Qh]
appositive: folds 
JeBoyDirk: folds 
color_singleton: folds 
MnnM150: calls 100
Duke Croix: raises 300 to 400
dddocky: folds 
RichRick1337: folds 
HighCardJasper: calls 300
MnnM150: folds 
*** FLOP *** [5c 8s 7h]
HighCardJasper: checks 
Duke Croix: checks 
*** TURN *** [5c 8s 7h] [Ad]
HighCardJasper: bets 500
Duke Croix: calls 500
*** RIVER *** [5c 8s 7h Ad] [4s]
HighCardJasper: bets 500
Duke Croix: raises 500 to 1000
HighCardJasper: calls 500
*** SHOW DOWN ***
Duke Croix: shows [Ah Qh] (a pair of Aces)
HighCardJasper: shows [Ac 5s] (two pair, Aces and Fives)
HighCardJasper collected 3733 from pot
*** SUMMARY ***
Total pot 3950 | Rake 217 
Board [5c 8s 7h Ad 4s]
Seat 1: color_singleton folded before Flop (didn't bet)
Seat 2: MnnM150 folded before Flop
Seat 3: Duke Croix showed [Ah Qh] and lost with a pair of Aces
Seat 4: dddocky (button) folded before Flop (didn't bet)
Seat 6: RichRick1337 (small blind) folded before Flop
Seat 7: HighCardJasper (big blind) showed [Ac 5s] and won (3733) with two pair, Aces and Fives
Seat 8: appositive folded before Flop (didn't bet)
Seat 9: JeBoyDirk folded before Flop (didn't bet)



PokerStars Home Game Hand #219637867460: {Club #3225207}  Hold'em No Limit (50/100) - 2020/10/22 17:43:31 ET
Table 'VU_table_tonight' 9-max (Play Money) Seat #6 is the button
Seat 1: color_singleton (13707 in chips) 
Seat 2: MnnM150 (9057 in chips) 
Seat 3: Duke Croix (33951 in chips) 
Seat 4: dddocky (1836 in chips) 
Seat 6: RichRick1337 (397 in chips) 
Seat 7: HighCardJasper (22436 in chips) 
Seat 8: appositive (8971 in chips) 
Seat 9: JeBoyDirk (18159 in chips) 
HighCardJasper: posts small blind 50
appositive: posts big blind 100
*** HOLE CARDS ***
Dealt to Duke Croix [Ad 9d]
JeBoyDirk: folds 
color_singleton: raises 100 to 200
MnnM150: calls 200
Duke Croix: raises 300 to 500
dddocky: calls 500
RichRick1337: folds 
HighCardJasper: folds 
appositive: calls 400
color_singleton: calls 300
MnnM150: calls 300
*** FLOP *** [9h 7d Jd]
appositive: checks 
color_singleton: checks 
MnnM150: checks 
Duke Croix: bets 1000
dddocky: folds 
appositive: folds 
color_singleton: folds 
MnnM150: folds 
Uncalled bet (1000) returned to Duke Croix
Duke Croix collected 2410 from pot
*** SUMMARY ***
Total pot 2550 | Rake 140 
Board [9h 7d Jd]
Seat 1: color_singleton folded on the Flop
Seat 2: MnnM150 folded on the Flop
Seat 3: Duke Croix collected (2410)
Seat 4: dddocky folded on the Flop
Seat 6: RichRick1337 (button) folded before Flop (didn't bet)
Seat 7: HighCardJasper (small blind) folded before Flop
Seat 8: appositive (big blind) folded on the Flop
Seat 9: JeBoyDirk folded before Flop (didn't bet)



PokerStars Home Game Hand #219637894790: {Club #3225207}  Hold'em No Limit (50/100) - 2020/10/22 17:44:23 ET
Table 'VU_table_tonight' 9-max (Play Money) Seat #7 is the button
Seat 1: color_singleton (13207 in chips) 
Seat 2: MnnM150 (8557 in chips) 
Seat 3: Duke Croix (35861 in chips) 
Seat 4: dddocky (1336 in chips) 
Seat 6: RichRick1337 (397 in chips) 
Seat 7: HighCardJasper (22386 in chips) 
Seat 8: appositive (8471 in chips) 
Seat 9: JeBoyDirk (18159 in chips) 
appositive: posts small blind 50
JeBoyDirk: posts big blind 100
*** HOLE CARDS ***
Dealt to Duke Croix [Qc 5d]
color_singleton: folds 
MnnM150: calls 100
Duke Croix: folds 
dddocky: calls 100
RichRick1337: folds 
HighCardJasper has timed out
HighCardJasper: folds 
appositive: folds 
JeBoyDirk: checks 
*** FLOP *** [8h 5h 2h]
JeBoyDirk: checks 
MnnM150: checks 
dddocky: bets 165
JeBoyDirk: folds 
MnnM150: calls 165
*** TURN *** [8h 5h 2h] [7d]
MnnM150: checks 
dddocky: bets 321
MnnM150: folds 
Uncalled bet (321) returned to dddocky
dddocky collected 643 from pot
dddocky: doesn't show hand 
*** SUMMARY ***
Total pot 680 | Rake 37 
Board [8h 5h 2h 7d]
Seat 1: color_singleton folded before Flop (didn't bet)
Seat 2: MnnM150 folded on the Turn
Seat 3: Duke Croix folded before Flop (didn't bet)
Seat 4: dddocky collected (643)
Seat 6: RichRick1337 folded before Flop (didn't bet)
Seat 7: HighCardJasper (button) folded before Flop (didn't bet)
Seat 8: appositive (small blind) folded before Flop
Seat 9: JeBoyDirk (big blind) folded on the Flop



PokerStars Home Game Hand #219637924119: {Club #3225207}  Hold'em No Limit (50/100) - 2020/10/22 17:45:18 ET
Table 'VU_table_tonight' 9-max (Play Money) Seat #8 is the button
Seat 1: color_singleton (13207 in chips) 
Seat 2: MnnM150 (8292 in chips) 
Seat 3: Duke Croix (35861 in chips) 
Seat 4: dddocky (1714 in chips) 
Seat 6: RichRick1337 (397 in chips) 
Seat 8: appositive (8421 in chips) 
Seat 9: JeBoyDirk (18059 in chips) 
JeBoyDirk: posts small blind 50
color_singleton: posts big blind 100
*** HOLE CARDS ***
Dealt to Duke Croix [9c 2c]
MnnM150: calls 100
Duke Croix: folds 
dddocky: calls 100
RichRick1337: calls 100
appositive: folds 
JeBoyDirk: calls 50
color_singleton: checks 
*** FLOP *** [Js 6s 7c]
JeBoyDirk: checks 
color_singleton: checks 
MnnM150: checks 
dddocky: bets 200
RichRick1337: folds 
JeBoyDirk: calls 200
color_singleton: folds 
MnnM150: folds 
*** TURN *** [Js 6s 7c] [Ac]
JeBoyDirk: checks 
dddocky: bets 100
JeBoyDirk: raises 400 to 500
dddocky: calls 400
*** RIVER *** [Js 6s 7c Ac] [2d]
JeBoyDirk: checks 
dddocky: checks 
*** SHOW DOWN ***
JeBoyDirk: shows [8c 8s] (a pair of Eights)
dddocky: shows [8h Jh] (a pair of Jacks)
dddocky collected 1795 from pot
*** SUMMARY ***
Total pot 1900 | Rake 105 
Board [Js 6s 7c Ac 2d]
Seat 1: color_singleton (big blind) folded on the Flop
Seat 2: MnnM150 folded on the Flop
Seat 3: Duke Croix folded before Flop (didn't bet)
Seat 4: dddocky showed [8h Jh] and won (1795) with a pair of Jacks
Seat 6: RichRick1337 folded on the Flop
Seat 8: appositive (button) folded before Flop (didn't bet)
Seat 9: JeBoyDirk (small blind) showed [8c 8s] and lost with a pair of Eights



PokerStars Home Game Hand #219637948682: {Club #3225207}  Hold'em No Limit (50/100) - 2020/10/22 17:46:04 ET
Table 'VU_table_tonight' 9-max (Play Money) Seat #9 is the button
Seat 1: color_singleton (13107 in chips) 
Seat 2: MnnM150 (8192 in chips) 
Seat 3: Duke Croix (35861 in chips) 
Seat 4: dddocky (2709 in chips) 
Seat 6: RichRick1337 (297 in chips) 
Seat 7: HighCardJasper (22386 in chips) 
Seat 8: appositive (8421 in chips) 
Seat 9: JeBoyDirk (17259 in chips) 
color_singleton: posts small blind 50
MnnM150: posts big blind 100
*** HOLE CARDS ***
Dealt to Duke Croix [Ah 4d]
Duke Croix: folds 
dddocky: folds 
RichRick1337: calls 100
HighCardJasper: calls 100
appositive: calls 100
JeBoyDirk: folds 
color_singleton: calls 50
MnnM150: checks 
*** FLOP *** [6s Jh Td]
color_singleton: checks 
MnnM150: checks 
RichRick1337: checks 
HighCardJasper: checks 
appositive: checks 
*** TURN *** [6s Jh Td] [As]
color_singleton: checks 
MnnM150: bets 236
RichRick1337: folds 
HighCardJasper: folds 
appositive: calls 236
color_singleton: folds 
*** RIVER *** [6s Jh Td As] [Ad]
MnnM150: bets 459
appositive: calls 459
*** SHOW DOWN ***
MnnM150: shows [6c Th] (two pair, Aces and Tens)
appositive: shows [Ks Js] (two pair, Aces and Jacks)
appositive collected 1786 from pot
*** SUMMARY ***
Total pot 1890 | Rake 104 
Board [6s Jh Td As Ad]
Seat 1: color_singleton (small blind) folded on the Turn
Seat 2: MnnM150 (big blind) showed [6c Th] and lost with two pair, Aces and Tens
Seat 3: Duke Croix folded before Flop (didn't bet)
Seat 4: dddocky folded before Flop (didn't bet)
Seat 6: RichRick1337 folded on the Turn
Seat 7: HighCardJasper folded on the Turn
Seat 8: appositive showed [Ks Js] and won (1786) with two pair, Aces and Jacks
Seat 9: JeBoyDirk (button) folded before Flop (didn't bet)



PokerStars Home Game Hand #219637979157: {Club #3225207}  Hold'em No Limit (50/100) - 2020/10/22 17:47:02 ET
Table 'VU_table_tonight' 9-max (Play Money) Seat #1 is the button
Seat 1: color_singleton (13007 in chips) 
Seat 2: MnnM150 (7397 in chips) 
Seat 3: Duke Croix (35861 in chips) 
Seat 4: dddocky (2709 in chips) 
Seat 6: RichRick1337 (197 in chips) 
Seat 7: HighCardJasper (22286 in chips) 
Seat 8: appositive (9412 in chips) 
Seat 9: JeBoyDirk (17259 in chips) 
MnnM150: posts small blind 50
Duke Croix: posts big blind 100
*** HOLE CARDS ***
Dealt to Duke Croix [6h 2h]
dddocky: folds 
RichRick1337: calls 100
HighCardJasper: calls 100
appositive: calls 100
JeBoyDirk: folds 
color_singleton: calls 100
MnnM150: calls 50
Duke Croix: checks 
*** FLOP *** [8s Qd 7c]
MnnM150: checks 
Duke Croix: checks 
RichRick1337: bets 97 and is all-in
HighCardJasper: calls 97
appositive: calls 97
color_singleton: calls 97
MnnM150: folds 
Duke Croix: folds 
*** TURN *** [8s Qd 7c] [3h]
HighCardJasper: checks 
appositive: checks 
color_singleton: checks 
*** RIVER *** [8s Qd 7c 3h] [Kc]
HighCardJasper: checks 
appositive: checks 
color_singleton: checks 
*** SHOW DOWN ***
RichRick1337: shows [4s Kh] (a pair of Kings)
HighCardJasper: mucks hand 
appositive: mucks hand 
color_singleton: shows [6d Ks] (a pair of Kings)
RichRick1337 collected 467 from pot
color_singleton collected 467 from pot
*** SUMMARY ***
Total pot 988 | Rake 54 
Board [8s Qd 7c 3h Kc]
Seat 1: color_singleton (button) showed [6d Ks] and won (467) with a pair of Kings
Seat 2: MnnM150 (small blind) folded on the Flop
Seat 3: Duke Croix (big blind) folded on the Flop
Seat 4: dddocky folded before Flop (didn't bet)
Seat 6: RichRick1337 showed [4s Kh] and won (467) with a pair of Kings
Seat 7: HighCardJasper mucked [Tc As]
Seat 8: appositive mucked [5d 6c]
Seat 9: JeBoyDirk folded before Flop (didn't bet)



PokerStars Home Game Hand #219638004290: {Club #3225207}  Hold'em No Limit (50/100) - 2020/10/22 17:47:50 ET
Table 'VU_table_tonight' 9-max (Play Money) Seat #2 is the button
Seat 1: color_singleton (13277 in chips) 
Seat 2: MnnM150 (7297 in chips) 
Seat 3: Duke Croix (35761 in chips) 
Seat 4: dddocky (2709 in chips) 
Seat 6: RichRick1337 (467 in chips) 
Seat 7: HighCardJasper (22089 in chips) 
Seat 8: appositive (9215 in chips) 
Seat 9: JeBoyDirk (17259 in chips) 
Duke Croix: posts small blind 50
dddocky: posts big blind 100
*** HOLE CARDS ***
Dealt to Duke Croix [5s 4c]
RichRick1337: calls 100
HighCardJasper: calls 100
appositive: folds 
JeBoyDirk: folds 
color_singleton: calls 100
MnnM150: calls 100
Duke Croix: calls 50
dddocky: checks 
*** FLOP *** [Qs Jc 8d]
Duke Croix: checks 
dddocky: checks 
RichRick1337: bets 100
HighCardJasper: calls 100
color_singleton: calls 100
MnnM150: raises 100 to 200
Duke Croix: folds 
dddocky: folds 
RichRick1337: calls 100
HighCardJasper: folds 
color_singleton: calls 100
*** TURN *** [Qs Jc 8d] [5h]
RichRick1337: checks 
color_singleton: checks 
MnnM150: bets 614
RichRick1337: calls 167 and is all-in
color_singleton: calls 614
*** RIVER *** [Qs Jc 8d 5h] [7h]
color_singleton: checks 
MnnM150: bets 1273
color_singleton: folds 
Uncalled bet (1273) returned to MnnM150
*** SHOW DOWN ***
MnnM150: shows [Jh 5c] (two pair, Jacks and Fives)
MnnM150 collected 845 from side pot
RichRick1337: shows [Ks As] (high card Ace)
MnnM150 collected 1702 from main pot
*** SUMMARY ***
Total pot 2695 Main pot 1702. Side pot 845. | Rake 148 
Board [Qs Jc 8d 5h 7h]
Seat 1: color_singleton folded on the River
Seat 2: MnnM150 (button) showed [Jh 5c] and won (2547) with two pair, Jacks and Fives
Seat 3: Duke Croix (small blind) folded on the Flop
Seat 4: dddocky (big blind) folded on the Flop
Seat 6: RichRick1337 showed [Ks As] and lost with high card Ace
Seat 7: HighCardJasper folded on the Flop
Seat 8: appositive folded before Flop (didn't bet)
Seat 9: JeBoyDirk folded before Flop (didn't bet)



PokerStars Home Game Hand #219638039516: {Club #3225207}  Hold'em No Limit (50/100) - 2020/10/22 17:48:57 ET
Table 'VU_table_tonight' 9-max (Play Money) Seat #3 is the button
Seat 1: color_singleton (12363 in chips) 
Seat 2: MnnM150 (8930 in chips) 
Seat 3: Duke Croix (35661 in chips) 
Seat 4: dddocky (2609 in chips) 
Seat 7: HighCardJasper (21889 in chips) 
Seat 8: appositive (9215 in chips) 
Seat 9: JeBoyDirk (17259 in chips) 
dddocky: posts small blind 50
HighCardJasper: posts big blind 100
*** HOLE CARDS ***
Dealt to Duke Croix [5h 7c]
appositive: folds 
JeBoyDirk: folds 
color_singleton: raises 200 to 300
MnnM150: calls 300
Duke Croix: folds 
dddocky: folds 
HighCardJasper: calls 200
*** FLOP *** [4c Ac Ts]
HighCardJasper: checks 
color_singleton: bets 449
MnnM150: folds 
HighCardJasper: folds 
Uncalled bet (449) returned to color_singleton
color_singleton collected 898 from pot
color_singleton: doesn't show hand 
*** SUMMARY ***
Total pot 950 | Rake 52 
Board [4c Ac Ts]
Seat 1: color_singleton collected (898)
Seat 2: MnnM150 folded on the Flop
Seat 3: Duke Croix (button) folded before Flop (didn't bet)
Seat 4: dddocky (small blind) folded before Flop
Seat 7: HighCardJasper (big blind) folded on the Flop
Seat 8: appositive folded before Flop (didn't bet)
Seat 9: JeBoyDirk folded before Flop (didn't bet)



PokerStars Home Game Hand #219638055411: {Club #3225207}  Hold'em No Limit (50/100) - 2020/10/22 17:49:27 ET
Table 'VU_table_tonight' 9-max (Play Money) Seat #4 is the button
Seat 1: color_singleton (12961 in chips) 
Seat 2: MnnM150 (8630 in chips) 
Seat 3: Duke Croix (35661 in chips) 
Seat 4: dddocky (2559 in chips) 
Seat 7: HighCardJasper (21589 in chips) 
Seat 8: appositive (9215 in chips) 
Seat 9: JeBoyDirk (17259 in chips) 
HighCardJasper: posts small blind 50
appositive: posts big blind 100
*** HOLE CARDS ***
Dealt to Duke Croix [4h Jc]
JeBoyDirk: folds 
color_singleton: raises 200 to 300
MnnM150: calls 300
Duke Croix: folds 
dddocky: folds 
HighCardJasper: folds 
appositive: folds 
*** FLOP *** [2s 3c 6d]
color_singleton: bets 354
MnnM150: folds 
Uncalled bet (354) returned to color_singleton
color_singleton collected 709 from pot
color_singleton: doesn't show hand 
*** SUMMARY ***
Total pot 750 | Rake 41 
Board [2s 3c 6d]
Seat 1: color_singleton collected (709)
Seat 2: MnnM150 folded on the Flop
Seat 3: Duke Croix folded before Flop (didn't bet)
Seat 4: dddocky (button) folded before Flop (didn't bet)
Seat 7: HighCardJasper (small blind) folded before Flop
Seat 8: appositive (big blind) folded before Flop
Seat 9: JeBoyDirk folded before Flop (didn't bet)



PokerStars Home Game Hand #219638067204: {Club #3225207}  Hold'em No Limit (50/100) - 2020/10/22 17:49:50 ET
Table 'VU_table_tonight' 9-max (Play Money) Seat #7 is the button
Seat 1: color_singleton (13370 in chips) 
Seat 2: MnnM150 (8330 in chips) 
Seat 3: Duke Croix (35661 in chips) 
Seat 4: dddocky (2559 in chips) 
Seat 7: HighCardJasper (21539 in chips) 
Seat 8: appositive (9115 in chips) 
Seat 9: JeBoyDirk (17259 in chips) 
appositive: posts small blind 50
JeBoyDirk: posts big blind 100
*** HOLE CARDS ***
Dealt to Duke Croix [Ad 8d]
color_singleton: raises 200 to 300
MnnM150: calls 300
Duke Croix: calls 300
dddocky: folds 
HighCardJasper: folds 
appositive: calls 250
JeBoyDirk: folds 
*** FLOP *** [7d 5c 3c]
appositive: bets 200
color_singleton: calls 200
MnnM150: calls 200
Duke Croix: calls 200
*** TURN *** [7d 5c 3c] [2h]
appositive: bets 700
color_singleton: folds 
MnnM150: folds 
Duke Croix: folds 
Uncalled bet (700) returned to appositive
appositive collected 1984 from pot
appositive: doesn't show hand 
*** SUMMARY ***
Total pot 2100 | Rake 116 
Board [7d 5c 3c 2h]
Seat 1: color_singleton folded on the Turn
Seat 2: MnnM150 folded on the Turn
Seat 3: Duke Croix folded on the Turn
Seat 4: dddocky folded before Flop (didn't bet)
Seat 7: HighCardJasper (button) folded before Flop (didn't bet)
Seat 8: appositive (small blind) collected (1984)
Seat 9: JeBoyDirk (big blind) folded before Flop



PokerStars Home Game Hand #219638092556: {Club #3225207}  Hold'em No Limit (50/100) - 2020/10/22 17:50:38 ET
Table 'VU_table_tonight' 9-max (Play Money) Seat #8 is the button
Seat 1: color_singleton (12870 in chips) 
Seat 2: MnnM150 (7830 in chips) 
Seat 3: Duke Croix (35161 in chips) 
Seat 4: dddocky (2559 in chips) 
Seat 7: HighCardJasper (21539 in chips) 
Seat 8: appositive (10599 in chips) 
Seat 9: JeBoyDirk (17159 in chips) 
JeBoyDirk: posts small blind 50
color_singleton: posts big blind 100
*** HOLE CARDS ***
Dealt to Duke Croix [As 3h]
MnnM150: calls 100
Duke Croix: folds 
dddocky: calls 100
HighCardJasper: calls 100
appositive: raises 300 to 400
JeBoyDirk: calls 350
color_singleton: folds 
MnnM150: calls 300
dddocky: folds 
HighCardJasper: calls 300
*** FLOP *** [Js 9h 2c]
JeBoyDirk: checks 
MnnM150: checks 
HighCardJasper: checks 
appositive: checks 
*** TURN *** [Js 9h 2c] [6d]
JeBoyDirk: checks 
MnnM150: checks 
HighCardJasper: checks 
appositive: bets 1000
JeBoyDirk: folds 
MnnM150: folds 
HighCardJasper: folds 
Uncalled bet (1000) returned to appositive
appositive collected 1701 from pot
appositive: doesn't show hand 
*** SUMMARY ***
Total pot 1800 | Rake 99 
Board [Js 9h 2c 6d]
Seat 1: color_singleton (big blind) folded before Flop
Seat 2: MnnM150 folded on the Turn
Seat 3: Duke Croix folded before Flop (didn't bet)
Seat 4: dddocky folded before Flop
Seat 7: HighCardJasper folded on the Turn
Seat 8: appositive (button) collected (1701)
Seat 9: JeBoyDirk (small blind) folded on the Turn



PokerStars Home Game Hand #219638129136: {Club #3225207}  Hold'em No Limit (50/100) - 2020/10/22 17:51:49 ET
Table 'VU_table_tonight' 9-max (Play Money) Seat #9 is the button
Seat 1: color_singleton (12770 in chips) 
Seat 2: MnnM150 (7430 in chips) 
Seat 3: Duke Croix (35161 in chips) 
Seat 4: dddocky (2459 in chips) 
Seat 7: HighCardJasper (21139 in chips) 
Seat 8: appositive (11900 in chips) 
Seat 9: JeBoyDirk (16759 in chips) 
color_singleton: posts small blind 50
MnnM150: posts big blind 100
*** HOLE CARDS ***
Dealt to Duke Croix [8d Td]
Duke Croix: calls 100
dddocky: folds 
HighCardJasper: folds 
appositive: calls 100
JeBoyDirk: folds 
color_singleton: calls 50
MnnM150: checks 
*** FLOP *** [Qc 5s 5c]
color_singleton: checks 
MnnM150: checks 
Duke Croix: checks 
appositive: checks 
*** TURN *** [Qc 5s 5c] [Jc]
color_singleton: bets 378
MnnM150: folds 
Duke Croix: folds 
appositive: folds 
Uncalled bet (378) returned to color_singleton
color_singleton collected 378 from pot
color_singleton: doesn't show hand 
*** SUMMARY ***
Total pot 400 | Rake 22 
Board [Qc 5s 5c Jc]
Seat 1: color_singleton (small blind) collected (378)
Seat 2: MnnM150 (big blind) folded on the Turn
Seat 3: Duke Croix folded on the Turn
Seat 4: dddocky folded before Flop (didn't bet)
Seat 7: HighCardJasper folded before Flop (didn't bet)
Seat 8: appositive folded on the Turn
Seat 9: JeBoyDirk (button) folded before Flop (didn't bet)



PokerStars Home Game Hand #219638147745: {Club #3225207}  Hold'em No Limit (50/100) - 2020/10/22 17:52:25 ET
Table 'VU_table_tonight' 9-max (Play Money) Seat #1 is the button
Seat 1: color_singleton (13048 in chips) 
Seat 2: MnnM150 (7330 in chips) 
Seat 3: Duke Croix (35061 in chips) 
Seat 4: dddocky (2459 in chips) 
Seat 7: HighCardJasper (21139 in chips) 
Seat 8: appositive (11800 in chips) 
Seat 9: JeBoyDirk (16759 in chips) 
MnnM150: posts small blind 50
Duke Croix: posts big blind 100
*** HOLE CARDS ***
Dealt to Duke Croix [8h 5s]
dddocky: calls 100
HighCardJasper: folds 
appositive: calls 100
JeBoyDirk: folds 
color_singleton: folds 
MnnM150: folds 
Duke Croix: checks 
*** FLOP *** [6s Qh 4s]
Duke Croix: checks 
dddocky: bets 165
appositive: calls 165
Duke Croix: folds 
*** TURN *** [6s Qh 4s] [7h]
dddocky: bets 321
appositive: folds 
Uncalled bet (321) returned to dddocky
dddocky collected 643 from pot
dddocky: doesn't show hand 
*** SUMMARY ***
Total pot 680 | Rake 37 
Board [6s Qh 4s 7h]
Seat 1: color_singleton (button) folded before Flop (didn't bet)
Seat 2: MnnM150 (small blind) folded before Flop
Seat 3: Duke Croix (big blind) folded on the Flop
Seat 4: dddocky collected (643)
Seat 7: HighCardJasper folded before Flop (didn't bet)
Seat 8: appositive folded on the Turn
Seat 9: JeBoyDirk folded before Flop (didn't bet)



PokerStars Home Game Hand #219638177293: {Club #3225207}  Hold'em No Limit (50/100) - 2020/10/22 17:53:12 ET
Table 'VU_table_tonight' 9-max (Play Money) Seat #2 is the button
Seat 1: color_singleton (13048 in chips) 
Seat 2: MnnM150 (7280 in chips) 
Seat 3: Duke Croix (34961 in chips) 
Seat 4: dddocky (2837 in chips) 
Seat 7: HighCardJasper (21139 in chips) 
Seat 8: appositive (11535 in chips) 
Seat 9: JeBoyDirk (16759 in chips) 
Duke Croix: posts small blind 50
dddocky: posts big blind 100
*** HOLE CARDS ***
Dealt to Duke Croix [4h 5s]
RichRick1337 leaves the table
HighCardJasper has timed out
HighCardJasper: folds 
appositive: calls 100
JeBoyDirk: folds 
color_singleton: folds 
MnnM150: folds 
Duke Croix: calls 50
dddocky: checks 
*** FLOP *** [3s 9s Ks]
Duke Croix: checks 
dddocky: checks 
appositive: bets 400
Duke Croix: folds 
dddocky: folds 
Uncalled bet (400) returned to appositive
appositive collected 283 from pot
appositive: doesn't show hand 
*** SUMMARY ***
Total pot 300 | Rake 17 
Board [3s 9s Ks]
Seat 1: color_singleton folded before Flop (didn't bet)
Seat 2: MnnM150 (button) folded before Flop (didn't bet)
Seat 3: Duke Croix (small blind) folded on the Flop
Seat 4: dddocky (big blind) folded on the Flop
Seat 7: HighCardJasper folded before Flop (didn't bet)
Seat 8: appositive collected (283)
Seat 9: JeBoyDirk folded before Flop (didn't bet)



PokerStars Home Game Hand #219638197804: {Club #3225207}  Hold'em No Limit (50/100) - 2020/10/22 17:53:52 ET
Table 'VU_table_tonight' 9-max (Play Money) Seat #3 is the button
Seat 1: color_singleton (13048 in chips) 
Seat 2: MnnM150 (7280 in chips) 
Seat 3: Duke Croix (34861 in chips) 
Seat 4: dddocky (2737 in chips) 
Seat 8: appositive (11718 in chips) 
Seat 9: JeBoyDirk (16759 in chips) 
dddocky: posts small blind 50
appositive: posts big blind 100
*** HOLE CARDS ***
Dealt to Duke Croix [4h Js]
JeBoyDirk: folds 
color_singleton: raises 100 to 200
MnnM150: folds 
Duke Croix: folds 
dddocky: folds 
appositive: folds 
Uncalled bet (100) returned to color_singleton
color_singleton collected 250 from pot
color_singleton: doesn't show hand 
*** SUMMARY ***
Total pot 250 | Rake 0 
Seat 1: color_singleton collected (250)
Seat 2: MnnM150 folded before Flop (didn't bet)
Seat 3: Duke Croix (button) folded before Flop (didn't bet)
Seat 4: dddocky (small blind) folded before Flop
Seat 8: appositive (big blind) folded before Flop
Seat 9: JeBoyDirk folded before Flop (didn't bet)



PokerStars Home Game Hand #219638204334: {Club #3225207}  Hold'em No Limit (50/100) - 2020/10/22 17:54:05 ET
Table 'VU_table_tonight' 9-max (Play Money) Seat #4 is the button
Seat 1: color_singleton (13198 in chips) 
Seat 2: MnnM150 (7280 in chips) 
Seat 3: Duke Croix (34861 in chips) 
Seat 4: dddocky (2687 in chips) 
Seat 8: appositive (11618 in chips) 
Seat 9: JeBoyDirk (16759 in chips) 
appositive: posts small blind 50
JeBoyDirk: posts big blind 100
*** HOLE CARDS ***
Dealt to Duke Croix [7c Kc]
color_singleton: raises 100 to 200
MnnM150: calls 200
Duke Croix: calls 200
dddocky: calls 200
appositive: folds 
JeBoyDirk: folds 
*** FLOP *** [9h Jc 7d]
color_singleton: checks 
MnnM150: checks 
Duke Croix: checks 
dddocky: checks 
*** TURN *** [9h Jc 7d] [9s]
color_singleton: checks 
MnnM150: checks 
Duke Croix: bets 400
dddocky: folds 
color_singleton: folds 
MnnM150: calls 400
*** RIVER *** [9h Jc 7d 9s] [8d]
MnnM150: checks 
Duke Croix: checks 
*** SHOW DOWN ***
MnnM150: shows [Ks 5c] (a pair of Nines)
Duke Croix: shows [7c Kc] (two pair, Nines and Sevens)
Duke Croix collected 1654 from pot
*** SUMMARY ***
Total pot 1750 | Rake 96 
Board [9h Jc 7d 9s 8d]
Seat 1: color_singleton folded on the Turn
Seat 2: MnnM150 showed [Ks 5c] and lost with a pair of Nines
Seat 3: Duke Croix showed [7c Kc] and won (1654) with two pair, Nines and Sevens
Seat 4: dddocky (button) folded on the Turn
Seat 8: appositive (small blind) folded before Flop
Seat 9: JeBoyDirk (big blind) folded before Flop



PokerStars Home Game Hand #219638226542: {Club #3225207}  Hold'em No Limit (50/100) - 2020/10/22 17:54:48 ET
Table 'VU_table_tonight' 9-max (Play Money) Seat #8 is the button
Seat 1: color_singleton (12998 in chips) 
Seat 2: MnnM150 (6680 in chips) 
Seat 3: Duke Croix (35915 in chips) 
Seat 4: dddocky (2487 in chips) 
Seat 7: HighCardJasper (21139 in chips) 
Seat 8: appositive (11568 in chips) 
Seat 9: JeBoyDirk (16659 in chips) 
JeBoyDirk: posts small blind 50
color_singleton: posts big blind 100
HighCardJasper: posts small & big blinds 150
*** HOLE CARDS ***
Dealt to Duke Croix [6s 8d]
MnnM150: calls 100
Duke Croix: folds 
dddocky: folds 
HighCardJasper: checks 
appositive: folds 
JeBoyDirk: raises 100 to 200
color_singleton: folds 
MnnM150: calls 100
HighCardJasper: folds 
*** FLOP *** [9c Jd Ah]
JeBoyDirk: checks 
MnnM150: checks 
*** TURN *** [9c Jd Ah] [7c]
JeBoyDirk has timed out
JeBoyDirk: checks 
MnnM150: checks 
*** RIVER *** [9c Jd Ah 7c] [8h]
JeBoyDirk: checks 
MnnM150: checks 
*** SHOW DOWN ***
JeBoyDirk: shows [6c Qd] (high card Ace)
MnnM150: shows [3h Kd] (high card Ace - King kicker)
MnnM150 collected 614 from pot
*** SUMMARY ***
Total pot 650 | Rake 36 
Board [9c Jd Ah 7c 8h]
Seat 1: color_singleton (big blind) folded before Flop
Seat 2: MnnM150 showed [3h Kd] and won (614) with high card Ace
Seat 3: Duke Croix folded before Flop (didn't bet)
Seat 4: dddocky folded before Flop (didn't bet)
Seat 7: HighCardJasper folded before Flop (didn't bet)
Seat 8: appositive (button) folded before Flop (didn't bet)
Seat 9: JeBoyDirk (small blind) showed [6c Qd] and lost with high card Ace



PokerStars Home Game Hand #219638247268: {Club #3225207}  Hold'em No Limit (50/100) - 2020/10/22 17:55:33 ET
Table 'VU_table_tonight' 9-max (Play Money) Seat #9 is the button
Seat 1: color_singleton (12898 in chips) 
Seat 2: MnnM150 (7094 in chips) 
Seat 3: Duke Croix (35915 in chips) 
Seat 4: dddocky (2487 in chips) 
Seat 7: HighCardJasper (20989 in chips) 
Seat 8: appositive (11568 in chips) 
Seat 9: JeBoyDirk (16459 in chips) 
color_singleton: posts small blind 50
MnnM150: posts big blind 100
*** HOLE CARDS ***
Dealt to Duke Croix [4c 3s]
Duke Croix: folds 
dddocky: raises 100 to 200
HighCardJasper: calls 200
appositive: raises 100 to 300
JeBoyDirk: folds 
color_singleton: calls 250
MnnM150: calls 200
dddocky: calls 100
HighCardJasper: calls 100
*** FLOP *** [Ks 8s Js]
color_singleton: checks 
MnnM150: bets 708
dddocky: calls 708
HighCardJasper: folds 
appositive: folds 
color_singleton: calls 708
*** TURN *** [Ks 8s Js] [5s]
color_singleton: checks 
MnnM150: checks 
dddocky: checks 
*** RIVER *** [Ks 8s Js 5s] [8h]
color_singleton: bets 3425
MnnM150: calls 3425
dddocky: folds 
*** SHOW DOWN ***
color_singleton: shows [Qh As] (a flush, Ace high)
MnnM150: mucks hand 
color_singleton collected 9898 from pot
*** SUMMARY ***
Total pot 10474 | Rake 576 
Board [Ks 8s Js 5s 8h]
Seat 1: color_singleton (small blind) showed [Qh As] and won (9898) with a flush, Ace high
Seat 2: MnnM150 (big blind) mucked [Qs 8d]
Seat 3: Duke Croix folded before Flop (didn't bet)
Seat 4: dddocky folded on the River
Seat 7: HighCardJasper folded on the Flop
Seat 8: appositive folded on the Flop
Seat 9: JeBoyDirk (button) folded before Flop (didn't bet)



PokerStars Home Game Hand #219638275597: {Club #3225207}  Hold'em No Limit (50/100) - 2020/10/22 17:56:44 ET
Table 'VU_table_tonight' 9-max (Play Money) Seat #1 is the button
Seat 1: color_singleton (18363 in chips) 
Seat 2: MnnM150 (2661 in chips) 
Seat 3: Duke Croix (35915 in chips) 
Seat 4: dddocky (1479 in chips) 
Seat 7: HighCardJasper (20689 in chips) 
Seat 8: appositive (11268 in chips) 
Seat 9: JeBoyDirk (16459 in chips) 
MnnM150: posts small blind 50
Duke Croix: posts big blind 100
*** HOLE CARDS ***
Dealt to Duke Croix [3d 9h]
dddocky: folds 
HighCardJasper: folds 
appositive: calls 100
JeBoyDirk: folds 
color_singleton: folds 
MnnM150: folds 
Duke Croix: checks 
*** FLOP *** [Kh 6h Ac]
Duke Croix: checks 
appositive: checks 
*** TURN *** [Kh 6h Ac] [4c]
Duke Croix: checks 
appositive: checks 
*** RIVER *** [Kh 6h Ac 4c] [3c]
Duke Croix: checks 
appositive: bets 200
Duke Croix: calls 200
*** SHOW DOWN ***
appositive: shows [Th 9d] (high card Ace)
Duke Croix: shows [3d 9h] (a pair of Threes)
Duke Croix collected 614 from pot
*** SUMMARY ***
Total pot 650 | Rake 36 
Board [Kh 6h Ac 4c 3c]
Seat 1: color_singleton (button) folded before Flop (didn't bet)
Seat 2: MnnM150 (small blind) folded before Flop
Seat 3: Duke Croix (big blind) showed [3d 9h] and won (614) with a pair of Threes
Seat 4: dddocky folded before Flop (didn't bet)
Seat 7: HighCardJasper folded before Flop (didn't bet)
Seat 8: appositive showed [Th 9d] and lost with high card Ace
Seat 9: JeBoyDirk folded before Flop (didn't bet)



PokerStars Home Game Hand #219638294556: {Club #3225207}  Hold'em No Limit (50/100) - 2020/10/22 17:57:31 ET
Table 'VU_table_tonight' 9-max (Play Money) Seat #2 is the button
Seat 1: color_singleton (18363 in chips) 
Seat 2: MnnM150 (2611 in chips) 
Seat 3: Duke Croix (36229 in chips) 
Seat 4: dddocky (1479 in chips) 
Seat 7: HighCardJasper (20689 in chips) 
Seat 8: appositive (10968 in chips) 
Seat 9: JeBoyDirk (16459 in chips) 
Duke Croix: posts small blind 50
dddocky: posts big blind 100
*** HOLE CARDS ***
Dealt to Duke Croix [Kc 6d]
HighCardJasper: folds 
appositive: folds 
JeBoyDirk: raises 300 to 400
color_singleton: calls 400
MnnM150: calls 400
Duke Croix: folds 
dddocky: folds 
*** FLOP *** [2d 2c Qc]
JeBoyDirk: bets 600
color_singleton: folds 
MnnM150: folds 
Uncalled bet (600) returned to JeBoyDirk
JeBoyDirk collected 1276 from pot
*** SUMMARY ***
Total pot 1350 | Rake 74 
Board [2d 2c Qc]
Seat 1: color_singleton folded on the Flop
Seat 2: MnnM150 (button) folded on the Flop
Seat 3: Duke Croix (small blind) folded before Flop
Seat 4: dddocky (big blind) folded before Flop
Seat 7: HighCardJasper folded before Flop (didn't bet)
Seat 8: appositive folded before Flop (didn't bet)
Seat 9: JeBoyDirk collected (1276)



PokerStars Home Game Hand #219638304105: {Club #3225207}  Hold'em No Limit (50/100) - 2020/10/22 17:57:56 ET
Table 'VU_table_tonight' 9-max (Play Money) Seat #3 is the button
Seat 1: color_singleton (17963 in chips) 
Seat 2: MnnM150 (2211 in chips) 
Seat 3: Duke Croix (36179 in chips) 
Seat 4: dddocky (1379 in chips) 
Seat 7: HighCardJasper (20689 in chips) 
Seat 8: appositive (10968 in chips) 
Seat 9: JeBoyDirk (17335 in chips) 
dddocky: posts small blind 50
HighCardJasper: posts big blind 100
*** HOLE CARDS ***
Dealt to Duke Croix [5h Ad]
appositive: calls 100
JeBoyDirk: folds 
color_singleton: raises 200 to 300
MnnM150: folds 
JeBoyDirk leaves the table
Duke Croix: calls 300
dddocky: folds 
HighCardJasper: folds 
poorrick1338 joins the table at seat #9 
appositive: calls 200
*** FLOP *** [Th 4d 8d]
appositive: bets 500
color_singleton: calls 500
Duke Croix: folds 
*** TURN *** [Th 4d 8d] [Td]
appositive: bets 1000
color_singleton: folds 
Uncalled bet (1000) returned to appositive
appositive collected 1937 from pot
appositive: doesn't show hand 
*** SUMMARY ***
Total pot 2050 | Rake 113 
Board [Th 4d 8d Td]
Seat 1: color_singleton folded on the Turn
Seat 2: MnnM150 folded before Flop (didn't bet)
Seat 3: Duke Croix (button) folded on the Flop
Seat 4: dddocky (small blind) folded before Flop
Seat 7: HighCardJasper (big blind) folded before Flop
Seat 8: appositive collected (1937)
Seat 9: JeBoyDirk folded before Flop (didn't bet)



PokerStars Home Game Hand #219638328461: {Club #3225207}  Hold'em No Limit (50/100) - 2020/10/22 17:58:57 ET
Table 'VU_table_tonight' 9-max (Play Money) Seat #4 is the button
Seat 1: color_singleton (17163 in chips) 
Seat 2: MnnM150 (2211 in chips) 
Seat 3: Duke Croix (35879 in chips) 
Seat 4: dddocky (1329 in chips) 
Seat 7: HighCardJasper (20589 in chips) 
Seat 8: appositive (12105 in chips) 
Seat 9: poorrick1338 (10000 in chips) 
HighCardJasper: posts small blind 50
appositive: posts big blind 100
poorrick1338: posts big blind 100
*** HOLE CARDS ***
Dealt to Duke Croix [Qh 7d]
poorrick1338: checks 
color_singleton: folds 
MnnM150: calls 100
Duke Croix: folds 
dddocky: folds 
HighCardJasper: calls 50
appositive: checks 
*** FLOP *** [5s Ad 6d]
HighCardJasper: checks 
appositive: checks 
poorrick1338: bets 200
MnnM150: calls 200
HighCardJasper: folds 
appositive: calls 200
*** TURN *** [5s Ad 6d] [4c]
appositive: checks 
poorrick1338: bets 100
MnnM150: calls 100
appositive: calls 100
*** RIVER *** [5s Ad 6d 4c] [Tc]
appositive: checks 
poorrick1338: checks 
MnnM150: checks 
*** SHOW DOWN ***
appositive: shows [2h 6h] (a pair of Sixes)
poorrick1338: shows [As 8s] (a pair of Aces)
MnnM150: mucks hand 
poorrick1338 collected 1228 from pot
*** SUMMARY ***
Total pot 1300 | Rake 72 
Board [5s Ad 6d 4c Tc]
Seat 1: color_singleton folded before Flop (didn't bet)
Seat 2: MnnM150 mucked [Jd 6c]
Seat 3: Duke Croix folded before Flop (didn't bet)
Seat 4: dddocky (button) folded before Flop (didn't bet)
Seat 7: HighCardJasper (small blind) folded on the Flop
Seat 8: appositive (big blind) showed [2h 6h] and lost with a pair of Sixes
Seat 9: poorrick1338 showed [As 8s] and won (1228) with a pair of Aces



PokerStars Home Game Hand #219638356176: {Club #3225207}  Hold'em No Limit (50/100) - 2020/10/22 18:00:06 ET
Table 'VU_table_tonight' 9-max (Play Money) Seat #7 is the button
Seat 1: color_singleton (17163 in chips) 
Seat 2: MnnM150 (1811 in chips) 
Seat 3: Duke Croix (35879 in chips) 
Seat 4: dddocky (1329 in chips) 
Seat 7: HighCardJasper (20489 in chips) 
Seat 8: appositive (11705 in chips) 
Seat 9: poorrick1338 (10828 in chips) 
appositive: posts small blind 50
poorrick1338: posts big blind 100
*** HOLE CARDS ***
Dealt to Duke Croix [Qs Qc]
color_singleton: raises 100 to 200
MnnM150: calls 200
Duke Croix: raises 300 to 500
dddocky: calls 500
HighCardJasper: folds 
appositive: folds 
poorrick1338: folds 
color_singleton: calls 300
MnnM150: calls 300
*** FLOP *** [6h Ac 5d]
color_singleton: checks 
MnnM150: checks 
Duke Croix said, "0"
Duke Croix: bets 1000
dddocky: calls 829 and is all-in
color_singleton: calls 1000
MnnM150: folds 
*** TURN *** [6h Ac 5d] [7c]
color_singleton: checks 
Duke Croix: checks 
*** RIVER *** [6h Ac 5d 7c] [3s]
color_singleton: bets 2352
Duke Croix: folds 
Uncalled bet (2352) returned to color_singleton
*** SHOW DOWN ***
color_singleton: shows [4s Ad] (a straight, Three to Seven)
color_singleton collected 323 from side pot
dddocky: shows [9h Ah] (a pair of Aces)
color_singleton collected 4382 from main pot
*** SUMMARY ***
Total pot 4979 Main pot 4382. Side pot 323. | Rake 274 
Board [6h Ac 5d 7c 3s]
Seat 1: color_singleton showed [4s Ad] and won (4705) with a straight, Three to Seven
Seat 2: MnnM150 folded on the Flop
Seat 3: Duke Croix folded on the River
Seat 4: dddocky showed [9h Ah] and lost with a pair of Aces
Seat 7: HighCardJasper (button) folded before Flop (didn't bet)
Seat 8: appositive (small blind) folded before Flop
Seat 9: poorrick1338 (big blind) folded before Flop



PokerStars Home Game Hand #219638376155: {Club #3225207}  Hold'em No Limit (50/100) - 2020/10/22 18:00:54 ET
Table 'VU_table_tonight' 9-max (Play Money) Seat #8 is the button
Seat 1: color_singleton (20368 in chips) 
Seat 2: MnnM150 (1311 in chips) 
Seat 3: Duke Croix (34379 in chips) 
Seat 7: HighCardJasper (20489 in chips) 
Seat 8: appositive (11655 in chips) 
Seat 9: poorrick1338 (10728 in chips) 
poorrick1338: posts small blind 50
color_singleton: posts big blind 100
*** HOLE CARDS ***
Dealt to Duke Croix [2h 5c]
MnnM150: folds 
Duke Croix: folds 
HighCardJasper: calls 100
appositive: calls 100
poorrick1338: raises 100 to 200
color_singleton: calls 100
HighCardJasper: calls 100
appositive: calls 100
*** FLOP *** [3c 8s Td]
poorrick1338: checks 
color_singleton: bets 378
HighCardJasper: folds 
appositive: folds 
poorrick1338: calls 378
*** TURN *** [3c 8s Td] [Qc]
poorrick1338: checks 
color_singleton: checks 
*** RIVER *** [3c 8s Td Qc] [Jd]
poorrick1338: checks 
color_singleton: checks 
*** SHOW DOWN ***
poorrick1338: shows [Kh 7d] (high card King)
color_singleton: shows [5d 8c] (a pair of Eights)
color_singleton collected 1470 from pot
*** SUMMARY ***
Total pot 1556 | Rake 86 
Board [3c 8s Td Qc Jd]
Seat 1: color_singleton (big blind) showed [5d 8c] and won (1470) with a pair of Eights
Seat 2: MnnM150 folded before Flop (didn't bet)
Seat 3: Duke Croix folded before Flop (didn't bet)
Seat 7: HighCardJasper folded on the Flop
Seat 8: appositive (button) folded on the Flop
Seat 9: poorrick1338 (small blind) showed [Kh 7d] and lost with high card King



PokerStars Home Game Hand #219638400706: {Club #3225207}  Hold'em No Limit (50/100) - 2020/10/22 18:01:47 ET
Table 'VU_table_tonight' 9-max (Play Money) Seat #9 is the button
Seat 1: color_singleton (21260 in chips) 
Seat 2: MnnM150 (1311 in chips) 
Seat 3: Duke Croix (34379 in chips) 
Seat 4: dddocky (10000 in chips) 
Seat 7: HighCardJasper (20289 in chips) 
Seat 8: appositive (11455 in chips) 
Seat 9: poorrick1338 (10150 in chips) 
color_singleton: posts small blind 50
MnnM150: posts big blind 100
*** HOLE CARDS ***
Dealt to Duke Croix [2s 8s]
Duke Croix: folds 
dddocky: calls 100
HighCardJasper: folds 
appositive: calls 100
poorrick1338: calls 100
color_singleton: calls 50
MnnM150: raises 1211 to 1311 and is all-in
dddocky: folds 
appositive: folds 
poorrick1338: folds 
color_singleton: folds 
Uncalled bet (1211) returned to MnnM150
MnnM150 collected 500 from pot
*** SUMMARY ***
Total pot 500 | Rake 0 
Seat 1: color_singleton (small blind) folded before Flop
Seat 2: MnnM150 (big blind) collected (500)
Seat 3: Duke Croix folded before Flop (didn't bet)
Seat 4: dddocky folded before Flop
Seat 7: HighCardJasper folded before Flop (didn't bet)
Seat 8: appositive folded before Flop
Seat 9: poorrick1338 (button) folded before Flop



PokerStars Home Game Hand #219638418885: {Club #3225207}  Hold'em No Limit (50/100) - 2020/10/22 18:02:25 ET
Table 'VU_table_tonight' 9-max (Play Money) Seat #1 is the button
Seat 1: color_singleton (21160 in chips) 
Seat 2: MnnM150 (1711 in chips) 
Seat 3: Duke Croix (34379 in chips) 
Seat 4: dddocky (9900 in chips) 
Seat 7: HighCardJasper (20289 in chips) 
Seat 8: appositive (11355 in chips) 
Seat 9: poorrick1338 (10050 in chips) 
MnnM150: posts small blind 50
Duke Croix: posts big blind 100
*** HOLE CARDS ***
Dealt to Duke Croix [7s 7d]
dddocky: folds 
HighCardJasper: calls 100
appositive: folds 
poorrick1338: calls 100
color_singleton: raises 300 to 400
MnnM150: calls 350
Duke Croix: calls 300
HighCardJasper: folds 
poorrick1338: folds 
*** FLOP *** [Kh 2h 8h]
MnnM150: checks 
Duke Croix: bets 700
color_singleton: raises 700 to 1400
MnnM150: folds 
Duke Croix: folds 
Uncalled bet (700) returned to color_singleton
color_singleton collected 2646 from pot
color_singleton: doesn't show hand 
*** SUMMARY ***
Total pot 2800 | Rake 154 
Board [Kh 2h 8h]
Seat 1: color_singleton (button) collected (2646)
Seat 2: MnnM150 (small blind) folded on the Flop
Seat 3: Duke Croix (big blind) folded on the Flop
Seat 4: dddocky folded before Flop (didn't bet)
Seat 7: HighCardJasper folded before Flop
Seat 8: appositive folded before Flop (didn't bet)
Seat 9: poorrick1338 folded before Flop



PokerStars Home Game Hand #219638436949: {Club #3225207}  Hold'em No Limit (50/100) - 2020/10/22 18:03:02 ET
Table 'VU_table_tonight' 9-max (Play Money) Seat #2 is the button
Seat 1: color_singleton (22706 in chips) 
Seat 2: MnnM150 (1311 in chips) 
Seat 3: Duke Croix (33279 in chips) 
Seat 4: dddocky (9900 in chips) 
Seat 7: HighCardJasper (20189 in chips) 
Seat 8: appositive (11355 in chips) 
Seat 9: poorrick1338 (9950 in chips) 
Duke Croix: posts small blind 50
dddocky: posts big blind 100
*** HOLE CARDS ***
Dealt to Duke Croix [9c 5c]
HighCardJasper: folds 
appositive: folds 
poorrick1338: calls 100
color_singleton: folds 
MnnM150: calls 100
Duke Croix: calls 50
dddocky: checks 
*** FLOP *** [9s 3h 5s]
Duke Croix: bets 300
dddocky: folds 
poorrick1338: folds 
MnnM150: folds 
Uncalled bet (300) returned to Duke Croix
Duke Croix collected 378 from pot
*** SUMMARY ***
Total pot 400 | Rake 22 
Board [9s 3h 5s]
Seat 1: color_singleton folded before Flop (didn't bet)
Seat 2: MnnM150 (button) folded on the Flop
Seat 3: Duke Croix (small blind) collected (378)
Seat 4: dddocky (big blind) folded on the Flop
Seat 7: HighCardJasper folded before Flop (didn't bet)
Seat 8: appositive folded before Flop (didn't bet)
Seat 9: poorrick1338 folded on the Flop



PokerStars Home Game Hand #219638448514: {Club #3225207}  Hold'em No Limit (50/100) - 2020/10/22 18:03:25 ET
Table 'VU_table_tonight' 9-max (Play Money) Seat #3 is the button
Seat 1: color_singleton (22706 in chips) 
Seat 2: MnnM150 (1211 in chips) 
Seat 3: Duke Croix (33557 in chips) 
Seat 4: dddocky (9800 in chips) 
Seat 7: HighCardJasper (20189 in chips) 
Seat 8: appositive (11355 in chips) 
Seat 9: poorrick1338 (9850 in chips) 
dddocky: posts small blind 50
HighCardJasper: posts big blind 100
*** HOLE CARDS ***
Dealt to Duke Croix [6d 9c]
appositive: calls 100
poorrick1338: calls 100
color_singleton: raises 100 to 200
MnnM150: calls 200
Duke Croix: folds 
dddocky: folds 
HighCardJasper: calls 100
appositive: calls 100
poorrick1338: calls 100
*** FLOP *** [7s Ks Kh]
HighCardJasper: checks 
appositive: checks 
poorrick1338: checks 
color_singleton: bets 500
MnnM150: folds 
HighCardJasper: folds 
appositive: folds 
poorrick1338: folds 
Uncalled bet (500) returned to color_singleton
color_singleton collected 992 from pot
color_singleton: doesn't show hand 
*** SUMMARY ***
Total pot 1050 | Rake 58 
Board [7s Ks Kh]
Seat 1: color_singleton collected (992)
Seat 2: MnnM150 folded on the Flop
Seat 3: Duke Croix (button) folded before Flop (didn't bet)
Seat 4: dddocky (small blind) folded before Flop
Seat 7: HighCardJasper (big blind) folded on the Flop
Seat 8: appositive folded on the Flop
Seat 9: poorrick1338 folded on the Flop



PokerStars Home Game Hand #219638472830: {Club #3225207}  Hold'em No Limit (50/100) - 2020/10/22 18:04:15 ET
Table 'VU_table_tonight' 9-max (Play Money) Seat #4 is the button
Seat 1: color_singleton (23498 in chips) 
Seat 2: MnnM150 (1011 in chips) 
Seat 3: Duke Croix (33557 in chips) 
Seat 4: dddocky (9750 in chips) 
Seat 7: HighCardJasper (19989 in chips) 
Seat 8: appositive (11155 in chips) 
Seat 9: poorrick1338 (9650 in chips) 
HighCardJasper: posts small blind 50
appositive: posts big blind 100
*** HOLE CARDS ***
Dealt to Duke Croix [Jc Jh]
poorrick1338: folds 
color_singleton: raises 300 to 400
MnnM150: folds 
Duke Croix: calls 400
dddocky: folds 
HighCardJasper: calls 350
appositive: calls 300
*** FLOP *** [2s 3c Tc]
HighCardJasper: checks 
appositive: checks 
color_singleton: bets 1512
Duke Croix: calls 1512
HighCardJasper: calls 1512
appositive: folds 
*** TURN *** [2s 3c Tc] [8s]
HighCardJasper: checks 
color_singleton: bets 5799
Duke Croix: folds 
HighCardJasper: folds 
Uncalled bet (5799) returned to color_singleton
color_singleton collected 5799 from pot
color_singleton: doesn't show hand 
*** SUMMARY ***
Total pot 6136 | Rake 337 
Board [2s 3c Tc 8s]
Seat 1: color_singleton collected (5799)
Seat 2: MnnM150 folded before Flop (didn't bet)
Seat 3: Duke Croix folded on the Turn
Seat 4: dddocky (button) folded before Flop (didn't bet)
Seat 7: HighCardJasper (small blind) folded on the Turn
Seat 8: appositive (big blind) folded on the Flop
Seat 9: poorrick1338 folded before Flop (didn't bet)



PokerStars Home Game Hand #219638495638: {Club #3225207}  Hold'em No Limit (50/100) - 2020/10/22 18:05:02 ET
Table 'VU_table_tonight' 9-max (Play Money) Seat #7 is the button
Seat 1: color_singleton (27385 in chips) 
Seat 2: MnnM150 (1011 in chips) 
Seat 3: Duke Croix (31645 in chips) 
Seat 4: dddocky (9750 in chips) 
Seat 7: HighCardJasper (18077 in chips) 
Seat 8: appositive (10755 in chips) 
Seat 9: poorrick1338 (9650 in chips) 
appositive: posts small blind 50
poorrick1338: posts big blind 100
*** HOLE CARDS ***
Dealt to Duke Croix [3d 6d]
color_singleton: folds 
MnnM150: folds 
Duke Croix: folds 
dddocky: calls 100
HighCardJasper: calls 100
appositive: folds 
poorrick1338: checks 
*** FLOP *** [Td Ac 2h]
poorrick1338: checks 
dddocky: bets 100
HighCardJasper: raises 100 to 200
poorrick1338: calls 200
dddocky: calls 100
*** TURN *** [Td Ac 2h] [Kd]
poorrick1338: checks 
dddocky: checks 
HighCardJasper: bets 300
poorrick1338: folds 
dddocky: calls 300
*** RIVER *** [Td Ac 2h Kd] [5c]
dddocky: bets 100
HighCardJasper: raises 700 to 800
dddocky: calls 700
*** SHOW DOWN ***
HighCardJasper: shows [Ah Tc] (two pair, Aces and Tens)
dddocky: mucks hand 
HighCardJasper collected 2977 from pot
*** SUMMARY ***
Total pot 3150 | Rake 173 
Board [Td Ac 2h Kd 5c]
Seat 1: color_singleton folded before Flop (didn't bet)
Seat 2: MnnM150 folded before Flop (didn't bet)
Seat 3: Duke Croix folded before Flop (didn't bet)
Seat 4: dddocky mucked [Ad 7c]
Seat 7: HighCardJasper (button) showed [Ah Tc] and won (2977) with two pair, Aces and Tens
Seat 8: appositive (small blind) folded before Flop
Seat 9: poorrick1338 (big blind) folded on the Turn



PokerStars Home Game Hand #219638519475: {Club #3225207}  Hold'em No Limit (50/100) - 2020/10/22 18:05:51 ET
Table 'VU_table_tonight' 9-max (Play Money) Seat #8 is the button
Seat 1: color_singleton (27385 in chips) 
Seat 2: MnnM150 (1011 in chips) 
Seat 3: Duke Croix (31645 in chips) 
Seat 4: dddocky (8350 in chips) 
Seat 7: HighCardJasper (19654 in chips) 
Seat 8: appositive (10705 in chips) 
Seat 9: poorrick1338 (9350 in chips) 
poorrick1338: posts small blind 50
color_singleton: posts big blind 100
*** HOLE CARDS ***
Dealt to Duke Croix [Th 7h]
MnnM150: calls 100
Duke Croix: calls 100
dddocky: calls 100
HighCardJasper: calls 100
appositive: calls 100
poorrick1338: calls 50
color_singleton: checks 
*** FLOP *** [Js Tc 4h]
poorrick1338: checks 
color_singleton: checks 
MnnM150: checks 
Duke Croix: bets 400
dddocky: folds 
HighCardJasper: folds 
appositive: folds 
poorrick1338: folds 
color_singleton: calls 400
MnnM150: folds 
*** TURN *** [Js Tc 4h] [2d]
color_singleton: checks 
Duke Croix: bets 800
color_singleton: folds 
Uncalled bet (800) returned to Duke Croix
Duke Croix collected 1417 from pot
*** SUMMARY ***
Total pot 1500 | Rake 83 
Board [Js Tc 4h 2d]
Seat 1: color_singleton (big blind) folded on the Turn
Seat 2: MnnM150 folded on the Flop
Seat 3: Duke Croix collected (1417)
Seat 4: dddocky folded on the Flop
Seat 7: HighCardJasper folded on the Flop
Seat 8: appositive (button) folded on the Flop
Seat 9: poorrick1338 (small blind) folded on the Flop



PokerStars Home Game Hand #219638540942: {Club #3225207}  Hold'em No Limit (50/100) - 2020/10/22 18:06:36 ET
Table 'VU_table_tonight' 9-max (Play Money) Seat #9 is the button
Seat 1: color_singleton (26885 in chips) 
Seat 2: MnnM150 (911 in chips) 
Seat 3: Duke Croix (32562 in chips) 
Seat 4: dddocky (8250 in chips) 
Seat 7: HighCardJasper (19554 in chips) 
Seat 8: appositive (10605 in chips) 
Seat 9: poorrick1338 (9250 in chips) 
color_singleton: posts small blind 50
MnnM150: posts big blind 100
*** HOLE CARDS ***
Dealt to Duke Croix [9h 3d]
Duke Croix: folds 
dddocky: folds 
HighCardJasper: calls 100
appositive: raises 100 to 200
poorrick1338: calls 200
color_singleton: calls 150
MnnM150: calls 100
HighCardJasper: calls 100
*** FLOP *** [4c 5h Ac]
color_singleton: checks 
MnnM150: checks 
HighCardJasper: bets 200
appositive: raises 300 to 500
poorrick1338: calls 500
color_singleton: folds 
MnnM150: folds 
HighCardJasper: calls 300
*** TURN *** [4c 5h Ac] [Th]
HighCardJasper: checks 
appositive: bets 1900
poorrick1338: calls 1900
HighCardJasper: calls 1900
*** RIVER *** [4c 5h Ac Th] [8s]
HighCardJasper: checks 
appositive: bets 7749
poorrick1338: folds 
HighCardJasper: calls 7749
*** SHOW DOWN ***
appositive: shows [Kd As] (a pair of Aces)
HighCardJasper: mucks hand 
appositive collected 22395 from pot
*** SUMMARY ***
Total pot 23698 | Rake 1303 
Board [4c 5h Ac Th 8s]
Seat 1: color_singleton (small blind) folded on the Flop
Seat 2: MnnM150 (big blind) folded on the Flop
Seat 3: Duke Croix folded before Flop (didn't bet)
Seat 4: dddocky folded before Flop (didn't bet)
Seat 7: HighCardJasper mucked [Qh Ad]
Seat 8: appositive showed [Kd As] and won (22395) with a pair of Aces
Seat 9: poorrick1338 (button) folded on the River



PokerStars Home Game Hand #219638579918: {Club #3225207}  Hold'em No Limit (50/100) - 2020/10/22 18:07:56 ET
Table 'VU_table_tonight' 9-max (Play Money) Seat #1 is the button
Seat 1: color_singleton (26685 in chips) 
Seat 2: MnnM150 (711 in chips) 
Seat 3: Duke Croix (32562 in chips) 
Seat 4: dddocky (8250 in chips) 
Seat 7: HighCardJasper (9205 in chips) 
Seat 8: appositive (22651 in chips) 
Seat 9: poorrick1338 (6650 in chips) 
MnnM150: posts small blind 50
Duke Croix: posts big blind 100
*** HOLE CARDS ***
Dealt to Duke Croix [8s Th]
dddocky: folds 
HighCardJasper: calls 100
appositive: calls 100
poorrick1338: folds 
color_singleton: folds 
MnnM150: calls 50
Duke Croix: checks 
*** FLOP *** [9d 8h Kc]
MnnM150: checks 
Duke Croix: bets 300
HighCardJasper: folds 
appositive: calls 300
MnnM150: calls 300
*** TURN *** [9d 8h Kc] [3s]
MnnM150: checks 
Duke Croix: checks 
appositive: checks 
*** RIVER *** [9d 8h Kc 3s] [6c]
MnnM150: checks 
Duke Croix: bets 400
appositive: calls 400
MnnM150: folds 
*** SHOW DOWN ***
Duke Croix: shows [8s Th] (a pair of Eights)
appositive: mucks hand 
Duke Croix collected 1984 from pot
*** SUMMARY ***
Total pot 2100 | Rake 116 
Board [9d 8h Kc 3s 6c]
Seat 1: color_singleton (button) folded before Flop (didn't bet)
Seat 2: MnnM150 (small blind) folded on the River
Seat 3: Duke Croix (big blind) showed [8s Th] and won (1984) with a pair of Eights
Seat 4: dddocky folded before Flop (didn't bet)
Seat 7: HighCardJasper folded on the Flop
Seat 8: appositive mucked [6h 2h]
Seat 9: poorrick1338 folded before Flop (didn't bet)



PokerStars Home Game Hand #219638606421: {Club #3225207}  Hold'em No Limit (50/100) - 2020/10/22 18:08:51 ET
Table 'VU_table_tonight' 9-max (Play Money) Seat #2 is the button
Seat 1: color_singleton (26685 in chips) 
Seat 2: MnnM150 (311 in chips) 
Seat 3: Duke Croix (33746 in chips) 
Seat 4: dddocky (8250 in chips) 
Seat 7: HighCardJasper (9105 in chips) 
Seat 8: appositive (21851 in chips) 
Seat 9: poorrick1338 (6650 in chips) 
Duke Croix: posts small blind 50
dddocky: posts big blind 100
*** HOLE CARDS ***
Dealt to Duke Croix [Jd 4d]
HighCardJasper: folds 
appositive: calls 100
poorrick1338: calls 100
color_singleton: folds 
MnnM150: calls 100
Duke Croix: calls 50
dddocky: checks 
*** FLOP *** [6h 7s 2c]
Duke Croix: checks 
dddocky: checks 
appositive: checks 
poorrick1338: checks 
MnnM150: checks 
*** TURN *** [6h 7s 2c] [Js]
Duke Croix: bets 300
dddocky: folds 
appositive: calls 300
poorrick1338: folds 
MnnM150: calls 211 and is all-in
*** RIVER *** [6h 7s 2c Js] [4s]
Duke Croix: bets 1300
appositive: folds 
Uncalled bet (1300) returned to Duke Croix
*** SHOW DOWN ***
Duke Croix: shows [Jd 4d] (two pair, Jacks and Fours)
Duke Croix collected 168 from side pot
MnnM150: shows [Ah 4c] (a pair of Fours)
Duke Croix collected 1071 from main pot
*** SUMMARY ***
Total pot 1311 Main pot 1071. Side pot 168. | Rake 72 
Board [6h 7s 2c Js 4s]
Seat 1: color_singleton folded before Flop (didn't bet)
Seat 2: MnnM150 (button) showed [Ah 4c] and lost with a pair of Fours
Seat 3: Duke Croix (small blind) showed [Jd 4d] and won (1239) with two pair, Jacks and Fours
Seat 4: dddocky (big blind) folded on the Turn
Seat 7: HighCardJasper folded before Flop (didn't bet)
Seat 8: appositive folded on the River
Seat 9: poorrick1338 folded on the Turn



PokerStars Home Game Hand #219638635107: {Club #3225207}  Hold'em No Limit (50/100) - 2020/10/22 18:09:50 ET
Table 'VU_table_tonight' 9-max (Play Money) Seat #3 is the button
Seat 1: color_singleton (26685 in chips) 
Seat 3: Duke Croix (34585 in chips) 
Seat 4: dddocky (8150 in chips) 
Seat 7: HighCardJasper (9105 in chips) 
Seat 8: appositive (21451 in chips) 
Seat 9: poorrick1338 (6550 in chips) 
dddocky: posts small blind 50
HighCardJasper: posts big blind 100
*** HOLE CARDS ***
Dealt to Duke Croix [Ad 4s]
appositive: calls 100
poorrick1338: raises 100 to 200
color_singleton: calls 200
Duke Croix: calls 200
dddocky: folds 
HighCardJasper: raises 100 to 300
appositive: calls 200
poorrick1338: calls 100
color_singleton: calls 100
Duke Croix: calls 100
*** FLOP *** [9h 2s 8c]
HighCardJasper: checks 
appositive: checks 
poorrick1338: checks 
color_singleton: checks 
Duke Croix: checks 
*** TURN *** [9h 2s 8c] [Qs]
HighCardJasper: checks 
appositive: checks 
poorrick1338: bets 600
color_singleton: folds 
Duke Croix: folds 
HighCardJasper: folds 
appositive: folds 
Uncalled bet (600) returned to poorrick1338
poorrick1338 collected 1465 from pot
poorrick1338: doesn't show hand 
*** SUMMARY ***
Total pot 1550 | Rake 85 
Board [9h 2s 8c Qs]
Seat 1: color_singleton folded on the Turn
Seat 3: Duke Croix (button) folded on the Turn
Seat 4: dddocky (small blind) folded before Flop
Seat 7: HighCardJasper (big blind) folded on the Turn
Seat 8: appositive folded on the Turn
Seat 9: poorrick1338 collected (1465)



PokerStars Home Game Hand #219638660091: {Club #3225207}  Hold'em No Limit (50/100) - 2020/10/22 18:10:41 ET
Table 'VU_table_tonight' 9-max (Play Money) Seat #4 is the button
Seat 1: color_singleton (26385 in chips) 
Seat 2: MnnM150 (10000 in chips) 
Seat 3: Duke Croix (34285 in chips) 
Seat 4: dddocky (8100 in chips) 
Seat 7: HighCardJasper (8805 in chips) 
Seat 8: appositive (21151 in chips) 
Seat 9: poorrick1338 (7715 in chips) 
HighCardJasper: posts small blind 50
appositive: posts big blind 100
*** HOLE CARDS ***
Dealt to Duke Croix [8d 7c]
poorrick1338: calls 100
color_singleton: raises 100 to 200
MnnM150: calls 200
Duke Croix: calls 200
dddocky: folds 
HighCardJasper: calls 150
appositive: folds 
poorrick1338: calls 100
*** FLOP *** [9c 2s 5s]
HighCardJasper: checks 
poorrick1338: checks 
color_singleton: checks 
MnnM150: bets 519
Duke Croix: folds 
HighCardJasper: folds 
poorrick1338: calls 519
color_singleton: calls 519
*** TURN *** [9c 2s 5s] [7d]
poorrick1338: checks 
color_singleton: checks 
MnnM150: bets 1255
poorrick1338: calls 1255
color_singleton: folds 
*** RIVER *** [9c 2s 5s 7d] [4d]
poorrick1338: checks 
MnnM150: checks 
*** SHOW DOWN ***
poorrick1338: shows [Tc 7h] (a pair of Sevens)
MnnM150: shows [9d Jh] (a pair of Nines)
MnnM150 collected 4883 from pot
*** SUMMARY ***
Total pot 5167 | Rake 284 
Board [9c 2s 5s 7d 4d]
Seat 1: color_singleton folded on the Turn
Seat 2: MnnM150 showed [9d Jh] and won (4883) with a pair of Nines
Seat 3: Duke Croix folded on the Flop
Seat 4: dddocky (button) folded before Flop (didn't bet)
Seat 7: HighCardJasper (small blind) folded on the Flop
Seat 8: appositive (big blind) folded before Flop
Seat 9: poorrick1338 showed [Tc 7h] and lost with a pair of Sevens



PokerStars Home Game Hand #219638698783: {Club #3225207}  Hold'em No Limit (50/100) - 2020/10/22 18:12:02 ET
Table 'VU_table_tonight' 9-max (Play Money) Seat #7 is the button
Seat 1: color_singleton (25666 in chips) 
Seat 2: MnnM150 (12909 in chips) 
Seat 3: Duke Croix (34085 in chips) 
Seat 4: dddocky (8100 in chips) 
Seat 7: HighCardJasper (8605 in chips) 
Seat 8: appositive (21051 in chips) 
Seat 9: poorrick1338 (5741 in chips) 
appositive: posts small blind 50
poorrick1338: posts big blind 100
*** HOLE CARDS ***
Dealt to Duke Croix [8c Jc]
color_singleton: folds 
MnnM150: calls 100
Duke Croix has timed out
Duke Croix: folds 
dddocky: folds 
HighCardJasper: raises 100 to 200
appositive: folds 
poorrick1338: raises 100 to 300
MnnM150: calls 200
HighCardJasper: calls 100
*** FLOP *** [Jh Qc 2c]
poorrick1338: checks 
MnnM150: checks 
HighCardJasper: checks 
*** TURN *** [Jh Qc 2c] [9d]
poorrick1338: checks 
MnnM150: checks 
HighCardJasper: checks 
*** RIVER *** [Jh Qc 2c 9d] [2d]
poorrick1338: bets 100
MnnM150: folds 
HighCardJasper: calls 100
*** SHOW DOWN ***
poorrick1338: shows [Ac 3c] (a pair of Deuces)
HighCardJasper: shows [As Jd] (two pair, Jacks and Deuces)
HighCardJasper collected 1087 from pot
*** SUMMARY ***
Total pot 1150 | Rake 63 
Board [Jh Qc 2c 9d 2d]
Seat 1: color_singleton folded before Flop (didn't bet)
Seat 2: MnnM150 folded on the River
Seat 3: Duke Croix folded before Flop (didn't bet)
Seat 4: dddocky folded before Flop (didn't bet)
Seat 7: HighCardJasper (button) showed [As Jd] and won (1087) with two pair, Jacks and Deuces
Seat 8: appositive (small blind) folded before Flop
Seat 9: poorrick1338 (big blind) showed [Ac 3c] and lost with a pair of Deuces



PokerStars Home Game Hand #219638737645: {Club #3225207}  Hold'em No Limit (50/100) - 2020/10/22 18:13:06 ET
Table 'VU_table_tonight' 9-max (Play Money) Seat #8 is the button
Seat 1: color_singleton (25666 in chips) 
Seat 2: MnnM150 (12609 in chips) 
Seat 3: Duke Croix (34085 in chips) 
Seat 4: dddocky (8100 in chips) 
Seat 7: HighCardJasper (9292 in chips) 
Seat 8: appositive (21001 in chips) 
Seat 9: poorrick1338 (5341 in chips) 
poorrick1338: posts small blind 50
color_singleton: posts big blind 100
*** HOLE CARDS ***
Dealt to Duke Croix [8h 2s]
MnnM150: calls 100
Duke Croix: folds 
dddocky: folds 
HighCardJasper: calls 100
appositive: folds 
poorrick1338: calls 50
color_singleton: checks 
*** FLOP *** [Jc Qd Js]
poorrick1338: bets 300
color_singleton: folds 
MnnM150: calls 300
HighCardJasper: calls 300
*** TURN *** [Jc Qd Js] [2h]
poorrick1338: bets 100
MnnM150: calls 100
HighCardJasper: calls 100
*** RIVER *** [Jc Qd Js 2h] [6h]
poorrick1338: checks 
MnnM150: checks 
HighCardJasper: bets 500
poorrick1338: folds 
MnnM150: folds 
Uncalled bet (500) returned to HighCardJasper
HighCardJasper collected 1512 from pot
HighCardJasper: doesn't show hand 
*** SUMMARY ***
Total pot 1600 | Rake 88 
Board [Jc Qd Js 2h 6h]
Seat 1: color_singleton (big blind) folded on the Flop
Seat 2: MnnM150 folded on the River
Seat 3: Duke Croix folded before Flop (didn't bet)
Seat 4: dddocky folded before Flop (didn't bet)
Seat 7: HighCardJasper collected (1512)
Seat 8: appositive (button) folded before Flop (didn't bet)
Seat 9: poorrick1338 (small blind) folded on the River



PokerStars Home Game Hand #219638767631: {Club #3225207}  Hold'em No Limit (50/100) - 2020/10/22 18:14:09 ET
Table 'VU_table_tonight' 9-max (Play Money) Seat #9 is the button
Seat 1: color_singleton (25566 in chips) 
Seat 2: MnnM150 (12109 in chips) 
Seat 3: Duke Croix (34085 in chips) 
Seat 4: dddocky (8100 in chips) 
Seat 7: HighCardJasper (10304 in chips) 
Seat 8: appositive (21001 in chips) 
Seat 9: poorrick1338 (4841 in chips) 
color_singleton: posts small blind 50
MnnM150: posts big blind 100
*** HOLE CARDS ***
Dealt to Duke Croix [Jd 2s]
Duke Croix: folds 
dddocky: folds 
HighCardJasper: folds 
appositive: folds 
poorrick1338: raises 100 to 200
color_singleton: calls 150
MnnM150: calls 100
*** FLOP *** [3s 7s 6d]
color_singleton: checks 
MnnM150: checks 
poorrick1338: bets 400
color_singleton: calls 400
MnnM150: folds 
*** TURN *** [3s 7s 6d] [9s]
color_singleton: checks 
poorrick1338: bets 300
color_singleton: calls 300
*** RIVER *** [3s 7s 6d 9s] [2c]
color_singleton: checks 
poorrick1338: checks 
*** SHOW DOWN ***
color_singleton: shows [Th 3h] (a pair of Threes)
poorrick1338: shows [Ac As] (a pair of Aces)
poorrick1338 collected 1890 from pot
*** SUMMARY ***
Total pot 2000 | Rake 110 
Board [3s 7s 6d 9s 2c]
Seat 1: color_singleton (small blind) showed [Th 3h] and lost with a pair of Threes
Seat 2: MnnM150 (big blind) folded on the Flop
Seat 3: Duke Croix folded before Flop (didn't bet)
Seat 4: dddocky folded before Flop (didn't bet)
Seat 7: HighCardJasper folded before Flop (didn't bet)
Seat 8: appositive folded before Flop (didn't bet)
Seat 9: poorrick1338 (button) showed [Ac As] and won (1890) with a pair of Aces



PokerStars Home Game Hand #219638793901: {Club #3225207}  Hold'em No Limit (50/100) - 2020/10/22 18:15:04 ET
Table 'VU_table_tonight' 9-max (Play Money) Seat #1 is the button
Seat 1: color_singleton (24666 in chips) 
Seat 2: MnnM150 (11909 in chips) 
Seat 3: Duke Croix (34085 in chips) 
Seat 4: dddocky (8100 in chips) 
Seat 7: HighCardJasper (10304 in chips) 
Seat 8: appositive (21001 in chips) 
Seat 9: poorrick1338 (5831 in chips) 
MnnM150: posts small blind 50
Duke Croix: posts big blind 100
*** HOLE CARDS ***
Dealt to Duke Croix [4d Kc]
dddocky: folds 
HighCardJasper: folds 
appositive: calls 100
poorrick1338: raises 400 to 500
color_singleton: folds 
MnnM150: folds 
Duke Croix: folds 
appositive: raises 400 to 900
poorrick1338: calls 400
*** FLOP *** [2c Jd Ah]
appositive: bets 2100
poorrick1338: calls 2100
*** TURN *** [2c Jd Ah] [9s]
appositive: bets 3900
poorrick1338: calls 2831 and is all-in
Uncalled bet (1069) returned to appositive
*** RIVER *** [2c Jd Ah 9s] [Qs]
*** SHOW DOWN ***
appositive: shows [Ad Qc] (two pair, Aces and Queens)
poorrick1338: shows [Js Ac] (two pair, Aces and Jacks)
appositive collected 11162 from pot
*** SUMMARY ***
Total pot 11812 | Rake 650 
Board [2c Jd Ah 9s Qs]
Seat 1: color_singleton (button) folded before Flop (didn't bet)
Seat 2: MnnM150 (small blind) folded before Flop
Seat 3: Duke Croix (big blind) folded before Flop
Seat 4: dddocky folded before Flop (didn't bet)
Seat 7: HighCardJasper folded before Flop (didn't bet)
Seat 8: appositive showed [Ad Qc] and won (11162) with two pair, Aces and Queens
Seat 9: poorrick1338 showed [Js Ac] and lost with two pair, Aces and Jacks



PokerStars Home Game Hand #219638816231: {Club #3225207}  Hold'em No Limit (50/100) - 2020/10/22 18:15:51 ET
Table 'VU_table_tonight' 9-max (Play Money) Seat #2 is the button
Seat 1: color_singleton (24666 in chips) 
Seat 2: MnnM150 (11859 in chips) 
Seat 3: Duke Croix (33985 in chips) 
Seat 4: dddocky (8100 in chips) 
Seat 7: HighCardJasper (10304 in chips) 
Seat 8: appositive (26332 in chips) 
Duke Croix: posts small blind 50
dddocky: posts big blind 100
*** HOLE CARDS ***
Dealt to Duke Croix [9d 6c]
HighCardJasper: folds 
appositive: calls 100
color_singleton: calls 100
MnnM150: raises 100 to 200
Duke Croix: folds 
dddocky: folds 
appositive: calls 100
color_singleton: calls 100
*** FLOP *** [4s Ks Ad]
appositive: bets 600
color_singleton: folds 
MnnM150: calls 600
*** TURN *** [4s Ks Ad] [Kh]
appositive: bets 1200
MnnM150: calls 1200
*** RIVER *** [4s Ks Ad Kh] [8s]
appositive: bets 4700
MnnM150: calls 4700
*** SHOW DOWN ***
appositive: shows [Ac Kd] (a full house, Kings full of Aces)
MnnM150: mucks hand 
appositive collected 12994 from pot
*** SUMMARY ***
Total pot 13750 | Rake 756 
Board [4s Ks Ad Kh 8s]
Seat 1: color_singleton folded on the Flop
Seat 2: MnnM150 (button) mucked [Jh Js]
Seat 3: Duke Croix (small blind) folded before Flop
Seat 4: dddocky (big blind) folded before Flop
Seat 7: HighCardJasper folded before Flop (didn't bet)
Seat 8: appositive showed [Ac Kd] and won (12994) with a full house, Kings full of Aces



PokerStars Home Game Hand #219638846244: {Club #3225207}  Hold'em No Limit (50/100) - 2020/10/22 18:16:55 ET
Table 'VU_table_tonight' 9-max (Play Money) Seat #3 is the button
Seat 1: color_singleton (24466 in chips) 
Seat 2: MnnM150 (5159 in chips) 
Seat 3: Duke Croix (33935 in chips) 
Seat 4: dddocky (8000 in chips) 
Seat 7: HighCardJasper (10304 in chips) 
Seat 8: appositive (32626 in chips) 
Seat 9: poorrick1338 (10000 in chips) 
dddocky: posts small blind 50
HighCardJasper: posts big blind 100
*** HOLE CARDS ***
Dealt to Duke Croix [9s Ks]
appositive: raises 200 to 300
poorrick1338: calls 300
color_singleton: folds 
MnnM150: folds 
Duke Croix: calls 300
dddocky: calls 250
HighCardJasper: folds 
*** FLOP *** [6s 3h 9h]
dddocky: bets 614
appositive: calls 614
poorrick1338: calls 614
Duke Croix: calls 614
*** TURN *** [6s 3h 9h] [7h]
dddocky: checks 
appositive: checks 
poorrick1338: checks 
Duke Croix: checks 
*** RIVER *** [6s 3h 9h 7h] [5s]
dddocky: checks 
appositive: bets 500
poorrick1338: folds 
Duke Croix: calls 500
dddocky: folds 
*** SHOW DOWN ***
appositive: shows [As Jd] (high card Ace)
Duke Croix: shows [9s Ks] (a pair of Nines)
Duke Croix collected 4494 from pot
*** SUMMARY ***
Total pot 4756 | Rake 262 
Board [6s 3h 9h 7h 5s]
Seat 1: color_singleton folded before Flop (didn't bet)
Seat 2: MnnM150 folded before Flop (didn't bet)
Seat 3: Duke Croix (button) showed [9s Ks] and won (4494) with a pair of Nines
Seat 4: dddocky (small blind) folded on the River
Seat 7: HighCardJasper (big blind) folded before Flop
Seat 8: appositive showed [As Jd] and lost with high card Ace
Seat 9: poorrick1338 folded on the River



PokerStars Home Game Hand #219638884773: {Club #3225207}  Hold'em No Limit (50/100) - 2020/10/22 18:18:16 ET
Table 'VU_table_tonight' 9-max (Play Money) Seat #4 is the button
Seat 1: color_singleton (24466 in chips) 
Seat 2: MnnM150 (5159 in chips) 
Seat 3: Duke Croix (37015 in chips) 
Seat 4: dddocky (7086 in chips) 
Seat 7: HighCardJasper (10204 in chips) 
Seat 8: appositive (31212 in chips) 
Seat 9: poorrick1338 (9086 in chips) 
HighCardJasper: posts small blind 50
appositive: posts big blind 100
*** HOLE CARDS ***
Dealt to Duke Croix [2h 9s]
poorrick1338: folds 
color_singleton: raises 200 to 300
MnnM150: folds 
Duke Croix: folds 
dddocky: folds 
HighCardJasper: folds 
appositive: folds 
Uncalled bet (200) returned to color_singleton
color_singleton collected 250 from pot
color_singleton: doesn't show hand 
*** SUMMARY ***
Total pot 250 | Rake 0 
Seat 1: color_singleton collected (250)
Seat 2: MnnM150 folded before Flop (didn't bet)
Seat 3: Duke Croix folded before Flop (didn't bet)
Seat 4: dddocky (button) folded before Flop (didn't bet)
Seat 7: HighCardJasper (small blind) folded before Flop
Seat 8: appositive (big blind) folded before Flop
Seat 9: poorrick1338 folded before Flop (didn't bet)



PokerStars Home Game Hand #219638892508: {Club #3225207}  Hold'em No Limit (50/100) - 2020/10/22 18:18:33 ET
Table 'VU_table_tonight' 9-max (Play Money) Seat #7 is the button
Seat 1: color_singleton (24616 in chips) 
Seat 2: MnnM150 (5159 in chips) 
Seat 3: Duke Croix (37015 in chips) 
Seat 4: dddocky (7086 in chips) 
Seat 7: HighCardJasper (10154 in chips) 
Seat 8: appositive (31112 in chips) 
Seat 9: poorrick1338 (9086 in chips) 
appositive: posts small blind 50
poorrick1338: posts big blind 100
*** HOLE CARDS ***
Dealt to Duke Croix [Qs Kc]
color_singleton: folds 
MnnM150: calls 100
Duke Croix has timed out
Duke Croix: folds 
dddocky: calls 100
HighCardJasper: calls 100
appositive: calls 50
poorrick1338: raises 100 to 200
MnnM150: calls 100
dddocky: calls 100
HighCardJasper: calls 100
appositive: calls 100
*** FLOP *** [As 6s 4s]
appositive: checks 
poorrick1338: bets 300
MnnM150: folds 
dddocky: calls 300
HighCardJasper: folds 
appositive: calls 300
*** TURN *** [As 6s 4s] [9c]
appositive: checks 
poorrick1338: bets 500
dddocky: folds 
appositive: folds 
Uncalled bet (500) returned to poorrick1338
poorrick1338 collected 1795 from pot
poorrick1338: doesn't show hand 
*** SUMMARY ***
Total pot 1900 | Rake 105 
Board [As 6s 4s 9c]
Seat 1: color_singleton folded before Flop (didn't bet)
Seat 2: MnnM150 folded on the Flop
Seat 3: Duke Croix folded before Flop (didn't bet)
Seat 4: dddocky folded on the Turn
Seat 7: HighCardJasper (button) folded on the Flop
Seat 8: appositive (small blind) folded on the Turn
Seat 9: poorrick1338 (big blind) collected (1795)



PokerStars Home Game Hand #219638988971: {Club #3225207}  Hold'em No Limit (50/100) - 2020/10/22 18:21:59 ET
Table 'VU_table_tonight' 9-max (Play Money) Seat #9 is the button
Seat 1: color_singleton (23781 in chips) 
Seat 2: MnnM150 (10435 in chips) 
Seat 3: Duke Croix (37015 in chips) 
Seat 4: dddocky (6586 in chips) 
Seat 7: HighCardJasper (4995 in chips) 
Seat 8: appositive (30612 in chips) 
Seat 9: poorrick1338 (10092 in chips) 
color_singleton: posts small blind 50
MnnM150: posts big blind 100
*** HOLE CARDS ***
Dealt to Duke Croix [2s Th]
Duke Croix: folds 
dddocky: folds 
HighCardJasper: folds 
appositive: folds 
poorrick1338: calls 100
color_singleton: folds 
MnnM150: checks 
*** FLOP *** [6s 3c 4c]
MnnM150: checks 
poorrick1338: checks 
*** TURN *** [6s 3c 4c] [8c]
MnnM150: checks 
poorrick1338: bets 400
MnnM150: folds 
Uncalled bet (400) returned to poorrick1338
poorrick1338 collected 236 from pot
poorrick1338: doesn't show hand 
*** SUMMARY ***
Total pot 250 | Rake 14 
Board [6s 3c 4c 8c]
Seat 1: color_singleton (small blind) folded before Flop
Seat 2: MnnM150 (big blind) folded on the Turn
Seat 3: Duke Croix folded before Flop (didn't bet)
Seat 4: dddocky folded before Flop (didn't bet)
Seat 7: HighCardJasper folded before Flop (didn't bet)
Seat 8: appositive folded before Flop (didn't bet)
Seat 9: poorrick1338 (button) collected (236)



PokerStars Home Game Hand #219639004286: {Club #3225207}  Hold'em No Limit (50/100) - 2020/10/22 18:22:32 ET
Table 'VU_table_tonight' 9-max (Play Money) Seat #1 is the button
Seat 1: color_singleton (23731 in chips) 
Seat 2: MnnM150 (10335 in chips) 
Seat 3: Duke Croix (37015 in chips) 
Seat 4: dddocky (6586 in chips) 
Seat 7: HighCardJasper (4995 in chips) 
Seat 8: appositive (30612 in chips) 
Seat 9: poorrick1338 (10228 in chips) 
MnnM150: posts small blind 50
Duke Croix: posts big blind 100
*** HOLE CARDS ***
Dealt to Duke Croix [Ts 2s]
dddocky: folds 
HighCardJasper: folds 
appositive: calls 100
poorrick1338: folds 
color_singleton: raises 100 to 200
MnnM150: calls 150
Duke Croix: calls 100
appositive: calls 100
*** FLOP *** [5d Ad Ah]
MnnM150: checks 
Duke Croix: checks 
appositive: checks 
color_singleton: bets 400
MnnM150: folds 
Duke Croix: folds 
appositive: calls 400
*** TURN *** [5d Ad Ah] [9s]
appositive: checks 
color_singleton: bets 756
appositive: folds 
Uncalled bet (756) returned to color_singleton
color_singleton collected 1512 from pot
color_singleton: doesn't show hand 
*** SUMMARY ***
Total pot 1600 | Rake 88 
Board [5d Ad Ah 9s]
Seat 1: color_singleton (button) collected (1512)
Seat 2: MnnM150 (small blind) folded on the Flop
Seat 3: Duke Croix (big blind) folded on the Flop
Seat 4: dddocky folded before Flop (didn't bet)
Seat 7: HighCardJasper folded before Flop (didn't bet)
Seat 8: appositive folded on the Turn
Seat 9: poorrick1338 folded before Flop (didn't bet)



PokerStars Home Game Hand #219639035917: {Club #3225207}  Hold'em No Limit (50/100) - 2020/10/22 18:23:40 ET
Table 'VU_table_tonight' 9-max (Play Money) Seat #2 is the button
Seat 1: color_singleton (24643 in chips) 
Seat 2: MnnM150 (10135 in chips) 
Seat 3: Duke Croix (36815 in chips) 
Seat 4: dddocky (6586 in chips) 
Seat 7: HighCardJasper (4995 in chips) 
Seat 8: appositive (30012 in chips) 
Seat 9: poorrick1338 (10228 in chips) 
Duke Croix: posts small blind 50
dddocky: posts big blind 100
*** HOLE CARDS ***
Dealt to Duke Croix [Ts 7s]
HighCardJasper: raises 100 to 200
appositive: folds 
poorrick1338: folds 
color_singleton: calls 200
MnnM150: calls 200
Duke Croix: calls 150
dddocky: calls 100
*** FLOP *** [9h 8h 7d]
Duke Croix: bets 500
dddocky: folds 
HighCardJasper: calls 500
color_singleton: calls 500
MnnM150: calls 500
*** TURN *** [9h 8h 7d] [5d]
Duke Croix: checks 
HighCardJasper: checks 
color_singleton: checks 
MnnM150: checks 
*** RIVER *** [9h 8h 7d 5d] [4c]
Duke Croix: checks 
HighCardJasper: checks 
color_singleton: checks 
MnnM150: checks 
*** SHOW DOWN ***
Duke Croix: shows [Ts 7s] (a pair of Sevens)
HighCardJasper: shows [Kh Kd] (a pair of Kings)
color_singleton: shows [9d 9s] (three of a kind, Nines)
MnnM150: mucks hand 
color_singleton collected 2835 from pot
*** SUMMARY ***
Total pot 3000 | Rake 165 
Board [9h 8h 7d 5d 4c]
Seat 1: color_singleton showed [9d 9s] and won (2835) with three of a kind, Nines
Seat 2: MnnM150 (button) mucked [Th Qd]
Seat 3: Duke Croix (small blind) showed [Ts 7s] and lost with a pair of Sevens
Seat 4: dddocky (big blind) folded on the Flop
Seat 7: HighCardJasper showed [Kh Kd] and lost with a pair of Kings
Seat 8: appositive folded before Flop (didn't bet)
Seat 9: poorrick1338 folded before Flop (didn't bet)



PokerStars Home Game Hand #219639071202: {Club #3225207}  Hold'em No Limit (50/100) - 2020/10/22 18:24:56 ET
Table 'VU_table_tonight' 9-max (Play Money) Seat #3 is the button
Seat 1: color_singleton (26778 in chips) 
Seat 2: MnnM150 (9435 in chips) 
Seat 3: Duke Croix (36115 in chips) 
Seat 4: dddocky (6386 in chips) 
Seat 7: HighCardJasper (4295 in chips) 
Seat 9: poorrick1338 (10228 in chips) 
dddocky: posts small blind 50
HighCardJasper: posts big blind 100
*** HOLE CARDS ***
Dealt to Duke Croix [8s Jd]
poorrick1338: raises 100 to 200
color_singleton: folds 
MnnM150: calls 200
Duke Croix: folds 
dddocky: calls 150
HighCardJasper: calls 100
*** FLOP *** [4c 4d 8h]
dddocky: checks 
HighCardJasper: checks 
poorrick1338: checks 
MnnM150: checks 
*** TURN *** [4c 4d 8h] [Ad]
dddocky: checks 
HighCardJasper: checks 
poorrick1338: bets 400
MnnM150: folds 
dddocky: calls 400
HighCardJasper: folds 
*** RIVER *** [4c 4d 8h Ad] [5c]
dddocky: bets 100
poorrick1338: calls 100
*** SHOW DOWN ***
dddocky: shows [Th As] (two pair, Aces and Fours)
poorrick1338: shows [Ah Qc] (two pair, Aces and Fours - Queen kicker)
poorrick1338 collected 1701 from pot
*** SUMMARY ***
Total pot 1800 | Rake 99 
Board [4c 4d 8h Ad 5c]
Seat 1: color_singleton folded before Flop (didn't bet)
Seat 2: MnnM150 folded on the Turn
Seat 3: Duke Croix (button) folded before Flop (didn't bet)
Seat 4: dddocky (small blind) showed [Th As] and lost with two pair, Aces and Fours
Seat 7: HighCardJasper (big blind) folded on the Turn
Seat 9: poorrick1338 showed [Ah Qc] and won (1701) with two pair, Aces and Fours



PokerStars Home Game Hand #219639100545: {Club #3225207}  Hold'em No Limit (50/100) - 2020/10/22 18:26:00 ET
Table 'VU_table_tonight' 9-max (Play Money) Seat #4 is the button
Seat 1: color_singleton (26778 in chips) 
Seat 2: MnnM150 (9235 in chips) 
Seat 3: Duke Croix (36115 in chips) 
Seat 4: dddocky (5686 in chips) 
Seat 7: HighCardJasper (4095 in chips) 
Seat 8: appositive (30012 in chips) 
Seat 9: poorrick1338 (11229 in chips) 
HighCardJasper: posts small blind 50
appositive: posts big blind 100
*** HOLE CARDS ***
Dealt to Duke Croix [Js 9s]
poorrick1338: calls 100
color_singleton: folds 
MnnM150: calls 100
Duke Croix: calls 100
dddocky: folds 
HighCardJasper: calls 50
appositive: checks 
*** FLOP *** [Kc 5c Ac]
HighCardJasper: checks 
appositive: checks 
poorrick1338: bets 500
MnnM150: folds 
Duke Croix: folds 
HighCardJasper: folds 
appositive: folds 
Uncalled bet (500) returned to poorrick1338
poorrick1338 collected 472 from pot
poorrick1338: doesn't show hand 
*** SUMMARY ***
Total pot 500 | Rake 28 
Board [Kc 5c Ac]
Seat 1: color_singleton folded before Flop (didn't bet)
Seat 2: MnnM150 folded on the Flop
Seat 3: Duke Croix folded on the Flop
Seat 4: dddocky (button) folded before Flop (didn't bet)
Seat 7: HighCardJasper (small blind) folded on the Flop
Seat 8: appositive (big blind) folded on the Flop
Seat 9: poorrick1338 collected (472)



PokerStars Home Game Hand #219639123195: {Club #3225207}  Hold'em No Limit (50/100) - 2020/10/22 18:26:49 ET
Table 'VU_table_tonight' 9-max (Play Money) Seat #7 is the button
Seat 1: color_singleton (26778 in chips) 
Seat 2: MnnM150 (9135 in chips) 
Seat 3: Duke Croix (36015 in chips) 
Seat 4: dddocky (5686 in chips) 
Seat 7: HighCardJasper (3995 in chips) 
Seat 8: appositive (29912 in chips) 
Seat 9: poorrick1338 (11601 in chips) 
appositive: posts small blind 50
poorrick1338: posts big blind 100
*** HOLE CARDS ***
Dealt to Duke Croix [6s Jc]
color_singleton: folds 
MnnM150: calls 100
Duke Croix: folds 
dddocky: folds 
HighCardJasper: calls 100
appositive: folds 
poorrick1338: checks 
*** FLOP *** [3d Qd Jd]
poorrick1338: bets 400
MnnM150: calls 400
HighCardJasper: folds 
*** TURN *** [3d Qd Jd] [Ah]
poorrick1338: checks 
MnnM150: checks 
*** RIVER *** [3d Qd Jd Ah] [Kh]
poorrick1338: bets 100
MnnM150: raises 643 to 743
poorrick1338: calls 643
*** SHOW DOWN ***
MnnM150: shows [5d Kc] (a pair of Kings)
poorrick1338: mucks hand 
MnnM150 collected 2491 from pot
*** SUMMARY ***
Total pot 2636 | Rake 145 
Board [3d Qd Jd Ah Kh]
Seat 1: color_singleton folded before Flop (didn't bet)
Seat 2: MnnM150 showed [5d Kc] and won (2491) with a pair of Kings
Seat 3: Duke Croix folded before Flop (didn't bet)
Seat 4: dddocky folded before Flop (didn't bet)
Seat 7: HighCardJasper (button) folded on the Flop
Seat 8: appositive (small blind) folded before Flop
Seat 9: poorrick1338 (big blind) mucked [Js 9h]



PokerStars Home Game Hand #219639155495: {Club #3225207}  Hold'em No Limit (50/100) - 2020/10/22 18:27:59 ET
Table 'VU_table_tonight' 9-max (Play Money) Seat #8 is the button
Seat 1: color_singleton (26778 in chips) 
Seat 2: MnnM150 (10383 in chips) 
Seat 3: Duke Croix (36015 in chips) 
Seat 4: dddocky (5686 in chips) 
Seat 7: HighCardJasper (3895 in chips) 
Seat 8: appositive (29862 in chips) 
Seat 9: poorrick1338 (10358 in chips) 
poorrick1338: posts small blind 50
color_singleton: posts big blind 100
*** HOLE CARDS ***
Dealt to Duke Croix [2d Ad]
MnnM150: calls 100
Duke Croix: raises 300 to 400
dddocky: folds 
HighCardJasper: folds 
appositive: calls 400
poorrick1338: folds 
color_singleton: folds 
MnnM150: calls 300
*** FLOP *** [Kd 5h 9h]
MnnM150: bets 638
Duke Croix: folds 
appositive: calls 638
*** TURN *** [Kd 5h 9h] [8d]
MnnM150: checks 
appositive: bets 1000
MnnM150: calls 1000
*** RIVER *** [Kd 5h 9h 8d] [3h]
MnnM150: bets 2186
appositive: raises 2186 to 4372
MnnM150: calls 2186
*** SHOW DOWN ***
appositive: shows [Kc 6c] (a pair of Kings)
MnnM150: shows [Kh Jh] (a flush, King high)
MnnM150 collected 12635 from pot
*** SUMMARY ***
Total pot 13370 | Rake 735 
Board [Kd 5h 9h 8d 3h]
Seat 1: color_singleton (big blind) folded before Flop
Seat 2: MnnM150 showed [Kh Jh] and won (12635) with a flush, King high
Seat 3: Duke Croix folded on the Flop
Seat 4: dddocky folded before Flop (didn't bet)
Seat 7: HighCardJasper folded before Flop (didn't bet)
Seat 8: appositive (button) showed [Kc 6c] and lost with a pair of Kings
Seat 9: poorrick1338 (small blind) folded before Flop



PokerStars Home Game Hand #219639183664: {Club #3225207}  Hold'em No Limit (50/100) - 2020/10/22 18:29:01 ET
Table 'VU_table_tonight' 9-max (Play Money) Seat #9 is the button
Seat 1: color_singleton (26678 in chips) 
Seat 2: MnnM150 (16608 in chips) 
Seat 3: Duke Croix (35615 in chips) 
Seat 4: dddocky (5686 in chips) 
Seat 7: HighCardJasper (3895 in chips) 
Seat 8: appositive (23452 in chips) 
Seat 9: poorrick1338 (10308 in chips) 
color_singleton: posts small blind 50
MnnM150: posts big blind 100
*** HOLE CARDS ***
Dealt to Duke Croix [9s 5d]
Duke Croix has timed out
Duke Croix: folds 
dddocky: folds 
HighCardJasper: calls 100
appositive: folds 
poorrick1338: calls 100
color_singleton: raises 400 to 500
MnnM150: folds 
HighCardJasper: folds 
poorrick1338: folds 
Uncalled bet (400) returned to color_singleton
color_singleton collected 400 from pot
color_singleton: doesn't show hand 
*** SUMMARY ***
Total pot 400 | Rake 0 
Seat 1: color_singleton (small blind) collected (400)
Seat 2: MnnM150 (big blind) folded before Flop
Seat 3: Duke Croix folded before Flop (didn't bet)
Seat 4: dddocky folded before Flop (didn't bet)
Seat 7: HighCardJasper folded before Flop
Seat 8: appositive folded before Flop (didn't bet)
Seat 9: poorrick1338 (button) folded before Flop



PokerStars Home Game Hand #219639212968: {Club #3225207}  Hold'em No Limit (50/100) - 2020/10/22 18:29:49 ET
Table 'VU_table_tonight' 9-max (Play Money) Seat #1 is the button
Seat 1: color_singleton (26978 in chips) 
Seat 2: MnnM150 (16508 in chips) 
Seat 3: Duke Croix (35615 in chips) 
Seat 4: dddocky (5686 in chips) 
Seat 7: HighCardJasper (3795 in chips) 
Seat 8: appositive (23452 in chips) 
Seat 9: poorrick1338 (10208 in chips) 
MnnM150: posts small blind 50
Duke Croix: posts big blind 100
*** HOLE CARDS ***
Dealt to Duke Croix [4s 4d]
dddocky: calls 100
HighCardJasper: calls 100
appositive: folds 
poorrick1338: calls 100
color_singleton: folds 
MnnM150: raises 100 to 200
Duke Croix: calls 100
dddocky: calls 100
HighCardJasper: calls 100
poorrick1338: calls 100
*** FLOP *** [6s Th 4c]
MnnM150: checks 
Duke Croix: checks 
dddocky: checks 
HighCardJasper: bets 200
poorrick1338: folds 
MnnM150: calls 200
Duke Croix: raises 500 to 700
dddocky: folds 
HighCardJasper: calls 500
MnnM150: calls 500
*** TURN *** [6s Th 4c] [5h]
MnnM150: checks 
Duke Croix: bets 1400
HighCardJasper: folds 
MnnM150: folds 
Uncalled bet (1400) returned to Duke Croix
Duke Croix collected 2929 from pot
*** SUMMARY ***
Total pot 3100 | Rake 171 
Board [6s Th 4c 5h]
Seat 1: color_singleton (button) folded before Flop (didn't bet)
Seat 2: MnnM150 (small blind) folded on the Turn
Seat 3: Duke Croix (big blind) collected (2929)
Seat 4: dddocky folded on the Flop
Seat 7: HighCardJasper folded on the Turn
Seat 8: appositive folded before Flop (didn't bet)
Seat 9: poorrick1338 folded on the Flop



PokerStars Home Game Hand #219639256440: {Club #3225207}  Hold'em No Limit (50/100) - 2020/10/22 18:31:23 ET
Table 'VU_table_tonight' 9-max (Play Money) Seat #2 is the button
Seat 1: color_singleton (26978 in chips) 
Seat 2: MnnM150 (15608 in chips) 
Seat 3: Duke Croix (37644 in chips) 
Seat 4: dddocky (5486 in chips) 
Seat 7: HighCardJasper (2895 in chips) 
Seat 8: appositive (23452 in chips) 
Seat 9: poorrick1338 (10008 in chips) 
Duke Croix: posts small blind 50
dddocky: posts big blind 100
*** HOLE CARDS ***
Dealt to Duke Croix [Kh 9c]
HighCardJasper: folds 
appositive: calls 100
poorrick1338: calls 100
color_singleton: raises 200 to 300
MnnM150: calls 300
Duke Croix: calls 250
dddocky: folds 
appositive: calls 200
poorrick1338: calls 200
*** FLOP *** [Jd Ah 9s]
Duke Croix: checks 
appositive: checks 
poorrick1338: bets 500
color_singleton: calls 500
MnnM150: folds 
Duke Croix: folds 
appositive: folds 
*** TURN *** [Jd Ah 9s] [Kc]
poorrick1338: checks 
color_singleton: checks 
*** RIVER *** [Jd Ah 9s Kc] [2d]
poorrick1338: bets 300
color_singleton: calls 300
*** SHOW DOWN ***
poorrick1338: shows [Qs Jc] (a pair of Jacks)
color_singleton: shows [Ks Qd] (a pair of Kings)
color_singleton collected 3024 from pot
*** SUMMARY ***
Total pot 3200 | Rake 176 
Board [Jd Ah 9s Kc 2d]
Seat 1: color_singleton showed [Ks Qd] and won (3024) with a pair of Kings
Seat 2: MnnM150 (button) folded on the Flop
Seat 3: Duke Croix (small blind) folded on the Flop
Seat 4: dddocky (big blind) folded before Flop
Seat 7: HighCardJasper folded before Flop (didn't bet)
Seat 8: appositive folded on the Flop
Seat 9: poorrick1338 showed [Qs Jc] and lost with a pair of Jacks



PokerStars Home Game Hand #219639290678: {Club #3225207}  Hold'em No Limit (50/100) - 2020/10/22 18:32:38 ET
Table 'VU_table_tonight' 9-max (Play Money) Seat #3 is the button
Seat 1: color_singleton (28902 in chips) 
Seat 2: MnnM150 (15308 in chips) 
Seat 3: Duke Croix (37344 in chips) 
Seat 4: dddocky (5386 in chips) 
Seat 7: HighCardJasper (2895 in chips) 
Seat 8: appositive (23152 in chips) 
Seat 9: poorrick1338 (8908 in chips) 
dddocky: posts small blind 50
HighCardJasper: posts big blind 100
*** HOLE CARDS ***
Dealt to Duke Croix [2h Ts]
appositive: folds 
poorrick1338: raises 100 to 200
color_singleton: raises 100 to 300
MnnM150: calls 300
Duke Croix: folds 
dddocky: calls 250
HighCardJasper: calls 200
poorrick1338: calls 100
*** FLOP *** [Jh 7c 3c]
dddocky: checks 
HighCardJasper: checks 
poorrick1338: bets 100
color_singleton: raises 500 to 600
MnnM150: folds 
dddocky: folds 
HighCardJasper: folds 
poorrick1338: calls 500
*** TURN *** [Jh 7c 3c] [8c]
poorrick1338: bets 300
color_singleton: calls 300
*** RIVER *** [Jh 7c 3c 8c] [Kd]
poorrick1338: bets 7708 and is all-in
color_singleton: folds 
Uncalled bet (7708) returned to poorrick1338
poorrick1338 collected 3118 from pot
poorrick1338: doesn't show hand 
*** SUMMARY ***
Total pot 3300 | Rake 182 
Board [Jh 7c 3c 8c Kd]
Seat 1: color_singleton folded on the River
Seat 2: MnnM150 folded on the Flop
Seat 3: Duke Croix (button) folded before Flop (didn't bet)
Seat 4: dddocky (small blind) folded on the Flop
Seat 7: HighCardJasper (big blind) folded on the Flop
Seat 8: appositive folded before Flop (didn't bet)
Seat 9: poorrick1338 collected (3118)



PokerStars Home Game Hand #219639325859: {Club #3225207}  Hold'em No Limit (50/100) - 2020/10/22 18:33:55 ET
Table 'VU_table_tonight' 9-max (Play Money) Seat #4 is the button
Seat 1: color_singleton (27702 in chips) 
Seat 2: MnnM150 (15008 in chips) 
Seat 3: Duke Croix (37344 in chips) 
Seat 4: dddocky (5086 in chips) 
Seat 7: HighCardJasper (2595 in chips) 
Seat 8: appositive (23152 in chips) 
Seat 9: poorrick1338 (10826 in chips) 
HighCardJasper: posts small blind 50
appositive: posts big blind 100
*** HOLE CARDS ***
Dealt to Duke Croix [7h 3c]
poorrick1338: raises 100 to 200
color_singleton: raises 200 to 400
MnnM150: folds 
Duke Croix: folds 
dddocky: calls 400
HighCardJasper: folds 
appositive: calls 300
poorrick1338: calls 200
*** FLOP *** [Ad Th 5c]
appositive: checks 
poorrick1338: checks 
color_singleton: checks 
dddocky: bets 100
appositive: calls 100
poorrick1338: calls 100
color_singleton: calls 100
*** TURN *** [Ad Th 5c] [6s]
appositive: checks 
poorrick1338: checks 
color_singleton: bets 968
dddocky: calls 968
appositive: folds 
poorrick1338: folds 
*** RIVER *** [Ad Th 5c 6s] [2h]
color_singleton: bets 3767
dddocky: calls 3618 and is all-in
Uncalled bet (149) returned to color_singleton
*** SHOW DOWN ***
color_singleton: shows [5h 5s] (three of a kind, Fives)
dddocky: shows [Ks Ac] (a pair of Aces)
color_singleton collected 10605 from pot
*** SUMMARY ***
Total pot 11222 | Rake 617 
Board [Ad Th 5c 6s 2h]
Seat 1: color_singleton showed [5h 5s] and won (10605) with three of a kind, Fives
Seat 2: MnnM150 folded before Flop (didn't bet)
Seat 3: Duke Croix folded before Flop (didn't bet)
Seat 4: dddocky (button) showed [Ks Ac] and lost with a pair of Aces
Seat 7: HighCardJasper (small blind) folded before Flop
Seat 8: appositive (big blind) folded on the Turn
Seat 9: poorrick1338 folded on the Turn



PokerStars Home Game Hand #219639370043: {Club #3225207}  Hold'em No Limit (50/100) - 2020/10/22 18:35:31 ET
Table 'VU_table_tonight' 9-max (Play Money) Seat #7 is the button
Seat 1: color_singleton (33221 in chips) 
Seat 2: MnnM150 (15008 in chips) 
Seat 3: Duke Croix (37344 in chips) 
Seat 7: HighCardJasper (2545 in chips) 
Seat 8: appositive (22652 in chips) 
Seat 9: poorrick1338 (10326 in chips) 
appositive: posts small blind 50
poorrick1338: posts big blind 100
*** HOLE CARDS ***
Dealt to Duke Croix [Jd As]
color_singleton: raises 200 to 300
MnnM150: folds 
Duke Croix: calls 300
HighCardJasper: folds 
appositive: folds 
poorrick1338: calls 200
*** FLOP *** [9h 3h 4d]
poorrick1338: checks 
color_singleton: bets 898
Duke Croix: folds 
poorrick1338: folds 
Uncalled bet (898) returned to color_singleton
color_singleton collected 898 from pot
color_singleton: doesn't show hand 
*** SUMMARY ***
Total pot 950 | Rake 52 
Board [9h 3h 4d]
Seat 1: color_singleton collected (898)
Seat 2: MnnM150 folded before Flop (didn't bet)
Seat 3: Duke Croix folded on the Flop
Seat 7: HighCardJasper (button) folded before Flop (didn't bet)
Seat 8: appositive (small blind) folded before Flop
Seat 9: poorrick1338 (big blind) folded on the Flop



PokerStars Home Game Hand #219639384619: {Club #3225207}  Hold'em No Limit (50/100) - 2020/10/22 18:36:03 ET
Table 'VU_table_tonight' 9-max (Play Money) Seat #8 is the button
Seat 1: color_singleton (33819 in chips) 
Seat 2: MnnM150 (15008 in chips) 
Seat 3: Duke Croix (37044 in chips) 
Seat 4: dddocky (10000 in chips) 
Seat 7: HighCardJasper (2545 in chips) 
Seat 8: appositive (22602 in chips) 
Seat 9: poorrick1338 (10026 in chips) 
poorrick1338: posts small blind 50
color_singleton: posts big blind 100
*** HOLE CARDS ***
Dealt to Duke Croix [5s 3c]
MnnM150: calls 100
Duke Croix: folds 
dddocky: calls 100
HighCardJasper: calls 100
appositive: calls 100
poorrick1338: calls 50
color_singleton: raises 200 to 300
MnnM150: folds 
dddocky: calls 200
HighCardJasper: calls 200
appositive: calls 200
poorrick1338: calls 200
*** FLOP *** [5d 3d 4s]
poorrick1338: checks 
color_singleton: bets 1512
dddocky: calls 1512
HighCardJasper: folds 
appositive: folds 
poorrick1338: folds 
*** TURN *** [5d 3d 4s] [As]
color_singleton: checks 
dddocky: bets 400
color_singleton: calls 400
*** RIVER *** [5d 3d 4s As] [9d]
color_singleton: checks 
dddocky: bets 2563
color_singleton: folds 
Uncalled bet (2563) returned to dddocky
dddocky collected 5126 from pot
dddocky: doesn't show hand 
*** SUMMARY ***
Total pot 5424 | Rake 298 
Board [5d 3d 4s As 9d]
Seat 1: color_singleton (big blind) folded on the River
Seat 2: MnnM150 folded before Flop
Seat 3: Duke Croix folded before Flop (didn't bet)
Seat 4: dddocky collected (5126)
Seat 7: HighCardJasper folded on the Flop
Seat 8: appositive (button) folded on the Flop
Seat 9: poorrick1338 (small blind) folded on the Flop



PokerStars Home Game Hand #219639422172: {Club #3225207}  Hold'em No Limit (50/100) - 2020/10/22 18:37:26 ET
Table 'VU_table_tonight' 9-max (Play Money) Seat #9 is the button
Seat 1: color_singleton (31607 in chips) 
Seat 2: MnnM150 (14908 in chips) 
Seat 3: Duke Croix (37044 in chips) 
Seat 4: dddocky (12914 in chips) 
Seat 7: HighCardJasper (2245 in chips) 
Seat 8: appositive (22302 in chips) 
Seat 9: poorrick1338 (9726 in chips) 
color_singleton: posts small blind 50
MnnM150: posts big blind 100
*** HOLE CARDS ***
Dealt to Duke Croix [Ac Kh]
Duke Croix: raises 300 to 400
dddocky: calls 400
HighCardJasper: calls 400
appositive: calls 400
poorrick1338: folds 
color_singleton: folds 
MnnM150: calls 300
*** FLOP *** [3h Qd 9d]
MnnM150: checks 
Duke Croix: checks 
dddocky: checks 
HighCardJasper: bets 1845 and is all-in
appositive: folds 
MnnM150: folds 
Duke Croix: folds 
dddocky: folds 
Uncalled bet (1845) returned to HighCardJasper
HighCardJasper collected 1937 from pot
HighCardJasper: doesn't show hand 
*** SUMMARY ***
Total pot 2050 | Rake 113 
Board [3h Qd 9d]
Seat 1: color_singleton (small blind) folded before Flop
Seat 2: MnnM150 (big blind) folded on the Flop
Seat 3: Duke Croix folded on the Flop
Seat 4: dddocky folded on the Flop
Seat 7: HighCardJasper collected (1937)
Seat 8: appositive folded on the Flop
Seat 9: poorrick1338 (button) folded before Flop (didn't bet)



PokerStars Home Game Hand #219639458311: {Club #3225207}  Hold'em No Limit (50/100) - 2020/10/22 18:38:36 ET
Table 'VU_table_tonight' 9-max (Play Money) Seat #1 is the button
Seat 1: color_singleton (31557 in chips) 
Seat 2: MnnM150 (14508 in chips) 
Seat 3: Duke Croix (36644 in chips) 
Seat 4: dddocky (12514 in chips) 
Seat 7: HighCardJasper (3782 in chips) 
Seat 8: appositive (21902 in chips) 
Seat 9: poorrick1338 (9726 in chips) 
MnnM150: posts small blind 50
Duke Croix: posts big blind 100
*** HOLE CARDS ***
Dealt to Duke Croix [Qc Kd]
dddocky has timed out
dddocky: folds 
HighCardJasper: folds 
appositive: folds 
poorrick1338: calls 100
color_singleton: raises 100 to 200
MnnM150: folds 
Duke Croix: raises 200 to 400
poorrick1338: calls 300
color_singleton: calls 200
*** FLOP *** [9d 2s 4s]
Duke Croix: checks 
poorrick1338: checks 
color_singleton: checks 
*** TURN *** [9d 2s 4s] [9c]
Duke Croix: bets 700
poorrick1338: calls 700
color_singleton: folds 
*** RIVER *** [9d 2s 4s 9c] [2c]
Duke Croix: checks 
poorrick1338: checks 
*** SHOW DOWN ***
Duke Croix: shows [Qc Kd] (two pair, Nines and Deuces)
poorrick1338: shows [7c Ah] (two pair, Nines and Deuces - Ace kicker)
poorrick1338 collected 2504 from pot
*** SUMMARY ***
Total pot 2650 | Rake 146 
Board [9d 2s 4s 9c 2c]
Seat 1: color_singleton (button) folded on the Turn
Seat 2: MnnM150 (small blind) folded before Flop
Seat 3: Duke Croix (big blind) showed [Qc Kd] and lost with two pair, Nines and Deuces
Seat 4: dddocky folded before Flop (didn't bet)
Seat 7: HighCardJasper folded before Flop (didn't bet)
Seat 8: appositive folded before Flop (didn't bet)
Seat 9: poorrick1338 showed [7c Ah] and won (2504) with two pair, Nines and Deuces



PokerStars Home Game Hand #219639487648: {Club #3225207}  Hold'em No Limit (50/100) - 2020/10/22 18:39:41 ET
Table 'VU_table_tonight' 9-max (Play Money) Seat #2 is the button
Seat 1: color_singleton (31157 in chips) 
Seat 2: MnnM150 (14458 in chips) 
Seat 3: Duke Croix (35544 in chips) 
Seat 4: dddocky (12514 in chips) 
Seat 7: HighCardJasper (3782 in chips) 
Seat 8: appositive (21902 in chips) 
Seat 9: poorrick1338 (11130 in chips) 
Duke Croix: posts small blind 50
dddocky: posts big blind 100
*** HOLE CARDS ***
Dealt to Duke Croix [9c As]
HighCardJasper: folds 
appositive: calls 100
poorrick1338: calls 100
color_singleton: raises 200 to 300
MnnM150: calls 300
Duke Croix: calls 250
dddocky: folds 
appositive: calls 200
poorrick1338 has timed out
poorrick1338: folds 
*** FLOP *** [3c 9h 7s]
Duke Croix: bets 1000
appositive: folds 
color_singleton: calls 1000
MnnM150: folds 
*** TURN *** [3c 9h 7s] [6d]
Duke Croix: checks 
color_singleton: checks 
*** RIVER *** [3c 9h 7s 6d] [8s]
Duke Croix: bets 2000
color_singleton: folds 
Uncalled bet (2000) returned to Duke Croix
Duke Croix collected 3213 from pot
*** SUMMARY ***
Total pot 3400 | Rake 187 
Board [3c 9h 7s 6d 8s]
Seat 1: color_singleton folded on the River
Seat 2: MnnM150 (button) folded on the Flop
Seat 3: Duke Croix (small blind) collected (3213)
Seat 4: dddocky (big blind) folded before Flop
Seat 7: HighCardJasper folded before Flop (didn't bet)
Seat 8: appositive folded on the Flop
Seat 9: poorrick1338 folded before Flop



PokerStars Home Game Hand #219639517586: {Club #3225207}  Hold'em No Limit (50/100) - 2020/10/22 18:40:47 ET
Table 'VU_table_tonight' 9-max (Play Money) Seat #3 is the button
Seat 1: color_singleton (29857 in chips) 
Seat 2: MnnM150 (14158 in chips) 
Seat 3: Duke Croix (37457 in chips) 
Seat 4: dddocky (12414 in chips) 
Seat 7: HighCardJasper (3782 in chips) 
Seat 8: appositive (21602 in chips) 
dddocky: posts small blind 50
HighCardJasper: posts big blind 100
*** HOLE CARDS ***
Dealt to Duke Croix [7d 6s]
appositive: folds 
color_singleton: folds 
MnnM150: calls 100
Duke Croix: calls 100
dddocky: folds 
HighCardJasper: checks 
*** FLOP *** [4c Js Qs]
HighCardJasper: checks 
MnnM150: checks 
Duke Croix: checks 
*** TURN *** [4c Js Qs] [5d]
HighCardJasper: checks 
MnnM150: checks 
Duke Croix: bets 300
HighCardJasper: folds 
MnnM150: folds 
Uncalled bet (300) returned to Duke Croix
Duke Croix collected 331 from pot
*** SUMMARY ***
Total pot 350 | Rake 19 
Board [4c Js Qs 5d]
Seat 1: color_singleton folded before Flop (didn't bet)
Seat 2: MnnM150 folded on the Turn
Seat 3: Duke Croix (button) collected (331)
Seat 4: dddocky (small blind) folded before Flop
Seat 7: HighCardJasper (big blind) folded on the Turn
Seat 8: appositive folded before Flop (didn't bet)



PokerStars Home Game Hand #219639533215: {Club #3225207}  Hold'em No Limit (50/100) - 2020/10/22 18:41:22 ET
Table 'VU_table_tonight' 9-max (Play Money) Seat #4 is the button
Seat 1: color_singleton (29857 in chips) 
Seat 2: MnnM150 (14058 in chips) 
Seat 3: Duke Croix (37688 in chips) 
Seat 4: dddocky (12364 in chips) 
Seat 7: HighCardJasper (3682 in chips) 
Seat 8: appositive (21602 in chips) 
Seat 9: poorrick1338 (11030 in chips) 
HighCardJasper: posts small blind 50
appositive: posts big blind 100
*** HOLE CARDS ***
Dealt to Duke Croix [4s 7c]
poorrick1338: folds 
color_singleton: folds 
MnnM150: calls 100
Duke Croix: folds 
dddocky: folds 
HighCardJasper: calls 50
appositive: checks 
*** FLOP *** [2d 6h Kh]
HighCardJasper: checks 
appositive: checks 
MnnM150: checks 
*** TURN *** [2d 6h Kh] [Kc]
HighCardJasper: checks 
appositive: checks 
MnnM150: bets 283
HighCardJasper: folds 
appositive: folds 
Uncalled bet (283) returned to MnnM150
MnnM150 collected 283 from pot
*** SUMMARY ***
Total pot 300 | Rake 17 
Board [2d 6h Kh Kc]
Seat 1: color_singleton folded before Flop (didn't bet)
Seat 2: MnnM150 collected (283)
Seat 3: Duke Croix folded before Flop (didn't bet)
Seat 4: dddocky (button) folded before Flop (didn't bet)
Seat 7: HighCardJasper (small blind) folded on the Turn
Seat 8: appositive (big blind) folded on the Turn
Seat 9: poorrick1338 folded before Flop (didn't bet)



PokerStars Home Game Hand #219639557595: {Club #3225207}  Hold'em No Limit (50/100) - 2020/10/22 18:42:17 ET
Table 'VU_table_tonight' 9-max (Play Money) Seat #7 is the button
Seat 1: color_singleton (29857 in chips) 
Seat 2: MnnM150 (14241 in chips) 
Seat 3: Duke Croix (37688 in chips) 
Seat 4: dddocky (12364 in chips) 
Seat 7: HighCardJasper (3582 in chips) 
Seat 8: appositive (21502 in chips) 
Seat 9: poorrick1338 (11030 in chips) 
appositive: posts small blind 50
poorrick1338: posts big blind 100
*** HOLE CARDS ***
Dealt to Duke Croix [7h 5d]
color_singleton: raises 200 to 300
MnnM150: calls 300
Duke Croix: folds 
dddocky: calls 300
HighCardJasper: folds 
appositive: folds 
poorrick1338: folds 
*** FLOP *** [Kh 8h 5s]
color_singleton: checks 
MnnM150: bets 496
dddocky: folds 
color_singleton: folds 
Uncalled bet (496) returned to MnnM150
MnnM150 collected 992 from pot
*** SUMMARY ***
Total pot 1050 | Rake 58 
Board [Kh 8h 5s]
Seat 1: color_singleton folded on the Flop
Seat 2: MnnM150 collected (992)
Seat 3: Duke Croix folded before Flop (didn't bet)
Seat 4: dddocky folded on the Flop
Seat 7: HighCardJasper (button) folded before Flop (didn't bet)
Seat 8: appositive (small blind) folded before Flop
Seat 9: poorrick1338 (big blind) folded before Flop



PokerStars Home Game Hand #219639574091: {Club #3225207}  Hold'em No Limit (50/100) - 2020/10/22 18:42:54 ET
Table 'VU_table_tonight' 9-max (Play Money) Seat #8 is the button
Seat 1: color_singleton (29557 in chips) 
Seat 2: MnnM150 (14933 in chips) 
Seat 3: Duke Croix (37688 in chips) 
Seat 4: dddocky (12064 in chips) 
Seat 7: HighCardJasper (3582 in chips) 
Seat 8: appositive (21452 in chips) 
Seat 9: poorrick1338 (10930 in chips) 
poorrick1338: posts small blind 50
color_singleton: posts big blind 100
*** HOLE CARDS ***
Dealt to Duke Croix [Js Kh]
MnnM150: folds 
Duke Croix: raises 300 to 400
dddocky: folds 
HighCardJasper: folds 
appositive: folds 
poorrick1338: calls 350
color_singleton: calls 300
*** FLOP *** [5s Ah 9h]
poorrick1338: bets 100
color_singleton: calls 100
Duke Croix: calls 100
*** TURN *** [5s Ah 9h] [2h]
poorrick1338: bets 200
color_singleton: folds 
Duke Croix: calls 200
*** RIVER *** [5s Ah 9h 2h] [As]
poorrick1338: bets 400
Duke Croix: folds 
Uncalled bet (400) returned to poorrick1338
poorrick1338 collected 1795 from pot
poorrick1338: doesn't show hand 
*** SUMMARY ***
Total pot 1900 | Rake 105 
Board [5s Ah 9h 2h As]
Seat 1: color_singleton (big blind) folded on the Turn
Seat 2: MnnM150 folded before Flop (didn't bet)
Seat 3: Duke Croix folded on the River
Seat 4: dddocky folded before Flop (didn't bet)
Seat 7: HighCardJasper folded before Flop (didn't bet)
Seat 8: appositive (button) folded before Flop (didn't bet)
Seat 9: poorrick1338 (small blind) collected (1795)



PokerStars Home Game Hand #219639596280: {Club #3225207}  Hold'em No Limit (50/100) - 2020/10/22 18:43:45 ET
Table 'VU_table_tonight' 9-max (Play Money) Seat #9 is the button
Seat 1: color_singleton (29057 in chips) 
Seat 2: MnnM150 (14933 in chips) 
Seat 3: Duke Croix (36988 in chips) 
Seat 4: dddocky (12064 in chips) 
Seat 7: HighCardJasper (3582 in chips) 
Seat 8: appositive (21452 in chips) 
Seat 9: poorrick1338 (12025 in chips) 
color_singleton: posts small blind 50
MnnM150: posts big blind 100
*** HOLE CARDS ***
Dealt to Duke Croix [Kh 7d]
Duke Croix: folds 
dddocky: calls 100
HighCardJasper: calls 100
appositive: calls 100
poorrick1338: calls 100
color_singleton: calls 50
MnnM150: checks 
*** FLOP *** [7s Ac 4s]
color_singleton: checks 
MnnM150: checks 
dddocky: checks 
HighCardJasper: checks 
appositive: checks 
poorrick1338: bets 500
color_singleton: calls 500
MnnM150: calls 500
dddocky: folds 
HighCardJasper: folds 
appositive: folds 
*** TURN *** [7s Ac 4s] [5h]
color_singleton: checks 
MnnM150: checks 
poorrick1338: bets 100
color_singleton: calls 100
MnnM150: calls 100
*** RIVER *** [7s Ac 4s 5h] [2s]
color_singleton: checks 
MnnM150: checks 
poorrick1338: checks 
*** SHOW DOWN ***
color_singleton: shows [As Tc] (a pair of Aces)
MnnM150: mucks hand 
poorrick1338: mucks hand 
color_singleton collected 2268 from pot
*** SUMMARY ***
Total pot 2400 | Rake 132 
Board [7s Ac 4s 5h 2s]
Seat 1: color_singleton (small blind) showed [As Tc] and won (2268) with a pair of Aces
Seat 2: MnnM150 (big blind) mucked [Qs Kc]
Seat 3: Duke Croix folded before Flop (didn't bet)
Seat 4: dddocky folded on the Flop
Seat 7: HighCardJasper folded on the Flop
Seat 8: appositive folded on the Flop
Seat 9: poorrick1338 (button) mucked [7h 6h]



PokerStars Home Game Hand #219639626167: {Club #3225207}  Hold'em No Limit (50/100) - 2020/10/22 18:44:53 ET
Table 'VU_table_tonight' 9-max (Play Money) Seat #1 is the button
Seat 1: color_singleton (30625 in chips) 
Seat 2: MnnM150 (14233 in chips) 
Seat 3: Duke Croix (36988 in chips) 
Seat 4: dddocky (11964 in chips) 
Seat 7: HighCardJasper (3482 in chips) 
Seat 8: appositive (21352 in chips) 
Seat 9: poorrick1338 (11325 in chips) 
MnnM150: posts small blind 50
Duke Croix: posts big blind 100
*** HOLE CARDS ***
Dealt to Duke Croix [3h As]
dddocky: folds 
HighCardJasper: calls 100
appositive: folds 
poorrick1338: calls 100
color_singleton: folds 
MnnM150: calls 50
Duke Croix: checks 
*** FLOP *** [9d Td Kd]
MnnM150: checks 
Duke Croix: checks 
HighCardJasper: bets 200
poorrick1338: calls 200
MnnM150: calls 200
Duke Croix: folds 
*** TURN *** [9d Td Kd] [8s]
MnnM150: checks 
HighCardJasper: bets 200
poorrick1338: calls 200
MnnM150: folds 
*** RIVER *** [9d Td Kd 8s] [4d]
HighCardJasper: checks 
poorrick1338: bets 100
HighCardJasper: raises 900 to 1000
poorrick1338: calls 900
*** SHOW DOWN ***
HighCardJasper: shows [7d Qd] (a flush, King high)
poorrick1338: mucks hand 
HighCardJasper collected 3213 from pot
*** SUMMARY ***
Total pot 3400 | Rake 187 
Board [9d Td Kd 8s 4d]
Seat 1: color_singleton (button) folded before Flop (didn't bet)
Seat 2: MnnM150 (small blind) folded on the Turn
Seat 3: Duke Croix (big blind) folded on the Flop
Seat 4: dddocky folded before Flop (didn't bet)
Seat 7: HighCardJasper showed [7d Qd] and won (3213) with a flush, King high
Seat 8: appositive folded before Flop (didn't bet)
Seat 9: poorrick1338 mucked [Qs Th]



PokerStars Home Game Hand #219639656534: {Club #3225207}  Hold'em No Limit (50/100) - 2020/10/22 18:46:02 ET
Table 'VU_table_tonight' 9-max (Play Money) Seat #2 is the button
Seat 1: color_singleton (30625 in chips) 
Seat 2: MnnM150 (13933 in chips) 
Seat 3: Duke Croix (36888 in chips) 
Seat 4: dddocky (11964 in chips) 
Seat 7: HighCardJasper (5195 in chips) 
Seat 8: appositive (21352 in chips) 
Seat 9: poorrick1338 (9825 in chips) 
Duke Croix: posts small blind 50
dddocky: posts big blind 100
*** HOLE CARDS ***
Dealt to Duke Croix [Kd 2d]
HighCardJasper: calls 100
appositive: folds 
poorrick1338: calls 100
color_singleton: folds 
MnnM150: folds 
Duke Croix: calls 50
dddocky: checks 
*** FLOP *** [Kh 9s 3h]
Duke Croix has timed out
Duke Croix: checks 
dddocky: checks 
HighCardJasper: checks 
poorrick1338: checks 
*** TURN *** [Kh 9s 3h] [Ks]
Duke Croix: bets 300
dddocky: folds 
HighCardJasper: folds 
poorrick1338: folds 
Uncalled bet (300) returned to Duke Croix
Duke Croix collected 378 from pot
*** SUMMARY ***
Total pot 400 | Rake 22 
Board [Kh 9s 3h Ks]
Seat 1: color_singleton folded before Flop (didn't bet)
Seat 2: MnnM150 (button) folded before Flop (didn't bet)
Seat 3: Duke Croix (small blind) collected (378)
Seat 4: dddocky (big blind) folded on the Turn
Seat 7: HighCardJasper folded on the Turn
Seat 8: appositive folded before Flop (didn't bet)
Seat 9: poorrick1338 folded on the Turn



PokerStars Home Game Hand #219639680900: {Club #3225207}  Hold'em No Limit (50/100) - 2020/10/22 18:46:59 ET
Table 'VU_table_tonight' 9-max (Play Money) Seat #3 is the button
Seat 1: color_singleton (30625 in chips) 
Seat 2: MnnM150 (13933 in chips) 
Seat 3: Duke Croix (37166 in chips) 
Seat 4: dddocky (11864 in chips) 
Seat 7: HighCardJasper (5095 in chips) 
Seat 8: appositive (21352 in chips) 
Seat 9: poorrick1338 (9725 in chips) 
dddocky: posts small blind 50
HighCardJasper: posts big blind 100
*** HOLE CARDS ***
Dealt to Duke Croix [7s Ac]
appositive: folds 
poorrick1338: calls 100
color_singleton: raises 200 to 300
MnnM150: calls 300
Duke Croix: calls 300
dddocky: folds 
HighCardJasper: calls 200
poorrick1338: calls 200
*** FLOP *** [3s Jc 9c]
HighCardJasper: checks 
poorrick1338: bets 400
color_singleton: calls 400
MnnM150: calls 400
Duke Croix: folds 
HighCardJasper: folds 
*** TURN *** [3s Jc 9c] [6c]
poorrick1338: bets 1299
color_singleton: calls 1299
MnnM150: folds 
*** RIVER *** [3s Jc 9c 6c] [6h]
poorrick1338: checks 
color_singleton: checks 
*** SHOW DOWN ***
poorrick1338: shows [Jd 9s] (two pair, Jacks and Nines)
color_singleton: shows [As Ad] (two pair, Aces and Sixes)
color_singleton collected 5054 from pot
*** SUMMARY ***
Total pot 5348 | Rake 294 
Board [3s Jc 9c 6c 6h]
Seat 1: color_singleton showed [As Ad] and won (5054) with two pair, Aces and Sixes
Seat 2: MnnM150 folded on the Turn
Seat 3: Duke Croix (button) folded on the Flop
Seat 4: dddocky (small blind) folded before Flop
Seat 7: HighCardJasper (big blind) folded on the Flop
Seat 8: appositive folded before Flop (didn't bet)
Seat 9: poorrick1338 showed [Jd 9s] and lost with two pair, Jacks and Nines



PokerStars Home Game Hand #219639699785: {Club #3225207}  Hold'em No Limit (50/100) - 2020/10/22 18:47:43 ET
Table 'VU_table_tonight' 9-max (Play Money) Seat #4 is the button
Seat 1: color_singleton (33680 in chips) 
Seat 2: MnnM150 (13233 in chips) 
Seat 3: Duke Croix (36866 in chips) 
Seat 4: dddocky (11814 in chips) 
Seat 7: HighCardJasper (4795 in chips) 
Seat 8: appositive (21352 in chips) 
Seat 9: poorrick1338 (7726 in chips) 
HighCardJasper: posts small blind 50
appositive: posts big blind 100
*** HOLE CARDS ***
Dealt to Duke Croix [6d 4c]
poorrick1338: calls 100
color_singleton: folds 
MnnM150: calls 100
Duke Croix: folds 
dddocky: calls 100
HighCardJasper: calls 50
appositive: checks 
*** FLOP *** [6c Ah Qd]
HighCardJasper: checks 
appositive: checks 
poorrick1338: checks 
MnnM150: checks 
dddocky: checks 
*** TURN *** [6c Ah Qd] [Td]
HighCardJasper: checks 
appositive: bets 1100
poorrick1338: folds 
MnnM150: folds 
dddocky: calls 1100
HighCardJasper: folds 
*** RIVER *** [6c Ah Qd Td] [Kd]
appositive: bets 3000
dddocky: calls 3000
*** SHOW DOWN ***
appositive: shows [Jd Kc] (a straight, Ten to Ace)
dddocky: mucks hand 
appositive collected 8221 from pot
*** SUMMARY ***
Total pot 8700 | Rake 479 
Board [6c Ah Qd Td Kd]
Seat 1: color_singleton folded before Flop (didn't bet)
Seat 2: MnnM150 folded on the Turn
Seat 3: Duke Croix folded before Flop (didn't bet)
Seat 4: dddocky (button) mucked [Th Qc]
Seat 7: HighCardJasper (small blind) folded on the Turn
Seat 8: appositive (big blind) showed [Jd Kc] and won (8221) with a straight, Ten to Ace
Seat 9: poorrick1338 folded on the Turn



PokerStars Home Game Hand #219639731403: {Club #3225207}  Hold'em No Limit (50/100) - 2020/10/22 18:48:56 ET
Table 'VU_table_tonight' 9-max (Play Money) Seat #7 is the button
Seat 1: color_singleton (33680 in chips) 
Seat 2: MnnM150 (13133 in chips) 
Seat 3: Duke Croix (36866 in chips) 
Seat 4: dddocky (7614 in chips) 
Seat 7: HighCardJasper (4695 in chips) 
Seat 8: appositive (25373 in chips) 
Seat 9: poorrick1338 (7626 in chips) 
appositive: posts small blind 50
poorrick1338: posts big blind 100
*** HOLE CARDS ***
Dealt to Duke Croix [3d Ah]
color_singleton: raises 200 to 300
MnnM150: folds 
Duke Croix: folds 
dddocky: folds 
HighCardJasper: folds 
appositive: folds 
poorrick1338: calls 200
*** FLOP *** [4s 2s Qd]
poorrick1338: checks 
color_singleton: checks 
*** TURN *** [4s 2s Qd] [Jc]
poorrick1338: checks 
color_singleton: checks 
*** RIVER *** [4s 2s Qd Jc] [3h]
poorrick1338: checks 
color_singleton: checks 
*** SHOW DOWN ***
poorrick1338: shows [6c 9h] (high card Queen)
color_singleton: shows [Kd Tc] (high card King)
color_singleton collected 614 from pot
*** SUMMARY ***
Total pot 650 | Rake 36 
Board [4s 2s Qd Jc 3h]
Seat 1: color_singleton showed [Kd Tc] and won (614) with high card King
Seat 2: MnnM150 folded before Flop (didn't bet)
Seat 3: Duke Croix folded before Flop (didn't bet)
Seat 4: dddocky folded before Flop (didn't bet)
Seat 7: HighCardJasper (button) folded before Flop (didn't bet)
Seat 8: appositive (small blind) folded before Flop
Seat 9: poorrick1338 (big blind) showed [6c 9h] and lost with high card Queen



PokerStars Home Game Hand #219639743139: {Club #3225207}  Hold'em No Limit (50/100) - 2020/10/22 18:49:24 ET
Table 'VU_table_tonight' 9-max (Play Money) Seat #8 is the button
Seat 1: color_singleton (33994 in chips) 
Seat 2: MnnM150 (13133 in chips) 
Seat 3: Duke Croix (36866 in chips) 
Seat 4: dddocky (7614 in chips) 
Seat 7: HighCardJasper (4695 in chips) 
Seat 8: appositive (25323 in chips) 
Seat 9: poorrick1338 (7326 in chips) 
poorrick1338: posts small blind 50
color_singleton: posts big blind 100
*** HOLE CARDS ***
Dealt to Duke Croix [Ac 4c]
MnnM150: calls 100
Duke Croix: calls 100
dddocky: calls 100
HighCardJasper: calls 100
appositive: folds 
poorrick1338: calls 50
color_singleton: checks 
*** FLOP *** [Kd Qh 2c]
poorrick1338: checks 
color_singleton: checks 
MnnM150: bets 283
Duke Croix: folds 
dddocky: calls 283
HighCardJasper: folds 
poorrick1338: folds 
color_singleton: folds 
*** TURN *** [Kd Qh 2c] [Jh]
MnnM150: bets 551
dddocky: calls 551
*** RIVER *** [Kd Qh 2c Jh] [9s]
MnnM150: checks 
dddocky: checks 
*** SHOW DOWN ***
MnnM150: shows [Jd Kc] (two pair, Kings and Jacks)
dddocky: mucks hand 
MnnM150 collected 2143 from pot
*** SUMMARY ***
Total pot 2268 | Rake 125 
Board [Kd Qh 2c Jh 9s]
Seat 1: color_singleton (big blind) folded on the Flop
Seat 2: MnnM150 showed [Jd Kc] and won (2143) with two pair, Kings and Jacks
Seat 3: Duke Croix folded on the Flop
Seat 4: dddocky mucked [Js Qc]
Seat 7: HighCardJasper folded on the Flop
Seat 8: appositive (button) folded before Flop (didn't bet)
Seat 9: poorrick1338 (small blind) folded on the Flop



PokerStars Home Game Hand #219639770545: {Club #3225207}  Hold'em No Limit (50/100) - 2020/10/22 18:50:19 ET
Table 'VU_table_tonight' 9-max (Play Money) Seat #9 is the button
Seat 1: color_singleton (33894 in chips) 
Seat 2: MnnM150 (14342 in chips) 
Seat 3: Duke Croix (36766 in chips) 
Seat 4: dddocky (6680 in chips) 
Seat 7: HighCardJasper (4595 in chips) 
Seat 8: appositive (25323 in chips) 
Seat 9: poorrick1338 (7226 in chips) 
color_singleton: posts small blind 50
MnnM150: posts big blind 100
*** HOLE CARDS ***
Dealt to Duke Croix [2d 9c]
Duke Croix: folds 
dddocky: calls 100
HighCardJasper: folds 
appositive: folds 
poorrick1338: folds 
color_singleton: calls 50
MnnM150: checks 
*** FLOP *** [2h 8s 9s]
color_singleton: checks 
MnnM150: checks 
dddocky: checks 
*** TURN *** [2h 8s 9s] [Qh]
color_singleton: checks 
MnnM150: checks 
dddocky: checks 
*** RIVER *** [2h 8s 9s Qh] [8c]
color_singleton: checks 
MnnM150: bets 283
dddocky: calls 283
color_singleton: folds 
*** SHOW DOWN ***
MnnM150: shows [Ah Jh] (a pair of Eights)
dddocky: shows [6d 6c] (two pair, Eights and Sixes)
dddocky collected 818 from pot
*** SUMMARY ***
Total pot 866 | Rake 48 
Board [2h 8s 9s Qh 8c]
Seat 1: color_singleton (small blind) folded on the River
Seat 2: MnnM150 (big blind) showed [Ah Jh] and lost with a pair of Eights
Seat 3: Duke Croix folded before Flop (didn't bet)
Seat 4: dddocky showed [6d 6c] and won (818) with two pair, Eights and Sixes
Seat 7: HighCardJasper folded before Flop (didn't bet)
Seat 8: appositive folded before Flop (didn't bet)
Seat 9: poorrick1338 (button) folded before Flop (didn't bet)



PokerStars Home Game Hand #219639785936: {Club #3225207}  Hold'em No Limit (50/100) - 2020/10/22 18:50:55 ET
Table 'VU_table_tonight' 9-max (Play Money) Seat #1 is the button
Seat 1: color_singleton (33794 in chips) 
Seat 2: MnnM150 (13959 in chips) 
Seat 3: Duke Croix (36766 in chips) 
Seat 4: dddocky (7115 in chips) 
Seat 7: HighCardJasper (4595 in chips) 
Seat 8: appositive (25323 in chips) 
Seat 9: poorrick1338 (7226 in chips) 
MnnM150: posts small blind 50
Duke Croix: posts big blind 100
*** HOLE CARDS ***
Dealt to Duke Croix [2s 4d]
dddocky: calls 100
HighCardJasper: calls 100
appositive: folds 
poorrick1338: calls 100
color_singleton: calls 100
MnnM150: calls 50
Duke Croix: checks 
*** FLOP *** [4s Jc 8c]
MnnM150: checks 
Duke Croix: checks 
dddocky: bets 100
HighCardJasper: calls 100
poorrick1338: calls 100
color_singleton: calls 100
MnnM150: calls 100
Duke Croix: folds 
*** TURN *** [4s Jc 8c] [4h]
MnnM150: checks 
dddocky: checks 
HighCardJasper: checks 
poorrick1338: checks 
color_singleton: checks 
*** RIVER *** [4s Jc 8c 4h] [6c]
MnnM150: checks 
dddocky: checks 
HighCardJasper: checks 
poorrick1338: bets 100
color_singleton: calls 100
MnnM150: calls 100
dddocky: folds 
HighCardJasper: folds 
*** SHOW DOWN ***
poorrick1338: shows [7c 6d] (two pair, Sixes and Fours)
color_singleton: shows [6h Kc] (two pair, Sixes and Fours - King kicker)
MnnM150: mucks hand 
color_singleton collected 1323 from pot
*** SUMMARY ***
Total pot 1400 | Rake 77 
Board [4s Jc 8c 4h 6c]
Seat 1: color_singleton (button) showed [6h Kc] and won (1323) with two pair, Sixes and Fours
Seat 2: MnnM150 (small blind) mucked [Th Ac]
Seat 3: Duke Croix (big blind) folded on the Flop
Seat 4: dddocky folded on the River
Seat 7: HighCardJasper folded on the River
Seat 8: appositive folded before Flop (didn't bet)
Seat 9: poorrick1338 showed [7c 6d] and lost with two pair, Sixes and Fours



PokerStars Home Game Hand #219639814693: {Club #3225207}  Hold'em No Limit (50/100) - 2020/10/22 18:52:02 ET
Table 'VU_table_tonight' 9-max (Play Money) Seat #2 is the button
Seat 1: color_singleton (34817 in chips) 
Seat 2: MnnM150 (13659 in chips) 
Seat 3: Duke Croix (36666 in chips) 
Seat 4: dddocky (6915 in chips) 
Seat 7: HighCardJasper (4395 in chips) 
Seat 8: appositive (25323 in chips) 
Seat 9: poorrick1338 (6926 in chips) 
Duke Croix: posts small blind 50
dddocky: posts big blind 100
*** HOLE CARDS ***
Dealt to Duke Croix [Jh 8d]
HighCardJasper: folds 
appositive: folds 
poorrick1338: calls 100
color_singleton: folds 
MnnM150: folds 
Duke Croix: calls 50
dddocky: checks 
*** FLOP *** [Jd Qs Tc]
Duke Croix: bets 200
dddocky: calls 200
poorrick1338: calls 200
*** TURN *** [Jd Qs Tc] [Ah]
Duke Croix: checks 
dddocky: checks 
poorrick1338: bets 300
Duke Croix: folds 
dddocky: calls 300
*** RIVER *** [Jd Qs Tc Ah] [9s]
dddocky: checks 
poorrick1338: checks 
*** SHOW DOWN ***
dddocky: shows [8h 9h] (a straight, Eight to Queen)
poorrick1338: mucks hand 
dddocky collected 1417 from pot
*** SUMMARY ***
Total pot 1500 | Rake 83 
Board [Jd Qs Tc Ah 9s]
Seat 1: color_singleton folded before Flop (didn't bet)
Seat 2: MnnM150 (button) folded before Flop (didn't bet)
Seat 3: Duke Croix (small blind) folded on the Turn
Seat 4: dddocky (big blind) showed [8h 9h] and won (1417) with a straight, Eight to Queen
Seat 7: HighCardJasper folded before Flop (didn't bet)
Seat 8: appositive folded before Flop (didn't bet)
Seat 9: poorrick1338 mucked [Qd 2c]



PokerStars Home Game Hand #219639831532: {Club #3225207}  Hold'em No Limit (50/100) - 2020/10/22 18:52:41 ET
Table 'VU_table_tonight' 9-max (Play Money) Seat #3 is the button
Seat 1: color_singleton (34817 in chips) 
Seat 2: MnnM150 (13659 in chips) 
Seat 3: Duke Croix (36366 in chips) 
Seat 4: dddocky (7732 in chips) 
Seat 7: HighCardJasper (4395 in chips) 
Seat 8: appositive (25323 in chips) 
Seat 9: poorrick1338 (6326 in chips) 
dddocky: posts small blind 50
HighCardJasper: posts big blind 100
*** HOLE CARDS ***
Dealt to Duke Croix [4h Qs]
appositive: calls 100
poorrick1338: calls 100
color_singleton: calls 100
MnnM150: folds 
Duke Croix: folds 
dddocky: folds 
HighCardJasper: checks 
*** FLOP *** [Ad Qc 8s]
HighCardJasper: checks 
appositive: checks 
poorrick1338: checks 
color_singleton: checks 
*** TURN *** [Ad Qc 8s] [5c]
HighCardJasper: checks 
appositive: checks 
poorrick1338: checks 
color_singleton: checks 
*** RIVER *** [Ad Qc 8s 5c] [9c]
HighCardJasper: checks 
appositive: bets 300
poorrick1338: calls 300
color_singleton: folds 
HighCardJasper: folds 
*** SHOW DOWN ***
appositive: shows [4s 9s] (a pair of Nines)
poorrick1338: mucks hand 
appositive collected 992 from pot
*** SUMMARY ***
Total pot 1050 | Rake 58 
Board [Ad Qc 8s 5c 9c]
Seat 1: color_singleton folded on the River
Seat 2: MnnM150 folded before Flop (didn't bet)
Seat 3: Duke Croix (button) folded before Flop (didn't bet)
Seat 4: dddocky (small blind) folded before Flop
Seat 7: HighCardJasper (big blind) folded on the River
Seat 8: appositive showed [4s 9s] and won (992) with a pair of Nines
Seat 9: poorrick1338 mucked [2c 2h]



PokerStars Home Game Hand #219639850163: {Club #3225207}  Hold'em No Limit (50/100) - 2020/10/22 18:53:25 ET
Table 'VU_table_tonight' 9-max (Play Money) Seat #4 is the button
Seat 1: color_singleton (34717 in chips) 
Seat 2: MnnM150 (13659 in chips) 
Seat 3: Duke Croix (36366 in chips) 
Seat 4: dddocky (7682 in chips) 
Seat 7: HighCardJasper (4295 in chips) 
Seat 8: appositive (25915 in chips) 
Seat 9: poorrick1338 (5926 in chips) 
HighCardJasper: posts small blind 50
appositive: posts big blind 100
*** HOLE CARDS ***
Dealt to Duke Croix [2d Tc]
poorrick1338: calls 100
color_singleton: raises 100 to 200
MnnM150: calls 200
Duke Croix: folds 
dddocky: folds 
HighCardJasper: folds 
appositive: folds 
poorrick1338: calls 100
*** FLOP *** [3d 5h Ah]
poorrick1338: checks 
color_singleton: checks 
MnnM150: checks 
*** TURN *** [3d 5h Ah] [Jd]
poorrick1338: checks 
color_singleton: checks 
MnnM150: checks 
*** RIVER *** [3d 5h Ah Jd] [5s]
poorrick1338: checks 
color_singleton: checks 
MnnM150: checks 
*** SHOW DOWN ***
poorrick1338: shows [9s 8s] (a pair of Fives)
color_singleton: shows [7d Kd] (a pair of Fives - Ace+King kicker)
MnnM150: mucks hand 
color_singleton collected 709 from pot
*** SUMMARY ***
Total pot 750 | Rake 41 
Board [3d 5h Ah Jd 5s]
Seat 1: color_singleton showed [7d Kd] and won (709) with a pair of Fives
Seat 2: MnnM150 mucked [Qd 7c]
Seat 3: Duke Croix folded before Flop (didn't bet)
Seat 4: dddocky (button) folded before Flop (didn't bet)
Seat 7: HighCardJasper (small blind) folded before Flop
Seat 8: appositive (big blind) folded before Flop
Seat 9: poorrick1338 showed [9s 8s] and lost with a pair of Fives



PokerStars Home Game Hand #219639864940: {Club #3225207}  Hold'em No Limit (50/100) - 2020/10/22 18:54:00 ET
Table 'VU_table_tonight' 9-max (Play Money) Seat #7 is the button
Seat 1: color_singleton (35226 in chips) 
Seat 2: MnnM150 (13459 in chips) 
Seat 3: Duke Croix (36366 in chips) 
Seat 4: dddocky (7682 in chips) 
Seat 7: HighCardJasper (4245 in chips) 
Seat 8: appositive (25815 in chips) 
Seat 9: poorrick1338 (5726 in chips) 
appositive: posts small blind 50
poorrick1338: posts big blind 100
*** HOLE CARDS ***
Dealt to Duke Croix [Th 6c]
color_singleton: folds 
MnnM150: calls 100
Duke Croix: folds 
dddocky: folds 
HighCardJasper: calls 100
appositive: calls 50
poorrick1338: checks 
*** FLOP *** [3c 2c 9h]
appositive: checks 
poorrick1338: checks 
MnnM150: checks 
HighCardJasper: checks 
*** TURN *** [3c 2c 9h] [Tc]
appositive: checks 
poorrick1338: checks 
MnnM150: checks 
HighCardJasper: checks 
*** RIVER *** [3c 2c 9h Tc] [Qs]
appositive: checks 
poorrick1338: bets 500
MnnM150: folds 
HighCardJasper: folds 
appositive: folds 
Uncalled bet (500) returned to poorrick1338
poorrick1338 collected 378 from pot
poorrick1338: doesn't show hand 
*** SUMMARY ***
Total pot 400 | Rake 22 
Board [3c 2c 9h Tc Qs]
Seat 1: color_singleton folded before Flop (didn't bet)
Seat 2: MnnM150 folded on the River
Seat 3: Duke Croix folded before Flop (didn't bet)
Seat 4: dddocky folded before Flop (didn't bet)
Seat 7: HighCardJasper (button) folded on the River
Seat 8: appositive (small blind) folded on the River
Seat 9: poorrick1338 (big blind) collected (378)



PokerStars Home Game Hand #219639886315: {Club #3225207}  Hold'em No Limit (50/100) - 2020/10/22 18:54:51 ET
Table 'VU_table_tonight' 9-max (Play Money) Seat #8 is the button
Seat 1: color_singleton (35226 in chips) 
Seat 2: MnnM150 (13359 in chips) 
Seat 3: Duke Croix (36366 in chips) 
Seat 4: dddocky (7682 in chips) 
Seat 7: HighCardJasper (4145 in chips) 
Seat 8: appositive (25715 in chips) 
Seat 9: poorrick1338 (6004 in chips) 
poorrick1338: posts small blind 50
color_singleton: posts big blind 100
*** HOLE CARDS ***
Dealt to Duke Croix [3h Ad]
MnnM150: calls 100
Duke Croix: folds 
dddocky: folds 
HighCardJasper: folds 
appositive: folds 
poorrick1338: folds 
color_singleton: raises 200 to 300
MnnM150: folds 
Uncalled bet (200) returned to color_singleton
color_singleton collected 250 from pot
color_singleton: doesn't show hand 
*** SUMMARY ***
Total pot 250 | Rake 0 
Seat 1: color_singleton (big blind) collected (250)
Seat 2: MnnM150 folded before Flop
Seat 3: Duke Croix folded before Flop (didn't bet)
Seat 4: dddocky folded before Flop (didn't bet)
Seat 7: HighCardJasper folded before Flop (didn't bet)
Seat 8: appositive (button) folded before Flop (didn't bet)
Seat 9: poorrick1338 (small blind) folded before Flop



PokerStars Home Game Hand #219639895063: {Club #3225207}  Hold'em No Limit (50/100) - 2020/10/22 18:55:12 ET
Table 'VU_table_tonight' 9-max (Play Money) Seat #9 is the button
Seat 1: color_singleton (35376 in chips) 
Seat 2: MnnM150 (13259 in chips) 
Seat 3: Duke Croix (36366 in chips) 
Seat 4: dddocky (7682 in chips) 
Seat 7: HighCardJasper (4145 in chips) 
Seat 8: appositive (25715 in chips) 
Seat 9: poorrick1338 (5954 in chips) 
color_singleton: posts small blind 50
MnnM150: posts big blind 100
*** HOLE CARDS ***
Dealt to Duke Croix [5d Qc]
Duke Croix: folds 
dddocky: calls 100
HighCardJasper: folds 
appositive: calls 100
poorrick1338: raises 100 to 200
color_singleton: calls 150
MnnM150: folds 
dddocky: calls 100
appositive: calls 100
*** FLOP *** [7c 6d 4s]
color_singleton: checks 
dddocky: bets 100
appositive: folds 
poorrick1338: calls 100
color_singleton: calls 100
*** TURN *** [7c 6d 4s] [9s]
color_singleton: checks 
dddocky: bets 100
poorrick1338: calls 100
color_singleton: calls 100
*** RIVER *** [7c 6d 4s 9s] [Kh]
color_singleton: checks 
dddocky: checks 
poorrick1338: bets 300
color_singleton: calls 300
dddocky: folds 
*** SHOW DOWN ***
poorrick1338: shows [Ks Td] (a pair of Kings)
color_singleton: mucks hand 
poorrick1338 collected 1984 from pot
*** SUMMARY ***
Total pot 2100 | Rake 116 
Board [7c 6d 4s 9s Kh]
Seat 1: color_singleton (small blind) mucked [7d 8d]
Seat 2: MnnM150 (big blind) folded before Flop
Seat 3: Duke Croix folded before Flop (didn't bet)
Seat 4: dddocky folded on the River
Seat 7: HighCardJasper folded before Flop (didn't bet)
Seat 8: appositive folded on the Flop
Seat 9: poorrick1338 (button) showed [Ks Td] and won (1984) with a pair of Kings



PokerStars Home Game Hand #219639918012: {Club #3225207}  Hold'em No Limit (50/100) - 2020/10/22 18:56:20 ET
Table 'VU_table_tonight' 9-max (Play Money) Seat #1 is the button
Seat 1: color_singleton (34676 in chips) 
Seat 2: MnnM150 (13159 in chips) 
Seat 3: Duke Croix (36366 in chips) 
Seat 4: dddocky (7282 in chips) 
Seat 7: HighCardJasper (4145 in chips) 
Seat 8: appositive (25515 in chips) 
Seat 9: poorrick1338 (7238 in chips) 
MnnM150: posts small blind 50
Duke Croix: posts big blind 100
*** HOLE CARDS ***
Dealt to Duke Croix [3h 8h]
dddocky: folds 
HighCardJasper: folds 
appositive: calls 100
poorrick1338: calls 100
color_singleton: raises 300 to 400
MnnM150: calls 350
Duke Croix: folds 
appositive: folds 
poorrick1338: calls 300
*** FLOP *** [5h 7d 2c]
MnnM150: checks 
poorrick1338: checks 
color_singleton: bets 700
MnnM150: folds 
poorrick1338: folds 
Uncalled bet (700) returned to color_singleton
color_singleton collected 1323 from pot
color_singleton: doesn't show hand 
*** SUMMARY ***
Total pot 1400 | Rake 77 
Board [5h 7d 2c]
Seat 1: color_singleton (button) collected (1323)
Seat 2: MnnM150 (small blind) folded on the Flop
Seat 3: Duke Croix (big blind) folded before Flop
Seat 4: dddocky folded before Flop (didn't bet)
Seat 7: HighCardJasper folded before Flop (didn't bet)
Seat 8: appositive folded before Flop
Seat 9: poorrick1338 folded on the Flop



PokerStars Home Game Hand #219639931762: {Club #3225207}  Hold'em No Limit (50/100) - 2020/10/22 18:57:02 ET
Table 'VU_table_tonight' 9-max (Play Money) Seat #2 is the button
Seat 1: color_singleton (35599 in chips) 
Seat 2: MnnM150 (12759 in chips) 
Seat 3: Duke Croix (36266 in chips) 
Seat 7: HighCardJasper (4145 in chips) 
Seat 8: appositive (25415 in chips) 
Seat 9: poorrick1338 (6838 in chips) 
Duke Croix: posts small blind 50
HighCardJasper: posts big blind 100
*** HOLE CARDS ***
Dealt to Duke Croix [2s 8h]
appositive: calls 100
poorrick1338: calls 100
color_singleton: raises 200 to 300
MnnM150: calls 300
Duke Croix: folds 
HighCardJasper: folds 
appositive: folds 
poorrick1338: calls 200
*** FLOP *** [7h Ah Js]
poorrick1338: checks 
color_singleton: checks 
MnnM150: bets 543
poorrick1338: calls 543
color_singleton: folds 
*** TURN *** [7h Ah Js] [2h]
poorrick1338: bets 500
MnnM150: raises 500 to 1000
poorrick1338: calls 500
*** RIVER *** [7h Ah Js 2h] [Td]
poorrick1338: bets 700
MnnM150: calls 700
*** SHOW DOWN ***
poorrick1338: shows [Th 7d] (two pair, Tens and Sevens)
MnnM150: shows [Ad 2d] (two pair, Aces and Deuces)
MnnM150 collected 5326 from pot
*** SUMMARY ***
Total pot 5636 | Rake 310 
Board [7h Ah Js 2h Td]
Seat 1: color_singleton folded on the Flop
Seat 2: MnnM150 (button) showed [Ad 2d] and won (5326) with two pair, Aces and Deuces
Seat 3: Duke Croix (small blind) folded before Flop
Seat 7: HighCardJasper (big blind) folded before Flop
Seat 8: appositive folded before Flop
Seat 9: poorrick1338 showed [Th 7d] and lost with two pair, Tens and Sevens



PokerStars Home Game Hand #219639949645: {Club #3225207}  Hold'em No Limit (50/100) - 2020/10/22 18:57:55 ET
Table 'VU_table_tonight' 9-max (Play Money) Seat #3 is the button
Seat 1: color_singleton (35299 in chips) 
Seat 2: MnnM150 (15542 in chips) 
Seat 3: Duke Croix (36216 in chips) 
Seat 7: HighCardJasper (4045 in chips) 
Seat 8: appositive (25315 in chips) 
Seat 9: poorrick1338 (4295 in chips) 
HighCardJasper: posts small blind 50
appositive: posts big blind 100
*** HOLE CARDS ***
Dealt to Duke Croix [6s 5d]
poorrick1338: calls 100
color_singleton: folds 
MnnM150: calls 100
Duke Croix: calls 100
HighCardJasper: folds 
appositive: checks 
*** FLOP *** [Qs Kc 7c]
appositive: checks 
poorrick1338: checks 
MnnM150: bets 212
Duke Croix: folds 
appositive: calls 212
poorrick1338: folds 
*** TURN *** [Qs Kc 7c] [4h]
appositive: checks 
MnnM150: bets 413
appositive: calls 413
*** RIVER *** [Qs Kc 7c 4h] [8d]
appositive: checks 
MnnM150: checks 
*** SHOW DOWN ***
appositive: shows [Tc 9c] (high card King)
MnnM150: shows [Kd 5s] (a pair of Kings)
MnnM150 collected 1606 from pot
*** SUMMARY ***
Total pot 1700 | Rake 94 
Board [Qs Kc 7c 4h 8d]
Seat 1: color_singleton folded before Flop (didn't bet)
Seat 2: MnnM150 showed [Kd 5s] and won (1606) with a pair of Kings
Seat 3: Duke Croix (button) folded on the Flop
Seat 7: HighCardJasper (small blind) folded before Flop
Seat 8: appositive (big blind) showed [Tc 9c] and lost with high card King
Seat 9: poorrick1338 folded on the Flop



PokerStars Home Game Hand #219639968377: {Club #3225207}  Hold'em No Limit (50/100) - 2020/10/22 18:58:51 ET
Table 'VU_table_tonight' 9-max (Play Money) Seat #7 is the button
Seat 1: color_singleton (35299 in chips) 
Seat 2: MnnM150 (16423 in chips) 
Seat 3: Duke Croix (36116 in chips) 
Seat 4: dddocky (7282 in chips) 
Seat 7: HighCardJasper (3995 in chips) 
Seat 8: appositive (24590 in chips) 
Seat 9: poorrick1338 (4195 in chips) 
appositive: posts small blind 50
poorrick1338: posts big blind 100
dddocky: posts small & big blinds 150
*** HOLE CARDS ***
Dealt to Duke Croix [Js 3c]
color_singleton: raises 200 to 300
MnnM150: folds 
Duke Croix: folds 
dddocky: folds 
HighCardJasper: calls 300
appositive: calls 250
poorrick1338: calls 200
*** FLOP *** [Kd 4d Jc]
appositive: checks 
poorrick1338: checks 
color_singleton: checks 
HighCardJasper: checks 
*** TURN *** [Kd 4d Jc] [Td]
appositive: checks 
poorrick1338: checks 
color_singleton: checks 
HighCardJasper: bets 200
appositive: folds 
poorrick1338: raises 200 to 400
color_singleton: calls 400
HighCardJasper: calls 200
*** RIVER *** [Kd 4d Jc Td] [6d]
poorrick1338: checks 
color_singleton: bets 2410
HighCardJasper: folds 
poorrick1338: folds 
Uncalled bet (2410) returned to color_singleton
color_singleton collected 2410 from pot
color_singleton: doesn't show hand 
*** SUMMARY ***
Total pot 2550 | Rake 140 
Board [Kd 4d Jc Td 6d]
Seat 1: color_singleton collected (2410)
Seat 2: MnnM150 folded before Flop (didn't bet)
Seat 3: Duke Croix folded before Flop (didn't bet)
Seat 4: dddocky folded before Flop (didn't bet)
Seat 7: HighCardJasper (button) folded on the River
Seat 8: appositive (small blind) folded on the Turn
Seat 9: poorrick1338 (big blind) folded on the River



PokerStars Home Game Hand #219639990307: {Club #3225207}  Hold'em No Limit (50/100) - 2020/10/22 18:59:57 ET
Table 'VU_table_tonight' 9-max (Play Money) Seat #8 is the button
Seat 1: color_singleton (37009 in chips) 
Seat 2: MnnM150 (16423 in chips) 
Seat 3: Duke Croix (36116 in chips) 
Seat 4: dddocky (7132 in chips) 
Seat 7: HighCardJasper (3295 in chips) 
Seat 8: appositive (24290 in chips) 
Seat 9: poorrick1338 (3495 in chips) 
poorrick1338: posts small blind 50
color_singleton: posts big blind 100
*** HOLE CARDS ***
Dealt to Duke Croix [2d Th]
MnnM150: calls 100
Duke Croix: folds 
dddocky: calls 100
HighCardJasper: folds 
appositive: calls 100
poorrick1338: calls 50
color_singleton: checks 
*** FLOP *** [9c 8h Ks]
poorrick1338: checks 
color_singleton: checks 
MnnM150: checks 
dddocky: checks 
appositive: bets 200
poorrick1338: calls 200
color_singleton: folds 
MnnM150: calls 200
dddocky: calls 200
*** TURN *** [9c 8h Ks] [9h]
poorrick1338: checks 
MnnM150: bets 614
dddocky: folds 
appositive: raises 614 to 1228
poorrick1338: folds 
MnnM150: calls 614
*** RIVER *** [9c 8h Ks 9h] [6d]
MnnM150: checks 
appositive: bets 3549
MnnM150: folds 
Uncalled bet (3549) returned to appositive
appositive collected 3549 from pot
appositive: doesn't show hand 
*** SUMMARY ***
Total pot 3756 | Rake 207 
Board [9c 8h Ks 9h 6d]
Seat 1: color_singleton (big blind) folded on the Flop
Seat 2: MnnM150 folded on the River
Seat 3: Duke Croix folded before Flop (didn't bet)
Seat 4: dddocky folded on the Turn
Seat 7: HighCardJasper folded before Flop (didn't bet)
Seat 8: appositive (button) collected (3549)
Seat 9: poorrick1338 (small blind) folded on the Turn



PokerStars Home Game Hand #219640022728: {Club #3225207}  Hold'em No Limit (50/100) - 2020/10/22 19:01:26 ET
Table 'VU_table_tonight' 9-max (Play Money) Seat #9 is the button
Seat 1: color_singleton (36909 in chips) 
Seat 2: MnnM150 (14895 in chips) 
Seat 3: Duke Croix (36116 in chips) 
Seat 4: dddocky (6832 in chips) 
Seat 7: HighCardJasper (3295 in chips) 
Seat 8: appositive (26311 in chips) 
Seat 9: poorrick1338 (3195 in chips) 
color_singleton: posts small blind 50
MnnM150: posts big blind 100
*** HOLE CARDS ***
Dealt to Duke Croix [6h 4d]
Duke Croix: folds 
dddocky: folds 
HighCardJasper: folds 
appositive: folds 
poorrick1338: folds 
color_singleton: raises 200 to 300
MnnM150: folds 
Uncalled bet (200) returned to color_singleton
color_singleton collected 200 from pot
color_singleton: doesn't show hand 
*** SUMMARY ***
Total pot 200 | Rake 0 
Seat 1: color_singleton (small blind) collected (200)
Seat 2: MnnM150 (big blind) folded before Flop
Seat 3: Duke Croix folded before Flop (didn't bet)
Seat 4: dddocky folded before Flop (didn't bet)
Seat 7: HighCardJasper folded before Flop (didn't bet)
Seat 8: appositive folded before Flop (didn't bet)
Seat 9: poorrick1338 (button) folded before Flop (didn't bet)



PokerStars Home Game Hand #219640031216: {Club #3225207}  Hold'em No Limit (50/100) - 2020/10/22 19:01:47 ET
Table 'VU_table_tonight' 9-max (Play Money) Seat #1 is the button
Seat 1: color_singleton (37009 in chips) 
Seat 2: MnnM150 (14795 in chips) 
Seat 3: Duke Croix (36116 in chips) 
Seat 4: dddocky (6832 in chips) 
Seat 7: HighCardJasper (3295 in chips) 
Seat 8: appositive (26311 in chips) 
MnnM150: posts small blind 50
Duke Croix: posts big blind 100
*** HOLE CARDS ***
Dealt to Duke Croix [Ac Qh]
dddocky: calls 100
HighCardJasper: raises 100 to 200
appositive: calls 200
color_singleton: calls 200
MnnM150: calls 150
Duke Croix: calls 100
dddocky: calls 100
*** FLOP *** [2h Tc 7c]
MnnM150: checks 
Duke Croix: checks 
dddocky: checks 
HighCardJasper: checks 
appositive: bets 300
color_singleton: calls 300
MnnM150: calls 300
Duke Croix: folds 
dddocky: calls 300
HighCardJasper: folds 
*** TURN *** [2h Tc 7c] [6c]
MnnM150: checks 
dddocky: checks 
appositive: bets 1134
color_singleton: calls 1134
MnnM150: folds 
dddocky: folds 
*** RIVER *** [2h Tc 7c 6c] [9d]
appositive: bets 4411
color_singleton: calls 4411
*** SHOW DOWN ***
appositive: shows [Qc Qs] (a pair of Queens)
color_singleton: shows [4c Kc] (a flush, King high)
color_singleton collected 12748 from pot
*** SUMMARY ***
Total pot 13490 | Rake 742 
Board [2h Tc 7c 6c 9d]
Seat 1: color_singleton (button) showed [4c Kc] and won (12748) with a flush, King high
Seat 2: MnnM150 (small blind) folded on the Turn
Seat 3: Duke Croix (big blind) folded on the Flop
Seat 4: dddocky folded on the Turn
Seat 7: HighCardJasper folded on the Flop
Seat 8: appositive showed [Qc Qs] and lost with a pair of Queens



PokerStars Home Game Hand #219640066389: {Club #3225207}  Hold'em No Limit (50/100) - 2020/10/22 19:03:03 ET
Table 'VU_table_tonight' 9-max (Play Money) Seat #2 is the button
Seat 1: color_singleton (43712 in chips) 
Seat 2: MnnM150 (14295 in chips) 
Seat 3: Duke Croix (35916 in chips) 
Seat 4: dddocky (6332 in chips) 
Seat 7: HighCardJasper (3095 in chips) 
Seat 8: appositive (20266 in chips) 
Duke Croix: posts small blind 50
dddocky: posts big blind 100
*** HOLE CARDS ***
Dealt to Duke Croix [2d Ts]
HighCardJasper: calls 100
appositive: folds 
color_singleton: folds 
MnnM150: folds 
Duke Croix: calls 50
dddocky: checks 
*** FLOP *** [5h 4c 6d]
Duke Croix: checks 
dddocky: checks 
HighCardJasper: checks 
*** TURN *** [5h 4c 6d] [3d]
Duke Croix: bets 300
dddocky: folds 
HighCardJasper: calls 300
*** RIVER *** [5h 4c 6d 3d] [6h]
Duke Croix: bets 700
HighCardJasper: folds 
Uncalled bet (700) returned to Duke Croix
Duke Croix collected 850 from pot
*** SUMMARY ***
Total pot 900 | Rake 50 
Board [5h 4c 6d 3d 6h]
Seat 1: color_singleton folded before Flop (didn't bet)
Seat 2: MnnM150 (button) folded before Flop (didn't bet)
Seat 3: Duke Croix (small blind) collected (850)
Seat 4: dddocky (big blind) folded on the Turn
Seat 7: HighCardJasper folded on the River
Seat 8: appositive folded before Flop (didn't bet)



PokerStars Home Game Hand #219640080344: {Club #3225207}  Hold'em No Limit (50/100) - 2020/10/22 19:03:37 ET
Table 'VU_table_tonight' 9-max (Play Money) Seat #3 is the button
Seat 1: color_singleton (43712 in chips) 
Seat 2: MnnM150 (14295 in chips) 
Seat 3: Duke Croix (36366 in chips) 
Seat 4: dddocky (6232 in chips) 
Seat 7: HighCardJasper (2695 in chips) 
Seat 8: appositive (20266 in chips) 
dddocky: posts small blind 50
HighCardJasper: posts big blind 100
*** HOLE CARDS ***
Dealt to Duke Croix [7s 5h]
appositive: calls 100
color_singleton: folds 
MnnM150: calls 100
Duke Croix: folds 
dddocky: folds 
HighCardJasper: checks 
*** FLOP *** [Qh Qs 5d]
HighCardJasper: checks 
appositive: checks 
MnnM150: checks 
*** TURN *** [Qh Qs 5d] [4s]
HighCardJasper: checks 
appositive: checks 
MnnM150: checks 
*** RIVER *** [Qh Qs 5d 4s] [7h]
HighCardJasper: checks 
appositive: checks 
MnnM150: checks 
*** SHOW DOWN ***
HighCardJasper: shows [Ts Kc] (a pair of Queens)
appositive: mucks hand 
MnnM150: shows [3s As] (a pair of Queens - Ace kicker)
MnnM150 collected 331 from pot
*** SUMMARY ***
Total pot 350 | Rake 19 
Board [Qh Qs 5d 4s 7h]
Seat 1: color_singleton folded before Flop (didn't bet)
Seat 2: MnnM150 showed [3s As] and won (331) with a pair of Queens
Seat 3: Duke Croix (button) folded before Flop (didn't bet)
Seat 4: dddocky (small blind) folded before Flop
Seat 7: HighCardJasper (big blind) showed [Ts Kc] and lost with a pair of Queens
Seat 8: appositive mucked [8s 9h]



PokerStars Home Game Hand #219640093319: {Club #3225207}  Hold'em No Limit (50/100) - 2020/10/22 19:04:09 ET
Table 'VU_table_tonight' 9-max (Play Money) Seat #4 is the button
Seat 1: color_singleton (43712 in chips) 
Seat 2: MnnM150 (14526 in chips) 
Seat 3: Duke Croix (36366 in chips) 
Seat 4: dddocky (6182 in chips) 
Seat 7: HighCardJasper (2595 in chips) 
Seat 8: appositive (20166 in chips) 
HighCardJasper: posts small blind 50
appositive: posts big blind 100
*** HOLE CARDS ***
Dealt to Duke Croix [5h 2s]
color_singleton: raises 200 to 300
MnnM150: calls 300
Duke Croix: folds 
dddocky: folds 
HighCardJasper: calls 250
appositive: folds 
*** FLOP *** [4c 8h 2c]
HighCardJasper: checks 
color_singleton: checks 
MnnM150: checks 
*** TURN *** [4c 8h 2c] [Jc]
HighCardJasper: bets 2295 and is all-in
color_singleton: folds 
MnnM150: folds 
Uncalled bet (2295) returned to HighCardJasper
HighCardJasper collected 945 from pot
HighCardJasper: doesn't show hand 
*** SUMMARY ***
Total pot 1000 | Rake 55 
Board [4c 8h 2c Jc]
Seat 1: color_singleton folded on the Turn
Seat 2: MnnM150 folded on the Turn
Seat 3: Duke Croix folded before Flop (didn't bet)
Seat 4: dddocky (button) folded before Flop (didn't bet)
Seat 7: HighCardJasper (small blind) collected (945)
Seat 8: appositive (big blind) folded before Flop



PokerStars Home Game Hand #219640111569: {Club #3225207}  Hold'em No Limit (50/100) - 2020/10/22 19:04:54 ET
Table 'VU_table_tonight' 9-max (Play Money) Seat #7 is the button
Seat 1: color_singleton (43412 in chips) 
Seat 2: MnnM150 (14226 in chips) 
Seat 3: Duke Croix (36366 in chips) 
Seat 4: dddocky (6182 in chips) 
Seat 7: HighCardJasper (3240 in chips) 
Seat 8: appositive (20066 in chips) 
Seat 9: poorrick1338 (3195 in chips) 
appositive: posts small blind 50
poorrick1338: posts big blind 100
*** HOLE CARDS ***
Dealt to Duke Croix [2d 6s]
color_singleton: folds 
MnnM150: calls 100
Duke Croix: folds 
dddocky: folds 
HighCardJasper: calls 100
appositive: folds 
poorrick1338: checks 
*** FLOP *** [Td Ts 9c]
poorrick1338: checks 
MnnM150: checks 
HighCardJasper: checks 
*** TURN *** [Td Ts 9c] [Qh]
poorrick1338: checks 
MnnM150: checks 
HighCardJasper: checks 
*** RIVER *** [Td Ts 9c Qh] [9d]
poorrick1338: checks 
MnnM150: bets 331
HighCardJasper: folds 
poorrick1338: calls 331
*** SHOW DOWN ***
MnnM150: shows [3h 3s] (two pair, Tens and Nines)
poorrick1338: shows [5d 5s] (two pair, Tens and Nines)
poorrick1338 collected 478 from pot
MnnM150 collected 478 from pot
*** SUMMARY ***
Total pot 1012 | Rake 56 
Board [Td Ts 9c Qh 9d]
Seat 1: color_singleton folded before Flop (didn't bet)
Seat 2: MnnM150 showed [3h 3s] and won (478) with two pair, Tens and Nines
Seat 3: Duke Croix folded before Flop (didn't bet)
Seat 4: dddocky folded before Flop (didn't bet)
Seat 7: HighCardJasper (button) folded on the River
Seat 8: appositive (small blind) folded before Flop
Seat 9: poorrick1338 (big blind) showed [5d 5s] and won (478) with two pair, Tens and Nines



PokerStars Home Game Hand #219640128779: {Club #3225207}  Hold'em No Limit (50/100) - 2020/10/22 19:05:36 ET
Table 'VU_table_tonight' 9-max (Play Money) Seat #8 is the button
Seat 1: color_singleton (43412 in chips) 
Seat 2: MnnM150 (14273 in chips) 
Seat 3: Duke Croix (36366 in chips) 
Seat 4: dddocky (6182 in chips) 
Seat 7: HighCardJasper (3140 in chips) 
Seat 8: appositive (20016 in chips) 
Seat 9: poorrick1338 (3242 in chips) 
poorrick1338: posts small blind 50
color_singleton: posts big blind 100
*** HOLE CARDS ***
Dealt to Duke Croix [Jh 3s]
MnnM150: folds 
Duke Croix: folds 
dddocky: folds 
HighCardJasper: calls 100
appositive: calls 100
poorrick1338: calls 50
color_singleton: checks 
*** FLOP *** [9s Ac 6d]
poorrick1338: checks 
color_singleton: checks 
HighCardJasper: checks 
appositive: bets 378
poorrick1338: folds 
color_singleton: folds 
HighCardJasper: folds 
Uncalled bet (378) returned to appositive
appositive collected 378 from pot
appositive: doesn't show hand 
*** SUMMARY ***
Total pot 400 | Rake 22 
Board [9s Ac 6d]
Seat 1: color_singleton (big blind) folded on the Flop
Seat 2: MnnM150 folded before Flop (didn't bet)
Seat 3: Duke Croix folded before Flop (didn't bet)
Seat 4: dddocky folded before Flop (didn't bet)
Seat 7: HighCardJasper folded on the Flop
Seat 8: appositive (button) collected (378)
Seat 9: poorrick1338 (small blind) folded on the Flop



PokerStars Home Game Hand #219640144552: {Club #3225207}  Hold'em No Limit (50/100) - 2020/10/22 19:06:14 ET
Table 'VU_table_tonight' 9-max (Play Money) Seat #9 is the button
Seat 1: color_singleton (43312 in chips) 
Seat 2: MnnM150 (14273 in chips) 
Seat 3: Duke Croix (36366 in chips) 
Seat 4: dddocky (6182 in chips) 
Seat 7: HighCardJasper (3040 in chips) 
Seat 8: appositive (20294 in chips) 
Seat 9: poorrick1338 (3142 in chips) 
color_singleton: posts small blind 50
MnnM150: posts big blind 100
*** HOLE CARDS ***
Dealt to Duke Croix [2d Jc]
Duke Croix: folds 
dddocky: folds 
HighCardJasper: folds 
appositive: calls 100
poorrick1338: calls 100
color_singleton: folds 
MnnM150: raises 100 to 200
appositive: calls 100
poorrick1338: calls 100
*** FLOP *** [3c Td 5h]
MnnM150: bets 307
appositive: folds 
poorrick1338: calls 307
*** TURN *** [3c Td 5h] [2c]
MnnM150: bets 597
poorrick1338: calls 597
*** RIVER *** [3c Td 5h 2c] [6s]
MnnM150: bets 1161
poorrick1338: calls 1161
*** SHOW DOWN ***
MnnM150: shows [Kc Kd] (a pair of Kings)
poorrick1338: shows [5d 4c] (a straight, Deuce to Six)
poorrick1338 collected 4517 from pot
*** SUMMARY ***
Total pot 4780 | Rake 263 
Board [3c Td 5h 2c 6s]
Seat 1: color_singleton (small blind) folded before Flop
Seat 2: MnnM150 (big blind) showed [Kc Kd] and lost with a pair of Kings
Seat 3: Duke Croix folded before Flop (didn't bet)
Seat 4: dddocky folded before Flop (didn't bet)
Seat 7: HighCardJasper folded before Flop (didn't bet)
Seat 8: appositive folded on the Flop
Seat 9: poorrick1338 (button) showed [5d 4c] and won (4517) with a straight, Deuce to Six



PokerStars Home Game Hand #219640162757: {Club #3225207}  Hold'em No Limit (50/100) - 2020/10/22 19:06:58 ET
Table 'VU_table_tonight' 9-max (Play Money) Seat #1 is the button
Seat 1: color_singleton (43262 in chips) 
Seat 2: MnnM150 (12008 in chips) 
Seat 3: Duke Croix (36366 in chips) 
Seat 4: dddocky (6182 in chips) 
Seat 7: HighCardJasper (3040 in chips) 
Seat 8: appositive (20094 in chips) 
Seat 9: poorrick1338 (5394 in chips) 
MnnM150: posts small blind 50
Duke Croix: posts big blind 100
*** HOLE CARDS ***
Dealt to Duke Croix [9c 6d]
dddocky: calls 100
HighCardJasper: folds 
appositive: folds 
poorrick1338: calls 100
color_singleton: calls 100
MnnM150: folds 
Duke Croix: checks 
*** FLOP *** [2c Ac Kd]
Duke Croix: checks 
dddocky: checks 
poorrick1338: bets 200
color_singleton: folds 
Duke Croix: folds 
dddocky: folds 
Uncalled bet (200) returned to poorrick1338
poorrick1338 collected 425 from pot
poorrick1338: doesn't show hand 
*** SUMMARY ***
Total pot 450 | Rake 25 
Board [2c Ac Kd]
Seat 1: color_singleton (button) folded on the Flop
Seat 2: MnnM150 (small blind) folded before Flop
Seat 3: Duke Croix (big blind) folded on the Flop
Seat 4: dddocky folded on the Flop
Seat 7: HighCardJasper folded before Flop (didn't bet)
Seat 8: appositive folded before Flop (didn't bet)
Seat 9: poorrick1338 collected (425)



PokerStars Home Game Hand #219640178968: {Club #3225207}  Hold'em No Limit (50/100) - 2020/10/22 19:07:38 ET
Table 'VU_table_tonight' 9-max (Play Money) Seat #2 is the button
Seat 1: color_singleton (43162 in chips) 
Seat 2: MnnM150 (11958 in chips) 
Seat 3: Duke Croix (36266 in chips) 
Seat 4: dddocky (6082 in chips) 
Seat 7: HighCardJasper (3040 in chips) 
Seat 8: appositive (20094 in chips) 
Seat 9: poorrick1338 (5719 in chips) 
Duke Croix: posts small blind 50
dddocky: posts big blind 100
*** HOLE CARDS ***
Dealt to Duke Croix [6c 6d]
HighCardJasper: calls 100
appositive: folds 
poorrick1338: folds 
color_singleton: raises 200 to 300
MnnM150: calls 300
Duke Croix: calls 250
dddocky: folds 
HighCardJasper: calls 200
*** FLOP *** [7c 6s 4d]
Duke Croix: checks 
HighCardJasper: checks 
color_singleton: checks 
MnnM150: checks 
*** TURN *** [7c 6s 4d] [Kc]
Duke Croix: bets 900
HighCardJasper: folds 
color_singleton: folds 
MnnM150: folds 
Uncalled bet (900) returned to Duke Croix
Duke Croix collected 1228 from pot
*** SUMMARY ***
Total pot 1300 | Rake 72 
Board [7c 6s 4d Kc]
Seat 1: color_singleton folded on the Turn
Seat 2: MnnM150 (button) folded on the Turn
Seat 3: Duke Croix (small blind) collected (1228)
Seat 4: dddocky (big blind) folded before Flop
Seat 7: HighCardJasper folded on the Turn
Seat 8: appositive folded before Flop (didn't bet)
Seat 9: poorrick1338 folded before Flop (didn't bet)



PokerStars Home Game Hand #219640195653: {Club #3225207}  Hold'em No Limit (50/100) - 2020/10/22 19:08:19 ET
Table 'VU_table_tonight' 9-max (Play Money) Seat #3 is the button
Seat 1: color_singleton (42862 in chips) 
Seat 2: MnnM150 (11658 in chips) 
Seat 3: Duke Croix (37194 in chips) 
Seat 4: dddocky (5982 in chips) 
Seat 7: HighCardJasper (2740 in chips) 
Seat 8: appositive (20094 in chips) 
Seat 9: poorrick1338 (5719 in chips) 
dddocky: posts small blind 50
HighCardJasper: posts big blind 100
*** HOLE CARDS ***
Dealt to Duke Croix [8d Tc]
appositive: calls 100
poorrick1338: folds 
color_singleton: raises 200 to 300
MnnM150: folds 
Duke Croix: folds 
dddocky: folds 
HighCardJasper: folds 
appositive: calls 200
*** FLOP *** [6d 4h Qc]
appositive: checks 
color_singleton: bets 354
appositive: folds 
Uncalled bet (354) returned to color_singleton
color_singleton collected 709 from pot
color_singleton: doesn't show hand 
*** SUMMARY ***
Total pot 750 | Rake 41 
Board [6d 4h Qc]
Seat 1: color_singleton collected (709)
Seat 2: MnnM150 folded before Flop (didn't bet)
Seat 3: Duke Croix (button) folded before Flop (didn't bet)
Seat 4: dddocky (small blind) folded before Flop
Seat 7: HighCardJasper (big blind) folded before Flop
Seat 8: appositive folded on the Flop
Seat 9: poorrick1338 folded before Flop (didn't bet)



PokerStars Home Game Hand #219640205987: {Club #3225207}  Hold'em No Limit (50/100) - 2020/10/22 19:08:44 ET
Table 'VU_table_tonight' 9-max (Play Money) Seat #4 is the button
Seat 1: color_singleton (43271 in chips) 
Seat 2: MnnM150 (11658 in chips) 
Seat 3: Duke Croix (37194 in chips) 
Seat 4: dddocky (5932 in chips) 
Seat 7: HighCardJasper (2640 in chips) 
Seat 8: appositive (19794 in chips) 
Seat 9: poorrick1338 (5719 in chips) 
HighCardJasper: posts small blind 50
appositive: posts big blind 100
*** HOLE CARDS ***
Dealt to Duke Croix [7c Js]
poorrick1338: calls 100
color_singleton: raises 100 to 200
MnnM150: folds 
Duke Croix: calls 200
dddocky: folds 
HighCardJasper: calls 150
appositive: calls 100
poorrick1338: calls 100
*** FLOP *** [Jc 5d Th]
HighCardJasper: checks 
appositive: checks 
poorrick1338: checks 
color_singleton: checks 
Duke Croix: bets 500
HighCardJasper: folds 
appositive: calls 500
poorrick1338: folds 
color_singleton: folds 
*** TURN *** [Jc 5d Th] [8h]
appositive: checks 
Duke Croix: bets 1000
appositive: folds 
Uncalled bet (1000) returned to Duke Croix
Duke Croix collected 1890 from pot
*** SUMMARY ***
Total pot 2000 | Rake 110 
Board [Jc 5d Th 8h]
Seat 1: color_singleton folded on the Flop
Seat 2: MnnM150 folded before Flop (didn't bet)
Seat 3: Duke Croix collected (1890)
Seat 4: dddocky (button) folded before Flop (didn't bet)
Seat 7: HighCardJasper (small blind) folded on the Flop
Seat 8: appositive (big blind) folded on the Turn
Seat 9: poorrick1338 folded on the Flop



PokerStars Home Game Hand #219640233112: {Club #3225207}  Hold'em No Limit (50/100) - 2020/10/22 19:09:51 ET
Table 'VU_table_tonight' 9-max (Play Money) Seat #7 is the button
Seat 1: color_singleton (43071 in chips) 
Seat 2: MnnM150 (11658 in chips) 
Seat 3: Duke Croix (38384 in chips) 
Seat 4: dddocky (5932 in chips) 
Seat 7: HighCardJasper (2440 in chips) 
Seat 8: appositive (19094 in chips) 
Seat 9: poorrick1338 (5519 in chips) 
appositive: posts small blind 50
poorrick1338: posts big blind 100
*** HOLE CARDS ***
Dealt to Duke Croix [Ad 8d]
color_singleton: raises 200 to 300
MnnM150: folds 
Duke Croix: calls 300
dddocky: folds 
HighCardJasper: calls 300
appositive: folds 
poorrick1338: calls 200
*** FLOP *** [Js 4s 3c]
poorrick1338: checks 
color_singleton: checks 
Duke Croix: checks 
HighCardJasper: checks 
*** TURN *** [Js 4s 3c] [Jd]
poorrick1338: bets 100
color_singleton: calls 100
Duke Croix: calls 100
HighCardJasper: folds 
*** RIVER *** [Js 4s 3c Jd] [3d]
poorrick1338: bets 600
color_singleton: folds 
Duke Croix: calls 600
*** SHOW DOWN ***
poorrick1338: shows [3h Ac] (a full house, Threes full of Jacks)
Duke Croix: mucks hand 
poorrick1338 collected 2599 from pot
*** SUMMARY ***
Total pot 2750 | Rake 151 
Board [Js 4s 3c Jd 3d]
Seat 1: color_singleton folded on the River
Seat 2: MnnM150 folded before Flop (didn't bet)
Seat 3: Duke Croix mucked [Ad 8d]
Seat 4: dddocky folded before Flop (didn't bet)
Seat 7: HighCardJasper (button) folded on the Turn
Seat 8: appositive (small blind) folded before Flop
Seat 9: poorrick1338 (big blind) showed [3h Ac] and won (2599) with a full house, Threes full of Jacks



PokerStars Home Game Hand #219640247844: {Club #3225207}  Hold'em No Limit (50/100) - 2020/10/22 19:10:28 ET
Table 'VU_table_tonight' 9-max (Play Money) Seat #8 is the button
Seat 1: color_singleton (42671 in chips) 
Seat 2: MnnM150 (11658 in chips) 
Seat 3: Duke Croix (37384 in chips) 
Seat 4: dddocky (5932 in chips) 
Seat 7: HighCardJasper (2140 in chips) 
Seat 8: appositive (19044 in chips) 
Seat 9: poorrick1338 (7118 in chips) 
poorrick1338: posts small blind 50
color_singleton: posts big blind 100
*** HOLE CARDS ***
Dealt to Duke Croix [Tc Td]
MnnM150: calls 100
Duke Croix: raises 400 to 500
dddocky: folds 
HighCardJasper: calls 500
appositive: folds 
poorrick1338: folds 
color_singleton: calls 400
MnnM150: calls 400
*** FLOP *** [Kc 9d 3d]
color_singleton: checks 
MnnM150: checks 
Duke Croix: bets 1000
HighCardJasper: raises 640 to 1640 and is all-in
color_singleton: calls 1640
MnnM150: folds 
Duke Croix: calls 640
*** TURN *** [Kc 9d 3d] [4s]
color_singleton: checks 
Duke Croix: checks 
*** RIVER *** [Kc 9d 3d 4s] [Jc]
color_singleton: checks 
Duke Croix: checks 
*** SHOW DOWN ***
color_singleton: shows [Qd 9c] (a pair of Nines)
Duke Croix: shows [Tc Td] (a pair of Tens)
HighCardJasper: mucks hand 
Duke Croix collected 6587 from pot
*** SUMMARY ***
Total pot 6970 | Rake 383 
Board [Kc 9d 3d 4s Jc]
Seat 1: color_singleton (big blind) showed [Qd 9c] and lost with a pair of Nines
Seat 2: MnnM150 folded on the Flop
Seat 3: Duke Croix showed [Tc Td] and won (6587) with a pair of Tens
Seat 4: dddocky folded before Flop (didn't bet)
Seat 7: HighCardJasper mucked [As 9h]
Seat 8: appositive (button) folded before Flop (didn't bet)
Seat 9: poorrick1338 (small blind) folded before Flop



PokerStars Home Game Hand #219640269017: {Club #3225207}  Hold'em No Limit (50/100) - 2020/10/22 19:11:21 ET
Table 'VU_table_tonight' 9-max (Play Money) Seat #9 is the button
Seat 1: color_singleton (40531 in chips) 
Seat 2: MnnM150 (11158 in chips) 
Seat 3: Duke Croix (41831 in chips) 
Seat 4: dddocky (5932 in chips) 
Seat 8: appositive (19044 in chips) 
Seat 9: poorrick1338 (7068 in chips) 
color_singleton: posts small blind 50
MnnM150: posts big blind 100
*** HOLE CARDS ***
Dealt to Duke Croix [Ac Qc]
Duke Croix: raises 300 to 400
dddocky: folds 
appositive: folds 
poorrick1338: calls 400
color_singleton: calls 350
MnnM150: folds 
*** FLOP *** [7s 6s 7d]
color_singleton: bets 614
Duke Croix: folds 
poorrick1338: calls 614
*** TURN *** [7s 6s 7d] [Ks]
color_singleton: checks 
poorrick1338: checks 
*** RIVER *** [7s 6s 7d Ks] [2s]
color_singleton: bets 2389
poorrick1338: calls 2389
*** SHOW DOWN ***
color_singleton: shows [As Js] (a flush, Ace high)
poorrick1338: mucks hand 
color_singleton collected 6904 from pot
*** SUMMARY ***
Total pot 7306 | Rake 402 
Board [7s 6s 7d Ks 2s]
Seat 1: color_singleton (small blind) showed [As Js] and won (6904) with a flush, Ace high
Seat 2: MnnM150 (big blind) folded before Flop
Seat 3: Duke Croix folded on the Flop
Seat 4: dddocky folded before Flop (didn't bet)
Seat 8: appositive folded before Flop (didn't bet)
Seat 9: poorrick1338 (button) mucked [6c Jh]



PokerStars Home Game Hand #219640280195: {Club #3225207}  Hold'em No Limit (50/100) - 2020/10/22 19:11:49 ET
Table 'VU_table_tonight' 9-max (Play Money) Seat #1 is the button
Seat 1: color_singleton (44032 in chips) 
Seat 2: MnnM150 (11058 in chips) 
Seat 3: Duke Croix (41431 in chips) 
Seat 4: dddocky (5932 in chips) 
Seat 8: appositive (19044 in chips) 
Seat 9: poorrick1338 (3665 in chips) 
MnnM150: posts small blind 50
Duke Croix: posts big blind 100
*** HOLE CARDS ***
Dealt to Duke Croix [Jc 3h]
dddocky: folds 
appositive: calls 100
poorrick1338: calls 100
color_singleton: folds 
MnnM150: folds 
Duke Croix: checks 
*** FLOP *** [3d 6d Qs]
Duke Croix: checks 
appositive: bets 331
poorrick1338: folds 
Duke Croix: folds 
Uncalled bet (331) returned to appositive
appositive collected 331 from pot
appositive: doesn't show hand 
*** SUMMARY ***
Total pot 350 | Rake 19 
Board [3d 6d Qs]
Seat 1: color_singleton (button) folded before Flop (didn't bet)
Seat 2: MnnM150 (small blind) folded before Flop
Seat 3: Duke Croix (big blind) folded on the Flop
Seat 4: dddocky folded before Flop (didn't bet)
Seat 8: appositive collected (331)
Seat 9: poorrick1338 folded on the Flop



PokerStars Home Game Hand #219640294474: {Club #3225207}  Hold'em No Limit (50/100) - 2020/10/22 19:12:25 ET
Table 'VU_table_tonight' 9-max (Play Money) Seat #2 is the button
Seat 1: color_singleton (44032 in chips) 
Seat 2: MnnM150 (11008 in chips) 
Seat 3: Duke Croix (41331 in chips) 
Seat 4: dddocky (5932 in chips) 
Seat 8: appositive (19275 in chips) 
Seat 9: poorrick1338 (3565 in chips) 
Duke Croix: posts small blind 50
dddocky: posts big blind 100
*** HOLE CARDS ***
Dealt to Duke Croix [6s Js]
appositive: raises 200 to 300
poorrick1338: folds 
color_singleton: folds 
MnnM150: calls 300
Duke Croix: folds 
dddocky: folds 
*** FLOP *** [8d 5c 9d]
appositive: bets 709
MnnM150: folds 
Uncalled bet (709) returned to appositive
appositive collected 709 from pot
appositive: doesn't show hand 
*** SUMMARY ***
Total pot 750 | Rake 41 
Board [8d 5c 9d]
Seat 1: color_singleton folded before Flop (didn't bet)
Seat 2: MnnM150 (button) folded on the Flop
Seat 3: Duke Croix (small blind) folded before Flop
Seat 4: dddocky (big blind) folded before Flop
Seat 8: appositive collected (709)
Seat 9: poorrick1338 folded before Flop (didn't bet)



PokerStars Home Game Hand #219640305445: {Club #3225207}  Hold'em No Limit (50/100) - 2020/10/22 19:12:52 ET
Table 'VU_table_tonight' 9-max (Play Money) Seat #3 is the button
Seat 1: color_singleton (44032 in chips) 
Seat 2: MnnM150 (10708 in chips) 
Seat 3: Duke Croix (41281 in chips) 
Seat 4: dddocky (5832 in chips) 
Seat 8: appositive (19684 in chips) 
Seat 9: poorrick1338 (3565 in chips) 
dddocky: posts small blind 50
appositive: posts big blind 100
*** HOLE CARDS ***
Dealt to Duke Croix [3h Ad]
poorrick1338: calls 100
color_singleton: raises 100 to 200
MnnM150: calls 200
Duke Croix: calls 200
dddocky: calls 150
appositive: folds 
poorrick1338: calls 100
*** FLOP *** [Jc 9h 2h]
dddocky: checks 
poorrick1338: checks 
color_singleton: checks 
MnnM150: checks 
Duke Croix: checks 
*** TURN *** [Jc 9h 2h] [Qs]
dddocky: checks 
poorrick1338: bets 800
color_singleton: folds 
MnnM150: folds 
Duke Croix: folds 
dddocky: folds 
Uncalled bet (800) returned to poorrick1338
poorrick1338 collected 1039 from pot
poorrick1338: doesn't show hand 
*** SUMMARY ***
Total pot 1100 | Rake 61 
Board [Jc 9h 2h Qs]
Seat 1: color_singleton folded on the Turn
Seat 2: MnnM150 folded on the Turn
Seat 3: Duke Croix (button) folded on the Turn
Seat 4: dddocky (small blind) folded on the Turn
Seat 8: appositive (big blind) folded before Flop
Seat 9: poorrick1338 collected (1039)



PokerStars Home Game Hand #219640331654: {Club #3225207}  Hold'em No Limit (50/100) - 2020/10/22 19:13:51 ET
Table 'VU_table_tonight' 9-max (Play Money) Seat #4 is the button
Seat 1: color_singleton (43832 in chips) 
Seat 2: MnnM150 (10508 in chips) 
Seat 3: Duke Croix (41081 in chips) 
Seat 4: dddocky (5632 in chips) 
Seat 8: appositive (19584 in chips) 
Seat 9: poorrick1338 (4404 in chips) 
appositive: posts small blind 50
poorrick1338: posts big blind 100
*** HOLE CARDS ***
Dealt to Duke Croix [6d Ks]
color_singleton: raises 100 to 200
MnnM150: calls 200
Duke Croix: folds 
dddocky: calls 200
appositive: folds 
poorrick1338: calls 100
*** FLOP *** [3s 6s 8c]
poorrick1338: bets 100
color_singleton: calls 100
MnnM150: calls 100
dddocky: calls 100
*** TURN *** [3s 6s 8c] [4d]
poorrick1338: checks 
color_singleton: checks 
MnnM150: checks 
dddocky: checks 
*** RIVER *** [3s 6s 8c 4d] [Th]
poorrick1338: bets 500
color_singleton: folds 
MnnM150: folds 
dddocky: folds 
Uncalled bet (500) returned to poorrick1338
poorrick1338 collected 1181 from pot
poorrick1338: doesn't show hand 
*** SUMMARY ***
Total pot 1250 | Rake 69 
Board [3s 6s 8c 4d Th]
Seat 1: color_singleton folded on the River
Seat 2: MnnM150 folded on the River
Seat 3: Duke Croix folded before Flop (didn't bet)
Seat 4: dddocky (button) folded on the River
Seat 8: appositive (small blind) folded before Flop
Seat 9: poorrick1338 (big blind) collected (1181)



PokerStars Home Game Hand #219640358868: {Club #3225207}  Hold'em No Limit (50/100) - 2020/10/22 19:15:00 ET
Table 'VU_table_tonight' 9-max (Play Money) Seat #8 is the button
Seat 1: color_singleton (43532 in chips) 
Seat 2: MnnM150 (10208 in chips) 
Seat 3: Duke Croix (41081 in chips) 
Seat 4: dddocky (5332 in chips) 
Seat 7: HighCardJasper (10000 in chips) 
Seat 8: appositive (19534 in chips) 
Seat 9: poorrick1338 (5285 in chips) 
poorrick1338: posts small blind 50
color_singleton: posts big blind 100
HighCardJasper: posts small & big blinds 150
*** HOLE CARDS ***
Dealt to Duke Croix [5h Ac]
MnnM150: folds 
Duke Croix: calls 100
dddocky: folds 
HighCardJasper: checks 
appositive: folds 
poorrick1338: calls 50
color_singleton: raises 200 to 300
Duke Croix: calls 200
appositive leaves the table
HighCardJasper: folds 
poorrick1338: calls 200
*** FLOP *** [Ts 6h Qc]
poorrick1338: checks 
color_singleton: bets 496
Duke Croix: folds 
poorrick1338: calls 496
*** TURN *** [Ts 6h Qc] [Kh]
poorrick1338: bets 300
color_singleton: calls 300
*** RIVER *** [Ts 6h Qc Kh] [7c]
poorrick1338: bets 400
MnnM150 leaves the table
color_singleton: folds 
Uncalled bet (400) returned to poorrick1338
poorrick1338 collected 2497 from pot
poorrick1338: doesn't show hand 
*** SUMMARY ***
Total pot 2642 | Rake 145 
Board [Ts 6h Qc Kh 7c]
Seat 1: color_singleton (big blind) folded on the River
Seat 2: MnnM150 folded before Flop (didn't bet)
Seat 3: Duke Croix folded on the Flop
Seat 4: dddocky folded before Flop (didn't bet)
Seat 7: HighCardJasper folded before Flop (didn't bet)
Seat 8: appositive (button) folded before Flop (didn't bet)
Seat 9: poorrick1338 (small blind) collected (2497)



PokerStars Home Game Hand #219640383190: {Club #3225207}  Hold'em No Limit (50/100) - 2020/10/22 19:16:01 ET
Table 'VU_table_tonight' 9-max (Play Money) Seat #9 is the button
Seat 1: color_singleton (42436 in chips) 
Seat 3: Duke Croix (40781 in chips) 
Seat 4: dddocky (5332 in chips) 
Seat 7: HighCardJasper (9850 in chips) 
Seat 9: poorrick1338 (6686 in chips) 
color_singleton: posts small blind 50
Duke Croix: posts big blind 100
*** HOLE CARDS ***
Dealt to Duke Croix [7s Kd]
dddocky: folds 
HighCardJasper: calls 100
poorrick1338: calls 100
color_singleton: calls 50
Duke Croix: checks 
*** FLOP *** [Ks 4c 7h]
color_singleton: checks 
Duke Croix: checks 
HighCardJasper: checks 
poorrick1338: checks 
*** TURN *** [Ks 4c 7h] [5d]
color_singleton: checks 
Duke Croix: bets 400
HighCardJasper: folds 
poorrick1338: raises 400 to 800
color_singleton: folds 
Duke Croix: raises 400 to 1200
poorrick1338: raises 400 to 1600
Duke Croix: raises 39081 to 40681 and is all-in
poorrick1338: calls 4986 and is all-in
Uncalled bet (34095) returned to Duke Croix
*** RIVER *** [Ks 4c 7h 5d] [4s]
*** SHOW DOWN ***
Duke Croix: shows [7s Kd] (two pair, Kings and Sevens)
poorrick1338: shows [6c 8d] (a straight, Four to Eight)
poorrick1338 collected 12826 from pot
*** SUMMARY ***
Total pot 13572 | Rake 746 
Board [Ks 4c 7h 5d 4s]
Seat 1: color_singleton (small blind) folded on the Turn
Seat 3: Duke Croix (big blind) showed [7s Kd] and lost with two pair, Kings and Sevens
Seat 4: dddocky folded before Flop (didn't bet)
Seat 7: HighCardJasper folded on the Turn
Seat 9: poorrick1338 (button) showed [6c 8d] and won (12826) with a straight, Four to Eight



PokerStars Home Game Hand #219640403639: {Club #3225207}  Hold'em No Limit (50/100) - 2020/10/22 19:16:53 ET
Table 'VU_table_tonight' 9-max (Play Money) Seat #1 is the button
Seat 1: color_singleton (42336 in chips) 
Seat 3: Duke Croix (34095 in chips) 
Seat 4: dddocky (5332 in chips) 
Seat 7: HighCardJasper (9750 in chips) 
Seat 9: poorrick1338 (12826 in chips) 
Duke Croix: posts small blind 50
dddocky: posts big blind 100
*** HOLE CARDS ***
Dealt to Duke Croix [7h Kc]
HighCardJasper: calls 100
poorrick1338: calls 100
color_singleton: folds 
Duke Croix: calls 50
dddocky: checks 
*** FLOP *** [3s 8c 3h]
Duke Croix: checks 
dddocky: checks 
HighCardJasper: checks 
poorrick1338: bets 400
Duke Croix: folds 
dddocky: calls 400
HighCardJasper: folds 
*** TURN *** [3s 8c 3h] [5d]
dddocky: checks 
poorrick1338: checks 
*** RIVER *** [3s 8c 3h 5d] [Ks]
dddocky: bets 567
poorrick1338: calls 567
*** SHOW DOWN ***
dddocky: shows [4c Kh] (two pair, Kings and Threes)
poorrick1338: mucks hand 
dddocky collected 2206 from pot
*** SUMMARY ***
Total pot 2334 | Rake 128 
Board [3s 8c 3h 5d Ks]
Seat 1: color_singleton (button) folded before Flop (didn't bet)
Seat 3: Duke Croix (small blind) folded on the Flop
Seat 4: dddocky (big blind) showed [4c Kh] and won (2206) with two pair, Kings and Threes
Seat 7: HighCardJasper folded on the Flop
Seat 9: poorrick1338 mucked [8h Qh]



PokerStars Home Game Hand #219640421723: {Club #3225207}  Hold'em No Limit (50/100) - 2020/10/22 19:17:38 ET
Table 'VU_table_tonight' 9-max (Play Money) Seat #3 is the button
Seat 1: color_singleton (42336 in chips) 
Seat 3: Duke Croix (33995 in chips) 
Seat 4: dddocky (6471 in chips) 
Seat 7: HighCardJasper (9650 in chips) 
Seat 9: poorrick1338 (11759 in chips) 
dddocky: posts small blind 50
HighCardJasper: posts big blind 100
*** HOLE CARDS ***
Dealt to Duke Croix [Th 7d]
poorrick1338: folds 
color_singleton: raises 100 to 200
Duke Croix: folds 
dddocky: folds 
HighCardJasper: calls 100
*** FLOP *** [3s 4s Jc]
HighCardJasper: checks 
color_singleton: checks 
*** TURN *** [3s 4s Jc] [9h]
HighCardJasper: checks 
color_singleton: bets 425
HighCardJasper: folds 
Uncalled bet (425) returned to color_singleton
color_singleton collected 425 from pot
color_singleton: doesn't show hand 
*** SUMMARY ***
Total pot 450 | Rake 25 
Board [3s 4s Jc 9h]
Seat 1: color_singleton collected (425)
Seat 3: Duke Croix (button) folded before Flop (didn't bet)
Seat 4: dddocky (small blind) folded before Flop
Seat 7: HighCardJasper (big blind) folded on the Turn
Seat 9: poorrick1338 folded before Flop (didn't bet)



PokerStars Home Game Hand #219640435770: {Club #3225207}  Hold'em No Limit (50/100) - 2020/10/22 19:18:14 ET
Table 'VU_table_tonight' 9-max (Play Money) Seat #4 is the button
Seat 1: color_singleton (42561 in chips) 
Seat 3: Duke Croix (33995 in chips) 
Seat 4: dddocky (6421 in chips) 
Seat 7: HighCardJasper (9450 in chips) 
Seat 9: poorrick1338 (11759 in chips) 
HighCardJasper: posts small blind 50
poorrick1338: posts big blind 100
*** HOLE CARDS ***
Dealt to Duke Croix [Qd 9s]
color_singleton: folds 
Duke Croix: calls 100
dddocky: calls 100
HighCardJasper: calls 50
poorrick1338: raises 100 to 200
Duke Croix: calls 100
dddocky: calls 100
HighCardJasper: calls 100
*** FLOP *** [Qc 2h 6h]
HighCardJasper: checks 
poorrick1338: checks 
Duke Croix: bets 500
dddocky: folds 
HighCardJasper: folds 
poorrick1338: folds 
Uncalled bet (500) returned to Duke Croix
Duke Croix collected 756 from pot
*** SUMMARY ***
Total pot 800 | Rake 44 
Board [Qc 2h 6h]
Seat 1: color_singleton folded before Flop (didn't bet)
Seat 3: Duke Croix collected (756)
Seat 4: dddocky (button) folded on the Flop
Seat 7: HighCardJasper (small blind) folded on the Flop
Seat 9: poorrick1338 (big blind) folded on the Flop



PokerStars Home Game Hand #219640452850: {Club #3225207}  Hold'em No Limit (50/100) - 2020/10/22 19:18:57 ET
Table 'VU_table_tonight' 9-max (Play Money) Seat #7 is the button
Seat 1: color_singleton (42561 in chips) 
Seat 3: Duke Croix (34551 in chips) 
Seat 4: dddocky (6221 in chips) 
Seat 7: HighCardJasper (9250 in chips) 
Seat 9: poorrick1338 (11559 in chips) 
poorrick1338: posts small blind 50
color_singleton: posts big blind 100
*** HOLE CARDS ***
Dealt to Duke Croix [Ac 8c]
Duke Croix: raises 300 to 400
dddocky: folds 
HighCardJasper: folds 
poorrick1338: calls 350
color_singleton: calls 300
*** FLOP *** [Kh 7d 2c]
poorrick1338: checks 
color_singleton: checks 
Duke Croix: checks 
*** TURN *** [Kh 7d 2c] [Qd]
poorrick1338: checks 
color_singleton: checks 
Duke Croix: checks 
*** RIVER *** [Kh 7d 2c Qd] [Qh]
poorrick1338: checks 
color_singleton: checks 
Duke Croix: bets 700
poorrick1338: folds 
color_singleton: folds 
Uncalled bet (700) returned to Duke Croix
Duke Croix collected 1134 from pot
*** SUMMARY ***
Total pot 1200 | Rake 66 
Board [Kh 7d 2c Qd Qh]
Seat 1: color_singleton (big blind) folded on the River
Seat 3: Duke Croix collected (1134)
Seat 4: dddocky folded before Flop (didn't bet)
Seat 7: HighCardJasper (button) folded before Flop (didn't bet)
Seat 9: poorrick1338 (small blind) folded on the River



PokerStars Home Game Hand #219640469913: {Club #3225207}  Hold'em No Limit (50/100) - 2020/10/22 19:19:42 ET
Table 'VU_table_tonight' 9-max (Play Money) Seat #9 is the button
Seat 1: color_singleton (42161 in chips) 
Seat 3: Duke Croix (35285 in chips) 
Seat 4: dddocky (6221 in chips) 
Seat 7: HighCardJasper (9250 in chips) 
Seat 9: poorrick1338 (11159 in chips) 
color_singleton: posts small blind 50
Duke Croix: posts big blind 100
*** HOLE CARDS ***
Dealt to Duke Croix [9d 2h]
dddocky: calls 100
HighCardJasper: calls 100
poorrick1338: calls 100
color_singleton: calls 50
Duke Croix: checks 
*** FLOP *** [5h Kc 5d]
color_singleton: checks 
Duke Croix: checks 
dddocky: checks 
HighCardJasper: checks 
poorrick1338: checks 
*** TURN *** [5h Kc 5d] [Tc]
color_singleton: bets 236
Duke Croix: folds 
dddocky: raises 236 to 472
HighCardJasper: folds 
poorrick1338: calls 472
color_singleton: calls 236
*** RIVER *** [5h Kc 5d Tc] [6h]
color_singleton: checks 
dddocky: checks 
poorrick1338: checks 
*** SHOW DOWN ***
color_singleton: shows [7h 5c] (three of a kind, Fives)
dddocky: mucks hand 
poorrick1338: mucks hand 
color_singleton collected 1811 from pot
*** SUMMARY ***
Total pot 1916 | Rake 105 
Board [5h Kc 5d Tc 6h]
Seat 1: color_singleton (small blind) showed [7h 5c] and won (1811) with three of a kind, Fives
Seat 3: Duke Croix (big blind) folded on the Turn
Seat 4: dddocky mucked [Th Qs]
Seat 7: HighCardJasper folded on the Turn
Seat 9: poorrick1338 (button) mucked [Ts 7s]



PokerStars Home Game Hand #219640488471: {Club #3225207}  Hold'em No Limit (50/100) - 2020/10/22 19:20:30 ET
Table 'VU_table_tonight' 9-max (Play Money) Seat #1 is the button
Seat 1: color_singleton (43400 in chips) 
Seat 3: Duke Croix (35185 in chips) 
Seat 4: dddocky (5649 in chips) 
Seat 7: HighCardJasper (9150 in chips) 
Seat 9: poorrick1338 (10587 in chips) 
Duke Croix: posts small blind 50
dddocky: posts big blind 100
*** HOLE CARDS ***
Dealt to Duke Croix [Qs 6d]
HighCardJasper: calls 100
poorrick1338: calls 100
color_singleton: calls 100
Duke Croix: calls 50
dddocky: checks 
*** FLOP *** [Tc 9c Ks]
Duke Croix: checks 
dddocky: checks 
HighCardJasper: checks 
poorrick1338: checks 
color_singleton: checks 
*** TURN *** [Tc 9c Ks] [Jc]
Duke Croix: bets 300
dddocky: folds 
HighCardJasper: folds 
poorrick1338: folds 
color_singleton: raises 400 to 700
Duke Croix: calls 400
*** RIVER *** [Tc 9c Ks Jc] [Td]
Duke Croix: checks 
color_singleton: checks 
*** SHOW DOWN ***
Duke Croix: shows [Qs 6d] (a straight, Nine to King)
color_singleton: mucks hand 
Duke Croix collected 1795 from pot
*** SUMMARY ***
Total pot 1900 | Rake 105 
Board [Tc 9c Ks Jc Td]
Seat 1: color_singleton (button) mucked [7h 8d]
Seat 3: Duke Croix (small blind) showed [Qs 6d] and won (1795) with a straight, Nine to King
Seat 4: dddocky (big blind) folded on the Turn
Seat 7: HighCardJasper folded on the Turn
Seat 9: poorrick1338 folded on the Turn



PokerStars Home Game Hand #219640521042: {Club #3225207}  Hold'em No Limit (50/100) - 2020/10/22 19:21:31 ET
Table 'VU_table_tonight' 9-max (Play Money) Seat #3 is the button
Seat 1: color_singleton (42600 in chips) 
Seat 3: Duke Croix (36180 in chips) 
Seat 4: dddocky (5549 in chips) 
Seat 7: HighCardJasper (9050 in chips) 
Seat 9: poorrick1338 (10487 in chips) 
dddocky: posts small blind 50
HighCardJasper: posts big blind 100
*** HOLE CARDS ***
Dealt to Duke Croix [8d Qc]
poorrick1338: calls 100
color_singleton: raises 200 to 300
Duke Croix: folds 
dddocky: folds 
HighCardJasper: calls 200
poorrick1338: folds 
*** FLOP *** [Kd Ah 7h]
HighCardJasper: checks 
color_singleton: bets 354
HighCardJasper: calls 354
*** TURN *** [Kd Ah 7h] [6c]
HighCardJasper: bets 600
color_singleton: calls 600
*** RIVER *** [Kd Ah 7h 6c] [Ac]
HighCardJasper: checks 
color_singleton: bets 1256
HighCardJasper: folds 
Uncalled bet (1256) returned to color_singleton
color_singleton collected 2512 from pot
color_singleton: doesn't show hand 
*** SUMMARY ***
Total pot 2658 | Rake 146 
Board [Kd Ah 7h 6c Ac]
Seat 1: color_singleton collected (2512)
Seat 3: Duke Croix (button) folded before Flop (didn't bet)
Seat 4: dddocky (small blind) folded before Flop
Seat 7: HighCardJasper (big blind) folded on the River
Seat 9: poorrick1338 folded before Flop



PokerStars Home Game Hand #219640541056: {Club #3225207}  Hold'em No Limit (50/100) - 2020/10/22 19:22:24 ET
Table 'VU_table_tonight' 9-max (Play Money) Seat #4 is the button
Seat 1: color_singleton (43858 in chips) 
Seat 3: Duke Croix (36180 in chips) 
Seat 4: dddocky (5499 in chips) 
Seat 7: HighCardJasper (7796 in chips) 
Seat 9: poorrick1338 (10387 in chips) 
HighCardJasper: posts small blind 50
poorrick1338: posts big blind 100
*** HOLE CARDS ***
Dealt to Duke Croix [6h Tc]
color_singleton: raises 200 to 300
Duke Croix: folds 
dddocky: folds 
HighCardJasper: folds 
poorrick1338: folds 
Uncalled bet (200) returned to color_singleton
color_singleton collected 250 from pot
color_singleton: doesn't show hand 
*** SUMMARY ***
Total pot 250 | Rake 0 
Seat 1: color_singleton collected (250)
Seat 3: Duke Croix folded before Flop (didn't bet)
Seat 4: dddocky (button) folded before Flop (didn't bet)
Seat 7: HighCardJasper (small blind) folded before Flop
Seat 9: poorrick1338 (big blind) folded before Flop



PokerStars Home Game Hand #219640546368: {Club #3225207}  Hold'em No Limit (50/100) - 2020/10/22 19:22:38 ET
Table 'VU_table_tonight' 9-max (Play Money) Seat #7 is the button
Seat 1: color_singleton (44008 in chips) 
Seat 3: Duke Croix (36180 in chips) 
Seat 4: dddocky (5499 in chips) 
Seat 7: HighCardJasper (7746 in chips) 
Seat 9: poorrick1338 (10287 in chips) 
poorrick1338: posts small blind 50
color_singleton: posts big blind 100
*** HOLE CARDS ***
Dealt to Duke Croix [5c Ac]
Duke Croix: raises 300 to 400
dddocky: calls 400
HighCardJasper: calls 400
poorrick1338: calls 350
color_singleton: calls 300
*** FLOP *** [3d 6d Ts]
poorrick1338: checks 
color_singleton: checks 
Duke Croix: checks 
dddocky: checks 
HighCardJasper: checks 
*** TURN *** [3d 6d Ts] [8h]
poorrick1338: checks 
color_singleton: bets 945
Duke Croix: folds 
dddocky: folds 
HighCardJasper: folds 
poorrick1338: folds 
Uncalled bet (945) returned to color_singleton
color_singleton collected 1890 from pot
color_singleton: doesn't show hand 
*** SUMMARY ***
Total pot 2000 | Rake 110 
Board [3d 6d Ts 8h]
Seat 1: color_singleton (big blind) collected (1890)
Seat 3: Duke Croix folded on the Turn
Seat 4: dddocky folded on the Turn
Seat 7: HighCardJasper (button) folded on the Turn
Seat 9: poorrick1338 (small blind) folded on the Turn



