PokerStars Home Game Hand #216485842898: {Club #3225207}  Hold'em No Limit (50/100) - 2020/07/16 14:49:58 ET
Table 'Fun times' 9-max (Play Money) Seat #2 is the button
Seat 1: color_singleton (11314 in chips) 
Seat 2: dddocky (18047 in chips) 
Seat 6: Klemtonius (8889 in chips) 
Seat 8: HighCardJasper (9772 in chips) 
Seat 9: Manon947 (10589 in chips) 
Klemtonius: posts small blind 50
HighCardJasper: posts big blind 100
Manon947: posts small & big blinds 150
*** HOLE CARDS ***
Dealt to Manon947 [6c 3c]
Manon947: checks 
color_singleton: folds 
dddocky: calls 100
Klemtonius: calls 50
HighCardJasper: raises 200 to 300
Manon947: calls 200
dddocky: folds 
Klemtonius: calls 200
*** FLOP *** [5c 9d 7s]
Klemtonius: checks 
HighCardJasper: checks 
Manon947: checks 
*** TURN *** [5c 9d 7s] [9s]
Klemtonius: bets 100
HighCardJasper: calls 100
Manon947: folds 
*** RIVER *** [5c 9d 7s 9s] [Jc]
Klemtonius: checks 
HighCardJasper: checks 
*** SHOW DOWN ***
Klemtonius: shows [Kc 3h] (a pair of Nines)
HighCardJasper: shows [Qc Ad] (a pair of Nines - Ace kicker)
HighCardJasper collected 1181 from pot
*** SUMMARY ***
Total pot 1250 | Rake 69 
Board [5c 9d 7s 9s Jc]
Seat 1: color_singleton folded before Flop (didn't bet)
Seat 2: dddocky (button) folded before Flop
Seat 6: Klemtonius (small blind) showed [Kc 3h] and lost with a pair of Nines
Seat 8: HighCardJasper (big blind) showed [Qc Ad] and won (1181) with a pair of Nines
Seat 9: Manon947 folded on the Turn



PokerStars Home Game Hand #216485881263: {Club #3225207}  Hold'em No Limit (50/100) - 2020/07/16 14:50:48 ET
Table 'Fun times' 9-max (Play Money) Seat #6 is the button
Seat 1: color_singleton (11314 in chips) 
Seat 2: dddocky (17947 in chips) 
Seat 6: Klemtonius (8489 in chips) 
Seat 8: HighCardJasper (10553 in chips) 
Seat 9: Manon947 (10239 in chips) 
HighCardJasper: posts small blind 50
Manon947: posts big blind 100
*** HOLE CARDS ***
Dealt to Manon947 [3c 5d]
color_singleton: raises 100 to 200
dddocky: calls 200
Klemtonius: calls 200
HighCardJasper: calls 150
Manon947: folds 
*** FLOP *** [7d 5c As]
HighCardJasper: checks 
color_singleton: checks 
dddocky: bets 100
Klemtonius: calls 100
HighCardJasper: calls 100
color_singleton: calls 100
*** TURN *** [7d 5c As] [Qd]
HighCardJasper: checks 
color_singleton: bets 614
dddocky: calls 614
Klemtonius: folds 
HighCardJasper: calls 614
*** RIVER *** [7d 5c As Qd] [8s]
HighCardJasper: checks 
color_singleton: checks 
dddocky: bets 100
HighCardJasper: calls 100
color_singleton: calls 100
*** SHOW DOWN ***
dddocky: shows [Ah 8d] (two pair, Aces and Eights)
HighCardJasper: mucks hand 
color_singleton: mucks hand 
dddocky collected 3253 from pot
*** SUMMARY ***
Total pot 3442 | Rake 189 
Board [7d 5c As Qd 8s]
Seat 1: color_singleton mucked [Ks Ac]
Seat 2: dddocky showed [Ah 8d] and won (3253) with two pair, Aces and Eights
Seat 6: Klemtonius (button) folded on the Turn
Seat 8: HighCardJasper (small blind) mucked [3h Ad]
Seat 9: Manon947 (big blind) folded before Flop



PokerStars Home Game Hand #216485911810: {Club #3225207}  Hold'em No Limit (50/100) - 2020/07/16 14:51:39 ET
Table 'Fun times' 9-max (Play Money) Seat #8 is the button
Seat 1: color_singleton (10300 in chips) 
Seat 2: dddocky (20186 in chips) 
Seat 6: Klemtonius (8189 in chips) 
Seat 8: HighCardJasper (9539 in chips) 
Seat 9: Manon947 (10139 in chips) 
Manon947: posts small blind 50
color_singleton: posts big blind 100
*** HOLE CARDS ***
Dealt to Manon947 [Ad Jh]
dddocky: calls 100
Klemtonius: calls 100
HighCardJasper: calls 100
Manon947: raises 100 to 200
color_singleton: raises 200 to 400
dddocky: calls 300
Klemtonius: calls 300
HighCardJasper: calls 300
Manon947: calls 200
*** FLOP *** [5d 2s 5h]
Manon947: checks 
color_singleton: checks 
dddocky: checks 
Klemtonius: checks 
HighCardJasper: checks 
*** TURN *** [5d 2s 5h] [9s]
Manon947: checks 
color_singleton: checks 
dddocky: checks 
Klemtonius: bets 1890
HighCardJasper: folds 
Manon947: folds 
color_singleton: folds 
dddocky: folds 
Uncalled bet (1890) returned to Klemtonius
Klemtonius collected 1890 from pot
Klemtonius: doesn't show hand 
*** SUMMARY ***
Total pot 2000 | Rake 110 
Board [5d 2s 5h 9s]
Seat 1: color_singleton (big blind) folded on the Turn
Seat 2: dddocky folded on the Turn
Seat 6: Klemtonius collected (1890)
Seat 8: HighCardJasper (button) folded on the Turn
Seat 9: Manon947 (small blind) folded on the Turn



PokerStars Home Game Hand #216485948292: {Club #3225207}  Hold'em No Limit (50/100) - 2020/07/16 14:52:40 ET
Table 'Fun times' 9-max (Play Money) Seat #9 is the button
Seat 1: color_singleton (9900 in chips) 
Seat 2: dddocky (19786 in chips) 
Seat 6: Klemtonius (9679 in chips) 
Seat 8: HighCardJasper (9139 in chips) 
Seat 9: Manon947 (9739 in chips) 
color_singleton: posts small blind 50
dddocky: posts big blind 100
*** HOLE CARDS ***
Dealt to Manon947 [Kd 4c]
Klemtonius: calls 100
HighCardJasper: calls 100
Manon947: calls 100
color_singleton: calls 50
dddocky: checks 
*** FLOP *** [Kc Kh 8s]
color_singleton: checks 
dddocky: checks 
Klemtonius: checks 
HighCardJasper: checks 
Manon947: bets 236
color_singleton: folds 
dddocky: folds 
Klemtonius: folds 
HighCardJasper: folds 
Uncalled bet (236) returned to Manon947
Manon947 collected 472 from pot
*** SUMMARY ***
Total pot 500 | Rake 28 
Board [Kc Kh 8s]
Seat 1: color_singleton (small blind) folded on the Flop
Seat 2: dddocky (big blind) folded on the Flop
Seat 6: Klemtonius folded on the Flop
Seat 8: HighCardJasper folded on the Flop
Seat 9: Manon947 (button) collected (472)



PokerStars Home Game Hand #216485972776: {Club #3225207}  Hold'em No Limit (50/100) - 2020/07/16 14:53:21 ET
Table 'Fun times' 9-max (Play Money) Seat #1 is the button
Seat 1: color_singleton (9800 in chips) 
Seat 2: dddocky (19686 in chips) 
Seat 6: Klemtonius (9579 in chips) 
Seat 8: HighCardJasper (9039 in chips) 
Seat 9: Manon947 (10111 in chips) 
dddocky: posts small blind 50
Klemtonius: posts big blind 100
*** HOLE CARDS ***
Dealt to Manon947 [Qh 7h]
HighCardJasper: calls 100
Manon947: calls 100
color_singleton: calls 100
dddocky: calls 50
Klemtonius: raises 100 to 200
HighCardJasper: calls 100
Manon947: calls 100
color_singleton: calls 100
dddocky: calls 100
*** FLOP *** [Kd Ks 8d]
dddocky: bets 100
Klemtonius: calls 100
HighCardJasper: folds 
Manon947: folds 
color_singleton: folds 
*** TURN *** [Kd Ks 8d] [Js]
dddocky: checks 
Klemtonius: bets 567
dddocky: folds 
Uncalled bet (567) returned to Klemtonius
Klemtonius collected 1134 from pot
Klemtonius: doesn't show hand 
*** SUMMARY ***
Total pot 1200 | Rake 66 
Board [Kd Ks 8d Js]
Seat 1: color_singleton (button) folded on the Flop
Seat 2: dddocky (small blind) folded on the Turn
Seat 6: Klemtonius (big blind) collected (1134)
Seat 8: HighCardJasper folded on the Flop
Seat 9: Manon947 folded on the Flop



PokerStars Home Game Hand #216486011819: {Club #3225207}  Hold'em No Limit (50/100) - 2020/07/16 14:54:26 ET
Table 'Fun times' 9-max (Play Money) Seat #2 is the button
Seat 1: color_singleton (9600 in chips) 
Seat 2: dddocky (19386 in chips) 
Seat 6: Klemtonius (10413 in chips) 
Seat 8: HighCardJasper (8839 in chips) 
Seat 9: Manon947 (9911 in chips) 
Klemtonius: posts small blind 50
HighCardJasper: posts big blind 100
*** HOLE CARDS ***
Dealt to Manon947 [Th Kh]
Manon947: calls 100
color_singleton: folds 
dddocky: folds 
Klemtonius: raises 100 to 200
HighCardJasper: calls 100
Manon947: calls 100
*** FLOP *** [Kd Qc 4s]
Klemtonius: bets 100
HighCardJasper: calls 100
Manon947: raises 100 to 200
Klemtonius: calls 100
HighCardJasper: calls 100
*** TURN *** [Kd Qc 4s] [Qh]
Klemtonius: checks 
HighCardJasper: checks 
Manon947: bets 567
Klemtonius: folds 
HighCardJasper: folds 
Uncalled bet (567) returned to Manon947
Manon947 collected 1134 from pot
*** SUMMARY ***
Total pot 1200 | Rake 66 
Board [Kd Qc 4s Qh]
Seat 1: color_singleton folded before Flop (didn't bet)
Seat 2: dddocky (button) folded before Flop (didn't bet)
Seat 6: Klemtonius (small blind) folded on the Turn
Seat 8: HighCardJasper (big blind) folded on the Turn
Seat 9: Manon947 collected (1134)



PokerStars Home Game Hand #216486039243: {Club #3225207}  Hold'em No Limit (50/100) - 2020/07/16 14:55:14 ET
Table 'Fun times' 9-max (Play Money) Seat #6 is the button
Seat 1: color_singleton (9600 in chips) 
Seat 2: dddocky (19386 in chips) 
Seat 6: Klemtonius (10013 in chips) 
Seat 8: HighCardJasper (8439 in chips) 
Seat 9: Manon947 (10645 in chips) 
HighCardJasper: posts small blind 50
Manon947: posts big blind 100
*** HOLE CARDS ***
Dealt to Manon947 [Qs 2c]
color_singleton: folds 
dddocky: calls 100
Klemtonius: calls 100
HighCardJasper: calls 50
Manon947: checks 
*** FLOP *** [3c 2s 6c]
HighCardJasper: bets 200
Manon947: calls 200
dddocky: calls 200
Klemtonius: raises 200 to 400
HighCardJasper: calls 200
Manon947: folds 
dddocky: calls 200
*** TURN *** [3c 2s 6c] [Td]
HighCardJasper: checks 
dddocky: checks 
Klemtonius: bets 850
HighCardJasper: folds 
dddocky: folds 
Uncalled bet (850) returned to Klemtonius
Klemtonius collected 1701 from pot
Klemtonius: doesn't show hand 
*** SUMMARY ***
Total pot 1800 | Rake 99 
Board [3c 2s 6c Td]
Seat 1: color_singleton folded before Flop (didn't bet)
Seat 2: dddocky folded on the Turn
Seat 6: Klemtonius (button) collected (1701)
Seat 8: HighCardJasper (small blind) folded on the Turn
Seat 9: Manon947 (big blind) folded on the Flop



PokerStars Home Game Hand #216486072390: {Club #3225207}  Hold'em No Limit (50/100) - 2020/07/16 14:56:12 ET
Table 'Fun times' 9-max (Play Money) Seat #8 is the button
Seat 1: color_singleton (9600 in chips) 
Seat 2: dddocky (18886 in chips) 
Seat 6: Klemtonius (11214 in chips) 
Seat 8: HighCardJasper (7939 in chips) 
Seat 9: Manon947 (10345 in chips) 
Manon947: posts small blind 50
color_singleton: posts big blind 100
*** HOLE CARDS ***
Dealt to Manon947 [7h 4s]
dddocky: calls 100
Klemtonius: raises 100 to 200
HighCardJasper: folds 
Manon947: folds 
color_singleton: calls 100
dddocky: calls 100
*** FLOP *** [9c 7s Ac]
color_singleton: checks 
dddocky: checks 
Klemtonius: bets 100
color_singleton: calls 100
dddocky: calls 100
*** TURN *** [9c 7s Ac] [9d]
color_singleton: checks 
dddocky: checks 
Klemtonius: bets 898
color_singleton: calls 898
dddocky: folds 
*** RIVER *** [9c 7s Ac 9d] [Js]
color_singleton: checks 
Klemtonius: bets 2595
color_singleton: folds 
Uncalled bet (2595) returned to Klemtonius
Klemtonius collected 2595 from pot
Klemtonius: doesn't show hand 
*** SUMMARY ***
Total pot 2746 | Rake 151 
Board [9c 7s Ac 9d Js]
Seat 1: color_singleton (big blind) folded on the River
Seat 2: dddocky folded on the Turn
Seat 6: Klemtonius collected (2595)
Seat 8: HighCardJasper (button) folded before Flop (didn't bet)
Seat 9: Manon947 (small blind) folded before Flop



PokerStars Home Game Hand #216486096557: {Club #3225207}  Hold'em No Limit (50/100) - 2020/07/16 14:57:08 ET
Table 'Fun times' 9-max (Play Money) Seat #9 is the button
Seat 1: color_singleton (8402 in chips) 
Seat 2: dddocky (18586 in chips) 
Seat 6: Klemtonius (12611 in chips) 
Seat 8: HighCardJasper (7939 in chips) 
Seat 9: Manon947 (10295 in chips) 
color_singleton: posts small blind 50
dddocky: posts big blind 100
*** HOLE CARDS ***
Dealt to Manon947 [6c Ks]
Klemtonius: calls 100
HighCardJasper: calls 100
Manon947: calls 100
Duke Croix joins the table at seat #3 
color_singleton: calls 50
dddocky: checks 
*** FLOP *** [2c Qs Ac]
color_singleton: checks 
dddocky: checks 
Klemtonius: bets 100
HighCardJasper: calls 100
Manon947: calls 100
color_singleton: folds 
dddocky: folds 
*** TURN *** [2c Qs Ac] [Jd]
Klemtonius: checks 
HighCardJasper: checks 
Manon947: checks 
*** RIVER *** [2c Qs Ac Jd] [5d]
Klemtonius: bets 378
HighCardJasper: folds 
Manon947: folds 
Uncalled bet (378) returned to Klemtonius
Klemtonius collected 756 from pot
Klemtonius: doesn't show hand 
*** SUMMARY ***
Total pot 800 | Rake 44 
Board [2c Qs Ac Jd 5d]
Seat 1: color_singleton (small blind) folded on the Flop
Seat 2: dddocky (big blind) folded on the Flop
Seat 6: Klemtonius collected (756)
Seat 8: HighCardJasper folded on the River
Seat 9: Manon947 (button) folded on the River



PokerStars Home Game Hand #216486126834: {Club #3225207}  Hold'em No Limit (50/100) - 2020/07/16 14:58:18 ET
Table 'Fun times' 9-max (Play Money) Seat #1 is the button
Seat 1: color_singleton (8302 in chips) 
Seat 2: dddocky (18486 in chips) 
Seat 3: Duke Croix (10000 in chips) 
Seat 6: Klemtonius (13167 in chips) 
Seat 8: HighCardJasper (7739 in chips) 
Seat 9: Manon947 (10095 in chips) 
dddocky: posts small blind 50
Duke Croix: posts big blind 100
*** HOLE CARDS ***
Dealt to Manon947 [3h 7d]
Klemtonius: folds 
HighCardJasper: calls 100
Manon947: folds 
color_singleton: folds 
dddocky: calls 50
Duke Croix: checks 
*** FLOP *** [5d 7c 7s]
dddocky: checks 
Duke Croix: checks 
HighCardJasper: checks 
*** TURN *** [5d 7c 7s] [As]
dddocky: checks 
Duke Croix: checks 
HighCardJasper: checks 
*** RIVER *** [5d 7c 7s As] [9h]
dddocky: checks 
Duke Croix: checks 
HighCardJasper: checks 
*** SHOW DOWN ***
dddocky: shows [Jh 6d] (a pair of Sevens)
Duke Croix: shows [9c Th] (two pair, Nines and Sevens)
HighCardJasper: mucks hand 
Duke Croix collected 283 from pot
*** SUMMARY ***
Total pot 300 | Rake 17 
Board [5d 7c 7s As 9h]
Seat 1: color_singleton (button) folded before Flop (didn't bet)
Seat 2: dddocky (small blind) showed [Jh 6d] and lost with a pair of Sevens
Seat 3: Duke Croix (big blind) showed [9c Th] and won (283) with two pair, Nines and Sevens
Seat 6: Klemtonius folded before Flop (didn't bet)
Seat 8: HighCardJasper mucked [Qs Td]
Seat 9: Manon947 folded before Flop (didn't bet)



PokerStars Home Game Hand #216486151017: {Club #3225207}  Hold'em No Limit (50/100) - 2020/07/16 14:59:14 ET
Table 'Fun times' 9-max (Play Money) Seat #2 is the button
Seat 1: color_singleton (8302 in chips) 
Seat 2: dddocky (18386 in chips) 
Seat 3: Duke Croix (10183 in chips) 
Seat 6: Klemtonius (13167 in chips) 
Seat 8: HighCardJasper (7639 in chips) 
Seat 9: Manon947 (10095 in chips) 
Duke Croix: posts small blind 50
Klemtonius: posts big blind 100
*** HOLE CARDS ***
Dealt to Manon947 [Qd Ad]
HighCardJasper: calls 100
Manon947: raises 100 to 200
color_singleton: folds 
dddocky: calls 200
Duke Croix: folds 
Klemtonius: calls 100
HighCardJasper: calls 100
*** FLOP *** [Kd Jh 3c]
Klemtonius: checks 
HighCardJasper: checks 
Manon947: bets 401
dddocky: folds 
Klemtonius: folds 
HighCardJasper: folds 
Uncalled bet (401) returned to Manon947
Manon947 collected 803 from pot
*** SUMMARY ***
Total pot 850 | Rake 47 
Board [Kd Jh 3c]
Seat 1: color_singleton folded before Flop (didn't bet)
Seat 2: dddocky (button) folded on the Flop
Seat 3: Duke Croix (small blind) folded before Flop
Seat 6: Klemtonius (big blind) folded on the Flop
Seat 8: HighCardJasper folded on the Flop
Seat 9: Manon947 collected (803)



PokerStars Home Game Hand #216486165076: {Club #3225207}  Hold'em No Limit (50/100) - 2020/07/16 14:59:46 ET
Table 'Fun times' 9-max (Play Money) Seat #3 is the button
Seat 1: color_singleton (8302 in chips) 
Seat 2: dddocky (18186 in chips) 
Seat 3: Duke Croix (10133 in chips) 
Seat 6: Klemtonius (12967 in chips) 
Seat 8: HighCardJasper (7439 in chips) 
Seat 9: Manon947 (10698 in chips) 
Klemtonius: posts small blind 50
HighCardJasper: posts big blind 100
*** HOLE CARDS ***
Dealt to Manon947 [8s 3h]
Manon947: folds 
color_singleton: calls 100
dddocky: folds 
Duke Croix: folds 
Klemtonius: calls 50
HighCardJasper: checks 
*** FLOP *** [Ks Kc 9c]
Klemtonius: checks 
HighCardJasper: checks 
color_singleton: checks 
*** TURN *** [Ks Kc 9c] [5c]
Klemtonius: bets 283
HighCardJasper: folds 
color_singleton: calls 283
*** RIVER *** [Ks Kc 9c 5c] [8h]
Klemtonius: bets 409
color_singleton: calls 409
*** SHOW DOWN ***
Klemtonius: shows [5h 3c] (two pair, Kings and Fives)
color_singleton: shows [Kh 2s] (three of a kind, Kings)
color_singleton collected 1591 from pot
*** SUMMARY ***
Total pot 1684 | Rake 93 
Board [Ks Kc 9c 5c 8h]
Seat 1: color_singleton showed [Kh 2s] and won (1591) with three of a kind, Kings
Seat 2: dddocky folded before Flop (didn't bet)
Seat 3: Duke Croix (button) folded before Flop (didn't bet)
Seat 6: Klemtonius (small blind) showed [5h 3c] and lost with two pair, Kings and Fives
Seat 8: HighCardJasper (big blind) folded on the Turn
Seat 9: Manon947 folded before Flop (didn't bet)



PokerStars Home Game Hand #216486189365: {Club #3225207}  Hold'em No Limit (50/100) - 2020/07/16 15:00:38 ET
Table 'Fun times' 9-max (Play Money) Seat #6 is the button
Seat 1: color_singleton (9101 in chips) 
Seat 2: dddocky (18186 in chips) 
Seat 3: Duke Croix (10133 in chips) 
Seat 6: Klemtonius (12175 in chips) 
Seat 8: HighCardJasper (7339 in chips) 
Seat 9: Manon947 (10698 in chips) 
HighCardJasper: posts small blind 50
Manon947: posts big blind 100
*** HOLE CARDS ***
Dealt to Manon947 [5s 9h]
color_singleton: raises 100 to 200
dddocky: calls 200
Duke Croix: calls 200
Klemtonius: calls 200
HighCardJasper: folds 
Manon947: folds 
*** FLOP *** [4h Th As]
color_singleton: bets 449
dddocky: folds 
Duke Croix: calls 449
Klemtonius: folds 
*** TURN *** [4h Th As] [Ad]
color_singleton: bets 873
Duke Croix: raises 1227 to 2100
color_singleton: calls 1227
*** RIVER *** [4h Th As Ad] [Jc]
color_singleton: checks 
Duke Croix: checks 
*** SHOW DOWN ***
color_singleton: shows [8c Ac] (three of a kind, Aces)
Duke Croix: shows [Ah 2s] (three of a kind, Aces)
color_singleton collected 2858 from pot
Duke Croix collected 2857 from pot
*** SUMMARY ***
Total pot 6048 | Rake 333 
Board [4h Th As Ad Jc]
Seat 1: color_singleton showed [8c Ac] and won (2858) with three of a kind, Aces
Seat 2: dddocky folded on the Flop
Seat 3: Duke Croix showed [Ah 2s] and won (2857) with three of a kind, Aces
Seat 6: Klemtonius (button) folded on the Flop
Seat 8: HighCardJasper (small blind) folded before Flop
Seat 9: Manon947 (big blind) folded before Flop



PokerStars Home Game Hand #216486223670: {Club #3225207}  Hold'em No Limit (50/100) - 2020/07/16 15:01:44 ET
Table 'Fun times' 9-max (Play Money) Seat #8 is the button
Seat 1: color_singleton (9210 in chips) 
Seat 2: dddocky (17986 in chips) 
Seat 3: Duke Croix (10241 in chips) 
Seat 6: Klemtonius (11975 in chips) 
Seat 8: HighCardJasper (7289 in chips) 
Seat 9: Manon947 (10598 in chips) 
Manon947: posts small blind 50
color_singleton: posts big blind 100
*** HOLE CARDS ***
Dealt to Manon947 [Td 9s]
dddocky: calls 100
Duke Croix: calls 100
Klemtonius: calls 100
HighCardJasper: calls 100
Manon947: calls 50
color_singleton: checks 
*** FLOP *** [5c 4d Kd]
Manon947: checks 
color_singleton: checks 
dddocky: bets 100
Duke Croix: calls 100
Klemtonius: folds 
HighCardJasper: folds 
Manon947: folds 
color_singleton: folds 
*** TURN *** [5c 4d Kd] [Js]
dddocky: bets 100
Duke Croix: calls 100
*** RIVER *** [5c 4d Kd Js] [8d]
dddocky: bets 100
Duke Croix: calls 100
*** SHOW DOWN ***
dddocky: shows [9d Ks] (a pair of Kings)
Duke Croix: mucks hand 
dddocky collected 1134 from pot
*** SUMMARY ***
Total pot 1200 | Rake 66 
Board [5c 4d Kd Js 8d]
Seat 1: color_singleton (big blind) folded on the Flop
Seat 2: dddocky showed [9d Ks] and won (1134) with a pair of Kings
Seat 3: Duke Croix mucked [As 3d]
Seat 6: Klemtonius folded on the Flop
Seat 8: HighCardJasper (button) folded on the Flop
Seat 9: Manon947 (small blind) folded on the Flop



PokerStars Home Game Hand #216486258043: {Club #3225207}  Hold'em No Limit (50/100) - 2020/07/16 15:02:46 ET
Table 'Fun times' 9-max (Play Money) Seat #9 is the button
Seat 1: color_singleton (9110 in chips) 
Seat 2: dddocky (18720 in chips) 
Seat 3: Duke Croix (9841 in chips) 
Seat 6: Klemtonius (11875 in chips) 
Seat 8: HighCardJasper (7189 in chips) 
Seat 9: Manon947 (10498 in chips) 
color_singleton: posts small blind 50
dddocky: posts big blind 100
*** HOLE CARDS ***
Dealt to Manon947 [5s Kd]
Duke Croix: raises 400 to 500
Klemtonius: folds 
HighCardJasper: calls 500
Manon947: folds 
color_singleton: folds 
dddocky: calls 400
*** FLOP *** [Tc 5h 3d]
dddocky: checks 
Klemtonius said, "Michel"
Duke Croix: checks 
HighCardJasper: checks 
*** TURN *** [Tc 5h 3d] [Qc]
dddocky: checks 
Klemtonius said, "Can you go live on twitch?"
Duke Croix: bets 900
Klemtonius said, "play them tunes for us"
HighCardJasper: folds 
dddocky: folds 
Uncalled bet (900) returned to Duke Croix
Duke Croix collected 1465 from pot
Duke Croix: doesn't show hand 
*** SUMMARY ***
Total pot 1550 | Rake 85 
Board [Tc 5h 3d Qc]
Seat 1: color_singleton (small blind) folded before Flop
Seat 2: dddocky (big blind) folded on the Turn
Seat 3: Duke Croix collected (1465)
Seat 6: Klemtonius folded before Flop (didn't bet)
Seat 8: HighCardJasper folded on the Turn
Seat 9: Manon947 (button) folded before Flop (didn't bet)



PokerStars Home Game Hand #216486287808: {Club #3225207}  Hold'em No Limit (50/100) - 2020/07/16 15:03:34 ET
Table 'Fun times' 9-max (Play Money) Seat #1 is the button
Seat 1: color_singleton (9060 in chips) 
Seat 2: dddocky (18220 in chips) 
Seat 3: Duke Croix (10806 in chips) 
Seat 6: Klemtonius (11875 in chips) 
Seat 8: HighCardJasper (6689 in chips) 
Seat 9: Manon947 (10498 in chips) 
dddocky: posts small blind 50
Duke Croix: posts big blind 100
*** HOLE CARDS ***
Dealt to Manon947 [Ac 8d]
Klemtonius: calls 100
HighCardJasper: calls 100
Manon947: calls 100
color_singleton: folds 
dddocky: folds 
Duke Croix: checks 
*** FLOP *** [6c 7c 4h]
Duke Croix said, "no im at home"
Duke Croix said, "only the laptop"
Duke Croix: checks 
Klemtonius: bets 212
HighCardJasper: calls 212
Manon947: calls 212
Klemtonius said, "ok"
Duke Croix said, "but manon is playing ??"
Duke Croix: folds 
*** TURN *** [6c 7c 4h] [Qc]
Klemtonius said, "nah wasnt working"
Klemtonius: bets 513
HighCardJasper: folds 
Manon947: calls 513
*** RIVER *** [6c 7c 4h Qc] [Qs]
Klemtonius: bets 1996
Manon947: folds 
Uncalled bet (1996) returned to Klemtonius
Klemtonius collected 1996 from pot
Klemtonius: doesn't show hand 
*** SUMMARY ***
Total pot 2112 | Rake 116 
Board [6c 7c 4h Qc Qs]
Seat 1: color_singleton (button) folded before Flop (didn't bet)
Seat 2: dddocky (small blind) folded before Flop
Seat 3: Duke Croix (big blind) folded on the Flop
Seat 6: Klemtonius collected (1996)
Seat 8: HighCardJasper folded on the Turn
Seat 9: Manon947 folded on the River



PokerStars Home Game Hand #216486339909: {Club #3225207}  Hold'em No Limit (50/100) - 2020/07/16 15:04:59 ET
Table 'Fun times' 9-max (Play Money) Seat #2 is the button
Seat 1: color_singleton (9060 in chips) 
Seat 2: dddocky (18170 in chips) 
Seat 3: Duke Croix (10706 in chips) 
Seat 6: Klemtonius (13046 in chips) 
Seat 8: HighCardJasper (6377 in chips) 
Seat 9: Manon947 (9673 in chips) 
Duke Croix: posts small blind 50
Klemtonius: posts big blind 100
*** HOLE CARDS ***
Dealt to Manon947 [8s Qc]
HighCardJasper: calls 100
Manon947: calls 100
color_singleton: folds 
dddocky: calls 100
Duke Croix: calls 50
Klemtonius: checks 
*** FLOP *** [9s 6s 4d]
Duke Croix: bets 400
Klemtonius: folds 
HighCardJasper: folds 
Manon947: folds 
dddocky: calls 400
*** TURN *** [9s 6s 4d] [Js]
Duke Croix: bets 500
dddocky: calls 500
*** RIVER *** [9s 6s 4d Js] [Qs]
Duke Croix: checks 
dddocky: checks 
*** SHOW DOWN ***
Duke Croix: shows [9h Ks] (a flush, King high)
dddocky: mucks hand 
Duke Croix collected 2173 from pot
*** SUMMARY ***
Total pot 2300 | Rake 127 
Board [9s 6s 4d Js Qs]
Seat 1: color_singleton folded before Flop (didn't bet)
Seat 2: dddocky (button) mucked [9d Jd]
Seat 3: Duke Croix (small blind) showed [9h Ks] and won (2173) with a flush, King high
Seat 6: Klemtonius (big blind) folded on the Flop
Seat 8: HighCardJasper folded on the Flop
Seat 9: Manon947 folded on the Flop



PokerStars Home Game Hand #216486374463: {Club #3225207}  Hold'em No Limit (50/100) - 2020/07/16 15:05:53 ET
Table 'Fun times' 9-max (Play Money) Seat #3 is the button
Seat 1: color_singleton (9060 in chips) 
Seat 2: dddocky (17170 in chips) 
Seat 3: Duke Croix (11879 in chips) 
Seat 6: Klemtonius (12946 in chips) 
Seat 8: HighCardJasper (6277 in chips) 
Seat 9: Manon947 (9573 in chips) 
Klemtonius: posts small blind 50
HighCardJasper: posts big blind 100
*** HOLE CARDS ***
Dealt to Manon947 [6c 8d]
Manon947: folds 
color_singleton: folds 
dddocky: calls 100
Duke Croix: folds 
Klemtonius: raises 100 to 200
HighCardJasper: calls 100
dddocky: calls 100
*** FLOP *** [8c 7s Jc]
Duke Croix said, "didnt even realize i had a flush"
Klemtonius: bets 567
HighCardJasper: calls 567
dddocky: folds 
*** TURN *** [8c 7s Jc] [Js]
Klemtonius: checks 
HighCardJasper: bets 500
Klemtonius: folds 
Uncalled bet (500) returned to HighCardJasper
HighCardJasper collected 1639 from pot
HighCardJasper: doesn't show hand 
*** SUMMARY ***
Total pot 1734 | Rake 95 
Board [8c 7s Jc Js]
Seat 1: color_singleton folded before Flop (didn't bet)
Seat 2: dddocky folded on the Flop
Seat 3: Duke Croix (button) folded before Flop (didn't bet)
Seat 6: Klemtonius (small blind) folded on the Turn
Seat 8: HighCardJasper (big blind) collected (1639)
Seat 9: Manon947 folded before Flop (didn't bet)



PokerStars Home Game Hand #216486400283: {Club #3225207}  Hold'em No Limit (50/100) - 2020/07/16 15:06:33 ET
Table 'Fun times' 9-max (Play Money) Seat #6 is the button
Seat 1: color_singleton (9060 in chips) 
Seat 2: dddocky (16970 in chips) 
Seat 3: Duke Croix (11879 in chips) 
Seat 6: Klemtonius (12179 in chips) 
Seat 8: HighCardJasper (7149 in chips) 
Seat 9: Manon947 (9573 in chips) 
HighCardJasper: posts small blind 50
Manon947: posts big blind 100
*** HOLE CARDS ***
Dealt to Manon947 [Js 3c]
color_singleton: raises 100 to 200
dddocky: folds 
Duke Croix: folds 
Klemtonius: calls 200
HighCardJasper: folds 
Manon947: folds 
*** FLOP *** [Ad Tc 9s]
color_singleton: checks 
Klemtonius: checks 
*** TURN *** [Ad Tc 9s] [Td]
color_singleton: bets 260
Klemtonius: folds 
Uncalled bet (260) returned to color_singleton
color_singleton collected 520 from pot
color_singleton: doesn't show hand 
*** SUMMARY ***
Total pot 550 | Rake 30 
Board [Ad Tc 9s Td]
Seat 1: color_singleton collected (520)
Seat 2: dddocky folded before Flop (didn't bet)
Seat 3: Duke Croix folded before Flop (didn't bet)
Seat 6: Klemtonius (button) folded on the Turn
Seat 8: HighCardJasper (small blind) folded before Flop
Seat 9: Manon947 (big blind) folded before Flop



PokerStars Home Game Hand #216486420664: {Club #3225207}  Hold'em No Limit (50/100) - 2020/07/16 15:07:05 ET
Table 'Fun times' 9-max (Play Money) Seat #8 is the button
Seat 1: color_singleton (9380 in chips) 
Seat 2: dddocky (16970 in chips) 
Seat 3: Duke Croix (11879 in chips) 
Seat 6: Klemtonius (11979 in chips) 
Seat 8: HighCardJasper (7099 in chips) 
Seat 9: Manon947 (9473 in chips) 
Manon947: posts small blind 50
color_singleton: posts big blind 100
*** HOLE CARDS ***
Dealt to Manon947 [9c 7s]
dddocky: calls 100
Duke Croix: raises 300 to 400
Klemtonius: calls 400
HighCardJasper: folds 
Manon947: folds 
color_singleton: folds 
dddocky: folds 
*** FLOP *** [Ks 5s 4h]
Duke Croix: bets 496
Klemtonius: raises 1984 to 2480
Duke Croix: folds 
Uncalled bet (1984) returned to Klemtonius
Klemtonius collected 1930 from pot
Klemtonius: doesn't show hand 
*** SUMMARY ***
Total pot 2042 | Rake 112 
Board [Ks 5s 4h]
Seat 1: color_singleton (big blind) folded before Flop
Seat 2: dddocky folded before Flop
Seat 3: Duke Croix folded on the Flop
Seat 6: Klemtonius collected (1930)
Seat 8: HighCardJasper (button) folded before Flop (didn't bet)
Seat 9: Manon947 (small blind) folded before Flop



PokerStars Home Game Hand #216486454523: {Club #3225207}  Hold'em No Limit (50/100) - 2020/07/16 15:07:58 ET
Table 'Fun times' 9-max (Play Money) Seat #9 is the button
Seat 1: color_singleton (9280 in chips) 
Seat 2: dddocky (16870 in chips) 
Seat 3: Duke Croix (10983 in chips) 
Seat 6: Klemtonius (13013 in chips) 
Seat 8: HighCardJasper (7099 in chips) 
Seat 9: Manon947 (9423 in chips) 
color_singleton: posts small blind 50
dddocky: posts big blind 100
*** HOLE CARDS ***
Dealt to Manon947 [3s Qc]
Duke Croix: calls 100
Klemtonius: calls 100
HighCardJasper: calls 100
Manon947: calls 100
color_singleton: calls 50
dddocky: checks 
*** FLOP *** [Qs Ah 4c]
color_singleton: checks 
dddocky: checks 
Duke Croix: checks 
Klemtonius: checks 
HighCardJasper: checks 
Manon947: checks 
*** TURN *** [Qs Ah 4c] [Td]
color_singleton: checks 
dddocky: checks 
Duke Croix has timed out
Duke Croix: checks 
Klemtonius: bets 283
HighCardJasper: folds 
Manon947: calls 283
color_singleton: calls 283
dddocky: folds 
Duke Croix: folds 
*** RIVER *** [Qs Ah 4c Td] [3d]
color_singleton: checks 
Klemtonius: bets 684
Manon947: calls 684
color_singleton: folds 
*** SHOW DOWN ***
Klemtonius: shows [Qh 6s] (a pair of Queens)
Manon947: shows [3s Qc] (two pair, Queens and Threes)
Manon947 collected 2662 from pot
*** SUMMARY ***
Total pot 2817 | Rake 155 
Board [Qs Ah 4c Td 3d]
Seat 1: color_singleton (small blind) folded on the River
Seat 2: dddocky (big blind) folded on the Turn
Seat 3: Duke Croix folded on the Turn
Seat 6: Klemtonius showed [Qh 6s] and lost with a pair of Queens
Seat 8: HighCardJasper folded on the Turn
Seat 9: Manon947 (button) showed [3s Qc] and won (2662) with two pair, Queens and Threes



PokerStars Home Game Hand #216486526766: {Club #3225207}  Hold'em No Limit (50/100) - 2020/07/16 15:09:50 ET
Table 'Fun times' 9-max (Play Money) Seat #1 is the button
Seat 1: color_singleton (8897 in chips) 
Seat 2: dddocky (16770 in chips) 
Seat 3: Duke Croix (10883 in chips) 
Seat 6: Klemtonius (11946 in chips) 
Seat 8: HighCardJasper (6999 in chips) 
Seat 9: Manon947 (11018 in chips) 
dddocky: posts small blind 50
Duke Croix: posts big blind 100
*** HOLE CARDS ***
Dealt to Manon947 [Jh Ah]
Klemtonius: raises 100 to 200
HighCardJasper: calls 200
Manon947: calls 200
color_singleton: folds 
dddocky: calls 150
Duke Croix: folds 
*** FLOP *** [Jc 4c Qh]
dddocky: checks 
Klemtonius: checks 
HighCardJasper: checks 
Manon947: bets 425
dddocky: folds 
Klemtonius: folds 
HighCardJasper: calls 425
*** TURN *** [Jc 4c Qh] [4h]
HighCardJasper: checks 
Manon947: bets 827
HighCardJasper: folds 
Uncalled bet (827) returned to Manon947
Manon947 collected 1654 from pot
*** SUMMARY ***
Total pot 1750 | Rake 96 
Board [Jc 4c Qh 4h]
Seat 1: color_singleton (button) folded before Flop (didn't bet)
Seat 2: dddocky (small blind) folded on the Flop
Seat 3: Duke Croix (big blind) folded before Flop
Seat 6: Klemtonius folded on the Flop
Seat 8: HighCardJasper folded on the Turn
Seat 9: Manon947 collected (1654)



PokerStars Home Game Hand #216486560073: {Club #3225207}  Hold'em No Limit (50/100) - 2020/07/16 15:10:42 ET
Table 'Fun times' 9-max (Play Money) Seat #2 is the button
Seat 1: color_singleton (8897 in chips) 
Seat 2: dddocky (16570 in chips) 
Seat 3: Duke Croix (10783 in chips) 
Seat 6: Klemtonius (11746 in chips) 
Seat 8: HighCardJasper (6374 in chips) 
Seat 9: Manon947 (12047 in chips) 
Duke Croix: posts small blind 50
Klemtonius: posts big blind 100
*** HOLE CARDS ***
Dealt to Manon947 [2c Qs]
HighCardJasper: raises 200 to 300
Manon947: folds 
color_singleton: folds 
dddocky: folds 
Duke Croix: folds 
Klemtonius: calls 200
*** FLOP *** [Qc 8c Jd]
Klemtonius: bets 614
HighCardJasper: calls 614
*** TURN *** [Qc 8c Jd] [4h]
Klemtonius: bets 1775
HighCardJasper: calls 1775
*** RIVER *** [Qc 8c Jd 4h] [Jh]
Klemtonius: checks 
HighCardJasper: bets 2000
Klemtonius: folds 
Uncalled bet (2000) returned to HighCardJasper
HighCardJasper collected 5129 from pot
HighCardJasper: doesn't show hand 
*** SUMMARY ***
Total pot 5428 | Rake 299 
Board [Qc 8c Jd 4h Jh]
Seat 1: color_singleton folded before Flop (didn't bet)
Seat 2: dddocky (button) folded before Flop (didn't bet)
Seat 3: Duke Croix (small blind) folded before Flop
Seat 6: Klemtonius (big blind) folded on the River
Seat 8: HighCardJasper collected (5129)
Seat 9: Manon947 folded before Flop (didn't bet)



PokerStars Home Game Hand #216486604873: {Club #3225207}  Hold'em No Limit (50/100) - 2020/07/16 15:11:52 ET
Table 'Fun times' 9-max (Play Money) Seat #3 is the button
Seat 1: color_singleton (8897 in chips) 
Seat 2: dddocky (16570 in chips) 
Seat 3: Duke Croix (10733 in chips) 
Seat 6: Klemtonius (9057 in chips) 
Seat 8: HighCardJasper (8814 in chips) 
Seat 9: Manon947 (12047 in chips) 
Klemtonius: posts small blind 50
HighCardJasper: posts big blind 100
*** HOLE CARDS ***
Dealt to Manon947 [Kd Jh]
Manon947: calls 100
color_singleton: folds 
dddocky: folds 
Duke Croix: folds 
Klemtonius: calls 50
HighCardJasper: raises 100 to 200
Manon947: calls 100
Klemtonius: calls 100
*** FLOP *** [Ah Ts 5s]
Klemtonius: bets 567
HighCardJasper: calls 567
Manon947: calls 567
*** TURN *** [Ah Ts 5s] [8c]
Klemtonius: checks 
HighCardJasper: bets 400
Manon947: calls 400
Klemtonius: calls 400
*** RIVER *** [Ah Ts 5s 8c] [6h]
Klemtonius: checks 
HighCardJasper: bets 1000
Manon947: folds 
Klemtonius: folds 
Uncalled bet (1000) returned to HighCardJasper
HighCardJasper collected 3308 from pot
HighCardJasper: doesn't show hand 
*** SUMMARY ***
Total pot 3501 | Rake 193 
Board [Ah Ts 5s 8c 6h]
Seat 1: color_singleton folded before Flop (didn't bet)
Seat 2: dddocky folded before Flop (didn't bet)
Seat 3: Duke Croix (button) folded before Flop (didn't bet)
Seat 6: Klemtonius (small blind) folded on the River
Seat 8: HighCardJasper (big blind) collected (3308)
Seat 9: Manon947 folded on the River



PokerStars Home Game Hand #216486660425: {Club #3225207}  Hold'em No Limit (50/100) - 2020/07/16 15:13:19 ET
Table 'Fun times' 9-max (Play Money) Seat #6 is the button
Seat 1: color_singleton (8897 in chips) 
Seat 2: dddocky (16570 in chips) 
Seat 3: Duke Croix (10733 in chips) 
Seat 6: Klemtonius (7890 in chips) 
Seat 8: HighCardJasper (10955 in chips) 
Seat 9: Manon947 (10880 in chips) 
HighCardJasper: posts small blind 50
Manon947: posts big blind 100
*** HOLE CARDS ***
Dealt to Manon947 [8h 7d]
color_singleton: folds 
dddocky: folds 
Duke Croix: raises 300 to 400
Klemtonius: folds 
HighCardJasper: calls 350
Manon947: folds 
*** FLOP *** [4s 2c 2s]
HighCardJasper: checks 
Duke Croix: bets 500
HighCardJasper: folds 
Uncalled bet (500) returned to Duke Croix
Duke Croix collected 850 from pot
Duke Croix: doesn't show hand 
*** SUMMARY ***
Total pot 900 | Rake 50 
Board [4s 2c 2s]
Seat 1: color_singleton folded before Flop (didn't bet)
Seat 2: dddocky folded before Flop (didn't bet)
Seat 3: Duke Croix collected (850)
Seat 6: Klemtonius (button) folded before Flop (didn't bet)
Seat 8: HighCardJasper (small blind) folded on the Flop
Seat 9: Manon947 (big blind) folded before Flop



PokerStars Home Game Hand #216486685070: {Club #3225207}  Hold'em No Limit (50/100) - 2020/07/16 15:13:58 ET
Table 'Fun times' 9-max (Play Money) Seat #8 is the button
Seat 1: color_singleton (8897 in chips) 
Seat 2: dddocky (16570 in chips) 
Seat 3: Duke Croix (11183 in chips) 
Seat 6: Klemtonius (7890 in chips) 
Seat 8: HighCardJasper (10555 in chips) 
Seat 9: Manon947 (10780 in chips) 
Manon947: posts small blind 50
color_singleton: posts big blind 100
*** HOLE CARDS ***
Dealt to Manon947 [Qs 7d]
dddocky: folds 
Duke Croix: raises 300 to 400
Klemtonius: calls 400
HighCardJasper: calls 400
Manon947: folds 
color_singleton: raises 600 to 1000
Duke Croix: calls 600
Klemtonius: folds 
HighCardJasper: folds 
*** FLOP *** [5h As 9d]
color_singleton: bets 1346
Duke Croix: folds 
Uncalled bet (1346) returned to color_singleton
color_singleton collected 2693 from pot
color_singleton: doesn't show hand 
*** SUMMARY ***
Total pot 2850 | Rake 157 
Board [5h As 9d]
Seat 1: color_singleton (big blind) collected (2693)
Seat 2: dddocky folded before Flop (didn't bet)
Seat 3: Duke Croix folded on the Flop
Seat 6: Klemtonius folded before Flop
Seat 8: HighCardJasper (button) folded before Flop
Seat 9: Manon947 (small blind) folded before Flop



PokerStars Home Game Hand #216486732224: {Club #3225207}  Hold'em No Limit (50/100) - 2020/07/16 15:14:58 ET
Table 'Fun times' 9-max (Play Money) Seat #9 is the button
Seat 1: color_singleton (10590 in chips) 
Seat 2: dddocky (16570 in chips) 
Seat 3: Duke Croix (10183 in chips) 
Seat 6: Klemtonius (7490 in chips) 
Seat 8: HighCardJasper (10155 in chips) 
Seat 9: Manon947 (10730 in chips) 
color_singleton: posts small blind 50
dddocky: posts big blind 100
*** HOLE CARDS ***
Dealt to Manon947 [Qs Qc]
Duke Croix: folds 
Klemtonius: folds 
HighCardJasper: raises 100 to 200
Manon947: calls 200
color_singleton: folds 
dddocky: calls 100
*** FLOP *** [6c 7d 5d]
dddocky: checks 
HighCardJasper: bets 200
Manon947: calls 200
dddocky: folds 
*** TURN *** [6c 7d 5d] [Kc]
HighCardJasper: checks 
Manon947: bets 496
HighCardJasper: calls 496
*** RIVER *** [6c 7d 5d Kc] [7h]
HighCardJasper: checks 
Manon947: bets 965
HighCardJasper: folds 
Uncalled bet (965) returned to Manon947
Manon947 collected 1930 from pot
*** SUMMARY ***
Total pot 2042 | Rake 112 
Board [6c 7d 5d Kc 7h]
Seat 1: color_singleton (small blind) folded before Flop
Seat 2: dddocky (big blind) folded on the Flop
Seat 3: Duke Croix folded before Flop (didn't bet)
Seat 6: Klemtonius folded before Flop (didn't bet)
Seat 8: HighCardJasper folded on the River
Seat 9: Manon947 (button) collected (1930)



PokerStars Home Game Hand #216486768568: {Club #3225207}  Hold'em No Limit (50/100) - 2020/07/16 15:15:55 ET
Table 'Fun times' 9-max (Play Money) Seat #1 is the button
Seat 1: color_singleton (10540 in chips) 
Seat 2: dddocky (16370 in chips) 
Seat 3: Duke Croix (10183 in chips) 
Seat 6: Klemtonius (7490 in chips) 
Seat 8: HighCardJasper (9259 in chips) 
Seat 9: Manon947 (11764 in chips) 
dddocky: posts small blind 50
Duke Croix: posts big blind 100
*** HOLE CARDS ***
Dealt to Manon947 [Ts 7c]
Klemtonius: raises 300 to 400
HighCardJasper: folds 
Manon947: folds 
color_singleton: folds 
dddocky: calls 350
Duke Croix: folds 
*** FLOP *** [Jc 5s 3h]
dddocky: checks 
Klemtonius: checks 
*** TURN *** [Jc 5s 3h] [6d]
dddocky: checks 
Klemtonius: checks 
*** RIVER *** [Jc 5s 3h 6d] [8c]
dddocky: checks 
Klemtonius: checks 
*** SHOW DOWN ***
dddocky: shows [9h Qd] (high card Queen)
Klemtonius: shows [Qs Kd] (high card King)
Klemtonius collected 850 from pot
*** SUMMARY ***
Total pot 900 | Rake 50 
Board [Jc 5s 3h 6d 8c]
Seat 1: color_singleton (button) folded before Flop (didn't bet)
Seat 2: dddocky (small blind) showed [9h Qd] and lost with high card Queen
Seat 3: Duke Croix (big blind) folded before Flop
Seat 6: Klemtonius showed [Qs Kd] and won (850) with high card King
Seat 8: HighCardJasper folded before Flop (didn't bet)
Seat 9: Manon947 folded before Flop (didn't bet)



PokerStars Home Game Hand #216486839434: {Club #3225207}  Hold'em No Limit (50/100) - 2020/07/16 15:17:46 ET
Table 'Fun times' 9-max (Play Money) Seat #6 is the button
Seat 1: color_singleton (10040 in chips) 
Seat 2: dddocky (17680 in chips) 
Seat 3: Duke Croix (10033 in chips) 
Seat 6: Klemtonius (7240 in chips) 
Seat 8: HighCardJasper (8659 in chips) 
Seat 9: Manon947 (11764 in chips) 
HighCardJasper: posts small blind 50
Manon947: posts big blind 100
*** HOLE CARDS ***
Dealt to Manon947 [6h 9c]
color_singleton: folds 
dddocky: folds 
Duke Croix: raises 300 to 400
Klemtonius: raises 300 to 700
HighCardJasper: folds 
Manon947: folds 
Duke Croix: calls 300
*** FLOP *** [3h Ts 6d]
Duke Croix: checks 
Klemtonius: bets 900
Duke Croix: folds 
Uncalled bet (900) returned to Klemtonius
Klemtonius collected 1465 from pot
Klemtonius: doesn't show hand 
*** SUMMARY ***
Total pot 1550 | Rake 85 
Board [3h Ts 6d]
Seat 1: color_singleton folded before Flop (didn't bet)
Seat 2: dddocky folded before Flop (didn't bet)
Seat 3: Duke Croix folded on the Flop
Seat 6: Klemtonius (button) collected (1465)
Seat 8: HighCardJasper (small blind) folded before Flop
Seat 9: Manon947 (big blind) folded before Flop



PokerStars Home Game Hand #216486858973: {Club #3225207}  Hold'em No Limit (50/100) - 2020/07/16 15:18:17 ET
Table 'Fun times' 9-max (Play Money) Seat #8 is the button
Seat 1: color_singleton (10040 in chips) 
Seat 2: dddocky (17680 in chips) 
Seat 3: Duke Croix (9333 in chips) 
Seat 6: Klemtonius (8005 in chips) 
Seat 8: HighCardJasper (8609 in chips) 
Seat 9: Manon947 (11664 in chips) 
Manon947: posts small blind 50
color_singleton: posts big blind 100
*** HOLE CARDS ***
Dealt to Manon947 [9d Ac]
dddocky: folds 
Duke Croix: folds 
Klemtonius: folds 
HighCardJasper: calls 100
Manon947: calls 50
color_singleton: checks 
*** FLOP *** [8c 3c Jd]
Manon947: checks 
color_singleton: checks 
HighCardJasper: checks 
*** TURN *** [8c 3c Jd] [7h]
Manon947: bets 141
color_singleton: raises 141 to 282
HighCardJasper: folds 
Manon947: calls 141
*** RIVER *** [8c 3c Jd 7h] [Js]
Manon947: checks 
color_singleton: bets 816
Manon947: folds 
Uncalled bet (816) returned to color_singleton
color_singleton collected 816 from pot
color_singleton: doesn't show hand 
*** SUMMARY ***
Total pot 864 | Rake 48 
Board [8c 3c Jd 7h Js]
Seat 1: color_singleton (big blind) collected (816)
Seat 2: dddocky folded before Flop (didn't bet)
Seat 3: Duke Croix folded before Flop (didn't bet)
Seat 6: Klemtonius folded before Flop (didn't bet)
Seat 8: HighCardJasper (button) folded on the Turn
Seat 9: Manon947 (small blind) folded on the River



PokerStars Home Game Hand #216486892274: {Club #3225207}  Hold'em No Limit (50/100) - 2020/07/16 15:19:09 ET
Table 'Fun times' 9-max (Play Money) Seat #9 is the button
Seat 1: color_singleton (10474 in chips) 
Seat 2: dddocky (17680 in chips) 
Seat 3: Duke Croix (9333 in chips) 
Seat 6: Klemtonius (8005 in chips) 
Seat 8: HighCardJasper (8509 in chips) 
Seat 9: Manon947 (11282 in chips) 
color_singleton: posts small blind 50
dddocky: posts big blind 100
*** HOLE CARDS ***
Dealt to Manon947 [8d 3h]
Duke Croix: folds 
Klemtonius: calls 100
HighCardJasper: calls 100
Manon947: calls 100
color_singleton: calls 50
dddocky: checks 
*** FLOP *** [9c 2h Ad]
color_singleton: checks 
dddocky: bets 100
Klemtonius: raises 100 to 200
HighCardJasper: folds 
Manon947: folds 
color_singleton: calls 200
dddocky: calls 100
*** TURN *** [9c 2h Ad] [6s]
color_singleton: checks 
dddocky: checks 
Klemtonius: bets 1039
color_singleton: folds 
dddocky: folds 
Uncalled bet (1039) returned to Klemtonius
Klemtonius collected 1039 from pot
Klemtonius: doesn't show hand 
*** SUMMARY ***
Total pot 1100 | Rake 61 
Board [9c 2h Ad 6s]
Seat 1: color_singleton (small blind) folded on the Turn
Seat 2: dddocky (big blind) folded on the Turn
Seat 3: Duke Croix folded before Flop (didn't bet)
Seat 6: Klemtonius collected (1039)
Seat 8: HighCardJasper folded on the Flop
Seat 9: Manon947 (button) folded on the Flop



PokerStars Home Game Hand #216486917567: {Club #3225207}  Hold'em No Limit (50/100) - 2020/07/16 15:19:49 ET
Table 'Fun times' 9-max (Play Money) Seat #1 is the button
Seat 1: color_singleton (10174 in chips) 
Seat 2: dddocky (17380 in chips) 
Seat 3: Duke Croix (9333 in chips) 
Seat 6: Klemtonius (8744 in chips) 
Seat 8: HighCardJasper (8409 in chips) 
Seat 9: Manon947 (11182 in chips) 
dddocky: posts small blind 50
Duke Croix: posts big blind 100
*** HOLE CARDS ***
Dealt to Manon947 [Kd 7c]
Klemtonius: calls 100
HighCardJasper: calls 100
Manon947: calls 100
color_singleton: calls 100
dddocky: folds 
Duke Croix: checks 
*** FLOP *** [2h 4h 6d]
Duke Croix: bets 500
Klemtonius: folds 
HighCardJasper: calls 500
Manon947: folds 
color_singleton: folds 
*** TURN *** [2h 4h 6d] [Qd]
Duke Croix: checks 
HighCardJasper: checks 
*** RIVER *** [2h 4h 6d Qd] [Ks]
Duke Croix: checks 
HighCardJasper: checks 
*** SHOW DOWN ***
Duke Croix: shows [2s 8s] (a pair of Deuces)
HighCardJasper: mucks hand 
Duke Croix collected 1465 from pot
*** SUMMARY ***
Total pot 1550 | Rake 85 
Board [2h 4h 6d Qd Ks]
Seat 1: color_singleton (button) folded on the Flop
Seat 2: dddocky (small blind) folded before Flop
Seat 3: Duke Croix (big blind) showed [2s 8s] and won (1465) with a pair of Deuces
Seat 6: Klemtonius folded on the Flop
Seat 8: HighCardJasper mucked [5s 7h]
Seat 9: Manon947 folded on the Flop



PokerStars Home Game Hand #216486943043: {Club #3225207}  Hold'em No Limit (50/100) - 2020/07/16 15:20:29 ET
Table 'Fun times' 9-max (Play Money) Seat #2 is the button
Seat 1: color_singleton (10074 in chips) 
Seat 2: dddocky (17330 in chips) 
Seat 3: Duke Croix (10198 in chips) 
Seat 6: Klemtonius (8644 in chips) 
Seat 8: HighCardJasper (7809 in chips) 
Seat 9: Manon947 (11082 in chips) 
Duke Croix: posts small blind 50
Klemtonius: posts big blind 100
*** HOLE CARDS ***
Dealt to Manon947 [3c 5c]
HighCardJasper: calls 100
Manon947: calls 100
color_singleton: raises 100 to 200
dddocky: folds 
Duke Croix: calls 150
Klemtonius: calls 100
HighCardJasper: calls 100
Manon947: calls 100
*** FLOP *** [Kh Qs 2c]
Duke Croix: checks 
Klemtonius: checks 
HighCardJasper: checks 
Manon947: checks 
color_singleton: bets 472
Duke Croix: calls 472
Klemtonius: folds 
HighCardJasper: folds 
Manon947: folds 
*** TURN *** [Kh Qs 2c] [As]
Duke Croix: checks 
color_singleton: bets 918
Duke Croix: raises 1282 to 2200
color_singleton: folds 
Uncalled bet (1282) returned to Duke Croix
Duke Croix collected 3572 from pot
Duke Croix: doesn't show hand 
*** SUMMARY ***
Total pot 3780 | Rake 208 
Board [Kh Qs 2c As]
Seat 1: color_singleton folded on the Turn
Seat 2: dddocky (button) folded before Flop (didn't bet)
Seat 3: Duke Croix (small blind) collected (3572)
Seat 6: Klemtonius (big blind) folded on the Flop
Seat 8: HighCardJasper folded on the Flop
Seat 9: Manon947 folded on the Flop



PokerStars Home Game Hand #216486989883: {Club #3225207}  Hold'em No Limit (50/100) - 2020/07/16 15:21:41 ET
Table 'Fun times' 9-max (Play Money) Seat #3 is the button
Seat 1: color_singleton (8484 in chips) 
Seat 2: dddocky (17330 in chips) 
Seat 3: Duke Croix (12180 in chips) 
Seat 6: Klemtonius (8444 in chips) 
Seat 8: HighCardJasper (7609 in chips) 
Seat 9: Manon947 (10882 in chips) 
Klemtonius: posts small blind 50
HighCardJasper: posts big blind 100
*** HOLE CARDS ***
Dealt to Manon947 [9s 6s]
Manon947: calls 100
color_singleton: calls 100
dddocky: calls 100
Duke Croix: raises 300 to 400
Klemtonius: folds 
HighCardJasper: folds 
Manon947: calls 300
color_singleton: calls 300
dddocky: calls 300
*** FLOP *** [2d 5h 4c]
Manon947: checks 
color_singleton: checks 
dddocky: bets 300
Duke Croix: calls 300
Manon947: folds 
color_singleton: calls 300
*** TURN *** [2d 5h 4c] [9h]
color_singleton: checks 
dddocky: checks 
Duke Croix: checks 
*** RIVER *** [2d 5h 4c 9h] [9c]
color_singleton: checks 
dddocky: checks 
Duke Croix: checks 
*** SHOW DOWN ***
color_singleton: shows [2s Ah] (two pair, Nines and Deuces)
dddocky: shows [Kd 5d] (two pair, Nines and Fives)
Duke Croix: mucks hand 
dddocky collected 2504 from pot
*** SUMMARY ***
Total pot 2650 | Rake 146 
Board [2d 5h 4c 9h 9c]
Seat 1: color_singleton showed [2s Ah] and lost with two pair, Nines and Deuces
Seat 2: dddocky showed [Kd 5d] and won (2504) with two pair, Nines and Fives
Seat 3: Duke Croix (button) mucked [As 8c]
Seat 6: Klemtonius (small blind) folded before Flop
Seat 8: HighCardJasper (big blind) folded before Flop
Seat 9: Manon947 folded on the Flop



PokerStars Home Game Hand #216487029719: {Club #3225207}  Hold'em No Limit (50/100) - 2020/07/16 15:22:43 ET
Table 'Fun times' 9-max (Play Money) Seat #6 is the button
Seat 1: color_singleton (7784 in chips) 
Seat 2: dddocky (19134 in chips) 
Seat 3: Duke Croix (11480 in chips) 
Seat 6: Klemtonius (8394 in chips) 
Seat 8: HighCardJasper (7509 in chips) 
Seat 9: Manon947 (10482 in chips) 
HighCardJasper: posts small blind 50
Manon947: posts big blind 100
*** HOLE CARDS ***
Dealt to Manon947 [Td 7d]
color_singleton: folds 
dddocky: folds 
Duke Croix: calls 100
Klemtonius: raises 100 to 200
HighCardJasper: calls 150
Manon947: calls 100
Duke Croix: calls 100
*** FLOP *** [4h Qh Ad]
HighCardJasper: checks 
Manon947: checks 
Duke Croix: checks 
Klemtonius: bets 756
HighCardJasper: folds 
Manon947: folds 
Duke Croix: folds 
Uncalled bet (756) returned to Klemtonius
Klemtonius collected 756 from pot
Klemtonius: doesn't show hand 
*** SUMMARY ***
Total pot 800 | Rake 44 
Board [4h Qh Ad]
Seat 1: color_singleton folded before Flop (didn't bet)
Seat 2: dddocky folded before Flop (didn't bet)
Seat 3: Duke Croix folded on the Flop
Seat 6: Klemtonius (button) collected (756)
Seat 8: HighCardJasper (small blind) folded on the Flop
Seat 9: Manon947 (big blind) folded on the Flop



PokerStars Home Game Hand #216487052605: {Club #3225207}  Hold'em No Limit (50/100) - 2020/07/16 15:23:19 ET
Table 'Fun times' 9-max (Play Money) Seat #8 is the button
Seat 1: color_singleton (7784 in chips) 
Seat 2: dddocky (19134 in chips) 
Seat 3: Duke Croix (11280 in chips) 
Seat 6: Klemtonius (8950 in chips) 
Seat 8: HighCardJasper (7309 in chips) 
Seat 9: Manon947 (10282 in chips) 
Manon947: posts small blind 50
color_singleton: posts big blind 100
*** HOLE CARDS ***
Dealt to Manon947 [9d 4d]
dddocky: folds 
Duke Croix: raises 300 to 400
Klemtonius: folds 
HighCardJasper: calls 400
Manon947: folds 
color_singleton: calls 300
*** FLOP *** [6s Tc Th]
color_singleton: checks 
Duke Croix: checks 
HighCardJasper: checks 
*** TURN *** [6s Tc Th] [Qs]
color_singleton: checks 
Duke Croix: checks 
HighCardJasper: checks 
*** RIVER *** [6s Tc Th Qs] [3h]
color_singleton: checks 
Duke Croix: checks 
HighCardJasper: bets 400
color_singleton: folds 
Duke Croix: folds 
Uncalled bet (400) returned to HighCardJasper
HighCardJasper collected 1181 from pot
HighCardJasper: doesn't show hand 
*** SUMMARY ***
Total pot 1250 | Rake 69 
Board [6s Tc Th Qs 3h]
Seat 1: color_singleton (big blind) folded on the River
Seat 2: dddocky folded before Flop (didn't bet)
Seat 3: Duke Croix folded on the River
Seat 6: Klemtonius folded before Flop (didn't bet)
Seat 8: HighCardJasper (button) collected (1181)
Seat 9: Manon947 (small blind) folded before Flop



PokerStars Home Game Hand #216487083062: {Club #3225207}  Hold'em No Limit (50/100) - 2020/07/16 15:24:07 ET
Table 'Fun times' 9-max (Play Money) Seat #9 is the button
Seat 1: color_singleton (7384 in chips) 
Seat 2: dddocky (19134 in chips) 
Seat 3: Duke Croix (10880 in chips) 
Seat 6: Klemtonius (8950 in chips) 
Seat 8: HighCardJasper (8090 in chips) 
Seat 9: Manon947 (10232 in chips) 
color_singleton: posts small blind 50
dddocky: posts big blind 100
*** HOLE CARDS ***
Dealt to Manon947 [Qh Qc]
Duke Croix: folds 
Klemtonius: raises 100 to 200
HighCardJasper: calls 200
Manon947: raises 100 to 300
color_singleton: folds 
dddocky: calls 200
Klemtonius: calls 100
HighCardJasper: calls 100
*** FLOP *** [As 6d 8h]
dddocky: checks 
Klemtonius: checks 
HighCardJasper: checks 
Manon947: bets 590
dddocky: folds 
Klemtonius: folds 
HighCardJasper: folds 
Uncalled bet (590) returned to Manon947
Manon947 collected 1181 from pot
*** SUMMARY ***
Total pot 1250 | Rake 69 
Board [As 6d 8h]
Seat 1: color_singleton (small blind) folded before Flop
Seat 2: dddocky (big blind) folded on the Flop
Seat 3: Duke Croix folded before Flop (didn't bet)
Seat 6: Klemtonius folded on the Flop
Seat 8: HighCardJasper folded on the Flop
Seat 9: Manon947 (button) collected (1181)



PokerStars Home Game Hand #216487102206: {Club #3225207}  Hold'em No Limit (50/100) - 2020/07/16 15:24:37 ET
Table 'Fun times' 9-max (Play Money) Seat #1 is the button
Seat 1: color_singleton (7334 in chips) 
Seat 2: dddocky (18834 in chips) 
Seat 3: Duke Croix (10880 in chips) 
Seat 6: Klemtonius (8650 in chips) 
Seat 8: HighCardJasper (7790 in chips) 
Seat 9: Manon947 (11113 in chips) 
dddocky: posts small blind 50
Duke Croix: posts big blind 100
*** HOLE CARDS ***
Dealt to Manon947 [3s Kh]
Klemtonius: raises 250 to 350
HighCardJasper: calls 350
Manon947: calls 350
color_singleton: folds 
dddocky: folds 
Duke Croix: calls 250
*** FLOP *** [5s 7s 2s]
Duke Croix: checks 
Klemtonius: checks 
HighCardJasper: checks 
Manon947: checks 
*** TURN *** [5s 7s 2s] [9d]
Duke Croix: checks 
Klemtonius: checks 
HighCardJasper: bets 400
Manon947: folds 
Duke Croix: folds 
Klemtonius: folds 
Uncalled bet (400) returned to HighCardJasper
HighCardJasper collected 1370 from pot
HighCardJasper: doesn't show hand 
*** SUMMARY ***
Total pot 1450 | Rake 80 
Board [5s 7s 2s 9d]
Seat 1: color_singleton (button) folded before Flop (didn't bet)
Seat 2: dddocky (small blind) folded before Flop
Seat 3: Duke Croix (big blind) folded on the Turn
Seat 6: Klemtonius folded on the Turn
Seat 8: HighCardJasper collected (1370)
Seat 9: Manon947 folded on the Turn



PokerStars Home Game Hand #216487138979: {Club #3225207}  Hold'em No Limit (50/100) - 2020/07/16 15:25:34 ET
Table 'Fun times' 9-max (Play Money) Seat #2 is the button
Seat 1: color_singleton (7334 in chips) 
Seat 2: dddocky (18784 in chips) 
Seat 3: Duke Croix (10530 in chips) 
Seat 6: Klemtonius (8300 in chips) 
Seat 8: HighCardJasper (8810 in chips) 
Seat 9: Manon947 (10763 in chips) 
Duke Croix: posts small blind 50
Klemtonius: posts big blind 100
*** HOLE CARDS ***
Dealt to Manon947 [2h Ah]
HighCardJasper: calls 100
Manon947: raises 100 to 200
color_singleton: folds 
dddocky: folds 
Duke Croix: folds 
Klemtonius: raises 133 to 333
HighCardJasper: folds 
Manon947: calls 133
*** FLOP *** [Jd Kd Td]
Klemtonius: bets 771
Manon947: folds 
Uncalled bet (771) returned to Klemtonius
Klemtonius collected 771 from pot
Klemtonius: doesn't show hand 
*** SUMMARY ***
Total pot 816 | Rake 45 
Board [Jd Kd Td]
Seat 1: color_singleton folded before Flop (didn't bet)
Seat 2: dddocky (button) folded before Flop (didn't bet)
Seat 3: Duke Croix (small blind) folded before Flop
Seat 6: Klemtonius (big blind) collected (771)
Seat 8: HighCardJasper folded before Flop
Seat 9: Manon947 folded on the Flop



PokerStars Home Game Hand #216487167657: {Club #3225207}  Hold'em No Limit (50/100) - 2020/07/16 15:26:18 ET
Table 'Fun times' 9-max (Play Money) Seat #3 is the button
Seat 1: color_singleton (7334 in chips) 
Seat 2: dddocky (18784 in chips) 
Seat 3: Duke Croix (10480 in chips) 
Seat 6: Klemtonius (8738 in chips) 
Seat 8: HighCardJasper (8710 in chips) 
Seat 9: Manon947 (10430 in chips) 
Klemtonius: posts small blind 50
HighCardJasper: posts big blind 100
*** HOLE CARDS ***
Dealt to Manon947 [Qh 5c]
Manon947: calls 100
color_singleton: raises 200 to 300
dddocky: calls 300
Duke Croix: folds 
Klemtonius: folds 
HighCardJasper: calls 200
Manon947: folds 
*** FLOP *** [2d 7s Kd]
HighCardJasper: checks 
color_singleton: checks 
dddocky: checks 
*** TURN *** [2d 7s Kd] [Td]
HighCardJasper: checks 
color_singleton: checks 
dddocky: checks 
*** RIVER *** [2d 7s Kd Td] [Jc]
HighCardJasper: bets 300
color_singleton: calls 300
dddocky: folds 
*** SHOW DOWN ***
HighCardJasper: shows [Th 2h] (two pair, Tens and Deuces)
color_singleton: mucks hand 
HighCardJasper collected 1559 from pot
*** SUMMARY ***
Total pot 1650 | Rake 91 
Board [2d 7s Kd Td Jc]
Seat 1: color_singleton mucked [6d 6h]
Seat 2: dddocky folded on the River
Seat 3: Duke Croix (button) folded before Flop (didn't bet)
Seat 6: Klemtonius (small blind) folded before Flop
Seat 8: HighCardJasper (big blind) showed [Th 2h] and won (1559) with two pair, Tens and Deuces
Seat 9: Manon947 folded before Flop



PokerStars Home Game Hand #216487201007: {Club #3225207}  Hold'em No Limit (50/100) - 2020/07/16 15:27:10 ET
Table 'Fun times' 9-max (Play Money) Seat #6 is the button
Seat 1: color_singleton (6734 in chips) 
Seat 2: dddocky (18484 in chips) 
Seat 3: Duke Croix (10480 in chips) 
Seat 6: Klemtonius (8688 in chips) 
Seat 8: HighCardJasper (9669 in chips) 
Seat 9: Manon947 (10330 in chips) 
HighCardJasper: posts small blind 50
Manon947: posts big blind 100
*** HOLE CARDS ***
Dealt to Manon947 [Ac 5c]
color_singleton: folds 
dddocky: folds 
Duke Croix: calls 100
Klemtonius: calls 100
HighCardJasper: raises 200 to 300
Manon947: calls 200
Duke Croix: calls 200
Klemtonius: calls 200
*** FLOP *** [4h 9d Jh]
HighCardJasper: bets 200
Manon947: calls 200
Duke Croix: calls 200
Klemtonius: calls 200
*** TURN *** [4h 9d Jh] [As]
HighCardJasper: bets 200
Manon947: raises 200 to 400
Duke Croix: calls 400
Klemtonius: folds 
HighCardJasper: calls 200
*** RIVER *** [4h 9d Jh As] [8d]
HighCardJasper: bets 500
Manon947: raises 500 to 1000
Duke Croix: calls 1000
HighCardJasper: raises 500 to 1500
Manon947: calls 500
Duke Croix: calls 500
*** SHOW DOWN ***
HighCardJasper: shows [Jd Jc] (three of a kind, Jacks)
Manon947: mucks hand 
Duke Croix: mucks hand 
HighCardJasper collected 7276 from pot
*** SUMMARY ***
Total pot 7700 | Rake 424 
Board [4h 9d Jh As 8d]
Seat 1: color_singleton folded before Flop (didn't bet)
Seat 2: dddocky folded before Flop (didn't bet)
Seat 3: Duke Croix mucked [9h 8h]
Seat 6: Klemtonius (button) folded on the Turn
Seat 8: HighCardJasper (small blind) showed [Jd Jc] and won (7276) with three of a kind, Jacks
Seat 9: Manon947 (big blind) mucked [Ac 5c]



PokerStars Home Game Hand #216487248945: {Club #3225207}  Hold'em No Limit (50/100) - 2020/07/16 15:28:26 ET
Table 'Fun times' 9-max (Play Money) Seat #8 is the button
Seat 1: color_singleton (6734 in chips) 
Seat 2: dddocky (18484 in chips) 
Seat 3: Duke Croix (8080 in chips) 
Seat 6: Klemtonius (8188 in chips) 
Seat 8: HighCardJasper (14545 in chips) 
Seat 9: Manon947 (7930 in chips) 
Manon947: posts small blind 50
color_singleton: posts big blind 100
*** HOLE CARDS ***
Dealt to Manon947 [8s 2h]
dddocky: calls 100
Duke Croix: calls 100
Klemtonius: calls 100
HighCardJasper: calls 100
Manon947: folds 
color_singleton: checks 
*** FLOP *** [As 9s 6d]
color_singleton: checks 
dddocky: checks 
Duke Croix: checks 
Klemtonius: checks 
HighCardJasper: checks 
*** TURN *** [As 9s 6d] [Jd]
color_singleton: checks 
dddocky: checks 
Duke Croix: checks 
Klemtonius: bets 520
HighCardJasper: folds 
color_singleton: folds 
dddocky: folds 
Duke Croix: folds 
Uncalled bet (520) returned to Klemtonius
Klemtonius collected 520 from pot
Klemtonius: doesn't show hand 
*** SUMMARY ***
Total pot 550 | Rake 30 
Board [As 9s 6d Jd]
Seat 1: color_singleton (big blind) folded on the Turn
Seat 2: dddocky folded on the Turn
Seat 3: Duke Croix folded on the Turn
Seat 6: Klemtonius collected (520)
Seat 8: HighCardJasper (button) folded on the Turn
Seat 9: Manon947 (small blind) folded before Flop



PokerStars Home Game Hand #216487464975: {Club #3225207}  Hold'em No Limit (50/100) - 2020/07/16 15:34:05 ET
Table 'Fun times' 9-max (Play Money) Seat #6 is the button
Seat 2: dddocky (18635 in chips) 
Seat 3: Duke Croix (8622 in chips) 
Seat 6: Klemtonius (8067 in chips) 
Seat 8: HighCardJasper (13779 in chips) 
Seat 9: Manon947 (7880 in chips) 
HighCardJasper: posts small blind 50
Manon947: posts big blind 100
*** HOLE CARDS ***
Dealt to Manon947 [5s 8s]
dddocky: calls 100
Duke Croix: folds 
Klemtonius: raises 100 to 200
HighCardJasper: folds 
Manon947: calls 100
dddocky: calls 100
*** FLOP *** [9c 4s 6d]
Manon947: checks 
dddocky: checks 
Klemtonius: checks 
*** TURN *** [9c 4s 6d] [5d]
Manon947: bets 307
dddocky: folds 
Klemtonius: folds 
Uncalled bet (307) returned to Manon947
Manon947 collected 614 from pot
*** SUMMARY ***
Total pot 650 | Rake 36 
Board [9c 4s 6d 5d]
Seat 2: dddocky folded on the Turn
Seat 3: Duke Croix folded before Flop (didn't bet)
Seat 6: Klemtonius (button) folded on the Turn
Seat 8: HighCardJasper (small blind) folded before Flop
Seat 9: Manon947 (big blind) collected (614)



PokerStars Home Game Hand #216487504429: {Club #3225207}  Hold'em No Limit (50/100) - 2020/07/16 15:35:08 ET
Table 'Fun times' 9-max (Play Money) Seat #8 is the button
Seat 1: color_singleton (6634 in chips) 
Seat 2: dddocky (18435 in chips) 
Seat 3: Duke Croix (8622 in chips) 
Seat 6: Klemtonius (7867 in chips) 
Seat 8: HighCardJasper (13729 in chips) 
Seat 9: Manon947 (8294 in chips) 
Manon947: posts small blind 50
color_singleton: posts big blind 100
*** HOLE CARDS ***
Dealt to Manon947 [Qs Ks]
dddocky: folds 
Duke Croix: raises 300 to 400
Klemtonius: folds 
HighCardJasper: folds 
Manon947: calls 350
color_singleton: folds 
*** FLOP *** [9c Jd Jc]
Manon947: checks 
Duke Croix: bets 500
Manon947: calls 500
*** TURN *** [9c Jd Jc] [4c]
Manon947: checks 
Duke Croix: checks 
*** RIVER *** [9c Jd Jc 4c] [5h]
Manon947: checks 
Duke Croix: bets 700
Manon947: folds 
Uncalled bet (700) returned to Duke Croix
Duke Croix collected 1795 from pot
Duke Croix: doesn't show hand 
*** SUMMARY ***
Total pot 1900 | Rake 105 
Board [9c Jd Jc 4c 5h]
Seat 1: color_singleton (big blind) folded before Flop
Seat 2: dddocky folded before Flop (didn't bet)
Seat 3: Duke Croix collected (1795)
Seat 6: Klemtonius folded before Flop (didn't bet)
Seat 8: HighCardJasper (button) folded before Flop (didn't bet)
Seat 9: Manon947 (small blind) folded on the River



PokerStars Home Game Hand #216487551575: {Club #3225207}  Hold'em No Limit (50/100) - 2020/07/16 15:36:22 ET
Table 'Fun times' 9-max (Play Money) Seat #9 is the button
Seat 1: color_singleton (6534 in chips) 
Seat 2: dddocky (18435 in chips) 
Seat 3: Duke Croix (9517 in chips) 
Seat 6: Klemtonius (7867 in chips) 
Seat 8: HighCardJasper (13729 in chips) 
Seat 9: Manon947 (7394 in chips) 
color_singleton: posts small blind 50
dddocky: posts big blind 100
*** HOLE CARDS ***
Dealt to Manon947 [5h 8d]
Duke Croix: calls 100
Klemtonius: calls 100
HighCardJasper: calls 100
Manon947: folds 
color_singleton: raises 400 to 500
dddocky: folds 
Duke Croix: folds 
Klemtonius: folds 
HighCardJasper: folds 
Uncalled bet (400) returned to color_singleton
color_singleton collected 500 from pot
color_singleton: doesn't show hand 
*** SUMMARY ***
Total pot 500 | Rake 0 
Seat 1: color_singleton (small blind) collected (500)
Seat 2: dddocky (big blind) folded before Flop
Seat 3: Duke Croix folded before Flop
Seat 6: Klemtonius folded before Flop
Seat 8: HighCardJasper folded before Flop
Seat 9: Manon947 (button) folded before Flop (didn't bet)



PokerStars Home Game Hand #216487573474: {Club #3225207}  Hold'em No Limit (50/100) - 2020/07/16 15:36:57 ET
Table 'Fun times' 9-max (Play Money) Seat #1 is the button
Seat 1: color_singleton (6934 in chips) 
Seat 2: dddocky (18335 in chips) 
Seat 3: Duke Croix (9417 in chips) 
Seat 6: Klemtonius (7767 in chips) 
Seat 8: HighCardJasper (13629 in chips) 
Seat 9: Manon947 (7394 in chips) 
dddocky: posts small blind 50
Duke Croix: posts big blind 100
*** HOLE CARDS ***
Dealt to Manon947 [3h 7c]
Klemtonius: calls 100
HighCardJasper: calls 100
Manon947: folds 
color_singleton: calls 100
dddocky: folds 
Duke Croix: checks 
*** FLOP *** [7h Ad 4d]
Duke Croix: checks 
Klemtonius: checks 
HighCardJasper: checks 
color_singleton: bets 200
Duke Croix: calls 200
Klemtonius: folds 
HighCardJasper: calls 200
*** TURN *** [7h Ad 4d] [9d]
Duke Croix: checks 
HighCardJasper: checks 
color_singleton: checks 
*** RIVER *** [7h Ad 4d 9d] [3c]
Duke Croix: bets 496
HighCardJasper: folds 
color_singleton: folds 
Uncalled bet (496) returned to Duke Croix
Duke Croix collected 992 from pot
Duke Croix: doesn't show hand 
*** SUMMARY ***
Total pot 1050 | Rake 58 
Board [7h Ad 4d 9d 3c]
Seat 1: color_singleton (button) folded on the River
Seat 2: dddocky (small blind) folded before Flop
Seat 3: Duke Croix (big blind) collected (992)
Seat 6: Klemtonius folded on the Flop
Seat 8: HighCardJasper folded on the River
Seat 9: Manon947 folded before Flop (didn't bet)



PokerStars Home Game Hand #216487620616: {Club #3225207}  Hold'em No Limit (50/100) - 2020/07/16 15:38:11 ET
Table 'Fun times' 9-max (Play Money) Seat #2 is the button
Seat 1: color_singleton (6634 in chips) 
Seat 2: dddocky (18285 in chips) 
Seat 3: Duke Croix (10109 in chips) 
Seat 6: Klemtonius (7667 in chips) 
Seat 8: HighCardJasper (13329 in chips) 
Seat 9: Manon947 (7394 in chips) 
Duke Croix: posts small blind 50
Klemtonius: posts big blind 100
*** HOLE CARDS ***
Dealt to Manon947 [9h Qh]
HighCardJasper: calls 100
Manon947: calls 100
color_singleton: folds 
dddocky: folds 
Duke Croix: folds 
Klemtonius: checks 
*** FLOP *** [Ad 3s Td]
Klemtonius: bets 100
HighCardJasper: calls 100
Manon947: calls 100
*** TURN *** [Ad 3s Td] [2c]
Klemtonius: checks 
HighCardJasper: checks 
Manon947: checks 
*** RIVER *** [Ad 3s Td 2c] [Ah]
Klemtonius: checks 
HighCardJasper: bets 300
Manon947: folds 
Klemtonius: folds 
Uncalled bet (300) returned to HighCardJasper
HighCardJasper collected 614 from pot
HighCardJasper: doesn't show hand 
*** SUMMARY ***
Total pot 650 | Rake 36 
Board [Ad 3s Td 2c Ah]
Seat 1: color_singleton folded before Flop (didn't bet)
Seat 2: dddocky (button) folded before Flop (didn't bet)
Seat 3: Duke Croix (small blind) folded before Flop
Seat 6: Klemtonius (big blind) folded on the River
Seat 8: HighCardJasper collected (614)
Seat 9: Manon947 folded on the River



PokerStars Home Game Hand #216487648623: {Club #3225207}  Hold'em No Limit (50/100) - 2020/07/16 15:38:54 ET
Table 'Fun times' 9-max (Play Money) Seat #3 is the button
Seat 1: color_singleton (6634 in chips) 
Seat 2: dddocky (18285 in chips) 
Seat 3: Duke Croix (10059 in chips) 
Seat 6: Klemtonius (7467 in chips) 
Seat 8: HighCardJasper (13743 in chips) 
Seat 9: Manon947 (7194 in chips) 
Klemtonius: posts small blind 50
HighCardJasper: posts big blind 100
*** HOLE CARDS ***
Dealt to Manon947 [6c Ts]
Manon947: folds 
color_singleton: calls 100
dddocky: folds 
Duke Croix has timed out
Duke Croix: folds 
Klemtonius: raises 325 to 425
HighCardJasper: calls 325
color_singleton: folds 
*** FLOP *** [8c Kc Jc]
Klemtonius: bets 449
HighCardJasper: folds 
Uncalled bet (449) returned to Klemtonius
Klemtonius collected 898 from pot
Klemtonius: doesn't show hand 
*** SUMMARY ***
Total pot 950 | Rake 52 
Board [8c Kc Jc]
Seat 1: color_singleton folded before Flop
Seat 2: dddocky folded before Flop (didn't bet)
Seat 3: Duke Croix (button) folded before Flop (didn't bet)
Seat 6: Klemtonius (small blind) collected (898)
Seat 8: HighCardJasper (big blind) folded on the Flop
Seat 9: Manon947 folded before Flop (didn't bet)



PokerStars Home Game Hand #216487686616: {Club #3225207}  Hold'em No Limit (50/100) - 2020/07/16 15:39:54 ET
Table 'Fun times' 9-max (Play Money) Seat #6 is the button
Seat 1: color_singleton (6534 in chips) 
Seat 2: dddocky (18285 in chips) 
Seat 3: Duke Croix (10059 in chips) 
Seat 6: Klemtonius (7940 in chips) 
Seat 8: HighCardJasper (13318 in chips) 
Seat 9: Manon947 (7194 in chips) 
HighCardJasper: posts small blind 50
Manon947: posts big blind 100
*** HOLE CARDS ***
Dealt to Manon947 [Td Kh]
color_singleton: folds 
dddocky: calls 100
Duke Croix: folds 
Klemtonius: calls 100
HighCardJasper: calls 50
Manon947: checks 
*** FLOP *** [8c Js 2d]
HighCardJasper: checks 
Manon947: checks 
dddocky: checks 
Klemtonius: checks 
*** TURN *** [8c Js 2d] [Jc]
HighCardJasper: checks 
Manon947: checks 
dddocky: checks 
Klemtonius: checks 
*** RIVER *** [8c Js 2d Jc] [6h]
HighCardJasper: checks 
Manon947: checks 
dddocky: checks 
Klemtonius: checks 
*** SHOW DOWN ***
HighCardJasper: shows [7d 3s] (a pair of Jacks)
Manon947: shows [Td Kh] (a pair of Jacks - King kicker)
dddocky: mucks hand 
Klemtonius: mucks hand 
Manon947 collected 378 from pot
*** SUMMARY ***
Total pot 400 | Rake 22 
Board [8c Js 2d Jc 6h]
Seat 1: color_singleton folded before Flop (didn't bet)
Seat 2: dddocky mucked [Tc 5c]
Seat 3: Duke Croix folded before Flop (didn't bet)
Seat 6: Klemtonius (button) mucked [5s 4s]
Seat 8: HighCardJasper (small blind) showed [7d 3s] and lost with a pair of Jacks
Seat 9: Manon947 (big blind) showed [Td Kh] and won (378) with a pair of Jacks



PokerStars Home Game Hand #216487716931: {Club #3225207}  Hold'em No Limit (50/100) - 2020/07/16 15:40:37 ET
Table 'Fun times' 9-max (Play Money) Seat #8 is the button
Seat 1: color_singleton (6534 in chips) 
Seat 2: dddocky (18185 in chips) 
Seat 3: Duke Croix (10059 in chips) 
Seat 6: Klemtonius (7840 in chips) 
Seat 8: HighCardJasper (13218 in chips) 
Seat 9: Manon947 (7472 in chips) 
Manon947: posts small blind 50
color_singleton: posts big blind 100
*** HOLE CARDS ***
Dealt to Manon947 [Jd As]
dddocky: raises 400 to 500
Duke Croix: folds 
Klemtonius: folds 
HighCardJasper: folds 
Manon947: calls 450
color_singleton: folds 
*** FLOP *** [Ac 8s Jh]
Manon947: bets 519
dddocky: folds 
Uncalled bet (519) returned to Manon947
Manon947 collected 1039 from pot
*** SUMMARY ***
Total pot 1100 | Rake 61 
Board [Ac 8s Jh]
Seat 1: color_singleton (big blind) folded before Flop
Seat 2: dddocky folded on the Flop
Seat 3: Duke Croix folded before Flop (didn't bet)
Seat 6: Klemtonius folded before Flop (didn't bet)
Seat 8: HighCardJasper (button) folded before Flop (didn't bet)
Seat 9: Manon947 (small blind) collected (1039)



PokerStars Home Game Hand #216487735500: {Club #3225207}  Hold'em No Limit (50/100) - 2020/07/16 15:41:06 ET
Table 'Fun times' 9-max (Play Money) Seat #9 is the button
Seat 1: color_singleton (6434 in chips) 
Seat 2: dddocky (17685 in chips) 
Seat 3: Duke Croix (10059 in chips) 
Seat 6: Klemtonius (7840 in chips) 
Seat 8: HighCardJasper (13218 in chips) 
Seat 9: Manon947 (8011 in chips) 
color_singleton: posts small blind 50
dddocky: posts big blind 100
*** HOLE CARDS ***
Dealt to Manon947 [5d Js]
Duke Croix: folds 
Klemtonius: calls 100
HighCardJasper: calls 100
Manon947: calls 100
color_singleton: raises 200 to 300
dddocky: folds 
Klemtonius: calls 200
HighCardJasper: folds 
Manon947: calls 200
*** FLOP *** [Qs 3s As]
color_singleton: bets 519
Klemtonius: raises 519 to 1038
Manon947: folds 
color_singleton: folds 
Uncalled bet (519) returned to Klemtonius
Klemtonius collected 2020 from pot
Klemtonius: doesn't show hand 
*** SUMMARY ***
Total pot 2138 | Rake 118 
Board [Qs 3s As]
Seat 1: color_singleton (small blind) folded on the Flop
Seat 2: dddocky (big blind) folded before Flop
Seat 3: Duke Croix folded before Flop (didn't bet)
Seat 6: Klemtonius collected (2020)
Seat 8: HighCardJasper folded before Flop
Seat 9: Manon947 (button) folded on the Flop



PokerStars Home Game Hand #216487762187: {Club #3225207}  Hold'em No Limit (50/100) - 2020/07/16 15:41:48 ET
Table 'Fun times' 9-max (Play Money) Seat #1 is the button
Seat 1: color_singleton (5615 in chips) 
Seat 2: dddocky (17585 in chips) 
Seat 3: Duke Croix (10059 in chips) 
Seat 6: Klemtonius (9041 in chips) 
Seat 8: HighCardJasper (13118 in chips) 
Seat 9: Manon947 (7711 in chips) 
dddocky: posts small blind 50
Duke Croix: posts big blind 100
*** HOLE CARDS ***
Dealt to Manon947 [5s 3s]
Klemtonius: raises 100 to 200
HighCardJasper: folds 
Manon947: calls 200
color_singleton: folds 
dddocky: folds 
Duke Croix: folds 
*** FLOP *** [Ah 8c Qh]
Klemtonius: checks 
Manon947: checks 
*** TURN *** [Ah 8c Qh] [As]
Klemtonius: bets 260
Manon947: folds 
Uncalled bet (260) returned to Klemtonius
Klemtonius collected 520 from pot
Klemtonius: doesn't show hand 
*** SUMMARY ***
Total pot 550 | Rake 30 
Board [Ah 8c Qh As]
Seat 1: color_singleton (button) folded before Flop (didn't bet)
Seat 2: dddocky (small blind) folded before Flop
Seat 3: Duke Croix (big blind) folded before Flop
Seat 6: Klemtonius collected (520)
Seat 8: HighCardJasper folded before Flop (didn't bet)
Seat 9: Manon947 folded on the Turn



PokerStars Home Game Hand #216487777065: {Club #3225207}  Hold'em No Limit (50/100) - 2020/07/16 15:42:11 ET
Table 'Fun times' 9-max (Play Money) Seat #2 is the button
Seat 1: color_singleton (5615 in chips) 
Seat 2: dddocky (17535 in chips) 
Seat 3: Duke Croix (9959 in chips) 
Seat 6: Klemtonius (9361 in chips) 
Seat 8: HighCardJasper (13118 in chips) 
Seat 9: Manon947 (7511 in chips) 
Duke Croix: posts small blind 50
Klemtonius: posts big blind 100
*** HOLE CARDS ***
Dealt to Manon947 [Qc 6s]
HighCardJasper: calls 100
Manon947: calls 100
color_singleton: folds 
dddocky: calls 100
Duke Croix: folds 
Klemtonius: checks 
*** FLOP *** [Th 9h 3h]
Klemtonius: checks 
HighCardJasper: checks 
Manon947: checks 
dddocky: checks 
*** TURN *** [Th 9h 3h] [Qh]
Klemtonius: checks 
HighCardJasper: checks 
Manon947: checks 
dddocky: checks 
*** RIVER *** [Th 9h 3h Qh] [2c]
Klemtonius: checks 
HighCardJasper: checks 
Manon947: bets 212
dddocky: folds 
Klemtonius: folds 
HighCardJasper: folds 
Uncalled bet (212) returned to Manon947
Manon947 collected 425 from pot
*** SUMMARY ***
Total pot 450 | Rake 25 
Board [Th 9h 3h Qh 2c]
Seat 1: color_singleton folded before Flop (didn't bet)
Seat 2: dddocky (button) folded on the River
Seat 3: Duke Croix (small blind) folded before Flop
Seat 6: Klemtonius (big blind) folded on the River
Seat 8: HighCardJasper folded on the River
Seat 9: Manon947 collected (425)



PokerStars Home Game Hand #216487809077: {Club #3225207}  Hold'em No Limit (50/100) - 2020/07/16 15:43:01 ET
Table 'Fun times' 9-max (Play Money) Seat #3 is the button
Seat 1: color_singleton (5615 in chips) 
Seat 2: dddocky (17435 in chips) 
Seat 3: Duke Croix (9909 in chips) 
Seat 6: Klemtonius (9261 in chips) 
Seat 8: HighCardJasper (13018 in chips) 
Seat 9: Manon947 (7836 in chips) 
Klemtonius: posts small blind 50
HighCardJasper: posts big blind 100
*** HOLE CARDS ***
Dealt to Manon947 [3s 3h]
Manon947: calls 100
color_singleton: folds 
dddocky: calls 100
Duke Croix: raises 500 to 600
Klemtonius: calls 550
HighCardJasper: folds 
Manon947: calls 500
dddocky: calls 500
*** FLOP *** [3c 4c 9c]
Klemtonius: bets 1900
Manon947: folds 
dddocky: folds 
Duke Croix: raises 7409 to 9309 and is all-in
Klemtonius: calls 6761 and is all-in
Uncalled bet (648) returned to Duke Croix
*** TURN *** [3c 4c 9c] [Qh]
*** RIVER *** [3c 4c 9c Qh] [4d]
*** SHOW DOWN ***
Klemtonius: shows [8h 8s] (two pair, Eights and Fours)
Duke Croix: shows [Ks Kd] (two pair, Kings and Fours)
Duke Croix collected 18732 from pot
*** SUMMARY ***
Total pot 19822 | Rake 1090 
Board [3c 4c 9c Qh 4d]
Seat 1: color_singleton folded before Flop (didn't bet)
Seat 2: dddocky folded on the Flop
Seat 3: Duke Croix (button) showed [Ks Kd] and won (18732) with two pair, Kings and Fours
Seat 6: Klemtonius (small blind) showed [8h 8s] and lost with two pair, Eights and Fours
Seat 8: HighCardJasper (big blind) folded before Flop
Seat 9: Manon947 folded on the Flop



PokerStars Home Game Hand #216487966091: {Club #3225207}  Hold'em No Limit (50/100) - 2020/07/16 15:47:08 ET
Table 'Fun times' 9-max (Play Money) Seat #6 is the button
Seat 1: color_singleton (6121 in chips) 
Seat 2: dddocky (15935 in chips) 
Seat 3: Duke Croix (19583 in chips) 
Seat 6: Klemtonius (9878 in chips) 
Seat 8: HighCardJasper (13079 in chips) 
Seat 9: Manon947 (7236 in chips) 
HighCardJasper: posts small blind 50
Manon947: posts big blind 100
*** HOLE CARDS ***
Dealt to Manon947 [As 7s]
color_singleton: folds 
dddocky: folds 
Duke Croix: folds 
Klemtonius: calls 100
HighCardJasper: calls 50
Manon947: checks 
*** FLOP *** [2h Ah 6c]
HighCardJasper: checks 
Manon947: bets 141
Klemtonius: folds 
HighCardJasper: calls 141
*** TURN *** [2h Ah 6c] [7h]
HighCardJasper: checks 
Manon947: bets 275
HighCardJasper: calls 275
*** RIVER *** [2h Ah 6c 7h] [3d]
HighCardJasper: bets 200
Manon947: calls 200
*** SHOW DOWN ***
HighCardJasper: shows [4h 5c] (a straight, Three to Seven)
Manon947: mucks hand 
HighCardJasper collected 1448 from pot
*** SUMMARY ***
Total pot 1532 | Rake 84 
Board [2h Ah 6c 7h 3d]
Seat 1: color_singleton folded before Flop (didn't bet)
Seat 2: dddocky folded before Flop (didn't bet)
Seat 3: Duke Croix folded before Flop (didn't bet)
Seat 6: Klemtonius (button) folded on the Flop
Seat 8: HighCardJasper (small blind) showed [4h 5c] and won (1448) with a straight, Three to Seven
Seat 9: Manon947 (big blind) mucked [As 7s]



PokerStars Home Game Hand #216488003552: {Club #3225207}  Hold'em No Limit (50/100) - 2020/07/16 15:48:07 ET
Table 'Fun times' 9-max (Play Money) Seat #8 is the button
Seat 1: color_singleton (6121 in chips) 
Seat 2: dddocky (15935 in chips) 
Seat 3: Duke Croix (19583 in chips) 
Seat 6: Klemtonius (9778 in chips) 
Seat 8: HighCardJasper (13811 in chips) 
Seat 9: Manon947 (6520 in chips) 
Manon947: posts small blind 50
color_singleton: posts big blind 100
*** HOLE CARDS ***
Dealt to Manon947 [2s Jh]
dddocky: calls 100
Duke Croix: raises 300 to 400
Klemtonius: folds 
HighCardJasper: folds 
Manon947: folds 
color_singleton: calls 300
dddocky: folds 
*** FLOP *** [Kh 6s 3s]
color_singleton: checks 
Duke Croix: checks 
*** TURN *** [Kh 6s 3s] [Ac]
color_singleton: checks 
Duke Croix: bets 449
color_singleton: raises 449 to 898
Duke Croix: calls 449
*** RIVER *** [Kh 6s 3s Ac] [Th]
color_singleton: bets 2595
Duke Croix: calls 2595
*** SHOW DOWN ***
color_singleton: shows [Kc Kd] (three of a kind, Kings)
Duke Croix: mucks hand 
color_singleton collected 7500 from pot
*** SUMMARY ***
Total pot 7936 | Rake 436 
Board [Kh 6s 3s Ac Th]
Seat 1: color_singleton (big blind) showed [Kc Kd] and won (7500) with three of a kind, Kings
Seat 2: dddocky folded before Flop
Seat 3: Duke Croix mucked [As Qd]
Seat 6: Klemtonius folded before Flop (didn't bet)
Seat 8: HighCardJasper (button) folded before Flop (didn't bet)
Seat 9: Manon947 (small blind) folded before Flop



PokerStars Home Game Hand #216488209264: {Club #3225207}  Hold'em No Limit (50/100) - 2020/07/16 15:53:24 ET
Table 'Fun times' 9-max (Play Money) Seat #1 is the button
Seat 1: color_singleton (9128 in chips) 
Seat 2: dddocky (15868 in chips) 
Seat 3: Duke Croix (15440 in chips) 
Seat 6: Klemtonius (10988 in chips) 
Seat 8: HighCardJasper (13235 in chips) 
Seat 9: Manon947 (6470 in chips) 
dddocky: posts small blind 50
Duke Croix: posts big blind 100
Manon947: posts small & big blinds 150
*** HOLE CARDS ***
Dealt to Manon947 [Qs 2d]
Klemtonius: calls 100
HighCardJasper: calls 100
Manon947: checks 
color_singleton: folds 
dddocky: calls 50
Duke Croix: checks 
*** FLOP *** [8s 4s Qc]
dddocky: checks 
Duke Croix: bets 400
Klemtonius: calls 400
HighCardJasper: calls 400
Manon947: calls 400
dddocky: folds 
*** TURN *** [8s 4s Qc] [Js]
Duke Croix: bets 800
Klemtonius: folds 
HighCardJasper: folds 
Manon947: calls 800
*** RIVER *** [8s 4s Qc Js] [Ad]
Duke Croix: checks 
Manon947: checks 
*** SHOW DOWN ***
Duke Croix: shows [Qd 2h] (a pair of Queens)
Manon947: shows [Qs 2d] (a pair of Queens)
Duke Croix collected 1772 from pot
Manon947 collected 1772 from pot
*** SUMMARY ***
Total pot 3750 | Rake 206 
Board [8s 4s Qc Js Ad]
Seat 1: color_singleton (button) folded before Flop (didn't bet)
Seat 2: dddocky (small blind) folded on the Flop
Seat 3: Duke Croix (big blind) showed [Qd 2h] and won (1772) with a pair of Queens
Seat 6: Klemtonius folded on the Turn
Seat 8: HighCardJasper folded on the Turn
Seat 9: Manon947 showed [Qs 2d] and won (1772) with a pair of Queens



PokerStars Home Game Hand #216488260183: {Club #3225207}  Hold'em No Limit (50/100) - 2020/07/16 15:54:38 ET
Table 'Fun times' 9-max (Play Money) Seat #2 is the button
Seat 1: color_singleton (9128 in chips) 
Seat 2: dddocky (15768 in chips) 
Seat 3: Duke Croix (15912 in chips) 
Seat 6: Klemtonius (10488 in chips) 
Seat 8: HighCardJasper (12735 in chips) 
Seat 9: Manon947 (6892 in chips) 
Duke Croix: posts small blind 50
Klemtonius: posts big blind 100
*** HOLE CARDS ***
Dealt to Manon947 [2h 9s]
HighCardJasper: calls 100
Manon947: folds 
color_singleton: calls 100
dddocky: folds 
Duke Croix: calls 50
Klemtonius: checks 
*** FLOP *** [Qc Th 7d]
Duke Croix: bets 300
Klemtonius: folds 
HighCardJasper: calls 300
color_singleton: calls 300
*** TURN *** [Qc Th 7d] [3c]
Duke Croix: checks 
HighCardJasper: bets 200
color_singleton: calls 200
Duke Croix: calls 200
*** RIVER *** [Qc Th 7d 3c] [2c]
Duke Croix: checks 
HighCardJasper: checks 
color_singleton: bets 897
Duke Croix: folds 
HighCardJasper: folds 
Uncalled bet (897) returned to color_singleton
color_singleton collected 1795 from pot
color_singleton: doesn't show hand 
*** SUMMARY ***
Total pot 1900 | Rake 105 
Board [Qc Th 7d 3c 2c]
Seat 1: color_singleton collected (1795)
Seat 2: dddocky (button) folded before Flop (didn't bet)
Seat 3: Duke Croix (small blind) folded on the River
Seat 6: Klemtonius (big blind) folded on the Flop
Seat 8: HighCardJasper folded on the River
Seat 9: Manon947 folded before Flop (didn't bet)



PokerStars Home Game Hand #216488294492: {Club #3225207}  Hold'em No Limit (50/100) - 2020/07/16 15:55:48 ET
Table 'Fun times' 9-max (Play Money) Seat #3 is the button
Seat 1: color_singleton (10323 in chips) 
Seat 2: dddocky (15768 in chips) 
Seat 3: Duke Croix (15312 in chips) 
Seat 6: Klemtonius (10388 in chips) 
Seat 8: HighCardJasper (12135 in chips) 
Seat 9: Manon947 (6892 in chips) 
Klemtonius: posts small blind 50
HighCardJasper: posts big blind 100
*** HOLE CARDS ***
Dealt to Manon947 [Jd 6c]
Manon947: calls 100
color_singleton: folds 
dddocky: calls 100
Duke Croix: folds 
Klemtonius: calls 50
HighCardJasper: checks 
*** FLOP *** [3c 4h 4s]
Klemtonius: checks 
HighCardJasper: checks 
Manon947: checks 
dddocky: checks 
*** TURN *** [3c 4h 4s] [7h]
Klemtonius: checks 
HighCardJasper: checks 
Manon947: checks 
dddocky: checks 
*** RIVER *** [3c 4h 4s 7h] [2d]
Klemtonius: checks 
HighCardJasper: checks 
Manon947: checks 
dddocky: checks 
*** SHOW DOWN ***
Klemtonius: shows [6h 9s] (a pair of Fours)
HighCardJasper: shows [Ks 3h] (two pair, Fours and Threes)
Manon947: mucks hand 
dddocky: mucks hand 
HighCardJasper collected 378 from pot
*** SUMMARY ***
Total pot 400 | Rake 22 
Board [3c 4h 4s 7h 2d]
Seat 1: color_singleton folded before Flop (didn't bet)
Seat 2: dddocky mucked [Ad Qc]
Seat 3: Duke Croix (button) folded before Flop (didn't bet)
Seat 6: Klemtonius (small blind) showed [6h 9s] and lost with a pair of Fours
Seat 8: HighCardJasper (big blind) showed [Ks 3h] and won (378) with two pair, Fours and Threes
Seat 9: Manon947 mucked [Jd 6c]



PokerStars Home Game Hand #216488316980: {Club #3225207}  Hold'em No Limit (50/100) - 2020/07/16 15:56:37 ET
Table 'Fun times' 9-max (Play Money) Seat #6 is the button
Seat 1: color_singleton (10323 in chips) 
Seat 2: dddocky (15668 in chips) 
Seat 3: Duke Croix (15312 in chips) 
Seat 6: Klemtonius (10288 in chips) 
Seat 8: HighCardJasper (12413 in chips) 
Seat 9: Manon947 (6792 in chips) 
HighCardJasper: posts small blind 50
Manon947: posts big blind 100
*** HOLE CARDS ***
Dealt to Manon947 [9s 5s]
color_singleton: folds 
dddocky: calls 100
Duke Croix: folds 
Klemtonius: folds 
HighCardJasper: calls 50
Manon947: checks 
*** FLOP *** [Td 4c Qc]
HighCardJasper: checks 
Manon947: checks 
dddocky: bets 100
HighCardJasper: calls 100
Manon947: calls 100
*** TURN *** [Td 4c Qc] [5h]
HighCardJasper: checks 
Manon947: bets 283
dddocky: calls 283
HighCardJasper: folds 
*** RIVER *** [Td 4c Qc 5h] [3d]
Manon947: bets 551
dddocky: calls 551
*** SHOW DOWN ***
Manon947: shows [9s 5s] (a pair of Fives)
dddocky: shows [Ts Ah] (a pair of Tens)
dddocky collected 2143 from pot
*** SUMMARY ***
Total pot 2268 | Rake 125 
Board [Td 4c Qc 5h 3d]
Seat 1: color_singleton folded before Flop (didn't bet)
Seat 2: dddocky showed [Ts Ah] and won (2143) with a pair of Tens
Seat 3: Duke Croix folded before Flop (didn't bet)
Seat 6: Klemtonius (button) folded before Flop (didn't bet)
Seat 8: HighCardJasper (small blind) folded on the Turn
Seat 9: Manon947 (big blind) showed [9s 5s] and lost with a pair of Fives



PokerStars Home Game Hand #216488352527: {Club #3225207}  Hold'em No Limit (50/100) - 2020/07/16 15:57:55 ET
Table 'Fun times' 9-max (Play Money) Seat #8 is the button
Seat 1: color_singleton (10323 in chips) 
Seat 2: dddocky (16777 in chips) 
Seat 3: Duke Croix (15312 in chips) 
Seat 6: Klemtonius (10288 in chips) 
Seat 8: HighCardJasper (12213 in chips) 
Seat 9: Manon947 (5758 in chips) 
Manon947: posts small blind 50
color_singleton: posts big blind 100
*** HOLE CARDS ***
Dealt to Manon947 [9c 2c]
dddocky: folds 
Duke Croix: folds 
Klemtonius: calls 100
HighCardJasper: calls 100
Manon947: calls 50
color_singleton: checks 
*** FLOP *** [5c Qd Js]
Manon947: checks 
color_singleton: checks 
Klemtonius: checks 
HighCardJasper: checks 
*** TURN *** [5c Qd Js] [3s]
Manon947: checks 
color_singleton: bets 189
Klemtonius: folds 
HighCardJasper: calls 189
Manon947: folds 
*** RIVER *** [5c Qd Js 3s] [6c]
color_singleton: bets 367
HighCardJasper: folds 
Uncalled bet (367) returned to color_singleton
color_singleton collected 735 from pot
color_singleton: doesn't show hand 
*** SUMMARY ***
Total pot 778 | Rake 43 
Board [5c Qd Js 3s 6c]
Seat 1: color_singleton (big blind) collected (735)
Seat 2: dddocky folded before Flop (didn't bet)
Seat 3: Duke Croix folded before Flop (didn't bet)
Seat 6: Klemtonius folded on the Turn
Seat 8: HighCardJasper (button) folded on the River
Seat 9: Manon947 (small blind) folded on the Turn



PokerStars Home Game Hand #216488381369: {Club #3225207}  Hold'em No Limit (50/100) - 2020/07/16 15:58:58 ET
Table 'Fun times' 9-max (Play Money) Seat #9 is the button
Seat 1: color_singleton (10769 in chips) 
Seat 2: dddocky (16777 in chips) 
Seat 3: Duke Croix (15312 in chips) 
Seat 6: Klemtonius (10188 in chips) 
Seat 8: HighCardJasper (11924 in chips) 
Seat 9: Manon947 (5658 in chips) 
color_singleton: posts small blind 50
dddocky: posts big blind 100
*** HOLE CARDS ***
Dealt to Manon947 [8c 7s]
Duke Croix: folds 
Klemtonius: raises 100 to 200
HighCardJasper: folds 
Manon947: folds 
color_singleton: calls 150
dddocky: calls 100
*** FLOP *** [Jh 7h Tc]
color_singleton: checks 
dddocky: checks 
Klemtonius: bets 567
color_singleton: folds 
dddocky: folds 
Uncalled bet (567) returned to Klemtonius
Klemtonius collected 567 from pot
Klemtonius: doesn't show hand 
*** SUMMARY ***
Total pot 600 | Rake 33 
Board [Jh 7h Tc]
Seat 1: color_singleton (small blind) folded on the Flop
Seat 2: dddocky (big blind) folded on the Flop
Seat 3: Duke Croix folded before Flop (didn't bet)
Seat 6: Klemtonius collected (567)
Seat 8: HighCardJasper folded before Flop (didn't bet)
Seat 9: Manon947 (button) folded before Flop (didn't bet)



PokerStars Home Game Hand #216488399414: {Club #3225207}  Hold'em No Limit (50/100) - 2020/07/16 15:59:38 ET
Table 'Fun times' 9-max (Play Money) Seat #1 is the button
Seat 1: color_singleton (10569 in chips) 
Seat 2: dddocky (16577 in chips) 
Seat 3: Duke Croix (15312 in chips) 
Seat 6: Klemtonius (10555 in chips) 
Seat 8: HighCardJasper (11924 in chips) 
Seat 9: Manon947 (5658 in chips) 
dddocky: posts small blind 50
Duke Croix: posts big blind 100
*** HOLE CARDS ***
Dealt to Manon947 [Kd 4c]
Klemtonius: calls 100
HighCardJasper: calls 100
Manon947: calls 100
color_singleton: folds 
dddocky: folds 
Duke Croix is disconnected 
Duke Croix has timed out while being disconnected
Duke Croix: checks 
*** FLOP *** [4s 5s Ad]
Duke Croix is connected 
Duke Croix: checks 
Klemtonius: bets 100
HighCardJasper: calls 100
Manon947: raises 362 to 462
Duke Croix: folds 
Klemtonius: folds 
HighCardJasper: calls 362
*** TURN *** [4s 5s Ad] [Js]
HighCardJasper: checks 
Manon947: bets 1393
HighCardJasper: calls 1393
*** RIVER *** [4s 5s Ad Js] [5h]
HighCardJasper: checks 
Manon947: checks 
*** SHOW DOWN ***
HighCardJasper: shows [Ah 2d] (two pair, Aces and Fives)
Manon947: mucks hand 
HighCardJasper collected 4026 from pot
*** SUMMARY ***
Total pot 4260 | Rake 234 
Board [4s 5s Ad Js 5h]
Seat 1: color_singleton (button) folded before Flop (didn't bet)
Seat 2: dddocky (small blind) folded before Flop
Seat 3: Duke Croix (big blind) folded on the Flop
Seat 6: Klemtonius folded on the Flop
Seat 8: HighCardJasper showed [Ah 2d] and won (4026) with two pair, Aces and Fives
Seat 9: Manon947 mucked [Kd 4c]



PokerStars Home Game Hand #216488444277: {Club #3225207}  Hold'em No Limit (50/100) - 2020/07/16 16:01:06 ET
Table 'Fun times' 9-max (Play Money) Seat #2 is the button
Seat 1: color_singleton (10569 in chips) 
Seat 2: dddocky (16527 in chips) 
Seat 3: Duke Croix (15212 in chips) 
Seat 6: Klemtonius (10355 in chips) 
Seat 8: HighCardJasper (13995 in chips) 
Seat 9: Manon947 (3703 in chips) 
Duke Croix: posts small blind 50
Klemtonius: posts big blind 100
*** HOLE CARDS ***
Dealt to Manon947 [2d 8d]
HighCardJasper: calls 100
Manon947: calls 100
color_singleton has timed out
color_singleton: folds 
dddocky: folds 
Duke Croix: raises 300 to 400
Klemtonius: calls 300
HighCardJasper: folds 
Manon947: folds 
*** FLOP *** [Jh 6d 7s]
Duke Croix: checks 
Klemtonius: bets 945
Duke Croix: folds 
Uncalled bet (945) returned to Klemtonius
Klemtonius collected 945 from pot
Klemtonius: doesn't show hand 
*** SUMMARY ***
Total pot 1000 | Rake 55 
Board [Jh 6d 7s]
Seat 1: color_singleton folded before Flop (didn't bet)
Seat 2: dddocky (button) folded before Flop (didn't bet)
Seat 3: Duke Croix (small blind) folded on the Flop
Seat 6: Klemtonius (big blind) collected (945)
Seat 8: HighCardJasper folded before Flop
Seat 9: Manon947 folded before Flop



PokerStars Home Game Hand #216488475504: {Club #3225207}  Hold'em No Limit (50/100) - 2020/07/16 16:02:01 ET
Table 'Fun times' 9-max (Play Money) Seat #3 is the button
Seat 2: dddocky (16527 in chips) 
Seat 3: Duke Croix (14812 in chips) 
Seat 6: Klemtonius (10900 in chips) 
Seat 8: HighCardJasper (13895 in chips) 
Seat 9: Manon947 (3603 in chips) 
Klemtonius: posts small blind 50
HighCardJasper: posts big blind 100
*** HOLE CARDS ***
Dealt to Manon947 [6h Js]
Manon947: calls 100
dddocky: calls 100
Duke Croix: folds 
Klemtonius: raises 100 to 200
HighCardJasper: calls 100
Manon947: folds 
dddocky: calls 100
*** FLOP *** [Jd 4s 9d]
Klemtonius: checks 
HighCardJasper: checks 
dddocky: bets 100
Klemtonius: folds 
HighCardJasper: calls 100
*** TURN *** [Jd 4s 9d] [Jc]
HighCardJasper: checks 
dddocky: bets 425
HighCardJasper: folds 
Uncalled bet (425) returned to dddocky
dddocky collected 850 from pot
dddocky: doesn't show hand 
*** SUMMARY ***
Total pot 900 | Rake 50 
Board [Jd 4s 9d Jc]
Seat 2: dddocky collected (850)
Seat 3: Duke Croix (button) folded before Flop (didn't bet)
Seat 6: Klemtonius (small blind) folded on the Flop
Seat 8: HighCardJasper (big blind) folded on the Turn
Seat 9: Manon947 folded before Flop



PokerStars Home Game Hand #216488502146: {Club #3225207}  Hold'em No Limit (50/100) - 2020/07/16 16:02:44 ET
Table 'Fun times' 9-max (Play Money) Seat #6 is the button
Seat 1: color_singleton (10569 in chips) 
Seat 2: dddocky (17077 in chips) 
Seat 3: Duke Croix (14812 in chips) 
Seat 6: Klemtonius (10700 in chips) 
Seat 8: HighCardJasper (13595 in chips) 
Seat 9: Manon947 (3503 in chips) 
HighCardJasper: posts small blind 50
Manon947: posts big blind 100
*** HOLE CARDS ***
Dealt to Manon947 [Jd Js]
color_singleton: raises 200 to 300
dddocky: folds 
Duke Croix has timed out
Duke Croix: folds 
Klemtonius: calls 300
HighCardJasper: calls 250
Manon947: calls 200
*** FLOP *** [9c Kd 8c]
HighCardJasper: checks 
Manon947: checks 
color_singleton: checks 
Klemtonius: bets 567
HighCardJasper: folds 
Manon947: calls 567
color_singleton: folds 
*** TURN *** [9c Kd 8c] [8d]
Manon947: bets 1103
Klemtonius: folds 
Uncalled bet (1103) returned to Manon947
Manon947 collected 2206 from pot
*** SUMMARY ***
Total pot 2334 | Rake 128 
Board [9c Kd 8c 8d]
Seat 1: color_singleton folded on the Flop
Seat 2: dddocky folded before Flop (didn't bet)
Seat 3: Duke Croix folded before Flop (didn't bet)
Seat 6: Klemtonius (button) folded on the Turn
Seat 8: HighCardJasper (small blind) folded on the Flop
Seat 9: Manon947 (big blind) collected (2206)



PokerStars Home Game Hand #216488553174: {Club #3225207}  Hold'em No Limit (50/100) - 2020/07/16 16:04:06 ET
Table 'Fun times' 9-max (Play Money) Seat #8 is the button
Seat 1: color_singleton (10269 in chips) 
Seat 2: dddocky (17077 in chips) 
Seat 6: Klemtonius (9833 in chips) 
Seat 8: HighCardJasper (13295 in chips) 
Seat 9: Manon947 (4842 in chips) 
Manon947: posts small blind 50
color_singleton: posts big blind 100
*** HOLE CARDS ***
Dealt to Manon947 [9s 8s]
dddocky: calls 100
Klemtonius: calls 100
HighCardJasper: raises 200 to 300
Manon947: calls 250
color_singleton: calls 200
dddocky: calls 200
Klemtonius: calls 200
*** FLOP *** [6s 2h 4d]
Manon947: checks 
color_singleton: checks 
dddocky: checks 
Klemtonius: bets 1417
HighCardJasper: calls 1417
Manon947: folds 
color_singleton: folds 
dddocky: folds 
*** TURN *** [6s 2h 4d] [Qd]
Klemtonius: checks 
HighCardJasper: bets 2048
Klemtonius: folds 
Uncalled bet (2048) returned to HighCardJasper
HighCardJasper collected 4096 from pot
HighCardJasper: doesn't show hand 
*** SUMMARY ***
Total pot 4334 | Rake 238 
Board [6s 2h 4d Qd]
Seat 1: color_singleton (big blind) folded on the Flop
Seat 2: dddocky folded on the Flop
Seat 6: Klemtonius folded on the Turn
Seat 8: HighCardJasper (button) collected (4096)
Seat 9: Manon947 (small blind) folded on the Flop



PokerStars Home Game Hand #216488599586: {Club #3225207}  Hold'em No Limit (50/100) - 2020/07/16 16:05:19 ET
Table 'Fun times' 9-max (Play Money) Seat #9 is the button
Seat 1: color_singleton (9969 in chips) 
Seat 2: dddocky (16777 in chips) 
Seat 6: Klemtonius (8116 in chips) 
Seat 8: HighCardJasper (15674 in chips) 
Seat 9: Manon947 (4542 in chips) 
color_singleton: posts small blind 50
dddocky: posts big blind 100
*** HOLE CARDS ***
Dealt to Manon947 [3s 5s]
Klemtonius: calls 100
HighCardJasper: calls 100
Manon947: calls 100
color_singleton: raises 200 to 300
dddocky: folds 
Klemtonius: calls 200
HighCardJasper: calls 200
Manon947: folds 
*** FLOP *** [Ad Ks 8d]
color_singleton: bets 519
Klemtonius: folds 
HighCardJasper: folds 
Uncalled bet (519) returned to color_singleton
color_singleton collected 1039 from pot
color_singleton: doesn't show hand 
*** SUMMARY ***
Total pot 1100 | Rake 61 
Board [Ad Ks 8d]
Seat 1: color_singleton (small blind) collected (1039)
Seat 2: dddocky (big blind) folded before Flop
Seat 6: Klemtonius folded on the Flop
Seat 8: HighCardJasper folded on the Flop
Seat 9: Manon947 (button) folded before Flop



PokerStars Home Game Hand #216488629463: {Club #3225207}  Hold'em No Limit (50/100) - 2020/07/16 16:06:06 ET
Table 'Fun times' 9-max (Play Money) Seat #1 is the button
Seat 1: color_singleton (10708 in chips) 
Seat 2: dddocky (16677 in chips) 
Seat 6: Klemtonius (7816 in chips) 
Seat 8: HighCardJasper (15374 in chips) 
Seat 9: Manon947 (4442 in chips) 
dddocky: posts small blind 50
Klemtonius: posts big blind 100
*** HOLE CARDS ***
Dealt to Manon947 [Jh Qc]
HighCardJasper: raises 200 to 300
Manon947: calls 300
color_singleton: folds 
dddocky: calls 250
Klemtonius: folds 
*** FLOP *** [9c 9s 8c]
dddocky: checks 
HighCardJasper: bets 300
Manon947: folds 
dddocky: folds 
Uncalled bet (300) returned to HighCardJasper
HighCardJasper collected 945 from pot
HighCardJasper: doesn't show hand 
*** SUMMARY ***
Total pot 1000 | Rake 55 
Board [9c 9s 8c]
Seat 1: color_singleton (button) folded before Flop (didn't bet)
Seat 2: dddocky (small blind) folded on the Flop
Seat 6: Klemtonius (big blind) folded before Flop
Seat 8: HighCardJasper collected (945)
Seat 9: Manon947 folded on the Flop



PokerStars Home Game Hand #216488647625: {Club #3225207}  Hold'em No Limit (50/100) - 2020/07/16 16:06:35 ET
Table 'Fun times' 9-max (Play Money) Seat #2 is the button
Seat 1: color_singleton (10708 in chips) 
Seat 2: dddocky (16377 in chips) 
Seat 6: Klemtonius (7716 in chips) 
Seat 8: HighCardJasper (16019 in chips) 
Seat 9: Manon947 (4142 in chips) 
Klemtonius: posts small blind 50
HighCardJasper: posts big blind 100
*** HOLE CARDS ***
Dealt to Manon947 [8c 4d]
Manon947: folds 
color_singleton: raises 100 to 200
dddocky: folds 
Klemtonius: calls 150
HighCardJasper: calls 100
*** FLOP *** [3h 5s Qc]
Klemtonius: bets 567
HighCardJasper: folds 
color_singleton: folds 
Uncalled bet (567) returned to Klemtonius
Klemtonius collected 567 from pot
Klemtonius: doesn't show hand 
*** SUMMARY ***
Total pot 600 | Rake 33 
Board [3h 5s Qc]
Seat 1: color_singleton folded on the Flop
Seat 2: dddocky (button) folded before Flop (didn't bet)
Seat 6: Klemtonius (small blind) collected (567)
Seat 8: HighCardJasper (big blind) folded on the Flop
Seat 9: Manon947 folded before Flop (didn't bet)



PokerStars Home Game Hand #216488663792: {Club #3225207}  Hold'em No Limit (50/100) - 2020/07/16 16:07:01 ET
Table 'Fun times' 9-max (Play Money) Seat #6 is the button
Seat 1: color_singleton (10508 in chips) 
Seat 2: dddocky (16377 in chips) 
Seat 6: Klemtonius (8083 in chips) 
Seat 8: HighCardJasper (15819 in chips) 
Seat 9: Manon947 (4142 in chips) 
HighCardJasper: posts small blind 50
Manon947: posts big blind 100
*** HOLE CARDS ***
Dealt to Manon947 [6s 5d]
color_singleton: raises 100 to 200
dddocky: calls 200
Klemtonius: calls 200
HighCardJasper: calls 150
Manon947: folds 
*** FLOP *** [Ts 5s Qd]
HighCardJasper: checks 
color_singleton: checks 
dddocky: bets 850
Klemtonius: folds 
HighCardJasper: folds 
color_singleton: folds 
Uncalled bet (850) returned to dddocky
dddocky collected 850 from pot
dddocky: doesn't show hand 
*** SUMMARY ***
Total pot 900 | Rake 50 
Board [Ts 5s Qd]
Seat 1: color_singleton folded on the Flop
Seat 2: dddocky collected (850)
Seat 6: Klemtonius (button) folded on the Flop
Seat 8: HighCardJasper (small blind) folded on the Flop
Seat 9: Manon947 (big blind) folded before Flop



PokerStars Home Game Hand #216488680761: {Club #3225207}  Hold'em No Limit (50/100) - 2020/07/16 16:07:28 ET
Table 'Fun times' 9-max (Play Money) Seat #8 is the button
Seat 1: color_singleton (10308 in chips) 
Seat 2: dddocky (17027 in chips) 
Seat 6: Klemtonius (7883 in chips) 
Seat 8: HighCardJasper (15619 in chips) 
Seat 9: Manon947 (4042 in chips) 
Manon947: posts small blind 50
color_singleton: posts big blind 100
*** HOLE CARDS ***
Dealt to Manon947 [6d 4s]
dddocky: calls 100
Klemtonius: calls 100
HighCardJasper: raises 200 to 300
Manon947: folds 
color_singleton: calls 200
dddocky: calls 200
Klemtonius: calls 200
*** FLOP *** [6s 8d Kc]
color_singleton: checks 
dddocky: checks 
Klemtonius: checks 
HighCardJasper: checks 
*** TURN *** [6s 8d Kc] [Td]
color_singleton: checks 
dddocky: checks 
Klemtonius: checks 
HighCardJasper: checks 
*** RIVER *** [6s 8d Kc Td] [2s]
color_singleton: checks 
dddocky: checks 
Klemtonius: checks 
HighCardJasper: checks 
*** SHOW DOWN ***
color_singleton: shows [8s 3s] (a pair of Eights)
dddocky: mucks hand 
Klemtonius: mucks hand 
HighCardJasper: mucks hand 
color_singleton collected 1181 from pot
*** SUMMARY ***
Total pot 1250 | Rake 69 
Board [6s 8d Kc Td 2s]
Seat 1: color_singleton (big blind) showed [8s 3s] and won (1181) with a pair of Eights
Seat 2: dddocky mucked [6c Js]
Seat 6: Klemtonius mucked [Qs 5c]
Seat 8: HighCardJasper (button) mucked [Ac Jh]
Seat 9: Manon947 (small blind) folded before Flop



PokerStars Home Game Hand #216488724753: {Club #3225207}  Hold'em No Limit (50/100) - 2020/07/16 16:08:27 ET
Table 'Fun times' 9-max (Play Money) Seat #9 is the button
Seat 1: color_singleton (11189 in chips) 
Seat 2: dddocky (16727 in chips) 
Seat 6: Klemtonius (7583 in chips) 
Seat 8: HighCardJasper (15319 in chips) 
Seat 9: Manon947 (3992 in chips) 
color_singleton: posts small blind 50
dddocky: posts big blind 100
*** HOLE CARDS ***
Dealt to Manon947 [2s 7h]
Klemtonius: calls 100
HighCardJasper: calls 100
Manon947: folds 
color_singleton: calls 50
dddocky: checks 
*** FLOP *** [Jh Ah Td]
color_singleton: checks 
dddocky: bets 100
Klemtonius: folds 
HighCardJasper: calls 100
color_singleton: calls 100
*** TURN *** [Jh Ah Td] [Kc]
color_singleton: checks 
dddocky: checks 
HighCardJasper: checks 
*** RIVER *** [Jh Ah Td Kc] [3s]
color_singleton: bets 330
dddocky: folds 
HighCardJasper: raises 330 to 660
color_singleton: folds 
Uncalled bet (330) returned to HighCardJasper
HighCardJasper collected 1285 from pot
HighCardJasper: doesn't show hand 
*** SUMMARY ***
Total pot 1360 | Rake 75 
Board [Jh Ah Td Kc 3s]
Seat 1: color_singleton (small blind) folded on the River
Seat 2: dddocky (big blind) folded on the River
Seat 6: Klemtonius folded on the Flop
Seat 8: HighCardJasper collected (1285)
Seat 9: Manon947 (button) folded before Flop (didn't bet)



PokerStars Home Game Hand #216488757856: {Club #3225207}  Hold'em No Limit (50/100) - 2020/07/16 16:09:20 ET
Table 'Fun times' 9-max (Play Money) Seat #1 is the button
Seat 1: color_singleton (10659 in chips) 
Seat 2: dddocky (16527 in chips) 
Seat 6: Klemtonius (7483 in chips) 
Seat 8: HighCardJasper (16074 in chips) 
Seat 9: Manon947 (3992 in chips) 
dddocky: posts small blind 50
Klemtonius: posts big blind 100
*** HOLE CARDS ***
Dealt to Manon947 [2h Qh]
HighCardJasper: calls 100
Manon947: calls 100
color_singleton: calls 100
dddocky: calls 50
Klemtonius: checks 
*** FLOP *** [4d 5c 8s]
dddocky: checks 
Klemtonius: bets 100
HighCardJasper: calls 100
Manon947: folds 
color_singleton: calls 100
dddocky: folds 
*** TURN *** [4d 5c 8s] [Ac]
Klemtonius: bets 100
HighCardJasper: calls 100
color_singleton: calls 100
*** RIVER *** [4d 5c 8s Ac] [6d]
Klemtonius: bets 1039
HighCardJasper: folds 
color_singleton: folds 
Uncalled bet (1039) returned to Klemtonius
Klemtonius collected 1039 from pot
Klemtonius: doesn't show hand 
*** SUMMARY ***
Total pot 1100 | Rake 61 
Board [4d 5c 8s Ac 6d]
Seat 1: color_singleton (button) folded on the River
Seat 2: dddocky (small blind) folded on the Flop
Seat 6: Klemtonius (big blind) collected (1039)
Seat 8: HighCardJasper folded on the River
Seat 9: Manon947 folded on the Flop



PokerStars Home Game Hand #216488795107: {Club #3225207}  Hold'em No Limit (50/100) - 2020/07/16 16:10:18 ET
Table 'Fun times' 9-max (Play Money) Seat #2 is the button
Seat 1: color_singleton (10359 in chips) 
Seat 2: dddocky (16427 in chips) 
Seat 6: Klemtonius (8222 in chips) 
Seat 8: HighCardJasper (15774 in chips) 
Seat 9: Manon947 (3892 in chips) 
Klemtonius: posts small blind 50
HighCardJasper: posts big blind 100
*** HOLE CARDS ***
Dealt to Manon947 [3c Jd]
Manon947: calls 100
color_singleton: calls 100
dddocky: folds 
Klemtonius: calls 50
HighCardJasper: checks 
*** FLOP *** [Jc Js 3d]
Klemtonius: checks 
HighCardJasper: checks 
Manon947: bets 189
color_singleton: folds 
Klemtonius: folds 
HighCardJasper: calls 189
*** TURN *** [Jc Js 3d] [2s]
HighCardJasper: checks 
Manon947: bets 367
HighCardJasper: folds 
Uncalled bet (367) returned to Manon947
Manon947 collected 735 from pot
*** SUMMARY ***
Total pot 778 | Rake 43 
Board [Jc Js 3d 2s]
Seat 1: color_singleton folded on the Flop
Seat 2: dddocky (button) folded before Flop (didn't bet)
Seat 6: Klemtonius (small blind) folded on the Flop
Seat 8: HighCardJasper (big blind) folded on the Turn
Seat 9: Manon947 collected (735)



PokerStars Home Game Hand #216488828329: {Club #3225207}  Hold'em No Limit (50/100) - 2020/07/16 16:11:10 ET
Table 'Fun times' 9-max (Play Money) Seat #6 is the button
Seat 1: color_singleton (10259 in chips) 
Seat 2: dddocky (16427 in chips) 
Seat 6: Klemtonius (8122 in chips) 
Seat 8: HighCardJasper (15485 in chips) 
Seat 9: Manon947 (4338 in chips) 
HighCardJasper: posts small blind 50
Manon947: posts big blind 100
*** HOLE CARDS ***
Dealt to Manon947 [9h 4h]
color_singleton: folds 
dddocky: folds 
Klemtonius: calls 100
HighCardJasper: calls 50
Manon947: checks 
*** FLOP *** [7s 3d 6c]
HighCardJasper: checks 
Manon947: checks 
Klemtonius: checks 
*** TURN *** [7s 3d 6c] [Ad]
HighCardJasper: checks 
Manon947: checks 
Klemtonius has timed out
Klemtonius: checks 
*** RIVER *** [7s 3d 6c Ad] [Kd]
HighCardJasper: checks 
Manon947: checks 
Klemtonius: checks 
*** SHOW DOWN ***
HighCardJasper: shows [9c Tc] (high card Ace)
Manon947: mucks hand 
Klemtonius: shows [6h Qd] (a pair of Sixes)
Klemtonius collected 283 from pot
*** SUMMARY ***
Total pot 300 | Rake 17 
Board [7s 3d 6c Ad Kd]
Seat 1: color_singleton folded before Flop (didn't bet)
Seat 2: dddocky folded before Flop (didn't bet)
Seat 6: Klemtonius (button) showed [6h Qd] and won (283) with a pair of Sixes
Seat 8: HighCardJasper (small blind) showed [9c Tc] and lost with high card Ace
Seat 9: Manon947 (big blind) mucked [9h 4h]



PokerStars Home Game Hand #216488865059: {Club #3225207}  Hold'em No Limit (50/100) - 2020/07/16 16:12:08 ET
Table 'Fun times' 9-max (Play Money) Seat #8 is the button
Seat 1: color_singleton (10259 in chips) 
Seat 2: dddocky (16427 in chips) 
Seat 3: Duke Croix (14812 in chips) 
Seat 6: Klemtonius (8305 in chips) 
Seat 8: HighCardJasper (15385 in chips) 
Seat 9: Manon947 (4238 in chips) 
Manon947: posts small blind 50
color_singleton: posts big blind 100
Duke Croix: posts small & big blinds 150
*** HOLE CARDS ***
Dealt to Manon947 [Tc 3c]
dddocky: folds 
Duke Croix: checks 
Klemtonius: folds 
HighCardJasper: calls 100
Manon947: calls 50
color_singleton: checks 
*** FLOP *** [6c 5d Kd]
Manon947: checks 
color_singleton: checks 
Duke Croix: checks 
HighCardJasper: checks 
*** TURN *** [6c 5d Kd] [Qh]
Manon947: checks 
color_singleton: checks 
Duke Croix: checks 
HighCardJasper: checks 
*** RIVER *** [6c 5d Kd Qh] [8h]
Manon947: checks 
color_singleton: checks 
Duke Croix: bets 400
HighCardJasper: calls 400
Manon947: folds 
color_singleton: folds 
*** SHOW DOWN ***
Duke Croix: shows [6h Qc] (two pair, Queens and Sixes)
HighCardJasper: mucks hand 
Duke Croix collected 1181 from pot
*** SUMMARY ***
Total pot 1250 | Rake 69 
Board [6c 5d Kd Qh 8h]
Seat 1: color_singleton (big blind) folded on the River
Seat 2: dddocky folded before Flop (didn't bet)
Seat 3: Duke Croix showed [6h Qc] and won (1181) with two pair, Queens and Sixes
Seat 6: Klemtonius folded before Flop (didn't bet)
Seat 8: HighCardJasper (button) mucked [Ah 8d]
Seat 9: Manon947 (small blind) folded on the River



PokerStars Home Game Hand #216488903125: {Club #3225207}  Hold'em No Limit (50/100) - 2020/07/16 16:13:08 ET
Table 'Fun times' 9-max (Play Money) Seat #9 is the button
Seat 1: color_singleton (10159 in chips) 
Seat 2: dddocky (16427 in chips) 
Seat 3: Duke Croix (15443 in chips) 
Seat 6: Klemtonius (8305 in chips) 
Seat 8: HighCardJasper (14885 in chips) 
Seat 9: Manon947 (4138 in chips) 
color_singleton: posts small blind 50
dddocky: posts big blind 100
*** HOLE CARDS ***
Dealt to Manon947 [Kc 5h]
Duke Croix: raises 400 to 500
Klemtonius: folds 
HighCardJasper: folds 
Manon947: folds 
color_singleton: folds 
dddocky: calls 400
*** FLOP *** [Qh 4c 3s]
dddocky: bets 100
Duke Croix: raises 300 to 400
dddocky: calls 300
*** TURN *** [Qh 4c 3s] [7h]
dddocky: bets 100
Duke Croix: calls 100
*** RIVER *** [Qh 4c 3s 7h] [8c]
dddocky: checks 
Duke Croix: checks 
*** SHOW DOWN ***
dddocky: shows [Qs As] (a pair of Queens)
Duke Croix: mucks hand 
dddocky collected 1937 from pot
*** SUMMARY ***
Total pot 2050 | Rake 113 
Board [Qh 4c 3s 7h 8c]
Seat 1: color_singleton (small blind) folded before Flop
Seat 2: dddocky (big blind) showed [Qs As] and won (1937) with a pair of Queens
Seat 3: Duke Croix mucked [6s 6h]
Seat 6: Klemtonius folded before Flop (didn't bet)
Seat 8: HighCardJasper folded before Flop (didn't bet)
Seat 9: Manon947 (button) folded before Flop (didn't bet)



PokerStars Home Game Hand #216488932646: {Club #3225207}  Hold'em No Limit (50/100) - 2020/07/16 16:13:54 ET
Table 'Fun times' 9-max (Play Money) Seat #1 is the button
Seat 1: color_singleton (10109 in chips) 
Seat 2: dddocky (17364 in chips) 
Seat 3: Duke Croix (14443 in chips) 
Seat 6: Klemtonius (8305 in chips) 
Seat 8: HighCardJasper (14885 in chips) 
Seat 9: Manon947 (4138 in chips) 
dddocky: posts small blind 50
Duke Croix: posts big blind 100
*** HOLE CARDS ***
Dealt to Manon947 [6c 3d]
Klemtonius: calls 100
HighCardJasper: calls 100
Manon947: folds 
color_singleton: raises 100 to 200
dddocky: calls 150
Duke Croix: calls 100
Klemtonius: folds 
HighCardJasper: calls 100
*** FLOP *** [7d 8h 5d]
dddocky: checks 
Duke Croix: checks 
HighCardJasper: bets 100
color_singleton: calls 100
dddocky: calls 100
Duke Croix: calls 100
*** TURN *** [7d 8h 5d] [6s]
dddocky: checks 
Duke Croix: checks 
HighCardJasper: checks 
color_singleton has timed out
color_singleton: checks 
*** RIVER *** [7d 8h 5d 6s] [7h]
dddocky: checks 
Duke Croix: checks 
HighCardJasper: bets 1000
color_singleton: folds 
dddocky: calls 1000
Duke Croix: folds 
*** SHOW DOWN ***
HighCardJasper: shows [4s 9s] (a straight, Five to Nine)
dddocky: mucks hand 
HighCardJasper collected 3118 from pot
*** SUMMARY ***
Total pot 3300 | Rake 182 
Board [7d 8h 5d 6s 7h]
Seat 1: color_singleton (button) folded on the River
Seat 2: dddocky (small blind) mucked [Kd 7c]
Seat 3: Duke Croix (big blind) folded on the River
Seat 6: Klemtonius folded before Flop
Seat 8: HighCardJasper showed [4s 9s] and won (3118) with a straight, Five to Nine
Seat 9: Manon947 folded before Flop (didn't bet)



PokerStars Home Game Hand #216488994131: {Club #3225207}  Hold'em No Limit (50/100) - 2020/07/16 16:15:31 ET
Table 'Fun times' 9-max (Play Money) Seat #2 is the button
Seat 1: color_singleton (9809 in chips) 
Seat 2: dddocky (16064 in chips) 
Seat 3: Duke Croix (14143 in chips) 
Seat 6: Klemtonius (8205 in chips) 
Seat 8: HighCardJasper (16703 in chips) 
Seat 9: Manon947 (4138 in chips) 
Duke Croix: posts small blind 50
Klemtonius: posts big blind 100
*** HOLE CARDS ***
Dealt to Manon947 [Tc Ts]
HighCardJasper: calls 100
Manon947: calls 100
color_singleton: raises 200 to 300
dddocky: calls 300
Duke Croix: folds 
Klemtonius: calls 200
HighCardJasper: calls 200
Manon947: calls 200
*** FLOP *** [As 7h 5h]
Klemtonius: checks 
HighCardJasper: checks 
Manon947: bets 732
color_singleton: folds 
dddocky: calls 732
Klemtonius: raises 732 to 1464
HighCardJasper: folds 
Manon947: folds 
dddocky: folds 
Uncalled bet (732) returned to Klemtonius
Klemtonius collected 3540 from pot
Klemtonius: doesn't show hand 
*** SUMMARY ***
Total pot 3746 | Rake 206 
Board [As 7h 5h]
Seat 1: color_singleton folded on the Flop
Seat 2: dddocky (button) folded on the Flop
Seat 3: Duke Croix (small blind) folded before Flop
Seat 6: Klemtonius (big blind) collected (3540)
Seat 8: HighCardJasper folded on the Flop
Seat 9: Manon947 folded on the Flop



PokerStars Home Game Hand #216489033746: {Club #3225207}  Hold'em No Limit (50/100) - 2020/07/16 16:16:31 ET
Table 'Fun times' 9-max (Play Money) Seat #3 is the button
Seat 1: color_singleton (9509 in chips) 
Seat 2: dddocky (15032 in chips) 
Seat 3: Duke Croix (14093 in chips) 
Seat 6: Klemtonius (10713 in chips) 
Seat 8: HighCardJasper (16403 in chips) 
Seat 9: Manon947 (3106 in chips) 
Klemtonius: posts small blind 50
HighCardJasper: posts big blind 100
*** HOLE CARDS ***
Dealt to Manon947 [3h Tc]
Manon947: folds 
color_singleton: raises 200 to 300
dddocky: folds 
Duke Croix: folds 
Klemtonius: calls 250
HighCardJasper: calls 200
*** FLOP *** [6c 3c Th]
Klemtonius: checks 
HighCardJasper: checks 
color_singleton: checks 
*** TURN *** [6c 3c Th] [5c]
Klemtonius: checks 
HighCardJasper: checks 
color_singleton: checks 
*** RIVER *** [6c 3c Th 5c] [Kc]
Klemtonius: checks 
HighCardJasper: bets 500
color_singleton: folds 
Klemtonius: folds 
Uncalled bet (500) returned to HighCardJasper
HighCardJasper collected 850 from pot
HighCardJasper: doesn't show hand 
*** SUMMARY ***
Total pot 900 | Rake 50 
Board [6c 3c Th 5c Kc]
Seat 1: color_singleton folded on the River
Seat 2: dddocky folded before Flop (didn't bet)
Seat 3: Duke Croix (button) folded before Flop (didn't bet)
Seat 6: Klemtonius (small blind) folded on the River
Seat 8: HighCardJasper (big blind) collected (850)
Seat 9: Manon947 folded before Flop (didn't bet)



PokerStars Home Game Hand #216489098566: {Club #3225207}  Hold'em No Limit (50/100) - 2020/07/16 16:18:10 ET
Table 'Fun times' 9-max (Play Money) Seat #6 is the button
Seat 1: color_singleton (9209 in chips) 
Seat 2: dddocky (15032 in chips) 
Seat 3: Duke Croix (14093 in chips) 
Seat 6: Klemtonius (10413 in chips) 
Seat 8: HighCardJasper (16953 in chips) 
Seat 9: Manon947 (3106 in chips) 
HighCardJasper: posts small blind 50
Manon947: posts big blind 100
*** HOLE CARDS ***
Dealt to Manon947 [2h 4c]
color_singleton: folds 
dddocky: calls 100
Duke Croix: raises 500 to 600
Klemtonius: folds 
HighCardJasper: folds 
Manon947: folds 
dddocky: folds 
Uncalled bet (500) returned to Duke Croix
Duke Croix collected 350 from pot
Duke Croix: doesn't show hand 
*** SUMMARY ***
Total pot 350 | Rake 0 
Seat 1: color_singleton folded before Flop (didn't bet)
Seat 2: dddocky folded before Flop
Seat 3: Duke Croix collected (350)
Seat 6: Klemtonius (button) folded before Flop (didn't bet)
Seat 8: HighCardJasper (small blind) folded before Flop
Seat 9: Manon947 (big blind) folded before Flop



PokerStars Home Game Hand #216489116581: {Club #3225207}  Hold'em No Limit (50/100) - 2020/07/16 16:18:38 ET
Table 'Fun times' 9-max (Play Money) Seat #8 is the button
Seat 1: color_singleton (9209 in chips) 
Seat 2: dddocky (14932 in chips) 
Seat 3: Duke Croix (14343 in chips) 
Seat 6: Klemtonius (10413 in chips) 
Seat 8: HighCardJasper (16903 in chips) 
Seat 9: Manon947 (3006 in chips) 
Manon947: posts small blind 50
color_singleton: posts big blind 100
*** HOLE CARDS ***
Dealt to Manon947 [9s 4c]
dddocky: calls 100
Duke Croix: folds 
Klemtonius: calls 100
HighCardJasper: calls 100
Manon947: folds 
color_singleton: checks 
*** FLOP *** [Qc 2h 5h]
color_singleton: checks 
dddocky: checks 
Klemtonius: bets 234
HighCardJasper: calls 234
color_singleton: folds 
dddocky: calls 234
*** TURN *** [Qc 2h 5h] [3c]
dddocky: checks 
Klemtonius: bets 544
HighCardJasper: calls 544
dddocky: folds 
*** RIVER *** [Qc 2h 5h 3c] [9h]
Klemtonius: bets 1058
HighCardJasper: raises 1058 to 2116
Klemtonius: calls 1058
*** SHOW DOWN ***
HighCardJasper: shows [6d 4d] (a straight, Deuce to Six)
Klemtonius: mucks hand 
HighCardJasper collected 6116 from pot
*** SUMMARY ***
Total pot 6472 | Rake 356 
Board [Qc 2h 5h 3c 9h]
Seat 1: color_singleton (big blind) folded on the Flop
Seat 2: dddocky folded on the Turn
Seat 3: Duke Croix folded before Flop (didn't bet)
Seat 6: Klemtonius mucked [Tc Qh]
Seat 8: HighCardJasper (button) showed [6d 4d] and won (6116) with a straight, Deuce to Six
Seat 9: Manon947 (small blind) folded before Flop



PokerStars Home Game Hand #216489156612: {Club #3225207}  Hold'em No Limit (50/100) - 2020/07/16 16:19:39 ET
Table 'Fun times' 9-max (Play Money) Seat #9 is the button
Seat 1: color_singleton (9109 in chips) 
Seat 2: dddocky (14598 in chips) 
Seat 3: Duke Croix (14343 in chips) 
Seat 6: Klemtonius (7419 in chips) 
Seat 8: HighCardJasper (20025 in chips) 
Seat 9: Manon947 (2956 in chips) 
color_singleton: posts small blind 50
dddocky: posts big blind 100
*** HOLE CARDS ***
Dealt to Manon947 [8c 2h]
Duke Croix: calls 100
Klemtonius: calls 100
HighCardJasper: calls 100
Manon947: folds 
color_singleton: raises 300 to 400
dddocky: folds 
Duke Croix: calls 300
Klemtonius: calls 300
HighCardJasper: calls 300
*** FLOP *** [Ah 5h 9h]
color_singleton: bets 803
Duke Croix: calls 803
Klemtonius: folds 
HighCardJasper: folds 
*** TURN *** [Ah 5h 9h] [Ts]
color_singleton: checks 
Duke Croix: checks 
*** RIVER *** [Ah 5h 9h Ts] [9s]
color_singleton: checks 
Duke Croix: checks 
*** SHOW DOWN ***
color_singleton: shows [Kc Kd] (two pair, Kings and Nines)
Duke Croix: shows [Ad 3h] (two pair, Aces and Nines)
Duke Croix collected 3124 from pot
*** SUMMARY ***
Total pot 3306 | Rake 182 
Board [Ah 5h 9h Ts 9s]
Seat 1: color_singleton (small blind) showed [Kc Kd] and lost with two pair, Kings and Nines
Seat 2: dddocky (big blind) folded before Flop
Seat 3: Duke Croix showed [Ad 3h] and won (3124) with two pair, Aces and Nines
Seat 6: Klemtonius folded on the Flop
Seat 8: HighCardJasper folded on the Flop
Seat 9: Manon947 (button) folded before Flop (didn't bet)



PokerStars Home Game Hand #216489202597: {Club #3225207}  Hold'em No Limit (50/100) - 2020/07/16 16:20:49 ET
Table 'Fun times' 9-max (Play Money) Seat #1 is the button
Seat 1: color_singleton (7906 in chips) 
Seat 2: dddocky (14498 in chips) 
Seat 3: Duke Croix (16264 in chips) 
Seat 6: Klemtonius (7019 in chips) 
Seat 8: HighCardJasper (19625 in chips) 
Seat 9: Manon947 (2956 in chips) 
dddocky: posts small blind 50
Duke Croix: posts big blind 100
*** HOLE CARDS ***
Dealt to Manon947 [5h 2h]
Klemtonius: calls 100
HighCardJasper: calls 100
Manon947: calls 100
color_singleton: raises 200 to 300
dddocky: folds 
Duke Croix: calls 200
Klemtonius: folds 
HighCardJasper: calls 200
Manon947: raises 200 to 500
color_singleton: calls 200
Duke Croix: calls 200
HighCardJasper: calls 200
*** FLOP *** [5s Kc Jh]
Duke Croix: checks 
HighCardJasper: checks 
Manon947: checks 
color_singleton: checks 
*** TURN *** [5s Kc Jh] [5c]
Duke Croix: checks 
HighCardJasper: checks 
Manon947: bets 2032
color_singleton: folds 
Duke Croix: folds 
HighCardJasper: folds 
Uncalled bet (2032) returned to Manon947
Manon947 collected 2032 from pot
*** SUMMARY ***
Total pot 2150 | Rake 118 
Board [5s Kc Jh 5c]
Seat 1: color_singleton (button) folded on the Turn
Seat 2: dddocky (small blind) folded before Flop
Seat 3: Duke Croix (big blind) folded on the Turn
Seat 6: Klemtonius folded before Flop
Seat 8: HighCardJasper folded on the Turn
Seat 9: Manon947 collected (2032)



PokerStars Home Game Hand #216489264067: {Club #3225207}  Hold'em No Limit (50/100) - 2020/07/16 16:22:07 ET
Table 'Fun times' 9-max (Play Money) Seat #2 is the button
Seat 1: color_singleton (7406 in chips) 
Seat 2: dddocky (14448 in chips) 
Seat 3: Duke Croix (15764 in chips) 
Seat 6: Klemtonius (6919 in chips) 
Seat 8: HighCardJasper (19125 in chips) 
Seat 9: Manon947 (4488 in chips) 
Duke Croix: posts small blind 50
Klemtonius: posts big blind 100
*** HOLE CARDS ***
Dealt to Manon947 [6h Qh]
HighCardJasper: calls 100
Manon947: calls 100
color_singleton: folds 
dddocky: calls 100
Duke Croix: raises 300 to 400
Klemtonius: folds 
HighCardJasper: folds 
Manon947: calls 300
dddocky: calls 300
*** FLOP *** [4s Th Ad]
Duke Croix: bets 900
Manon947: folds 
dddocky: folds 
Uncalled bet (900) returned to Duke Croix
Duke Croix collected 1323 from pot
Duke Croix: doesn't show hand 
*** SUMMARY ***
Total pot 1400 | Rake 77 
Board [4s Th Ad]
Seat 1: color_singleton folded before Flop (didn't bet)
Seat 2: dddocky (button) folded on the Flop
Seat 3: Duke Croix (small blind) collected (1323)
Seat 6: Klemtonius (big blind) folded before Flop
Seat 8: HighCardJasper folded before Flop
Seat 9: Manon947 folded on the Flop



PokerStars Home Game Hand #216489297358: {Club #3225207}  Hold'em No Limit (50/100) - 2020/07/16 16:22:58 ET
Table 'Fun times' 9-max (Play Money) Seat #3 is the button
Seat 1: color_singleton (7406 in chips) 
Seat 2: dddocky (14048 in chips) 
Seat 3: Duke Croix (16687 in chips) 
Seat 6: Klemtonius (6819 in chips) 
Seat 8: HighCardJasper (19025 in chips) 
Seat 9: Manon947 (4088 in chips) 
Klemtonius: posts small blind 50
HighCardJasper: posts big blind 100
*** HOLE CARDS ***
Dealt to Manon947 [3h 3c]
Manon947: calls 100
color_singleton: folds 
dddocky: folds 
Duke Croix: calls 100
Klemtonius: calls 50
HighCardJasper: checks 
*** FLOP *** [2c 7s 4h]
Klemtonius: checks 
HighCardJasper: bets 200
Manon947: calls 200
Duke Croix: calls 200
Klemtonius: folds 
*** TURN *** [2c 7s 4h] [Ks]
HighCardJasper: checks 
Manon947: checks 
Duke Croix: bets 500
HighCardJasper: folds 
Manon947: folds 
Uncalled bet (500) returned to Duke Croix
Duke Croix collected 945 from pot
Duke Croix: doesn't show hand 
*** SUMMARY ***
Total pot 1000 | Rake 55 
Board [2c 7s 4h Ks]
Seat 1: color_singleton folded before Flop (didn't bet)
Seat 2: dddocky folded before Flop (didn't bet)
Seat 3: Duke Croix (button) collected (945)
Seat 6: Klemtonius (small blind) folded on the Flop
Seat 8: HighCardJasper (big blind) folded on the Turn
Seat 9: Manon947 folded on the Turn



PokerStars Home Game Hand #216489346305: {Club #3225207}  Hold'em No Limit (50/100) - 2020/07/16 16:24:13 ET
Table 'Fun times' 9-max (Play Money) Seat #6 is the button
Seat 1: color_singleton (7406 in chips) 
Seat 2: dddocky (14048 in chips) 
Seat 3: Duke Croix (17332 in chips) 
Seat 6: Klemtonius (6719 in chips) 
Seat 8: HighCardJasper (18725 in chips) 
Seat 9: Manon947 (3788 in chips) 
HighCardJasper: posts small blind 50
Manon947: posts big blind 100
*** HOLE CARDS ***
Dealt to Manon947 [Kd 4h]
color_singleton: folds 
dddocky: calls 100
Duke Croix: folds 
Klemtonius: calls 100
HighCardJasper: calls 50
Manon947: checks 
*** FLOP *** [Jc 7d Ts]
HighCardJasper: checks 
Manon947: checks 
dddocky: checks 
Klemtonius: checks 
*** TURN *** [Jc 7d Ts] [5d]
Mafak2020 joins the table at seat #7 
HighCardJasper: checks 
Manon947: checks 
dddocky: checks 
Klemtonius: checks 
*** RIVER *** [Jc 7d Ts 5d] [Ad]
HighCardJasper: checks 
Manon947: checks 
dddocky: checks 
Klemtonius: checks 
*** SHOW DOWN ***
HighCardJasper: shows [2c 4c] (high card Ace)
Manon947: shows [Kd 4h] (high card Ace - King kicker)
dddocky: mucks hand 
Klemtonius: shows [5h Kh] (a pair of Fives)
Klemtonius collected 378 from pot
*** SUMMARY ***
Total pot 400 | Rake 22 
Board [Jc 7d Ts 5d Ad]
Seat 1: color_singleton folded before Flop (didn't bet)
Seat 2: dddocky mucked [2s Qd]
Seat 3: Duke Croix folded before Flop (didn't bet)
Seat 6: Klemtonius (button) showed [5h Kh] and won (378) with a pair of Fives
Seat 8: HighCardJasper (small blind) showed [2c 4c] and lost with high card Ace
Seat 9: Manon947 (big blind) showed [Kd 4h] and lost with high card Ace



PokerStars Home Game Hand #216489404574: {Club #3225207}  Hold'em No Limit (50/100) - 2020/07/16 16:25:27 ET
Table 'Fun times' 9-max (Play Money) Seat #8 is the button
Seat 1: color_singleton (7406 in chips) 
Seat 2: dddocky (13948 in chips) 
Seat 3: Duke Croix (17332 in chips) 
Seat 6: Klemtonius (6997 in chips) 
Seat 7: Mafak2020 (10000 in chips) 
Seat 8: HighCardJasper (18625 in chips) 
Seat 9: Manon947 (3688 in chips) 
Manon947: posts small blind 50
color_singleton: posts big blind 100
Mafak2020: posts big blind 100
*** HOLE CARDS ***
Dealt to Manon947 [Js Ts]
dddocky: folds 
Duke Croix: folds 
Klemtonius: raises 344 to 444
Mafak2020: folds 
HighCardJasper: folds 
Manon947: calls 394
color_singleton: folds 
*** FLOP *** [3s 8h 7s]
Manon947: checks 
Klemtonius: bets 514
Manon947: calls 514
*** TURN *** [3s 8h 7s] [Qd]
Manon947: checks 
Klemtonius: bets 1000
Manon947 has timed out
Manon947: folds 
Uncalled bet (1000) returned to Klemtonius
Klemtonius collected 2000 from pot
Klemtonius: doesn't show hand 
*** SUMMARY ***
Total pot 2116 | Rake 116 
Board [3s 8h 7s Qd]
Seat 1: color_singleton (big blind) folded before Flop
Seat 2: dddocky folded before Flop (didn't bet)
Seat 3: Duke Croix folded before Flop (didn't bet)
Seat 6: Klemtonius collected (2000)
Seat 7: Mafak2020 folded before Flop (didn't bet)
Seat 8: HighCardJasper (button) folded before Flop (didn't bet)
Seat 9: Manon947 (small blind) folded on the Turn



PokerStars Home Game Hand #216489456868: {Club #3225207}  Hold'em No Limit (50/100) - 2020/07/16 16:26:47 ET
Table 'Fun times' 9-max (Play Money) Seat #9 is the button
Seat 1: color_singleton (7306 in chips) 
Seat 2: dddocky (13948 in chips) 
Seat 3: Duke Croix (17332 in chips) 
Seat 6: Klemtonius (8039 in chips) 
Seat 7: Mafak2020 (9900 in chips) 
Seat 8: HighCardJasper (18625 in chips) 
Seat 9: Manon947 (2730 in chips) 
color_singleton: posts small blind 50
dddocky: posts big blind 100
*** HOLE CARDS ***
Dealt to Manon947 [9c 3d]
Duke Croix: raises 300 to 400
Klemtonius: folds 
Mafak2020: folds 
HighCardJasper: calls 400
Manon947: folds 
color_singleton: calls 350
dddocky: calls 300
*** FLOP *** [7d 6d Qs]
color_singleton: checks 
dddocky: checks 
Duke Croix: bets 700
HighCardJasper: calls 700
color_singleton: calls 700
dddocky: calls 700
*** TURN *** [7d 6d Qs] [Td]
color_singleton: checks 
dddocky: checks 
Duke Croix: checks 
HighCardJasper: checks 
*** RIVER *** [7d 6d Qs Td] [6c]
color_singleton: checks 
dddocky: bets 100
Duke Croix: raises 1500 to 1600
HighCardJasper: calls 1600
color_singleton: folds 
dddocky: calls 1500
*** SHOW DOWN ***
Duke Croix: shows [Ad 5d] (a flush, Ace high)
HighCardJasper: mucks hand 
dddocky: mucks hand 
Duke Croix collected 8694 from pot
*** SUMMARY ***
Total pot 9200 | Rake 506 
Board [7d 6d Qs Td 6c]
Seat 1: color_singleton (small blind) folded on the River
Seat 2: dddocky (big blind) mucked [2d Kd]
Seat 3: Duke Croix showed [Ad 5d] and won (8694) with a flush, Ace high
Seat 6: Klemtonius folded before Flop (didn't bet)
Seat 7: Mafak2020 folded before Flop (didn't bet)
Seat 8: HighCardJasper mucked [Qd Jh]
Seat 9: Manon947 (button) folded before Flop (didn't bet)



PokerStars Home Game Hand #216489514060: {Club #3225207}  Hold'em No Limit (50/100) - 2020/07/16 16:28:15 ET
Table 'Fun times' 9-max (Play Money) Seat #1 is the button
Seat 1: color_singleton (6206 in chips) 
Seat 2: dddocky (11248 in chips) 
Seat 3: Duke Croix (23326 in chips) 
Seat 6: Klemtonius (8039 in chips) 
Seat 7: Mafak2020 (9900 in chips) 
Seat 8: HighCardJasper (15925 in chips) 
Seat 9: Manon947 (2730 in chips) 
dddocky: posts small blind 50
Duke Croix: posts big blind 100
*** HOLE CARDS ***
Dealt to Manon947 [Kc 2d]
Klemtonius: raises 100 to 200
Mafak2020: calls 200
HighCardJasper: calls 200
Manon947: calls 200
color_singleton: calls 200
dddocky: calls 150
Duke Croix: calls 100
*** FLOP *** [7s 3h 6h]
dddocky: checks 
Duke Croix: checks 
Klemtonius: checks 
Mafak2020: checks 
HighCardJasper: checks 
Manon947: checks 
color_singleton: checks 
*** TURN *** [7s 3h 6h] [8c]
dddocky has timed out
dddocky: checks 
Duke Croix: checks 
Klemtonius: checks 
Mafak2020: checks 
HighCardJasper: checks 
Manon947: checks 
color_singleton: checks 
*** RIVER *** [7s 3h 6h 8c] [5s]
dddocky: checks 
Duke Croix: checks 
Klemtonius: checks 
Mafak2020: checks 
HighCardJasper: checks 
Manon947: checks 
color_singleton: checks 
*** SHOW DOWN ***
dddocky: shows [Kh Td] (high card King)
Duke Croix: mucks hand 
Klemtonius: shows [6s Ks] (a pair of Sixes)
Mafak2020: mucks hand 
HighCardJasper: shows [2c 7d] (a pair of Sevens)
Manon947: mucks hand 
color_singleton: shows [5h 5d] (three of a kind, Fives)
color_singleton collected 1323 from pot
*** SUMMARY ***
Total pot 1400 | Rake 77 
Board [7s 3h 6h 8c 5s]
Seat 1: color_singleton (button) showed [5h 5d] and won (1323) with three of a kind, Fives
Seat 2: dddocky (small blind) showed [Kh Td] and lost with high card King
Seat 3: Duke Croix (big blind) mucked [Qs 2h]
Seat 6: Klemtonius showed [6s Ks] and lost with a pair of Sixes
Seat 7: Mafak2020 mucked [Jh Ts]
Seat 8: HighCardJasper showed [2c 7d] and lost with a pair of Sevens
Seat 9: Manon947 mucked [Kc 2d]



PokerStars Home Game Hand #216489584915: {Club #3225207}  Hold'em No Limit (50/100) - 2020/07/16 16:30:04 ET
Table 'Fun times' 9-max (Play Money) Seat #2 is the button
Seat 1: color_singleton (7329 in chips) 
Seat 2: dddocky (11048 in chips) 
Seat 3: Duke Croix (23126 in chips) 
Seat 6: Klemtonius (7839 in chips) 
Seat 7: Mafak2020 (9700 in chips) 
Seat 8: HighCardJasper (15725 in chips) 
Seat 9: Manon947 (2530 in chips) 
Duke Croix: posts small blind 50
Klemtonius: posts big blind 100
*** HOLE CARDS ***
Dealt to Manon947 [Kh 4c]
Mafak2020: raises 100 to 200
HighCardJasper: calls 200
Manon947: calls 200
color_singleton: calls 200
dddocky: calls 200
Duke Croix: folds 
Klemtonius: calls 100
*** FLOP *** [Td 9c 5s]
Klemtonius: bets 100
Mafak2020: raises 100 to 200
HighCardJasper: calls 200
Manon947: folds 
color_singleton: calls 200
dddocky: calls 200
Klemtonius: calls 100
*** TURN *** [Td 9c 5s] [Js]
Klemtonius: checks 
Mafak2020: checks 
HighCardJasper: checks 
color_singleton: bets 1063
dddocky: folds 
Klemtonius: calls 1063
Mafak2020: calls 1063
HighCardJasper: folds 
*** RIVER *** [Td 9c 5s Js] [Jc]
Klemtonius: checks 
Mafak2020: bets 800
color_singleton: calls 800
Klemtonius: folds 
*** SHOW DOWN ***
Mafak2020: shows [As Ac] (two pair, Aces and Jacks)
color_singleton: shows [Jd Kd] (three of a kind, Jacks)
color_singleton collected 6652 from pot
*** SUMMARY ***
Total pot 7039 | Rake 387 
Board [Td 9c 5s Js Jc]
Seat 1: color_singleton showed [Jd Kd] and won (6652) with three of a kind, Jacks
Seat 2: dddocky (button) folded on the Turn
Seat 3: Duke Croix (small blind) folded before Flop
Seat 6: Klemtonius (big blind) folded on the River
Seat 7: Mafak2020 showed [As Ac] and lost with two pair, Aces and Jacks
Seat 8: HighCardJasper folded on the Turn
Seat 9: Manon947 folded on the Flop



PokerStars Home Game Hand #216489644138: {Club #3225207}  Hold'em No Limit (50/100) - 2020/07/16 16:31:37 ET
Table 'Fun times' 9-max (Play Money) Seat #3 is the button
Seat 1: color_singleton (11718 in chips) 
Seat 2: dddocky (10648 in chips) 
Seat 3: Duke Croix (23076 in chips) 
Seat 6: Klemtonius (6376 in chips) 
Seat 7: Mafak2020 (7437 in chips) 
Seat 8: HighCardJasper (15325 in chips) 
Seat 9: Manon947 (2330 in chips) 
Klemtonius: posts small blind 50
Mafak2020: posts big blind 100
*** HOLE CARDS ***
Dealt to Manon947 [6h 2s]
HighCardJasper: calls 100
Manon947: folds 
color_singleton: raises 100 to 200
dddocky: calls 200
Duke Croix: calls 200
Klemtonius: calls 150
Mafak2020: folds 
HighCardJasper: calls 100
*** FLOP *** [5d 8c 6d]
Klemtonius: checks 
HighCardJasper: checks 
color_singleton: checks 
dddocky: checks 
Duke Croix: checks 
*** TURN *** [5d 8c 6d] [Qd]
Klemtonius: checks 
HighCardJasper: bets 200
color_singleton: raises 200 to 400
dddocky: calls 400
Duke Croix: calls 400
Klemtonius: folds 
HighCardJasper: calls 200
*** RIVER *** [5d 8c 6d Qd] [3h]
HighCardJasper: checks 
color_singleton: checks 
dddocky: bets 1275
Duke Croix: folds 
HighCardJasper: folds 
color_singleton: calls 1275
*** SHOW DOWN ***
dddocky: shows [Ad 4d] (a flush, Ace high)
color_singleton: mucks hand 
dddocky collected 4961 from pot
*** SUMMARY ***
Total pot 5250 | Rake 289 
Board [5d 8c 6d Qd 3h]
Seat 1: color_singleton mucked [Qc 9h]
Seat 2: dddocky showed [Ad 4d] and won (4961) with a flush, Ace high
Seat 3: Duke Croix (button) folded on the River
Seat 6: Klemtonius (small blind) folded on the Turn
Seat 7: Mafak2020 (big blind) folded before Flop
Seat 8: HighCardJasper folded on the River
Seat 9: Manon947 folded before Flop (didn't bet)



PokerStars Home Game Hand #216489706666: {Club #3225207}  Hold'em No Limit (50/100) - 2020/07/16 16:33:15 ET
Table 'Fun times' 9-max (Play Money) Seat #6 is the button
Seat 1: color_singleton (9843 in chips) 
Seat 2: dddocky (13734 in chips) 
Seat 3: Duke Croix (22476 in chips) 
Seat 6: Klemtonius (6176 in chips) 
Seat 7: Mafak2020 (7337 in chips) 
Seat 8: HighCardJasper (14725 in chips) 
Seat 9: Manon947 (2330 in chips) 
Mafak2020: posts small blind 50
HighCardJasper: posts big blind 100
*** HOLE CARDS ***
Dealt to Manon947 [3s 4s]
Manon947: calls 100
color_singleton: folds 
dddocky: calls 100
Duke Croix: raises 400 to 500
Klemtonius: folds 
Mafak2020: folds 
HighCardJasper: folds 
Manon947: folds 
dddocky: folds 
Uncalled bet (400) returned to Duke Croix
Duke Croix collected 450 from pot
Duke Croix: doesn't show hand 
*** SUMMARY ***
Total pot 450 | Rake 0 
Seat 1: color_singleton folded before Flop (didn't bet)
Seat 2: dddocky folded before Flop
Seat 3: Duke Croix collected (450)
Seat 6: Klemtonius (button) folded before Flop (didn't bet)
Seat 7: Mafak2020 (small blind) folded before Flop
Seat 8: HighCardJasper (big blind) folded before Flop
Seat 9: Manon947 folded before Flop



PokerStars Home Game Hand #216489727670: {Club #3225207}  Hold'em No Limit (50/100) - 2020/07/16 16:33:47 ET
Table 'Fun times' 9-max (Play Money) Seat #7 is the button
Seat 1: color_singleton (9843 in chips) 
Seat 2: dddocky (13634 in chips) 
Seat 3: Duke Croix (22826 in chips) 
Seat 6: Klemtonius (6176 in chips) 
Seat 7: Mafak2020 (7287 in chips) 
Seat 8: HighCardJasper (14625 in chips) 
Seat 9: Manon947 (2230 in chips) 
HighCardJasper: posts small blind 50
Manon947: posts big blind 100
*** HOLE CARDS ***
Dealt to Manon947 [9c Qs]
color_singleton: folds 
dddocky: calls 100
Duke Croix: raises 300 to 400
Klemtonius: folds 
Mafak2020: raises 300 to 700
HighCardJasper: folds 
Manon947: folds 
dddocky: folds 
Duke Croix: folds 
Uncalled bet (300) returned to Mafak2020
Mafak2020 collected 1050 from pot
Mafak2020: doesn't show hand 
*** SUMMARY ***
Total pot 1050 | Rake 0 
Seat 1: color_singleton folded before Flop (didn't bet)
Seat 2: dddocky folded before Flop
Seat 3: Duke Croix folded before Flop
Seat 6: Klemtonius folded before Flop (didn't bet)
Seat 7: Mafak2020 (button) collected (1050)
Seat 8: HighCardJasper (small blind) folded before Flop
Seat 9: Manon947 (big blind) folded before Flop



PokerStars Home Game Hand #216489747080: {Club #3225207}  Hold'em No Limit (50/100) - 2020/07/16 16:34:18 ET
Table 'Fun times' 9-max (Play Money) Seat #8 is the button
Seat 1: color_singleton (9843 in chips) 
Seat 2: dddocky (13534 in chips) 
Seat 3: Duke Croix (22426 in chips) 
Seat 6: Klemtonius (6176 in chips) 
Seat 7: Mafak2020 (7937 in chips) 
Seat 8: HighCardJasper (14575 in chips) 
Seat 9: Manon947 (2130 in chips) 
Manon947: posts small blind 50
color_singleton: posts big blind 100
*** HOLE CARDS ***
Dealt to Manon947 [Ts Ah]
dddocky: folds 
Duke Croix: folds 
Klemtonius: calls 100
Mafak2020: calls 100
HighCardJasper: calls 100
Manon947: calls 50
color_singleton: checks 
*** FLOP *** [5s 6c 5c]
Manon947: checks 
color_singleton: checks 
Klemtonius: checks 
Mafak2020: bets 600
HighCardJasper: folds 
Manon947: folds 
color_singleton: calls 600
Klemtonius: folds 
*** TURN *** [5s 6c 5c] [Jc]
color_singleton: checks 
Mafak2020: bets 500
color_singleton: folds 
Uncalled bet (500) returned to Mafak2020
Mafak2020 collected 1606 from pot
Mafak2020: doesn't show hand 
*** SUMMARY ***
Total pot 1700 | Rake 94 
Board [5s 6c 5c Jc]
Seat 1: color_singleton (big blind) folded on the Turn
Seat 2: dddocky folded before Flop (didn't bet)
Seat 3: Duke Croix folded before Flop (didn't bet)
Seat 6: Klemtonius folded on the Flop
Seat 7: Mafak2020 collected (1606)
Seat 8: HighCardJasper (button) folded on the Flop
Seat 9: Manon947 (small blind) folded on the Flop



PokerStars Home Game Hand #216489790916: {Club #3225207}  Hold'em No Limit (50/100) - 2020/07/16 16:35:26 ET
Table 'Fun times' 9-max (Play Money) Seat #9 is the button
Seat 1: color_singleton (9143 in chips) 
Seat 2: dddocky (13534 in chips) 
Seat 3: Duke Croix (22426 in chips) 
Seat 6: Klemtonius (6076 in chips) 
Seat 7: Mafak2020 (8843 in chips) 
Seat 8: HighCardJasper (14475 in chips) 
Seat 9: Manon947 (2030 in chips) 
color_singleton: posts small blind 50
dddocky: posts big blind 100
*** HOLE CARDS ***
Dealt to Manon947 [5h 6d]
Duke Croix: folds 
Klemtonius: calls 100
Mafak2020: calls 100
HighCardJasper: calls 100
Manon947: folds 
color_singleton: calls 50
dddocky: checks 
*** FLOP *** [Kh 3c Ac]
color_singleton: checks 
dddocky: checks 
Klemtonius: bets 100
Mafak2020: calls 100
HighCardJasper: calls 100
color_singleton: folds 
dddocky: folds 
*** TURN *** [Kh 3c Ac] [Jh]
Klemtonius: bets 378
Mafak2020: folds 
HighCardJasper: calls 378
*** RIVER *** [Kh 3c Ac Jh] [Qd]
Klemtonius: checks 
HighCardJasper: checks 
*** SHOW DOWN ***
Klemtonius: shows [Kc 7d] (a pair of Kings)
HighCardJasper: shows [Ah 8s] (a pair of Aces)
HighCardJasper collected 1470 from pot
*** SUMMARY ***
Total pot 1556 | Rake 86 
Board [Kh 3c Ac Jh Qd]
Seat 1: color_singleton (small blind) folded on the Flop
Seat 2: dddocky (big blind) folded on the Flop
Seat 3: Duke Croix folded before Flop (didn't bet)
Seat 6: Klemtonius showed [Kc 7d] and lost with a pair of Kings
Seat 7: Mafak2020 folded on the Turn
Seat 8: HighCardJasper showed [Ah 8s] and won (1470) with a pair of Aces
Seat 9: Manon947 (button) folded before Flop (didn't bet)



PokerStars Home Game Hand #216489839807: {Club #3225207}  Hold'em No Limit (50/100) - 2020/07/16 16:36:42 ET
Table 'Fun times' 9-max (Play Money) Seat #1 is the button
Seat 1: color_singleton (9043 in chips) 
Seat 2: dddocky (13434 in chips) 
Seat 3: Duke Croix (22426 in chips) 
Seat 6: Klemtonius (5498 in chips) 
Seat 7: Mafak2020 (8643 in chips) 
Seat 8: HighCardJasper (15367 in chips) 
Seat 9: Manon947 (2030 in chips) 
dddocky: posts small blind 50
Duke Croix: posts big blind 100
*** HOLE CARDS ***
Dealt to Manon947 [4h Ks]
Klemtonius: folds 
Mafak2020: calls 100
HighCardJasper: calls 100
Manon947: calls 100
color_singleton: calls 100
dddocky: calls 50
Duke Croix: checks 
*** FLOP *** [Kh 3c 4s]
dddocky: checks 
Duke Croix: checks 
Mafak2020: checks 
HighCardJasper: checks 
Manon947: bets 283
color_singleton: calls 283
dddocky: folds 
Duke Croix: folds 
Mafak2020: folds 
HighCardJasper: calls 283
*** TURN *** [Kh 3c 4s] [7c]
HighCardJasper: checks 
Manon947: bets 684
color_singleton: folds 
HighCardJasper: folds 
Uncalled bet (684) returned to Manon947
Manon947 collected 1369 from pot
*** SUMMARY ***
Total pot 1449 | Rake 80 
Board [Kh 3c 4s 7c]
Seat 1: color_singleton (button) folded on the Turn
Seat 2: dddocky (small blind) folded on the Flop
Seat 3: Duke Croix (big blind) folded on the Flop
Seat 6: Klemtonius folded before Flop (didn't bet)
Seat 7: Mafak2020 folded on the Flop
Seat 8: HighCardJasper folded on the Turn
Seat 9: Manon947 collected (1369)



PokerStars Home Game Hand #216489894604: {Club #3225207}  Hold'em No Limit (50/100) - 2020/07/16 16:38:08 ET
Table 'Fun times' 9-max (Play Money) Seat #2 is the button
Seat 1: color_singleton (8660 in chips) 
Seat 2: dddocky (13334 in chips) 
Seat 3: Duke Croix (22326 in chips) 
Seat 6: Klemtonius (5498 in chips) 
Seat 7: Mafak2020 (8543 in chips) 
Seat 8: HighCardJasper (14984 in chips) 
Seat 9: Manon947 (3016 in chips) 
Duke Croix: posts small blind 50
Klemtonius: posts big blind 100
*** HOLE CARDS ***
Dealt to Manon947 [Ac 4c]
Mafak2020 has timed out
Mafak2020: folds 
HighCardJasper: raises 200 to 300
Manon947: calls 300
color_singleton: calls 300
dddocky: folds 
Duke Croix: folds 
Klemtonius: calls 200
*** FLOP *** [2d 9c 7c]
Klemtonius: checks 
HighCardJasper: checks 
Manon947: checks 
color_singleton: checks 
*** TURN *** [2d 9c 7c] [3s]
Klemtonius: checks 
HighCardJasper: checks 
Manon947: checks 
color_singleton: checks 
*** RIVER *** [2d 9c 7c 3s] [Jd]
Klemtonius: bets 1181
HighCardJasper: folds 
Manon947: raises 1181 to 2362
color_singleton: folds 
Klemtonius: calls 1181
*** SHOW DOWN ***
Manon947: shows [Ac 4c] (high card Ace)
Klemtonius: shows [Jc Ts] (a pair of Jacks)
Klemtonius collected 5645 from pot
*** SUMMARY ***
Total pot 5974 | Rake 329 
Board [2d 9c 7c 3s Jd]
Seat 1: color_singleton folded on the River
Seat 2: dddocky (button) folded before Flop (didn't bet)
Seat 3: Duke Croix (small blind) folded before Flop
Seat 6: Klemtonius (big blind) showed [Jc Ts] and won (5645) with a pair of Jacks
Seat 7: Mafak2020 folded before Flop (didn't bet)
Seat 8: HighCardJasper folded on the River
Seat 9: Manon947 showed [Ac 4c] and lost with high card Ace



PokerStars Home Game Hand #216489946237: {Club #3225207}  Hold'em No Limit (50/100) - 2020/07/16 16:39:29 ET
Table 'Fun times' 9-max (Play Money) Seat #3 is the button
Seat 1: color_singleton (8360 in chips) 
Seat 2: dddocky (13334 in chips) 
Seat 3: Duke Croix (22276 in chips) 
Seat 6: Klemtonius (8481 in chips) 
Seat 7: Mafak2020 (8543 in chips) 
Seat 8: HighCardJasper (14684 in chips) 
Seat 9: Manon947 (354 in chips) 
Klemtonius: posts small blind 50
Mafak2020: posts big blind 100
*** HOLE CARDS ***
Dealt to Manon947 [Jh 8h]
HighCardJasper: calls 100
Manon947: calls 100
color_singleton: raises 100 to 200
dddocky: calls 200
Duke Croix: calls 200
Klemtonius: calls 150
Mafak2020: calls 100
HighCardJasper: calls 100
Manon947: calls 100
*** FLOP *** [8c 3h Qd]
Klemtonius: checks 
Mafak2020: bets 200
HighCardJasper: calls 200
Manon947: folds 
color_singleton: calls 200
dddocky: folds 
Duke Croix: folds 
Klemtonius: folds 
*** TURN *** [8c 3h Qd] [Jd]
Mafak2020: checks 
HighCardJasper: checks 
color_singleton: bets 945
Mafak2020: folds 
HighCardJasper: folds 
Uncalled bet (945) returned to color_singleton
color_singleton collected 1890 from pot
color_singleton: doesn't show hand 
*** SUMMARY ***
Total pot 2000 | Rake 110 
Board [8c 3h Qd Jd]
Seat 1: color_singleton collected (1890)
Seat 2: dddocky folded on the Flop
Seat 3: Duke Croix (button) folded on the Flop
Seat 6: Klemtonius (small blind) folded on the Flop
Seat 7: Mafak2020 (big blind) folded on the Turn
Seat 8: HighCardJasper folded on the Turn
Seat 9: Manon947 folded on the Flop



PokerStars Home Game Hand #216489997875: {Club #3225207}  Hold'em No Limit (50/100) - 2020/07/16 16:40:50 ET
Table 'Fun times' 9-max (Play Money) Seat #6 is the button
Seat 1: color_singleton (9850 in chips) 
Seat 2: dddocky (13134 in chips) 
Seat 3: Duke Croix (22076 in chips) 
Seat 6: Klemtonius (8281 in chips) 
Seat 7: Mafak2020 (8143 in chips) 
Seat 8: HighCardJasper (14284 in chips) 
Seat 9: Manon947 (154 in chips) 
Mafak2020: posts small blind 50
HighCardJasper: posts big blind 100
*** HOLE CARDS ***
Dealt to Manon947 [4h 5s]
Manon947: folds 
color_singleton: folds 
dddocky: calls 100
Duke Croix: folds 
Klemtonius: calls 100
Mafak2020: calls 50
HighCardJasper: checks 
*** FLOP *** [Kh Qs 7s]
Mafak2020: checks 
HighCardJasper: checks 
dddocky: checks 
Klemtonius: bets 378
Mafak2020: folds 
HighCardJasper: folds 
dddocky: folds 
Uncalled bet (378) returned to Klemtonius
Klemtonius collected 378 from pot
Klemtonius: doesn't show hand 
*** SUMMARY ***
Total pot 400 | Rake 22 
Board [Kh Qs 7s]
Seat 1: color_singleton folded before Flop (didn't bet)
Seat 2: dddocky folded on the Flop
Seat 3: Duke Croix folded before Flop (didn't bet)
Seat 6: Klemtonius (button) collected (378)
Seat 7: Mafak2020 (small blind) folded on the Flop
Seat 8: HighCardJasper (big blind) folded on the Flop
Seat 9: Manon947 folded before Flop (didn't bet)



PokerStars Home Game Hand #216490028260: {Club #3225207}  Hold'em No Limit (50/100) - 2020/07/16 16:41:38 ET
Table 'Fun times' 9-max (Play Money) Seat #7 is the button
Seat 1: color_singleton (9850 in chips) 
Seat 2: dddocky (13034 in chips) 
Seat 3: Duke Croix (22076 in chips) 
Seat 6: Klemtonius (8559 in chips) 
Seat 7: Mafak2020 (8043 in chips) 
Seat 8: HighCardJasper (14184 in chips) 
Seat 9: Manon947 (154 in chips) 
HighCardJasper: posts small blind 50
Manon947: posts big blind 100
*** HOLE CARDS ***
Dealt to Manon947 [7h 2c]
color_singleton: folds 
dddocky: calls 100
Duke Croix: folds 
Klemtonius: calls 100
Mafak2020: calls 100
HighCardJasper: raises 100 to 200
Manon947: folds 
dddocky: calls 100
Klemtonius: calls 100
Mafak2020: calls 100
*** FLOP *** [8s 4s Kd]
HighCardJasper: checks 
dddocky: checks 
Klemtonius: bets 100
Mafak2020: calls 100
HighCardJasper: calls 100
dddocky: calls 100
*** TURN *** [8s 4s Kd] [9d]
HighCardJasper: checks 
dddocky: checks 
Klemtonius: checks 
Mafak2020: checks 
*** RIVER *** [8s 4s Kd 9d] [6s]
HighCardJasper: checks 
dddocky: checks 
Klemtonius: checks 
Mafak2020: checks 
*** SHOW DOWN ***
HighCardJasper: shows [4d Ah] (a pair of Fours)
dddocky: mucks hand 
Klemtonius: shows [7c 6d] (a pair of Sixes)
Mafak2020: mucks hand 
Klemtonius collected 1228 from pot
*** SUMMARY ***
Total pot 1300 | Rake 72 
Board [8s 4s Kd 9d 6s]
Seat 1: color_singleton folded before Flop (didn't bet)
Seat 2: dddocky mucked [Qh As]
Seat 3: Duke Croix folded before Flop (didn't bet)
Seat 6: Klemtonius showed [7c 6d] and won (1228) with a pair of Sixes
Seat 7: Mafak2020 (button) mucked [Ac 3d]
Seat 8: HighCardJasper (small blind) showed [4d Ah] and lost with a pair of Fours
Seat 9: Manon947 (big blind) folded before Flop



PokerStars Home Game Hand #216490118916: {Club #3225207}  Hold'em No Limit (50/100) - 2020/07/16 16:44:03 ET
Table 'Fun times' 9-max (Play Money) Seat #1 is the button
Seat 1: color_singleton (9800 in chips) 
Seat 2: dddocky (14686 in chips) 
Seat 3: Duke Croix (22076 in chips) 
Seat 6: Klemtonius (7559 in chips) 
Seat 7: Mafak2020 (7743 in chips) 
Seat 8: HighCardJasper (13684 in chips) 
Seat 9: Manon947 (5438 in chips) 
dddocky: posts small blind 50
Duke Croix: posts big blind 100
Manon947: posts small blind 50
*** HOLE CARDS ***
Dealt to Manon947 [Ts Jd]
Klemtonius: calls 100
Mafak2020: calls 100
HighCardJasper: calls 100
Manon947: calls 100
color_singleton: folds 
dddocky: calls 50
Duke Croix: raises 100 to 200
Klemtonius: calls 100
Mafak2020: calls 100
HighCardJasper: calls 100
Manon947: calls 100
dddocky: calls 100
*** FLOP *** [7c 8c 2h]
dddocky: checks 
Duke Croix: bets 700
Klemtonius: folds 
Mafak2020: folds 
HighCardJasper: folds 
Manon947: folds 
dddocky: folds 
Uncalled bet (700) returned to Duke Croix
Duke Croix collected 1181 from pot
Duke Croix: doesn't show hand 
*** SUMMARY ***
Total pot 1250 | Rake 69 
Board [7c 8c 2h]
Seat 1: color_singleton (button) folded before Flop (didn't bet)
Seat 2: dddocky (small blind) folded on the Flop
Seat 3: Duke Croix (big blind) collected (1181)
Seat 6: Klemtonius folded on the Flop
Seat 7: Mafak2020 folded on the Flop
Seat 8: HighCardJasper folded on the Flop
Seat 9: Manon947 folded on the Flop



PokerStars Home Game Hand #216490209620: {Club #3225207}  Hold'em No Limit (50/100) - 2020/07/16 16:46:27 ET
Table 'Fun times' 9-max (Play Money) Seat #3 is the button
Seat 1: color_singleton (9400 in chips) 
Seat 2: dddocky (15929 in chips) 
Seat 3: Duke Croix (23007 in chips) 
Seat 6: Klemtonius (7059 in chips) 
Seat 7: Mafak2020 (7143 in chips) 
Seat 8: HighCardJasper (13084 in chips) 
Seat 9: Manon947 (10000 in chips) 
Klemtonius: posts small blind 50
Mafak2020: posts big blind 100
Manon947: posts big blind 100
*** HOLE CARDS ***
Dealt to Manon947 [Ts Jc]
HighCardJasper: calls 100
Manon947: checks 
color_singleton: calls 100
dddocky: calls 100
Duke Croix: calls 100
Klemtonius: calls 50
Mafak2020: checks 
*** FLOP *** [4c Ah Qd]
Klemtonius: checks 
Mafak2020: checks 
HighCardJasper: checks 
Manon947: checks 
color_singleton: checks 
dddocky: checks 
Duke Croix: checks 
*** TURN *** [4c Ah Qd] [Ad]
Klemtonius: checks 
Mafak2020: checks 
HighCardJasper: checks 
Manon947: checks 
color_singleton: checks 
dddocky: checks 
Duke Croix: bets 400
Klemtonius: folds 
Mafak2020: calls 400
HighCardJasper: folds 
Manon947: folds 
color_singleton: folds 
dddocky: folds 
*** RIVER *** [4c Ah Qd Ad] [Qh]
Mafak2020: checks 
Duke Croix: bets 700
Mafak2020: folds 
Uncalled bet (700) returned to Duke Croix
Duke Croix collected 1417 from pot
Duke Croix: doesn't show hand 
*** SUMMARY ***
Total pot 1500 | Rake 83 
Board [4c Ah Qd Ad Qh]
Seat 1: color_singleton folded on the Turn
Seat 2: dddocky folded on the Turn
Seat 3: Duke Croix (button) collected (1417)
Seat 6: Klemtonius (small blind) folded on the Turn
Seat 7: Mafak2020 (big blind) folded on the River
Seat 8: HighCardJasper folded on the Turn
Seat 9: Manon947 folded on the Turn (didn't bet)



PokerStars Home Game Hand #216490276810: {Club #3225207}  Hold'em No Limit (50/100) - 2020/07/16 16:48:13 ET
Table 'Fun times' 9-max (Play Money) Seat #6 is the button
Seat 1: color_singleton (9300 in chips) 
Seat 2: dddocky (15829 in chips) 
Seat 3: Duke Croix (23924 in chips) 
Seat 6: Klemtonius (6959 in chips) 
Seat 7: Mafak2020 (6643 in chips) 
Seat 8: HighCardJasper (12984 in chips) 
Seat 9: Manon947 (9900 in chips) 
Mafak2020: posts small blind 50
HighCardJasper: posts big blind 100
*** HOLE CARDS ***
Dealt to Manon947 [Qh 3d]
Manon947: calls 100
color_singleton: folds 
dddocky: folds 
Duke Croix: calls 100
Klemtonius: calls 100
Mafak2020: calls 50
HighCardJasper: checks 
*** FLOP *** [4h Td As]
Mafak2020: checks 
HighCardJasper: checks 
Manon947: checks 
Duke Croix: checks 
Klemtonius: bets 432
Mafak2020: folds 
HighCardJasper: folds 
Manon947: folds 
Duke Croix: folds 
Uncalled bet (432) returned to Klemtonius
Klemtonius collected 472 from pot
Klemtonius: doesn't show hand 
*** SUMMARY ***
Total pot 500 | Rake 28 
Board [4h Td As]
Seat 1: color_singleton folded before Flop (didn't bet)
Seat 2: dddocky folded before Flop (didn't bet)
Seat 3: Duke Croix folded on the Flop
Seat 6: Klemtonius (button) collected (472)
Seat 7: Mafak2020 (small blind) folded on the Flop
Seat 8: HighCardJasper (big blind) folded on the Flop
Seat 9: Manon947 folded on the Flop



PokerStars Home Game Hand #216490302884: {Club #3225207}  Hold'em No Limit (50/100) - 2020/07/16 16:48:54 ET
Table 'Fun times' 9-max (Play Money) Seat #7 is the button
Seat 1: color_singleton (9300 in chips) 
Seat 2: dddocky (15829 in chips) 
Seat 3: Duke Croix (23824 in chips) 
Seat 6: Klemtonius (7331 in chips) 
Seat 7: Mafak2020 (6543 in chips) 
Seat 8: HighCardJasper (12884 in chips) 
Seat 9: Manon947 (9800 in chips) 
HighCardJasper: posts small blind 50
Manon947: posts big blind 100
*** HOLE CARDS ***
Dealt to Manon947 [5c 6d]
color_singleton: raises 100 to 200
dddocky: calls 200
Duke Croix: calls 200
Klemtonius: calls 200
Mafak2020: calls 200
HighCardJasper: calls 150
Manon947: folds 
*** FLOP *** [4h 3d Qh]
HighCardJasper: checks 
color_singleton: bets 1228
dddocky: folds 
Duke Croix: folds 
Klemtonius: folds 
Mafak2020: folds 
HighCardJasper: folds 
Uncalled bet (1228) returned to color_singleton
color_singleton collected 1228 from pot
color_singleton: doesn't show hand 
*** SUMMARY ***
Total pot 1300 | Rake 72 
Board [4h 3d Qh]
Seat 1: color_singleton collected (1228)
Seat 2: dddocky folded on the Flop
Seat 3: Duke Croix folded on the Flop
Seat 6: Klemtonius folded on the Flop
Seat 7: Mafak2020 (button) folded on the Flop
Seat 8: HighCardJasper (small blind) folded on the Flop
Seat 9: Manon947 (big blind) folded before Flop



PokerStars Home Game Hand #216490331736: {Club #3225207}  Hold'em No Limit (50/100) - 2020/07/16 16:49:40 ET
Table 'Fun times' 9-max (Play Money) Seat #8 is the button
Seat 1: color_singleton (10328 in chips) 
Seat 2: dddocky (15629 in chips) 
Seat 3: Duke Croix (23624 in chips) 
Seat 6: Klemtonius (7131 in chips) 
Seat 7: Mafak2020 (6343 in chips) 
Seat 8: HighCardJasper (12684 in chips) 
Seat 9: Manon947 (9700 in chips) 
Manon947: posts small blind 50
color_singleton: posts big blind 100
*** HOLE CARDS ***
Dealt to Manon947 [4c 6c]
dddocky: calls 100
Duke Croix: folds 
Klemtonius: folds 
Mafak2020: raises 100 to 200
HighCardJasper: calls 200
Manon947: calls 150
color_singleton: calls 100
dddocky: calls 100
*** FLOP *** [4d Jc 5c]
Manon947: checks 
color_singleton: checks 
dddocky: bets 100
Mafak2020: calls 100
HighCardJasper: calls 100
Manon947: calls 100
color_singleton: folds 
*** TURN *** [4d Jc 5c] [3d]
Manon947: checks 
dddocky: checks 
Mafak2020: checks 
HighCardJasper: checks 
*** RIVER *** [4d Jc 5c 3d] [Kc]
Manon947: bets 661
dddocky: folds 
Mafak2020: raises 661 to 1322
HighCardJasper: folds 
Manon947: calls 661
*** SHOW DOWN ***
Mafak2020: shows [Kd Qs] (a pair of Kings)
Manon947: shows [4c 6c] (a flush, King high)
Manon947 collected 3822 from pot
*** SUMMARY ***
Total pot 4044 | Rake 222 
Board [4d Jc 5c 3d Kc]
Seat 1: color_singleton (big blind) folded on the Flop
Seat 2: dddocky folded on the River
Seat 3: Duke Croix folded before Flop (didn't bet)
Seat 6: Klemtonius folded before Flop (didn't bet)
Seat 7: Mafak2020 showed [Kd Qs] and lost with a pair of Kings
Seat 8: HighCardJasper (button) folded on the River
Seat 9: Manon947 (small blind) showed [4c 6c] and won (3822) with a flush, King high



PokerStars Home Game Hand #216490373844: {Club #3225207}  Hold'em No Limit (50/100) - 2020/07/16 16:50:46 ET
Table 'Fun times' 9-max (Play Money) Seat #9 is the button
Seat 1: color_singleton (10128 in chips) 
Seat 2: dddocky (15329 in chips) 
Seat 3: Duke Croix (23624 in chips) 
Seat 6: Klemtonius (7131 in chips) 
Seat 7: Mafak2020 (4721 in chips) 
Seat 8: HighCardJasper (12384 in chips) 
Seat 9: Manon947 (11900 in chips) 
color_singleton: posts small blind 50
dddocky: posts big blind 100
*** HOLE CARDS ***
Dealt to Manon947 [As Ah]
Duke Croix: folds 
Klemtonius: calls 100
Mafak2020: folds 
HighCardJasper: calls 100
Manon947: raises 100 to 200
color_singleton: calls 150
dddocky: calls 100
Klemtonius: calls 100
HighCardJasper: calls 100
*** FLOP *** [3h Ks Td]
color_singleton: bets 472
dddocky: folds 
Klemtonius: folds 
HighCardJasper: folds 
Manon947: calls 472
*** TURN *** [3h Ks Td] [Jh]
color_singleton: checks 
Manon947: bets 918
color_singleton: calls 918
*** RIVER *** [3h Ks Td Jh] [5s]
color_singleton: checks 
Manon947: bets 1786
color_singleton: folds 
Uncalled bet (1786) returned to Manon947
Manon947 collected 3572 from pot
*** SUMMARY ***
Total pot 3780 | Rake 208 
Board [3h Ks Td Jh 5s]
Seat 1: color_singleton (small blind) folded on the River
Seat 2: dddocky (big blind) folded on the Flop
Seat 3: Duke Croix folded before Flop (didn't bet)
Seat 6: Klemtonius folded on the Flop
Seat 7: Mafak2020 folded before Flop (didn't bet)
Seat 8: HighCardJasper folded on the Flop
Seat 9: Manon947 (button) collected (3572)



PokerStars Home Game Hand #216490426746: {Club #3225207}  Hold'em No Limit (50/100) - 2020/07/16 16:52:10 ET
Table 'Fun times' 9-max (Play Money) Seat #1 is the button
Seat 1: color_singleton (8538 in chips) 
Seat 2: dddocky (15129 in chips) 
Seat 3: Duke Croix (23624 in chips) 
Seat 6: Klemtonius (6931 in chips) 
Seat 7: Mafak2020 (4721 in chips) 
Seat 8: HighCardJasper (12184 in chips) 
Seat 9: Manon947 (13882 in chips) 
dddocky: posts small blind 50
Duke Croix: posts big blind 100
*** HOLE CARDS ***
Dealt to Manon947 [6d Td]
Klemtonius: folds 
Mafak2020: folds 
HighCardJasper: calls 100
Manon947: calls 100
color_singleton: raises 200 to 300
dddocky: calls 250
Duke Croix: folds 
HighCardJasper: calls 200
Manon947: calls 200
*** FLOP *** [6s Ah 3d]
dddocky: checks 
HighCardJasper: checks 
Manon947: checks 
color_singleton: bets 614
dddocky: folds 
HighCardJasper: folds 
Manon947: folds 
Uncalled bet (614) returned to color_singleton
color_singleton collected 1228 from pot
color_singleton: doesn't show hand 
*** SUMMARY ***
Total pot 1300 | Rake 72 
Board [6s Ah 3d]
Seat 1: color_singleton (button) collected (1228)
Seat 2: dddocky (small blind) folded on the Flop
Seat 3: Duke Croix (big blind) folded before Flop
Seat 6: Klemtonius folded before Flop (didn't bet)
Seat 7: Mafak2020 folded before Flop (didn't bet)
Seat 8: HighCardJasper folded on the Flop
Seat 9: Manon947 folded on the Flop



PokerStars Home Game Hand #216490453973: {Club #3225207}  Hold'em No Limit (50/100) - 2020/07/16 16:52:47 ET
Table 'Fun times' 9-max (Play Money) Seat #2 is the button
Seat 1: color_singleton (9466 in chips) 
Seat 2: dddocky (14829 in chips) 
Seat 3: Duke Croix (23524 in chips) 
Seat 6: Klemtonius (6931 in chips) 
Seat 7: Mafak2020 (4721 in chips) 
Seat 8: HighCardJasper (11884 in chips) 
Seat 9: Manon947 (13582 in chips) 
Duke Croix: posts small blind 50
Klemtonius: posts big blind 100
*** HOLE CARDS ***
Dealt to Manon947 [9s 9d]
Mafak2020: raises 100 to 200
HighCardJasper: calls 200
Manon947: calls 200
color_singleton: folds 
dddocky: calls 200
Duke Croix: folds 
Klemtonius: folds 
*** FLOP *** [Tc 2h Kh]
Mafak2020: checks 
HighCardJasper: checks 
Manon947: checks 
dddocky: bets 898
Mafak2020: folds 
HighCardJasper: folds 
Manon947: folds 
Uncalled bet (898) returned to dddocky
dddocky collected 898 from pot
dddocky: doesn't show hand 
*** SUMMARY ***
Total pot 950 | Rake 52 
Board [Tc 2h Kh]
Seat 1: color_singleton folded before Flop (didn't bet)
Seat 2: dddocky (button) collected (898)
Seat 3: Duke Croix (small blind) folded before Flop
Seat 6: Klemtonius (big blind) folded before Flop
Seat 7: Mafak2020 folded on the Flop
Seat 8: HighCardJasper folded on the Flop
Seat 9: Manon947 folded on the Flop



PokerStars Home Game Hand #216490486321: {Club #3225207}  Hold'em No Limit (50/100) - 2020/07/16 16:53:38 ET
Table 'Fun times' 9-max (Play Money) Seat #3 is the button
Seat 1: color_singleton (9466 in chips) 
Seat 2: dddocky (15527 in chips) 
Seat 3: Duke Croix (23474 in chips) 
Seat 6: Klemtonius (6831 in chips) 
Seat 7: Mafak2020 (4521 in chips) 
Seat 8: HighCardJasper (11684 in chips) 
Seat 9: Manon947 (13382 in chips) 
Klemtonius: posts small blind 50
Mafak2020: posts big blind 100
*** HOLE CARDS ***
Dealt to Manon947 [Ah 8c]
HighCardJasper: calls 100
Manon947: calls 100
color_singleton: raises 200 to 300
dddocky: folds 
Duke Croix: folds 
Klemtonius: calls 250
Mafak2020: calls 200
HighCardJasper: calls 200
Manon947: calls 200
*** FLOP *** [2s Td Ks]
Klemtonius: checks 
Mafak2020: checks 
HighCardJasper: checks 
Manon947: checks 
color_singleton: bets 708
Klemtonius: calls 708
Mafak2020: folds 
HighCardJasper: folds 
Manon947: folds 
*** TURN *** [2s Td Ks] [Jh]
Klemtonius: checks 
color_singleton: checks 
*** RIVER *** [2s Td Ks Jh] [4h]
Klemtonius: bets 100
color_singleton: calls 100
*** SHOW DOWN ***
Klemtonius: shows [Ac Jd] (a pair of Jacks)
color_singleton: shows [9s Kd] (a pair of Kings)
color_singleton collected 2945 from pot
*** SUMMARY ***
Total pot 3116 | Rake 171 
Board [2s Td Ks Jh 4h]
Seat 1: color_singleton showed [9s Kd] and won (2945) with a pair of Kings
Seat 2: dddocky folded before Flop (didn't bet)
Seat 3: Duke Croix (button) folded before Flop (didn't bet)
Seat 6: Klemtonius (small blind) showed [Ac Jd] and lost with a pair of Jacks
Seat 7: Mafak2020 (big blind) folded on the Flop
Seat 8: HighCardJasper folded on the Flop
Seat 9: Manon947 folded on the Flop



PokerStars Home Game Hand #216490523653: {Club #3225207}  Hold'em No Limit (50/100) - 2020/07/16 16:54:39 ET
Table 'Fun times' 9-max (Play Money) Seat #6 is the button
Seat 1: color_singleton (11303 in chips) 
Seat 2: dddocky (15527 in chips) 
Seat 3: Duke Croix (23474 in chips) 
Seat 6: Klemtonius (5723 in chips) 
Seat 7: Mafak2020 (4221 in chips) 
Seat 8: HighCardJasper (11384 in chips) 
Seat 9: Manon947 (13082 in chips) 
Mafak2020: posts small blind 50
HighCardJasper: posts big blind 100
*** HOLE CARDS ***
Dealt to Manon947 [Qc 6c]
Manon947: calls 100
color_singleton: raises 200 to 300
dddocky: folds 
Duke Croix: folds 
Klemtonius: calls 300
Mafak2020: raises 200 to 500
HighCardJasper: calls 400
Manon947: calls 400
color_singleton: calls 200
Klemtonius: calls 200
*** FLOP *** [7s 6d As]
Mafak2020: checks 
HighCardJasper: checks 
Manon947: checks 
color_singleton: checks 
Klemtonius: bets 987
Mafak2020: calls 987
HighCardJasper: folds 
Manon947: folds 
color_singleton: folds 
*** TURN *** [7s 6d As] [5c]
Mafak2020: checks 
Klemtonius: bets 4228
Mafak2020: calls 2734 and is all-in
Uncalled bet (1494) returned to Klemtonius
*** RIVER *** [7s 6d As 5c] [3c]
*** SHOW DOWN ***
Mafak2020: shows [Js Jd] (a pair of Jacks)
Klemtonius: shows [8s Ad] (a pair of Aces)
Klemtonius collected 9395 from pot
*** SUMMARY ***
Total pot 9942 | Rake 547 
Board [7s 6d As 5c 3c]
Seat 1: color_singleton folded on the Flop
Seat 2: dddocky folded before Flop (didn't bet)
Seat 3: Duke Croix folded before Flop (didn't bet)
Seat 6: Klemtonius (button) showed [8s Ad] and won (9395) with a pair of Aces
Seat 7: Mafak2020 (small blind) showed [Js Jd] and lost with a pair of Jacks
Seat 8: HighCardJasper (big blind) folded on the Flop
Seat 9: Manon947 folded on the Flop



PokerStars Home Game Hand #216490564631: {Club #3225207}  Hold'em No Limit (50/100) - 2020/07/16 16:56:03 ET
Table 'Fun times' 9-max (Play Money) Seat #8 is the button
Seat 1: color_singleton (10803 in chips) 
Seat 2: dddocky (15527 in chips) 
Seat 3: Duke Croix (23474 in chips) 
Seat 6: Klemtonius (10897 in chips) 
Seat 8: HighCardJasper (10884 in chips) 
Seat 9: Manon947 (12582 in chips) 
Manon947: posts small blind 50
color_singleton: posts big blind 100
*** HOLE CARDS ***
Dealt to Manon947 [Th Kd]
dddocky: folds 
Duke Croix: folds 
Klemtonius: folds 
HighCardJasper: raises 200 to 300
Manon947: folds 
color_singleton: folds 
Uncalled bet (200) returned to HighCardJasper
HighCardJasper collected 250 from pot
HighCardJasper: doesn't show hand 
*** SUMMARY ***
Total pot 250 | Rake 0 
Seat 1: color_singleton (big blind) folded before Flop
Seat 2: dddocky folded before Flop (didn't bet)
Seat 3: Duke Croix folded before Flop (didn't bet)
Seat 6: Klemtonius folded before Flop (didn't bet)
Seat 8: HighCardJasper (button) collected (250)
Seat 9: Manon947 (small blind) folded before Flop



PokerStars Home Game Hand #216490578718: {Club #3225207}  Hold'em No Limit (50/100) - 2020/07/16 16:56:34 ET
Table 'Fun times' 9-max (Play Money) Seat #9 is the button
Seat 1: color_singleton (10703 in chips) 
Seat 2: dddocky (15527 in chips) 
Seat 3: Duke Croix (23474 in chips) 
Seat 6: Klemtonius (10897 in chips) 
Seat 7: Mafak2020 (10000 in chips) 
Seat 8: HighCardJasper (11034 in chips) 
Seat 9: Manon947 (12532 in chips) 
color_singleton: posts small blind 50
dddocky: posts big blind 100
*** HOLE CARDS ***
Dealt to Manon947 [7d 5h]
Duke Croix: folds 
Klemtonius: calls 100
Mafak2020: raises 300 to 400
HighCardJasper: folds 
Manon947: folds 
color_singleton: calls 350
dddocky: folds 
Klemtonius: folds 
*** FLOP *** [7h Kd 4s]
color_singleton: checks 
Mafak2020: bets 1100
color_singleton: folds 
Uncalled bet (1100) returned to Mafak2020
Mafak2020 collected 945 from pot
Mafak2020: doesn't show hand 
*** SUMMARY ***
Total pot 1000 | Rake 55 
Board [7h Kd 4s]
Seat 1: color_singleton (small blind) folded on the Flop
Seat 2: dddocky (big blind) folded before Flop
Seat 3: Duke Croix folded before Flop (didn't bet)
Seat 6: Klemtonius folded before Flop
Seat 7: Mafak2020 collected (945)
Seat 8: HighCardJasper folded before Flop (didn't bet)
Seat 9: Manon947 (button) folded before Flop (didn't bet)



PokerStars Home Game Hand #216490596566: {Club #3225207}  Hold'em No Limit (50/100) - 2020/07/16 16:57:14 ET
Table 'Fun times' 9-max (Play Money) Seat #1 is the button
Seat 1: color_singleton (10303 in chips) 
Seat 2: dddocky (15427 in chips) 
Seat 3: Duke Croix (23474 in chips) 
Seat 6: Klemtonius (10797 in chips) 
Seat 7: Mafak2020 (10545 in chips) 
Seat 8: HighCardJasper (11034 in chips) 
Seat 9: Manon947 (12532 in chips) 
dddocky: posts small blind 50
Duke Croix: posts big blind 100
*** HOLE CARDS ***
Dealt to Manon947 [Ts 7c]
Klemtonius: raises 233 to 333
Mafak2020: raises 233 to 566
HighCardJasper: folds 
Manon947: folds 
color_singleton: folds 
dddocky: folds 
Duke Croix: folds 
Klemtonius: calls 233
*** FLOP *** [6h Kd Th]
Klemtonius: checks 
Mafak2020: bets 800
Klemtonius: raises 800 to 1600
Mafak2020: calls 800
*** TURN *** [6h Kd Th] [7s]
Klemtonius: bets 1800
Mafak2020: calls 1800
*** RIVER *** [6h Kd Th 7s] [6c]
Klemtonius: bets 6831 and is all-in
Mafak2020: calls 6579 and is all-in
Uncalled bet (252) returned to Klemtonius
*** SHOW DOWN ***
Klemtonius: shows [Jh Jc] (two pair, Jacks and Sixes)
Mafak2020: shows [As 3d] (a pair of Sixes)
Klemtonius collected 20072 from pot
*** SUMMARY ***
Total pot 21240 | Rake 1168 
Board [6h Kd Th 7s 6c]
Seat 1: color_singleton (button) folded before Flop (didn't bet)
Seat 2: dddocky (small blind) folded before Flop
Seat 3: Duke Croix (big blind) folded before Flop
Seat 6: Klemtonius showed [Jh Jc] and won (20072) with two pair, Jacks and Sixes
Seat 7: Mafak2020 showed [As 3d] and lost with a pair of Sixes
Seat 8: HighCardJasper folded before Flop (didn't bet)
Seat 9: Manon947 folded before Flop (didn't bet)



PokerStars Home Game Hand #216490640680: {Club #3225207}  Hold'em No Limit (50/100) - 2020/07/16 16:58:51 ET
Table 'Fun times' 9-max (Play Money) Seat #2 is the button
Seat 1: color_singleton (10303 in chips) 
Seat 2: dddocky (15377 in chips) 
Seat 3: Duke Croix (23374 in chips) 
Seat 6: Klemtonius (20324 in chips) 
Seat 8: HighCardJasper (11034 in chips) 
Seat 9: Manon947 (12532 in chips) 
Duke Croix: posts small blind 50
Klemtonius: posts big blind 100
*** HOLE CARDS ***
Dealt to Manon947 [8d 6c]
HighCardJasper: calls 100
Manon947: folds 
color_singleton: raises 100 to 200
dddocky: folds 
Duke Croix: raises 400 to 600
Klemtonius: calls 500
HighCardJasper: calls 500
color_singleton: calls 400
*** FLOP *** [Ad 6h 5h]
Duke Croix: checks 
Klemtonius: checks 
HighCardJasper: checks 
color_singleton: checks 
*** TURN *** [Ad 6h 5h] [3s]
Duke Croix: bets 1200
Klemtonius: folds 
HighCardJasper: calls 1200
color_singleton: folds 
*** RIVER *** [Ad 6h 5h 3s] [8c]
Duke Croix: bets 1800
HighCardJasper: raises 7434 to 9234 and is all-in
Duke Croix: calls 7434
*** SHOW DOWN ***
HighCardJasper: shows [5d 5s] (three of a kind, Fives)
Duke Croix: shows [As Ah] (three of a kind, Aces)
Duke Croix collected 21988 from pot
*** SUMMARY ***
Total pot 23268 | Rake 1280 
Board [Ad 6h 5h 3s 8c]
Seat 1: color_singleton folded on the Turn
Seat 2: dddocky (button) folded before Flop (didn't bet)
Seat 3: Duke Croix (small blind) showed [As Ah] and won (21988) with three of a kind, Aces
Seat 6: Klemtonius (big blind) folded on the Turn
Seat 8: HighCardJasper showed [5d 5s] and lost with three of a kind, Fives
Seat 9: Manon947 folded before Flop (didn't bet)



PokerStars Home Game Hand #216490681421: {Club #3225207}  Hold'em No Limit (50/100) - 2020/07/16 17:00:20 ET
Table 'Fun times' 9-max (Play Money) Seat #3 is the button
Seat 1: color_singleton (9703 in chips) 
Seat 2: dddocky (15377 in chips) 
Seat 3: Duke Croix (34328 in chips) 
Seat 6: Klemtonius (19724 in chips) 
Seat 7: Mafak2020 (10000 in chips) 
Seat 9: Manon947 (12532 in chips) 
Klemtonius: posts small blind 50
Mafak2020: posts big blind 100
*** HOLE CARDS ***
Dealt to Manon947 [6s Qh]
Manon947: calls 100
color_singleton: calls 100
dddocky: folds 
Duke Croix: raises 300 to 400
Klemtonius: folds 
Mafak2020: folds 
Manon947: folds 
color_singleton: calls 300
*** FLOP *** [4s 8s Js]
color_singleton: checks 
Duke Croix: bets 500
color_singleton: folds 
Uncalled bet (500) returned to Duke Croix
Duke Croix collected 992 from pot
Duke Croix: doesn't show hand 
*** SUMMARY ***
Total pot 1050 | Rake 58 
Board [4s 8s Js]
Seat 1: color_singleton folded on the Flop
Seat 2: dddocky folded before Flop (didn't bet)
Seat 3: Duke Croix (button) collected (992)
Seat 6: Klemtonius (small blind) folded before Flop
Seat 7: Mafak2020 (big blind) folded before Flop
Seat 9: Manon947 folded before Flop



PokerStars Home Game Hand #216490701880: {Club #3225207}  Hold'em No Limit (50/100) - 2020/07/16 17:01:00 ET
Table 'Fun times' 9-max (Play Money) Seat #6 is the button
Seat 1: color_singleton (9303 in chips) 
Seat 2: dddocky (15377 in chips) 
Seat 3: Duke Croix (34920 in chips) 
Seat 6: Klemtonius (19674 in chips) 
Seat 7: Mafak2020 (9900 in chips) 
Seat 8: HighCardJasper (10000 in chips) 
Seat 9: Manon947 (12432 in chips) 
Mafak2020: posts small blind 50
HighCardJasper: posts big blind 100
*** HOLE CARDS ***
Dealt to Manon947 [Ah 2h]
Manon947: calls 100
color_singleton: raises 200 to 300
dddocky: folds 
Duke Croix: calls 300
Klemtonius: calls 300
Mafak2020: calls 250
HighCardJasper: calls 200
Manon947: calls 200
*** FLOP *** [Ad 9d 2d]
Mafak2020: checks 
HighCardJasper: checks 
Manon947: bets 850
color_singleton: folds 
Duke Croix: folds 
Klemtonius: folds 
Mafak2020: folds 
HighCardJasper: folds 
Uncalled bet (850) returned to Manon947
Manon947 collected 1701 from pot
*** SUMMARY ***
Total pot 1800 | Rake 99 
Board [Ad 9d 2d]
Seat 1: color_singleton folded on the Flop
Seat 2: dddocky folded before Flop (didn't bet)
Seat 3: Duke Croix folded on the Flop
Seat 6: Klemtonius (button) folded on the Flop
Seat 7: Mafak2020 (small blind) folded on the Flop
Seat 8: HighCardJasper (big blind) folded on the Flop
Seat 9: Manon947 collected (1701)



PokerStars Home Game Hand #216490726640: {Club #3225207}  Hold'em No Limit (50/100) - 2020/07/16 17:01:44 ET
Table 'Fun times' 9-max (Play Money) Seat #7 is the button
Seat 1: color_singleton (9003 in chips) 
Seat 2: dddocky (15377 in chips) 
Seat 3: Duke Croix (34620 in chips) 
Seat 6: Klemtonius (19374 in chips) 
Seat 7: Mafak2020 (9600 in chips) 
Seat 8: HighCardJasper (9700 in chips) 
Seat 9: Manon947 (13833 in chips) 
HighCardJasper: posts small blind 50
Manon947: posts big blind 100
*** HOLE CARDS ***
Dealt to Manon947 [5h Qs]
color_singleton: folds 
dddocky: folds 
Duke Croix: folds 
Klemtonius: calls 100
Mafak2020: raises 300 to 400
HighCardJasper: folds 
Manon947: folds 
Klemtonius: calls 300
*** FLOP *** [5s 9s 8d]
Klemtonius: bets 898
Mafak2020: calls 898
*** TURN *** [5s 9s 8d] [Jc]
Klemtonius: checks 
Mafak2020: checks 
*** RIVER *** [5s 9s 8d Jc] [Qd]
Klemtonius: bets 2595
Mafak2020: folds 
Uncalled bet (2595) returned to Klemtonius
Klemtonius collected 2595 from pot
Klemtonius: doesn't show hand 
*** SUMMARY ***
Total pot 2746 | Rake 151 
Board [5s 9s 8d Jc Qd]
Seat 1: color_singleton folded before Flop (didn't bet)
Seat 2: dddocky folded before Flop (didn't bet)
Seat 3: Duke Croix folded before Flop (didn't bet)
Seat 6: Klemtonius collected (2595)
Seat 7: Mafak2020 (button) folded on the River
Seat 8: HighCardJasper (small blind) folded before Flop
Seat 9: Manon947 (big blind) folded before Flop



PokerStars Home Game Hand #216490765076: {Club #3225207}  Hold'em No Limit (50/100) - 2020/07/16 17:02:47 ET
Table 'Fun times' 9-max (Play Money) Seat #8 is the button
Seat 1: color_singleton (9003 in chips) 
Seat 2: dddocky (15377 in chips) 
Seat 3: Duke Croix (34620 in chips) 
Seat 6: Klemtonius (20671 in chips) 
Seat 7: Mafak2020 (8302 in chips) 
Seat 8: HighCardJasper (9650 in chips) 
Seat 9: Manon947 (13733 in chips) 
Manon947: posts small blind 50
color_singleton: posts big blind 100
*** HOLE CARDS ***
Dealt to Manon947 [4c 5s]
dddocky: calls 100
Duke Croix: calls 100
Klemtonius: raises 500 to 600
Mafak2020: calls 600
HighCardJasper: folds 
Manon947: folds 
color_singleton has timed out
color_singleton: folds 
dddocky: calls 500
Duke Croix: folds 
*** FLOP *** [Ts 8h 9h]
dddocky: bets 1937
Klemtonius: folds 
Mafak2020: raises 1937 to 3874
dddocky: calls 1937
*** TURN *** [Ts 8h 9h] [6h]
dddocky: checks 
Mafak2020: bets 3828 and is all-in
dddocky: folds 
Uncalled bet (3828) returned to Mafak2020
Mafak2020 collected 9259 from pot
Mafak2020: doesn't show hand 
*** SUMMARY ***
Total pot 9798 | Rake 539 
Board [Ts 8h 9h 6h]
Seat 1: color_singleton (big blind) folded before Flop
Seat 2: dddocky folded on the Turn
Seat 3: Duke Croix folded before Flop
Seat 6: Klemtonius folded on the Flop
Seat 7: Mafak2020 collected (9259)
Seat 8: HighCardJasper (button) folded before Flop (didn't bet)
Seat 9: Manon947 (small blind) folded before Flop



PokerStars Home Game Hand #216490814069: {Club #3225207}  Hold'em No Limit (50/100) - 2020/07/16 17:04:05 ET
Table 'Fun times' 9-max (Play Money) Seat #9 is the button
Seat 1: color_singleton (8903 in chips) 
Seat 2: dddocky (10903 in chips) 
Seat 3: Duke Croix (34520 in chips) 
Seat 6: Klemtonius (20071 in chips) 
Seat 7: Mafak2020 (13087 in chips) 
Seat 8: HighCardJasper (9650 in chips) 
Seat 9: Manon947 (13683 in chips) 
color_singleton: posts small blind 50
dddocky: posts big blind 100
*** HOLE CARDS ***
Dealt to Manon947 [7d Ah]
Duke Croix: folds 
Klemtonius: folds 
Mafak2020: calls 100
HighCardJasper: calls 100
Manon947: calls 100
color_singleton: raises 200 to 300
dddocky: folds 
Mafak2020: calls 200
HighCardJasper: calls 200
Manon947: calls 200
*** FLOP *** [Jc Jh 6c]
color_singleton: checks 
Mafak2020: checks 
HighCardJasper: checks 
Manon947: bets 1228
color_singleton: folds 
Mafak2020: folds 
HighCardJasper: folds 
Uncalled bet (1228) returned to Manon947
Manon947 collected 1228 from pot
*** SUMMARY ***
Total pot 1300 | Rake 72 
Board [Jc Jh 6c]
Seat 1: color_singleton (small blind) folded on the Flop
Seat 2: dddocky (big blind) folded before Flop
Seat 3: Duke Croix folded before Flop (didn't bet)
Seat 6: Klemtonius folded before Flop (didn't bet)
Seat 7: Mafak2020 folded on the Flop
Seat 8: HighCardJasper folded on the Flop
Seat 9: Manon947 (button) collected (1228)



PokerStars Home Game Hand #216490849416: {Club #3225207}  Hold'em No Limit (50/100) - 2020/07/16 17:05:03 ET
Table 'Fun times' 9-max (Play Money) Seat #1 is the button
Seat 1: color_singleton (8603 in chips) 
Seat 2: dddocky (10803 in chips) 
Seat 3: Duke Croix (34520 in chips) 
Seat 7: Mafak2020 (12787 in chips) 
Seat 8: HighCardJasper (9350 in chips) 
Seat 9: Manon947 (14611 in chips) 
dddocky: posts small blind 50
Duke Croix: posts big blind 100
*** HOLE CARDS ***
Dealt to Manon947 [2c As]
Mafak2020: raises 300 to 400
HighCardJasper: calls 400
Manon947: calls 400
color_singleton: folds 
dddocky: folds 
Duke Croix: folds 
*** FLOP *** [9d 5c Js]
Mafak2020: checks 
HighCardJasper: checks 
Manon947: checks 
*** TURN *** [9d 5c Js] [Kd]
Mafak2020: checks 
HighCardJasper: checks 
Manon947: bets 1276
Mafak2020: folds 
HighCardJasper: folds 
Uncalled bet (1276) returned to Manon947
Manon947 collected 1276 from pot
*** SUMMARY ***
Total pot 1350 | Rake 74 
Board [9d 5c Js Kd]
Seat 1: color_singleton (button) folded before Flop (didn't bet)
Seat 2: dddocky (small blind) folded before Flop
Seat 3: Duke Croix (big blind) folded before Flop
Seat 7: Mafak2020 folded on the Turn
Seat 8: HighCardJasper folded on the Turn
Seat 9: Manon947 collected (1276)



PokerStars Home Game Hand #216490878314: {Club #3225207}  Hold'em No Limit (50/100) - 2020/07/16 17:05:50 ET
Table 'Fun times' 9-max (Play Money) Seat #2 is the button
Seat 1: color_singleton (8603 in chips) 
Seat 2: dddocky (10753 in chips) 
Seat 3: Duke Croix (34420 in chips) 
Seat 6: Klemtonius (20071 in chips) 
Seat 7: Mafak2020 (12387 in chips) 
Seat 8: HighCardJasper (8950 in chips) 
Seat 9: Manon947 (15487 in chips) 
Duke Croix: posts small blind 50
Klemtonius: posts big blind 100
*** HOLE CARDS ***
Dealt to Manon947 [Td 5s]
Mafak2020: calls 100
HighCardJasper: folds 
Manon947: calls 100
color_singleton: folds 
dddocky: calls 100
Duke Croix: calls 50
Klemtonius: checks 
*** FLOP *** [2c As 9c]
Duke Croix: checks 
Klemtonius: checks 
Mafak2020: checks 
Manon947: checks 
dddocky: checks 
*** TURN *** [2c As 9c] [Qh]
Duke Croix: bets 300
Klemtonius: folds 
Mafak2020: folds 
Manon947: folds 
dddocky: folds 
Uncalled bet (300) returned to Duke Croix
Duke Croix collected 472 from pot
Duke Croix: doesn't show hand 
*** SUMMARY ***
Total pot 500 | Rake 28 
Board [2c As 9c Qh]
Seat 1: color_singleton folded before Flop (didn't bet)
Seat 2: dddocky (button) folded on the Turn
Seat 3: Duke Croix (small blind) collected (472)
Seat 6: Klemtonius (big blind) folded on the Turn
Seat 7: Mafak2020 folded on the Turn
Seat 8: HighCardJasper folded before Flop (didn't bet)
Seat 9: Manon947 folded on the Turn



PokerStars Home Game Hand #216490910983: {Club #3225207}  Hold'em No Limit (50/100) - 2020/07/16 17:06:43 ET
Table 'Fun times' 9-max (Play Money) Seat #3 is the button
Seat 1: color_singleton (8603 in chips) 
Seat 2: dddocky (10653 in chips) 
Seat 3: Duke Croix (34792 in chips) 
Seat 6: Klemtonius (19971 in chips) 
Seat 7: Mafak2020 (12287 in chips) 
Seat 8: HighCardJasper (8950 in chips) 
Seat 9: Manon947 (15387 in chips) 
Klemtonius: posts small blind 50
Mafak2020: posts big blind 100
*** HOLE CARDS ***
Dealt to Manon947 [9s Ac]
HighCardJasper: calls 100
Manon947: calls 100
color_singleton: folds 
dddocky: calls 100
Duke Croix: calls 100
Klemtonius: calls 50
Mafak2020: checks 
*** FLOP *** [8c 7c 4d]
Klemtonius: bets 567
Mafak2020: calls 567
HighCardJasper: folds 
Manon947: folds 
dddocky: folds 
Duke Croix: folds 
*** TURN *** [8c 7c 4d] [Jh]
Klemtonius: bets 819
Mafak2020: calls 819
*** RIVER *** [8c 7c 4d Jh] [Ad]
Klemtonius: checks 
Mafak2020: checks 
*** SHOW DOWN ***
Klemtonius: shows [Tc Td] (a pair of Tens)
Mafak2020: mucks hand 
Klemtonius collected 3187 from pot
*** SUMMARY ***
Total pot 3372 | Rake 185 
Board [8c 7c 4d Jh Ad]
Seat 1: color_singleton folded before Flop (didn't bet)
Seat 2: dddocky folded on the Flop
Seat 3: Duke Croix (button) folded on the Flop
Seat 6: Klemtonius (small blind) showed [Tc Td] and won (3187) with a pair of Tens
Seat 7: Mafak2020 (big blind) mucked [4h 5s]
Seat 8: HighCardJasper folded on the Flop
Seat 9: Manon947 folded on the Flop



PokerStars Home Game Hand #216490955812: {Club #3225207}  Hold'em No Limit (50/100) - 2020/07/16 17:07:51 ET
Table 'Fun times' 9-max (Play Money) Seat #6 is the button
Seat 1: color_singleton (8603 in chips) 
Seat 2: dddocky (10553 in chips) 
Seat 3: Duke Croix (34692 in chips) 
Seat 6: Klemtonius (21672 in chips) 
Seat 7: Mafak2020 (10801 in chips) 
Seat 8: HighCardJasper (8850 in chips) 
Seat 9: Manon947 (15287 in chips) 
Mafak2020: posts small blind 50
HighCardJasper: posts big blind 100
*** HOLE CARDS ***
Dealt to Manon947 [3d 2h]
Manon947: calls 100
color_singleton: folds 
dddocky: calls 100
Duke Croix: folds 
Klemtonius: calls 100
Mafak2020: calls 50
HighCardJasper: checks 
*** FLOP *** [Jc Qd Qh]
Mafak2020: bets 300
HighCardJasper: folds 
Manon947: folds 
dddocky: folds 
Klemtonius: folds 
Uncalled bet (300) returned to Mafak2020
Mafak2020 collected 472 from pot
Mafak2020: doesn't show hand 
*** SUMMARY ***
Total pot 500 | Rake 28 
Board [Jc Qd Qh]
Seat 1: color_singleton folded before Flop (didn't bet)
Seat 2: dddocky folded on the Flop
Seat 3: Duke Croix folded before Flop (didn't bet)
Seat 6: Klemtonius (button) folded on the Flop
Seat 7: Mafak2020 (small blind) collected (472)
Seat 8: HighCardJasper (big blind) folded on the Flop
Seat 9: Manon947 folded on the Flop



PokerStars Home Game Hand #216490992138: {Club #3225207}  Hold'em No Limit (50/100) - 2020/07/16 17:08:50 ET
Table 'Fun times' 9-max (Play Money) Seat #7 is the button
Seat 1: color_singleton (8603 in chips) 
Seat 2: dddocky (10453 in chips) 
Seat 3: Duke Croix (34692 in chips) 
Seat 6: Klemtonius (21572 in chips) 
Seat 7: Mafak2020 (11173 in chips) 
Seat 8: HighCardJasper (8750 in chips) 
Seat 9: Manon947 (15187 in chips) 
HighCardJasper: posts small blind 50
Manon947: posts big blind 100
*** HOLE CARDS ***
Dealt to Manon947 [4c 2c]
color_singleton: raises 200 to 300
dddocky: calls 300
Duke Croix: folds 
Klemtonius: folds 
Mafak2020: calls 300
HighCardJasper: folds 
Manon947: calls 200
*** FLOP *** [Ad 9d 2d]
Manon947: checks 
color_singleton: bets 590
dddocky: calls 590
Mafak2020: calls 590
Manon947: folds 
*** TURN *** [Ad 9d 2d] [Ks]
color_singleton: checks 
dddocky: checks 
Mafak2020: checks 
*** RIVER *** [Ad 9d 2d Ks] [5d]
color_singleton: checks 
dddocky: checks 
Mafak2020: bets 1200
color_singleton: calls 1200
dddocky: folds 
*** SHOW DOWN ***
Mafak2020: shows [Qd Kc] (a flush, Ace high)
color_singleton: mucks hand 
Mafak2020 collected 5122 from pot
*** SUMMARY ***
Total pot 5420 | Rake 298 
Board [Ad 9d 2d Ks 5d]
Seat 1: color_singleton mucked [Ts Td]
Seat 2: dddocky folded on the River
Seat 3: Duke Croix folded before Flop (didn't bet)
Seat 6: Klemtonius folded before Flop (didn't bet)
Seat 7: Mafak2020 (button) showed [Qd Kc] and won (5122) with a flush, Ace high
Seat 8: HighCardJasper (small blind) folded before Flop
Seat 9: Manon947 (big blind) folded on the Flop



PokerStars Home Game Hand #216491035158: {Club #3225207}  Hold'em No Limit (50/100) - 2020/07/16 17:10:00 ET
Table 'Fun times' 9-max (Play Money) Seat #8 is the button
Seat 1: color_singleton (6513 in chips) 
Seat 2: dddocky (9563 in chips) 
Seat 3: Duke Croix (34692 in chips) 
Seat 6: Klemtonius (21572 in chips) 
Seat 7: Mafak2020 (14205 in chips) 
Seat 8: HighCardJasper (8700 in chips) 
Seat 9: Manon947 (14887 in chips) 
Manon947: posts small blind 50
color_singleton: posts big blind 100
*** HOLE CARDS ***
Dealt to Manon947 [9h Qh]
dddocky: raises 100 to 200
Duke Croix: folds 
Klemtonius: folds 
Mafak2020: folds 
HighCardJasper: calls 200
Manon947: calls 150
color_singleton: folds 
*** FLOP *** [Js Jh 7s]
Manon947: checks 
dddocky: bets 100
HighCardJasper: calls 100
Manon947: calls 100
*** TURN *** [Js Jh 7s] [Ks]
Manon947: checks 
dddocky: bets 100
HighCardJasper: calls 100
Manon947: calls 100
*** RIVER *** [Js Jh 7s Ks] [Jd]
Manon947: checks 
dddocky: bets 1228
HighCardJasper: calls 1228
Manon947: folds 
*** SHOW DOWN ***
dddocky: shows [Ah Ac] (a full house, Jacks full of Aces)
HighCardJasper: mucks hand 
dddocky collected 3549 from pot
*** SUMMARY ***
Total pot 3756 | Rake 207 
Board [Js Jh 7s Ks Jd]
Seat 1: color_singleton (big blind) folded before Flop
Seat 2: dddocky showed [Ah Ac] and won (3549) with a full house, Jacks full of Aces
Seat 3: Duke Croix folded before Flop (didn't bet)
Seat 6: Klemtonius folded before Flop (didn't bet)
Seat 7: Mafak2020 folded before Flop (didn't bet)
Seat 8: HighCardJasper (button) mucked [4h 7h]
Seat 9: Manon947 (small blind) folded on the River



PokerStars Home Game Hand #216491065593: {Club #3225207}  Hold'em No Limit (50/100) - 2020/07/16 17:10:49 ET
Table 'Fun times' 9-max (Play Money) Seat #9 is the button
Seat 1: color_singleton (6413 in chips) 
Seat 2: dddocky (11484 in chips) 
Seat 3: Duke Croix (34692 in chips) 
Seat 6: Klemtonius (21572 in chips) 
Seat 7: Mafak2020 (14205 in chips) 
Seat 8: HighCardJasper (7072 in chips) 
Seat 9: Manon947 (14487 in chips) 
color_singleton: posts small blind 50
dddocky: posts big blind 100
*** HOLE CARDS ***
Dealt to Manon947 [Jh 3h]
Duke Croix: folds 
Klemtonius: calls 100
Mafak2020: calls 100
HighCardJasper: calls 100
Manon947: calls 100
color_singleton: calls 50
dddocky: checks 
*** FLOP *** [2d 3c Qh]
color_singleton: checks 
dddocky: checks 
Klemtonius: checks 
Mafak2020: checks 
HighCardJasper: checks 
Manon947: bets 100
color_singleton: calls 100
dddocky: folds 
Klemtonius: calls 100
Mafak2020: folds 
HighCardJasper: calls 100
*** TURN *** [2d 3c Qh] [4s]
color_singleton: checks 
Klemtonius: bets 100
HighCardJasper: raises 200 to 300
Manon947: calls 300
color_singleton: folds 
Klemtonius: folds 
*** RIVER *** [2d 3c Qh 4s] [As]
HighCardJasper: bets 500
Manon947: folds 
Uncalled bet (500) returned to HighCardJasper
HighCardJasper collected 1606 from pot
HighCardJasper: doesn't show hand 
*** SUMMARY ***
Total pot 1700 | Rake 94 
Board [2d 3c Qh 4s As]
Seat 1: color_singleton (small blind) folded on the Turn
Seat 2: dddocky (big blind) folded on the Flop
Seat 3: Duke Croix folded before Flop (didn't bet)
Seat 6: Klemtonius folded on the Turn
Seat 7: Mafak2020 folded on the Flop
Seat 8: HighCardJasper collected (1606)
Seat 9: Manon947 (button) folded on the River



PokerStars Home Game Hand #216491116571: {Club #3225207}  Hold'em No Limit (50/100) - 2020/07/16 17:12:13 ET
Table 'Fun times' 9-max (Play Money) Seat #1 is the button
Seat 1: color_singleton (6213 in chips) 
Seat 2: dddocky (11384 in chips) 
Seat 3: Duke Croix (34692 in chips) 
Seat 6: Klemtonius (21272 in chips) 
Seat 7: Mafak2020 (14105 in chips) 
Seat 8: HighCardJasper (8178 in chips) 
Seat 9: Manon947 (13987 in chips) 
dddocky: posts small blind 50
Duke Croix: posts big blind 100
*** HOLE CARDS ***
Dealt to Manon947 [4c Jd]
Klemtonius: calls 100
Mafak2020: folds 
HighCardJasper: calls 100
Manon947: calls 100
color_singleton: calls 100
dddocky: calls 50
Duke Croix: checks 
*** FLOP *** [6c 9h Kc]
dddocky: checks 
Duke Croix: checks 
Klemtonius: checks 
HighCardJasper: checks 
Manon947: checks 
color_singleton: bets 300
dddocky: calls 300
Duke Croix: calls 300
Klemtonius: folds 
HighCardJasper: calls 300
Manon947: folds 
*** TURN *** [6c 9h Kc] [Jc]
dddocky: checks 
Duke Croix has timed out
Duke Croix: checks 
HighCardJasper: checks 
color_singleton: checks 
*** RIVER *** [6c 9h Kc Jc] [8s]
dddocky: checks 
Duke Croix: bets 1000
HighCardJasper: folds 
color_singleton: calls 1000
dddocky: folds 
*** SHOW DOWN ***
Duke Croix: shows [6s 9s] (two pair, Nines and Sixes)
color_singleton: mucks hand 
Duke Croix collected 3591 from pot
*** SUMMARY ***
Total pot 3800 | Rake 209 
Board [6c 9h Kc Jc 8s]
Seat 1: color_singleton (button) mucked [Kh 4d]
Seat 2: dddocky (small blind) folded on the River
Seat 3: Duke Croix (big blind) showed [6s 9s] and won (3591) with two pair, Nines and Sixes
Seat 6: Klemtonius folded on the Flop
Seat 7: Mafak2020 folded before Flop (didn't bet)
Seat 8: HighCardJasper folded on the River
Seat 9: Manon947 folded on the Flop



PokerStars Home Game Hand #216491168689: {Club #3225207}  Hold'em No Limit (50/100) - 2020/07/16 17:13:38 ET
Table 'Fun times' 9-max (Play Money) Seat #2 is the button
Seat 1: color_singleton (4813 in chips) 
Seat 2: dddocky (10984 in chips) 
Seat 3: Duke Croix (36883 in chips) 
Seat 6: Klemtonius (21172 in chips) 
Seat 7: Mafak2020 (14105 in chips) 
Seat 8: HighCardJasper (7778 in chips) 
Seat 9: Manon947 (13887 in chips) 
Duke Croix: posts small blind 50
Klemtonius: posts big blind 100
*** HOLE CARDS ***
Dealt to Manon947 [Js Ac]
Mafak2020: raises 300 to 400
HighCardJasper: folds 
Manon947: calls 400
color_singleton: folds 
dddocky: calls 400
Duke Croix: folds 
Klemtonius: calls 300
*** FLOP *** [4s 6d 7h]
Klemtonius: checks 
Mafak2020: bets 400
Manon947: folds 
dddocky: calls 400
Klemtonius: folds 
*** TURN *** [4s 6d 7h] [Th]
Mafak2020: checks 
dddocky: checks 
*** RIVER *** [4s 6d 7h Th] [Jh]
Mafak2020: checks 
dddocky: checks 
*** SHOW DOWN ***
Mafak2020: shows [Kd Ad] (high card Ace)
dddocky: shows [Qc 6c] (a pair of Sixes)
dddocky collected 2315 from pot
*** SUMMARY ***
Total pot 2450 | Rake 135 
Board [4s 6d 7h Th Jh]
Seat 1: color_singleton folded before Flop (didn't bet)
Seat 2: dddocky (button) showed [Qc 6c] and won (2315) with a pair of Sixes
Seat 3: Duke Croix (small blind) folded before Flop
Seat 6: Klemtonius (big blind) folded on the Flop
Seat 7: Mafak2020 showed [Kd Ad] and lost with high card Ace
Seat 8: HighCardJasper folded before Flop (didn't bet)
Seat 9: Manon947 folded on the Flop



PokerStars Home Game Hand #216491204135: {Club #3225207}  Hold'em No Limit (50/100) - 2020/07/16 17:14:36 ET
Table 'Fun times' 9-max (Play Money) Seat #3 is the button
Seat 1: color_singleton (4813 in chips) 
Seat 2: dddocky (12499 in chips) 
Seat 3: Duke Croix (36833 in chips) 
Seat 6: Klemtonius (20772 in chips) 
Seat 7: Mafak2020 (13305 in chips) 
Seat 8: HighCardJasper (7778 in chips) 
Seat 9: Manon947 (13487 in chips) 
Klemtonius: posts small blind 50
Mafak2020: posts big blind 100
*** HOLE CARDS ***
Dealt to Manon947 [Ac 8c]
HighCardJasper: raises 100 to 200
Manon947: calls 200
color_singleton: folds 
dddocky: calls 200
Duke Croix: folds 
Klemtonius: folds 
Mafak2020: calls 100
*** FLOP *** [5s Jd 8d]
Mafak2020: bets 400
HighCardJasper: calls 400
Manon947: calls 400
dddocky: calls 400
*** TURN *** [5s Jd 8d] [2d]
Mafak2020: bets 1000
HighCardJasper: calls 1000
Manon947: folds 
dddocky: folds 
*** RIVER *** [5s Jd 8d 2d] [As]
Mafak2020: checks 
HighCardJasper: bets 1000
Mafak2020: folds 
Uncalled bet (1000) returned to HighCardJasper
HighCardJasper collected 4205 from pot
HighCardJasper: doesn't show hand 
*** SUMMARY ***
Total pot 4450 | Rake 245 
Board [5s Jd 8d 2d As]
Seat 1: color_singleton folded before Flop (didn't bet)
Seat 2: dddocky folded on the Turn
Seat 3: Duke Croix (button) folded before Flop (didn't bet)
Seat 6: Klemtonius (small blind) folded before Flop
Seat 7: Mafak2020 (big blind) folded on the River
Seat 8: HighCardJasper collected (4205)
Seat 9: Manon947 folded on the Turn



PokerStars Home Game Hand #216491249201: {Club #3225207}  Hold'em No Limit (50/100) - 2020/07/16 17:15:49 ET
Table 'Fun times' 9-max (Play Money) Seat #6 is the button
Seat 1: color_singleton (4813 in chips) 
Seat 2: dddocky (11899 in chips) 
Seat 3: Duke Croix (36833 in chips) 
Seat 6: Klemtonius (20722 in chips) 
Seat 7: Mafak2020 (11705 in chips) 
Seat 8: HighCardJasper (10383 in chips) 
Seat 9: Manon947 (12887 in chips) 
Mafak2020: posts small blind 50
HighCardJasper: posts big blind 100
*** HOLE CARDS ***
Dealt to Manon947 [6h 4d]
Manon947: calls 100
color_singleton: raises 100 to 200
dddocky: calls 200
Duke Croix: folds 
Klemtonius: raises 200 to 400
Mafak2020: calls 350
HighCardJasper: folds 
Manon947: folds 
color_singleton: calls 200
dddocky: calls 200
*** FLOP *** [6d Jh 3s]
Mafak2020: checks 
color_singleton: checks 
dddocky: bets 1701
Klemtonius has timed out
Klemtonius: folds 
Mafak2020: folds 
color_singleton: folds 
Uncalled bet (1701) returned to dddocky
dddocky collected 1701 from pot
dddocky: doesn't show hand 
*** SUMMARY ***
Total pot 1800 | Rake 99 
Board [6d Jh 3s]
Seat 1: color_singleton folded on the Flop
Seat 2: dddocky collected (1701)
Seat 3: Duke Croix folded before Flop (didn't bet)
Seat 6: Klemtonius (button) folded on the Flop
Seat 7: Mafak2020 (small blind) folded on the Flop
Seat 8: HighCardJasper (big blind) folded before Flop
Seat 9: Manon947 folded before Flop



PokerStars Home Game Hand #216491295289: {Club #3225207}  Hold'em No Limit (50/100) - 2020/07/16 17:16:56 ET
Table 'Fun times' 9-max (Play Money) Seat #7 is the button
Seat 1: color_singleton (4413 in chips) 
Seat 2: dddocky (13200 in chips) 
Seat 3: Duke Croix (36833 in chips) 
Seat 6: Klemtonius (20322 in chips) 
Seat 7: Mafak2020 (11305 in chips) 
Seat 8: HighCardJasper (10283 in chips) 
Seat 9: Manon947 (12787 in chips) 
HighCardJasper: posts small blind 50
Manon947: posts big blind 100
*** HOLE CARDS ***
Dealt to Manon947 [7d 5c]
color_singleton: folds 
dddocky: folds 
Duke Croix: raises 300 to 400
Klemtonius: folds 
Mafak2020: folds 
HighCardJasper: calls 350
Manon947: folds 
*** FLOP *** [2h Kc 8c]
HighCardJasper: checks 
Duke Croix: checks 
*** TURN *** [2h Kc 8c] [5d]
HighCardJasper: checks 
Duke Croix: checks 
*** RIVER *** [2h Kc 8c 5d] [2s]
HighCardJasper: checks 
Duke Croix: checks 
*** SHOW DOWN ***
HighCardJasper: shows [Td 6d] (a pair of Deuces)
Duke Croix: shows [Ts 7h] (a pair of Deuces)
HighCardJasper collected 425 from pot
Duke Croix collected 425 from pot
*** SUMMARY ***
Total pot 900 | Rake 50 
Board [2h Kc 8c 5d 2s]
Seat 1: color_singleton folded before Flop (didn't bet)
Seat 2: dddocky folded before Flop (didn't bet)
Seat 3: Duke Croix showed [Ts 7h] and won (425) with a pair of Deuces
Seat 6: Klemtonius folded before Flop (didn't bet)
Seat 7: Mafak2020 (button) folded before Flop (didn't bet)
Seat 8: HighCardJasper (small blind) showed [Td 6d] and won (425) with a pair of Deuces
Seat 9: Manon947 (big blind) folded before Flop



PokerStars Home Game Hand #216491320533: {Club #3225207}  Hold'em No Limit (50/100) - 2020/07/16 17:17:37 ET
Table 'Fun times' 9-max (Play Money) Seat #8 is the button
Seat 1: color_singleton (4413 in chips) 
Seat 2: dddocky (13200 in chips) 
Seat 3: Duke Croix (36858 in chips) 
Seat 6: Klemtonius (20322 in chips) 
Seat 7: Mafak2020 (11305 in chips) 
Seat 8: HighCardJasper (10308 in chips) 
Seat 9: Manon947 (12687 in chips) 
Manon947: posts small blind 50
color_singleton: posts big blind 100
*** HOLE CARDS ***
Dealt to Manon947 [Jd Th]
dddocky: folds 
Duke Croix: folds 
Klemtonius: calls 100
Mafak2020: calls 100
HighCardJasper: calls 100
Manon947: calls 50
color_singleton: raises 300 to 400
Klemtonius: folds 
Mafak2020: calls 300
HighCardJasper: calls 300
Manon947: calls 300
*** FLOP *** [4c 2h Kd]
Manon947: checks 
color_singleton: checks 
Mafak2020: checks 
HighCardJasper: checks 
*** TURN *** [4c 2h Kd] [5s]
Manon947: checks 
color_singleton: bets 803
Mafak2020: folds 
HighCardJasper: folds 
Manon947: folds 
Uncalled bet (803) returned to color_singleton
color_singleton collected 1606 from pot
color_singleton: doesn't show hand 
*** SUMMARY ***
Total pot 1700 | Rake 94 
Board [4c 2h Kd 5s]
Seat 1: color_singleton (big blind) collected (1606)
Seat 2: dddocky folded before Flop (didn't bet)
Seat 3: Duke Croix folded before Flop (didn't bet)
Seat 6: Klemtonius folded before Flop
Seat 7: Mafak2020 folded on the Turn
Seat 8: HighCardJasper (button) folded on the Turn
Seat 9: Manon947 (small blind) folded on the Turn



PokerStars Home Game Hand #216491358086: {Club #3225207}  Hold'em No Limit (50/100) - 2020/07/16 17:18:39 ET
Table 'Fun times' 9-max (Play Money) Seat #9 is the button
Seat 1: color_singleton (5619 in chips) 
Seat 2: dddocky (13200 in chips) 
Seat 3: Duke Croix (36858 in chips) 
Seat 6: Klemtonius (20222 in chips) 
Seat 7: Mafak2020 (10905 in chips) 
Seat 8: HighCardJasper (9908 in chips) 
Seat 9: Manon947 (12287 in chips) 
color_singleton: posts small blind 50
dddocky: posts big blind 100
*** HOLE CARDS ***
Dealt to Manon947 [Td Th]
Duke Croix: raises 300 to 400
Klemtonius: calls 400
Mafak2020: calls 400
HighCardJasper: folds 
Manon947: calls 400
color_singleton: calls 350
dddocky: calls 300
*** FLOP *** [Jd 4s Qh]
color_singleton: checks 
dddocky: bets 2268
Duke Croix: calls 2268
Klemtonius: folds 
Mafak2020: calls 2268
Manon947: folds 
color_singleton: folds 
*** TURN *** [Jd 4s Qh] [As]
dddocky: checks 
Duke Croix: bets 34190 and is all-in
Mafak2020: calls 8237 and is all-in
dddocky: folds 
Uncalled bet (25953) returned to Duke Croix
*** RIVER *** [Jd 4s Qh As] [3s]
*** SHOW DOWN ***
Duke Croix: shows [Jh Qc] (two pair, Queens and Jacks)
Mafak2020: shows [Kh Tc] (a straight, Ten to Ace)
Mafak2020 collected 24266 from pot
*** SUMMARY ***
Total pot 25678 | Rake 1412 
Board [Jd 4s Qh As 3s]
Seat 1: color_singleton (small blind) folded on the Flop
Seat 2: dddocky (big blind) folded on the Turn
Seat 3: Duke Croix showed [Jh Qc] and lost with two pair, Queens and Jacks
Seat 6: Klemtonius folded on the Flop
Seat 7: Mafak2020 showed [Kh Tc] and won (24266) with a straight, Ten to Ace
Seat 8: HighCardJasper folded before Flop (didn't bet)
Seat 9: Manon947 (button) folded on the Flop



PokerStars Home Game Hand #216491398880: {Club #3225207}  Hold'em No Limit (50/100) - 2020/07/16 17:19:46 ET
Table 'Fun times' 9-max (Play Money) Seat #1 is the button
Seat 1: color_singleton (5219 in chips) 
Seat 2: dddocky (10532 in chips) 
Seat 3: Duke Croix (25953 in chips) 
Seat 6: Klemtonius (19822 in chips) 
Seat 7: Mafak2020 (24266 in chips) 
Seat 8: HighCardJasper (9908 in chips) 
Seat 9: Manon947 (11887 in chips) 
dddocky: posts small blind 50
Duke Croix: posts big blind 100
*** HOLE CARDS ***
Dealt to Manon947 [Ks Th]
Klemtonius: calls 100
Mafak2020: calls 100
HighCardJasper: raises 200 to 300
Manon947: calls 300
color_singleton: folds 
dddocky: calls 250
Duke Croix: calls 200
Klemtonius: calls 200
Mafak2020: calls 200
*** FLOP *** [5c Jc 2s]
dddocky: checks 
Duke Croix: checks 
Klemtonius: bets 850
Mafak2020: folds 
HighCardJasper: calls 850
Manon947: folds 
dddocky: folds 
Duke Croix: folds 
*** TURN *** [5c Jc 2s] [Kc]
Klemtonius: bets 3307
HighCardJasper: folds 
Uncalled bet (3307) returned to Klemtonius
Klemtonius collected 3307 from pot
Klemtonius: doesn't show hand 
*** SUMMARY ***
Total pot 3500 | Rake 193 
Board [5c Jc 2s Kc]
Seat 1: color_singleton (button) folded before Flop (didn't bet)
Seat 2: dddocky (small blind) folded on the Flop
Seat 3: Duke Croix (big blind) folded on the Flop
Seat 6: Klemtonius collected (3307)
Seat 7: Mafak2020 folded on the Flop
Seat 8: HighCardJasper folded on the Turn
Seat 9: Manon947 folded on the Flop



PokerStars Home Game Hand #216491448519: {Club #3225207}  Hold'em No Limit (50/100) - 2020/07/16 17:21:07 ET
Table 'Fun times' 9-max (Play Money) Seat #2 is the button
Seat 1: color_singleton (5219 in chips) 
Seat 2: dddocky (10232 in chips) 
Seat 3: Duke Croix (25653 in chips) 
Seat 6: Klemtonius (21979 in chips) 
Seat 7: Mafak2020 (23966 in chips) 
Seat 8: HighCardJasper (8758 in chips) 
Seat 9: Manon947 (11587 in chips) 
Duke Croix: posts small blind 50
Klemtonius: posts big blind 100
*** HOLE CARDS ***
Dealt to Manon947 [5s 3h]
Mafak2020: calls 100
HighCardJasper: calls 100
Manon947: folds 
color_singleton: folds 
dddocky: folds 
Duke Croix: folds 
Klemtonius: checks 
*** FLOP *** [5d 8h 6s]
Klemtonius: bets 331
Mafak2020: folds 
HighCardJasper: calls 331
*** TURN *** [5d 8h 6s] [Qd]
Klemtonius: bets 956
HighCardJasper: folds 
Uncalled bet (956) returned to Klemtonius
Klemtonius collected 956 from pot
Klemtonius: doesn't show hand 
*** SUMMARY ***
Total pot 1012 | Rake 56 
Board [5d 8h 6s Qd]
Seat 1: color_singleton folded before Flop (didn't bet)
Seat 2: dddocky (button) folded before Flop (didn't bet)
Seat 3: Duke Croix (small blind) folded before Flop
Seat 6: Klemtonius (big blind) collected (956)
Seat 7: Mafak2020 folded on the Flop
Seat 8: HighCardJasper folded on the Turn
Seat 9: Manon947 folded before Flop (didn't bet)



PokerStars Home Game Hand #216491468238: {Club #3225207}  Hold'em No Limit (50/100) - 2020/07/16 17:21:40 ET
Table 'Fun times' 9-max (Play Money) Seat #3 is the button
Seat 1: color_singleton (5219 in chips) 
Seat 2: dddocky (10232 in chips) 
Seat 3: Duke Croix (25603 in chips) 
Seat 6: Klemtonius (22504 in chips) 
Seat 7: Mafak2020 (23866 in chips) 
Seat 8: HighCardJasper (8327 in chips) 
Seat 9: Manon947 (11587 in chips) 
Klemtonius: posts small blind 50
Mafak2020: posts big blind 100
*** HOLE CARDS ***
Dealt to Manon947 [Ac 5c]
HighCardJasper: folds 
Manon947: calls 100
color_singleton: folds 
dddocky: calls 100
Duke Croix: folds 
Klemtonius: folds 
Mafak2020: checks 
*** FLOP *** [7c As 4s]
Mafak2020: checks 
Manon947: bets 165
dddocky: folds 
Mafak2020: folds 
Uncalled bet (165) returned to Manon947
Manon947 collected 331 from pot
*** SUMMARY ***
Total pot 350 | Rake 19 
Board [7c As 4s]
Seat 1: color_singleton folded before Flop (didn't bet)
Seat 2: dddocky folded on the Flop
Seat 3: Duke Croix (button) folded before Flop (didn't bet)
Seat 6: Klemtonius (small blind) folded before Flop
Seat 7: Mafak2020 (big blind) folded on the Flop
Seat 8: HighCardJasper folded before Flop (didn't bet)
Seat 9: Manon947 collected (331)



PokerStars Home Game Hand #216491491030: {Club #3225207}  Hold'em No Limit (50/100) - 2020/07/16 17:22:18 ET
Table 'Fun times' 9-max (Play Money) Seat #6 is the button
Seat 1: color_singleton (5219 in chips) 
Seat 2: dddocky (10132 in chips) 
Seat 3: Duke Croix (25603 in chips) 
Seat 6: Klemtonius (22454 in chips) 
Seat 7: Mafak2020 (23766 in chips) 
Seat 8: HighCardJasper (8327 in chips) 
Seat 9: Manon947 (11818 in chips) 
Mafak2020: posts small blind 50
HighCardJasper: posts big blind 100
*** HOLE CARDS ***
Dealt to Manon947 [Qh Tc]
Manon947: calls 100
color_singleton: calls 100
dddocky: folds 
Duke Croix: raises 300 to 400
Klemtonius: folds 
Mafak2020: calls 350
HighCardJasper: calls 300
Manon947: folds 
color_singleton: calls 300
*** FLOP *** [7c 6h 7d]
Mafak2020: checks 
HighCardJasper: checks 
color_singleton: checks 
Duke Croix: bets 600
Mafak2020: folds 
HighCardJasper: folds 
color_singleton: folds 
Uncalled bet (600) returned to Duke Croix
Duke Croix collected 1606 from pot
Duke Croix: doesn't show hand 
*** SUMMARY ***
Total pot 1700 | Rake 94 
Board [7c 6h 7d]
Seat 1: color_singleton folded on the Flop
Seat 2: dddocky folded before Flop (didn't bet)
Seat 3: Duke Croix collected (1606)
Seat 6: Klemtonius (button) folded before Flop (didn't bet)
Seat 7: Mafak2020 (small blind) folded on the Flop
Seat 8: HighCardJasper (big blind) folded on the Flop
Seat 9: Manon947 folded before Flop



PokerStars Home Game Hand #216491521812: {Club #3225207}  Hold'em No Limit (50/100) - 2020/07/16 17:23:09 ET
Table 'Fun times' 9-max (Play Money) Seat #7 is the button
Seat 1: color_singleton (4819 in chips) 
Seat 2: dddocky (10132 in chips) 
Seat 3: Duke Croix (26809 in chips) 
Seat 6: Klemtonius (22454 in chips) 
Seat 7: Mafak2020 (23366 in chips) 
Seat 8: HighCardJasper (7927 in chips) 
Seat 9: Manon947 (11718 in chips) 
HighCardJasper: posts small blind 50
Manon947: posts big blind 100
*** HOLE CARDS ***
Dealt to Manon947 [2h Jd]
color_singleton: folds 
dddocky has timed out
dddocky: folds 
Duke Croix: folds 
Klemtonius: calls 100
Mafak2020: calls 100
HighCardJasper: calls 50
Manon947: checks 
*** FLOP *** [Jh 3c Td]
HighCardJasper: checks 
Manon947: bets 189
Klemtonius: raises 189 to 378
Mafak2020: calls 378
HighCardJasper: folds 
Manon947: calls 189
*** TURN *** [Jh 3c Td] [Ts]
Manon947: bets 725
Klemtonius: folds 
Mafak2020: calls 725
*** RIVER *** [Jh 3c Td Ts] [Ad]
Manon947: checks 
Mafak2020: checks 
*** SHOW DOWN ***
Manon947: shows [2h Jd] (two pair, Jacks and Tens)
Mafak2020: mucks hand 
Manon947 collected 2820 from pot
*** SUMMARY ***
Total pot 2984 | Rake 164 
Board [Jh 3c Td Ts Ad]
Seat 1: color_singleton folded before Flop (didn't bet)
Seat 2: dddocky folded before Flop (didn't bet)
Seat 3: Duke Croix folded before Flop (didn't bet)
Seat 6: Klemtonius folded on the Turn
Seat 7: Mafak2020 (button) mucked [8d Qc]
Seat 8: HighCardJasper (small blind) folded on the Flop
Seat 9: Manon947 (big blind) showed [2h Jd] and won (2820) with two pair, Jacks and Tens



PokerStars Home Game Hand #216491568218: {Club #3225207}  Hold'em No Limit (50/100) - 2020/07/16 17:24:26 ET
Table 'Fun times' 9-max (Play Money) Seat #8 is the button
Seat 1: color_singleton (4819 in chips) 
Seat 3: Duke Croix (26809 in chips) 
Seat 6: Klemtonius (21976 in chips) 
Seat 7: Mafak2020 (22163 in chips) 
Seat 8: HighCardJasper (7827 in chips) 
Seat 9: Manon947 (13335 in chips) 
Manon947: posts small blind 50
color_singleton: posts big blind 100
*** HOLE CARDS ***
Dealt to Manon947 [Th Kd]
Duke Croix: calls 100
Klemtonius: calls 100
Mafak2020: folds 
HighCardJasper: calls 100
Manon947: calls 50
color_singleton: raises 200 to 300
Duke Croix: calls 200
Klemtonius: calls 200
HighCardJasper: folds 
Manon947: calls 200
*** FLOP *** [3c 9h Ad]
Manon947: checks 
color_singleton: checks 
Duke Croix: checks 
Klemtonius: checks 
*** TURN *** [3c 9h Ad] [Kc]
Manon947: bets 614
color_singleton: calls 614
Duke Croix: folds 
Klemtonius: folds 
*** RIVER *** [3c 9h Ad Kc] [Kh]
Manon947: bets 1194
color_singleton has timed out
color_singleton: folds 
Uncalled bet (1194) returned to Manon947
Manon947 collected 2389 from pot
*** SUMMARY ***
Total pot 2528 | Rake 139 
Board [3c 9h Ad Kc Kh]
Seat 1: color_singleton (big blind) folded on the River
Seat 3: Duke Croix folded on the Turn
Seat 6: Klemtonius folded on the Turn
Seat 7: Mafak2020 folded before Flop (didn't bet)
Seat 8: HighCardJasper (button) folded before Flop
Seat 9: Manon947 (small blind) collected (2389)



PokerStars Home Game Hand #216491627315: {Club #3225207}  Hold'em No Limit (50/100) - 2020/07/16 17:26:05 ET
Table 'Fun times' 9-max (Play Money) Seat #9 is the button
Seat 3: Duke Croix (26509 in chips) 
Seat 6: Klemtonius (21676 in chips) 
Seat 7: Mafak2020 (22163 in chips) 
Seat 8: HighCardJasper (7727 in chips) 
Seat 9: Manon947 (14810 in chips) 
Duke Croix: posts small blind 50
Klemtonius: posts big blind 100
*** HOLE CARDS ***
Dealt to Manon947 [Ah 7s]
Mafak2020 has timed out
Mafak2020: folds 
HighCardJasper: calls 100
Manon947: calls 100
Duke Croix: raises 500 to 600
Klemtonius: folds 
HighCardJasper: calls 500
Manon947: calls 500
*** FLOP *** [8d 3d 3s]
Duke Croix: bets 1000
HighCardJasper: folds 
Manon947: folds 
Uncalled bet (1000) returned to Duke Croix
Duke Croix collected 1795 from pot
Duke Croix: doesn't show hand 
*** SUMMARY ***
Total pot 1900 | Rake 105 
Board [8d 3d 3s]
Seat 3: Duke Croix (small blind) collected (1795)
Seat 6: Klemtonius (big blind) folded before Flop
Seat 7: Mafak2020 folded before Flop (didn't bet)
Seat 8: HighCardJasper folded on the Flop
Seat 9: Manon947 (button) folded on the Flop



PokerStars Home Game Hand #216491656733: {Club #3225207}  Hold'em No Limit (50/100) - 2020/07/16 17:26:51 ET
Table 'Fun times' 9-max (Play Money) Seat #3 is the button
Seat 1: color_singleton (3905 in chips) 
Seat 3: Duke Croix (27704 in chips) 
Seat 6: Klemtonius (21576 in chips) 
Seat 7: Mafak2020 (22163 in chips) 
Seat 8: HighCardJasper (7127 in chips) 
Seat 9: Manon947 (14210 in chips) 
Klemtonius: posts small blind 50
Mafak2020: posts big blind 100
color_singleton: posts small blind 50
*** HOLE CARDS ***
Dealt to Manon947 [9s Ah]
HighCardJasper: calls 100
Manon947: calls 100
color_singleton: raises 200 to 300
Duke Croix: folds 
Klemtonius: folds 
Mafak2020: raises 200 to 500
HighCardJasper: calls 400
Manon947: calls 400
color_singleton: calls 200
*** FLOP *** [4h Tc 9c]
Mafak2020: checks 
HighCardJasper: checks 
Manon947: checks 
color_singleton: checks 
*** TURN *** [4h Tc 9c] [2d]
Mafak2020: checks 
HighCardJasper: checks 
Manon947: bets 992
color_singleton: calls 992
Mafak2020: folds 
HighCardJasper: folds 
*** RIVER *** [4h Tc 9c 2d] [Qh]
Manon947: checks 
color_singleton: checks 
*** SHOW DOWN ***
Manon947: shows [9s Ah] (a pair of Nines)
color_singleton: shows [Qc Kc] (a pair of Queens)
color_singleton collected 3859 from pot
*** SUMMARY ***
Total pot 4084 | Rake 225 
Board [4h Tc 9c 2d Qh]
Seat 1: color_singleton showed [Qc Kc] and won (3859) with a pair of Queens
Seat 3: Duke Croix (button) folded before Flop (didn't bet)
Seat 6: Klemtonius (small blind) folded before Flop
Seat 7: Mafak2020 (big blind) folded on the Turn
Seat 8: HighCardJasper folded on the Turn
Seat 9: Manon947 showed [9s Ah] and lost with a pair of Nines



PokerStars Home Game Hand #216491698237: {Club #3225207}  Hold'em No Limit (50/100) - 2020/07/16 17:28:01 ET
Table 'Fun times' 9-max (Play Money) Seat #6 is the button
Seat 1: color_singleton (6222 in chips) 
Seat 3: Duke Croix (27704 in chips) 
Seat 6: Klemtonius (21526 in chips) 
Seat 7: Mafak2020 (21663 in chips) 
Seat 8: HighCardJasper (6627 in chips) 
Seat 9: Manon947 (12718 in chips) 
Mafak2020: posts small blind 50
HighCardJasper: posts big blind 100
*** HOLE CARDS ***
Dealt to Manon947 [3h 5c]
Manon947: folds 
color_singleton: folds 
Duke Croix: folds 
Klemtonius: raises 100 to 200
Mafak2020: calls 150
HighCardJasper: calls 100
*** FLOP *** [3c Ah Qd]
Mafak2020: checks 
HighCardJasper: checks 
Klemtonius: bets 283
Mafak2020: calls 283
HighCardJasper: folds 
*** TURN *** [3c Ah Qd] [6c]
Mafak2020: checks 
Klemtonius: bets 1102
Mafak2020: folds 
Uncalled bet (1102) returned to Klemtonius
Klemtonius collected 1102 from pot
Klemtonius: doesn't show hand 
*** SUMMARY ***
Total pot 1166 | Rake 64 
Board [3c Ah Qd 6c]
Seat 1: color_singleton folded before Flop (didn't bet)
Seat 3: Duke Croix folded before Flop (didn't bet)
Seat 6: Klemtonius (button) collected (1102)
Seat 7: Mafak2020 (small blind) folded on the Turn
Seat 8: HighCardJasper (big blind) folded on the Flop
Seat 9: Manon947 folded before Flop (didn't bet)



PokerStars Home Game Hand #216491745594: {Club #3225207}  Hold'em No Limit (50/100) - 2020/07/16 17:29:20 ET
Table 'Fun times' 9-max (Play Money) Seat #7 is the button
Seat 1: color_singleton (6222 in chips) 
Seat 3: Duke Croix (27704 in chips) 
Seat 6: Klemtonius (22145 in chips) 
Seat 7: Mafak2020 (21180 in chips) 
Seat 8: HighCardJasper (6427 in chips) 
Seat 9: Manon947 (12718 in chips) 
HighCardJasper: posts small blind 50
Manon947: posts big blind 100
*** HOLE CARDS ***
Dealt to Manon947 [Qd 2c]
color_singleton: folds 
Duke Croix: calls 100
Klemtonius: calls 100
Mafak2020: calls 100
HighCardJasper: calls 50
Manon947: checks 
*** FLOP *** [5d Ac 6c]
HighCardJasper: checks 
Manon947: checks 
Duke Croix: bets 300
Klemtonius: folds 
Mafak2020: folds 
HighCardJasper: folds 
Manon947: folds 
Uncalled bet (300) returned to Duke Croix
Duke Croix collected 472 from pot
Duke Croix: doesn't show hand 
*** SUMMARY ***
Total pot 500 | Rake 28 
Board [5d Ac 6c]
Seat 1: color_singleton folded before Flop (didn't bet)
Seat 3: Duke Croix collected (472)
Seat 6: Klemtonius folded on the Flop
Seat 7: Mafak2020 (button) folded on the Flop
Seat 8: HighCardJasper (small blind) folded on the Flop
Seat 9: Manon947 (big blind) folded on the Flop



PokerStars Home Game Hand #216491795230: {Club #3225207}  Hold'em No Limit (50/100) - 2020/07/16 17:30:37 ET
Table 'Fun times' 9-max (Play Money) Seat #8 is the button
Seat 1: color_singleton (6222 in chips) 
Seat 2: dddocky (10132 in chips) 
Seat 3: Duke Croix (28076 in chips) 
Seat 6: Klemtonius (22045 in chips) 
Seat 7: Mafak2020 (21080 in chips) 
Seat 8: HighCardJasper (6327 in chips) 
Seat 9: Manon947 (12618 in chips) 
Manon947: posts small blind 50
color_singleton: posts big blind 100
dddocky: posts small blind 50
*** HOLE CARDS ***
Dealt to Manon947 [9s Jh]
dddocky: calls 100
Duke Croix: raises 300 to 400
Klemtonius: folds 
Mafak2020: folds 
HighCardJasper: folds 
Manon947: folds 
color_singleton: calls 300
dddocky: calls 300
*** FLOP *** [Ts 3s 4h]
color_singleton: bets 614
dddocky: calls 614
Duke Croix: raises 1186 to 1800
color_singleton: folds 
dddocky: folds 
Uncalled bet (1186) returned to Duke Croix
Duke Croix collected 2969 from pot
Duke Croix: doesn't show hand 
*** SUMMARY ***
Total pot 3142 | Rake 173 
Board [Ts 3s 4h]
Seat 1: color_singleton (big blind) folded on the Flop
Seat 2: dddocky folded on the Flop
Seat 3: Duke Croix collected (2969)
Seat 6: Klemtonius folded before Flop (didn't bet)
Seat 7: Mafak2020 folded before Flop (didn't bet)
Seat 8: HighCardJasper (button) folded before Flop (didn't bet)
Seat 9: Manon947 (small blind) folded before Flop



PokerStars Home Game Hand #216491832633: {Club #3225207}  Hold'em No Limit (50/100) - 2020/07/16 17:31:41 ET
Table 'Fun times' 9-max (Play Money) Seat #9 is the button
Seat 1: color_singleton (5208 in chips) 
Seat 2: dddocky (9068 in chips) 
Seat 3: Duke Croix (30031 in chips) 
Seat 6: Klemtonius (22045 in chips) 
Seat 7: Mafak2020 (21080 in chips) 
Seat 8: HighCardJasper (6327 in chips) 
Seat 9: Manon947 (12568 in chips) 
color_singleton: posts small blind 50
dddocky: posts big blind 100
*** HOLE CARDS ***
Dealt to Manon947 [5h 9s]
Duke Croix: raises 300 to 400
Klemtonius: calls 400
Mafak2020: calls 400
HighCardJasper: folds 
Manon947: folds 
color_singleton: calls 350
dddocky: calls 300
*** FLOP *** [8s 7c 5c]
color_singleton: checks 
dddocky: checks 
Duke Croix: checks 
Klemtonius: bets 945
Mafak2020: calls 945
color_singleton: folds 
dddocky: folds 
Duke Croix: folds 
*** TURN *** [8s 7c 5c] [8c]
Klemtonius: bets 1838
Mafak2020 has timed out
Mafak2020: folds 
Uncalled bet (1838) returned to Klemtonius
Klemtonius collected 3676 from pot
Klemtonius: doesn't show hand 
*** SUMMARY ***
Total pot 3890 | Rake 214 
Board [8s 7c 5c 8c]
Seat 1: color_singleton (small blind) folded on the Flop
Seat 2: dddocky (big blind) folded on the Flop
Seat 3: Duke Croix folded on the Flop
Seat 6: Klemtonius collected (3676)
Seat 7: Mafak2020 folded on the Turn
Seat 8: HighCardJasper folded before Flop (didn't bet)
Seat 9: Manon947 (button) folded before Flop (didn't bet)



PokerStars Home Game Hand #216491876461: {Club #3225207}  Hold'em No Limit (50/100) - 2020/07/16 17:32:55 ET
Table 'Fun times' 9-max (Play Money) Seat #1 is the button
Seat 1: color_singleton (4808 in chips) 
Seat 2: dddocky (8668 in chips) 
Seat 3: Duke Croix (29631 in chips) 
Seat 6: Klemtonius (24376 in chips) 
Seat 8: HighCardJasper (6327 in chips) 
Seat 9: Manon947 (12568 in chips) 
dddocky: posts small blind 50
Duke Croix: posts big blind 100
*** HOLE CARDS ***
Dealt to Manon947 [7h 4h]
Klemtonius: calls 100
HighCardJasper: calls 100
Manon947: calls 100
color_singleton: calls 100
dddocky: calls 50
Duke Croix: checks 
*** FLOP *** [Td Ac Ah]
dddocky: bets 100
Duke Croix: raises 300 to 400
Klemtonius: folds 
HighCardJasper: folds 
Manon947: folds 
color_singleton: folds 
dddocky: calls 300
*** TURN *** [Td Ac Ah] [9s]
dddocky: checks 
Duke Croix: checks 
*** RIVER *** [Td Ac Ah 9s] [7c]
dddocky: bets 1323
Duke Croix: calls 1323
*** SHOW DOWN ***
dddocky: shows [Ks Ad] (three of a kind, Aces)
Duke Croix: mucks hand 
dddocky collected 3823 from pot
*** SUMMARY ***
Total pot 4046 | Rake 223 
Board [Td Ac Ah 9s 7c]
Seat 1: color_singleton (button) folded on the Flop
Seat 2: dddocky (small blind) showed [Ks Ad] and won (3823) with three of a kind, Aces
Seat 3: Duke Croix (big blind) mucked [8d Tc]
Seat 6: Klemtonius folded on the Flop
Seat 8: HighCardJasper folded on the Flop
Seat 9: Manon947 folded on the Flop



PokerStars Home Game Hand #216491916844: {Club #3225207}  Hold'em No Limit (50/100) - 2020/07/16 17:34:02 ET
Table 'Fun times' 9-max (Play Money) Seat #2 is the button
Seat 1: color_singleton (4708 in chips) 
Seat 2: dddocky (10668 in chips) 
Seat 3: Duke Croix (27808 in chips) 
Seat 6: Klemtonius (24276 in chips) 
Seat 8: HighCardJasper (6227 in chips) 
Seat 9: Manon947 (12468 in chips) 
Duke Croix: posts small blind 50
Klemtonius: posts big blind 100
*** HOLE CARDS ***
Dealt to Manon947 [Ts Kd]
HighCardJasper: calls 100
Manon947: calls 100
color_singleton: folds 
dddocky: calls 100
Duke Croix: folds 
Klemtonius: checks 
*** FLOP *** [Qs 2d Ah]
Klemtonius: bets 212
HighCardJasper: calls 212
Manon947: folds 
dddocky: folds 
*** TURN *** [Qs 2d Ah] [6s]
Klemtonius: bets 826
HighCardJasper: folds 
Uncalled bet (826) returned to Klemtonius
Klemtonius collected 826 from pot
Klemtonius: doesn't show hand 
*** SUMMARY ***
Total pot 874 | Rake 48 
Board [Qs 2d Ah 6s]
Seat 1: color_singleton folded before Flop (didn't bet)
Seat 2: dddocky (button) folded on the Flop
Seat 3: Duke Croix (small blind) folded before Flop
Seat 6: Klemtonius (big blind) collected (826)
Seat 8: HighCardJasper folded on the Turn
Seat 9: Manon947 folded on the Flop



PokerStars Home Game Hand #216491944856: {Club #3225207}  Hold'em No Limit (50/100) - 2020/07/16 17:34:50 ET
Table 'Fun times' 9-max (Play Money) Seat #3 is the button
Seat 1: color_singleton (4708 in chips) 
Seat 2: dddocky (10568 in chips) 
Seat 3: Duke Croix (27758 in chips) 
Seat 6: Klemtonius (24790 in chips) 
Seat 8: HighCardJasper (5915 in chips) 
Seat 9: Manon947 (12368 in chips) 
Klemtonius: posts small blind 50
HighCardJasper: posts big blind 100
*** HOLE CARDS ***
Dealt to Manon947 [5s 6c]
Manon947: calls 100
color_singleton: calls 100
dddocky: folds 
Duke Croix: folds 
Klemtonius: calls 50
HighCardJasper: checks 
*** FLOP *** [Qs 7s 8h]
Klemtonius: checks 
HighCardJasper: checks 
Manon947: checks 
color_singleton: checks 
*** TURN *** [Qs 7s 8h] [Jd]
Klemtonius: checks 
HighCardJasper: checks 
Manon947: checks 
color_singleton: checks 
*** RIVER *** [Qs 7s 8h Jd] [2s]
Klemtonius: checks 
HighCardJasper: checks 
Manon947: checks 
color_singleton: checks 
*** SHOW DOWN ***
Klemtonius: shows [9s 3c] (high card Queen)
HighCardJasper: shows [4s 7d] (a pair of Sevens)
Manon947: mucks hand 
color_singleton: mucks hand 
HighCardJasper collected 378 from pot
*** SUMMARY ***
Total pot 400 | Rake 22 
Board [Qs 7s 8h Jd 2s]
Seat 1: color_singleton mucked [Kd 3h]
Seat 2: dddocky folded before Flop (didn't bet)
Seat 3: Duke Croix (button) folded before Flop (didn't bet)
Seat 6: Klemtonius (small blind) showed [9s 3c] and lost with high card Queen
Seat 8: HighCardJasper (big blind) showed [4s 7d] and won (378) with a pair of Sevens
Seat 9: Manon947 mucked [5s 6c]



PokerStars Home Game Hand #216491996699: {Club #3225207}  Hold'em No Limit (50/100) - 2020/07/16 17:36:14 ET
Table 'Fun times' 9-max (Play Money) Seat #6 is the button
Seat 1: color_singleton (4608 in chips) 
Seat 2: dddocky (10568 in chips) 
Seat 3: Duke Croix (27758 in chips) 
Seat 6: Klemtonius (24690 in chips) 
Seat 8: HighCardJasper (6193 in chips) 
Seat 9: Manon947 (12268 in chips) 
HighCardJasper: posts small blind 50
Manon947: posts big blind 100
*** HOLE CARDS ***
Dealt to Manon947 [8d 5s]
color_singleton: calls 100
dddocky: raises 100 to 200
Duke Croix: folds 
Klemtonius: folds 
HighCardJasper: calls 150
Manon947: folds 
color_singleton: calls 100
*** FLOP *** [6d Jc 9d]
HighCardJasper: checks 
color_singleton: checks 
dddocky: bets 100
HighCardJasper: calls 100
color_singleton: calls 100
*** TURN *** [6d Jc 9d] [9h]
HighCardJasper: checks 
color_singleton: checks 
dddocky: bets 100
HighCardJasper: calls 100
color_singleton: folds 
*** RIVER *** [6d Jc 9d 9h] [6s]
HighCardJasper: checks 
dddocky: bets 100
HighCardJasper: folds 
Uncalled bet (100) returned to dddocky
dddocky collected 1134 from pot
dddocky: doesn't show hand 
*** SUMMARY ***
Total pot 1200 | Rake 66 
Board [6d Jc 9d 9h 6s]
Seat 1: color_singleton folded on the Turn
Seat 2: dddocky collected (1134)
Seat 3: Duke Croix folded before Flop (didn't bet)
Seat 6: Klemtonius (button) folded before Flop (didn't bet)
Seat 8: HighCardJasper (small blind) folded on the River
Seat 9: Manon947 (big blind) folded before Flop



PokerStars Home Game Hand #216492027887: {Club #3225207}  Hold'em No Limit (50/100) - 2020/07/16 17:37:07 ET
Table 'Fun times' 9-max (Play Money) Seat #8 is the button
Seat 1: color_singleton (4308 in chips) 
Seat 2: dddocky (11302 in chips) 
Seat 3: Duke Croix (27758 in chips) 
Seat 6: Klemtonius (24690 in chips) 
Seat 8: HighCardJasper (5793 in chips) 
Seat 9: Manon947 (12168 in chips) 
Manon947: posts small blind 50
color_singleton: posts big blind 100
*** HOLE CARDS ***
Dealt to Manon947 [3d 2c]
dddocky: calls 100
Duke Croix: raises 400 to 500
Klemtonius: raises 400 to 900
HighCardJasper: folds 
Manon947: folds 
color_singleton: calls 800
dddocky: folds 
Duke Croix: calls 400
*** FLOP *** [Th 5s 4c]
color_singleton: checks 
Duke Croix: checks 
Klemtonius: bets 2693
color_singleton: folds 
Duke Croix: folds 
Uncalled bet (2693) returned to Klemtonius
Klemtonius collected 2693 from pot
Klemtonius: doesn't show hand 
*** SUMMARY ***
Total pot 2850 | Rake 157 
Board [Th 5s 4c]
Seat 1: color_singleton (big blind) folded on the Flop
Seat 2: dddocky folded before Flop
Seat 3: Duke Croix folded on the Flop
Seat 6: Klemtonius collected (2693)
Seat 8: HighCardJasper (button) folded before Flop (didn't bet)
Seat 9: Manon947 (small blind) folded before Flop



PokerStars Home Game Hand #216492058219: {Club #3225207}  Hold'em No Limit (50/100) - 2020/07/16 17:37:59 ET
Table 'Fun times' 9-max (Play Money) Seat #9 is the button
Seat 1: color_singleton (3408 in chips) 
Seat 2: dddocky (11202 in chips) 
Seat 3: Duke Croix (26858 in chips) 
Seat 6: Klemtonius (26483 in chips) 
Seat 8: HighCardJasper (5793 in chips) 
Seat 9: Manon947 (12118 in chips) 
color_singleton: posts small blind 50
dddocky: posts big blind 100
*** HOLE CARDS ***
Dealt to Manon947 [7c Ah]
Duke Croix: folds 
Klemtonius: folds 
HighCardJasper: calls 100
Manon947: calls 100
color_singleton: raises 200 to 300
dddocky: calls 200
HighCardJasper: folds 
Manon947: calls 200
*** FLOP *** [4s 4h 2c]
color_singleton: bets 472
dddocky: folds 
Manon947: calls 472
*** TURN *** [4s 4h 2c] [3c]
color_singleton: bets 918
Manon947: folds 
Uncalled bet (918) returned to color_singleton
color_singleton collected 1837 from pot
color_singleton: doesn't show hand 
*** SUMMARY ***
Total pot 1944 | Rake 107 
Board [4s 4h 2c 3c]
Seat 1: color_singleton (small blind) collected (1837)
Seat 2: dddocky (big blind) folded on the Flop
Seat 3: Duke Croix folded before Flop (didn't bet)
Seat 6: Klemtonius folded before Flop (didn't bet)
Seat 8: HighCardJasper folded before Flop
Seat 9: Manon947 (button) folded on the Turn



PokerStars Home Game Hand #216492082865: {Club #3225207}  Hold'em No Limit (50/100) - 2020/07/16 17:38:42 ET
Table 'Fun times' 9-max (Play Money) Seat #1 is the button
Seat 1: color_singleton (4473 in chips) 
Seat 2: dddocky (10902 in chips) 
Seat 3: Duke Croix (26858 in chips) 
Seat 6: Klemtonius (26483 in chips) 
Seat 8: HighCardJasper (5693 in chips) 
Seat 9: Manon947 (11346 in chips) 
dddocky: posts small blind 50
Duke Croix: posts big blind 100
*** HOLE CARDS ***
Dealt to Manon947 [2d 6d]
Klemtonius: raises 221 to 321
HighCardJasper: folds 
Manon947: folds 
color_singleton: calls 321
dddocky: folds 
Duke Croix: calls 221
*** FLOP *** [9c 5c 5h]
Duke Croix: bets 600
Klemtonius: folds 
color_singleton: folds 
Uncalled bet (600) returned to Duke Croix
Duke Croix collected 957 from pot
Duke Croix: doesn't show hand 
*** SUMMARY ***
Total pot 1013 | Rake 56 
Board [9c 5c 5h]
Seat 1: color_singleton (button) folded on the Flop
Seat 2: dddocky (small blind) folded before Flop
Seat 3: Duke Croix (big blind) collected (957)
Seat 6: Klemtonius folded on the Flop
Seat 8: HighCardJasper folded before Flop (didn't bet)
Seat 9: Manon947 folded before Flop (didn't bet)



PokerStars Home Game Hand #216492110808: {Club #3225207}  Hold'em No Limit (50/100) - 2020/07/16 17:39:29 ET
Table 'Fun times' 9-max (Play Money) Seat #2 is the button
Seat 1: color_singleton (4152 in chips) 
Seat 2: dddocky (10852 in chips) 
Seat 3: Duke Croix (27494 in chips) 
Seat 6: Klemtonius (26162 in chips) 
Seat 8: HighCardJasper (5693 in chips) 
Seat 9: Manon947 (11346 in chips) 
Duke Croix: posts small blind 50
Klemtonius: posts big blind 100
*** HOLE CARDS ***
Dealt to Manon947 [8d Ts]
HighCardJasper: calls 100
Manon947: folds 
color_singleton: calls 100
dddocky: raises 400 to 500
Duke Croix: folds 
Klemtonius: folds 
HighCardJasper: folds 
color_singleton: folds 
Uncalled bet (400) returned to dddocky
dddocky collected 450 from pot
dddocky: doesn't show hand 
*** SUMMARY ***
Total pot 450 | Rake 0 
Seat 1: color_singleton folded before Flop
Seat 2: dddocky (button) collected (450)
Seat 3: Duke Croix (small blind) folded before Flop
Seat 6: Klemtonius (big blind) folded before Flop
Seat 8: HighCardJasper folded before Flop
Seat 9: Manon947 folded before Flop (didn't bet)



PokerStars Home Game Hand #216492125163: {Club #3225207}  Hold'em No Limit (50/100) - 2020/07/16 17:39:54 ET
Table 'Fun times' 9-max (Play Money) Seat #3 is the button
Seat 1: color_singleton (4052 in chips) 
Seat 2: dddocky (11202 in chips) 
Seat 3: Duke Croix (27444 in chips) 
Seat 6: Klemtonius (26062 in chips) 
Seat 8: HighCardJasper (5593 in chips) 
Seat 9: Manon947 (11346 in chips) 
Klemtonius: posts small blind 50
HighCardJasper: posts big blind 100
*** HOLE CARDS ***
Dealt to Manon947 [Td Qd]
Manon947: calls 100
color_singleton: raises 200 to 300
dddocky: folds 
Mafak2020 is disconnected 
Duke Croix: calls 300
Klemtonius: raises 200 to 500
HighCardJasper: folds 
Manon947: calls 400
color_singleton: calls 200
Duke Croix: calls 200
*** FLOP *** [Ad 3h 8d]
Klemtonius: checks 
Manon947: checks 
color_singleton: checks 
Duke Croix: bets 600
Klemtonius: folds 
Manon947: calls 600
color_singleton: folds 
*** TURN *** [Ad 3h 8d] [5c]
Manon947: checks 
Duke Croix: bets 1400
Manon947: folds 
Uncalled bet (1400) returned to Duke Croix
Duke Croix collected 3118 from pot
Duke Croix: doesn't show hand 
*** SUMMARY ***
Total pot 3300 | Rake 182 
Board [Ad 3h 8d 5c]
Seat 1: color_singleton folded on the Flop
Seat 2: dddocky folded before Flop (didn't bet)
Seat 3: Duke Croix (button) collected (3118)
Seat 6: Klemtonius (small blind) folded on the Flop
Seat 8: HighCardJasper (big blind) folded before Flop
Seat 9: Manon947 folded on the Turn



PokerStars Home Game Hand #216492180678: {Club #3225207}  Hold'em No Limit (50/100) - 2020/07/16 17:41:18 ET
Table 'Fun times' 9-max (Play Money) Seat #6 is the button
Seat 1: color_singleton (3552 in chips) 
Seat 2: dddocky (11202 in chips) 
Seat 3: Duke Croix (29462 in chips) 
Seat 6: Klemtonius (25562 in chips) 
Seat 8: HighCardJasper (5493 in chips) 
Seat 9: Manon947 (10246 in chips) 
HighCardJasper: posts small blind 50
Manon947: posts big blind 100
*** HOLE CARDS ***
Dealt to Manon947 [5s Ac]
color_singleton: raises 100 to 200
dddocky: calls 200
Duke Croix: calls 200
Klemtonius: folds 
HighCardJasper: calls 150
Manon947: calls 100
*** FLOP *** [Ah 6s Qd]
HighCardJasper: checks 
Manon947: bets 472
color_singleton: calls 472
dddocky: folds 
Duke Croix: folds 
HighCardJasper: calls 472
*** TURN *** [Ah 6s Qd] [6d]
HighCardJasper: checks 
Manon947: bets 1141
color_singleton: folds 
HighCardJasper: folds 
Uncalled bet (1141) returned to Manon947
Manon947 collected 2283 from pot
*** SUMMARY ***
Total pot 2416 | Rake 133 
Board [Ah 6s Qd 6d]
Seat 1: color_singleton folded on the Turn
Seat 2: dddocky folded on the Flop
Seat 3: Duke Croix folded on the Flop
Seat 6: Klemtonius (button) folded before Flop (didn't bet)
Seat 8: HighCardJasper (small blind) folded on the Turn
Seat 9: Manon947 (big blind) collected (2283)



PokerStars Home Game Hand #216492212418: {Club #3225207}  Hold'em No Limit (50/100) - 2020/07/16 17:42:13 ET
Table 'Fun times' 9-max (Play Money) Seat #8 is the button
Seat 1: color_singleton (2880 in chips) 
Seat 2: dddocky (11002 in chips) 
Seat 3: Duke Croix (29262 in chips) 
Seat 6: Klemtonius (25562 in chips) 
Seat 8: HighCardJasper (4821 in chips) 
Seat 9: Manon947 (11857 in chips) 
Manon947: posts small blind 50
color_singleton: posts big blind 100
*** HOLE CARDS ***
Dealt to Manon947 [5h As]
dddocky: calls 100
Duke Croix has timed out
Duke Croix: folds 
Klemtonius: calls 100
HighCardJasper: calls 100
Manon947: calls 50
color_singleton: raises 200 to 300
dddocky: folds 
Klemtonius: calls 200
HighCardJasper: calls 200
Manon947: calls 200
*** FLOP *** [Jh Kd 3d]
Manon947: checks 
color_singleton: bets 614
Klemtonius: folds 
HighCardJasper: folds 
Manon947: folds 
Uncalled bet (614) returned to color_singleton
color_singleton collected 1228 from pot
color_singleton: doesn't show hand 
*** SUMMARY ***
Total pot 1300 | Rake 72 
Board [Jh Kd 3d]
Seat 1: color_singleton (big blind) collected (1228)
Seat 2: dddocky folded before Flop
Seat 3: Duke Croix folded before Flop (didn't bet)
Seat 6: Klemtonius folded on the Flop
Seat 8: HighCardJasper (button) folded on the Flop
Seat 9: Manon947 (small blind) folded on the Flop



PokerStars Home Game Hand #216492247690: {Club #3225207}  Hold'em No Limit (50/100) - 2020/07/16 17:43:14 ET
Table 'Fun times' 9-max (Play Money) Seat #9 is the button
Seat 1: color_singleton (3808 in chips) 
Seat 2: dddocky (10902 in chips) 
Seat 6: Klemtonius (25262 in chips) 
Seat 8: HighCardJasper (4521 in chips) 
Seat 9: Manon947 (11557 in chips) 
color_singleton: posts small blind 50
dddocky: posts big blind 100
*** HOLE CARDS ***
Dealt to Manon947 [9d Tc]
Klemtonius: raises 344 to 444
HighCardJasper: calls 444
Manon947: folds 
color_singleton: folds 
dddocky: folds 
*** FLOP *** [5s Qd Kh]
Klemtonius: bets 490
HighCardJasper: calls 490
*** TURN *** [5s Qd Kh] [4c]
Klemtonius: checks 
HighCardJasper: checks 
*** RIVER *** [5s Qd Kh 4c] [3h]
Klemtonius: checks 
HighCardJasper: checks 
*** SHOW DOWN ***
Klemtonius: shows [Ad 2d] (a straight, Ace to Five)
HighCardJasper: mucks hand 
Klemtonius collected 1907 from pot
*** SUMMARY ***
Total pot 2018 | Rake 111 
Board [5s Qd Kh 4c 3h]
Seat 1: color_singleton (small blind) folded before Flop
Seat 2: dddocky (big blind) folded before Flop
Seat 6: Klemtonius showed [Ad 2d] and won (1907) with a straight, Ace to Five
Seat 8: HighCardJasper mucked [Jc Qs]
Seat 9: Manon947 (button) folded before Flop (didn't bet)



PokerStars Home Game Hand #216492284103: {Club #3225207}  Hold'em No Limit (50/100) - 2020/07/16 17:44:17 ET
Table 'Fun times' 9-max (Play Money) Seat #1 is the button
Seat 1: color_singleton (3758 in chips) 
Seat 3: Duke Croix (29262 in chips) 
Seat 6: Klemtonius (26235 in chips) 
Seat 8: HighCardJasper (3587 in chips) 
Seat 9: Manon947 (11557 in chips) 
Duke Croix: posts small blind 50
Klemtonius: posts big blind 100
*** HOLE CARDS ***
Dealt to Manon947 [Kd Jh]
HighCardJasper: calls 100
Manon947: calls 100
color_singleton: folds 
Duke Croix has timed out
Duke Croix: folds 
Klemtonius: checks 
*** FLOP *** [2h 8d 6h]
Klemtonius: checks 
HighCardJasper: checks 
Manon947: checks 
*** TURN *** [2h 8d 6h] [2c]
Klemtonius: checks 
HighCardJasper: checks 
Manon947: checks 
*** RIVER *** [2h 8d 6h 2c] [4s]
Klemtonius: bets 165
HighCardJasper: folds 
Manon947: folds 
Uncalled bet (165) returned to Klemtonius
Klemtonius collected 331 from pot
Klemtonius: doesn't show hand 
*** SUMMARY ***
Total pot 350 | Rake 19 
Board [2h 8d 6h 2c 4s]
Seat 1: color_singleton (button) folded before Flop (didn't bet)
Seat 3: Duke Croix (small blind) folded before Flop
Seat 6: Klemtonius (big blind) collected (331)
Seat 8: HighCardJasper folded on the River
Seat 9: Manon947 folded on the River



PokerStars Home Game Hand #216492318912: {Club #3225207}  Hold'em No Limit (50/100) - 2020/07/16 17:45:17 ET
Table 'Fun times' 9-max (Play Money) Seat #3 is the button
Seat 1: color_singleton (3758 in chips) 
Seat 2: dddocky (10802 in chips) 
Seat 3: Duke Croix (29212 in chips) 
Seat 6: Klemtonius (26466 in chips) 
Seat 8: HighCardJasper (3487 in chips) 
Seat 9: Manon947 (11457 in chips) 
Klemtonius: posts small blind 50
HighCardJasper: posts big blind 100
dddocky: posts small blind 50
*** HOLE CARDS ***
Dealt to Manon947 [7c 8c]
Manon947: calls 100
color_singleton: folds 
dddocky: calls 100
Duke Croix: raises 300 to 400
Klemtonius: raises 300 to 700
HighCardJasper: folds 
Manon947: folds 
dddocky: calls 600
Duke Croix: calls 300
*** FLOP *** [Jd 5s 6s]
Klemtonius: bets 1110
dddocky: folds 
Duke Croix: calls 1110
*** TURN *** [Jd 5s 6s] [4s]
Klemtonius: checks 
Duke Croix: bets 2000
Klemtonius: raises 2000 to 4000
Duke Croix: calls 2000
*** RIVER *** [Jd 5s 6s 4s] [4h]
Klemtonius: checks 
Duke Croix: checks 
*** SHOW DOWN ***
Klemtonius: shows [Kc Ad] (a pair of Fours)
Duke Croix: shows [Js Td] (two pair, Jacks and Fours)
Duke Croix collected 11879 from pot
*** SUMMARY ***
Total pot 12570 | Rake 691 
Board [Jd 5s 6s 4s 4h]
Seat 1: color_singleton folded before Flop (didn't bet)
Seat 2: dddocky folded on the Flop
Seat 3: Duke Croix (button) showed [Js Td] and won (11879) with two pair, Jacks and Fours
Seat 6: Klemtonius (small blind) showed [Kc Ad] and lost with a pair of Fours
Seat 8: HighCardJasper (big blind) folded before Flop
Seat 9: Manon947 folded before Flop



PokerStars Home Game Hand #216492362058: {Club #3225207}  Hold'em No Limit (50/100) - 2020/07/16 17:46:32 ET
Table 'Fun times' 9-max (Play Money) Seat #6 is the button
Seat 1: color_singleton (3758 in chips) 
Seat 2: dddocky (10052 in chips) 
Seat 3: Duke Croix (35281 in chips) 
Seat 6: Klemtonius (20656 in chips) 
Seat 8: HighCardJasper (3387 in chips) 
Seat 9: Manon947 (11357 in chips) 
HighCardJasper: posts small blind 50
Manon947: posts big blind 100
*** HOLE CARDS ***
Dealt to Manon947 [Td 9s]
color_singleton: raises 100 to 200
dddocky: calls 200
Duke Croix: calls 200
Klemtonius: calls 200
HighCardJasper: calls 150
Manon947: folds 
*** FLOP *** [8c Qd 8d]
HighCardJasper: checks 
color_singleton: checks 
dddocky: checks 
Duke Croix: checks 
Klemtonius: checks 
*** TURN *** [8c Qd 8d] [6d]
HighCardJasper: checks 
color_singleton: checks 
dddocky: checks 
Duke Croix: bets 600
Klemtonius: folds 
HighCardJasper: calls 600
color_singleton: folds 
dddocky: folds 
*** RIVER *** [8c Qd 8d 6d] [Ah]
HighCardJasper: bets 1000
Duke Croix: folds 
Uncalled bet (1000) returned to HighCardJasper
HighCardJasper collected 2173 from pot
HighCardJasper: doesn't show hand 
*** SUMMARY ***
Total pot 2300 | Rake 127 
Board [8c Qd 8d 6d Ah]
Seat 1: color_singleton folded on the Turn
Seat 2: dddocky folded on the Turn
Seat 3: Duke Croix folded on the River
Seat 6: Klemtonius (button) folded on the Turn
Seat 8: HighCardJasper (small blind) collected (2173)
Seat 9: Manon947 (big blind) folded before Flop



PokerStars Home Game Hand #216492408223: {Club #3225207}  Hold'em No Limit (50/100) - 2020/07/16 17:47:53 ET
Table 'Fun times' 9-max (Play Money) Seat #8 is the button
Seat 1: color_singleton (3558 in chips) 
Seat 2: dddocky (9852 in chips) 
Seat 3: Duke Croix (34481 in chips) 
Seat 6: Klemtonius (20456 in chips) 
Seat 8: HighCardJasper (4760 in chips) 
Seat 9: Manon947 (11257 in chips) 
Manon947: posts small blind 50
color_singleton: posts big blind 100
*** HOLE CARDS ***
Dealt to Manon947 [Jc 5c]
dddocky: folds 
Duke Croix: folds 
Klemtonius: raises 100 to 200
HighCardJasper: calls 200
Manon947: calls 150
color_singleton: calls 100
*** FLOP *** [Jh 6d Td]
Manon947: checks 
color_singleton: checks 
Klemtonius: bets 756
HighCardJasper: folds 
Manon947: calls 756
color_singleton: calls 756
*** TURN *** [Jh 6d Td] [Qs]
Manon947: checks 
color_singleton: checks 
Klemtonius: checks 
*** RIVER *** [Jh 6d Td Qs] [As]
Manon947: checks 
color_singleton: checks 
Klemtonius: bets 800
Manon947: folds 
color_singleton: calls 800
*** SHOW DOWN ***
Klemtonius: shows [Th Ah] (two pair, Aces and Tens)
color_singleton: mucks hand 
Klemtonius collected 4411 from pot
*** SUMMARY ***
Total pot 4668 | Rake 257 
Board [Jh 6d Td Qs As]
Seat 1: color_singleton (big blind) mucked [9d Ad]
Seat 2: dddocky folded before Flop (didn't bet)
Seat 3: Duke Croix folded before Flop (didn't bet)
Seat 6: Klemtonius showed [Th Ah] and won (4411) with two pair, Aces and Tens
Seat 8: HighCardJasper (button) folded on the Flop
Seat 9: Manon947 (small blind) folded on the River



PokerStars Home Game Hand #216492459706: {Club #3225207}  Hold'em No Limit (50/100) - 2020/07/16 17:49:10 ET
Table 'Fun times' 9-max (Play Money) Seat #9 is the button
Seat 1: color_singleton (1802 in chips) 
Seat 2: dddocky (9852 in chips) 
Seat 3: Duke Croix (34481 in chips) 
Seat 6: Klemtonius (23111 in chips) 
Seat 8: HighCardJasper (4560 in chips) 
Seat 9: Manon947 (10301 in chips) 
color_singleton: posts small blind 50
dddocky: posts big blind 100
*** HOLE CARDS ***
Dealt to Manon947 [3c 8c]
Duke Croix: calls 100
Klemtonius: raises 100 to 200
HighCardJasper: folds 
Manon947: calls 200
color_singleton: raises 400 to 600
dddocky: folds 
Duke Croix: folds 
Klemtonius: calls 400
Manon947: calls 400
*** FLOP *** [4h Ah 5d]
color_singleton: bets 1202 and is all-in
Klemtonius: calls 1202
Manon947: folds 
*** TURN *** [4h Ah 5d] [8h]
*** RIVER *** [4h Ah 5d 8h] [7s]
*** SHOW DOWN ***
color_singleton: shows [2d As] (a pair of Aces)
Klemtonius: shows [3d Ad] (a pair of Aces)
color_singleton collected 2081 from pot
Klemtonius collected 2081 from pot
*** SUMMARY ***
Total pot 4404 | Rake 242 
Board [4h Ah 5d 8h 7s]
Seat 1: color_singleton (small blind) showed [2d As] and won (2081) with a pair of Aces
Seat 2: dddocky (big blind) folded before Flop
Seat 3: Duke Croix folded before Flop
Seat 6: Klemtonius showed [3d Ad] and won (2081) with a pair of Aces
Seat 8: HighCardJasper folded before Flop (didn't bet)
Seat 9: Manon947 (button) folded on the Flop



PokerStars Home Game Hand #216492487849: {Club #3225207}  Hold'em No Limit (50/100) - 2020/07/16 17:50:01 ET
Table 'Fun times' 9-max (Play Money) Seat #1 is the button
Seat 1: color_singleton (2081 in chips) 
Seat 2: dddocky (9752 in chips) 
Seat 3: Duke Croix (34381 in chips) 
Seat 6: Klemtonius (23390 in chips) 
Seat 8: HighCardJasper (4560 in chips) 
Seat 9: Manon947 (9701 in chips) 
dddocky: posts small blind 50
Duke Croix: posts big blind 100
*** HOLE CARDS ***
Dealt to Manon947 [Jd Th]
Klemtonius: calls 100
HighCardJasper: calls 100
Manon947: calls 100
Mafak2020 was removed from the table for failing to post
Mafak2020 leaves the table
color_singleton: raises 200 to 300
dddocky: calls 250
Duke Croix: calls 200
Klemtonius: calls 200
HighCardJasper: calls 200
Manon947: calls 200
*** FLOP *** [5d 2d Qh]
dddocky: checks 
Duke Croix: checks 
Klemtonius: bets 1001
HighCardJasper: folds 
Manon947: folds 
color_singleton: folds 
dddocky: folds 
Duke Croix: folds 
Uncalled bet (1001) returned to Klemtonius
Klemtonius collected 1701 from pot
Klemtonius: doesn't show hand 
*** SUMMARY ***
Total pot 1800 | Rake 99 
Board [5d 2d Qh]
Seat 1: color_singleton (button) folded on the Flop
Seat 2: dddocky (small blind) folded on the Flop
Seat 3: Duke Croix (big blind) folded on the Flop
Seat 6: Klemtonius collected (1701)
Seat 8: HighCardJasper folded on the Flop
Seat 9: Manon947 folded on the Flop



PokerStars Home Game Hand #216492530477: {Club #3225207}  Hold'em No Limit (50/100) - 2020/07/16 17:51:16 ET
Table 'Fun times' 9-max (Play Money) Seat #2 is the button
Seat 1: color_singleton (1781 in chips) 
Seat 2: dddocky (9452 in chips) 
Seat 3: Duke Croix (34081 in chips) 
Seat 6: Klemtonius (24791 in chips) 
Seat 8: HighCardJasper (4260 in chips) 
Seat 9: Manon947 (9401 in chips) 
Duke Croix: posts small blind 50
Klemtonius: posts big blind 100
*** HOLE CARDS ***
Dealt to Manon947 [9c Qc]
HighCardJasper: calls 100
Manon947: calls 100
color_singleton: folds 
dddocky: calls 100
Duke Croix: raises 400 to 500
Klemtonius: folds 
HighCardJasper: folds 
Manon947: calls 400
dddocky: folds 
*** FLOP *** [Jd Kh Tc]
Duke Croix: bets 900
Manon947: calls 900
*** TURN *** [Jd Kh Tc] [3h]
Duke Croix: bets 1400
Manon947: calls 1400
*** RIVER *** [Jd Kh Tc 3h] [5h]
Duke Croix: checks 
Manon947: checks 
*** SHOW DOWN ***
Duke Croix: shows [Ad Ac] (a pair of Aces)
Manon947: shows [9c Qc] (a straight, Nine to King)
Manon947 collected 5575 from pot
*** SUMMARY ***
Total pot 5900 | Rake 325 
Board [Jd Kh Tc 3h 5h]
Seat 1: color_singleton folded before Flop (didn't bet)
Seat 2: dddocky (button) folded before Flop
Seat 3: Duke Croix (small blind) showed [Ad Ac] and lost with a pair of Aces
Seat 6: Klemtonius (big blind) folded before Flop
Seat 8: HighCardJasper folded before Flop
Seat 9: Manon947 showed [9c Qc] and won (5575) with a straight, Nine to King



PokerStars Home Game Hand #216492554450: {Club #3225207}  Hold'em No Limit (50/100) - 2020/07/16 17:51:59 ET
Table 'Fun times' 9-max (Play Money) Seat #3 is the button
Seat 1: color_singleton (1781 in chips) 
Seat 2: dddocky (9352 in chips) 
Seat 3: Duke Croix (31281 in chips) 
Seat 6: Klemtonius (24691 in chips) 
Seat 8: HighCardJasper (4160 in chips) 
Seat 9: Manon947 (12176 in chips) 
Klemtonius: posts small blind 50
HighCardJasper: posts big blind 100
*** HOLE CARDS ***
Dealt to Manon947 [7h 5s]
Manon947: folds 
color_singleton: raises 100 to 200
dddocky: folds 
Duke Croix: calls 200
Klemtonius: calls 150
HighCardJasper: calls 100
*** FLOP *** [6c 8c Qd]
Klemtonius: bets 756
HighCardJasper: calls 756
color_singleton: raises 825 to 1581 and is all-in
Duke Croix: calls 1581
Klemtonius: calls 825
HighCardJasper: calls 825
*** TURN *** [6c 8c Qd] [7c]
Klemtonius: checks 
HighCardJasper: checks 
Duke Croix: checks 
*** RIVER *** [6c 8c Qd 7c] [Ac]
Klemtonius: checks 
HighCardJasper: checks 
Duke Croix: checks 
*** SHOW DOWN ***
Klemtonius: shows [Ts 7s] (a pair of Sevens)
HighCardJasper: shows [Jh Jd] (a pair of Jacks)
color_singleton: shows [As Ah] (three of a kind, Aces)
Duke Croix: mucks hand 
color_singleton collected 6732 from pot
*** SUMMARY ***
Total pot 7124 | Rake 392 
Board [6c 8c Qd 7c Ac]
Seat 1: color_singleton showed [As Ah] and won (6732) with three of a kind, Aces
Seat 2: dddocky folded before Flop (didn't bet)
Seat 3: Duke Croix (button) mucked [Qh 9h]
Seat 6: Klemtonius (small blind) showed [Ts 7s] and lost with a pair of Sevens
Seat 8: HighCardJasper (big blind) showed [Jh Jd] and lost with a pair of Jacks
Seat 9: Manon947 folded before Flop (didn't bet)



PokerStars Home Game Hand #216492669926: {Club #3225207}  Hold'em No Limit (50/100) - 2020/07/16 17:55:33 ET
Table 'Fun times' 9-max (Play Money) Seat #2 is the button
Seat 1: color_singleton (6582 in chips) 
Seat 2: dddocky (9152 in chips) 
Seat 3: Duke Croix (33536 in chips) 
Seat 6: Klemtonius (18960 in chips) 
Seat 7: Mafak2020 (9900 in chips) 
Seat 8: HighCardJasper (2179 in chips) 
Seat 9: Manon947 (12176 in chips) 
Duke Croix: posts small blind 50
Klemtonius: posts big blind 100
Manon947: posts small & big blinds 150
*** HOLE CARDS ***
Dealt to Manon947 [Th 6h]
Mafak2020: calls 100
HighCardJasper: calls 100
Manon947: checks 
color_singleton: folds 
dddocky: calls 100
Duke Croix: calls 50
Klemtonius: checks 
*** FLOP *** [Tc Kc 4s]
Duke Croix has timed out
Duke Croix: checks 
Klemtonius: checks 
Mafak2020: bets 600
HighCardJasper: folds 
Manon947: folds 
dddocky: calls 600
Duke Croix: folds 
Klemtonius: folds 
*** TURN *** [Tc Kc 4s] [6s]
Mafak2020: checks 
dddocky: checks 
*** RIVER *** [Tc Kc 4s 6s] [Qc]
Mafak2020: checks 
dddocky: checks 
*** SHOW DOWN ***
Mafak2020: shows [5s Kd] (a pair of Kings)
dddocky: shows [Kh 9c] (a pair of Kings - Queen+Ten+Nine kicker)
dddocky collected 1748 from pot
*** SUMMARY ***
Total pot 1850 | Rake 102 
Board [Tc Kc 4s 6s Qc]
Seat 1: color_singleton folded before Flop (didn't bet)
Seat 2: dddocky (button) showed [Kh 9c] and won (1748) with a pair of Kings
Seat 3: Duke Croix (small blind) folded on the Flop
Seat 6: Klemtonius (big blind) folded on the Flop
Seat 7: Mafak2020 showed [5s Kd] and lost with a pair of Kings
Seat 8: HighCardJasper folded on the Flop
Seat 9: Manon947 folded on the Flop (didn't bet)



PokerStars Home Game Hand #216492706479: {Club #3225207}  Hold'em No Limit (50/100) - 2020/07/16 17:56:57 ET
Table 'Fun times' 9-max (Play Money) Seat #3 is the button
Seat 1: color_singleton (6582 in chips) 
Seat 2: dddocky (10200 in chips) 
Seat 3: Duke Croix (33436 in chips) 
Seat 6: Klemtonius (18860 in chips) 
Seat 7: Mafak2020 (9200 in chips) 
Seat 8: HighCardJasper (2079 in chips) 
Seat 9: Manon947 (12026 in chips) 
Klemtonius: posts small blind 50
Mafak2020: posts big blind 100
*** HOLE CARDS ***
Dealt to Manon947 [Jd 3h]
HighCardJasper: calls 100
Manon947: calls 100
color_singleton: calls 100
dddocky: folds 
Duke Croix: raises 500 to 600
Klemtonius: folds 
Mafak2020: calls 500
HighCardJasper: raises 1479 to 2079 and is all-in
Manon947: folds 
color_singleton: folds 
Duke Croix: calls 1479
Mafak2020: calls 1479
*** FLOP *** [2s Qh Ad]
Mafak2020: checks 
Duke Croix: bets 1565
Mafak2020: raises 5556 to 7121 and is all-in
Duke Croix: calls 5556
*** TURN *** [2s Qh Ad] [6d]
*** RIVER *** [2s Qh Ad 6d] [7s]
*** SHOW DOWN ***
Mafak2020: shows [Ac Kd] (a pair of Aces)
Duke Croix: shows [As 9s] (a pair of Aces - lower kicker)
Mafak2020 collected 13459 from side pot
HighCardJasper: shows [4c 4d] (a pair of Fours)
Mafak2020 collected 6130 from main pot
*** SUMMARY ***
Total pot 20729 Main pot 6130. Side pot 13459. | Rake 1140 
Board [2s Qh Ad 6d 7s]
Seat 1: color_singleton folded before Flop
Seat 2: dddocky folded before Flop (didn't bet)
Seat 3: Duke Croix (button) showed [As 9s] and lost with a pair of Aces
Seat 6: Klemtonius (small blind) folded before Flop
Seat 7: Mafak2020 (big blind) showed [Ac Kd] and won (19589) with a pair of Aces
Seat 8: HighCardJasper showed [4c 4d] and lost with a pair of Fours
Seat 9: Manon947 folded before Flop



PokerStars Home Game Hand #216492741867: {Club #3225207}  Hold'em No Limit (50/100) - 2020/07/16 17:58:18 ET
Table 'Fun times' 9-max (Play Money) Seat #6 is the button
Seat 1: color_singleton (6482 in chips) 
Seat 2: dddocky (10200 in chips) 
Seat 3: Duke Croix (24236 in chips) 
Seat 6: Klemtonius (18810 in chips) 
Seat 7: Mafak2020 (19589 in chips) 
Seat 9: Manon947 (11926 in chips) 
Mafak2020: posts small blind 50
Manon947: posts big blind 100
*** HOLE CARDS ***
Dealt to Manon947 [4s 3s]
color_singleton: raises 100 to 200
dddocky: folds 
Duke Croix: folds 
Klemtonius: calls 200
Mafak2020: calls 150
Manon947: calls 100
*** FLOP *** [8h 5c 3d]
Mafak2020: checks 
Manon947: checks 
color_singleton: checks 
Klemtonius: bets 756
Mafak2020: folds 
Manon947: folds 
color_singleton: folds 
Uncalled bet (756) returned to Klemtonius
Klemtonius collected 756 from pot
Klemtonius: doesn't show hand 
*** SUMMARY ***
Total pot 800 | Rake 44 
Board [8h 5c 3d]
Seat 1: color_singleton folded on the Flop
Seat 2: dddocky folded before Flop (didn't bet)
Seat 3: Duke Croix folded before Flop (didn't bet)
Seat 6: Klemtonius (button) collected (756)
Seat 7: Mafak2020 (small blind) folded on the Flop
Seat 9: Manon947 (big blind) folded on the Flop



PokerStars Home Game Hand #216492757649: {Club #3225207}  Hold'em No Limit (50/100) - 2020/07/16 17:58:54 ET
Table 'Fun times' 9-max (Play Money) Seat #7 is the button
Seat 1: color_singleton (6282 in chips) 
Seat 2: dddocky (10200 in chips) 
Seat 3: Duke Croix (24236 in chips) 
Seat 6: Klemtonius (19366 in chips) 
Seat 7: Mafak2020 (19389 in chips) 
Seat 9: Manon947 (11726 in chips) 
Manon947: posts small blind 50
color_singleton: posts big blind 100
*** HOLE CARDS ***
Dealt to Manon947 [3h Ad]
dddocky: calls 100
Duke Croix: calls 100
Klemtonius: calls 100
Mafak2020: calls 100
Manon947: calls 50
color_singleton: checks 
*** FLOP *** [6h 8s 5h]
Manon947: checks 
color_singleton: checks 
dddocky: checks 
Duke Croix: bets 300
Klemtonius: calls 300
Mafak2020: calls 300
Manon947: calls 300
color_singleton: calls 300
dddocky: folds 
*** TURN *** [6h 8s 5h] [9h]
Manon947: checks 
color_singleton: checks 
Duke Croix: bets 992
Klemtonius: raises 992 to 1984
Mafak2020: folds 
Manon947: folds 
color_singleton: folds 
Duke Croix: calls 992
*** RIVER *** [6h 8s 5h 9h] [5s]
Duke Croix: checks 
Klemtonius: bets 16982 and is all-in
Duke Croix: folds 
Uncalled bet (16982) returned to Klemtonius
Klemtonius collected 5734 from pot
Klemtonius: doesn't show hand 
*** SUMMARY ***
Total pot 6068 | Rake 334 
Board [6h 8s 5h 9h 5s]
Seat 1: color_singleton (big blind) folded on the Turn
Seat 2: dddocky folded on the Flop
Seat 3: Duke Croix folded on the River
Seat 6: Klemtonius collected (5734)
Seat 7: Mafak2020 (button) folded on the Turn
Seat 9: Manon947 (small blind) folded on the Turn



PokerStars Home Game Hand #216492799577: {Club #3225207}  Hold'em No Limit (50/100) - 2020/07/16 18:00:30 ET
Table 'Fun times' 9-max (Play Money) Seat #9 is the button
Seat 1: color_singleton (5882 in chips) 
Seat 2: dddocky (10100 in chips) 
Seat 3: Duke Croix (21852 in chips) 
Seat 6: Klemtonius (22716 in chips) 
Seat 7: Mafak2020 (18989 in chips) 
Seat 8: HighCardJasper (10000 in chips) 
Seat 9: Manon947 (11326 in chips) 
color_singleton: posts small blind 50
dddocky: posts big blind 100
HighCardJasper: posts small & big blinds 150
*** HOLE CARDS ***
Dealt to Manon947 [4c Ks]
Duke Croix: calls 100
Klemtonius: calls 100
Mafak2020: raises 100 to 200
HighCardJasper has timed out
HighCardJasper: folds 
Manon947: calls 200
color_singleton: calls 150
dddocky: folds 
Duke Croix: calls 100
Klemtonius: calls 100
*** FLOP *** [8c Ts Ac]
color_singleton: checks 
Duke Croix: checks 
Klemtonius: checks 
Mafak2020: checks 
Manon947: checks 
*** TURN *** [8c Ts Ac] [9c]
color_singleton: checks 
Duke Croix: checks 
Klemtonius: checks 
Mafak2020: checks 
Manon947: checks 
*** RIVER *** [8c Ts Ac 9c] [6d]
color_singleton: checks 
Duke Croix: checks 
Klemtonius: bets 100
Mafak2020: folds 
Manon947: folds 
color_singleton: folds 
Duke Croix: folds 
Uncalled bet (100) returned to Klemtonius
Klemtonius collected 1181 from pot
Klemtonius: doesn't show hand 
*** SUMMARY ***
Total pot 1250 | Rake 69 
Board [8c Ts Ac 9c 6d]
Seat 1: color_singleton (small blind) folded on the River
Seat 2: dddocky (big blind) folded before Flop
Seat 3: Duke Croix folded on the River
Seat 6: Klemtonius collected (1181)
Seat 7: Mafak2020 folded on the River
Seat 8: HighCardJasper folded before Flop (didn't bet)
Seat 9: Manon947 (button) folded on the River



PokerStars Home Game Hand #216492854166: {Club #3225207}  Hold'em No Limit (50/100) - 2020/07/16 18:02:15 ET
Table 'Fun times' 9-max (Play Money) Seat #1 is the button
Seat 1: color_singleton (5682 in chips) 
Seat 2: dddocky (10000 in chips) 
Seat 3: Duke Croix (21652 in chips) 
Seat 6: Klemtonius (23697 in chips) 
Seat 7: Mafak2020 (18789 in chips) 
Seat 8: HighCardJasper (9850 in chips) 
Seat 9: Manon947 (11126 in chips) 
dddocky: posts small blind 50
Duke Croix: posts big blind 100
*** HOLE CARDS ***
Dealt to Manon947 [3s 4s]
Klemtonius: raises 100 to 200
Mafak2020: folds 
HighCardJasper: calls 200
Manon947: calls 200
color_singleton: folds 
dddocky: folds 
Duke Croix: calls 100
*** FLOP *** [Jd 8s 2s]
Duke Croix has timed out
Duke Croix: checks 
Klemtonius: bets 401
HighCardJasper: folds 
Manon947: folds 
Duke Croix: folds 
Uncalled bet (401) returned to Klemtonius
Klemtonius collected 803 from pot
Klemtonius: doesn't show hand 
*** SUMMARY ***
Total pot 850 | Rake 47 
Board [Jd 8s 2s]
Seat 1: color_singleton (button) folded before Flop (didn't bet)
Seat 2: dddocky (small blind) folded before Flop
Seat 3: Duke Croix (big blind) folded on the Flop
Seat 6: Klemtonius collected (803)
Seat 7: Mafak2020 folded before Flop (didn't bet)
Seat 8: HighCardJasper folded on the Flop
Seat 9: Manon947 folded on the Flop



PokerStars Home Game Hand #216492882332: {Club #3225207}  Hold'em No Limit (50/100) - 2020/07/16 18:03:06 ET
Table 'Fun times' 9-max (Play Money) Seat #2 is the button
Seat 1: color_singleton (5682 in chips) 
Seat 2: dddocky (9950 in chips) 
Seat 3: Duke Croix (21452 in chips) 
Seat 6: Klemtonius (24300 in chips) 
Seat 7: Mafak2020 (18789 in chips) 
Seat 8: HighCardJasper (9650 in chips) 
Seat 9: Manon947 (10926 in chips) 
Duke Croix: posts small blind 50
Klemtonius: posts big blind 100
*** HOLE CARDS ***
Dealt to Manon947 [Qc 2s]
Mafak2020: raises 200 to 300
HighCardJasper: calls 300
Manon947: folds 
color_singleton: calls 300
dddocky: folds 
Duke Croix: folds 
Klemtonius: calls 200
*** FLOP *** [6s Kh Js]
Klemtonius: checks 
Mafak2020: bets 500
HighCardJasper: folds 
color_singleton: folds 
Klemtonius: raises 500 to 1000
Mafak2020: raises 500 to 1500
Klemtonius: calls 500
*** TURN *** [6s Kh Js] [Td]
Klemtonius: bets 2008
Mafak2020: calls 2008
*** RIVER *** [6s Kh Js Td] [Ac]
Klemtonius: checks 
Mafak2020: bets 4981
Klemtonius: folds 
Uncalled bet (4981) returned to Mafak2020
Mafak2020 collected 7811 from pot
Mafak2020: doesn't show hand 
*** SUMMARY ***
Total pot 8266 | Rake 455 
Board [6s Kh Js Td Ac]
Seat 1: color_singleton folded on the Flop
Seat 2: dddocky (button) folded before Flop (didn't bet)
Seat 3: Duke Croix (small blind) folded before Flop
Seat 6: Klemtonius (big blind) folded on the River
Seat 7: Mafak2020 collected (7811)
Seat 8: HighCardJasper folded on the Flop
Seat 9: Manon947 folded before Flop (didn't bet)



PokerStars Home Game Hand #216492946297: {Club #3225207}  Hold'em No Limit (50/100) - 2020/07/16 18:04:53 ET
Table 'Fun times' 9-max (Play Money) Seat #3 is the button
Seat 1: color_singleton (5382 in chips) 
Seat 2: dddocky (9950 in chips) 
Seat 3: Duke Croix (21402 in chips) 
Seat 6: Klemtonius (20492 in chips) 
Seat 7: Mafak2020 (22792 in chips) 
Seat 8: HighCardJasper (9350 in chips) 
Seat 9: Manon947 (10926 in chips) 
Klemtonius: posts small blind 50
Mafak2020: posts big blind 100
*** HOLE CARDS ***
Dealt to Manon947 [4d 7c]
HighCardJasper: folds 
Manon947: folds 
color_singleton: raises 100 to 200
dddocky: calls 200
Duke Croix: calls 200
Klemtonius: calls 150
Mafak2020: calls 100
*** FLOP *** [7s As 8h]
Klemtonius: bets 945
Mafak2020: folds 
color_singleton: calls 945
dddocky: folds 
Duke Croix: folds 
*** TURN *** [7s As 8h] [9c]
Klemtonius: checks 
color_singleton: bets 2731
Klemtonius: folds 
Uncalled bet (2731) returned to color_singleton
color_singleton collected 2731 from pot
color_singleton: doesn't show hand 
*** SUMMARY ***
Total pot 2890 | Rake 159 
Board [7s As 8h 9c]
Seat 1: color_singleton collected (2731)
Seat 2: dddocky folded on the Flop
Seat 3: Duke Croix (button) folded on the Flop
Seat 6: Klemtonius (small blind) folded on the Turn
Seat 7: Mafak2020 (big blind) folded on the Flop
Seat 8: HighCardJasper folded before Flop (didn't bet)
Seat 9: Manon947 folded before Flop (didn't bet)



PokerStars Home Game Hand #216492974631: {Club #3225207}  Hold'em No Limit (50/100) - 2020/07/16 18:05:45 ET
Table 'Fun times' 9-max (Play Money) Seat #6 is the button
Seat 1: color_singleton (6968 in chips) 
Seat 2: dddocky (9750 in chips) 
Seat 3: Duke Croix (21202 in chips) 
Seat 6: Klemtonius (19347 in chips) 
Seat 7: Mafak2020 (22592 in chips) 
Seat 8: HighCardJasper (9350 in chips) 
Seat 9: Manon947 (10926 in chips) 
Mafak2020: posts small blind 50
HighCardJasper: posts big blind 100
*** HOLE CARDS ***
Dealt to Manon947 [8s 5h]
Manon947: folds 
color_singleton: folds 
dddocky: calls 100
Duke Croix: folds 
Klemtonius: calls 100
Mafak2020: folds 
HighCardJasper: checks 
*** FLOP *** [Kc Ts 3h]
HighCardJasper: checks 
dddocky: checks 
Klemtonius: checks 
*** TURN *** [Kc Ts 3h] [Td]
HighCardJasper: checks 
dddocky: checks 
Klemtonius: bets 331
HighCardJasper: calls 331
dddocky: folds 
*** RIVER *** [Kc Ts 3h Td] [Ac]
HighCardJasper: bets 300
Klemtonius: calls 300
*** SHOW DOWN ***
HighCardJasper: shows [Jc Tc] (three of a kind, Tens)
Klemtonius: mucks hand 
HighCardJasper collected 1523 from pot
*** SUMMARY ***
Total pot 1612 | Rake 89 
Board [Kc Ts 3h Td Ac]
Seat 1: color_singleton folded before Flop (didn't bet)
Seat 2: dddocky folded on the Turn
Seat 3: Duke Croix folded before Flop (didn't bet)
Seat 6: Klemtonius (button) mucked [2h Kh]
Seat 7: Mafak2020 (small blind) folded before Flop
Seat 8: HighCardJasper (big blind) showed [Jc Tc] and won (1523) with three of a kind, Tens
Seat 9: Manon947 folded before Flop (didn't bet)



PokerStars Home Game Hand #216493007197: {Club #3225207}  Hold'em No Limit (50/100) - 2020/07/16 18:06:46 ET
Table 'Fun times' 9-max (Play Money) Seat #7 is the button
Seat 1: color_singleton (6968 in chips) 
Seat 2: dddocky (9650 in chips) 
Seat 3: Duke Croix (21202 in chips) 
Seat 6: Klemtonius (18616 in chips) 
Seat 7: Mafak2020 (22542 in chips) 
Seat 8: HighCardJasper (10142 in chips) 
Seat 9: Manon947 (10926 in chips) 
HighCardJasper: posts small blind 50
Manon947: posts big blind 100
*** HOLE CARDS ***
Dealt to Manon947 [Ac Th]
color_singleton: folds 
dddocky: calls 100
Duke Croix: calls 100
Klemtonius: raises 400 to 500
Mafak2020: calls 500
HighCardJasper: folds 
Manon947: calls 400
dddocky: folds 
Duke Croix has timed out
Duke Croix: folds 
*** FLOP *** [3h Kc 3s]
Manon947: checks 
Klemtonius: bets 827
Mafak2020: folds 
Manon947: calls 827
*** TURN *** [3h Kc 3s] [9d]
Manon947: checks 
Klemtonius: bets 3217
Manon947: folds 
Uncalled bet (3217) returned to Klemtonius
Klemtonius collected 3217 from pot
Klemtonius: doesn't show hand 
*** SUMMARY ***
Total pot 3404 | Rake 187 
Board [3h Kc 3s 9d]
Seat 1: color_singleton folded before Flop (didn't bet)
Seat 2: dddocky folded before Flop
Seat 3: Duke Croix folded before Flop
Seat 6: Klemtonius collected (3217)
Seat 7: Mafak2020 (button) folded on the Flop
Seat 8: HighCardJasper (small blind) folded before Flop
Seat 9: Manon947 (big blind) folded on the Turn



PokerStars Home Game Hand #216493047222: {Club #3225207}  Hold'em No Limit (50/100) - 2020/07/16 18:08:00 ET
Table 'Fun times' 9-max (Play Money) Seat #8 is the button
Seat 1: color_singleton (6968 in chips) 
Seat 2: dddocky (9550 in chips) 
Seat 3: Duke Croix (21102 in chips) 
Seat 6: Klemtonius (20506 in chips) 
Seat 7: Mafak2020 (22042 in chips) 
Seat 8: HighCardJasper (10092 in chips) 
Seat 9: Manon947 (9599 in chips) 
Manon947: posts small blind 50
color_singleton: posts big blind 100
*** HOLE CARDS ***
Dealt to Manon947 [8d Ac]
dddocky: calls 100
Duke Croix: raises 300 to 400
Klemtonius: raises 600 to 1000
Mafak2020: calls 1000
HighCardJasper: folds 
Manon947: folds 
color_singleton: folds 
dddocky: folds 
Duke Croix: calls 600
*** FLOP *** [Kc 8c Qc]
Duke Croix: checks 
Klemtonius: bets 1535
Mafak2020: raises 1535 to 3070
Duke Croix: folds 
Klemtonius: raises 16436 to 19506 and is all-in
Mafak2020: calls 16436
*** TURN *** [Kc 8c Qc] [4s]
*** RIVER *** [Kc 8c Qc 4s] [5h]
*** SHOW DOWN ***
Klemtonius: shows [Kd Ks] (three of a kind, Kings)
Mafak2020: shows [6c Jc] (a flush, King high)
Mafak2020 collected 39938 from pot
*** SUMMARY ***
Total pot 42262 | Rake 2324 
Board [Kc 8c Qc 4s 5h]
Seat 1: color_singleton (big blind) folded before Flop
Seat 2: dddocky folded before Flop
Seat 3: Duke Croix folded on the Flop
Seat 6: Klemtonius showed [Kd Ks] and lost with three of a kind, Kings
Seat 7: Mafak2020 showed [6c Jc] and won (39938) with a flush, King high
Seat 8: HighCardJasper (button) folded before Flop (didn't bet)
Seat 9: Manon947 (small blind) folded before Flop



PokerStars Home Game Hand #216493088977: {Club #3225207}  Hold'em No Limit (50/100) - 2020/07/16 18:09:19 ET
Table 'Fun times' 9-max (Play Money) Seat #9 is the button
Seat 1: color_singleton (6868 in chips) 
Seat 2: dddocky (9450 in chips) 
Seat 3: Duke Croix (20102 in chips) 
Seat 7: Mafak2020 (41474 in chips) 
Seat 8: HighCardJasper (10092 in chips) 
Seat 9: Manon947 (9549 in chips) 
color_singleton: posts small blind 50
dddocky: posts big blind 100
*** HOLE CARDS ***
Dealt to Manon947 [7s 7c]
Duke Croix: folds 
Mafak2020: calls 100
HighCardJasper: calls 100
Manon947: calls 100
color_singleton: calls 50
dddocky: checks 
*** FLOP *** [5d 3h 5c]
color_singleton: checks 
dddocky: checks 
Mafak2020: checks 
HighCardJasper: checks 
Manon947: bets 236
color_singleton: folds 
dddocky: folds 
Mafak2020: calls 236
HighCardJasper: folds 
*** TURN *** [5d 3h 5c] [Kd]
Mafak2020: checks 
Manon947: bets 459
Mafak2020: folds 
Uncalled bet (459) returned to Manon947
Manon947 collected 919 from pot
*** SUMMARY ***
Total pot 972 | Rake 53 
Board [5d 3h 5c Kd]
Seat 1: color_singleton (small blind) folded on the Flop
Seat 2: dddocky (big blind) folded on the Flop
Seat 3: Duke Croix folded before Flop (didn't bet)
Seat 7: Mafak2020 folded on the Turn
Seat 8: HighCardJasper folded on the Flop
Seat 9: Manon947 (button) collected (919)



PokerStars Home Game Hand #216493122097: {Club #3225207}  Hold'em No Limit (50/100) - 2020/07/16 18:10:21 ET
Table 'Fun times' 9-max (Play Money) Seat #1 is the button
Seat 1: color_singleton (6768 in chips) 
Seat 2: dddocky (9350 in chips) 
Seat 3: Duke Croix (20102 in chips) 
Seat 6: Klemtonius (10000 in chips) 
Seat 7: Mafak2020 (41138 in chips) 
Seat 8: HighCardJasper (9992 in chips) 
Seat 9: Manon947 (10132 in chips) 
dddocky: posts small blind 50
Duke Croix: posts big blind 100
*** HOLE CARDS ***
Dealt to Manon947 [8h 5s]
Klemtonius: calls 100
Mafak2020: calls 100
HighCardJasper: calls 100
Manon947: folds 
color_singleton: calls 100
dddocky: calls 50
Duke Croix: checks 
*** FLOP *** [6h 7s Jd]
dddocky: checks 
Duke Croix: bets 300
Klemtonius: folds 
Mafak2020: calls 300
HighCardJasper: folds 
color_singleton: folds 
dddocky: folds 
*** TURN *** [6h 7s Jd] [9h]
Duke Croix: bets 500
Mafak2020: folds 
Uncalled bet (500) returned to Duke Croix
Duke Croix collected 1134 from pot
Duke Croix: doesn't show hand 
*** SUMMARY ***
Total pot 1200 | Rake 66 
Board [6h 7s Jd 9h]
Seat 1: color_singleton (button) folded on the Flop
Seat 2: dddocky (small blind) folded on the Flop
Seat 3: Duke Croix (big blind) collected (1134)
Seat 6: Klemtonius folded on the Flop
Seat 7: Mafak2020 folded on the Turn
Seat 8: HighCardJasper folded on the Flop
Seat 9: Manon947 folded before Flop (didn't bet)



PokerStars Home Game Hand #216493150986: {Club #3225207}  Hold'em No Limit (50/100) - 2020/07/16 18:11:15 ET
Table 'Fun times' 9-max (Play Money) Seat #2 is the button
Seat 1: color_singleton (6668 in chips) 
Seat 2: dddocky (9250 in chips) 
Seat 3: Duke Croix (20836 in chips) 
Seat 6: Klemtonius (9900 in chips) 
Seat 7: Mafak2020 (40738 in chips) 
Seat 8: HighCardJasper (9892 in chips) 
Seat 9: Manon947 (10132 in chips) 
Duke Croix: posts small blind 50
Klemtonius: posts big blind 100
*** HOLE CARDS ***
Dealt to Manon947 [Kh Kc]
Mafak2020: calls 100
HighCardJasper: calls 100
Manon947: raises 100 to 200
color_singleton: raises 200 to 400
dddocky: folds 
Duke Croix: calls 350
Klemtonius: calls 300
Mafak2020: calls 300
HighCardJasper: folds 
Manon947: calls 200
*** FLOP *** [4h Kd 5s]
Duke Croix: checks 
Klemtonius: checks 
Mafak2020: bets 100
Manon947: raises 1092 to 1192
color_singleton: folds 
Duke Croix: folds 
Klemtonius: folds 
Mafak2020: calls 1092
*** TURN *** [4h Kd 5s] [4c]
Mafak2020: bets 1800
Manon947: raises 1800 to 3600
Mafak2020: raises 1800 to 5400
Manon947: raises 1800 to 7200
Mafak2020: calls 1800
*** RIVER *** [4h Kd 5s 4c] [9s]
Mafak2020: checks 
Manon947: bets 1340 and is all-in
Mafak2020: calls 1340
*** SHOW DOWN ***
Manon947: shows [Kh Kc] (a full house, Kings full of Fours)
Mafak2020: shows [5c Ks] (two pair, Kings and Fives)
Manon947 collected 20378 from pot
*** SUMMARY ***
Total pot 21564 | Rake 1186 
Board [4h Kd 5s 4c 9s]
Seat 1: color_singleton folded on the Flop
Seat 2: dddocky (button) folded before Flop (didn't bet)
Seat 3: Duke Croix (small blind) folded on the Flop
Seat 6: Klemtonius (big blind) folded on the Flop
Seat 7: Mafak2020 showed [5c Ks] and lost with two pair, Kings and Fives
Seat 8: HighCardJasper folded before Flop
Seat 9: Manon947 showed [Kh Kc] and won (20378) with a full house, Kings full of Fours



PokerStars Home Game Hand #216493209051: {Club #3225207}  Hold'em No Limit (50/100) - 2020/07/16 18:13:04 ET
Table 'Fun times' 9-max (Play Money) Seat #3 is the button
Seat 1: color_singleton (6268 in chips) 
Seat 2: dddocky (9250 in chips) 
Seat 3: Duke Croix (20436 in chips) 
Seat 6: Klemtonius (9500 in chips) 
Seat 7: Mafak2020 (30606 in chips) 
Seat 8: HighCardJasper (9792 in chips) 
Seat 9: Manon947 (20378 in chips) 
Klemtonius: posts small blind 50
Mafak2020: posts big blind 100
*** HOLE CARDS ***
Dealt to Manon947 [Ah 9h]
HighCardJasper: calls 100
Manon947: calls 100
color_singleton: calls 100
dddocky: calls 100
Duke Croix: folds 
Klemtonius: calls 50
Mafak2020: checks 
*** FLOP *** [Jh Js 5d]
Klemtonius: checks 
Mafak2020: checks 
HighCardJasper: checks 
Manon947: checks 
color_singleton: checks 
dddocky: checks 
*** TURN *** [Jh Js 5d] [Td]
Klemtonius: checks 
Mafak2020: checks 
HighCardJasper: checks 
Manon947: bets 283
color_singleton: folds 
dddocky: folds 
Klemtonius: folds 
Mafak2020: folds 
HighCardJasper: folds 
Uncalled bet (283) returned to Manon947
Manon947 collected 567 from pot
*** SUMMARY ***
Total pot 600 | Rake 33 
Board [Jh Js 5d Td]
Seat 1: color_singleton folded on the Turn
Seat 2: dddocky folded on the Turn
Seat 3: Duke Croix (button) folded before Flop (didn't bet)
Seat 6: Klemtonius (small blind) folded on the Turn
Seat 7: Mafak2020 (big blind) folded on the Turn
Seat 8: HighCardJasper folded on the Turn
Seat 9: Manon947 collected (567)



PokerStars Home Game Hand #216493249965: {Club #3225207}  Hold'em No Limit (50/100) - 2020/07/16 18:14:21 ET
Table 'Fun times' 9-max (Play Money) Seat #6 is the button
Seat 1: color_singleton (6168 in chips) 
Seat 2: dddocky (9150 in chips) 
Seat 3: Duke Croix (20436 in chips) 
Seat 6: Klemtonius (9400 in chips) 
Seat 8: HighCardJasper (9692 in chips) 
Seat 9: Manon947 (20845 in chips) 
HighCardJasper: posts small blind 50
Manon947: posts big blind 100
*** HOLE CARDS ***
Dealt to Manon947 [6s Ks]
color_singleton: raises 100 to 200
dddocky: folds 
Duke Croix: folds 
Klemtonius: calls 200
HighCardJasper: calls 150
Manon947: calls 100
*** FLOP *** [2d Ah Kh]
HighCardJasper: checks 
Manon947: bets 378
color_singleton: calls 378
Klemtonius: folds 
HighCardJasper: calls 378
*** TURN *** [2d Ah Kh] [3c]
HighCardJasper: checks 
Manon947: checks 
color_singleton: checks 
*** RIVER *** [2d Ah Kh 3c] [4h]
Mafak2020 is disconnected 
HighCardJasper: checks 
Manon947: bets 1828
color_singleton: folds 
HighCardJasper: raises 1828 to 3656
Manon947: calls 1828
*** SHOW DOWN ***
HighCardJasper: shows [5s 3h] (a straight, Ace to Five)
Manon947: mucks hand 
HighCardJasper collected 8737 from pot
*** SUMMARY ***
Total pot 9246 | Rake 509 
Board [2d Ah Kh 3c 4h]
Seat 1: color_singleton folded on the River
Seat 2: dddocky folded before Flop (didn't bet)
Seat 3: Duke Croix folded before Flop (didn't bet)
Seat 6: Klemtonius (button) folded on the Flop
Seat 8: HighCardJasper (small blind) showed [5s 3h] and won (8737) with a straight, Ace to Five
Seat 9: Manon947 (big blind) mucked [6s Ks]



PokerStars Home Game Hand #216493286035: {Club #3225207}  Hold'em No Limit (50/100) - 2020/07/16 18:15:30 ET
Table 'Fun times' 9-max (Play Money) Seat #8 is the button
Seat 1: color_singleton (5590 in chips) 
Seat 2: dddocky (9150 in chips) 
Seat 3: Duke Croix (20436 in chips) 
Seat 6: Klemtonius (9200 in chips) 
Seat 8: HighCardJasper (14195 in chips) 
Seat 9: Manon947 (16611 in chips) 
Manon947: posts small blind 50
color_singleton: posts big blind 100
*** HOLE CARDS ***
Dealt to Manon947 [4d Ac]
dddocky: folds 
Duke Croix: folds 
Klemtonius: folds 
HighCardJasper: calls 100
Manon947: calls 50
color_singleton: checks 
*** FLOP *** [4s 5d 8c]
Manon947: checks 
color_singleton: checks 
HighCardJasper: checks 
*** TURN *** [4s 5d 8c] [6d]
Manon947: bets 141
color_singleton: folds 
HighCardJasper: calls 141
*** RIVER *** [4s 5d 8c 6d] [Kd]
Manon947: checks 
HighCardJasper: checks 
*** SHOW DOWN ***
Manon947: shows [4d Ac] (a pair of Fours)
HighCardJasper: shows [5c 2s] (a pair of Fives)
HighCardJasper collected 550 from pot
*** SUMMARY ***
Total pot 582 | Rake 32 
Board [4s 5d 8c 6d Kd]
Seat 1: color_singleton (big blind) folded on the Turn
Seat 2: dddocky folded before Flop (didn't bet)
Seat 3: Duke Croix folded before Flop (didn't bet)
Seat 6: Klemtonius folded before Flop (didn't bet)
Seat 8: HighCardJasper (button) showed [5c 2s] and won (550) with a pair of Fives
Seat 9: Manon947 (small blind) showed [4d Ac] and lost with a pair of Fours



PokerStars Home Game Hand #216493308557: {Club #3225207}  Hold'em No Limit (50/100) - 2020/07/16 18:16:13 ET
Table 'Fun times' 9-max (Play Money) Seat #9 is the button
Seat 1: color_singleton (5490 in chips) 
Seat 2: dddocky (9150 in chips) 
Seat 3: Duke Croix (20436 in chips) 
Seat 6: Klemtonius (9200 in chips) 
Seat 8: HighCardJasper (14504 in chips) 
Seat 9: Manon947 (16370 in chips) 
color_singleton: posts small blind 50
dddocky: posts big blind 100
*** HOLE CARDS ***
Dealt to Manon947 [Kc 2s]
Duke Croix has timed out
Duke Croix: folds 
Klemtonius: calls 100
HighCardJasper: calls 100
Manon947: calls 100
color_singleton: calls 50
dddocky: checks 
*** FLOP *** [5h 4c 6h]
color_singleton: bets 236
dddocky: folds 
Klemtonius: raises 236 to 472
HighCardJasper: calls 472
Manon947: folds 
color_singleton: calls 236
*** TURN *** [5h 4c 6h] [8h]
color_singleton: checks 
Klemtonius: bets 905
HighCardJasper: folds 
color_singleton: folds 
Uncalled bet (905) returned to Klemtonius
Klemtonius collected 1811 from pot
Klemtonius: doesn't show hand 
*** SUMMARY ***
Total pot 1916 | Rake 105 
Board [5h 4c 6h 8h]
Seat 1: color_singleton (small blind) folded on the Turn
Seat 2: dddocky (big blind) folded on the Flop
Seat 3: Duke Croix folded before Flop (didn't bet)
Seat 6: Klemtonius collected (1811)
Seat 8: HighCardJasper folded on the Turn
Seat 9: Manon947 (button) folded on the Flop



PokerStars Home Game Hand #216493341230: {Club #3225207}  Hold'em No Limit (50/100) - 2020/07/16 18:17:15 ET
Table 'Fun times' 9-max (Play Money) Seat #1 is the button
Seat 1: color_singleton (4918 in chips) 
Seat 2: dddocky (9050 in chips) 
Seat 3: Duke Croix (20436 in chips) 
Seat 6: Klemtonius (10439 in chips) 
Seat 8: HighCardJasper (13932 in chips) 
Seat 9: Manon947 (16270 in chips) 
dddocky: posts small blind 50
Duke Croix: posts big blind 100
*** HOLE CARDS ***
Dealt to Manon947 [Qs Qc]
Klemtonius: raises 356 to 456
HighCardJasper: folds 
Manon947: calls 456
color_singleton: folds 
dddocky: folds 
Duke Croix: folds 
*** FLOP *** [8s Tc Ad]
Klemtonius: bets 1004
Manon947: folds 
Uncalled bet (1004) returned to Klemtonius
Klemtonius collected 1004 from pot
Klemtonius: doesn't show hand 
*** SUMMARY ***
Total pot 1062 | Rake 58 
Board [8s Tc Ad]
Seat 1: color_singleton (button) folded before Flop (didn't bet)
Seat 2: dddocky (small blind) folded before Flop
Seat 3: Duke Croix (big blind) folded before Flop
Seat 6: Klemtonius collected (1004)
Seat 8: HighCardJasper folded before Flop (didn't bet)
Seat 9: Manon947 folded on the Flop



PokerStars Home Game Hand #216493358568: {Club #3225207}  Hold'em No Limit (50/100) - 2020/07/16 18:17:48 ET
Table 'Fun times' 9-max (Play Money) Seat #2 is the button
Seat 1: color_singleton (4918 in chips) 
Seat 2: dddocky (9000 in chips) 
Seat 3: Duke Croix (20336 in chips) 
Seat 6: Klemtonius (10987 in chips) 
Seat 8: HighCardJasper (13932 in chips) 
Seat 9: Manon947 (15814 in chips) 
Duke Croix: posts small blind 50
Klemtonius: posts big blind 100
*** HOLE CARDS ***
Dealt to Manon947 [Ac 8h]
HighCardJasper: calls 100
Manon947: calls 100
color_singleton: folds 
dddocky: folds 
Duke Croix: calls 50
Klemtonius: checks 
*** FLOP *** [4c 6h 9s]
Duke Croix: checks 
Klemtonius: checks 
HighCardJasper: checks 
Manon947: checks 
*** TURN *** [4c 6h 9s] [4d]
Duke Croix: bets 300
Klemtonius: raises 300 to 600
HighCardJasper: calls 600
Manon947: folds 
Duke Croix: calls 300
*** RIVER *** [4c 6h 9s 4d] [2d]
Duke Croix: bets 1300
Klemtonius: folds 
HighCardJasper: calls 1300
*** SHOW DOWN ***
Duke Croix: shows [2h 4s] (a full house, Fours full of Deuces)
HighCardJasper: mucks hand 
Duke Croix collected 4536 from pot
*** SUMMARY ***
Total pot 4800 | Rake 264 
Board [4c 6h 9s 4d 2d]
Seat 1: color_singleton folded before Flop (didn't bet)
Seat 2: dddocky (button) folded before Flop (didn't bet)
Seat 3: Duke Croix (small blind) showed [2h 4s] and won (4536) with a full house, Fours full of Deuces
Seat 6: Klemtonius (big blind) folded on the River
Seat 8: HighCardJasper mucked [Jc 4h]
Seat 9: Manon947 folded on the Turn



PokerStars Home Game Hand #216493390048: {Club #3225207}  Hold'em No Limit (50/100) - 2020/07/16 18:18:45 ET
Table 'Fun times' 9-max (Play Money) Seat #3 is the button
Seat 1: color_singleton (4918 in chips) 
Seat 2: dddocky (9000 in chips) 
Seat 3: Duke Croix (22872 in chips) 
Seat 6: Klemtonius (10287 in chips) 
Seat 8: HighCardJasper (11932 in chips) 
Seat 9: Manon947 (15714 in chips) 
Klemtonius: posts small blind 50
HighCardJasper: posts big blind 100
*** HOLE CARDS ***
Dealt to Manon947 [5d 8h]
Manon947: folds 
color_singleton: raises 100 to 200
dddocky: folds 
Duke Croix: folds 
Klemtonius: folds 
HighCardJasper: calls 100
*** FLOP *** [Qh Ac 7h]
HighCardJasper: checks 
color_singleton: bets 212
HighCardJasper: calls 212
*** TURN *** [Qh Ac 7h] [8c]
HighCardJasper: checks 
color_singleton: checks 
*** RIVER *** [Qh Ac 7h 8c] [Js]
HighCardJasper: checks 
color_singleton: checks 
*** SHOW DOWN ***
HighCardJasper: shows [Ks 4s] (high card Ace)
color_singleton: shows [Kd 6h] (high card Ace)
HighCardJasper collected 413 from pot
color_singleton collected 413 from pot
*** SUMMARY ***
Total pot 874 | Rake 48 
Board [Qh Ac 7h 8c Js]
Seat 1: color_singleton showed [Kd 6h] and won (413) with high card Ace
Seat 2: dddocky folded before Flop (didn't bet)
Seat 3: Duke Croix (button) folded before Flop (didn't bet)
Seat 6: Klemtonius (small blind) folded before Flop
Seat 8: HighCardJasper (big blind) showed [Ks 4s] and won (413) with high card Ace
Seat 9: Manon947 folded before Flop (didn't bet)



PokerStars Home Game Hand #216493409490: {Club #3225207}  Hold'em No Limit (50/100) - 2020/07/16 18:19:22 ET
Table 'Fun times' 9-max (Play Money) Seat #6 is the button
Seat 1: color_singleton (4919 in chips) 
Seat 2: dddocky (9000 in chips) 
Seat 3: Duke Croix (22872 in chips) 
Seat 6: Klemtonius (10237 in chips) 
Seat 8: HighCardJasper (11933 in chips) 
Seat 9: Manon947 (15714 in chips) 
HighCardJasper: posts small blind 50
Manon947: posts big blind 100
*** HOLE CARDS ***
Dealt to Manon947 [Qs 5s]
color_singleton: raises 100 to 200
dddocky: calls 200
Duke Croix: folds 
Klemtonius: folds 
HighCardJasper: calls 150
Manon947: calls 100
*** FLOP *** [Qh Ts 4s]
HighCardJasper: checks 
Manon947: bets 378
color_singleton: calls 378
dddocky: folds 
HighCardJasper: folds 
*** TURN *** [Qh Ts 4s] [Td]
Manon947: bets 735
color_singleton: folds 
Uncalled bet (735) returned to Manon947
Manon947 collected 1470 from pot
*** SUMMARY ***
Total pot 1556 | Rake 86 
Board [Qh Ts 4s Td]
Seat 1: color_singleton folded on the Turn
Seat 2: dddocky folded on the Flop
Seat 3: Duke Croix folded before Flop (didn't bet)
Seat 6: Klemtonius (button) folded before Flop (didn't bet)
Seat 8: HighCardJasper (small blind) folded on the Flop
Seat 9: Manon947 (big blind) collected (1470)



PokerStars Home Game Hand #216493434789: {Club #3225207}  Hold'em No Limit (50/100) - 2020/07/16 18:20:11 ET
Table 'Fun times' 9-max (Play Money) Seat #8 is the button
Seat 1: color_singleton (4341 in chips) 
Seat 2: dddocky (8800 in chips) 
Seat 3: Duke Croix (22872 in chips) 
Seat 6: Klemtonius (10237 in chips) 
Seat 8: HighCardJasper (11733 in chips) 
Seat 9: Manon947 (16606 in chips) 
Manon947: posts small blind 50
color_singleton: posts big blind 100
*** HOLE CARDS ***
Dealt to Manon947 [4d 7d]
dddocky: calls 100
Duke Croix: raises 300 to 400
Klemtonius: folds 
HighCardJasper: folds 
Manon947: calls 350
color_singleton: calls 300
dddocky: calls 300
*** FLOP *** [3s 7h 6c]
Manon947: checks 
color_singleton: checks 
dddocky: checks 
Duke Croix: bets 756
Manon947: folds 
color_singleton: calls 756
dddocky: folds 
*** TURN *** [3s 7h 6c] [Qh]
color_singleton: checks 
Duke Croix: bets 1470
color_singleton: folds 
Uncalled bet (1470) returned to Duke Croix
Duke Croix collected 2941 from pot
Duke Croix: doesn't show hand 
*** SUMMARY ***
Total pot 3112 | Rake 171 
Board [3s 7h 6c Qh]
Seat 1: color_singleton (big blind) folded on the Turn
Seat 2: dddocky folded on the Flop
Seat 3: Duke Croix collected (2941)
Seat 6: Klemtonius folded before Flop (didn't bet)
Seat 8: HighCardJasper (button) folded before Flop (didn't bet)
Seat 9: Manon947 (small blind) folded on the Flop



PokerStars Home Game Hand #216493460985: {Club #3225207}  Hold'em No Limit (50/100) - 2020/07/16 18:21:02 ET
Table 'Fun times' 9-max (Play Money) Seat #9 is the button
Seat 1: color_singleton (3185 in chips) 
Seat 2: dddocky (8400 in chips) 
Seat 3: Duke Croix (24657 in chips) 
Seat 6: Klemtonius (10237 in chips) 
Seat 8: HighCardJasper (11733 in chips) 
Seat 9: Manon947 (16206 in chips) 
color_singleton: posts small blind 50
dddocky: posts big blind 100
*** HOLE CARDS ***
Dealt to Manon947 [6d 3c]
Duke Croix: folds 
Klemtonius: calls 100
HighCardJasper: calls 100
Manon947: folds 
color_singleton: folds 
dddocky: checks 
*** FLOP *** [Js 7c Ac]
dddocky: checks 
Klemtonius: bets 331
HighCardJasper: folds 
dddocky: folds 
Uncalled bet (331) returned to Klemtonius
Klemtonius collected 331 from pot
Klemtonius: doesn't show hand 
*** SUMMARY ***
Total pot 350 | Rake 19 
Board [Js 7c Ac]
Seat 1: color_singleton (small blind) folded before Flop
Seat 2: dddocky (big blind) folded on the Flop
Seat 3: Duke Croix folded before Flop (didn't bet)
Seat 6: Klemtonius collected (331)
Seat 8: HighCardJasper folded on the Flop
Seat 9: Manon947 (button) folded before Flop (didn't bet)



PokerStars Home Game Hand #216493472587: {Club #3225207}  Hold'em No Limit (50/100) - 2020/07/16 18:21:24 ET
Table 'Fun times' 9-max (Play Money) Seat #1 is the button
Seat 1: color_singleton (3135 in chips) 
Seat 2: dddocky (8300 in chips) 
Seat 3: Duke Croix (24657 in chips) 
Seat 6: Klemtonius (10468 in chips) 
Seat 8: HighCardJasper (11633 in chips) 
Seat 9: Manon947 (16206 in chips) 
dddocky: posts small blind 50
Duke Croix: posts big blind 100
*** HOLE CARDS ***
Dealt to Manon947 [2h Kh]
Klemtonius: calls 100
HighCardJasper: calls 100
Manon947: calls 100
color_singleton: folds 
dddocky: folds 
Duke Croix: checks 
*** FLOP *** [Td 4d 2c]
Duke Croix: checks 
Klemtonius: checks 
HighCardJasper: checks 
Manon947: checks 
*** TURN *** [Td 4d 2c] [9s]
Duke Croix: checks 
Klemtonius: checks 
HighCardJasper: checks 
Manon947: bets 212
Duke Croix: folds 
Klemtonius: calls 212
HighCardJasper: calls 212
*** RIVER *** [Td 4d 2c 9s] [2s]
Klemtonius: checks 
HighCardJasper: checks 
Manon947: bets 513
Klemtonius: folds 
HighCardJasper: folds 
Uncalled bet (513) returned to Manon947
Manon947 collected 1026 from pot
*** SUMMARY ***
Total pot 1086 | Rake 60 
Board [Td 4d 2c 9s 2s]
Seat 1: color_singleton (button) folded before Flop (didn't bet)
Seat 2: dddocky (small blind) folded before Flop
Seat 3: Duke Croix (big blind) folded on the Turn
Seat 6: Klemtonius folded on the River
Seat 8: HighCardJasper folded on the River
Seat 9: Manon947 collected (1026)



PokerStars Home Game Hand #216493502575: {Club #3225207}  Hold'em No Limit (50/100) - 2020/07/16 18:22:22 ET
Table 'Fun times' 9-max (Play Money) Seat #2 is the button
Seat 1: color_singleton (3135 in chips) 
Seat 2: dddocky (8250 in chips) 
Seat 3: Duke Croix (24557 in chips) 
Seat 6: Klemtonius (10156 in chips) 
Seat 8: HighCardJasper (11321 in chips) 
Seat 9: Manon947 (16920 in chips) 
Duke Croix: posts small blind 50
Klemtonius: posts big blind 100
*** HOLE CARDS ***
Dealt to Manon947 [3s 6c]
HighCardJasper: folds 
Manon947: folds 
color_singleton has timed out
color_singleton: folds 
dddocky: folds 
Duke Croix: raises 400 to 500
Klemtonius: calls 400
*** FLOP *** [3h Ks 8d]
Duke Croix: bets 600
Klemtonius: folds 
Uncalled bet (600) returned to Duke Croix
Duke Croix collected 945 from pot
Duke Croix: doesn't show hand 
*** SUMMARY ***
Total pot 1000 | Rake 55 
Board [3h Ks 8d]
Seat 1: color_singleton folded before Flop (didn't bet)
Seat 2: dddocky (button) folded before Flop (didn't bet)
Seat 3: Duke Croix (small blind) collected (945)
Seat 6: Klemtonius (big blind) folded on the Flop
Seat 8: HighCardJasper folded before Flop (didn't bet)
Seat 9: Manon947 folded before Flop (didn't bet)



PokerStars Home Game Hand #216493529842: {Club #3225207}  Hold'em No Limit (50/100) - 2020/07/16 18:23:03 ET
Table 'Fun times' 9-max (Play Money) Seat #3 is the button
Seat 2: dddocky (8250 in chips) 
Seat 3: Duke Croix (25002 in chips) 
Seat 6: Klemtonius (9656 in chips) 
Seat 8: HighCardJasper (11321 in chips) 
Seat 9: Manon947 (16920 in chips) 
Klemtonius: posts small blind 50
HighCardJasper: posts big blind 100
*** HOLE CARDS ***
Dealt to Manon947 [6d 7h]
Manon947: calls 100
dddocky: folds 
Duke Croix: calls 100
Klemtonius: calls 50
HighCardJasper: checks 
*** FLOP *** [3c 2s Jd]
Klemtonius: checks 
HighCardJasper: checks 
Manon947: checks 
Duke Croix: checks 
*** TURN *** [3c 2s Jd] [9h]
Klemtonius: bets 100
HighCardJasper: calls 100
Manon947: folds 
Duke Croix: calls 100
*** RIVER *** [3c 2s Jd 9h] [4c]
Klemtonius: bets 100
HighCardJasper: folds 
Duke Croix: calls 100
*** SHOW DOWN ***
Klemtonius: shows [Jh 5h] (a pair of Jacks)
Duke Croix: mucks hand 
Klemtonius collected 850 from pot
*** SUMMARY ***
Total pot 900 | Rake 50 
Board [3c 2s Jd 9h 4c]
Seat 2: dddocky folded before Flop (didn't bet)
Seat 3: Duke Croix (button) mucked [Qh 9d]
Seat 6: Klemtonius (small blind) showed [Jh 5h] and won (850) with a pair of Jacks
Seat 8: HighCardJasper (big blind) folded on the River
Seat 9: Manon947 folded on the Turn



PokerStars Home Game Hand #216493550200: {Club #3225207}  Hold'em No Limit (50/100) - 2020/07/16 18:23:43 ET
Table 'Fun times' 9-max (Play Money) Seat #6 is the button
Seat 1: color_singleton (3135 in chips) 
Seat 2: dddocky (8250 in chips) 
Seat 3: Duke Croix (24702 in chips) 
Seat 6: Klemtonius (10206 in chips) 
Seat 8: HighCardJasper (11121 in chips) 
Seat 9: Manon947 (16820 in chips) 
HighCardJasper: posts small blind 50
Manon947: posts big blind 100
*** HOLE CARDS ***
Dealt to Manon947 [Qh Kd]
color_singleton: folds 
dddocky: calls 100
Duke Croix: folds 
Klemtonius: calls 100
HighCardJasper: calls 50
Manon947: checks 
*** FLOP *** [4s 6h 2d]
HighCardJasper: checks 
Manon947: checks 
dddocky: checks 
Klemtonius: bets 100
HighCardJasper: calls 100
Manon947: calls 100
dddocky: calls 100
*** TURN *** [4s 6h 2d] [7d]
HighCardJasper: checks 
Manon947: checks 
dddocky: checks 
Klemtonius: bets 100
HighCardJasper: raises 100 to 200
Manon947: calls 200
dddocky: calls 200
Klemtonius: calls 100
*** RIVER *** [4s 6h 2d 7d] [3c]
HighCardJasper: checks 
Manon947: checks 
dddocky: checks 
Klemtonius: bets 100
HighCardJasper: raises 400 to 500
Manon947: folds 
dddocky: folds 
Klemtonius: calls 400
*** SHOW DOWN ***
HighCardJasper: shows [7s 5c] (a straight, Three to Seven)
Klemtonius: mucks hand 
HighCardJasper collected 2457 from pot
*** SUMMARY ***
Total pot 2600 | Rake 143 
Board [4s 6h 2d 7d 3c]
Seat 1: color_singleton folded before Flop (didn't bet)
Seat 2: dddocky folded on the River
Seat 3: Duke Croix folded before Flop (didn't bet)
Seat 6: Klemtonius (button) mucked [6s 9s]
Seat 8: HighCardJasper (small blind) showed [7s 5c] and won (2457) with a straight, Three to Seven
Seat 9: Manon947 (big blind) folded on the River



PokerStars Home Game Hand #216493586374: {Club #3225207}  Hold'em No Limit (50/100) - 2020/07/16 18:24:53 ET
Table 'Fun times' 9-max (Play Money) Seat #8 is the button
Seat 1: color_singleton (3135 in chips) 
Seat 2: dddocky (7850 in chips) 
Seat 3: Duke Croix (24702 in chips) 
Seat 6: Klemtonius (9306 in chips) 
Seat 8: HighCardJasper (12678 in chips) 
Seat 9: Manon947 (16420 in chips) 
Manon947: posts small blind 50
color_singleton: posts big blind 100
*** HOLE CARDS ***
Dealt to Manon947 [2d Qd]
dddocky: calls 100
Duke Croix: raises 300 to 400
Klemtonius: folds 
HighCardJasper: folds 
Mafak2020 was removed from the table for failing to post
Mafak2020 leaves the table
Manon947: calls 350
color_singleton: calls 300
dddocky: calls 300
*** FLOP *** [5h Jc Th]
Manon947: checks 
color_singleton: bets 1512
dddocky: folds 
Duke Croix: folds 
Manon947: folds 
Uncalled bet (1512) returned to color_singleton
color_singleton collected 1512 from pot
color_singleton: doesn't show hand 
*** SUMMARY ***
Total pot 1600 | Rake 88 
Board [5h Jc Th]
Seat 1: color_singleton (big blind) collected (1512)
Seat 2: dddocky folded on the Flop
Seat 3: Duke Croix folded on the Flop
Seat 6: Klemtonius folded before Flop (didn't bet)
Seat 8: HighCardJasper (button) folded before Flop (didn't bet)
Seat 9: Manon947 (small blind) folded on the Flop



PokerStars Home Game Hand #216493605320: {Club #3225207}  Hold'em No Limit (50/100) - 2020/07/16 18:25:30 ET
Table 'Fun times' 9-max (Play Money) Seat #9 is the button
Seat 1: color_singleton (4247 in chips) 
Seat 2: dddocky (7450 in chips) 
Seat 3: Duke Croix (24302 in chips) 
Seat 6: Klemtonius (9306 in chips) 
Seat 8: HighCardJasper (12678 in chips) 
Seat 9: Manon947 (16020 in chips) 
color_singleton: posts small blind 50
dddocky: posts big blind 100
*** HOLE CARDS ***
Dealt to Manon947 [7d 9h]
Duke Croix: folds 
Klemtonius: raises 122 to 222
HighCardJasper: calls 222
Manon947: folds 
color_singleton: calls 172
dddocky: calls 122
*** FLOP *** [Kc Jh 8h]
color_singleton: checks 
dddocky: checks 
Klemtonius: checks 
HighCardJasper: bets 200
color_singleton: calls 200
dddocky: calls 200
Klemtonius: calls 200
*** TURN *** [Kc Jh 8h] [8d]
color_singleton: checks 
dddocky: checks 
Klemtonius: bets 100
HighCardJasper: calls 100
color_singleton: folds 
dddocky: calls 100
*** RIVER *** [Kc Jh 8h 8d] [5h]
dddocky: bets 1879
Klemtonius: folds 
HighCardJasper: folds 
Uncalled bet (1879) returned to dddocky
dddocky collected 1879 from pot
dddocky: doesn't show hand 
*** SUMMARY ***
Total pot 1988 | Rake 109 
Board [Kc Jh 8h 8d 5h]
Seat 1: color_singleton (small blind) folded on the Turn
Seat 2: dddocky (big blind) collected (1879)
Seat 3: Duke Croix folded before Flop (didn't bet)
Seat 6: Klemtonius folded on the River
Seat 8: HighCardJasper folded on the River
Seat 9: Manon947 (button) folded before Flop (didn't bet)



PokerStars Home Game Hand #216493642572: {Club #3225207}  Hold'em No Limit (50/100) - 2020/07/16 18:26:43 ET
Table 'Fun times' 9-max (Play Money) Seat #1 is the button
Seat 1: color_singleton (3825 in chips) 
Seat 2: dddocky (8807 in chips) 
Seat 3: Duke Croix (24302 in chips) 
Seat 6: Klemtonius (8784 in chips) 
Seat 8: HighCardJasper (12156 in chips) 
Seat 9: Manon947 (16020 in chips) 
dddocky: posts small blind 50
Duke Croix: posts big blind 100
*** HOLE CARDS ***
Dealt to Manon947 [4s 2h]
Klemtonius: raises 282 to 382
HighCardJasper: folds 
Manon947: folds 
color_singleton: folds 
dddocky: folds 
Duke Croix: calls 282
*** FLOP *** [8s Qc 7d]
Duke Croix: checks 
Klemtonius: checks 
*** TURN *** [8s Qc 7d] [9d]
Duke Croix: bets 500
Klemtonius: calls 500
*** RIVER *** [8s Qc 7d 9d] [5d]
Duke Croix: bets 1000
Klemtonius: raises 1000 to 2000
Duke Croix: folds 
Uncalled bet (1000) returned to Klemtonius
Klemtonius collected 3604 from pot
Klemtonius: doesn't show hand 
*** SUMMARY ***
Total pot 3814 | Rake 210 
Board [8s Qc 7d 9d 5d]
Seat 1: color_singleton (button) folded before Flop (didn't bet)
Seat 2: dddocky (small blind) folded before Flop
Seat 3: Duke Croix (big blind) folded on the River
Seat 6: Klemtonius collected (3604)
Seat 8: HighCardJasper folded before Flop (didn't bet)
Seat 9: Manon947 folded before Flop (didn't bet)



PokerStars Home Game Hand #216493664506: {Club #3225207}  Hold'em No Limit (50/100) - 2020/07/16 18:27:27 ET
Table 'Fun times' 9-max (Play Money) Seat #2 is the button
Seat 1: color_singleton (3825 in chips) 
Seat 2: dddocky (8757 in chips) 
Seat 3: Duke Croix (22420 in chips) 
Seat 6: Klemtonius (10506 in chips) 
Seat 8: HighCardJasper (12156 in chips) 
Seat 9: Manon947 (16020 in chips) 
Duke Croix: posts small blind 50
Klemtonius: posts big blind 100
*** HOLE CARDS ***
Dealt to Manon947 [Td 4d]
HighCardJasper: calls 100
Manon947: calls 100
color_singleton: folds 
dddocky: calls 100
Duke Croix: calls 50
Klemtonius: raises 100 to 200
HighCardJasper: calls 100
Manon947: calls 100
dddocky: calls 100
Duke Croix: calls 100
*** FLOP *** [Kh 5d 4s]
Duke Croix: checks 
Klemtonius: checks 
HighCardJasper: checks 
Manon947: bets 472
dddocky: folds 
Duke Croix: calls 472
Klemtonius: folds 
HighCardJasper: calls 472
*** TURN *** [Kh 5d 4s] [4c]
Duke Croix: checks 
HighCardJasper: checks 
Manon947: bets 1141
Duke Croix: folds 
HighCardJasper: folds 
Uncalled bet (1141) returned to Manon947
Manon947 collected 2283 from pot
*** SUMMARY ***
Total pot 2416 | Rake 133 
Board [Kh 5d 4s 4c]
Seat 1: color_singleton folded before Flop (didn't bet)
Seat 2: dddocky (button) folded on the Flop
Seat 3: Duke Croix (small blind) folded on the Turn
Seat 6: Klemtonius (big blind) folded on the Flop
Seat 8: HighCardJasper folded on the Turn
Seat 9: Manon947 collected (2283)



PokerStars Home Game Hand #216493700065: {Club #3225207}  Hold'em No Limit (50/100) - 2020/07/16 18:28:36 ET
Table 'Fun times' 9-max (Play Money) Seat #3 is the button
Seat 1: color_singleton (3825 in chips) 
Seat 2: dddocky (8557 in chips) 
Seat 3: Duke Croix (21748 in chips) 
Seat 6: Klemtonius (10306 in chips) 
Seat 8: HighCardJasper (11484 in chips) 
Seat 9: Manon947 (17631 in chips) 
Klemtonius: posts small blind 50
HighCardJasper: posts big blind 100
*** HOLE CARDS ***
Dealt to Manon947 [Ks 3c]
Manon947: calls 100
color_singleton: folds 
dddocky: calls 100
Duke Croix: folds 
Klemtonius: calls 50
HighCardJasper: checks 
*** FLOP *** [5s 3s 8d]
Klemtonius: bets 666
HighCardJasper: folds 
Manon947: folds 
dddocky: folds 
Uncalled bet (666) returned to Klemtonius
Klemtonius collected 378 from pot
Klemtonius: doesn't show hand 
*** SUMMARY ***
Total pot 400 | Rake 22 
Board [5s 3s 8d]
Seat 1: color_singleton folded before Flop (didn't bet)
Seat 2: dddocky folded on the Flop
Seat 3: Duke Croix (button) folded before Flop (didn't bet)
Seat 6: Klemtonius (small blind) collected (378)
Seat 8: HighCardJasper (big blind) folded on the Flop
Seat 9: Manon947 folded on the Flop



PokerStars Home Game Hand #216493714736: {Club #3225207}  Hold'em No Limit (50/100) - 2020/07/16 18:29:06 ET
Table 'Fun times' 9-max (Play Money) Seat #6 is the button
Seat 1: color_singleton (3825 in chips) 
Seat 2: dddocky (8457 in chips) 
Seat 3: Duke Croix (21748 in chips) 
Seat 6: Klemtonius (10584 in chips) 
Seat 8: HighCardJasper (11384 in chips) 
Seat 9: Manon947 (17531 in chips) 
HighCardJasper: posts small blind 50
Manon947: posts big blind 100
*** HOLE CARDS ***
Dealt to Manon947 [3d 7c]
color_singleton: folds 
dddocky: folds 
Duke Croix: calls 100
Klemtonius: calls 100
HighCardJasper: calls 50
Manon947: checks 
*** FLOP *** [Ah 9d 7d]
HighCardJasper: checks 
Manon947: checks 
Duke Croix: checks 
Klemtonius: checks 
*** TURN *** [Ah 9d 7d] [5c]
HighCardJasper: checks 
Manon947: bets 189
Duke Croix: calls 189
Klemtonius: folds 
HighCardJasper: folds 
*** RIVER *** [Ah 9d 7d 5c] [Td]
Manon947: bets 367
Duke Croix: folds 
Uncalled bet (367) returned to Manon947
Manon947 collected 735 from pot
*** SUMMARY ***
Total pot 778 | Rake 43 
Board [Ah 9d 7d 5c Td]
Seat 1: color_singleton folded before Flop (didn't bet)
Seat 2: dddocky folded before Flop (didn't bet)
Seat 3: Duke Croix folded on the River
Seat 6: Klemtonius (button) folded on the Turn
Seat 8: HighCardJasper (small blind) folded on the Turn
Seat 9: Manon947 (big blind) collected (735)



PokerStars Home Game Hand #216493745045: {Club #3225207}  Hold'em No Limit (50/100) - 2020/07/16 18:30:05 ET
Table 'Fun times' 9-max (Play Money) Seat #8 is the button
Seat 1: color_singleton (3825 in chips) 
Seat 2: dddocky (8457 in chips) 
Seat 3: Duke Croix (21459 in chips) 
Seat 6: Klemtonius (10484 in chips) 
Seat 8: HighCardJasper (11284 in chips) 
Seat 9: Manon947 (17977 in chips) 
Manon947: posts small blind 50
color_singleton: posts big blind 100
*** HOLE CARDS ***
Dealt to Manon947 [4h 7h]
dddocky: calls 100
Duke Croix: folds 
Klemtonius: raises 233 to 333
HighCardJasper: folds 
Manon947: folds 
color_singleton: calls 233
dddocky: folds 
*** FLOP *** [4c Jh 9s]
color_singleton: checks 
Klemtonius: checks 
*** TURN *** [4c Jh 9s] [Ks]
color_singleton: bets 385
Klemtonius: folds 
Uncalled bet (385) returned to color_singleton
color_singleton collected 771 from pot
color_singleton: doesn't show hand 
*** SUMMARY ***
Total pot 816 | Rake 45 
Board [4c Jh 9s Ks]
Seat 1: color_singleton (big blind) collected (771)
Seat 2: dddocky folded before Flop
Seat 3: Duke Croix folded before Flop (didn't bet)
Seat 6: Klemtonius folded on the Turn
Seat 8: HighCardJasper (button) folded before Flop (didn't bet)
Seat 9: Manon947 (small blind) folded before Flop



PokerStars Home Game Hand #216493766361: {Club #3225207}  Hold'em No Limit (50/100) - 2020/07/16 18:30:47 ET
Table 'Fun times' 9-max (Play Money) Seat #9 is the button
Seat 1: color_singleton (4263 in chips) 
Seat 2: dddocky (8357 in chips) 
Seat 3: Duke Croix (21459 in chips) 
Seat 6: Klemtonius (10151 in chips) 
Seat 8: HighCardJasper (11284 in chips) 
Seat 9: Manon947 (17927 in chips) 
color_singleton: posts small blind 50
dddocky: posts big blind 100
*** HOLE CARDS ***
Dealt to Manon947 [Js 9h]
Duke Croix: raises 200 to 300
Klemtonius: folds 
HighCardJasper: calls 300
Manon947: calls 300
color_singleton: calls 250
dddocky: folds 
*** FLOP *** [Td Ts 5d]
color_singleton: checks 
Duke Croix: checks 
HighCardJasper: checks 
Manon947: checks 
*** TURN *** [Td Ts 5d] [5h]
color_singleton: checks 
Duke Croix: bets 700
HighCardJasper: folds 
Manon947: folds 
color_singleton: raises 700 to 1400
Duke Croix: calls 700
*** RIVER *** [Td Ts 5d 5h] [Th]
color_singleton: bets 2563 and is all-in
Duke Croix: folds 
Uncalled bet (2563) returned to color_singleton
color_singleton collected 3874 from pot
color_singleton: doesn't show hand 
*** SUMMARY ***
Total pot 4100 | Rake 226 
Board [Td Ts 5d 5h Th]
Seat 1: color_singleton (small blind) collected (3874)
Seat 2: dddocky (big blind) folded before Flop
Seat 3: Duke Croix folded on the River
Seat 6: Klemtonius folded before Flop (didn't bet)
Seat 8: HighCardJasper folded on the Turn
Seat 9: Manon947 (button) folded on the Turn



PokerStars Home Game Hand #216493794437: {Club #3225207}  Hold'em No Limit (50/100) - 2020/07/16 18:31:42 ET
Table 'Fun times' 9-max (Play Money) Seat #1 is the button
Seat 1: color_singleton (6437 in chips) 
Seat 2: dddocky (8257 in chips) 
Seat 3: Duke Croix (19759 in chips) 
Seat 8: HighCardJasper (10984 in chips) 
Seat 9: Manon947 (17627 in chips) 
dddocky: posts small blind 50
Duke Croix: posts big blind 100
*** HOLE CARDS ***
Dealt to Manon947 [8c 2c]
HighCardJasper: calls 100
Manon947: calls 100
color_singleton: raises 200 to 300
dddocky: calls 250
Duke Croix: calls 200
HighCardJasper: calls 200
Manon947: calls 200
*** FLOP *** [5h Ks 2h]
dddocky: bets 1417
Duke Croix: folds 
HighCardJasper: folds 
Manon947: folds 
color_singleton: folds 
Uncalled bet (1417) returned to dddocky
dddocky collected 1417 from pot
dddocky: doesn't show hand 
*** SUMMARY ***
Total pot 1500 | Rake 83 
Board [5h Ks 2h]
Seat 1: color_singleton (button) folded on the Flop
Seat 2: dddocky (small blind) collected (1417)
Seat 3: Duke Croix (big blind) folded on the Flop
Seat 8: HighCardJasper folded on the Flop
Seat 9: Manon947 folded on the Flop



PokerStars Home Game Hand #216493809483: {Club #3225207}  Hold'em No Limit (50/100) - 2020/07/16 18:32:11 ET
Table 'Fun times' 9-max (Play Money) Seat #2 is the button
Seat 1: color_singleton (6137 in chips) 
Seat 2: dddocky (9374 in chips) 
Seat 3: Duke Croix (19459 in chips) 
Seat 8: HighCardJasper (10684 in chips) 
Seat 9: Manon947 (17327 in chips) 
Duke Croix: posts small blind 50
HighCardJasper: posts big blind 100
*** HOLE CARDS ***
Dealt to Manon947 [3h 7d]
Manon947: folds 
color_singleton: folds 
dddocky: calls 100
Duke Croix: calls 50
HighCardJasper: checks 
*** FLOP *** [Js 7c 2h]
Duke Croix: checks 
HighCardJasper: checks 
dddocky: checks 
*** TURN *** [Js 7c 2h] [7h]
Duke Croix: checks 
HighCardJasper: checks 
dddocky: checks 
*** RIVER *** [Js 7c 2h 7h] [8d]
Duke Croix: checks 
HighCardJasper: bets 200
dddocky: folds 
Duke Croix: folds 
Uncalled bet (200) returned to HighCardJasper
HighCardJasper collected 283 from pot
HighCardJasper: doesn't show hand 
*** SUMMARY ***
Total pot 300 | Rake 17 
Board [Js 7c 2h 7h 8d]
Seat 1: color_singleton folded before Flop (didn't bet)
Seat 2: dddocky (button) folded on the River
Seat 3: Duke Croix (small blind) folded on the River
Seat 8: HighCardJasper (big blind) collected (283)
Seat 9: Manon947 folded before Flop (didn't bet)



PokerStars Home Game Hand #216493829664: {Club #3225207}  Hold'em No Limit (50/100) - 2020/07/16 18:32:51 ET
Table 'Fun times' 9-max (Play Money) Seat #3 is the button
Seat 1: color_singleton (6137 in chips) 
Seat 2: dddocky (9274 in chips) 
Seat 3: Duke Croix (19359 in chips) 
Seat 8: HighCardJasper (10867 in chips) 
Seat 9: Manon947 (17327 in chips) 
HighCardJasper: posts small blind 50
Manon947: posts big blind 100
*** HOLE CARDS ***
Dealt to Manon947 [8s 3h]
color_singleton: folds 
dddocky: folds 
Duke Croix: raises 300 to 400
HighCardJasper: calls 350
Manon947: folds 
*** FLOP *** [4d 9c 7h]
HighCardJasper: checks 
Duke Croix: bets 400
HighCardJasper: folds 
Uncalled bet (400) returned to Duke Croix
Duke Croix collected 850 from pot
Duke Croix: doesn't show hand 
*** SUMMARY ***
Total pot 900 | Rake 50 
Board [4d 9c 7h]
Seat 1: color_singleton folded before Flop (didn't bet)
Seat 2: dddocky folded before Flop (didn't bet)
Seat 3: Duke Croix (button) collected (850)
Seat 8: HighCardJasper (small blind) folded on the Flop
Seat 9: Manon947 (big blind) folded before Flop



PokerStars Home Game Hand #216493845041: {Club #3225207}  Hold'em No Limit (50/100) - 2020/07/16 18:33:21 ET
Table 'Fun times' 9-max (Play Money) Seat #8 is the button
Seat 1: color_singleton (6137 in chips) 
Seat 2: dddocky (9274 in chips) 
Seat 3: Duke Croix (19809 in chips) 
Seat 8: HighCardJasper (10467 in chips) 
Seat 9: Manon947 (17227 in chips) 
Manon947: posts small blind 50
color_singleton: posts big blind 100
*** HOLE CARDS ***
Dealt to Manon947 [Qc 6d]
dddocky: calls 100
Duke Croix: calls 100
HighCardJasper: calls 100
Manon947: calls 50
color_singleton: checks 
*** FLOP *** [Ah 8d 5s]
Manon947: checks 
color_singleton: checks 
dddocky: checks 
Duke Croix: checks 
HighCardJasper: checks 
*** TURN *** [Ah 8d 5s] [6s]
Manon947: checks 
color_singleton: checks 
dddocky: checks 
Duke Croix: checks 
HighCardJasper: bets 200
Manon947: calls 200
color_singleton: folds 
dddocky: folds 
Duke Croix: folds 
*** RIVER *** [Ah 8d 5s 6s] [7d]
Manon947: checks 
HighCardJasper: bets 300
Manon947: calls 300
*** SHOW DOWN ***
HighCardJasper: shows [2c 4s] (a straight, Four to Eight)
Manon947: mucks hand 
HighCardJasper collected 1417 from pot
*** SUMMARY ***
Total pot 1500 | Rake 83 
Board [Ah 8d 5s 6s 7d]
Seat 1: color_singleton (big blind) folded on the Turn
Seat 2: dddocky folded on the Turn
Seat 3: Duke Croix folded on the Turn
Seat 8: HighCardJasper (button) showed [2c 4s] and won (1417) with a straight, Four to Eight
Seat 9: Manon947 (small blind) mucked [Qc 6d]



PokerStars Home Game Hand #216493869467: {Club #3225207}  Hold'em No Limit (50/100) - 2020/07/16 18:34:09 ET
Table 'Fun times' 9-max (Play Money) Seat #9 is the button
Seat 1: color_singleton (6037 in chips) 
Seat 2: dddocky (9174 in chips) 
Seat 3: Duke Croix (19709 in chips) 
Seat 8: HighCardJasper (11284 in chips) 
Seat 9: Manon947 (16627 in chips) 
color_singleton: posts small blind 50
dddocky: posts big blind 100
*** HOLE CARDS ***
Dealt to Manon947 [Js 8s]
Duke Croix: folds 
HighCardJasper: calls 100
Manon947: calls 100
color_singleton: folds 
dddocky: checks 
*** FLOP *** [5d 6h 9h]
dddocky: checks 
HighCardJasper: checks 
Manon947: checks 
*** TURN *** [5d 6h 9h] [Td]
dddocky: checks 
HighCardJasper: checks 
Manon947: checks 
*** RIVER *** [5d 6h 9h Td] [2h]
dddocky: bets 331
HighCardJasper: folds 
Manon947: folds 
Uncalled bet (331) returned to dddocky
dddocky collected 331 from pot
dddocky: doesn't show hand 
*** SUMMARY ***
Total pot 350 | Rake 19 
Board [5d 6h 9h Td 2h]
Seat 1: color_singleton (small blind) folded before Flop
Seat 2: dddocky (big blind) collected (331)
Seat 3: Duke Croix folded before Flop (didn't bet)
Seat 8: HighCardJasper folded on the River
Seat 9: Manon947 (button) folded on the River



PokerStars Home Game Hand #216493884466: {Club #3225207}  Hold'em No Limit (50/100) - 2020/07/16 18:34:39 ET
Table 'Fun times' 9-max (Play Money) Seat #1 is the button
Seat 1: color_singleton (5987 in chips) 
Seat 2: dddocky (9405 in chips) 
Seat 3: Duke Croix (19709 in chips) 
Seat 8: HighCardJasper (11184 in chips) 
Seat 9: Manon947 (16527 in chips) 
dddocky: posts small blind 50
Duke Croix: posts big blind 100
*** HOLE CARDS ***
Dealt to Manon947 [9d 7s]
HighCardJasper: calls 100
Manon947: folds 
color_singleton: raises 200 to 300
dddocky: calls 250
Duke Croix: calls 200
HighCardJasper: calls 200
*** FLOP *** [Kc Ts 4d]
dddocky: checks 
Duke Croix: checks 
HighCardJasper: checks 
color_singleton: checks 
*** TURN *** [Kc Ts 4d] [5d]
dddocky: checks 
Duke Croix: bets 700
HighCardJasper: folds 
color_singleton: calls 700
dddocky: folds 
*** RIVER *** [Kc Ts 4d 5d] [Js]
Duke Croix: checks 
color_singleton: bets 1228
Duke Croix: folds 
Uncalled bet (1228) returned to color_singleton
color_singleton collected 2457 from pot
color_singleton: doesn't show hand 
*** SUMMARY ***
Total pot 2600 | Rake 143 
Board [Kc Ts 4d 5d Js]
Seat 1: color_singleton (button) collected (2457)
Seat 2: dddocky (small blind) folded on the Turn
Seat 3: Duke Croix (big blind) folded on the River
Seat 8: HighCardJasper folded on the Turn
Seat 9: Manon947 folded before Flop (didn't bet)



PokerStars Home Game Hand #216493923256: {Club #3225207}  Hold'em No Limit (50/100) - 2020/07/16 18:35:40 ET
Table 'Fun times' 9-max (Play Money) Seat #2 is the button
Seat 1: color_singleton (7444 in chips) 
Seat 2: dddocky (9105 in chips) 
Seat 3: Duke Croix (18709 in chips) 
Seat 6: Klemtonius (10151 in chips) 
Seat 8: HighCardJasper (10884 in chips) 
Seat 9: Manon947 (16527 in chips) 
Duke Croix: posts small blind 50
Klemtonius: posts big blind 100
*** HOLE CARDS ***
Dealt to Manon947 [3s 6h]
HighCardJasper: calls 100
Manon947: folds 
color_singleton: raises 200 to 300
dddocky: calls 300
Duke Croix: folds 
Klemtonius: calls 200
HighCardJasper: calls 200
*** FLOP *** [5h 6c 9h]
Klemtonius: checks 
HighCardJasper: checks 
color_singleton: checks 
dddocky: checks 
*** TURN *** [5h 6c 9h] [8c]
Klemtonius: checks 
HighCardJasper: bets 200
color_singleton: calls 200
dddocky: folds 
Klemtonius: folds 
*** RIVER *** [5h 6c 9h 8c] [4c]
HighCardJasper: bets 300
color_singleton: folds 
Uncalled bet (300) returned to HighCardJasper
HighCardJasper collected 1559 from pot
HighCardJasper: doesn't show hand 
*** SUMMARY ***
Total pot 1650 | Rake 91 
Board [5h 6c 9h 8c 4c]
Seat 1: color_singleton folded on the River
Seat 2: dddocky (button) folded on the Turn
Seat 3: Duke Croix (small blind) folded before Flop
Seat 6: Klemtonius (big blind) folded on the Turn
Seat 8: HighCardJasper collected (1559)
Seat 9: Manon947 folded before Flop (didn't bet)



PokerStars Home Game Hand #216493948359: {Club #3225207}  Hold'em No Limit (50/100) - 2020/07/16 18:36:30 ET
Table 'Fun times' 9-max (Play Money) Seat #3 is the button
Seat 1: color_singleton (6944 in chips) 
Seat 2: dddocky (8805 in chips) 
Seat 3: Duke Croix (18659 in chips) 
Seat 6: Klemtonius (9851 in chips) 
Seat 8: HighCardJasper (11943 in chips) 
Seat 9: Manon947 (16527 in chips) 
Klemtonius: posts small blind 50
HighCardJasper: posts big blind 100
*** HOLE CARDS ***
Dealt to Manon947 [Jh Js]
Manon947: calls 100
color_singleton: raises 200 to 300
dddocky: calls 300
Duke Croix: folds 
Klemtonius: calls 250
HighCardJasper: calls 200
Manon947: calls 200
*** FLOP *** [9d Qh 4h]
Klemtonius: checks 
HighCardJasper: checks 
Manon947: bets 708
color_singleton: calls 708
dddocky: folds 
Klemtonius: folds 
HighCardJasper: folds 
*** TURN *** [9d Qh 4h] [Qs]
Manon947: bets 1378
color_singleton: calls 1378
*** RIVER *** [9d Qh 4h Qs] [3s]
Manon947: bets 2680
color_singleton: calls 2680
*** SHOW DOWN ***
Manon947: shows [Jh Js] (two pair, Queens and Jacks)
color_singleton: shows [Qc Ks] (three of a kind, Queens)
color_singleton collected 10425 from pot
*** SUMMARY ***
Total pot 11032 | Rake 607 
Board [9d Qh 4h Qs 3s]
Seat 1: color_singleton showed [Qc Ks] and won (10425) with three of a kind, Queens
Seat 2: dddocky folded on the Flop
Seat 3: Duke Croix (button) folded before Flop (didn't bet)
Seat 6: Klemtonius (small blind) folded on the Flop
Seat 8: HighCardJasper (big blind) folded on the Flop
Seat 9: Manon947 showed [Jh Js] and lost with two pair, Queens and Jacks



PokerStars Home Game Hand #216493975829: {Club #3225207}  Hold'em No Limit (50/100) - 2020/07/16 18:37:25 ET
Table 'Fun times' 9-max (Play Money) Seat #6 is the button
Seat 1: color_singleton (12303 in chips) 
Seat 2: dddocky (8505 in chips) 
Seat 3: Duke Croix (18659 in chips) 
Seat 6: Klemtonius (9551 in chips) 
Seat 8: HighCardJasper (11643 in chips) 
Seat 9: Manon947 (11461 in chips) 
HighCardJasper: posts small blind 50
Manon947: posts big blind 100
*** HOLE CARDS ***
Dealt to Manon947 [Ah Jc]
color_singleton: folds 
dddocky: calls 100
Duke Croix: folds 
Klemtonius: raises 100 to 200
HighCardJasper: calls 150
Manon947: calls 100
dddocky: calls 100
*** FLOP *** [2d 6s 3h]
HighCardJasper: checks 
Manon947: checks 
dddocky: checks 
Klemtonius: bets 756
HighCardJasper: folds 
Manon947: folds 
dddocky: folds 
Uncalled bet (756) returned to Klemtonius
Klemtonius collected 756 from pot
Klemtonius: doesn't show hand 
*** SUMMARY ***
Total pot 800 | Rake 44 
Board [2d 6s 3h]
Seat 1: color_singleton folded before Flop (didn't bet)
Seat 2: dddocky folded on the Flop
Seat 3: Duke Croix folded before Flop (didn't bet)
Seat 6: Klemtonius (button) collected (756)
Seat 8: HighCardJasper (small blind) folded on the Flop
Seat 9: Manon947 (big blind) folded on the Flop



PokerStars Home Game Hand #216493998649: {Club #3225207}  Hold'em No Limit (50/100) - 2020/07/16 18:38:11 ET
Table 'Fun times' 9-max (Play Money) Seat #8 is the button
Seat 1: color_singleton (12303 in chips) 
Seat 2: dddocky (8305 in chips) 
Seat 3: Duke Croix (18659 in chips) 
Seat 6: Klemtonius (10107 in chips) 
Seat 8: HighCardJasper (11443 in chips) 
Seat 9: Manon947 (11261 in chips) 
Manon947: posts small blind 50
color_singleton: posts big blind 100
*** HOLE CARDS ***
Dealt to Manon947 [6s Kh]
dddocky: folds 
Duke Croix: raises 400 to 500
Klemtonius: folds 
HighCardJasper: folds 
Manon947: folds 
color_singleton: calls 400
*** FLOP *** [4h As Qc]
color_singleton: checks 
Duke Croix: checks 
*** TURN *** [4h As Qc] [9d]
color_singleton: bets 496
Duke Croix: folds 
Uncalled bet (496) returned to color_singleton
color_singleton collected 992 from pot
color_singleton: doesn't show hand 
*** SUMMARY ***
Total pot 1050 | Rake 58 
Board [4h As Qc 9d]
Seat 1: color_singleton (big blind) collected (992)
Seat 2: dddocky folded before Flop (didn't bet)
Seat 3: Duke Croix folded on the Turn
Seat 6: Klemtonius folded before Flop (didn't bet)
Seat 8: HighCardJasper (button) folded before Flop (didn't bet)
Seat 9: Manon947 (small blind) folded before Flop



PokerStars Home Game Hand #216494021705: {Club #3225207}  Hold'em No Limit (50/100) - 2020/07/16 18:38:57 ET
Table 'Fun times' 9-max (Play Money) Seat #9 is the button
Seat 1: color_singleton (12795 in chips) 
Seat 2: dddocky (8305 in chips) 
Seat 3: Duke Croix (18159 in chips) 
Seat 6: Klemtonius (10107 in chips) 
Seat 8: HighCardJasper (11443 in chips) 
Seat 9: Manon947 (11211 in chips) 
color_singleton: posts small blind 50
dddocky: posts big blind 100
*** HOLE CARDS ***
Dealt to Manon947 [Qc 4s]
Duke Croix: folds 
Klemtonius: folds 
HighCardJasper: calls 100
Manon947: calls 100
color_singleton: calls 50
dddocky: checks 
*** FLOP *** [4d 5s Kh]
color_singleton: bets 189
dddocky: folds 
HighCardJasper: calls 189
Manon947: calls 189
*** TURN *** [4d 5s Kh] [5h]
color_singleton: bets 457
HighCardJasper: folds 
Manon947: folds 
Uncalled bet (457) returned to color_singleton
color_singleton collected 914 from pot
color_singleton: doesn't show hand 
*** SUMMARY ***
Total pot 967 | Rake 53 
Board [4d 5s Kh 5h]
Seat 1: color_singleton (small blind) collected (914)
Seat 2: dddocky (big blind) folded on the Flop
Seat 3: Duke Croix folded before Flop (didn't bet)
Seat 6: Klemtonius folded before Flop (didn't bet)
Seat 8: HighCardJasper folded on the Turn
Seat 9: Manon947 (button) folded on the Turn



PokerStars Home Game Hand #216494044752: {Club #3225207}  Hold'em No Limit (50/100) - 2020/07/16 18:39:31 ET
Table 'Fun times' 9-max (Play Money) Seat #1 is the button
Seat 1: color_singleton (13420 in chips) 
Seat 2: dddocky (8205 in chips) 
Seat 3: Duke Croix (18159 in chips) 
Seat 6: Klemtonius (10107 in chips) 
Seat 8: HighCardJasper (11154 in chips) 
Seat 9: Manon947 (10922 in chips) 
dddocky: posts small blind 50
Duke Croix: posts big blind 100
*** HOLE CARDS ***
Dealt to Manon947 [Jc 7d]
Klemtonius: calls 100
HighCardJasper: calls 100
Manon947: calls 100
color_singleton: folds 
dddocky: folds 
Duke Croix: raises 300 to 400
Klemtonius: calls 300
HighCardJasper: folds 
Manon947: folds 
*** FLOP *** [4d Jh 2d]
Duke Croix: bets 400
Klemtonius: raises 400 to 800
Duke Croix: calls 400
*** TURN *** [4d Jh 2d] [Qc]
Duke Croix: checks 
Klemtonius: bets 2504
Duke Croix: calls 2504
*** RIVER *** [4d Jh 2d Qc] [Ts]
Duke Croix: bets 3000
Klemtonius: folds 
Uncalled bet (3000) returned to Duke Croix
Duke Croix collected 7237 from pot
Duke Croix: doesn't show hand 
*** SUMMARY ***
Total pot 7658 | Rake 421 
Board [4d Jh 2d Qc Ts]
Seat 1: color_singleton (button) folded before Flop (didn't bet)
Seat 2: dddocky (small blind) folded before Flop
Seat 3: Duke Croix (big blind) collected (7237)
Seat 6: Klemtonius folded on the River
Seat 8: HighCardJasper folded before Flop
Seat 9: Manon947 folded before Flop



PokerStars Home Game Hand #216494077689: {Club #3225207}  Hold'em No Limit (50/100) - 2020/07/16 18:40:37 ET
Table 'Fun times' 9-max (Play Money) Seat #2 is the button
Seat 1: color_singleton (13420 in chips) 
Seat 2: dddocky (8155 in chips) 
Seat 3: Duke Croix (21692 in chips) 
Seat 6: Klemtonius (6403 in chips) 
Seat 8: HighCardJasper (11054 in chips) 
Seat 9: Manon947 (10822 in chips) 
Duke Croix: posts small blind 50
Klemtonius: posts big blind 100
*** HOLE CARDS ***
Dealt to Manon947 [Tc 6c]
HighCardJasper: calls 100
Manon947: calls 100
color_singleton: raises 200 to 300
dddocky: calls 300
Duke Croix: folds 
Klemtonius: calls 200
HighCardJasper: calls 200
Manon947: calls 200
*** FLOP *** [2s 2h Kc]
Klemtonius: checks 
HighCardJasper: checks 
Manon947: checks 
color_singleton: checks 
dddocky: bets 100
Klemtonius: folds 
HighCardJasper: calls 100
Manon947: calls 100
color_singleton: raises 200 to 300
dddocky: calls 200
HighCardJasper: calls 200
Manon947: folds 
*** TURN *** [2s 2h Kc] [3c]
HighCardJasper: checks 
color_singleton: checks 
dddocky: checks 
*** RIVER *** [2s 2h Kc 3c] [4h]
HighCardJasper: checks 
color_singleton: bets 1205
dddocky: calls 1205
HighCardJasper: folds 
*** SHOW DOWN ***
color_singleton: shows [Ac As] (two pair, Aces and Deuces)
dddocky: mucks hand 
color_singleton collected 4687 from pot
*** SUMMARY ***
Total pot 4960 | Rake 273 
Board [2s 2h Kc 3c 4h]
Seat 1: color_singleton showed [Ac As] and won (4687) with two pair, Aces and Deuces
Seat 2: dddocky (button) mucked [Js Kd]
Seat 3: Duke Croix (small blind) folded before Flop
Seat 6: Klemtonius (big blind) folded on the Flop
Seat 8: HighCardJasper folded on the River
Seat 9: Manon947 folded on the Flop



PokerStars Home Game Hand #216494105773: {Club #3225207}  Hold'em No Limit (50/100) - 2020/07/16 18:41:34 ET
Table 'Fun times' 9-max (Play Money) Seat #3 is the button
Seat 1: color_singleton (16302 in chips) 
Seat 2: dddocky (6350 in chips) 
Seat 3: Duke Croix (21642 in chips) 
Seat 6: Klemtonius (6103 in chips) 
Seat 8: HighCardJasper (10454 in chips) 
Seat 9: Manon947 (10422 in chips) 
Klemtonius: posts small blind 50
HighCardJasper: posts big blind 100
*** HOLE CARDS ***
Dealt to Manon947 [7d Kd]
Manon947: calls 100
color_singleton: raises 200 to 300
dddocky: folds 
Duke Croix: folds 
Klemtonius: raises 200 to 500
HighCardJasper: calls 400
Manon947: calls 400
color_singleton: calls 200
*** FLOP *** [9d 3d 2h]
Klemtonius: bets 1890
HighCardJasper: folds 
Manon947: folds 
color_singleton: folds 
Uncalled bet (1890) returned to Klemtonius
Klemtonius collected 1890 from pot
Klemtonius: doesn't show hand 
*** SUMMARY ***
Total pot 2000 | Rake 110 
Board [9d 3d 2h]
Seat 1: color_singleton folded on the Flop
Seat 2: dddocky folded before Flop (didn't bet)
Seat 3: Duke Croix (button) folded before Flop (didn't bet)
Seat 6: Klemtonius (small blind) collected (1890)
Seat 8: HighCardJasper (big blind) folded on the Flop
Seat 9: Manon947 folded on the Flop



PokerStars Home Game Hand #216494127971: {Club #3225207}  Hold'em No Limit (50/100) - 2020/07/16 18:42:20 ET
Table 'Fun times' 9-max (Play Money) Seat #6 is the button
Seat 1: color_singleton (15802 in chips) 
Seat 2: dddocky (6350 in chips) 
Seat 3: Duke Croix (21642 in chips) 
Seat 6: Klemtonius (7493 in chips) 
Seat 8: HighCardJasper (9954 in chips) 
Seat 9: Manon947 (9922 in chips) 
HighCardJasper: posts small blind 50
Manon947: posts big blind 100
*** HOLE CARDS ***
Dealt to Manon947 [7s 2d]
color_singleton: raises 200 to 300
dddocky: calls 300
Duke Croix: folds 
Klemtonius: calls 300
HighCardJasper: calls 250
Manon947: folds 
*** FLOP *** [Qc Js Ks]
HighCardJasper: checks 
color_singleton: checks 
dddocky: checks 
Klemtonius: bets 1228
HighCardJasper: folds 
color_singleton: folds 
dddocky: folds 
Uncalled bet (1228) returned to Klemtonius
Klemtonius collected 1228 from pot
Klemtonius: doesn't show hand 
*** SUMMARY ***
Total pot 1300 | Rake 72 
Board [Qc Js Ks]
Seat 1: color_singleton folded on the Flop
Seat 2: dddocky folded on the Flop
Seat 3: Duke Croix folded before Flop (didn't bet)
Seat 6: Klemtonius (button) collected (1228)
Seat 8: HighCardJasper (small blind) folded on the Flop
Seat 9: Manon947 (big blind) folded before Flop



PokerStars Home Game Hand #216494149644: {Club #3225207}  Hold'em No Limit (50/100) - 2020/07/16 18:43:04 ET
Table 'Fun times' 9-max (Play Money) Seat #8 is the button
Seat 1: color_singleton (15502 in chips) 
Seat 2: dddocky (6050 in chips) 
Seat 3: Duke Croix (21642 in chips) 
Seat 6: Klemtonius (8421 in chips) 
Seat 8: HighCardJasper (9654 in chips) 
Seat 9: Manon947 (9822 in chips) 
Manon947: posts small blind 50
color_singleton: posts big blind 100
*** HOLE CARDS ***
Dealt to Manon947 [Ad Qs]
dddocky: folds 
Duke Croix: folds 
Klemtonius: raises 100 to 200
HighCardJasper: folds 
Manon947: calls 150
color_singleton: calls 100
*** FLOP *** [4h Jd 6c]
Manon947: checks 
color_singleton: bets 283
Klemtonius: folds 
Manon947: calls 283
*** TURN *** [4h Jd 6c] [6s]
Manon947: checks 
color_singleton: checks 
*** RIVER *** [4h Jd 6c 6s] [Kd]
Manon947: checks 
color_singleton: checks 
*** SHOW DOWN ***
Manon947: shows [Ad Qs] (a pair of Sixes)
color_singleton: shows [4c 2c] (two pair, Sixes and Fours)
color_singleton collected 1102 from pot
*** SUMMARY ***
Total pot 1166 | Rake 64 
Board [4h Jd 6c 6s Kd]
Seat 1: color_singleton (big blind) showed [4c 2c] and won (1102) with two pair, Sixes and Fours
Seat 2: dddocky folded before Flop (didn't bet)
Seat 3: Duke Croix folded before Flop (didn't bet)
Seat 6: Klemtonius folded on the Flop
Seat 8: HighCardJasper (button) folded before Flop (didn't bet)
Seat 9: Manon947 (small blind) showed [Ad Qs] and lost with a pair of Sixes



PokerStars Home Game Hand #216494169690: {Club #3225207}  Hold'em No Limit (50/100) - 2020/07/16 18:43:45 ET
Table 'Fun times' 9-max (Play Money) Seat #9 is the button
Seat 1: color_singleton (16121 in chips) 
Seat 2: dddocky (6050 in chips) 
Seat 3: Duke Croix (21642 in chips) 
Seat 6: Klemtonius (8221 in chips) 
Seat 8: HighCardJasper (9654 in chips) 
Seat 9: Manon947 (9339 in chips) 
color_singleton: posts small blind 50
dddocky: posts big blind 100
*** HOLE CARDS ***
Dealt to Manon947 [2s 2h]
Duke Croix: raises 300 to 400
Klemtonius: folds 
HighCardJasper: calls 400
Manon947: calls 400
color_singleton: calls 350
dddocky: folds 
*** FLOP *** [8c 6d 6s]
color_singleton: checks 
Duke Croix: checks 
HighCardJasper: checks 
Manon947: checks 
*** TURN *** [8c 6d 6s] [4d]
color_singleton: checks 
Duke Croix: checks 
HighCardJasper: checks 
Manon947: bets 803
color_singleton: folds 
Duke Croix: folds 
HighCardJasper: folds 
Uncalled bet (803) returned to Manon947
Manon947 collected 1606 from pot
*** SUMMARY ***
Total pot 1700 | Rake 94 
Board [8c 6d 6s 4d]
Seat 1: color_singleton (small blind) folded on the Turn
Seat 2: dddocky (big blind) folded before Flop
Seat 3: Duke Croix folded on the Turn
Seat 6: Klemtonius folded before Flop (didn't bet)
Seat 8: HighCardJasper folded on the Turn
Seat 9: Manon947 (button) collected (1606)



PokerStars Home Game Hand #216494193151: {Club #3225207}  Hold'em No Limit (50/100) - 2020/07/16 18:44:34 ET
Table 'Fun times' 9-max (Play Money) Seat #1 is the button
Seat 1: color_singleton (15721 in chips) 
Seat 2: dddocky (5950 in chips) 
Seat 3: Duke Croix (21242 in chips) 
Seat 6: Klemtonius (8221 in chips) 
Seat 8: HighCardJasper (9254 in chips) 
Seat 9: Manon947 (10545 in chips) 
dddocky: posts small blind 50
Duke Croix: posts big blind 100
*** HOLE CARDS ***
Dealt to Manon947 [8s 3d]
Klemtonius: calls 100
HighCardJasper: calls 100
Manon947: folds 
color_singleton: calls 100
dddocky: folds 
Duke Croix: checks 
*** FLOP *** [6d Th Qh]
Duke Croix: checks 
Klemtonius: checks 
HighCardJasper: checks 
color_singleton: bets 212
Duke Croix: folds 
Klemtonius: folds 
HighCardJasper: folds 
Uncalled bet (212) returned to color_singleton
color_singleton collected 425 from pot
color_singleton: doesn't show hand 
*** SUMMARY ***
Total pot 450 | Rake 25 
Board [6d Th Qh]
Seat 1: color_singleton (button) collected (425)
Seat 2: dddocky (small blind) folded before Flop
Seat 3: Duke Croix (big blind) folded on the Flop
Seat 6: Klemtonius folded on the Flop
Seat 8: HighCardJasper folded on the Flop
Seat 9: Manon947 folded before Flop (didn't bet)



PokerStars Home Game Hand #216494213176: {Club #3225207}  Hold'em No Limit (50/100) - 2020/07/16 18:45:15 ET
Table 'Fun times' 9-max (Play Money) Seat #2 is the button
Seat 1: color_singleton (16046 in chips) 
Seat 2: dddocky (5900 in chips) 
Seat 3: Duke Croix (21142 in chips) 
Seat 6: Klemtonius (8121 in chips) 
Seat 8: HighCardJasper (9154 in chips) 
Seat 9: Manon947 (10545 in chips) 
Duke Croix: posts small blind 50
Klemtonius: posts big blind 100
*** HOLE CARDS ***
Dealt to Manon947 [3c 6s]
HighCardJasper: calls 100
Manon947: folds 
color_singleton: raises 100 to 200
dddocky: folds 
Duke Croix: folds 
Klemtonius: raises 232 to 432
HighCardJasper: folds 
color_singleton: calls 232
*** FLOP *** [9d 6d Js]
Klemtonius: bets 234
color_singleton: folds 
Uncalled bet (234) returned to Klemtonius
Klemtonius collected 958 from pot
Klemtonius: doesn't show hand 
*** SUMMARY ***
Total pot 1014 | Rake 56 
Board [9d 6d Js]
Seat 1: color_singleton folded on the Flop
Seat 2: dddocky (button) folded before Flop (didn't bet)
Seat 3: Duke Croix (small blind) folded before Flop
Seat 6: Klemtonius (big blind) collected (958)
Seat 8: HighCardJasper folded before Flop
Seat 9: Manon947 folded before Flop (didn't bet)



PokerStars Home Game Hand #216494233486: {Club #3225207}  Hold'em No Limit (50/100) - 2020/07/16 18:45:57 ET
Table 'Fun times' 9-max (Play Money) Seat #3 is the button
Seat 1: color_singleton (15614 in chips) 
Seat 2: dddocky (5900 in chips) 
Seat 3: Duke Croix (21092 in chips) 
Seat 6: Klemtonius (8647 in chips) 
Seat 8: HighCardJasper (9054 in chips) 
Seat 9: Manon947 (10545 in chips) 
Klemtonius: posts small blind 50
HighCardJasper: posts big blind 100
*** HOLE CARDS ***
Dealt to Manon947 [Kc 8d]
Manon947: calls 100
color_singleton: calls 100
dddocky: folds 
Duke Croix: folds 
Klemtonius: calls 50
HighCardJasper: checks 
*** FLOP *** [8h 7h 9s]
Klemtonius: bets 378
HighCardJasper: folds 
Manon947: calls 378
color_singleton: folds 
*** TURN *** [8h 7h 9s] [Ac]
Klemtonius: checks 
Manon947: bets 546
Klemtonius: calls 546
*** RIVER *** [8h 7h 9s Ac] [Th]
Klemtonius: checks 
Manon947: bets 1062
Klemtonius: raises 1062 to 2124
Manon947: folds 
Uncalled bet (1062) returned to Klemtonius
Klemtonius collected 4132 from pot
Klemtonius: doesn't show hand 
*** SUMMARY ***
Total pot 4372 | Rake 240 
Board [8h 7h 9s Ac Th]
Seat 1: color_singleton folded on the Flop
Seat 2: dddocky folded before Flop (didn't bet)
Seat 3: Duke Croix (button) folded before Flop (didn't bet)
Seat 6: Klemtonius (small blind) collected (4132)
Seat 8: HighCardJasper (big blind) folded on the Flop
Seat 9: Manon947 folded on the River



PokerStars Home Game Hand #216494260704: {Club #3225207}  Hold'em No Limit (50/100) - 2020/07/16 18:46:53 ET
Table 'Fun times' 9-max (Play Money) Seat #6 is the button
Seat 1: color_singleton (15514 in chips) 
Seat 2: dddocky (5900 in chips) 
Seat 3: Duke Croix (21092 in chips) 
Seat 6: Klemtonius (10693 in chips) 
Seat 8: HighCardJasper (8954 in chips) 
Seat 9: Manon947 (8459 in chips) 
HighCardJasper: posts small blind 50
Manon947: posts big blind 100
*** HOLE CARDS ***
Dealt to Manon947 [3d 5h]
color_singleton: raises 100 to 200
dddocky: folds 
Duke Croix: raises 300 to 500
Klemtonius: calls 500
HighCardJasper: folds 
Manon947: folds 
color_singleton: calls 300
*** FLOP *** [Kc Ah Ts]
color_singleton: checks 
Duke Croix: checks 
Klemtonius: bets 1559
color_singleton: calls 1559
Duke Croix: folds 
*** TURN *** [Kc Ah Ts] [5d]
color_singleton: bets 2253
Klemtonius: folds 
Uncalled bet (2253) returned to color_singleton
color_singleton collected 4506 from pot
color_singleton: doesn't show hand 
*** SUMMARY ***
Total pot 4768 | Rake 262 
Board [Kc Ah Ts 5d]
Seat 1: color_singleton collected (4506)
Seat 2: dddocky folded before Flop (didn't bet)
Seat 3: Duke Croix folded on the Flop
Seat 6: Klemtonius (button) folded on the Turn
Seat 8: HighCardJasper (small blind) folded before Flop
Seat 9: Manon947 (big blind) folded before Flop



PokerStars Home Game Hand #216494284442: {Club #3225207}  Hold'em No Limit (50/100) - 2020/07/16 18:47:41 ET
Table 'Fun times' 9-max (Play Money) Seat #8 is the button
Seat 1: color_singleton (17961 in chips) 
Seat 2: dddocky (5900 in chips) 
Seat 3: Duke Croix (20592 in chips) 
Seat 6: Klemtonius (8634 in chips) 
Seat 8: HighCardJasper (8904 in chips) 
Seat 9: Manon947 (8359 in chips) 
Manon947: posts small blind 50
color_singleton: posts big blind 100
*** HOLE CARDS ***
Dealt to Manon947 [Ad 6s]
dddocky: calls 100
Duke Croix: calls 100
Klemtonius: calls 100
HighCardJasper: calls 100
Manon947: calls 50
color_singleton: checks 
*** FLOP *** [9h 5c Ah]
Manon947: bets 283
color_singleton: folds 
dddocky: folds 
Duke Croix: calls 283
Klemtonius: folds 
HighCardJasper: calls 283
*** TURN *** [9h 5c Ah] [Jc]
Manon947: bets 684
Duke Croix: calls 684
HighCardJasper: folds 
*** RIVER *** [9h 5c Ah Jc] [4s]
Manon947: bets 1331
Duke Croix: calls 1331
*** SHOW DOWN ***
Manon947: shows [Ad 6s] (a pair of Aces)
Duke Croix: mucks hand 
Manon947 collected 5178 from pot
*** SUMMARY ***
Total pot 5479 | Rake 301 
Board [9h 5c Ah Jc 4s]
Seat 1: color_singleton (big blind) folded on the Flop
Seat 2: dddocky folded on the Flop
Seat 3: Duke Croix mucked [3c As]
Seat 6: Klemtonius folded on the Flop
Seat 8: HighCardJasper (button) folded on the Turn
Seat 9: Manon947 (small blind) showed [Ad 6s] and won (5178) with a pair of Aces



PokerStars Home Game Hand #216494309566: {Club #3225207}  Hold'em No Limit (50/100) - 2020/07/16 18:48:33 ET
Table 'Fun times' 9-max (Play Money) Seat #9 is the button
Seat 1: color_singleton (17861 in chips) 
Seat 2: dddocky (5800 in chips) 
Seat 3: Duke Croix (18194 in chips) 
Seat 6: Klemtonius (8534 in chips) 
Seat 8: HighCardJasper (8521 in chips) 
Seat 9: Manon947 (11139 in chips) 
color_singleton: posts small blind 50
dddocky: posts big blind 100
*** HOLE CARDS ***
Dealt to Manon947 [Jd 8h]
Duke Croix: folds 
Klemtonius: calls 100
HighCardJasper: calls 100
Manon947: calls 100
color_singleton: raises 200 to 300
dddocky: calls 200
Klemtonius: folds 
HighCardJasper: calls 200
Manon947: calls 200
*** FLOP *** [9c Th 9s]
color_singleton: bets 614
dddocky: folds 
HighCardJasper: folds 
Manon947: folds 
Uncalled bet (614) returned to color_singleton
color_singleton collected 1228 from pot
color_singleton: doesn't show hand 
*** SUMMARY ***
Total pot 1300 | Rake 72 
Board [9c Th 9s]
Seat 1: color_singleton (small blind) collected (1228)
Seat 2: dddocky (big blind) folded on the Flop
Seat 3: Duke Croix folded before Flop (didn't bet)
Seat 6: Klemtonius folded before Flop
Seat 8: HighCardJasper folded on the Flop
Seat 9: Manon947 (button) folded on the Flop



PokerStars Home Game Hand #216494328738: {Club #3225207}  Hold'em No Limit (50/100) - 2020/07/16 18:49:12 ET
Table 'Fun times' 9-max (Play Money) Seat #1 is the button
Seat 1: color_singleton (18789 in chips) 
Seat 2: dddocky (5500 in chips) 
Seat 3: Duke Croix (18194 in chips) 
Seat 6: Klemtonius (8434 in chips) 
Seat 8: HighCardJasper (8221 in chips) 
Seat 9: Manon947 (10839 in chips) 
dddocky: posts small blind 50
Duke Croix: posts big blind 100
*** HOLE CARDS ***
Dealt to Manon947 [Jc Qs]
Klemtonius: raises 455 to 555
HighCardJasper: folds 
Manon947: folds 
color_singleton: calls 555
dddocky: folds 
Duke Croix: folds 
*** FLOP *** [Kd 5c 4d]
Klemtonius: checks 
color_singleton: checks 
*** TURN *** [Kd 5c 4d] [2d]
Klemtonius: bets 555
color_singleton: folds 
Uncalled bet (555) returned to Klemtonius
Klemtonius collected 1191 from pot
Klemtonius: doesn't show hand 
*** SUMMARY ***
Total pot 1260 | Rake 69 
Board [Kd 5c 4d 2d]
Seat 1: color_singleton (button) folded on the Turn
Seat 2: dddocky (small blind) folded before Flop
Seat 3: Duke Croix (big blind) folded before Flop
Seat 6: Klemtonius collected (1191)
Seat 8: HighCardJasper folded before Flop (didn't bet)
Seat 9: Manon947 folded before Flop (didn't bet)



PokerStars Home Game Hand #216494345541: {Club #3225207}  Hold'em No Limit (50/100) - 2020/07/16 18:49:48 ET
Table 'Fun times' 9-max (Play Money) Seat #2 is the button
Seat 1: color_singleton (18234 in chips) 
Seat 2: dddocky (5450 in chips) 
Seat 3: Duke Croix (18094 in chips) 
Seat 6: Klemtonius (9070 in chips) 
Seat 8: HighCardJasper (8221 in chips) 
Seat 9: Manon947 (10839 in chips) 
Duke Croix: posts small blind 50
Klemtonius: posts big blind 100
*** HOLE CARDS ***
Dealt to Manon947 [As 5d]
HighCardJasper: calls 100
Manon947: calls 100
color_singleton: folds 
dddocky: calls 100
Duke Croix: calls 50
Klemtonius: checks 
*** FLOP *** [Qd 2d 4s]
Duke Croix: checks 
Klemtonius: checks 
HighCardJasper: checks 
Manon947: checks 
dddocky: checks 
*** TURN *** [Qd 2d 4s] [Js]
Duke Croix: checks 
Klemtonius: bets 236
HighCardJasper: folds 
Manon947: calls 236
dddocky: folds 
Duke Croix: calls 236
*** RIVER *** [Qd 2d 4s Js] [7h]
Duke Croix: checks 
Klemtonius: checks 
Manon947: bets 571
Duke Croix: folds 
Klemtonius: calls 571
*** SHOW DOWN ***
Manon947: shows [As 5d] (high card Ace)
Klemtonius: shows [7s 3s] (a pair of Sevens)
Klemtonius collected 2221 from pot
*** SUMMARY ***
Total pot 2350 | Rake 129 
Board [Qd 2d 4s Js 7h]
Seat 1: color_singleton folded before Flop (didn't bet)
Seat 2: dddocky (button) folded on the Turn
Seat 3: Duke Croix (small blind) folded on the River
Seat 6: Klemtonius (big blind) showed [7s 3s] and won (2221) with a pair of Sevens
Seat 8: HighCardJasper folded on the Turn
Seat 9: Manon947 showed [As 5d] and lost with high card Ace



PokerStars Home Game Hand #216494366170: {Club #3225207}  Hold'em No Limit (50/100) - 2020/07/16 18:50:31 ET
Table 'Fun times' 9-max (Play Money) Seat #3 is the button
Seat 1: color_singleton (18234 in chips) 
Seat 2: dddocky (5350 in chips) 
Seat 3: Duke Croix (17758 in chips) 
Seat 6: Klemtonius (10384 in chips) 
Seat 8: HighCardJasper (8121 in chips) 
Seat 9: Manon947 (9932 in chips) 
Klemtonius: posts small blind 50
HighCardJasper: posts big blind 100
*** HOLE CARDS ***
Dealt to Manon947 [8h Qc]
Manon947: calls 100
color_singleton: folds 
dddocky: folds 
Duke Croix: folds 
Klemtonius: raises 100 to 200
HighCardJasper: calls 100
Manon947: folds 
*** FLOP *** [Ah 4s Qd]
Klemtonius: checks 
HighCardJasper: checks 
*** TURN *** [Ah 4s Qd] [Jc]
Klemtonius: checks 
HighCardJasper: checks 
*** RIVER *** [Ah 4s Qd Jc] [Ts]
Klemtonius: checks 
HighCardJasper: checks 
*** SHOW DOWN ***
Klemtonius: shows [7d 6s] (high card Ace)
HighCardJasper: mucks hand 
Klemtonius collected 472 from pot
*** SUMMARY ***
Total pot 500 | Rake 28 
Board [Ah 4s Qd Jc Ts]
Seat 1: color_singleton folded before Flop (didn't bet)
Seat 2: dddocky folded before Flop (didn't bet)
Seat 3: Duke Croix (button) folded before Flop (didn't bet)
Seat 6: Klemtonius (small blind) showed [7d 6s] and won (472) with high card Ace
Seat 8: HighCardJasper (big blind) mucked [2d 3d]
Seat 9: Manon947 folded before Flop



PokerStars Home Game Hand #216494385003: {Club #3225207}  Hold'em No Limit (50/100) - 2020/07/16 18:51:10 ET
Table 'Fun times' 9-max (Play Money) Seat #6 is the button
Seat 1: color_singleton (18234 in chips) 
Seat 2: dddocky (5350 in chips) 
Seat 3: Duke Croix (17758 in chips) 
Seat 6: Klemtonius (10656 in chips) 
Seat 8: HighCardJasper (7921 in chips) 
Seat 9: Manon947 (9832 in chips) 
HighCardJasper: posts small blind 50
Manon947: posts big blind 100
*** HOLE CARDS ***
Dealt to Manon947 [2c 4h]
color_singleton: folds 
dddocky: calls 100
Duke Croix: calls 100
Klemtonius: raises 300 to 400
HighCardJasper: calls 350
Manon947: folds 
dddocky: calls 300
Duke Croix: calls 300
*** FLOP *** [7h Td Jc]
HighCardJasper: bets 200
dddocky: folds 
Duke Croix: calls 200
Klemtonius: calls 200
*** TURN *** [7h Td Jc] [Ts]
HighCardJasper: checks 
Duke Croix: checks 
Klemtonius: checks 
*** RIVER *** [7h Td Jc Ts] [8c]
HighCardJasper: bets 300
Duke Croix: calls 300
Klemtonius: raises 300 to 600
HighCardJasper: folds 
Duke Croix: calls 300
*** SHOW DOWN ***
Klemtonius: shows [9h Ah] (a straight, Seven to Jack)
Duke Croix: mucks hand 
Klemtonius collected 3591 from pot
*** SUMMARY ***
Total pot 3800 | Rake 209 
Board [7h Td Jc Ts 8c]
Seat 1: color_singleton folded before Flop (didn't bet)
Seat 2: dddocky folded on the Flop
Seat 3: Duke Croix mucked [8h Qd]
Seat 6: Klemtonius (button) showed [9h Ah] and won (3591) with a straight, Seven to Jack
Seat 8: HighCardJasper (small blind) folded on the River
Seat 9: Manon947 (big blind) folded before Flop



PokerStars Home Game Hand #216494424434: {Club #3225207}  Hold'em No Limit (50/100) - 2020/07/16 18:52:32 ET
Table 'Fun times' 9-max (Play Money) Seat #8 is the button
Seat 1: color_singleton (18234 in chips) 
Seat 2: dddocky (4950 in chips) 
Seat 3: Duke Croix (16558 in chips) 
Seat 6: Klemtonius (13047 in chips) 
Seat 8: HighCardJasper (7021 in chips) 
Seat 9: Manon947 (9732 in chips) 
Manon947: posts small blind 50
color_singleton: posts big blind 100
*** HOLE CARDS ***
Dealt to Manon947 [9h Ah]
dddocky: folds 
Duke Croix: calls 100
Klemtonius has timed out
Klemtonius: folds 
HighCardJasper: folds 
Manon947: calls 50
color_singleton: checks 
*** FLOP *** [Ts Kc 3s]
Manon947: checks 
color_singleton: checks 
Duke Croix: checks 
*** TURN *** [Ts Kc 3s] [7h]
Manon947: checks 
color_singleton: checks 
Duke Croix: bets 250
Manon947: folds 
color_singleton: folds 
Uncalled bet (250) returned to Duke Croix
Duke Croix collected 283 from pot
Duke Croix: doesn't show hand 
*** SUMMARY ***
Total pot 300 | Rake 17 
Board [Ts Kc 3s 7h]
Seat 1: color_singleton (big blind) folded on the Turn
Seat 2: dddocky folded before Flop (didn't bet)
Seat 3: Duke Croix collected (283)
Seat 6: Klemtonius folded before Flop (didn't bet)
Seat 8: HighCardJasper (button) folded before Flop (didn't bet)
Seat 9: Manon947 (small blind) folded on the Turn



PokerStars Home Game Hand #216494456251: {Club #3225207}  Hold'em No Limit (50/100) - 2020/07/16 18:53:39 ET
Table 'Fun times' 9-max (Play Money) Seat #9 is the button
Seat 1: color_singleton (18134 in chips) 
Seat 2: dddocky (4950 in chips) 
Seat 3: Duke Croix (16741 in chips) 
Seat 8: HighCardJasper (7021 in chips) 
Seat 9: Manon947 (9632 in chips) 
color_singleton: posts small blind 50
dddocky: posts big blind 100
*** HOLE CARDS ***
Dealt to Manon947 [Ah 5s]
Duke Croix: folds 
HighCardJasper: folds 
Manon947: calls 100
color_singleton: raises 200 to 300
dddocky: folds 
Manon947: calls 200
*** FLOP *** [7h Jc Jd]
color_singleton: checks 
Manon947: checks 
*** TURN *** [7h Jc Jd] [Kd]
color_singleton: bets 330
Manon947: folds 
Uncalled bet (330) returned to color_singleton
color_singleton collected 661 from pot
color_singleton: doesn't show hand 
*** SUMMARY ***
Total pot 700 | Rake 39 
Board [7h Jc Jd Kd]
Seat 1: color_singleton (small blind) collected (661)
Seat 2: dddocky (big blind) folded before Flop
Seat 3: Duke Croix folded before Flop (didn't bet)
Seat 8: HighCardJasper folded before Flop (didn't bet)
Seat 9: Manon947 (button) folded on the Turn



PokerStars Home Game Hand #216494469782: {Club #3225207}  Hold'em No Limit (50/100) - 2020/07/16 18:54:08 ET
Table 'Fun times' 9-max (Play Money) Seat #1 is the button
Seat 1: color_singleton (18495 in chips) 
Seat 2: dddocky (4850 in chips) 
Seat 3: Duke Croix (16741 in chips) 
Seat 6: Klemtonius (13047 in chips) 
Seat 8: HighCardJasper (7021 in chips) 
Seat 9: Manon947 (9332 in chips) 
dddocky: posts small blind 50
Duke Croix: posts big blind 100
*** HOLE CARDS ***
Dealt to Manon947 [5d 6s]
Klemtonius: calls 100
HighCardJasper: folds 
Manon947: folds 
color_singleton: calls 100
dddocky: folds 
Duke Croix: checks 
*** FLOP *** [Kc 9h 7c]
Duke Croix: bets 200
Klemtonius: folds 
color_singleton: calls 200
*** TURN *** [Kc 9h 7c] [Td]
Duke Croix: bets 600
color_singleton: folds 
Uncalled bet (600) returned to Duke Croix
Duke Croix collected 709 from pot
Duke Croix: doesn't show hand 
*** SUMMARY ***
Total pot 750 | Rake 41 
Board [Kc 9h 7c Td]
Seat 1: color_singleton (button) folded on the Turn
Seat 2: dddocky (small blind) folded before Flop
Seat 3: Duke Croix (big blind) collected (709)
Seat 6: Klemtonius folded on the Flop
Seat 8: HighCardJasper folded before Flop (didn't bet)
Seat 9: Manon947 folded before Flop (didn't bet)



PokerStars Home Game Hand #216494495538: {Club #3225207}  Hold'em No Limit (50/100) - 2020/07/16 18:54:57 ET
Table 'Fun times' 9-max (Play Money) Seat #2 is the button
Seat 1: color_singleton (18195 in chips) 
Seat 2: dddocky (4800 in chips) 
Seat 3: Duke Croix (17150 in chips) 
Seat 6: Klemtonius (12947 in chips) 
Seat 8: HighCardJasper (7021 in chips) 
Seat 9: Manon947 (9332 in chips) 
Duke Croix: posts small blind 50
Klemtonius: posts big blind 100
*** HOLE CARDS ***
Dealt to Manon947 [Jc 2d]
HighCardJasper: raises 100 to 200
Manon947: calls 200
color_singleton: calls 200
dddocky: calls 200
Duke Croix: calls 150
Klemtonius: calls 100
*** FLOP *** [2s Kh Jd]
Duke Croix: bets 700
Klemtonius: folds 
HighCardJasper: folds 
Manon947: calls 700
color_singleton: calls 700
dddocky: folds 
*** TURN *** [2s Kh Jd] [8h]
Duke Croix: bets 1559
Manon947: calls 1559
color_singleton: folds 
*** RIVER *** [2s Kh Jd 8h] [6c]
Duke Croix: checks 
Manon947: checks 
*** SHOW DOWN ***
Duke Croix: shows [Kd Qs] (a pair of Kings)
Manon947: shows [Jc 2d] (two pair, Jacks and Deuces)
Manon947 collected 6065 from pot
*** SUMMARY ***
Total pot 6418 | Rake 353 
Board [2s Kh Jd 8h 6c]
Seat 1: color_singleton folded on the Turn
Seat 2: dddocky (button) folded on the Flop
Seat 3: Duke Croix (small blind) showed [Kd Qs] and lost with a pair of Kings
Seat 6: Klemtonius (big blind) folded on the Flop
Seat 8: HighCardJasper folded on the Flop
Seat 9: Manon947 showed [Jc 2d] and won (6065) with two pair, Jacks and Deuces



PokerStars Home Game Hand #216494513999: {Club #3225207}  Hold'em No Limit (50/100) - 2020/07/16 18:55:46 ET
Table 'Fun times' 9-max (Play Money) Seat #3 is the button
Seat 1: color_singleton (17295 in chips) 
Seat 2: dddocky (4600 in chips) 
Seat 3: Duke Croix (14691 in chips) 
Seat 6: Klemtonius (12747 in chips) 
Seat 8: HighCardJasper (6821 in chips) 
Seat 9: Manon947 (12938 in chips) 
Klemtonius: posts small blind 50
HighCardJasper: posts big blind 100
*** HOLE CARDS ***
Dealt to Manon947 [4d Ah]
Manon947: calls 100
color_singleton: raises 200 to 300
dddocky: calls 300
Duke Croix: calls 300
Klemtonius: calls 250
HighCardJasper: folds 
Manon947: calls 200
*** FLOP *** [2h 7s 3d]
Klemtonius: bets 1512
Manon947: folds 
color_singleton: folds 
dddocky: folds 
Duke Croix: folds 
Uncalled bet (1512) returned to Klemtonius
Klemtonius collected 1512 from pot
Klemtonius: doesn't show hand 
*** SUMMARY ***
Total pot 1600 | Rake 88 
Board [2h 7s 3d]
Seat 1: color_singleton folded on the Flop
Seat 2: dddocky folded on the Flop
Seat 3: Duke Croix (button) folded on the Flop
Seat 6: Klemtonius (small blind) collected (1512)
Seat 8: HighCardJasper (big blind) folded before Flop
Seat 9: Manon947 folded on the Flop



PokerStars Home Game Hand #216494524673: {Club #3225207}  Hold'em No Limit (50/100) - 2020/07/16 18:56:15 ET
Table 'Fun times' 9-max (Play Money) Seat #6 is the button
Seat 1: color_singleton (16995 in chips) 
Seat 2: dddocky (4300 in chips) 
Seat 3: Duke Croix (14391 in chips) 
Seat 6: Klemtonius (13959 in chips) 
Seat 8: HighCardJasper (6721 in chips) 
Seat 9: Manon947 (12638 in chips) 
HighCardJasper: posts small blind 50
Manon947: posts big blind 100
*** HOLE CARDS ***
Dealt to Manon947 [4s 2s]
color_singleton: folds 
dddocky: folds 
Duke Croix: folds 
Klemtonius: calls 100
HighCardJasper: calls 50
Manon947: checks 
*** FLOP *** [Qd 6h Ac]
HighCardJasper: checks 
Manon947: checks 
Klemtonius: checks 
*** TURN *** [Qd 6h Ac] [7d]
HighCardJasper: checks 
Manon947: checks 
Klemtonius: bets 211
HighCardJasper: calls 211
Manon947: folds 
*** RIVER *** [Qd 6h Ac 7d] [Js]
HighCardJasper: checks 
Klemtonius: bets 322
HighCardJasper: calls 322
*** SHOW DOWN ***
Klemtonius: shows [5h 4d] (high card Ace)
HighCardJasper: shows [Qh 8h] (a pair of Queens)
HighCardJasper collected 1291 from pot
*** SUMMARY ***
Total pot 1366 | Rake 75 
Board [Qd 6h Ac 7d Js]
Seat 1: color_singleton folded before Flop (didn't bet)
Seat 2: dddocky folded before Flop (didn't bet)
Seat 3: Duke Croix folded before Flop (didn't bet)
Seat 6: Klemtonius (button) showed [5h 4d] and lost with high card Ace
Seat 8: HighCardJasper (small blind) showed [Qh 8h] and won (1291) with a pair of Queens
Seat 9: Manon947 (big blind) folded on the Turn



PokerStars Home Game Hand #216494547488: {Club #3225207}  Hold'em No Limit (50/100) - 2020/07/16 18:57:16 ET
Table 'Fun times' 9-max (Play Money) Seat #8 is the button
Seat 1: color_singleton (16995 in chips) 
Seat 2: dddocky (4300 in chips) 
Seat 3: Duke Croix (14391 in chips) 
Seat 6: Klemtonius (13326 in chips) 
Seat 8: HighCardJasper (7379 in chips) 
Seat 9: Manon947 (12538 in chips) 
Manon947: posts small blind 50
color_singleton: posts big blind 100
*** HOLE CARDS ***
Dealt to Manon947 [4c Ad]
dddocky: calls 100
Duke Croix: calls 100
Klemtonius: calls 100
HighCardJasper: raises 100 to 200
Manon947: calls 150
color_singleton: calls 100
dddocky: calls 100
Duke Croix: calls 100
Klemtonius: calls 100
*** FLOP *** [6c 8h 9d]
Manon947: checks 
color_singleton: checks 
dddocky: checks 
Duke Croix: checks 
Klemtonius: checks 
HighCardJasper: checks 
*** TURN *** [6c 8h 9d] [4d]
Manon947: bets 567
color_singleton: calls 567
dddocky: calls 567
Duke Croix: folds 
Klemtonius: raises 1133 to 1700
HighCardJasper: folds 
Manon947: folds 
color_singleton: calls 1133
dddocky: folds 
*** RIVER *** [6c 8h 9d 4d] [Qc]
color_singleton: checks 
Klemtonius: bets 5419
color_singleton: folds 
Uncalled bet (5419) returned to Klemtonius
Klemtonius collected 5419 from pot
Klemtonius: doesn't show hand 
*** SUMMARY ***
Total pot 5734 | Rake 315 
Board [6c 8h 9d 4d Qc]
Seat 1: color_singleton (big blind) folded on the River
Seat 2: dddocky folded on the Turn
Seat 3: Duke Croix folded on the Turn
Seat 6: Klemtonius collected (5419)
Seat 8: HighCardJasper (button) folded on the Turn
Seat 9: Manon947 (small blind) folded on the Turn



PokerStars Home Game Hand #216494572831: {Club #3225207}  Hold'em No Limit (50/100) - 2020/07/16 18:58:23 ET
Table 'Fun times' 9-max (Play Money) Seat #9 is the button
Seat 1: color_singleton (15095 in chips) 
Seat 2: dddocky (3533 in chips) 
Seat 3: Duke Croix (14191 in chips) 
Seat 6: Klemtonius (16845 in chips) 
Seat 8: HighCardJasper (7179 in chips) 
Seat 9: Manon947 (11771 in chips) 
color_singleton: posts small blind 50
dddocky: posts big blind 100
*** HOLE CARDS ***
Dealt to Manon947 [7h 4h]
Duke Croix: raises 300 to 400
Klemtonius: folds 
HighCardJasper: calls 400
Manon947: folds 
color_singleton: calls 350
dddocky: folds 
*** FLOP *** [Js Kh Ad]
color_singleton: checks 
Duke Croix: checks 
HighCardJasper: bets 300
color_singleton: calls 300
Duke Croix: calls 300
*** TURN *** [Js Kh Ad] [2h]
color_singleton: checks 
Duke Croix: checks 
HighCardJasper: bets 1000
color_singleton: folds 
Duke Croix: folds 
Uncalled bet (1000) returned to HighCardJasper
HighCardJasper collected 2079 from pot
HighCardJasper: doesn't show hand 
*** SUMMARY ***
Total pot 2200 | Rake 121 
Board [Js Kh Ad 2h]
Seat 1: color_singleton (small blind) folded on the Turn
Seat 2: dddocky (big blind) folded before Flop
Seat 3: Duke Croix folded on the Turn
Seat 6: Klemtonius folded before Flop (didn't bet)
Seat 8: HighCardJasper collected (2079)
Seat 9: Manon947 (button) folded before Flop (didn't bet)



PokerStars Home Game Hand #216494589240: {Club #3225207}  Hold'em No Limit (50/100) - 2020/07/16 18:59:07 ET
Table 'Fun times' 9-max (Play Money) Seat #1 is the button
Seat 1: color_singleton (14395 in chips) 
Seat 2: dddocky (3433 in chips) 
Seat 3: Duke Croix (13491 in chips) 
Seat 6: Klemtonius (16845 in chips) 
Seat 8: HighCardJasper (8558 in chips) 
Seat 9: Manon947 (11771 in chips) 
dddocky: posts small blind 50
Duke Croix: posts big blind 100
*** HOLE CARDS ***
Dealt to Manon947 [Ah Th]
Klemtonius: folds 
HighCardJasper: calls 100
Manon947: calls 100
color_singleton: calls 100
dddocky: calls 50
Duke Croix: checks 
*** FLOP *** [Td 8c Ac]
dddocky: checks 
Duke Croix: bets 300
HighCardJasper: folds 
Manon947: raises 300 to 600
color_singleton: folds 
dddocky: folds 
Duke Croix: calls 300
*** TURN *** [Td 8c Ac] [Jd]
Duke Croix: checks 
Manon947: bets 803
Duke Croix: calls 803
*** RIVER *** [Td 8c Ac Jd] [3c]
Duke Croix: bets 1000
Manon947: raises 1000 to 2000
Duke Croix: calls 1000
*** SHOW DOWN ***
Manon947: shows [Ah Th] (two pair, Aces and Tens)
Duke Croix: shows [7h 9d] (a straight, Seven to Jack)
Duke Croix collected 6904 from pot
*** SUMMARY ***
Total pot 7306 | Rake 402 
Board [Td 8c Ac Jd 3c]
Seat 1: color_singleton (button) folded on the Flop
Seat 2: dddocky (small blind) folded on the Flop
Seat 3: Duke Croix (big blind) showed [7h 9d] and won (6904) with a straight, Seven to Jack
Seat 6: Klemtonius folded before Flop (didn't bet)
Seat 8: HighCardJasper folded on the Flop
Seat 9: Manon947 showed [Ah Th] and lost with two pair, Aces and Tens



PokerStars Home Game Hand #216494609758: {Club #3225207}  Hold'em No Limit (50/100) - 2020/07/16 19:00:01 ET
Table 'Fun times' 9-max (Play Money) Seat #2 is the button
Seat 1: color_singleton (14295 in chips) 
Seat 2: dddocky (3333 in chips) 
Seat 3: Duke Croix (16892 in chips) 
Seat 6: Klemtonius (16845 in chips) 
Seat 8: HighCardJasper (8458 in chips) 
Seat 9: Manon947 (8268 in chips) 
Duke Croix: posts small blind 50
Klemtonius: posts big blind 100
*** HOLE CARDS ***
Dealt to Manon947 [5h 6d]
HighCardJasper: calls 100
Manon947: calls 100
color_singleton: calls 100
dddocky: calls 100
Duke Croix: calls 50
Klemtonius: checks 
*** FLOP *** [2c Ac 3h]
Duke Croix: bets 400
Klemtonius: folds 
HighCardJasper: folds 
Manon947: calls 400
color_singleton: folds 
dddocky: calls 400
*** TURN *** [2c Ac 3h] [7s]
Duke Croix: bets 500
Manon947: folds 
dddocky: calls 500
*** RIVER *** [2c Ac 3h 7s] [Qd]
Duke Croix: checks 
dddocky: bets 100
Duke Croix: raises 500 to 600
dddocky: calls 500
*** SHOW DOWN ***
Duke Croix: shows [Ad 4s] (a pair of Aces)
dddocky: shows [Tc Ah] (a pair of Aces - Queen+Ten kicker)
dddocky collected 3780 from pot
*** SUMMARY ***
Total pot 4000 | Rake 220 
Board [2c Ac 3h 7s Qd]
Seat 1: color_singleton folded on the Flop
Seat 2: dddocky (button) showed [Tc Ah] and won (3780) with a pair of Aces
Seat 3: Duke Croix (small blind) showed [Ad 4s] and lost with a pair of Aces
Seat 6: Klemtonius (big blind) folded on the Flop
Seat 8: HighCardJasper folded on the Flop
Seat 9: Manon947 folded on the Turn



PokerStars Home Game Hand #216494634909: {Club #3225207}  Hold'em No Limit (50/100) - 2020/07/16 19:01:02 ET
Table 'Fun times' 9-max (Play Money) Seat #3 is the button
Seat 1: color_singleton (14195 in chips) 
Seat 2: dddocky (5513 in chips) 
Seat 3: Duke Croix (15292 in chips) 
Seat 6: Klemtonius (16745 in chips) 
Seat 8: HighCardJasper (8358 in chips) 
Seat 9: Manon947 (7768 in chips) 
Klemtonius: posts small blind 50
HighCardJasper: posts big blind 100
*** HOLE CARDS ***
Dealt to Manon947 [8d 7h]
Manon947: calls 100
color_singleton: raises 100 to 200
dddocky: folds 
Duke Croix: calls 200
Klemtonius: calls 150
HighCardJasper: calls 100
Manon947: calls 100
*** FLOP *** [8s As 2s]
Klemtonius: bets 500
HighCardJasper: folds 
Manon947: folds 
color_singleton: folds 
Duke Croix: folds 
Uncalled bet (500) returned to Klemtonius
Klemtonius collected 945 from pot
Klemtonius: doesn't show hand 
*** SUMMARY ***
Total pot 1000 | Rake 55 
Board [8s As 2s]
Seat 1: color_singleton folded on the Flop
Seat 2: dddocky folded before Flop (didn't bet)
Seat 3: Duke Croix (button) folded on the Flop
Seat 6: Klemtonius (small blind) collected (945)
Seat 8: HighCardJasper (big blind) folded on the Flop
Seat 9: Manon947 folded on the Flop



PokerStars Home Game Hand #216494659754: {Club #3225207}  Hold'em No Limit (50/100) - 2020/07/16 19:01:49 ET
Table 'Fun times' 9-max (Play Money) Seat #6 is the button
Seat 1: color_singleton (13995 in chips) 
Seat 3: Duke Croix (15092 in chips) 
Seat 6: Klemtonius (17490 in chips) 
Seat 8: HighCardJasper (8158 in chips) 
Seat 9: Manon947 (7568 in chips) 
HighCardJasper: posts small blind 50
Manon947: posts big blind 100
*** HOLE CARDS ***
Dealt to Manon947 [Jc Ah]
color_singleton: folds 
Duke Croix: raises 300 to 400
Klemtonius: raises 300 to 700
HighCardJasper: folds 
dddocky leaves the table
Manon947: folds 
Duke Croix: calls 300
*** FLOP *** [Qd 8h 6d]
Duke Croix: checks 
Klemtonius: bets 1465
Duke Croix: folds 
Uncalled bet (1465) returned to Klemtonius
Klemtonius collected 1465 from pot
Klemtonius: doesn't show hand 
*** SUMMARY ***
Total pot 1550 | Rake 85 
Board [Qd 8h 6d]
Seat 1: color_singleton folded before Flop (didn't bet)
Seat 3: Duke Croix folded on the Flop
Seat 6: Klemtonius (button) collected (1465)
Seat 8: HighCardJasper (small blind) folded before Flop
Seat 9: Manon947 (big blind) folded before Flop



PokerStars Home Game Hand #216494672136: {Club #3225207}  Hold'em No Limit (50/100) - 2020/07/16 19:02:16 ET
Table 'Fun times' 9-max (Play Money) Seat #8 is the button
Seat 1: color_singleton (13995 in chips) 
Seat 3: Duke Croix (14392 in chips) 
Seat 6: Klemtonius (18255 in chips) 
Seat 8: HighCardJasper (8108 in chips) 
Seat 9: Manon947 (7468 in chips) 
Manon947: posts small blind 50
color_singleton: posts big blind 100
*** HOLE CARDS ***
Dealt to Manon947 [3d 7c]
Duke Croix: raises 100 to 200
Klemtonius: folds 
HighCardJasper has timed out
HighCardJasper: folds 
Manon947: folds 
color_singleton: calls 100
*** FLOP *** [Td 4h Qc]
color_singleton: bets 212
Duke Croix: folds 
Uncalled bet (212) returned to color_singleton
color_singleton collected 425 from pot
color_singleton: doesn't show hand 
*** SUMMARY ***
Total pot 450 | Rake 25 
Board [Td 4h Qc]
Seat 1: color_singleton (big blind) collected (425)
Seat 3: Duke Croix folded on the Flop
Seat 6: Klemtonius folded before Flop (didn't bet)
Seat 8: HighCardJasper (button) folded before Flop (didn't bet)
Seat 9: Manon947 (small blind) folded before Flop



PokerStars Home Game Hand #216494688620: {Club #3225207}  Hold'em No Limit (50/100) - 2020/07/16 19:02:52 ET
Table 'Fun times' 9-max (Play Money) Seat #9 is the button
Seat 1: color_singleton (14220 in chips) 
Seat 3: Duke Croix (14192 in chips) 
Seat 6: Klemtonius (18255 in chips) 
Seat 8: HighCardJasper (8108 in chips) 
Seat 9: Manon947 (7418 in chips) 
color_singleton: posts small blind 50
Duke Croix: posts big blind 100
*** HOLE CARDS ***
Dealt to Manon947 [6c Tc]
Klemtonius: raises 100 to 200
HighCardJasper: folds 
Manon947: calls 200
color_singleton: folds 
Duke Croix: calls 100
*** FLOP *** [Jd 4s 5h]
Duke Croix: checks 
Klemtonius: checks 
Manon947: checks 
*** TURN *** [Jd 4s 5h] [Qc]
Duke Croix: checks 
Klemtonius: checks 
Manon947: checks 
*** RIVER *** [Jd 4s 5h Qc] [8h]
Duke Croix: checks 
Klemtonius: bets 123
Manon947: folds 
Duke Croix: folds 
Uncalled bet (123) returned to Klemtonius
Klemtonius collected 614 from pot
Klemtonius: doesn't show hand 
*** SUMMARY ***
Total pot 650 | Rake 36 
Board [Jd 4s 5h Qc 8h]
Seat 1: color_singleton (small blind) folded before Flop
Seat 3: Duke Croix (big blind) folded on the River
Seat 6: Klemtonius collected (614)
Seat 8: HighCardJasper folded before Flop (didn't bet)
Seat 9: Manon947 (button) folded on the River



PokerStars Home Game Hand #216494707784: {Club #3225207}  Hold'em No Limit (50/100) - 2020/07/16 19:03:34 ET
Table 'Fun times' 9-max (Play Money) Seat #1 is the button
Seat 1: color_singleton (14170 in chips) 
Seat 3: Duke Croix (13992 in chips) 
Seat 6: Klemtonius (18669 in chips) 
Seat 8: HighCardJasper (8108 in chips) 
Seat 9: Manon947 (7218 in chips) 
Duke Croix: posts small blind 50
Klemtonius: posts big blind 100
*** HOLE CARDS ***
Dealt to Manon947 [9d 4d]
HighCardJasper: calls 100
Manon947: calls 100
color_singleton: raises 100 to 200
Duke Croix: calls 150
Klemtonius: calls 100
HighCardJasper: calls 100
Manon947: calls 100
*** FLOP *** [Js Kc Qc]
Duke Croix: checks 
Klemtonius: bets 100
HighCardJasper: calls 100
Manon947: folds 
color_singleton: raises 622 to 722
Duke Croix: folds 
Klemtonius: folds 
HighCardJasper: folds 
Uncalled bet (622) returned to color_singleton
color_singleton collected 1228 from pot
color_singleton: doesn't show hand 
*** SUMMARY ***
Total pot 1300 | Rake 72 
Board [Js Kc Qc]
Seat 1: color_singleton (button) collected (1228)
Seat 3: Duke Croix (small blind) folded on the Flop
Seat 6: Klemtonius (big blind) folded on the Flop
Seat 8: HighCardJasper folded on the Flop
Seat 9: Manon947 folded on the Flop



PokerStars Home Game Hand #216494726527: {Club #3225207}  Hold'em No Limit (50/100) - 2020/07/16 19:04:15 ET
Table 'Fun times' 9-max (Play Money) Seat #3 is the button
Seat 1: color_singleton (15098 in chips) 
Seat 3: Duke Croix (13792 in chips) 
Seat 6: Klemtonius (18369 in chips) 
Seat 8: HighCardJasper (7808 in chips) 
Seat 9: Manon947 (7018 in chips) 
Klemtonius: posts small blind 50
HighCardJasper: posts big blind 100
*** HOLE CARDS ***
Dealt to Manon947 [4d Ah]
Manon947: calls 100
color_singleton: folds 
Duke Croix: folds 
Klemtonius: calls 50
HighCardJasper: raises 200 to 300
Manon947: calls 200
Klemtonius: folds 
*** FLOP *** [Ad Jc 5c]
HighCardJasper: bets 300
Manon947: calls 300
*** TURN *** [Ad Jc 5c] [6c]
HighCardJasper: checks 
Manon947: checks 
*** RIVER *** [Ad Jc 5c 6c] [8s]
HighCardJasper: checks 
Manon947: bets 614
HighCardJasper: calls 614
*** SHOW DOWN ***
Manon947: shows [4d Ah] (a pair of Aces)
HighCardJasper: mucks hand 
Manon947 collected 2389 from pot
*** SUMMARY ***
Total pot 2528 | Rake 139 
Board [Ad Jc 5c 6c 8s]
Seat 1: color_singleton folded before Flop (didn't bet)
Seat 3: Duke Croix (button) folded before Flop (didn't bet)
Seat 6: Klemtonius (small blind) folded before Flop
Seat 8: HighCardJasper (big blind) mucked [Ks Kh]
Seat 9: Manon947 showed [4d Ah] and won (2389) with a pair of Aces



PokerStars Home Game Hand #216494746497: {Club #3225207}  Hold'em No Limit (50/100) - 2020/07/16 19:04:58 ET
Table 'Fun times' 9-max (Play Money) Seat #6 is the button
Seat 1: color_singleton (15098 in chips) 
Seat 3: Duke Croix (13792 in chips) 
Seat 6: Klemtonius (18269 in chips) 
Seat 8: HighCardJasper (6594 in chips) 
Seat 9: Manon947 (8193 in chips) 
HighCardJasper: posts small blind 50
Manon947: posts big blind 100
*** HOLE CARDS ***
Dealt to Manon947 [7h 3c]
color_singleton: raises 100 to 200
Duke Croix: folds 
Klemtonius: folds 
HighCardJasper: calls 150
Manon947: folds 
*** FLOP *** [Qd 6c 4d]
HighCardJasper: checks 
color_singleton: checks 
*** TURN *** [Qd 6c 4d] [Kc]
HighCardJasper: checks 
color_singleton: bets 236
HighCardJasper: calls 236
*** RIVER *** [Qd 6c 4d Kc] [Qs]
HighCardJasper: checks 
color_singleton: checks 
*** SHOW DOWN ***
HighCardJasper: shows [5s 2s] (a pair of Queens)
color_singleton: shows [Ks 9c] (two pair, Kings and Queens)
color_singleton collected 919 from pot
*** SUMMARY ***
Total pot 972 | Rake 53 
Board [Qd 6c 4d Kc Qs]
Seat 1: color_singleton showed [Ks 9c] and won (919) with two pair, Kings and Queens
Seat 3: Duke Croix folded before Flop (didn't bet)
Seat 6: Klemtonius (button) folded before Flop (didn't bet)
Seat 8: HighCardJasper (small blind) showed [5s 2s] and lost with a pair of Queens
Seat 9: Manon947 (big blind) folded before Flop



PokerStars Home Game Hand #216494761415: {Club #3225207}  Hold'em No Limit (50/100) - 2020/07/16 19:05:31 ET
Table 'Fun times' 9-max (Play Money) Seat #8 is the button
Seat 1: color_singleton (15581 in chips) 
Seat 3: Duke Croix (13792 in chips) 
Seat 6: Klemtonius (18269 in chips) 
Seat 8: HighCardJasper (6158 in chips) 
Seat 9: Manon947 (8093 in chips) 
Manon947: posts small blind 50
color_singleton: posts big blind 100
*** HOLE CARDS ***
Dealt to Manon947 [8d 9d]
Duke Croix: raises 300 to 400
Klemtonius: calls 400
HighCardJasper: folds 
Manon947: calls 350
color_singleton: folds 
*** FLOP *** [Jd 5d 2h]
Manon947: checks 
Duke Croix: checks 
Klemtonius: checks 
*** TURN *** [Jd 5d 2h] [Kd]
Manon947: bets 614
Duke Croix: calls 614
Klemtonius: folds 
*** RIVER *** [Jd 5d 2h Kd] [Qh]
Manon947: bets 1194
Duke Croix: folds 
Uncalled bet (1194) returned to Manon947
Manon947 collected 2389 from pot
*** SUMMARY ***
Total pot 2528 | Rake 139 
Board [Jd 5d 2h Kd Qh]
Seat 1: color_singleton (big blind) folded before Flop
Seat 3: Duke Croix folded on the River
Seat 6: Klemtonius folded on the Turn
Seat 8: HighCardJasper (button) folded before Flop (didn't bet)
Seat 9: Manon947 (small blind) collected (2389)



PokerStars Home Game Hand #216494780018: {Club #3225207}  Hold'em No Limit (50/100) - 2020/07/16 19:06:12 ET
Table 'Fun times' 9-max (Play Money) Seat #9 is the button
Seat 1: color_singleton (15481 in chips) 
Seat 3: Duke Croix (12778 in chips) 
Seat 6: Klemtonius (17869 in chips) 
Seat 8: HighCardJasper (6158 in chips) 
Seat 9: Manon947 (9468 in chips) 
color_singleton: posts small blind 50
Duke Croix: posts big blind 100
*** HOLE CARDS ***
Dealt to Manon947 [Jh 9d]
Klemtonius: calls 100
HighCardJasper: calls 100
Manon947: calls 100
color_singleton: calls 50
Duke Croix: checks 
*** FLOP *** [Td 7c 4d]
color_singleton: bets 236
Duke Croix: folds 
Klemtonius: calls 236
HighCardJasper: folds 
Manon947: folds 
*** TURN *** [Td 7c 4d] [7h]
color_singleton: bets 459
Klemtonius: calls 459
*** RIVER *** [Td 7c 4d 7h] [Js]
color_singleton: checks 
Klemtonius: checks 
*** SHOW DOWN ***
color_singleton: shows [3s Ts] (two pair, Tens and Sevens)
Klemtonius: shows [9h Tc] (two pair, Tens and Sevens)
color_singleton collected 893 from pot
Klemtonius collected 893 from pot
*** SUMMARY ***
Total pot 1890 | Rake 104 
Board [Td 7c 4d 7h Js]
Seat 1: color_singleton (small blind) showed [3s Ts] and won (893) with two pair, Tens and Sevens
Seat 3: Duke Croix (big blind) folded on the Flop
Seat 6: Klemtonius showed [9h Tc] and won (893) with two pair, Tens and Sevens
Seat 8: HighCardJasper folded on the Flop
Seat 9: Manon947 (button) folded on the Flop



PokerStars Home Game Hand #216494798776: {Club #3225207}  Hold'em No Limit (50/100) - 2020/07/16 19:06:53 ET
Table 'Fun times' 9-max (Play Money) Seat #1 is the button
Seat 1: color_singleton (15579 in chips) 
Seat 3: Duke Croix (12678 in chips) 
Seat 6: Klemtonius (17967 in chips) 
Seat 8: HighCardJasper (6058 in chips) 
Seat 9: Manon947 (9368 in chips) 
Duke Croix: posts small blind 50
Klemtonius: posts big blind 100
*** HOLE CARDS ***
Dealt to Manon947 [Qs 4c]
HighCardJasper: calls 100
Manon947: calls 100
color_singleton: folds 
Duke Croix: calls 50
Klemtonius: checks 
*** FLOP *** [As Ad Qh]
Duke Croix: checks 
Klemtonius: bets 100
HighCardJasper: folds 
Manon947: raises 100 to 200
Duke Croix: folds 
Klemtonius: calls 100
*** TURN *** [As Ad Qh] [6d]
Klemtonius: checks 
Manon947: bets 378
Klemtonius: calls 378
*** RIVER *** [As Ad Qh 6d] [6s]
Klemtonius: checks 
Manon947: bets 735
Klemtonius: folds 
Uncalled bet (735) returned to Manon947
Manon947 collected 1470 from pot
*** SUMMARY ***
Total pot 1556 | Rake 86 
Board [As Ad Qh 6d 6s]
Seat 1: color_singleton (button) folded before Flop (didn't bet)
Seat 3: Duke Croix (small blind) folded on the Flop
Seat 6: Klemtonius (big blind) folded on the River
Seat 8: HighCardJasper folded on the Flop
Seat 9: Manon947 collected (1470)



PokerStars Home Game Hand #216494817927: {Club #3225207}  Hold'em No Limit (50/100) - 2020/07/16 19:07:35 ET
Table 'Fun times' 9-max (Play Money) Seat #3 is the button
Seat 1: color_singleton (15579 in chips) 
Seat 3: Duke Croix (12578 in chips) 
Seat 6: Klemtonius (17289 in chips) 
Seat 8: HighCardJasper (5958 in chips) 
Seat 9: Manon947 (10160 in chips) 
Klemtonius: posts small blind 50
HighCardJasper: posts big blind 100
*** HOLE CARDS ***
Dealt to Manon947 [Ad Tc]
Manon947: calls 100
color_singleton: raises 100 to 200
Duke Croix: folds 
Klemtonius: raises 100 to 300
HighCardJasper: folds 
Manon947: calls 200
color_singleton: calls 100
*** FLOP *** [Qh 8d 4s]
Klemtonius: checks 
Manon947: checks 
color_singleton: checks 
*** TURN *** [Qh 8d 4s] [8s]
Klemtonius: bets 472
Manon947: folds 
color_singleton: folds 
Uncalled bet (472) returned to Klemtonius
Klemtonius collected 945 from pot
Klemtonius: doesn't show hand 
*** SUMMARY ***
Total pot 1000 | Rake 55 
Board [Qh 8d 4s 8s]
Seat 1: color_singleton folded on the Turn
Seat 3: Duke Croix (button) folded before Flop (didn't bet)
Seat 6: Klemtonius (small blind) collected (945)
Seat 8: HighCardJasper (big blind) folded before Flop
Seat 9: Manon947 folded on the Turn



PokerStars Home Game Hand #216494835603: {Club #3225207}  Hold'em No Limit (50/100) - 2020/07/16 19:08:15 ET
Table 'Fun times' 9-max (Play Money) Seat #6 is the button
Seat 1: color_singleton (15279 in chips) 
Seat 3: Duke Croix (12578 in chips) 
Seat 6: Klemtonius (17934 in chips) 
Seat 8: HighCardJasper (5858 in chips) 
Seat 9: Manon947 (9860 in chips) 
HighCardJasper: posts small blind 50
Manon947: posts big blind 100
*** HOLE CARDS ***
Dealt to Manon947 [4d 2h]
color_singleton: folds 
Duke Croix: folds 
Klemtonius: raises 100 to 200
HighCardJasper: calls 150
Manon947: folds 
*** FLOP *** [Td Qh 9d]
HighCardJasper: checks 
Klemtonius: bets 100
HighCardJasper: calls 100
*** TURN *** [Td Qh 9d] [7h]
HighCardJasper: checks 
Klemtonius: bets 100
HighCardJasper: calls 100
*** RIVER *** [Td Qh 9d 7h] [8d]
HighCardJasper: checks 
Klemtonius: bets 850
HighCardJasper: folds 
Uncalled bet (850) returned to Klemtonius
Klemtonius collected 850 from pot
Klemtonius: doesn't show hand 
*** SUMMARY ***
Total pot 900 | Rake 50 
Board [Td Qh 9d 7h 8d]
Seat 1: color_singleton folded before Flop (didn't bet)
Seat 3: Duke Croix folded before Flop (didn't bet)
Seat 6: Klemtonius (button) collected (850)
Seat 8: HighCardJasper (small blind) folded on the River
Seat 9: Manon947 (big blind) folded before Flop



PokerStars Home Game Hand #216494852900: {Club #3225207}  Hold'em No Limit (50/100) - 2020/07/16 19:08:53 ET
Table 'Fun times' 9-max (Play Money) Seat #8 is the button
Seat 1: color_singleton (15279 in chips) 
Seat 3: Duke Croix (12578 in chips) 
Seat 6: Klemtonius (18384 in chips) 
Seat 8: HighCardJasper (5458 in chips) 
Seat 9: Manon947 (9760 in chips) 
Manon947: posts small blind 50
color_singleton: posts big blind 100
*** HOLE CARDS ***
Dealt to Manon947 [8c 3d]
Duke Croix: raises 300 to 400
Klemtonius: folds 
HighCardJasper: folds 
Manon947: folds 
color_singleton: calls 300
*** FLOP *** [6c Qd Ts]
color_singleton: checks 
Duke Croix: bets 400
color_singleton: folds 
Uncalled bet (400) returned to Duke Croix
Duke Croix collected 803 from pot
Duke Croix: doesn't show hand 
*** SUMMARY ***
Total pot 850 | Rake 47 
Board [6c Qd Ts]
Seat 1: color_singleton (big blind) folded on the Flop
Seat 3: Duke Croix collected (803)
Seat 6: Klemtonius folded before Flop (didn't bet)
Seat 8: HighCardJasper (button) folded before Flop (didn't bet)
Seat 9: Manon947 (small blind) folded before Flop



PokerStars Home Game Hand #216494862866: {Club #3225207}  Hold'em No Limit (50/100) - 2020/07/16 19:09:16 ET
Table 'Fun times' 9-max (Play Money) Seat #9 is the button
Seat 1: color_singleton (14879 in chips) 
Seat 3: Duke Croix (12981 in chips) 
Seat 6: Klemtonius (18384 in chips) 
Seat 8: HighCardJasper (5458 in chips) 
Seat 9: Manon947 (9710 in chips) 
color_singleton: posts small blind 50
Duke Croix: posts big blind 100
*** HOLE CARDS ***
Dealt to Manon947 [8d 3d]
Klemtonius: calls 100
HighCardJasper: raises 100 to 200
Manon947: calls 200
color_singleton: folds 
Duke Croix: calls 100
Klemtonius: calls 100
*** FLOP *** [7d 2s 6d]
Duke Croix: checks 
Klemtonius: checks 
HighCardJasper: checks 
Manon947: checks 
*** TURN *** [7d 2s 6d] [7s]
Duke Croix: checks 
Klemtonius: checks 
HighCardJasper: checks 
Manon947: checks 
*** RIVER *** [7d 2s 6d 7s] [Qc]
Duke Croix: checks 
Klemtonius: checks 
HighCardJasper: bets 500
Manon947: folds 
Duke Croix: folds 
Klemtonius: folds 
Uncalled bet (500) returned to HighCardJasper
HighCardJasper collected 803 from pot
HighCardJasper: doesn't show hand 
*** SUMMARY ***
Total pot 850 | Rake 47 
Board [7d 2s 6d 7s Qc]
Seat 1: color_singleton (small blind) folded before Flop
Seat 3: Duke Croix (big blind) folded on the River
Seat 6: Klemtonius folded on the River
Seat 8: HighCardJasper collected (803)
Seat 9: Manon947 (button) folded on the River



PokerStars Home Game Hand #216494890197: {Club #3225207}  Hold'em No Limit (50/100) - 2020/07/16 19:10:02 ET
Table 'Fun times' 9-max (Play Money) Seat #1 is the button
Seat 1: color_singleton (14829 in chips) 
Seat 3: Duke Croix (12781 in chips) 
Seat 6: Klemtonius (18184 in chips) 
Seat 8: HighCardJasper (6061 in chips) 
Seat 9: Manon947 (9510 in chips) 
Duke Croix: posts small blind 50
Klemtonius: posts big blind 100
*** HOLE CARDS ***
Dealt to Manon947 [Qh Kc]
HighCardJasper: calls 100
Manon947: calls 100
color_singleton: calls 100
Duke Croix: calls 50
Klemtonius: checks 
*** FLOP *** [As Jh 9d]
Duke Croix: checks 
Klemtonius: checks 
HighCardJasper: checks 
Manon947: checks 
color_singleton: checks 
*** TURN *** [As Jh 9d] [2s]
Duke Croix: bets 300
Klemtonius: folds 
HighCardJasper: folds 
Manon947: calls 300
color_singleton: folds 
*** RIVER *** [As Jh 9d 2s] [Th]
Duke Croix: bets 700
Manon947: raises 700 to 1400
Duke Croix: folds 
Uncalled bet (700) returned to Manon947
Manon947 collected 2362 from pot
*** SUMMARY ***
Total pot 2500 | Rake 138 
Board [As Jh 9d 2s Th]
Seat 1: color_singleton (button) folded on the Turn
Seat 3: Duke Croix (small blind) folded on the River
Seat 6: Klemtonius (big blind) folded on the Turn
Seat 8: HighCardJasper folded on the Turn
Seat 9: Manon947 collected (2362)



PokerStars Home Game Hand #216494916961: {Club #3225207}  Hold'em No Limit (50/100) - 2020/07/16 19:11:02 ET
Table 'Fun times' 9-max (Play Money) Seat #3 is the button
Seat 1: color_singleton (14729 in chips) 
Seat 3: Duke Croix (11681 in chips) 
Seat 6: Klemtonius (18084 in chips) 
Seat 8: HighCardJasper (5961 in chips) 
Seat 9: Manon947 (10772 in chips) 
Klemtonius: posts small blind 50
HighCardJasper: posts big blind 100
*** HOLE CARDS ***
Dealt to Manon947 [5c 6h]
Manon947: calls 100
color_singleton: folds 
Duke Croix: calls 100
Klemtonius: calls 50
HighCardJasper: raises 200 to 300
Manon947: folds 
Duke Croix: calls 200
Klemtonius: calls 200
*** FLOP *** [8s 3c 6c]
Klemtonius: checks 
HighCardJasper: checks 
Duke Croix: bets 472
Klemtonius: folds 
HighCardJasper: folds 
Uncalled bet (472) returned to Duke Croix
Duke Croix collected 945 from pot
Duke Croix: doesn't show hand 
*** SUMMARY ***
Total pot 1000 | Rake 55 
Board [8s 3c 6c]
Seat 1: color_singleton folded before Flop (didn't bet)
Seat 3: Duke Croix (button) collected (945)
Seat 6: Klemtonius (small blind) folded on the Flop
Seat 8: HighCardJasper (big blind) folded on the Flop
Seat 9: Manon947 folded before Flop



PokerStars Home Game Hand #216494930656: {Club #3225207}  Hold'em No Limit (50/100) - 2020/07/16 19:11:33 ET
Table 'Fun times' 9-max (Play Money) Seat #6 is the button
Seat 1: color_singleton (14729 in chips) 
Seat 3: Duke Croix (12326 in chips) 
Seat 6: Klemtonius (17784 in chips) 
Seat 8: HighCardJasper (5661 in chips) 
Seat 9: Manon947 (10672 in chips) 
HighCardJasper: posts small blind 50
Manon947: posts big blind 100
*** HOLE CARDS ***
Dealt to Manon947 [7h Tc]
color_singleton: calls 100
Duke Croix: folds 
Klemtonius: calls 100
HighCardJasper: calls 50
Manon947: checks 
*** FLOP *** [Jh 7d 2c]
HighCardJasper: checks 
Manon947: checks 
color_singleton: bets 189
Klemtonius: folds 
HighCardJasper: folds 
Manon947: folds 
Uncalled bet (189) returned to color_singleton
color_singleton collected 378 from pot
color_singleton: doesn't show hand 
*** SUMMARY ***
Total pot 400 | Rake 22 
Board [Jh 7d 2c]
Seat 1: color_singleton collected (378)
Seat 3: Duke Croix folded before Flop (didn't bet)
Seat 6: Klemtonius (button) folded on the Flop
Seat 8: HighCardJasper (small blind) folded on the Flop
Seat 9: Manon947 (big blind) folded on the Flop



PokerStars Home Game Hand #216494946128: {Club #3225207}  Hold'em No Limit (50/100) - 2020/07/16 19:12:07 ET
Table 'Fun times' 9-max (Play Money) Seat #8 is the button
Seat 1: color_singleton (15007 in chips) 
Seat 3: Duke Croix (12326 in chips) 
Seat 6: Klemtonius (17684 in chips) 
Seat 8: HighCardJasper (5561 in chips) 
Seat 9: Manon947 (10572 in chips) 
Manon947: posts small blind 50
color_singleton: posts big blind 100
*** HOLE CARDS ***
Dealt to Manon947 [8s 5s]
Duke Croix: raises 300 to 400
Klemtonius: calls 400
HighCardJasper: folds 
Manon947: calls 350
color_singleton: folds 
*** FLOP *** [Ac 5d Ah]
Manon947: checks 
Duke Croix: checks 
Klemtonius: checks 
*** TURN *** [Ac 5d Ah] [6d]
Manon947: checks 
Duke Croix: bets 700
Klemtonius: folds 
Manon947: folds 
Uncalled bet (700) returned to Duke Croix
Duke Croix collected 1228 from pot
Duke Croix: doesn't show hand 
*** SUMMARY ***
Total pot 1300 | Rake 72 
Board [Ac 5d Ah 6d]
Seat 1: color_singleton (big blind) folded before Flop
Seat 3: Duke Croix collected (1228)
Seat 6: Klemtonius folded on the Turn
Seat 8: HighCardJasper (button) folded before Flop (didn't bet)
Seat 9: Manon947 (small blind) folded on the Turn



PokerStars Home Game Hand #216494967978: {Club #3225207}  Hold'em No Limit (50/100) - 2020/07/16 19:12:57 ET
Table 'Fun times' 9-max (Play Money) Seat #9 is the button
Seat 1: color_singleton (14907 in chips) 
Seat 3: Duke Croix (13154 in chips) 
Seat 6: Klemtonius (17284 in chips) 
Seat 8: HighCardJasper (5561 in chips) 
Seat 9: Manon947 (10172 in chips) 
color_singleton: posts small blind 50
Duke Croix: posts big blind 100
*** HOLE CARDS ***
Dealt to Manon947 [3c Kc]
Klemtonius: calls 100
HighCardJasper: calls 100
Manon947: calls 100
color_singleton: raises 200 to 300
Duke Croix: folds 
Klemtonius: calls 200
HighCardJasper: calls 200
Manon947: calls 200
*** FLOP *** [7s 6h 8h]
color_singleton: checks 
Klemtonius: checks 
HighCardJasper: checks 
Manon947: checks 
*** TURN *** [7s 6h 8h] [9d]
color_singleton: checks 
Klemtonius: checks 
HighCardJasper: bets 200
Manon947: folds 
color_singleton: calls 200
Klemtonius: folds 
*** RIVER *** [7s 6h 8h 9d] [As]
color_singleton: checks 
HighCardJasper: bets 1000
color_singleton: folds 
Uncalled bet (1000) returned to HighCardJasper
HighCardJasper collected 1606 from pot
HighCardJasper: doesn't show hand 
*** SUMMARY ***
Total pot 1700 | Rake 94 
Board [7s 6h 8h 9d As]
Seat 1: color_singleton (small blind) folded on the River
Seat 3: Duke Croix (big blind) folded before Flop
Seat 6: Klemtonius folded on the Turn
Seat 8: HighCardJasper collected (1606)
Seat 9: Manon947 (button) folded on the Turn



PokerStars Home Game Hand #216494993722: {Club #3225207}  Hold'em No Limit (50/100) - 2020/07/16 19:13:54 ET
Table 'Fun times' 9-max (Play Money) Seat #1 is the button
Seat 1: color_singleton (14407 in chips) 
Seat 3: Duke Croix (13054 in chips) 
Seat 6: Klemtonius (16984 in chips) 
Seat 8: HighCardJasper (6667 in chips) 
Seat 9: Manon947 (9872 in chips) 
Duke Croix: posts small blind 50
Klemtonius: posts big blind 100
*** HOLE CARDS ***
Dealt to Manon947 [9h Kh]
HighCardJasper has timed out
HighCardJasper: folds 
Manon947: calls 100
color_singleton: folds 
Duke Croix: folds 
Klemtonius: checks 
*** FLOP *** [2c Ac 2s]
Klemtonius: checks 
Manon947: checks 
*** TURN *** [2c Ac 2s] [8d]
Klemtonius: bets 100
Manon947: calls 100
*** RIVER *** [2c Ac 2s 8d] [Jd]
Klemtonius: checks 
Manon947: checks 
*** SHOW DOWN ***
Klemtonius: shows [9d 8h] (two pair, Eights and Deuces)
Manon947: mucks hand 
Klemtonius collected 425 from pot
*** SUMMARY ***
Total pot 450 | Rake 25 
Board [2c Ac 2s 8d Jd]
Seat 1: color_singleton (button) folded before Flop (didn't bet)
Seat 3: Duke Croix (small blind) folded before Flop
Seat 6: Klemtonius (big blind) showed [9d 8h] and won (425) with two pair, Eights and Deuces
Seat 8: HighCardJasper folded before Flop (didn't bet)
Seat 9: Manon947 mucked [9h Kh]



PokerStars Home Game Hand #216495010710: {Club #3225207}  Hold'em No Limit (50/100) - 2020/07/16 19:14:33 ET
Table 'Fun times' 9-max (Play Money) Seat #3 is the button
Seat 1: color_singleton (14407 in chips) 
Seat 3: Duke Croix (13004 in chips) 
Seat 6: Klemtonius (17209 in chips) 
Seat 9: Manon947 (9672 in chips) 
Klemtonius: posts small blind 50
Manon947: posts big blind 100
*** HOLE CARDS ***
Dealt to Manon947 [5h Ad]
HighCardJasper leaves the table
color_singleton: raises 100 to 200
Duke Croix: folds 
Klemtonius: calls 150
Manon947: calls 100
*** FLOP *** [3h Ts 9c]
Klemtonius: checks 
Manon947: checks 
color_singleton: checks 
*** TURN *** [3h Ts 9c] [3d]
Klemtonius: bets 283
Manon947: folds 
color_singleton: folds 
Uncalled bet (283) returned to Klemtonius
Klemtonius collected 567 from pot
Klemtonius: doesn't show hand 
*** SUMMARY ***
Total pot 600 | Rake 33 
Board [3h Ts 9c 3d]
Seat 1: color_singleton folded on the Turn
Seat 3: Duke Croix (button) folded before Flop (didn't bet)
Seat 6: Klemtonius (small blind) collected (567)
Seat 9: Manon947 (big blind) folded on the Turn



PokerStars Home Game Hand #216495021914: {Club #3225207}  Hold'em No Limit (50/100) - 2020/07/16 19:14:58 ET
Table 'Fun times' 9-max (Play Money) Seat #6 is the button
Seat 1: color_singleton (14207 in chips) 
Seat 3: Duke Croix (13004 in chips) 
Seat 6: Klemtonius (17576 in chips) 
Seat 9: Manon947 (9472 in chips) 
Manon947: posts small blind 50
color_singleton: posts big blind 100
*** HOLE CARDS ***
Dealt to Manon947 [Kc As]
Duke Croix: calls 100
Klemtonius: calls 100
Manon947: calls 50
color_singleton: checks 
*** FLOP *** [2d Qc 6d]
Manon947: checks 
color_singleton: checks 
Duke Croix: checks 
Klemtonius: checks 
*** TURN *** [2d Qc 6d] [Ac]
Manon947: bets 189
color_singleton: folds 
Duke Croix: folds 
Klemtonius: folds 
Uncalled bet (189) returned to Manon947
Manon947 collected 378 from pot
*** SUMMARY ***
Total pot 400 | Rake 22 
Board [2d Qc 6d Ac]
Seat 1: color_singleton (big blind) folded on the Turn
Seat 3: Duke Croix folded on the Turn
Seat 6: Klemtonius (button) folded on the Turn
Seat 9: Manon947 (small blind) collected (378)



PokerStars Home Game Hand #216495042393: {Club #3225207}  Hold'em No Limit (50/100) - 2020/07/16 19:15:44 ET
Table 'Fun times' 9-max (Play Money) Seat #9 is the button
Seat 1: color_singleton (14107 in chips) 
Seat 3: Duke Croix (12904 in chips) 
Seat 6: Klemtonius (17476 in chips) 
Seat 9: Manon947 (9750 in chips) 
color_singleton: posts small blind 50
Duke Croix: posts big blind 100
*** HOLE CARDS ***
Dealt to Manon947 [7c Ac]
Klemtonius: calls 100
Manon947: raises 100 to 200
color_singleton: calls 150
Duke Croix: folds 
Klemtonius: calls 100
*** FLOP *** [2c Kh 3s]
color_singleton: checks 
Klemtonius: checks 
Manon947: checks 
*** TURN *** [2c Kh 3s] [9h]
color_singleton: checks 
Klemtonius: checks 
Manon947: bets 661
color_singleton: folds 
Klemtonius: folds 
Uncalled bet (661) returned to Manon947
Manon947 collected 661 from pot
*** SUMMARY ***
Total pot 700 | Rake 39 
Board [2c Kh 3s 9h]
Seat 1: color_singleton (small blind) folded on the Turn
Seat 3: Duke Croix (big blind) folded before Flop
Seat 6: Klemtonius folded on the Turn
Seat 9: Manon947 (button) collected (661)



PokerStars Home Game Hand #216495059572: {Club #3225207}  Hold'em No Limit (50/100) - 2020/07/16 19:16:24 ET
Table 'Fun times' 9-max (Play Money) Seat #1 is the button
Seat 1: color_singleton (13907 in chips) 
Seat 3: Duke Croix (12804 in chips) 
Seat 6: Klemtonius (17276 in chips) 
Seat 9: Manon947 (10211 in chips) 
Duke Croix: posts small blind 50
Klemtonius: posts big blind 100
*** HOLE CARDS ***
Dealt to Manon947 [4d 6h]
Manon947: calls 100
color_singleton: folds 
Duke Croix: raises 300 to 400
Klemtonius: raises 700 to 1100
Manon947: folds 
Duke Croix: calls 700
*** FLOP *** [Jc 3d 8h]
Duke Croix: checks 
Klemtonius: bets 2173
Duke Croix: calls 2173
*** TURN *** [Jc 3d 8h] [5d]
Duke Croix: checks 
Klemtonius: bets 6280
Duke Croix: raises 3251 to 9531 and is all-in
Klemtonius: calls 3251
*** RIVER *** [Jc 3d 8h 5d] [9h]
*** SHOW DOWN ***
Duke Croix: shows [Jh As] (a pair of Jacks)
Klemtonius: shows [Qs Qh] (a pair of Queens)
Klemtonius collected 24294 from pot
*** SUMMARY ***
Total pot 25708 | Rake 1414 
Board [Jc 3d 8h 5d 9h]
Seat 1: color_singleton (button) folded before Flop (didn't bet)
Seat 3: Duke Croix (small blind) showed [Jh As] and lost with a pair of Jacks
Seat 6: Klemtonius (big blind) showed [Qs Qh] and won (24294) with a pair of Queens
Seat 9: Manon947 folded before Flop



PokerStars Home Game Hand #216495082083: {Club #3225207}  Hold'em No Limit (50/100) - 2020/07/16 19:17:15 ET
Table 'Fun times' 9-max (Play Money) Seat #6 is the button
Seat 1: color_singleton (13907 in chips) 
Seat 6: Klemtonius (28766 in chips) 
Seat 9: Manon947 (10111 in chips) 
Manon947: posts small blind 50
color_singleton: posts big blind 100
*** HOLE CARDS ***
Dealt to Manon947 [As 8s]
Klemtonius: calls 100
Manon947: calls 50
color_singleton: checks 
*** FLOP *** [Ad 6s Ac]
Manon947: bets 141
color_singleton: calls 141
Klemtonius: calls 141
*** TURN *** [Ad 6s Ac] [2h]
Manon947: bets 341
color_singleton: folds 
Klemtonius: calls 341
*** RIVER *** [Ad 6s Ac 2h] [5s]
Manon947: bets 1328
Klemtonius: folds 
Uncalled bet (1328) returned to Manon947
Manon947 collected 1328 from pot
*** SUMMARY ***
Total pot 1405 | Rake 77 
Board [Ad 6s Ac 2h 5s]
Seat 1: color_singleton (big blind) folded on the Turn
Seat 6: Klemtonius (button) folded on the River
Seat 9: Manon947 (small blind) collected (1328)



PokerStars Home Game Hand #216495098508: {Club #3225207}  Hold'em No Limit (50/100) - 2020/07/16 19:17:51 ET
Table 'Fun times' 9-max (Play Money) Seat #9 is the button
Seat 1: color_singleton (13666 in chips) 
Seat 6: Klemtonius (28184 in chips) 
Seat 9: Manon947 (10857 in chips) 
color_singleton: posts small blind 50
Klemtonius: posts big blind 100
*** HOLE CARDS ***
Dealt to Manon947 [7h 5c]
Manon947: folds 
color_singleton: folds 
Uncalled bet (50) returned to Klemtonius
Klemtonius collected 100 from pot
Klemtonius: doesn't show hand 
*** SUMMARY ***
Total pot 100 | Rake 0 
Seat 1: color_singleton (small blind) folded before Flop
Seat 6: Klemtonius (big blind) collected (100)
Seat 9: Manon947 (button) folded before Flop (didn't bet)



PokerStars Home Game Hand #216495101246: {Club #3225207}  Hold'em No Limit (50/100) - 2020/07/16 19:17:58 ET
Table 'Fun times' 9-max (Play Money) Seat #1 is the button
Seat 1: color_singleton (13616 in chips) 
Seat 6: Klemtonius (28234 in chips) 
Seat 9: Manon947 (10857 in chips) 
Klemtonius: posts small blind 50
Manon947: posts big blind 100
*** HOLE CARDS ***
Dealt to Manon947 [4c Td]
color_singleton: raises 100 to 200
Klemtonius: folds 
Manon947: folds 
Uncalled bet (100) returned to color_singleton
color_singleton collected 250 from pot
color_singleton: doesn't show hand 
*** SUMMARY ***
Total pot 250 | Rake 0 
Seat 1: color_singleton (button) collected (250)
Seat 6: Klemtonius (small blind) folded before Flop
Seat 9: Manon947 (big blind) folded before Flop



PokerStars Home Game Hand #216495123982: {Club #3225207}  Hold'em No Limit (50/100) - 2020/07/16 19:18:49 ET
Table 'Fun times' 9-max (Play Money) Seat #1 is the button
Seat 1: color_singleton (12642 in chips) 
Seat 6: Klemtonius (29184 in chips) 
Seat 9: Manon947 (10757 in chips) 
Klemtonius: posts small blind 50
Manon947: posts big blind 100
*** HOLE CARDS ***
Dealt to Manon947 [Kh 5d]
color_singleton: raises 100 to 200
Klemtonius: calls 150
Manon947: calls 100
*** FLOP *** [Qc 6h 8d]
Klemtonius: bets 567
Manon947: folds 
color_singleton: calls 567
*** TURN *** [Qc 6h 8d] [8c]
Klemtonius: bets 819
color_singleton: folds 
Uncalled bet (819) returned to Klemtonius
Klemtonius collected 1639 from pot
Klemtonius: doesn't show hand 
*** SUMMARY ***
Total pot 1734 | Rake 95 
Board [Qc 6h 8d 8c]
Seat 1: color_singleton (button) folded on the Turn
Seat 6: Klemtonius (small blind) collected (1639)
Seat 9: Manon947 (big blind) folded on the Flop



