PokerStars Home Game Hand #218536444875: {Club #3225207}  Hold'em No Limit (50/100) - 2020/09/17 14:52:46 ET
Table 'fun time' 9-max (Play Money) Seat #1 is the button
Seat 1: dddocky (10000 in chips) 
Seat 2: Duke Croix (10000 in chips) 
Seat 9: HighCardJasper (10000 in chips) 
color_singleton joins the table at seat #3 
Klemtonius joins the table at seat #5 
Duke Croix: posts small blind 50
HighCardJasper: posts big blind 100
*** HOLE CARDS ***
Dealt to Duke Croix [7s 9c]
dddocky: calls 100
Duke Croix: calls 50
HighCardJasper: checks 
*** FLOP *** [9d 6d Ad]
Duke Croix: checks 
HighCardJasper: bets 100
dddocky: raises 100 to 200
Duke Croix: folds 
HighCardJasper: calls 100
*** TURN *** [9d 6d Ad] [Th]
HighCardJasper: checks 
dddocky: bets 100
HighCardJasper: calls 100
*** RIVER *** [9d 6d Ad Th] [3c]
HighCardJasper: checks 
dddocky: bets 100
HighCardJasper: calls 100
*** SHOW DOWN ***
dddocky: shows [4d Ac] (a pair of Aces)
HighCardJasper: mucks hand 
dddocky collected 1039 from pot
*** SUMMARY ***
Total pot 1100 | Rake 61 
Board [9d 6d Ad Th 3c]
Seat 1: dddocky (button) showed [4d Ac] and won (1039) with a pair of Aces
Seat 2: Duke Croix (small blind) folded on the Flop
Seat 9: HighCardJasper (big blind) mucked [2c Kd]



PokerStars Home Game Hand #218536470354: {Club #3225207}  Hold'em No Limit (50/100) - 2020/09/17 14:53:29 ET
Table 'fun time' 9-max (Play Money) Seat #2 is the button
Seat 1: dddocky (10539 in chips) 
Seat 2: Duke Croix (9900 in chips) 
Seat 9: HighCardJasper (9500 in chips) 
HighCardJasper: posts small blind 50
dddocky: posts big blind 100
*** HOLE CARDS ***
Dealt to Duke Croix [Qs 6s]
Duke Croix: folds 
HighCardJasper: calls 50
dddocky: checks 
*** FLOP *** [Ts 3s Jd]
HighCardJasper: checks 
dddocky: checks 
*** TURN *** [Ts 3s Jd] [2c]
HighCardJasper: bets 100
dddocky: folds 
Uncalled bet (100) returned to HighCardJasper
HighCardJasper collected 189 from pot
HighCardJasper: doesn't show hand 
*** SUMMARY ***
Total pot 200 | Rake 11 
Board [Ts 3s Jd 2c]
Seat 1: dddocky (big blind) folded on the Turn
Seat 2: Duke Croix (button) folded before Flop (didn't bet)
Seat 9: HighCardJasper (small blind) collected (189)



PokerStars Home Game Hand #218536480933: {Club #3225207}  Hold'em No Limit (50/100) - 2020/09/17 14:53:47 ET
Table 'fun time' 9-max (Play Money) Seat #9 is the button
Seat 1: dddocky (10439 in chips) 
Seat 2: Duke Croix (9900 in chips) 
Seat 3: color_singleton (10000 in chips) 
Seat 5: Klemtonius (10000 in chips) 
Seat 9: HighCardJasper (9589 in chips) 
dddocky: posts small blind 50
Duke Croix: posts big blind 100
color_singleton: posts big blind 100
Klemtonius: posts big blind 100
*** HOLE CARDS ***
Dealt to Duke Croix [6h 9c]
color_singleton: checks 
Klemtonius: checks 
HighCardJasper: raises 100 to 200
dddocky: calls 150
Duke Croix: calls 100
color_singleton: calls 100
Klemtonius: calls 100
*** FLOP *** [Kh 3s 7d]
dddocky: checks 
Duke Croix: checks 
color_singleton: checks 
Klemtonius: bets 472
HighCardJasper: folds 
dddocky: folds 
Duke Croix: folds 
color_singleton: folds 
Uncalled bet (472) returned to Klemtonius
Klemtonius collected 945 from pot
Klemtonius: doesn't show hand 
*** SUMMARY ***
Total pot 1000 | Rake 55 
Board [Kh 3s 7d]
Seat 1: dddocky (small blind) folded on the Flop
Seat 2: Duke Croix (big blind) folded on the Flop
Seat 3: color_singleton folded on the Flop
Seat 5: Klemtonius collected (945)
Seat 9: HighCardJasper (button) folded on the Flop



PokerStars Home Game Hand #218536505619: {Club #3225207}  Hold'em No Limit (50/100) - 2020/09/17 14:54:28 ET
Table 'fun time' 9-max (Play Money) Seat #1 is the button
Seat 1: dddocky (10239 in chips) 
Seat 2: Duke Croix (9700 in chips) 
Seat 3: color_singleton (9800 in chips) 
Seat 5: Klemtonius (10745 in chips) 
Seat 9: HighCardJasper (9389 in chips) 
Duke Croix: posts small blind 50
color_singleton: posts big blind 100
*** HOLE CARDS ***
Dealt to Duke Croix [2s 7c]
Klemtonius: raises 100 to 200
HighCardJasper: folds 
dddocky: calls 200
Duke Croix: folds 
color_singleton: calls 100
*** FLOP *** [Ts 5h Td]
color_singleton: checks 
Klemtonius: checks 
dddocky: checks 
*** TURN *** [Ts 5h Td] [3s]
color_singleton: checks 
Klemtonius: checks 
dddocky: checks 
*** RIVER *** [Ts 5h Td 3s] [5s]
color_singleton: checks 
Klemtonius: checks 
dddocky: checks 
*** SHOW DOWN ***
color_singleton: shows [Jd 8h] (two pair, Tens and Fives)
Klemtonius: shows [9c Ac] (two pair, Tens and Fives - Ace kicker)
dddocky: mucks hand 
Klemtonius collected 614 from pot
*** SUMMARY ***
Total pot 650 | Rake 36 
Board [Ts 5h Td 3s 5s]
Seat 1: dddocky (button) mucked [Kh 2h]
Seat 2: Duke Croix (small blind) folded before Flop
Seat 3: color_singleton (big blind) showed [Jd 8h] and lost with two pair, Tens and Fives
Seat 5: Klemtonius showed [9c Ac] and won (614) with two pair, Tens and Fives
Seat 9: HighCardJasper folded before Flop (didn't bet)



PokerStars Home Game Hand #218536523116: {Club #3225207}  Hold'em No Limit (50/100) - 2020/09/17 14:54:58 ET
Table 'fun time' 9-max (Play Money) Seat #2 is the button
Seat 1: dddocky (10039 in chips) 
Seat 2: Duke Croix (9650 in chips) 
Seat 3: color_singleton (9600 in chips) 
Seat 5: Klemtonius (11159 in chips) 
Seat 9: HighCardJasper (9389 in chips) 
color_singleton: posts small blind 50
Klemtonius: posts big blind 100
*** HOLE CARDS ***
Dealt to Duke Croix [9s 7s]
HighCardJasper: calls 100
dddocky: calls 100
Duke Croix: calls 100
color_singleton: calls 50
Klemtonius: raises 100 to 200
HighCardJasper: calls 100
dddocky: calls 100
Duke Croix: calls 100
color_singleton: calls 100
*** FLOP *** [2c 8c 3d]
color_singleton: checks 
Klemtonius: bets 945
HighCardJasper: folds 
dddocky: folds 
Duke Croix: folds 
color_singleton: folds 
Uncalled bet (945) returned to Klemtonius
Klemtonius collected 945 from pot
Klemtonius: doesn't show hand 
*** SUMMARY ***
Total pot 1000 | Rake 55 
Board [2c 8c 3d]
Seat 1: dddocky folded on the Flop
Seat 2: Duke Croix (button) folded on the Flop
Seat 3: color_singleton (small blind) folded on the Flop
Seat 5: Klemtonius (big blind) collected (945)
Seat 9: HighCardJasper folded on the Flop



PokerStars Home Game Hand #218536545619: {Club #3225207}  Hold'em No Limit (50/100) - 2020/09/17 14:55:50 ET
Table 'fun time' 9-max (Play Money) Seat #3 is the button
Seat 1: dddocky (9839 in chips) 
Seat 2: Duke Croix (9450 in chips) 
Seat 3: color_singleton (9400 in chips) 
Seat 5: Klemtonius (11904 in chips) 
Seat 9: HighCardJasper (9189 in chips) 
Klemtonius: posts small blind 50
HighCardJasper: posts big blind 100
*** HOLE CARDS ***
Dealt to Duke Croix [Ad 5s]
dddocky: folds 
Duke Croix: raises 200 to 300
color_singleton: folds 
Klemtonius: folds 
HighCardJasper: calls 200
*** FLOP *** [5h Qh Jh]
HighCardJasper: checks 
Duke Croix: checks 
*** TURN *** [5h Qh Jh] [2s]
HighCardJasper: bets 300
Duke Croix: folds 
Uncalled bet (300) returned to HighCardJasper
HighCardJasper collected 614 from pot
HighCardJasper: doesn't show hand 
*** SUMMARY ***
Total pot 650 | Rake 36 
Board [5h Qh Jh 2s]
Seat 1: dddocky folded before Flop (didn't bet)
Seat 2: Duke Croix folded on the Turn
Seat 3: color_singleton (button) folded before Flop (didn't bet)
Seat 5: Klemtonius (small blind) folded before Flop
Seat 9: HighCardJasper (big blind) collected (614)



PokerStars Home Game Hand #218536562416: {Club #3225207}  Hold'em No Limit (50/100) - 2020/09/17 14:56:29 ET
Table 'fun time' 9-max (Play Money) Seat #5 is the button
Seat 1: dddocky (9839 in chips) 
Seat 2: Duke Croix (9150 in chips) 
Seat 3: color_singleton (9400 in chips) 
Seat 5: Klemtonius (11854 in chips) 
Seat 9: HighCardJasper (9503 in chips) 
HighCardJasper: posts small blind 50
dddocky: posts big blind 100
*** HOLE CARDS ***
Dealt to Duke Croix [7d 6c]
Duke Croix: folds 
color_singleton: raises 200 to 300
Klemtonius: folds 
HighCardJasper: calls 250
dddocky: calls 200
*** FLOP *** [Js 4s Jh]
HighCardJasper: checks 
dddocky: checks 
color_singleton: bets 425
HighCardJasper: calls 425
dddocky: folds 
*** TURN *** [Js 4s Jh] [4h]
HighCardJasper: checks 
color_singleton: checks 
*** RIVER *** [Js 4s Jh 4h] [8d]
HighCardJasper: bets 500
color_singleton: calls 500
*** SHOW DOWN ***
HighCardJasper: shows [As Jc] (a full house, Jacks full of Fours)
color_singleton: mucks hand 
HighCardJasper collected 2599 from pot
*** SUMMARY ***
Total pot 2750 | Rake 151 
Board [Js 4s Jh 4h 8d]
Seat 1: dddocky (big blind) folded on the Flop
Seat 2: Duke Croix folded before Flop (didn't bet)
Seat 3: color_singleton mucked [Qs Ad]
Seat 5: Klemtonius (button) folded before Flop (didn't bet)
Seat 9: HighCardJasper (small blind) showed [As Jc] and won (2599) with a full house, Jacks full of Fours



PokerStars Home Game Hand #218536581320: {Club #3225207}  Hold'em No Limit (50/100) - 2020/09/17 14:57:13 ET
Table 'fun time' 9-max (Play Money) Seat #9 is the button
Seat 1: dddocky (9539 in chips) 
Seat 2: Duke Croix (9150 in chips) 
Seat 3: color_singleton (8175 in chips) 
Seat 5: Klemtonius (11854 in chips) 
Seat 9: HighCardJasper (10877 in chips) 
dddocky: posts small blind 50
Duke Croix: posts big blind 100
*** HOLE CARDS ***
Dealt to Duke Croix [8h 5s]
color_singleton: folds 
Klemtonius: calls 100
HighCardJasper: calls 100
dddocky: calls 50
Duke Croix: checks 
*** FLOP *** [8s Qs 6h]
dddocky: checks 
Duke Croix: checks 
Klemtonius: bets 100
HighCardJasper: calls 100
dddocky: calls 100
Duke Croix: folds 
*** TURN *** [8s Qs 6h] [7d]
dddocky: bets 100
Klemtonius: calls 100
HighCardJasper: calls 100
*** RIVER *** [8s Qs 6h 7d] [8d]
dddocky: bets 100
Klemtonius: calls 100
HighCardJasper: folds 
*** SHOW DOWN ***
dddocky: shows [7c Tc] (two pair, Eights and Sevens)
Klemtonius: mucks hand 
dddocky collected 1134 from pot
*** SUMMARY ***
Total pot 1200 | Rake 66 
Board [8s Qs 6h 7d 8d]
Seat 1: dddocky (small blind) showed [7c Tc] and won (1134) with two pair, Eights and Sevens
Seat 2: Duke Croix (big blind) folded on the Flop
Seat 3: color_singleton folded before Flop (didn't bet)
Seat 5: Klemtonius mucked [9c 6c]
Seat 9: HighCardJasper (button) folded on the River



PokerStars Home Game Hand #218536605674: {Club #3225207}  Hold'em No Limit (50/100) - 2020/09/17 14:58:10 ET
Table 'fun time' 9-max (Play Money) Seat #1 is the button
Seat 1: dddocky (10273 in chips) 
Seat 2: Duke Croix (9050 in chips) 
Seat 3: color_singleton (8175 in chips) 
Seat 5: Klemtonius (11454 in chips) 
Seat 9: HighCardJasper (10577 in chips) 
Duke Croix: posts small blind 50
color_singleton: posts big blind 100
*** HOLE CARDS ***
Dealt to Duke Croix [Kd Ac]
Klemtonius: calls 100
HighCardJasper: calls 100
dddocky: calls 100
Duke Croix: raises 300 to 400
color_singleton: folds 
Klemtonius: folds 
HighCardJasper: folds 
dddocky: folds 
Uncalled bet (300) returned to Duke Croix
Duke Croix collected 500 from pot
*** SUMMARY ***
Total pot 500 | Rake 0 
Seat 1: dddocky (button) folded before Flop
Seat 2: Duke Croix (small blind) collected (500)
Seat 3: color_singleton (big blind) folded before Flop
Seat 5: Klemtonius folded before Flop
Seat 9: HighCardJasper folded before Flop



PokerStars Home Game Hand #218536614683: {Club #3225207}  Hold'em No Limit (50/100) - 2020/09/17 14:58:31 ET
Table 'fun time' 9-max (Play Money) Seat #2 is the button
Seat 1: dddocky (10173 in chips) 
Seat 2: Duke Croix (9450 in chips) 
Seat 3: color_singleton (8075 in chips) 
Seat 5: Klemtonius (11354 in chips) 
Seat 9: HighCardJasper (10477 in chips) 
color_singleton: posts small blind 50
Klemtonius: posts big blind 100
*** HOLE CARDS ***
Dealt to Duke Croix [Kc 2d]
HighCardJasper: calls 100
dddocky: calls 100
Duke Croix: folds 
color_singleton: raises 200 to 300
Klemtonius: folds 
HighCardJasper: calls 200
dddocky: folds 
*** FLOP *** [6d 4c Td]
color_singleton: checks 
HighCardJasper: checks 
*** TURN *** [6d 4c Td] [Ah]
color_singleton: checks 
HighCardJasper: checks 
*** RIVER *** [6d 4c Td Ah] [3s]
color_singleton: bets 378
HighCardJasper: folds 
Uncalled bet (378) returned to color_singleton
color_singleton collected 756 from pot
color_singleton: doesn't show hand 
*** SUMMARY ***
Total pot 800 | Rake 44 
Board [6d 4c Td Ah 3s]
Seat 1: dddocky folded before Flop
Seat 2: Duke Croix (button) folded before Flop (didn't bet)
Seat 3: color_singleton (small blind) collected (756)
Seat 5: Klemtonius (big blind) folded before Flop
Seat 9: HighCardJasper folded on the River



PokerStars Home Game Hand #218536628154: {Club #3225207}  Hold'em No Limit (50/100) - 2020/09/17 14:59:02 ET
Table 'fun time' 9-max (Play Money) Seat #3 is the button
Seat 1: dddocky (10073 in chips) 
Seat 2: Duke Croix (9450 in chips) 
Seat 3: color_singleton (8531 in chips) 
Seat 5: Klemtonius (11254 in chips) 
Seat 9: HighCardJasper (10177 in chips) 
Klemtonius: posts small blind 50
HighCardJasper: posts big blind 100
*** HOLE CARDS ***
Dealt to Duke Croix [Qs 2s]
dddocky: calls 100
Duke Croix: folds 
color_singleton: raises 200 to 300
Klemtonius: folds 
HighCardJasper: folds 
dddocky: calls 200
*** FLOP *** [6s 5c 4d]
dddocky: checks 
color_singleton: checks 
*** TURN *** [6s 5c 4d] [8h]
dddocky: checks 
color_singleton: checks 
*** RIVER *** [6s 5c 4d 8h] [Td]
dddocky: bets 100
color_singleton: calls 100
*** SHOW DOWN ***
dddocky: shows [Th Jh] (a pair of Tens)
color_singleton: mucks hand 
dddocky collected 898 from pot
*** SUMMARY ***
Total pot 950 | Rake 52 
Board [6s 5c 4d 8h Td]
Seat 1: dddocky showed [Th Jh] and won (898) with a pair of Tens
Seat 2: Duke Croix folded before Flop (didn't bet)
Seat 3: color_singleton (button) mucked [Qc As]
Seat 5: Klemtonius (small blind) folded before Flop
Seat 9: HighCardJasper (big blind) folded before Flop



PokerStars Home Game Hand #218536643203: {Club #3225207}  Hold'em No Limit (50/100) - 2020/09/17 14:59:34 ET
Table 'fun time' 9-max (Play Money) Seat #5 is the button
Seat 1: dddocky (10571 in chips) 
Seat 2: Duke Croix (9450 in chips) 
Seat 3: color_singleton (8131 in chips) 
Seat 5: Klemtonius (11204 in chips) 
Seat 9: HighCardJasper (10077 in chips) 
HighCardJasper: posts small blind 50
dddocky: posts big blind 100
*** HOLE CARDS ***
Dealt to Duke Croix [3h 9d]
Duke Croix: folds 
color_singleton: folds 
Klemtonius: raises 100 to 200
HighCardJasper: calls 150
dddocky: calls 100
*** FLOP *** [4h 5d 7h]
HighCardJasper: checks 
dddocky: checks 
Klemtonius: bets 250
HighCardJasper: folds 
dddocky: folds 
Uncalled bet (250) returned to Klemtonius
Klemtonius collected 567 from pot
Klemtonius: doesn't show hand 
*** SUMMARY ***
Total pot 600 | Rake 33 
Board [4h 5d 7h]
Seat 1: dddocky (big blind) folded on the Flop
Seat 2: Duke Croix folded before Flop (didn't bet)
Seat 3: color_singleton folded before Flop (didn't bet)
Seat 5: Klemtonius (button) collected (567)
Seat 9: HighCardJasper (small blind) folded on the Flop



PokerStars Home Game Hand #218536654674: {Club #3225207}  Hold'em No Limit (50/100) - 2020/09/17 15:00:00 ET
Table 'fun time' 9-max (Play Money) Seat #9 is the button
Seat 1: dddocky (10371 in chips) 
Seat 2: Duke Croix (9450 in chips) 
Seat 3: color_singleton (8131 in chips) 
Seat 5: Klemtonius (11571 in chips) 
Seat 9: HighCardJasper (9877 in chips) 
dddocky: posts small blind 50
Duke Croix: posts big blind 100
*** HOLE CARDS ***
Dealt to Duke Croix [3s Jh]
color_singleton: raises 100 to 200
Klemtonius: calls 200
HighCardJasper: folds 
dddocky: calls 150
Duke Croix: calls 100
*** FLOP *** [5s Qd 6s]
dddocky: checks 
Duke Croix: checks 
color_singleton: checks 
Klemtonius: checks 
*** TURN *** [5s Qd 6s] [8c]
dddocky: checks 
Duke Croix: checks 
color_singleton: checks 
Klemtonius: checks 
*** RIVER *** [5s Qd 6s 8c] [2d]
dddocky: checks 
Duke Croix: checks 
color_singleton: checks 
Klemtonius: checks 
*** SHOW DOWN ***
dddocky: shows [7s Jc] (high card Queen)
Duke Croix: mucks hand 
color_singleton: shows [Kc Th] (high card King)
Klemtonius: mucks hand 
color_singleton collected 756 from pot
*** SUMMARY ***
Total pot 800 | Rake 44 
Board [5s Qd 6s 8c 2d]
Seat 1: dddocky (small blind) showed [7s Jc] and lost with high card Queen
Seat 2: Duke Croix (big blind) mucked [3s Jh]
Seat 3: color_singleton showed [Kc Th] and won (756) with high card King
Seat 5: Klemtonius mucked [Td 7d]
Seat 9: HighCardJasper (button) folded before Flop (didn't bet)



PokerStars Home Game Hand #218536676856: {Club #3225207}  Hold'em No Limit (50/100) - 2020/09/17 15:00:47 ET
Table 'fun time' 9-max (Play Money) Seat #1 is the button
Seat 1: dddocky (10171 in chips) 
Seat 2: Duke Croix (9250 in chips) 
Seat 3: color_singleton (8687 in chips) 
Seat 5: Klemtonius (11371 in chips) 
Seat 9: HighCardJasper (9877 in chips) 
Duke Croix: posts small blind 50
color_singleton: posts big blind 100
*** HOLE CARDS ***
Dealt to Duke Croix [Kd 6h]
Klemtonius: folds 
HighCardJasper: calls 100
dddocky: calls 100
Duke Croix: calls 50
color_singleton: raises 200 to 300
HighCardJasper: calls 200
dddocky: folds 
Duke Croix has timed out
Duke Croix: folds 
*** FLOP *** [Jh 4d Qd]
color_singleton: checks 
HighCardJasper: checks 
*** TURN *** [Jh 4d Qd] [Ad]
color_singleton: checks 
HighCardJasper: bets 300
color_singleton: calls 300
*** RIVER *** [Jh 4d Qd Ad] [9c]
color_singleton: checks 
HighCardJasper: bets 400
color_singleton: calls 400
*** SHOW DOWN ***
HighCardJasper: shows [Th Ac] (a pair of Aces)
color_singleton: mucks hand 
HighCardJasper collected 2079 from pot
*** SUMMARY ***
Total pot 2200 | Rake 121 
Board [Jh 4d Qd Ad 9c]
Seat 1: dddocky (button) folded before Flop
Seat 2: Duke Croix (small blind) folded before Flop
Seat 3: color_singleton (big blind) mucked [3s As]
Seat 5: Klemtonius folded before Flop (didn't bet)
Seat 9: HighCardJasper showed [Th Ac] and won (2079) with a pair of Aces



PokerStars Home Game Hand #218536710696: {Club #3225207}  Hold'em No Limit (50/100) - 2020/09/17 15:01:50 ET
Table 'fun time' 9-max (Play Money) Seat #2 is the button
Seat 1: dddocky (10071 in chips) 
Seat 2: Duke Croix (9150 in chips) 
Seat 3: color_singleton (7687 in chips) 
Seat 5: Klemtonius (11371 in chips) 
Seat 9: HighCardJasper (10956 in chips) 
color_singleton: posts small blind 50
Klemtonius: posts big blind 100
*** HOLE CARDS ***
Dealt to Duke Croix [Qc 4c]
HighCardJasper: calls 100
dddocky: folds 
Duke Croix: folds 
color_singleton: calls 50
Klemtonius: raises 100 to 200
HighCardJasper: calls 100
color_singleton: calls 100
*** FLOP *** [Ah Ad 3s]
color_singleton: checks 
Klemtonius: checks 
HighCardJasper: checks 
*** TURN *** [Ah Ad 3s] [Qs]
color_singleton: checks 
Klemtonius: bets 100
HighCardJasper: folds 
color_singleton: folds 
Uncalled bet (100) returned to Klemtonius
Klemtonius collected 567 from pot
Klemtonius: doesn't show hand 
*** SUMMARY ***
Total pot 600 | Rake 33 
Board [Ah Ad 3s Qs]
Seat 1: dddocky folded before Flop (didn't bet)
Seat 2: Duke Croix (button) folded before Flop (didn't bet)
Seat 3: color_singleton (small blind) folded on the Turn
Seat 5: Klemtonius (big blind) collected (567)
Seat 9: HighCardJasper folded on the Turn



PokerStars Home Game Hand #218536734398: {Club #3225207}  Hold'em No Limit (50/100) - 2020/09/17 15:02:31 ET
Table 'fun time' 9-max (Play Money) Seat #3 is the button
Seat 1: dddocky (10071 in chips) 
Seat 2: Duke Croix (9150 in chips) 
Seat 3: color_singleton (7487 in chips) 
Seat 5: Klemtonius (11738 in chips) 
Seat 9: HighCardJasper (10756 in chips) 
Klemtonius: posts small blind 50
HighCardJasper: posts big blind 100
*** HOLE CARDS ***
Dealt to Duke Croix [Kd Qs]
dddocky: calls 100
Duke Croix: raises 400 to 500
color_singleton: folds 
Klemtonius: calls 450
HighCardJasper: folds 
dddocky: folds 
*** FLOP *** [Jd Ac 7c]
Klemtonius: bets 567
Duke Croix: folds 
Uncalled bet (567) returned to Klemtonius
Klemtonius collected 1134 from pot
Klemtonius: doesn't show hand 
*** SUMMARY ***
Total pot 1200 | Rake 66 
Board [Jd Ac 7c]
Seat 1: dddocky folded before Flop
Seat 2: Duke Croix folded on the Flop
Seat 3: color_singleton (button) folded before Flop (didn't bet)
Seat 5: Klemtonius (small blind) collected (1134)
Seat 9: HighCardJasper (big blind) folded before Flop



PokerStars Home Game Hand #218536763033: {Club #3225207}  Hold'em No Limit (50/100) - 2020/09/17 15:03:01 ET
Table 'fun time' 9-max (Play Money) Seat #5 is the button
Seat 1: dddocky (9971 in chips) 
Seat 2: Duke Croix (8650 in chips) 
Seat 3: color_singleton (7487 in chips) 
Seat 5: Klemtonius (12372 in chips) 
Seat 9: HighCardJasper (10656 in chips) 
HighCardJasper: posts small blind 50
dddocky: posts big blind 100
*** HOLE CARDS ***
Dealt to Duke Croix [8d 5d]
Duke Croix: folds 
color_singleton: folds 
Klemtonius: calls 100
HighCardJasper: calls 50
dddocky: checks 
*** FLOP *** [3h 7s Tc]
HighCardJasper: checks 
dddocky: checks 
Klemtonius: checks 
*** TURN *** [3h 7s Tc] [6d]
HighCardJasper: checks 
dddocky: checks 
Klemtonius: bets 100
HighCardJasper: calls 100
dddocky: calls 100
*** RIVER *** [3h 7s Tc 6d] [5s]
HighCardJasper: checks 
dddocky: checks 
Klemtonius: checks 
*** SHOW DOWN ***
HighCardJasper: shows [Qh Jh] (high card Queen)
dddocky: shows [4h Qd] (a straight, Three to Seven)
Klemtonius: mucks hand 
dddocky collected 567 from pot
*** SUMMARY ***
Total pot 600 | Rake 33 
Board [3h 7s Tc 6d 5s]
Seat 1: dddocky (big blind) showed [4h Qd] and won (567) with a straight, Three to Seven
Seat 2: Duke Croix folded before Flop (didn't bet)
Seat 3: color_singleton folded before Flop (didn't bet)
Seat 5: Klemtonius (button) mucked [7c 9d]
Seat 9: HighCardJasper (small blind) showed [Qh Jh] and lost with high card Queen



PokerStars Home Game Hand #218536795492: {Club #3225207}  Hold'em No Limit (50/100) - 2020/09/17 15:03:55 ET
Table 'fun time' 9-max (Play Money) Seat #9 is the button
Seat 1: dddocky (10338 in chips) 
Seat 2: Duke Croix (8650 in chips) 
Seat 3: color_singleton (7487 in chips) 
Seat 5: Klemtonius (12172 in chips) 
Seat 9: HighCardJasper (10456 in chips) 
dddocky: posts small blind 50
Duke Croix: posts big blind 100
*** HOLE CARDS ***
Dealt to Duke Croix [Ad 7s]
color_singleton: folds 
Klemtonius: raises 100 to 200
HighCardJasper: folds 
dddocky: folds 
Duke Croix: calls 100
*** FLOP *** [5d 4d 7d]
Duke Croix: bets 300
Klemtonius: folds 
Uncalled bet (300) returned to Duke Croix
Duke Croix collected 425 from pot
*** SUMMARY ***
Total pot 450 | Rake 25 
Board [5d 4d 7d]
Seat 1: dddocky (small blind) folded before Flop
Seat 2: Duke Croix (big blind) collected (425)
Seat 3: color_singleton folded before Flop (didn't bet)
Seat 5: Klemtonius folded on the Flop
Seat 9: HighCardJasper (button) folded before Flop (didn't bet)



PokerStars Home Game Hand #218536811223: {Club #3225207}  Hold'em No Limit (50/100) - 2020/09/17 15:04:20 ET
Table 'fun time' 9-max (Play Money) Seat #1 is the button
Seat 1: dddocky (10288 in chips) 
Seat 2: Duke Croix (8875 in chips) 
Seat 3: color_singleton (7487 in chips) 
Seat 5: Klemtonius (11972 in chips) 
Seat 9: HighCardJasper (10456 in chips) 
Duke Croix: posts small blind 50
color_singleton: posts big blind 100
*** HOLE CARDS ***
Dealt to Duke Croix [Qd Kh]
Klemtonius: calls 100
HighCardJasper: calls 100
dddocky: calls 100
Duke Croix: raises 400 to 500
color_singleton: calls 400
Klemtonius: folds 
HighCardJasper: folds 
dddocky: folds 
*** FLOP *** [Jc 7h Ac]
Duke Croix: bets 700
color_singleton: calls 700
*** TURN *** [Jc 7h Ac] [5s]
Duke Croix: bets 1000
color_singleton: calls 1000
*** RIVER *** [Jc 7h Ac 5s] [7c]
Duke Croix: bets 6675 and is all-in
color_singleton: calls 5287 and is all-in
Uncalled bet (1388) returned to Duke Croix
*** SHOW DOWN ***
Duke Croix: shows [Qd Kh] (a pair of Sevens)
color_singleton: shows [Ah 7s] (a full house, Sevens full of Aces)
color_singleton collected 14434 from pot
*** SUMMARY ***
Total pot 15274 | Rake 840 
Board [Jc 7h Ac 5s 7c]
Seat 1: dddocky (button) folded before Flop
Seat 2: Duke Croix (small blind) showed [Qd Kh] and lost with a pair of Sevens
Seat 3: color_singleton (big blind) showed [Ah 7s] and won (14434) with a full house, Sevens full of Aces
Seat 5: Klemtonius folded before Flop
Seat 9: HighCardJasper folded before Flop



PokerStars Home Game Hand #218536843458: {Club #3225207}  Hold'em No Limit (50/100) - 2020/09/17 15:05:10 ET
Table 'fun time' 9-max (Play Money) Seat #2 is the button
Seat 1: dddocky (10188 in chips) 
Seat 2: Duke Croix (1388 in chips) 
Seat 3: color_singleton (14434 in chips) 
Seat 5: Klemtonius (11872 in chips) 
Seat 9: HighCardJasper (10356 in chips) 
color_singleton: posts small blind 50
Klemtonius: posts big blind 100
*** HOLE CARDS ***
Dealt to Duke Croix [9c 4d]
HighCardJasper: calls 100
dddocky: folds 
Duke Croix: folds 
color_singleton: folds 
Klemtonius: checks 
*** FLOP *** [As 7d 3d]
Klemtonius: bets 236
HighCardJasper: calls 236
*** TURN *** [As 7d 3d] [6h]
Klemtonius: checks 
HighCardJasper: checks 
*** RIVER *** [As 7d 3d 6h] [Kd]
Klemtonius: checks 
HighCardJasper: checks 
*** SHOW DOWN ***
Klemtonius: shows [4c 3h] (a pair of Threes)
HighCardJasper: shows [Jd 7c] (a pair of Sevens)
HighCardJasper collected 682 from pot
*** SUMMARY ***
Total pot 722 | Rake 40 
Board [As 7d 3d 6h Kd]
Seat 1: dddocky folded before Flop (didn't bet)
Seat 2: Duke Croix (button) folded before Flop (didn't bet)
Seat 3: color_singleton (small blind) folded before Flop
Seat 5: Klemtonius (big blind) showed [4c 3h] and lost with a pair of Threes
Seat 9: HighCardJasper showed [Jd 7c] and won (682) with a pair of Sevens



PokerStars Home Game Hand #218536868519: {Club #3225207}  Hold'em No Limit (50/100) - 2020/09/17 15:05:48 ET
Table 'fun time' 9-max (Play Money) Seat #3 is the button
Seat 1: dddocky (10188 in chips) 
Seat 2: Duke Croix (1388 in chips) 
Seat 3: color_singleton (14384 in chips) 
Seat 5: Klemtonius (11536 in chips) 
Seat 9: HighCardJasper (10702 in chips) 
Klemtonius: posts small blind 50
HighCardJasper: posts big blind 100
*** HOLE CARDS ***
Dealt to Duke Croix [9h 3h]
dddocky: calls 100
Duke Croix: folds 
color_singleton: folds 
Klemtonius: calls 50
HighCardJasper: checks 
*** FLOP *** [Th 5c 7d]
Klemtonius: bets 283
HighCardJasper: folds 
dddocky: folds 
Uncalled bet (283) returned to Klemtonius
Klemtonius collected 283 from pot
Klemtonius: doesn't show hand 
*** SUMMARY ***
Total pot 300 | Rake 17 
Board [Th 5c 7d]
Seat 1: dddocky folded on the Flop
Seat 2: Duke Croix folded before Flop (didn't bet)
Seat 3: color_singleton (button) folded before Flop (didn't bet)
Seat 5: Klemtonius (small blind) collected (283)
Seat 9: HighCardJasper (big blind) folded on the Flop



PokerStars Home Game Hand #218536886313: {Club #3225207}  Hold'em No Limit (50/100) - 2020/09/17 15:06:15 ET
Table 'fun time' 9-max (Play Money) Seat #5 is the button
Seat 1: dddocky (10088 in chips) 
Seat 2: Duke Croix (1388 in chips) 
Seat 3: color_singleton (14384 in chips) 
Seat 5: Klemtonius (11719 in chips) 
Seat 9: HighCardJasper (10602 in chips) 
HighCardJasper: posts small blind 50
dddocky: posts big blind 100
*** HOLE CARDS ***
Dealt to Duke Croix [5c Qd]
Duke Croix: folds 
color_singleton: raises 100 to 200
Klemtonius: calls 200
HighCardJasper: folds 
dddocky: folds 
*** FLOP *** [2h Ah Qc]
color_singleton: checks 
Klemtonius: bets 520
color_singleton: folds 
Uncalled bet (520) returned to Klemtonius
Klemtonius collected 520 from pot
Klemtonius: doesn't show hand 
*** SUMMARY ***
Total pot 550 | Rake 30 
Board [2h Ah Qc]
Seat 1: dddocky (big blind) folded before Flop
Seat 2: Duke Croix folded before Flop (didn't bet)
Seat 3: color_singleton folded on the Flop
Seat 5: Klemtonius (button) collected (520)
Seat 9: HighCardJasper (small blind) folded before Flop



PokerStars Home Game Hand #218536907805: {Club #3225207}  Hold'em No Limit (50/100) - 2020/09/17 15:06:48 ET
Table 'fun time' 9-max (Play Money) Seat #9 is the button
Seat 1: dddocky (9988 in chips) 
Seat 2: Duke Croix (1388 in chips) 
Seat 3: color_singleton (14184 in chips) 
Seat 5: Klemtonius (12039 in chips) 
Seat 9: HighCardJasper (10552 in chips) 
dddocky: posts small blind 50
Duke Croix: posts big blind 100
*** HOLE CARDS ***
Dealt to Duke Croix [8d Tc]
color_singleton: raises 100 to 200
Klemtonius: folds 
HighCardJasper: calls 200
dddocky: folds 
Duke Croix: calls 100
*** FLOP *** [As Th Qs]
Duke Croix: checks 
color_singleton: bets 307
HighCardJasper: calls 307
Duke Croix: folds 
*** TURN *** [As Th Qs] [Ah]
color_singleton: bets 600
HighCardJasper: folds 
Uncalled bet (600) returned to color_singleton
color_singleton collected 1194 from pot
color_singleton: doesn't show hand 
*** SUMMARY ***
Total pot 1264 | Rake 70 
Board [As Th Qs Ah]
Seat 1: dddocky (small blind) folded before Flop
Seat 2: Duke Croix (big blind) folded on the Flop
Seat 3: color_singleton collected (1194)
Seat 5: Klemtonius folded before Flop (didn't bet)
Seat 9: HighCardJasper (button) folded on the Turn



PokerStars Home Game Hand #218536932675: {Club #3225207}  Hold'em No Limit (50/100) - 2020/09/17 15:07:26 ET
Table 'fun time' 9-max (Play Money) Seat #1 is the button
Seat 1: dddocky (9938 in chips) 
Seat 2: Duke Croix (1188 in chips) 
Seat 3: color_singleton (14871 in chips) 
Seat 5: Klemtonius (12039 in chips) 
Seat 9: HighCardJasper (10045 in chips) 
Duke Croix: posts small blind 50
color_singleton: posts big blind 100
*** HOLE CARDS ***
Dealt to Duke Croix [Jd Ac]
Klemtonius: calls 100
HighCardJasper: calls 100
dddocky: calls 100
Duke Croix: raises 200 to 300
color_singleton: folds 
Klemtonius: raises 200 to 500
HighCardJasper: calls 400
dddocky: calls 400
Duke Croix: calls 200
*** FLOP *** [8s Ts 2d]
Duke Croix: checks 
Klemtonius: bets 1984
HighCardJasper: folds 
dddocky: folds 
Duke Croix: folds 
Uncalled bet (1984) returned to Klemtonius
Klemtonius collected 1984 from pot
Klemtonius: doesn't show hand 
*** SUMMARY ***
Total pot 2100 | Rake 116 
Board [8s Ts 2d]
Seat 1: dddocky (button) folded on the Flop
Seat 2: Duke Croix (small blind) folded on the Flop
Seat 3: color_singleton (big blind) folded before Flop
Seat 5: Klemtonius collected (1984)
Seat 9: HighCardJasper folded on the Flop



PokerStars Home Game Hand #218536961320: {Club #3225207}  Hold'em No Limit (50/100) - 2020/09/17 15:08:09 ET
Table 'fun time' 9-max (Play Money) Seat #2 is the button
Seat 1: dddocky (9438 in chips) 
Seat 2: Duke Croix (688 in chips) 
Seat 3: color_singleton (14771 in chips) 
Seat 5: Klemtonius (13523 in chips) 
Seat 9: HighCardJasper (9545 in chips) 
color_singleton: posts small blind 50
Klemtonius: posts big blind 100
*** HOLE CARDS ***
Dealt to Duke Croix [9c 8h]
HighCardJasper: folds 
dddocky: folds 
Duke Croix: folds 
color_singleton: raises 200 to 300
Klemtonius: raises 200 to 500
color_singleton: calls 200
*** FLOP *** [As Jd 4d]
color_singleton: checks 
Klemtonius: checks 
*** TURN *** [As Jd 4d] [6c]
color_singleton: checks 
Klemtonius: checks 
*** RIVER *** [As Jd 4d 6c] [Jc]
color_singleton: bets 800
Klemtonius: raises 800 to 1600
color_singleton: raises 2700 to 4300
Klemtonius: calls 2700
*** SHOW DOWN ***
color_singleton: shows [Jh Js] (four of a kind, Jacks)
Klemtonius: mucks hand 
color_singleton collected 9072 from pot
*** SUMMARY ***
Total pot 9600 | Rake 528 
Board [As Jd 4d 6c Jc]
Seat 1: dddocky folded before Flop (didn't bet)
Seat 2: Duke Croix (button) folded before Flop (didn't bet)
Seat 3: color_singleton (small blind) showed [Jh Js] and won (9072) with four of a kind, Jacks
Seat 5: Klemtonius (big blind) mucked [Ac Ks]
Seat 9: HighCardJasper folded before Flop (didn't bet)



PokerStars Home Game Hand #218537006925: {Club #3225207}  Hold'em No Limit (50/100) - 2020/09/17 15:09:19 ET
Table 'fun time' 9-max (Play Money) Seat #3 is the button
Seat 1: dddocky (9438 in chips) 
Seat 2: Duke Croix (688 in chips) 
Seat 3: color_singleton (19043 in chips) 
Seat 5: Klemtonius (8723 in chips) 
Seat 9: HighCardJasper (9545 in chips) 
Klemtonius: posts small blind 50
HighCardJasper: posts big blind 100
*** HOLE CARDS ***
Dealt to Duke Croix [Qs Th]
dddocky: folds 
Duke Croix: raises 588 to 688 and is all-in
color_singleton: folds 
Klemtonius: folds 
HighCardJasper: folds 
Uncalled bet (588) returned to Duke Croix
Duke Croix collected 250 from pot
*** SUMMARY ***
Total pot 250 | Rake 0 
Seat 1: dddocky folded before Flop (didn't bet)
Seat 2: Duke Croix collected (250)
Seat 3: color_singleton (button) folded before Flop (didn't bet)
Seat 5: Klemtonius (small blind) folded before Flop
Seat 9: HighCardJasper (big blind) folded before Flop



PokerStars Home Game Hand #218537019168: {Club #3225207}  Hold'em No Limit (50/100) - 2020/09/17 15:09:37 ET
Table 'fun time' 9-max (Play Money) Seat #5 is the button
Seat 1: dddocky (9438 in chips) 
Seat 2: Duke Croix (838 in chips) 
Seat 3: color_singleton (19043 in chips) 
Seat 5: Klemtonius (8673 in chips) 
Seat 9: HighCardJasper (9445 in chips) 
HighCardJasper: posts small blind 50
dddocky: posts big blind 100
*** HOLE CARDS ***
Dealt to Duke Croix [8d Tc]
Duke Croix: folds 
color_singleton: folds 
Klemtonius: calls 100
HighCardJasper: calls 50
dddocky: checks 
*** FLOP *** [Ah Qh 8s]
HighCardJasper: checks 
dddocky: checks 
Klemtonius: bets 283
HighCardJasper: calls 283
dddocky: folds 
*** TURN *** [Ah Qh 8s] [6h]
HighCardJasper: checks 
Klemtonius: bets 818
HighCardJasper: folds 
Uncalled bet (818) returned to Klemtonius
Klemtonius collected 818 from pot
Klemtonius: doesn't show hand 
*** SUMMARY ***
Total pot 866 | Rake 48 
Board [Ah Qh 8s 6h]
Seat 1: dddocky (big blind) folded on the Flop
Seat 2: Duke Croix folded before Flop (didn't bet)
Seat 3: color_singleton folded before Flop (didn't bet)
Seat 5: Klemtonius (button) collected (818)
Seat 9: HighCardJasper (small blind) folded on the Turn



PokerStars Home Game Hand #218537045506: {Club #3225207}  Hold'em No Limit (50/100) - 2020/09/17 15:10:18 ET
Table 'fun time' 9-max (Play Money) Seat #9 is the button
Seat 1: dddocky (9338 in chips) 
Seat 2: Duke Croix (838 in chips) 
Seat 3: color_singleton (19043 in chips) 
Seat 5: Klemtonius (9108 in chips) 
Seat 9: HighCardJasper (9062 in chips) 
dddocky: posts small blind 50
Duke Croix: posts big blind 100
*** HOLE CARDS ***
Dealt to Duke Croix [Ac 2s]
color_singleton: folds 
Klemtonius: calls 100
HighCardJasper: calls 100
dddocky: calls 50
Duke Croix: checks 
*** FLOP *** [Td Js 4h]
dddocky: checks 
Duke Croix: checks 
Klemtonius: checks 
HighCardJasper: checks 
*** TURN *** [Td Js 4h] [Qs]
dddocky: bets 100
Duke Croix: folds 
Klemtonius: calls 100
HighCardJasper: calls 100
*** RIVER *** [Td Js 4h Qs] [Ks]
dddocky: bets 100
Klemtonius: calls 100
HighCardJasper: calls 100
*** SHOW DOWN ***
dddocky: shows [3h Qd] (a pair of Queens)
Klemtonius: shows [Kd 8c] (a pair of Kings)
HighCardJasper: mucks hand 
Klemtonius collected 945 from pot
*** SUMMARY ***
Total pot 1000 | Rake 55 
Board [Td Js 4h Qs Ks]
Seat 1: dddocky (small blind) showed [3h Qd] and lost with a pair of Queens
Seat 2: Duke Croix (big blind) folded on the Turn
Seat 3: color_singleton folded before Flop (didn't bet)
Seat 5: Klemtonius showed [Kd 8c] and won (945) with a pair of Kings
Seat 9: HighCardJasper (button) mucked [Qh 3d]



PokerStars Home Game Hand #218537074880: {Club #3225207}  Hold'em No Limit (50/100) - 2020/09/17 15:11:03 ET
Table 'fun time' 9-max (Play Money) Seat #1 is the button
Seat 1: dddocky (9038 in chips) 
Seat 2: Duke Croix (738 in chips) 
Seat 3: color_singleton (19043 in chips) 
Seat 5: Klemtonius (9753 in chips) 
Seat 9: HighCardJasper (8762 in chips) 
Duke Croix: posts small blind 50
color_singleton: posts big blind 100
*** HOLE CARDS ***
Dealt to Duke Croix [6c Js]
Klemtonius: calls 100
HighCardJasper: calls 100
dddocky: folds 
Duke Croix: folds 
color_singleton: raises 300 to 400
Klemtonius: folds 
HighCardJasper: calls 300
*** FLOP *** [Qc 3c Jh]
color_singleton: checks 
HighCardJasper: bets 200
color_singleton: calls 200
*** TURN *** [Qc 3c Jh] [8d]
color_singleton: checks 
HighCardJasper: bets 200
color_singleton: folds 
Uncalled bet (200) returned to HighCardJasper
HighCardJasper collected 1276 from pot
HighCardJasper: doesn't show hand 
*** SUMMARY ***
Total pot 1350 | Rake 74 
Board [Qc 3c Jh 8d]
Seat 1: dddocky (button) folded before Flop (didn't bet)
Seat 2: Duke Croix (small blind) folded before Flop
Seat 3: color_singleton (big blind) folded on the Turn
Seat 5: Klemtonius folded before Flop
Seat 9: HighCardJasper collected (1276)



PokerStars Home Game Hand #218537112875: {Club #3225207}  Hold'em No Limit (50/100) - 2020/09/17 15:12:01 ET
Table 'fun time' 9-max (Play Money) Seat #2 is the button
Seat 1: dddocky (9038 in chips) 
Seat 2: Duke Croix (688 in chips) 
Seat 3: color_singleton (18443 in chips) 
Seat 5: Klemtonius (9653 in chips) 
Seat 9: HighCardJasper (9438 in chips) 
color_singleton: posts small blind 50
Klemtonius: posts big blind 100
*** HOLE CARDS ***
Dealt to Duke Croix [Ah 2c]
HighCardJasper: calls 100
dddocky: calls 100
Duke Croix: raises 588 to 688 and is all-in
color_singleton: folds 
Klemtonius: folds 
HighCardJasper: folds 
dddocky: folds 
Uncalled bet (588) returned to Duke Croix
Duke Croix collected 450 from pot
*** SUMMARY ***
Total pot 450 | Rake 0 
Seat 1: dddocky folded before Flop
Seat 2: Duke Croix (button) collected (450)
Seat 3: color_singleton (small blind) folded before Flop
Seat 5: Klemtonius (big blind) folded before Flop
Seat 9: HighCardJasper folded before Flop



PokerStars Home Game Hand #218537123611: {Club #3225207}  Hold'em No Limit (50/100) - 2020/09/17 15:12:17 ET
Table 'fun time' 9-max (Play Money) Seat #3 is the button
Seat 1: dddocky (8938 in chips) 
Seat 2: Duke Croix (1038 in chips) 
Seat 3: color_singleton (18393 in chips) 
Seat 5: Klemtonius (9553 in chips) 
Seat 9: HighCardJasper (9338 in chips) 
Klemtonius: posts small blind 50
HighCardJasper: posts big blind 100
*** HOLE CARDS ***
Dealt to Duke Croix [3d 6h]
dddocky: folds 
Duke Croix: folds 
color_singleton: folds 
Klemtonius: calls 50
HighCardJasper: checks 
*** FLOP *** [Ks Ac Kc]
Klemtonius: checks 
HighCardJasper: checks 
*** TURN *** [Ks Ac Kc] [7c]
Klemtonius: bets 100
HighCardJasper: folds 
Uncalled bet (100) returned to Klemtonius
Klemtonius collected 189 from pot
Klemtonius: doesn't show hand 
*** SUMMARY ***
Total pot 200 | Rake 11 
Board [Ks Ac Kc 7c]
Seat 1: dddocky folded before Flop (didn't bet)
Seat 2: Duke Croix folded before Flop (didn't bet)
Seat 3: color_singleton (button) folded before Flop (didn't bet)
Seat 5: Klemtonius (small blind) collected (189)
Seat 9: HighCardJasper (big blind) folded on the Turn



PokerStars Home Game Hand #218537135117: {Club #3225207}  Hold'em No Limit (50/100) - 2020/09/17 15:12:35 ET
Table 'fun time' 9-max (Play Money) Seat #5 is the button
Seat 1: dddocky (8938 in chips) 
Seat 2: Duke Croix (1038 in chips) 
Seat 3: color_singleton (18393 in chips) 
Seat 5: Klemtonius (9642 in chips) 
Seat 9: HighCardJasper (9238 in chips) 
HighCardJasper: posts small blind 50
dddocky: posts big blind 100
*** HOLE CARDS ***
Dealt to Duke Croix [5h 9s]
Duke Croix: folds 
color_singleton: raises 200 to 300
Klemtonius: calls 300
HighCardJasper: folds 
dddocky: calls 200
*** FLOP *** [4d Ts 4h]
dddocky: checks 
color_singleton: checks 
Klemtonius: bets 449
dddocky: folds 
color_singleton: calls 449
*** TURN *** [4d Ts 4h] [2s]
color_singleton: checks 
Klemtonius: checks 
*** RIVER *** [4d Ts 4h 2s] [Qs]
color_singleton: checks 
Klemtonius: checks 
*** SHOW DOWN ***
color_singleton: shows [Kd Jh] (a pair of Fours)
Klemtonius: shows [7h Tc] (two pair, Tens and Fours)
Klemtonius collected 1746 from pot
*** SUMMARY ***
Total pot 1848 | Rake 102 
Board [4d Ts 4h 2s Qs]
Seat 1: dddocky (big blind) folded on the Flop
Seat 2: Duke Croix folded before Flop (didn't bet)
Seat 3: color_singleton showed [Kd Jh] and lost with a pair of Fours
Seat 5: Klemtonius (button) showed [7h Tc] and won (1746) with two pair, Tens and Fours
Seat 9: HighCardJasper (small blind) folded before Flop



PokerStars Home Game Hand #218537161938: {Club #3225207}  Hold'em No Limit (50/100) - 2020/09/17 15:13:16 ET
Table 'fun time' 9-max (Play Money) Seat #9 is the button
Seat 1: dddocky (8638 in chips) 
Seat 2: Duke Croix (1038 in chips) 
Seat 3: color_singleton (17644 in chips) 
Seat 5: Klemtonius (10639 in chips) 
Seat 9: HighCardJasper (9188 in chips) 
dddocky: posts small blind 50
Duke Croix: posts big blind 100
*** HOLE CARDS ***
Dealt to Duke Croix [8c 4h]
color_singleton: raises 200 to 300
Klemtonius: folds 
HighCardJasper: calls 300
dddocky: calls 250
Duke Croix: folds 
*** FLOP *** [As 7d 2h]
dddocky: checks 
color_singleton: checks 
HighCardJasper: checks 
*** TURN *** [As 7d 2h] [Tc]
dddocky: checks 
color_singleton: checks 
HighCardJasper: bets 200
dddocky has timed out
dddocky: folds 
color_singleton: calls 200
*** RIVER *** [As 7d 2h Tc] [7h]
color_singleton: checks 
HighCardJasper: bets 500
color_singleton: folds 
Uncalled bet (500) returned to HighCardJasper
HighCardJasper collected 1323 from pot
HighCardJasper: doesn't show hand 
*** SUMMARY ***
Total pot 1400 | Rake 77 
Board [As 7d 2h Tc 7h]
Seat 1: dddocky (small blind) folded on the Turn
Seat 2: Duke Croix (big blind) folded before Flop
Seat 3: color_singleton folded on the River
Seat 5: Klemtonius folded before Flop (didn't bet)
Seat 9: HighCardJasper (button) collected (1323)



PokerStars Home Game Hand #218537197492: {Club #3225207}  Hold'em No Limit (50/100) - 2020/09/17 15:14:10 ET
Table 'fun time' 9-max (Play Money) Seat #1 is the button
Seat 1: dddocky (8338 in chips) 
Seat 2: Duke Croix (938 in chips) 
Seat 3: color_singleton (17144 in chips) 
Seat 5: Klemtonius (10639 in chips) 
Seat 9: HighCardJasper (10011 in chips) 
Duke Croix: posts small blind 50
color_singleton: posts big blind 100
*** HOLE CARDS ***
Dealt to Duke Croix [9c Qh]
Klemtonius: calls 100
HighCardJasper: raises 100 to 200
dddocky: calls 200
Duke Croix: folds 
color_singleton: folds 
Klemtonius: calls 100
*** FLOP *** [8c As Ks]
Klemtonius: checks 
HighCardJasper: checks 
dddocky: checks 
*** TURN *** [8c As Ks] [3s]
Klemtonius: checks 
HighCardJasper: checks 
dddocky: checks 
*** RIVER *** [8c As Ks 3s] [5h]
Klemtonius: checks 
HighCardJasper: bets 300
dddocky: folds 
Klemtonius: folds 
Uncalled bet (300) returned to HighCardJasper
HighCardJasper collected 709 from pot
HighCardJasper: doesn't show hand 
*** SUMMARY ***
Total pot 750 | Rake 41 
Board [8c As Ks 3s 5h]
Seat 1: dddocky (button) folded on the River
Seat 2: Duke Croix (small blind) folded before Flop
Seat 3: color_singleton (big blind) folded before Flop
Seat 5: Klemtonius folded on the River
Seat 9: HighCardJasper collected (709)



PokerStars Home Game Hand #218537223540: {Club #3225207}  Hold'em No Limit (50/100) - 2020/09/17 15:14:50 ET
Table 'fun time' 9-max (Play Money) Seat #2 is the button
Seat 1: dddocky (8138 in chips) 
Seat 2: Duke Croix (888 in chips) 
Seat 3: color_singleton (17044 in chips) 
Seat 5: Klemtonius (10439 in chips) 
Seat 9: HighCardJasper (10520 in chips) 
color_singleton: posts small blind 50
Klemtonius: posts big blind 100
*** HOLE CARDS ***
Dealt to Duke Croix [9s 2h]
HighCardJasper: calls 100
dddocky: folds 
Duke Croix: folds 
color_singleton: calls 50
Klemtonius: checks 
*** FLOP *** [Ts 7c Tc]
color_singleton: bets 141
Klemtonius: folds 
HighCardJasper: calls 141
*** TURN *** [Ts 7c Tc] [6s]
color_singleton: bets 550
HighCardJasper: folds 
Uncalled bet (550) returned to color_singleton
color_singleton collected 550 from pot
color_singleton: doesn't show hand 
*** SUMMARY ***
Total pot 582 | Rake 32 
Board [Ts 7c Tc 6s]
Seat 1: dddocky folded before Flop (didn't bet)
Seat 2: Duke Croix (button) folded before Flop (didn't bet)
Seat 3: color_singleton (small blind) collected (550)
Seat 5: Klemtonius (big blind) folded on the Flop
Seat 9: HighCardJasper folded on the Turn



PokerStars Home Game Hand #218537242119: {Club #3225207}  Hold'em No Limit (50/100) - 2020/09/17 15:15:18 ET
Table 'fun time' 9-max (Play Money) Seat #3 is the button
Seat 1: dddocky (8138 in chips) 
Seat 2: Duke Croix (888 in chips) 
Seat 3: color_singleton (17353 in chips) 
Seat 5: Klemtonius (10339 in chips) 
Seat 9: HighCardJasper (10279 in chips) 
Klemtonius: posts small blind 50
HighCardJasper: posts big blind 100
*** HOLE CARDS ***
Dealt to Duke Croix [3h 7c]
dddocky: calls 100
Duke Croix: folds 
color_singleton: folds 
Klemtonius: raises 100 to 200
HighCardJasper: calls 100
dddocky: calls 100
*** FLOP *** [Ah 2s 3d]
Klemtonius: checks 
HighCardJasper: checks 
dddocky: checks 
*** TURN *** [Ah 2s 3d] [6h]
Klemtonius: bets 283
HighCardJasper: calls 283
dddocky: folds 
*** RIVER *** [Ah 2s 3d 6h] [5s]
Klemtonius: checks 
HighCardJasper: bets 300
Klemtonius: calls 300
*** SHOW DOWN ***
HighCardJasper: shows [5h Qd] (a pair of Fives)
Klemtonius: shows [Ac Qs] (a pair of Aces)
Klemtonius collected 1669 from pot
*** SUMMARY ***
Total pot 1766 | Rake 97 
Board [Ah 2s 3d 6h 5s]
Seat 1: dddocky folded on the Turn
Seat 2: Duke Croix folded before Flop (didn't bet)
Seat 3: color_singleton (button) folded before Flop (didn't bet)
Seat 5: Klemtonius (small blind) showed [Ac Qs] and won (1669) with a pair of Aces
Seat 9: HighCardJasper (big blind) showed [5h Qd] and lost with a pair of Fives



PokerStars Home Game Hand #218537272752: {Club #3225207}  Hold'em No Limit (50/100) - 2020/09/17 15:16:05 ET
Table 'fun time' 9-max (Play Money) Seat #5 is the button
Seat 1: dddocky (7938 in chips) 
Seat 2: Duke Croix (888 in chips) 
Seat 3: color_singleton (17353 in chips) 
Seat 5: Klemtonius (11225 in chips) 
Seat 9: HighCardJasper (9496 in chips) 
HighCardJasper: posts small blind 50
dddocky: posts big blind 100
*** HOLE CARDS ***
Dealt to Duke Croix [8s 6d]
Duke Croix: folds 
color_singleton: calls 100
Klemtonius: raises 100 to 200
HighCardJasper: calls 150
dddocky: calls 100
color_singleton: calls 100
*** FLOP *** [5h 2s Kd]
HighCardJasper: checks 
dddocky: checks 
color_singleton: checks 
Klemtonius: checks 
*** TURN *** [5h 2s Kd] [3c]
HighCardJasper: checks 
dddocky: bets 378
color_singleton: folds 
Klemtonius: folds 
HighCardJasper: calls 378
*** RIVER *** [5h 2s Kd 3c] [7s]
HighCardJasper: checks 
dddocky: bets 735
HighCardJasper: folds 
Uncalled bet (735) returned to dddocky
dddocky collected 1470 from pot
dddocky: doesn't show hand 
*** SUMMARY ***
Total pot 1556 | Rake 86 
Board [5h 2s Kd 3c 7s]
Seat 1: dddocky (big blind) collected (1470)
Seat 2: Duke Croix folded before Flop (didn't bet)
Seat 3: color_singleton folded on the Turn
Seat 5: Klemtonius (button) folded on the Turn
Seat 9: HighCardJasper (small blind) folded on the River



PokerStars Home Game Hand #218537316335: {Club #3225207}  Hold'em No Limit (50/100) - 2020/09/17 15:17:11 ET
Table 'fun time' 9-max (Play Money) Seat #9 is the button
Seat 1: dddocky (8830 in chips) 
Seat 2: Duke Croix (888 in chips) 
Seat 3: color_singleton (17153 in chips) 
Seat 5: Klemtonius (11025 in chips) 
Seat 9: HighCardJasper (8918 in chips) 
dddocky: posts small blind 50
Duke Croix: posts big blind 100
*** HOLE CARDS ***
Dealt to Duke Croix [9d Tc]
color_singleton: folds 
Klemtonius: calls 100
HighCardJasper: raises 100 to 200
dddocky: calls 150
Duke Croix: calls 100
Klemtonius: calls 100
*** FLOP *** [Jh Ad 5d]
dddocky: checks 
Duke Croix: checks 
Klemtonius: bets 378
HighCardJasper: calls 378
dddocky: folds 
Duke Croix: folds 
*** TURN *** [Jh Ad 5d] [8h]
Klemtonius: bets 1470
HighCardJasper: calls 1470
*** RIVER *** [Jh Ad 5d 8h] [6d]
Klemtonius: checks 
HighCardJasper: checks 
*** SHOW DOWN ***
Klemtonius: shows [Kd 5c] (a pair of Fives)
HighCardJasper: shows [Ah Qc] (a pair of Aces)
HighCardJasper collected 4249 from pot
*** SUMMARY ***
Total pot 4496 | Rake 247 
Board [Jh Ad 5d 8h 6d]
Seat 1: dddocky (small blind) folded on the Flop
Seat 2: Duke Croix (big blind) folded on the Flop
Seat 3: color_singleton folded before Flop (didn't bet)
Seat 5: Klemtonius showed [Kd 5c] and lost with a pair of Fives
Seat 9: HighCardJasper (button) showed [Ah Qc] and won (4249) with a pair of Aces



PokerStars Home Game Hand #218537352691: {Club #3225207}  Hold'em No Limit (50/100) - 2020/09/17 15:18:07 ET
Table 'fun time' 9-max (Play Money) Seat #1 is the button
Seat 1: dddocky (8630 in chips) 
Seat 2: Duke Croix (688 in chips) 
Seat 3: color_singleton (17153 in chips) 
Seat 5: Klemtonius (8977 in chips) 
Seat 9: HighCardJasper (11119 in chips) 
Duke Croix: posts small blind 50
color_singleton: posts big blind 100
*** HOLE CARDS ***
Dealt to Duke Croix [4d 7d]
Klemtonius: raises 233 to 333
HighCardJasper: folds 
dddocky: calls 333
Duke Croix: folds 
color_singleton: folds 
*** FLOP *** [Td 2s 9c]
Klemtonius: checks 
dddocky: bets 771
Klemtonius: calls 771
*** TURN *** [Td 2s 9c] [Qc]
Klemtonius: checks 
dddocky: bets 2228
Klemtonius: folds 
Uncalled bet (2228) returned to dddocky
dddocky collected 2228 from pot
dddocky: doesn't show hand 
*** SUMMARY ***
Total pot 2358 | Rake 130 
Board [Td 2s 9c Qc]
Seat 1: dddocky (button) collected (2228)
Seat 2: Duke Croix (small blind) folded before Flop
Seat 3: color_singleton (big blind) folded before Flop
Seat 5: Klemtonius folded on the Turn
Seat 9: HighCardJasper folded before Flop (didn't bet)



PokerStars Home Game Hand #218537381804: {Club #3225207}  Hold'em No Limit (50/100) - 2020/09/17 15:18:52 ET
Table 'fun time' 9-max (Play Money) Seat #2 is the button
Seat 1: dddocky (9754 in chips) 
Seat 2: Duke Croix (638 in chips) 
Seat 3: color_singleton (17053 in chips) 
Seat 5: Klemtonius (7873 in chips) 
Seat 9: HighCardJasper (11119 in chips) 
color_singleton: posts small blind 50
Klemtonius: posts big blind 100
*** HOLE CARDS ***
Dealt to Duke Croix [5h Jc]
HighCardJasper: raises 100 to 200
dddocky: calls 200
Duke Croix: folds 
color_singleton: calls 150
Klemtonius: calls 100
*** FLOP *** [Jh 2c 7s]
color_singleton: checks 
Klemtonius: checks 
HighCardJasper: checks 
dddocky: checks 
*** TURN *** [Jh 2c 7s] [9s]
color_singleton: bets 378
Klemtonius: calls 378
HighCardJasper: folds 
dddocky: calls 378
*** RIVER *** [Jh 2c 7s 9s] [4c]
color_singleton: checks 
Klemtonius: checks 
dddocky: checks 
*** SHOW DOWN ***
color_singleton: shows [As 9c] (a pair of Nines)
Klemtonius: mucks hand 
dddocky: mucks hand 
color_singleton collected 1828 from pot
*** SUMMARY ***
Total pot 1934 | Rake 106 
Board [Jh 2c 7s 9s 4c]
Seat 1: dddocky mucked [5s Kc]
Seat 2: Duke Croix (button) folded before Flop (didn't bet)
Seat 3: color_singleton (small blind) showed [As 9c] and won (1828) with a pair of Nines
Seat 5: Klemtonius (big blind) mucked [Th 9h]
Seat 9: HighCardJasper folded on the Turn



PokerStars Home Game Hand #218537426363: {Club #3225207}  Hold'em No Limit (50/100) - 2020/09/17 15:20:01 ET
Table 'fun time' 9-max (Play Money) Seat #3 is the button
Seat 1: dddocky (9176 in chips) 
Seat 2: Duke Croix (638 in chips) 
Seat 3: color_singleton (18303 in chips) 
Seat 5: Klemtonius (7295 in chips) 
Seat 9: HighCardJasper (10919 in chips) 
Klemtonius: posts small blind 50
HighCardJasper: posts big blind 100
*** HOLE CARDS ***
Dealt to Duke Croix [2c 6d]
dddocky: calls 100
Duke Croix: folds 
color_singleton: folds 
Klemtonius: calls 50
HighCardJasper: checks 
*** FLOP *** [Qd 7d 8d]
Klemtonius: checks 
HighCardJasper: bets 200
dddocky: folds 
Klemtonius: folds 
Uncalled bet (200) returned to HighCardJasper
HighCardJasper collected 283 from pot
HighCardJasper: doesn't show hand 
*** SUMMARY ***
Total pot 300 | Rake 17 
Board [Qd 7d 8d]
Seat 1: dddocky folded on the Flop
Seat 2: Duke Croix folded before Flop (didn't bet)
Seat 3: color_singleton (button) folded before Flop (didn't bet)
Seat 5: Klemtonius (small blind) folded on the Flop
Seat 9: HighCardJasper (big blind) collected (283)



PokerStars Home Game Hand #218537449199: {Club #3225207}  Hold'em No Limit (50/100) - 2020/09/17 15:20:35 ET
Table 'fun time' 9-max (Play Money) Seat #5 is the button
Seat 1: dddocky (9076 in chips) 
Seat 2: Duke Croix (638 in chips) 
Seat 3: color_singleton (18303 in chips) 
Seat 5: Klemtonius (7195 in chips) 
Seat 9: HighCardJasper (11102 in chips) 
HighCardJasper: posts small blind 50
dddocky: posts big blind 100
*** HOLE CARDS ***
Dealt to Duke Croix [3d 5h]
Duke Croix: folds 
color_singleton: calls 100
Klemtonius: raises 356 to 456
HighCardJasper: calls 406
dddocky: folds 
color_singleton: folds 
*** FLOP *** [6h 9c 5d]
HighCardJasper: checks 
Klemtonius: bets 1051
HighCardJasper: folds 
Uncalled bet (1051) returned to Klemtonius
Klemtonius collected 1051 from pot
Klemtonius: doesn't show hand 
*** SUMMARY ***
Total pot 1112 | Rake 61 
Board [6h 9c 5d]
Seat 1: dddocky (big blind) folded before Flop
Seat 2: Duke Croix folded before Flop (didn't bet)
Seat 3: color_singleton folded before Flop
Seat 5: Klemtonius (button) collected (1051)
Seat 9: HighCardJasper (small blind) folded on the Flop



PokerStars Home Game Hand #218537467653: {Club #3225207}  Hold'em No Limit (50/100) - 2020/09/17 15:21:04 ET
Table 'fun time' 9-max (Play Money) Seat #9 is the button
Seat 1: dddocky (8976 in chips) 
Seat 2: Duke Croix (638 in chips) 
Seat 3: color_singleton (18203 in chips) 
Seat 5: Klemtonius (7790 in chips) 
Seat 9: HighCardJasper (10646 in chips) 
dddocky: posts small blind 50
Duke Croix: posts big blind 100
*** HOLE CARDS ***
Dealt to Duke Croix [8h 7c]
color_singleton: folds 
Klemtonius: calls 100
HighCardJasper: calls 100
dddocky: calls 50
Duke Croix: raises 538 to 638 and is all-in
Klemtonius: folds 
HighCardJasper: folds 
dddocky: folds 
Uncalled bet (538) returned to Duke Croix
Duke Croix collected 400 from pot
*** SUMMARY ***
Total pot 400 | Rake 0 
Seat 1: dddocky (small blind) folded before Flop
Seat 2: Duke Croix (big blind) collected (400)
Seat 3: color_singleton folded before Flop (didn't bet)
Seat 5: Klemtonius folded before Flop
Seat 9: HighCardJasper (button) folded before Flop



PokerStars Home Game Hand #218537485813: {Club #3225207}  Hold'em No Limit (50/100) - 2020/09/17 15:21:31 ET
Table 'fun time' 9-max (Play Money) Seat #1 is the button
Seat 1: dddocky (8876 in chips) 
Seat 2: Duke Croix (938 in chips) 
Seat 3: color_singleton (18203 in chips) 
Seat 5: Klemtonius (7690 in chips) 
Seat 9: HighCardJasper (10546 in chips) 
Duke Croix: posts small blind 50
color_singleton: posts big blind 100
*** HOLE CARDS ***
Dealt to Duke Croix [Js Ks]
Klemtonius: folds 
HighCardJasper: calls 100
dddocky: folds 
Duke Croix: raises 838 to 938 and is all-in
color_singleton: calls 838
HighCardJasper: folds 
*** FLOP *** [3h 5d 7h]
*** TURN *** [3h 5d 7h] [2h]
*** RIVER *** [3h 5d 7h 2h] [6s]
*** SHOW DOWN ***
Duke Croix: shows [Js Ks] (high card King)
color_singleton: shows [8h Ah] (a flush, Ace high)
color_singleton collected 1867 from pot
*** SUMMARY ***
Total pot 1976 | Rake 109 
Board [3h 5d 7h 2h 6s]
Seat 1: dddocky (button) folded before Flop (didn't bet)
Seat 2: Duke Croix (small blind) showed [Js Ks] and lost with high card King
Seat 3: color_singleton (big blind) showed [8h Ah] and won (1867) with a flush, Ace high
Seat 5: Klemtonius folded before Flop (didn't bet)
Seat 9: HighCardJasper folded before Flop



PokerStars Home Game Hand #218537524054: {Club #3225207}  Hold'em No Limit (50/100) - 2020/09/17 15:22:30 ET
Table 'fun time' 9-max (Play Money) Seat #9 is the button
Seat 1: dddocky (8776 in chips) 
Seat 2: Duke Croix (10000 in chips) 
Seat 3: color_singleton (19132 in chips) 
Seat 9: HighCardJasper (10046 in chips) 
dddocky: posts small blind 50
Duke Croix: posts big blind 100
*** HOLE CARDS ***
Dealt to Duke Croix [3c Kd]
color_singleton: folds 
HighCardJasper: calls 100
dddocky: calls 50
Duke Croix: checks 
*** FLOP *** [Ah 8s Js]
dddocky: checks 
Duke Croix: checks 
HighCardJasper: bets 200
dddocky: folds 
Duke Croix: folds 
Uncalled bet (200) returned to HighCardJasper
HighCardJasper collected 283 from pot
HighCardJasper: doesn't show hand 
*** SUMMARY ***
Total pot 300 | Rake 17 
Board [Ah 8s Js]
Seat 1: dddocky (small blind) folded on the Flop
Seat 2: Duke Croix (big blind) folded on the Flop
Seat 3: color_singleton folded before Flop (didn't bet)
Seat 9: HighCardJasper (button) collected (283)



PokerStars Home Game Hand #218537539713: {Club #3225207}  Hold'em No Limit (50/100) - 2020/09/17 15:22:54 ET
Table 'fun time' 9-max (Play Money) Seat #2 is the button
Seat 2: Duke Croix (9900 in chips) 
Seat 3: color_singleton (19132 in chips) 
Seat 9: HighCardJasper (10229 in chips) 
color_singleton: posts small blind 50
HighCardJasper: posts big blind 100
*** HOLE CARDS ***
Dealt to Duke Croix [As Ac]
Duke Croix: raises 300 to 400
color_singleton: folds 
HighCardJasper: folds 
Uncalled bet (300) returned to Duke Croix
Duke Croix collected 250 from pot
*** SUMMARY ***
Total pot 250 | Rake 0 
Seat 2: Duke Croix (button) collected (250)
Seat 3: color_singleton (small blind) folded before Flop
Seat 9: HighCardJasper (big blind) folded before Flop



PokerStars Home Game Hand #218537550658: {Club #3225207}  Hold'em No Limit (50/100) - 2020/09/17 15:23:11 ET
Table 'fun time' 9-max (Play Money) Seat #3 is the button
Seat 2: Duke Croix (10050 in chips) 
Seat 3: color_singleton (19082 in chips) 
Seat 9: HighCardJasper (10129 in chips) 
HighCardJasper: posts small blind 50
Duke Croix: posts big blind 100
*** HOLE CARDS ***
Dealt to Duke Croix [9c Kh]
color_singleton: raises 200 to 300
HighCardJasper has timed out
HighCardJasper: folds 
Duke Croix: calls 200
*** FLOP *** [Jd 3h 4s]
Duke Croix: checks 
color_singleton: checks 
*** TURN *** [Jd 3h 4s] [Ah]
Duke Croix: checks 
color_singleton: bets 307
Duke Croix: folds 
Uncalled bet (307) returned to color_singleton
color_singleton collected 614 from pot
color_singleton: doesn't show hand 
*** SUMMARY ***
Total pot 650 | Rake 36 
Board [Jd 3h 4s Ah]
Seat 2: Duke Croix (big blind) folded on the Turn
Seat 3: color_singleton (button) collected (614)
Seat 9: HighCardJasper (small blind) folded before Flop



PokerStars Home Game Hand #218537576760: {Club #3225207}  Hold'em No Limit (50/100) - 2020/09/17 15:23:51 ET
Table 'fun time' 9-max (Play Money) Seat #2 is the button
Seat 2: Duke Croix (9750 in chips) 
Seat 3: color_singleton (19396 in chips) 
Duke Croix: posts small blind 50
color_singleton: posts big blind 100
*** HOLE CARDS ***
Dealt to Duke Croix [8s 5c]
Duke Croix: calls 50
color_singleton: checks 
*** FLOP *** [Qc 7s Ts]
color_singleton: checks 
Duke Croix: checks 
*** TURN *** [Qc 7s Ts] [Ac]
color_singleton: bets 189
Duke Croix: folds 
Uncalled bet (189) returned to color_singleton
color_singleton collected 189 from pot
color_singleton: doesn't show hand 
*** SUMMARY ***
Total pot 200 | Rake 11 
Board [Qc 7s Ts Ac]
Seat 2: Duke Croix (button) (small blind) folded on the Turn
Seat 3: color_singleton (big blind) collected (189)



PokerStars Home Game Hand #218537587428: {Club #3225207}  Hold'em No Limit (50/100) - 2020/09/17 15:24:07 ET
Table 'fun time' 9-max (Play Money) Seat #3 is the button
Seat 2: Duke Croix (9650 in chips) 
Seat 3: color_singleton (19485 in chips) 
color_singleton: posts small blind 50
Duke Croix: posts big blind 100
*** HOLE CARDS ***
Dealt to Duke Croix [Th Tc]
color_singleton: raises 200 to 300
Duke Croix: raises 500 to 800
color_singleton: folds 
Uncalled bet (500) returned to Duke Croix
Duke Croix collected 600 from pot
*** SUMMARY ***
Total pot 600 | Rake 0 
Seat 2: Duke Croix (big blind) collected (600)
Seat 3: color_singleton (button) (small blind) folded before Flop



PokerStars Home Game Hand #218537598002: {Club #3225207}  Hold'em No Limit (50/100) - 2020/09/17 15:24:24 ET
Table 'fun time' 9-max (Play Money) Seat #2 is the button
Seat 1: dddocky (8676 in chips) 
Seat 2: Duke Croix (9950 in chips) 
Seat 3: color_singleton (19185 in chips) 
color_singleton: posts small blind 50
dddocky: posts big blind 100
*** HOLE CARDS ***
Dealt to Duke Croix [Jh 8c]
Duke Croix: folds 
color_singleton: folds 
Uncalled bet (50) returned to dddocky
dddocky collected 100 from pot
dddocky: doesn't show hand 
*** SUMMARY ***
Total pot 100 | Rake 0 
Seat 1: dddocky (big blind) collected (100)
Seat 2: Duke Croix (button) folded before Flop (didn't bet)
Seat 3: color_singleton (small blind) folded before Flop



PokerStars Home Game Hand #218537602135: {Club #3225207}  Hold'em No Limit (50/100) - 2020/09/17 15:24:30 ET
Table 'fun time' 9-max (Play Money) Seat #3 is the button
Seat 1: dddocky (8726 in chips) 
Seat 2: Duke Croix (9950 in chips) 
Seat 3: color_singleton (19135 in chips) 
dddocky: posts small blind 50
Duke Croix: posts big blind 100
*** HOLE CARDS ***
Dealt to Duke Croix [6c 5c]
color_singleton: calls 100
dddocky: calls 50
Duke Croix: raises 300 to 400
color_singleton: calls 300
dddocky: calls 300
*** FLOP *** [6d Qs 4c]
dddocky: checks 
Duke Croix: bets 600
color_singleton: calls 600
dddocky: folds 
*** TURN *** [6d Qs 4c] [Jh]
Duke Croix: checks 
color_singleton: bets 1134
Duke Croix: folds 
Uncalled bet (1134) returned to color_singleton
color_singleton collected 2268 from pot
color_singleton: doesn't show hand 
*** SUMMARY ***
Total pot 2400 | Rake 132 
Board [6d Qs 4c Jh]
Seat 1: dddocky (small blind) folded on the Flop
Seat 2: Duke Croix (big blind) folded on the Turn
Seat 3: color_singleton (button) collected (2268)



PokerStars Home Game Hand #218537639088: {Club #3225207}  Hold'em No Limit (50/100) - 2020/09/17 15:25:27 ET
Table 'fun time' 9-max (Play Money) Seat #1 is the button
Seat 1: dddocky (8326 in chips) 
Seat 2: Duke Croix (8950 in chips) 
Seat 3: color_singleton (20403 in chips) 
Seat 5: Klemtonius (8140 in chips) 
Duke Croix: posts small blind 50
color_singleton: posts big blind 100
Klemtonius: posts small & big blinds 150
*** HOLE CARDS ***
Dealt to Duke Croix [Kd Ks]
Klemtonius: checks 
dddocky: folds 
Duke Croix: raises 300 to 400
color_singleton: calls 300
Klemtonius: calls 300
*** FLOP *** [4c 8c 6c]
Duke Croix: bets 600
color_singleton: folds 
Klemtonius: calls 600
*** TURN *** [4c 8c 6c] [5d]
Duke Croix: checks 
Klemtonius: bets 2315
Duke Croix: folds 
Uncalled bet (2315) returned to Klemtonius
Klemtonius collected 2315 from pot
Klemtonius: doesn't show hand 
*** SUMMARY ***
Total pot 2450 | Rake 135 
Board [4c 8c 6c 5d]
Seat 1: dddocky (button) folded before Flop (didn't bet)
Seat 2: Duke Croix (small blind) folded on the Turn
Seat 3: color_singleton (big blind) folded on the Flop
Seat 5: Klemtonius collected (2315)



PokerStars Home Game Hand #218537673927: {Club #3225207}  Hold'em No Limit (50/100) - 2020/09/17 15:26:21 ET
Table 'fun time' 9-max (Play Money) Seat #2 is the button
Seat 1: dddocky (8326 in chips) 
Seat 2: Duke Croix (7950 in chips) 
Seat 3: color_singleton (20003 in chips) 
Seat 5: Klemtonius (9405 in chips) 
Seat 9: HighCardJasper (10079 in chips) 
color_singleton: posts small blind 50
Klemtonius: posts big blind 100
HighCardJasper: posts small & big blinds 150
*** HOLE CARDS ***
Dealt to Duke Croix [Jh 6s]
HighCardJasper: checks 
dddocky: calls 100
Duke Croix: folds 
color_singleton: folds 
Klemtonius: raises 100 to 200
HighCardJasper: folds 
dddocky: calls 100
*** FLOP *** [4h Qc Tc]
Klemtonius: bets 283
dddocky: calls 283
*** TURN *** [4h Qc Tc] [Ts]
Klemtonius: bets 551
dddocky: calls 551
*** RIVER *** [4h Qc Tc Ts] [3s]
Klemtonius: bets 100
dddocky: raises 2343 to 2443
Klemtonius: folds 
Uncalled bet (2343) returned to dddocky
dddocky collected 2332 from pot
dddocky: doesn't show hand 
*** SUMMARY ***
Total pot 2468 | Rake 136 
Board [4h Qc Tc Ts 3s]
Seat 1: dddocky collected (2332)
Seat 2: Duke Croix (button) folded before Flop (didn't bet)
Seat 3: color_singleton (small blind) folded before Flop
Seat 5: Klemtonius (big blind) folded on the River
Seat 9: HighCardJasper folded before Flop (didn't bet)



PokerStars Home Game Hand #218537706990: {Club #3225207}  Hold'em No Limit (50/100) - 2020/09/17 15:27:12 ET
Table 'fun time' 9-max (Play Money) Seat #3 is the button
Seat 1: dddocky (9524 in chips) 
Seat 2: Duke Croix (7950 in chips) 
Seat 3: color_singleton (19953 in chips) 
Seat 5: Klemtonius (8271 in chips) 
Seat 9: HighCardJasper (9929 in chips) 
Klemtonius: posts small blind 50
HighCardJasper: posts big blind 100
*** HOLE CARDS ***
Dealt to Duke Croix [4h Td]
dddocky: calls 100
Duke Croix: folds 
color_singleton: folds 
Klemtonius: raises 100 to 200
HighCardJasper: calls 100
dddocky: calls 100
*** FLOP *** [Ah Ks 2d]
Klemtonius: bets 567
HighCardJasper: folds 
dddocky: folds 
Uncalled bet (567) returned to Klemtonius
Klemtonius collected 567 from pot
Klemtonius: doesn't show hand 
*** SUMMARY ***
Total pot 600 | Rake 33 
Board [Ah Ks 2d]
Seat 1: dddocky folded on the Flop
Seat 2: Duke Croix folded before Flop (didn't bet)
Seat 3: color_singleton (button) folded before Flop (didn't bet)
Seat 5: Klemtonius (small blind) collected (567)
Seat 9: HighCardJasper (big blind) folded on the Flop



PokerStars Home Game Hand #218537725108: {Club #3225207}  Hold'em No Limit (50/100) - 2020/09/17 15:27:40 ET
Table 'fun time' 9-max (Play Money) Seat #5 is the button
Seat 1: dddocky (9324 in chips) 
Seat 2: Duke Croix (7950 in chips) 
Seat 3: color_singleton (19953 in chips) 
Seat 5: Klemtonius (8638 in chips) 
Seat 9: HighCardJasper (9729 in chips) 
HighCardJasper: posts small blind 50
dddocky: posts big blind 100
*** HOLE CARDS ***
Dealt to Duke Croix [4c 2s]
Duke Croix: folds 
color_singleton: folds 
Klemtonius: folds 
HighCardJasper: calls 50
dddocky: checks 
*** FLOP *** [6h 6d 9s]
HighCardJasper: checks 
dddocky: checks 
*** TURN *** [6h 6d 9s] [7s]
HighCardJasper: bets 100
dddocky: folds 
Uncalled bet (100) returned to HighCardJasper
HighCardJasper collected 189 from pot
HighCardJasper: doesn't show hand 
*** SUMMARY ***
Total pot 200 | Rake 11 
Board [6h 6d 9s 7s]
Seat 1: dddocky (big blind) folded on the Turn
Seat 2: Duke Croix folded before Flop (didn't bet)
Seat 3: color_singleton folded before Flop (didn't bet)
Seat 5: Klemtonius (button) folded before Flop (didn't bet)
Seat 9: HighCardJasper (small blind) collected (189)



PokerStars Home Game Hand #218537739620: {Club #3225207}  Hold'em No Limit (50/100) - 2020/09/17 15:28:02 ET
Table 'fun time' 9-max (Play Money) Seat #9 is the button
Seat 1: dddocky (9224 in chips) 
Seat 2: Duke Croix (7950 in chips) 
Seat 3: color_singleton (19953 in chips) 
Seat 5: Klemtonius (8638 in chips) 
Seat 9: HighCardJasper (9818 in chips) 
dddocky: posts small blind 50
Duke Croix: posts big blind 100
*** HOLE CARDS ***
Dealt to Duke Croix [2d 6d]
color_singleton: folds 
Klemtonius: calls 100
HighCardJasper: calls 100
dddocky: calls 50
Duke Croix: checks 
*** FLOP *** [Kc 7h 3h]
dddocky: checks 
Duke Croix: checks 
Klemtonius: checks 
HighCardJasper: checks 
*** TURN *** [Kc 7h 3h] [Tc]
dddocky: checks 
Duke Croix: checks 
Klemtonius: bets 100
HighCardJasper: calls 100
dddocky: calls 100
Duke Croix: folds 
*** RIVER *** [Kc 7h 3h Tc] [9h]
dddocky: checks 
Klemtonius: bets 330
HighCardJasper: calls 330
dddocky: folds 
*** SHOW DOWN ***
Klemtonius: shows [Td 5h] (a pair of Tens)
HighCardJasper: shows [Jd Th] (a pair of Tens - King+Jack kicker)
HighCardJasper collected 1285 from pot
*** SUMMARY ***
Total pot 1360 | Rake 75 
Board [Kc 7h 3h Tc 9h]
Seat 1: dddocky (small blind) folded on the River
Seat 2: Duke Croix (big blind) folded on the Turn
Seat 3: color_singleton folded before Flop (didn't bet)
Seat 5: Klemtonius showed [Td 5h] and lost with a pair of Tens
Seat 9: HighCardJasper (button) showed [Jd Th] and won (1285) with a pair of Tens



PokerStars Home Game Hand #218537776912: {Club #3225207}  Hold'em No Limit (50/100) - 2020/09/17 15:29:00 ET
Table 'fun time' 9-max (Play Money) Seat #1 is the button
Seat 1: dddocky (9024 in chips) 
Seat 2: Duke Croix (7850 in chips) 
Seat 3: color_singleton (19953 in chips) 
Seat 5: Klemtonius (8108 in chips) 
Seat 9: HighCardJasper (10573 in chips) 
Duke Croix: posts small blind 50
color_singleton: posts big blind 100
*** HOLE CARDS ***
Dealt to Duke Croix [2c 2s]
Klemtonius: calls 100
HighCardJasper: calls 100
dddocky: calls 100
Duke Croix: raises 300 to 400
color_singleton: calls 300
Klemtonius: folds 
HighCardJasper: folds 
dddocky: calls 300
*** FLOP *** [Ah 9h Jd]
Duke Croix: checks 
color_singleton: checks 
dddocky: checks 
*** TURN *** [Ah 9h Jd] [3s]
Duke Croix: bets 600
color_singleton: calls 600
dddocky: folds 
*** RIVER *** [Ah 9h Jd 3s] [Jh]
Duke Croix: checks 
color_singleton: bets 1228
Duke Croix: folds 
Uncalled bet (1228) returned to color_singleton
color_singleton collected 2457 from pot
color_singleton: doesn't show hand 
*** SUMMARY ***
Total pot 2600 | Rake 143 
Board [Ah 9h Jd 3s Jh]
Seat 1: dddocky (button) folded on the Turn
Seat 2: Duke Croix (small blind) folded on the River
Seat 3: color_singleton (big blind) collected (2457)
Seat 5: Klemtonius folded before Flop
Seat 9: HighCardJasper folded before Flop



PokerStars Home Game Hand #218537813412: {Club #3225207}  Hold'em No Limit (50/100) - 2020/09/17 15:29:56 ET
Table 'fun time' 9-max (Play Money) Seat #2 is the button
Seat 1: dddocky (8624 in chips) 
Seat 2: Duke Croix (6850 in chips) 
Seat 3: color_singleton (21410 in chips) 
Seat 5: Klemtonius (8008 in chips) 
Seat 9: HighCardJasper (10473 in chips) 
color_singleton: posts small blind 50
Klemtonius: posts big blind 100
*** HOLE CARDS ***
Dealt to Duke Croix [Ac Js]
HighCardJasper: calls 100
dddocky: calls 100
Duke Croix: raises 400 to 500
color_singleton: folds 
Klemtonius: calls 400
HighCardJasper: folds 
dddocky: calls 400
*** FLOP *** [7d 8d 6c]
Klemtonius: checks 
dddocky: checks 
Duke Croix: checks 
*** TURN *** [7d 8d 6c] [8h]
Klemtonius: checks 
dddocky: bets 100
Duke Croix: calls 100
Klemtonius: folds 
*** RIVER *** [7d 8d 6c 8h] [3s]
dddocky: bets 100
Duke Croix: folds 
Uncalled bet (100) returned to dddocky
dddocky collected 1748 from pot
dddocky: doesn't show hand 
*** SUMMARY ***
Total pot 1850 | Rake 102 
Board [7d 8d 6c 8h 3s]
Seat 1: dddocky collected (1748)
Seat 2: Duke Croix (button) folded on the River
Seat 3: color_singleton (small blind) folded before Flop
Seat 5: Klemtonius (big blind) folded on the Turn
Seat 9: HighCardJasper folded before Flop



PokerStars Home Game Hand #218537848751: {Club #3225207}  Hold'em No Limit (50/100) - 2020/09/17 15:30:51 ET
Table 'fun time' 9-max (Play Money) Seat #3 is the button
Seat 1: dddocky (9772 in chips) 
Seat 2: Duke Croix (6250 in chips) 
Seat 3: color_singleton (21360 in chips) 
Seat 5: Klemtonius (7508 in chips) 
Seat 9: HighCardJasper (10373 in chips) 
Klemtonius: posts small blind 50
HighCardJasper: posts big blind 100
*** HOLE CARDS ***
Dealt to Duke Croix [Kh Qs]
dddocky: folds 
Duke Croix: raises 300 to 400
color_singleton: calls 400
Klemtonius: folds 
HighCardJasper: calls 300
*** FLOP *** [Jd 4c 9c]
HighCardJasper: checks 
Duke Croix: checks 
color_singleton: checks 
*** TURN *** [Jd 4c 9c] [Kc]
HighCardJasper: bets 300
Duke Croix: raises 400 to 700
color_singleton: folds 
HighCardJasper: folds 
Uncalled bet (400) returned to Duke Croix
Duke Croix collected 1748 from pot
*** SUMMARY ***
Total pot 1850 | Rake 102 
Board [Jd 4c 9c Kc]
Seat 1: dddocky folded before Flop (didn't bet)
Seat 2: Duke Croix collected (1748)
Seat 3: color_singleton (button) folded on the Turn
Seat 5: Klemtonius (small blind) folded before Flop
Seat 9: HighCardJasper (big blind) folded on the Turn



PokerStars Home Game Hand #218537869973: {Club #3225207}  Hold'em No Limit (50/100) - 2020/09/17 15:31:24 ET
Table 'fun time' 9-max (Play Money) Seat #5 is the button
Seat 1: dddocky (9772 in chips) 
Seat 2: Duke Croix (7298 in chips) 
Seat 3: color_singleton (20960 in chips) 
Seat 5: Klemtonius (7458 in chips) 
Seat 9: HighCardJasper (9673 in chips) 
HighCardJasper: posts small blind 50
dddocky: posts big blind 100
*** HOLE CARDS ***
Dealt to Duke Croix [2h 4h]
Duke Croix: folds 
color_singleton: raises 200 to 300
Klemtonius: calls 300
HighCardJasper: folds 
dddocky: calls 200
*** FLOP *** [6h Kh 5d]
dddocky: bets 100
color_singleton: raises 100 to 200
Klemtonius: calls 200
dddocky: calls 100
*** TURN *** [6h Kh 5d] [3d]
dddocky: checks 
color_singleton: bets 732
Klemtonius: folds 
dddocky: calls 732
*** RIVER *** [6h Kh 5d 3d] [2c]
dddocky: checks 
color_singleton: checks 
*** SHOW DOWN ***
dddocky: shows [Jh 9h] (high card King)
color_singleton: shows [9d 9s] (a pair of Nines)
color_singleton collected 2848 from pot
*** SUMMARY ***
Total pot 3014 | Rake 166 
Board [6h Kh 5d 3d 2c]
Seat 1: dddocky (big blind) showed [Jh 9h] and lost with high card King
Seat 2: Duke Croix folded before Flop (didn't bet)
Seat 3: color_singleton showed [9d 9s] and won (2848) with a pair of Nines
Seat 5: Klemtonius (button) folded on the Turn
Seat 9: HighCardJasper (small blind) folded before Flop



PokerStars Home Game Hand #218537901619: {Club #3225207}  Hold'em No Limit (50/100) - 2020/09/17 15:32:13 ET
Table 'fun time' 9-max (Play Money) Seat #9 is the button
Seat 1: dddocky (8540 in chips) 
Seat 2: Duke Croix (7298 in chips) 
Seat 3: color_singleton (22576 in chips) 
Seat 5: Klemtonius (6958 in chips) 
Seat 9: HighCardJasper (9623 in chips) 
dddocky: posts small blind 50
Duke Croix: posts big blind 100
*** HOLE CARDS ***
Dealt to Duke Croix [Qh 5s]
color_singleton: folds 
Klemtonius: folds 
HighCardJasper: raises 100 to 200
dddocky: calls 150
Duke Croix: calls 100
*** FLOP *** [3c Td 7s]
dddocky: bets 567
Duke Croix: folds 
HighCardJasper: calls 567
*** TURN *** [3c Td 7s] [Kh]
dddocky: checks 
HighCardJasper: bets 500
dddocky: folds 
Uncalled bet (500) returned to HighCardJasper
HighCardJasper collected 1639 from pot
HighCardJasper: doesn't show hand 
*** SUMMARY ***
Total pot 1734 | Rake 95 
Board [3c Td 7s Kh]
Seat 1: dddocky (small blind) folded on the Turn
Seat 2: Duke Croix (big blind) folded on the Flop
Seat 3: color_singleton folded before Flop (didn't bet)
Seat 5: Klemtonius folded before Flop (didn't bet)
Seat 9: HighCardJasper (button) collected (1639)



PokerStars Home Game Hand #218537921818: {Club #3225207}  Hold'em No Limit (50/100) - 2020/09/17 15:32:45 ET
Table 'fun time' 9-max (Play Money) Seat #1 is the button
Seat 1: dddocky (7773 in chips) 
Seat 2: Duke Croix (7098 in chips) 
Seat 3: color_singleton (22576 in chips) 
Seat 5: Klemtonius (6958 in chips) 
Seat 9: HighCardJasper (10495 in chips) 
Duke Croix: posts small blind 50
color_singleton: posts big blind 100
*** HOLE CARDS ***
Dealt to Duke Croix [3h 4h]
Klemtonius: raises 332 to 432
HighCardJasper: folds 
dddocky: folds 
Duke Croix: calls 382
color_singleton: folds 
*** FLOP *** [4s Ac Th]
Duke Croix: checks 
Klemtonius: bets 455
Duke Croix: folds 
Uncalled bet (455) returned to Klemtonius
Klemtonius collected 911 from pot
Klemtonius: doesn't show hand 
*** SUMMARY ***
Total pot 964 | Rake 53 
Board [4s Ac Th]
Seat 1: dddocky (button) folded before Flop (didn't bet)
Seat 2: Duke Croix (small blind) folded on the Flop
Seat 3: color_singleton (big blind) folded before Flop
Seat 5: Klemtonius collected (911)
Seat 9: HighCardJasper folded before Flop (didn't bet)



PokerStars Home Game Hand #218537940436: {Club #3225207}  Hold'em No Limit (50/100) - 2020/09/17 15:33:14 ET
Table 'fun time' 9-max (Play Money) Seat #2 is the button
Seat 1: dddocky (7773 in chips) 
Seat 2: Duke Croix (6666 in chips) 
Seat 3: color_singleton (22476 in chips) 
Seat 5: Klemtonius (7437 in chips) 
Seat 9: HighCardJasper (10495 in chips) 
color_singleton: posts small blind 50
Klemtonius: posts big blind 100
*** HOLE CARDS ***
Dealt to Duke Croix [Ac 7h]
HighCardJasper: calls 100
dddocky: calls 100
Duke Croix: calls 100
color_singleton: calls 50
Klemtonius: raises 100 to 200
HighCardJasper: calls 100
dddocky: calls 100
Duke Croix: calls 100
color_singleton: calls 100
*** FLOP *** [9c Jc 6c]
color_singleton: checks 
Klemtonius: bets 945
HighCardJasper: folds 
dddocky: folds 
Duke Croix: calls 945
color_singleton: folds 
*** TURN *** [9c Jc 6c] [2s]
Klemtonius: bets 2731
Duke Croix: folds 
Uncalled bet (2731) returned to Klemtonius
Klemtonius collected 2731 from pot
Klemtonius: doesn't show hand 
*** SUMMARY ***
Total pot 2890 | Rake 159 
Board [9c Jc 6c 2s]
Seat 1: dddocky folded on the Flop
Seat 2: Duke Croix (button) folded on the Turn
Seat 3: color_singleton (small blind) folded on the Flop
Seat 5: Klemtonius (big blind) collected (2731)
Seat 9: HighCardJasper folded on the Flop



PokerStars Home Game Hand #218537985399: {Club #3225207}  Hold'em No Limit (50/100) - 2020/09/17 15:34:24 ET
Table 'fun time' 9-max (Play Money) Seat #3 is the button
Seat 1: dddocky (7573 in chips) 
Seat 2: Duke Croix (5521 in chips) 
Seat 3: color_singleton (22276 in chips) 
Seat 5: Klemtonius (9023 in chips) 
Seat 9: HighCardJasper (10295 in chips) 
Klemtonius: posts small blind 50
HighCardJasper: posts big blind 100
*** HOLE CARDS ***
Dealt to Duke Croix [Jd 5s]
dddocky: folds 
Duke Croix: folds 
color_singleton: folds 
Klemtonius: calls 50
HighCardJasper: checks 
*** FLOP *** [6c Jc 6s]
Klemtonius: checks 
HighCardJasper: checks 
*** TURN *** [6c Jc 6s] [5d]
Klemtonius: checks 
HighCardJasper: checks 
*** RIVER *** [6c Jc 6s 5d] [9d]
Klemtonius: checks 
HighCardJasper: checks 
*** SHOW DOWN ***
Klemtonius: shows [7d 2c] (a pair of Sixes)
HighCardJasper: shows [Ad 8c] (a pair of Sixes - Ace kicker)
HighCardJasper collected 189 from pot
*** SUMMARY ***
Total pot 200 | Rake 11 
Board [6c Jc 6s 5d 9d]
Seat 1: dddocky folded before Flop (didn't bet)
Seat 2: Duke Croix folded before Flop (didn't bet)
Seat 3: color_singleton (button) folded before Flop (didn't bet)
Seat 5: Klemtonius (small blind) showed [7d 2c] and lost with a pair of Sixes
Seat 9: HighCardJasper (big blind) showed [Ad 8c] and won (189) with a pair of Sixes



PokerStars Home Game Hand #218538009571: {Club #3225207}  Hold'em No Limit (50/100) - 2020/09/17 15:35:02 ET
Table 'fun time' 9-max (Play Money) Seat #5 is the button
Seat 1: dddocky (7573 in chips) 
Seat 2: Duke Croix (5521 in chips) 
Seat 3: color_singleton (22276 in chips) 
Seat 5: Klemtonius (8923 in chips) 
Seat 9: HighCardJasper (10384 in chips) 
HighCardJasper: posts small blind 50
dddocky: posts big blind 100
*** HOLE CARDS ***
Dealt to Duke Croix [Tc Ac]
Duke Croix: raises 300 to 400
color_singleton: folds 
Klemtonius: folds 
HighCardJasper: folds 
dddocky: folds 
Uncalled bet (300) returned to Duke Croix
Duke Croix collected 250 from pot
*** SUMMARY ***
Total pot 250 | Rake 0 
Seat 1: dddocky (big blind) folded before Flop
Seat 2: Duke Croix collected (250)
Seat 3: color_singleton folded before Flop (didn't bet)
Seat 5: Klemtonius (button) folded before Flop (didn't bet)
Seat 9: HighCardJasper (small blind) folded before Flop



PokerStars Home Game Hand #218538022610: {Club #3225207}  Hold'em No Limit (50/100) - 2020/09/17 15:35:22 ET
Table 'fun time' 9-max (Play Money) Seat #9 is the button
Seat 1: dddocky (7473 in chips) 
Seat 2: Duke Croix (5671 in chips) 
Seat 3: color_singleton (22276 in chips) 
Seat 5: Klemtonius (8923 in chips) 
Seat 9: HighCardJasper (10334 in chips) 
dddocky: posts small blind 50
Duke Croix: posts big blind 100
*** HOLE CARDS ***
Dealt to Duke Croix [4d 3d]
color_singleton: raises 100 to 200
Klemtonius: calls 200
HighCardJasper: folds 
dddocky: calls 150
Duke Croix: calls 100
*** FLOP *** [2c Qd Jh]
dddocky: checks 
Duke Croix: checks 
color_singleton: checks 
Klemtonius: checks 
*** TURN *** [2c Qd Jh] [Ah]
dddocky: checks 
Duke Croix: checks 
color_singleton: checks 
Klemtonius: checks 
*** RIVER *** [2c Qd Jh Ah] [6d]
dddocky: checks 
Duke Croix: checks 
color_singleton: checks 
Klemtonius: checks 
*** SHOW DOWN ***
dddocky: shows [9d Ks] (high card Ace)
Duke Croix: mucks hand 
color_singleton: mucks hand 
Klemtonius: mucks hand 
dddocky collected 756 from pot
*** SUMMARY ***
Total pot 800 | Rake 44 
Board [2c Qd Jh Ah 6d]
Seat 1: dddocky (small blind) showed [9d Ks] and won (756) with high card Ace
Seat 2: Duke Croix (big blind) mucked [4d 3d]
Seat 3: color_singleton mucked [9c 7c]
Seat 5: Klemtonius mucked [Kd 3h]
Seat 9: HighCardJasper (button) folded before Flop (didn't bet)



PokerStars Home Game Hand #218538076161: {Club #3225207}  Hold'em No Limit (50/100) - 2020/09/17 15:36:46 ET
Table 'fun time' 9-max (Play Money) Seat #1 is the button
Seat 1: dddocky (8029 in chips) 
Seat 2: Duke Croix (5471 in chips) 
Seat 3: color_singleton (22076 in chips) 
Seat 5: Klemtonius (8723 in chips) 
Seat 9: HighCardJasper (10334 in chips) 
Duke Croix: posts small blind 50
color_singleton: posts big blind 100
*** HOLE CARDS ***
Dealt to Duke Croix [Kh 7c]
Klemtonius: calls 100
HighCardJasper: calls 100
dddocky: calls 100
Duke Croix: calls 50
color_singleton: checks 
*** FLOP *** [6d 2c Td]
Duke Croix: checks 
color_singleton: checks 
Klemtonius: checks 
HighCardJasper: checks 
dddocky: bets 100
Duke Croix: folds 
color_singleton: calls 100
Klemtonius: calls 100
HighCardJasper: calls 100
*** TURN *** [6d 2c Td] [Qs]
color_singleton: checks 
Klemtonius: checks 
HighCardJasper: checks 
dddocky: bets 200
color_singleton: calls 200
Klemtonius: folds 
HighCardJasper: folds 
*** RIVER *** [6d 2c Td Qs] [4s]
color_singleton: checks 
dddocky: bets 1228
color_singleton: folds 
Uncalled bet (1228) returned to dddocky
dddocky collected 1228 from pot
dddocky: doesn't show hand 
*** SUMMARY ***
Total pot 1300 | Rake 72 
Board [6d 2c Td Qs 4s]
Seat 1: dddocky (button) collected (1228)
Seat 2: Duke Croix (small blind) folded on the Flop
Seat 3: color_singleton (big blind) folded on the River
Seat 5: Klemtonius folded on the Turn
Seat 9: HighCardJasper folded on the Turn



PokerStars Home Game Hand #218538118557: {Club #3225207}  Hold'em No Limit (50/100) - 2020/09/17 15:37:48 ET
Table 'fun time' 9-max (Play Money) Seat #2 is the button
Seat 1: dddocky (8857 in chips) 
Seat 2: Duke Croix (5371 in chips) 
Seat 3: color_singleton (21676 in chips) 
Seat 5: Klemtonius (8523 in chips) 
Seat 9: HighCardJasper (10134 in chips) 
color_singleton: posts small blind 50
Klemtonius: posts big blind 100
*** HOLE CARDS ***
Dealt to Duke Croix [7h Qs]
HighCardJasper: raises 100 to 200
dddocky: folds 
Duke Croix: folds 
color_singleton: calls 150
Klemtonius: calls 100
*** FLOP *** [3h 5c 4h]
color_singleton: bets 283
Klemtonius: calls 283
HighCardJasper: calls 283
*** TURN *** [3h 5c 4h] [6d]
color_singleton: checks 
Klemtonius: bets 684
HighCardJasper: folds 
color_singleton: folds 
Uncalled bet (684) returned to Klemtonius
Klemtonius collected 1369 from pot
Klemtonius: doesn't show hand 
*** SUMMARY ***
Total pot 1449 | Rake 80 
Board [3h 5c 4h 6d]
Seat 1: dddocky folded before Flop (didn't bet)
Seat 2: Duke Croix (button) folded before Flop (didn't bet)
Seat 3: color_singleton (small blind) folded on the Turn
Seat 5: Klemtonius (big blind) collected (1369)
Seat 9: HighCardJasper folded on the Turn



PokerStars Home Game Hand #218538152121: {Club #3225207}  Hold'em No Limit (50/100) - 2020/09/17 15:38:40 ET
Table 'fun time' 9-max (Play Money) Seat #3 is the button
Seat 1: dddocky (8857 in chips) 
Seat 2: Duke Croix (5371 in chips) 
Seat 3: color_singleton (21193 in chips) 
Seat 5: Klemtonius (9409 in chips) 
Seat 9: HighCardJasper (9651 in chips) 
Klemtonius: posts small blind 50
HighCardJasper: posts big blind 100
*** HOLE CARDS ***
Dealt to Duke Croix [9h 6h]
dddocky: calls 100
Duke Croix: folds 
color_singleton: folds 
Klemtonius: calls 50
HighCardJasper: checks 
*** FLOP *** [Qh 7c Ah]
Klemtonius: checks 
HighCardJasper: checks 
dddocky: bets 200
Klemtonius: folds 
HighCardJasper: folds 
Uncalled bet (200) returned to dddocky
dddocky collected 283 from pot
dddocky: doesn't show hand 
*** SUMMARY ***
Total pot 300 | Rake 17 
Board [Qh 7c Ah]
Seat 1: dddocky collected (283)
Seat 2: Duke Croix folded before Flop (didn't bet)
Seat 3: color_singleton (button) folded before Flop (didn't bet)
Seat 5: Klemtonius (small blind) folded on the Flop
Seat 9: HighCardJasper (big blind) folded on the Flop



PokerStars Home Game Hand #218538181523: {Club #3225207}  Hold'em No Limit (50/100) - 2020/09/17 15:39:26 ET
Table 'fun time' 9-max (Play Money) Seat #5 is the button
Seat 1: dddocky (9040 in chips) 
Seat 2: Duke Croix (5371 in chips) 
Seat 3: color_singleton (21193 in chips) 
Seat 5: Klemtonius (9309 in chips) 
Seat 9: HighCardJasper (9551 in chips) 
HighCardJasper: posts small blind 50
dddocky: posts big blind 100
*** HOLE CARDS ***
Dealt to Duke Croix [Ts 5s]
Duke Croix: folds 
color_singleton: raises 200 to 300
Klemtonius: calls 300
HighCardJasper: calls 250
dddocky: calls 200
*** FLOP *** [Qs Tc 5c]
HighCardJasper: checks 
dddocky: checks 
color_singleton: checks 
Klemtonius: bets 100
HighCardJasper: calls 100
dddocky: calls 100
color_singleton: calls 100
*** TURN *** [Qs Tc 5c] [Ac]
HighCardJasper: checks 
dddocky: checks 
color_singleton: checks 
Klemtonius: bets 756
HighCardJasper: folds 
dddocky: folds 
color_singleton: folds 
Uncalled bet (756) returned to Klemtonius
Klemtonius collected 1512 from pot
Klemtonius: doesn't show hand 
*** SUMMARY ***
Total pot 1600 | Rake 88 
Board [Qs Tc 5c Ac]
Seat 1: dddocky (big blind) folded on the Turn
Seat 2: Duke Croix folded before Flop (didn't bet)
Seat 3: color_singleton folded on the Turn
Seat 5: Klemtonius (button) collected (1512)
Seat 9: HighCardJasper (small blind) folded on the Turn



PokerStars Home Game Hand #218538229500: {Club #3225207}  Hold'em No Limit (50/100) - 2020/09/17 15:40:40 ET
Table 'fun time' 9-max (Play Money) Seat #9 is the button
Seat 1: dddocky (8640 in chips) 
Seat 2: Duke Croix (5371 in chips) 
Seat 3: color_singleton (20793 in chips) 
Seat 5: Klemtonius (10421 in chips) 
Seat 9: HighCardJasper (9151 in chips) 
dddocky: posts small blind 50
Duke Croix: posts big blind 100
*** HOLE CARDS ***
Dealt to Duke Croix [9d 4h]
color_singleton: raises 100 to 200
Klemtonius: folds 
HighCardJasper: calls 200
dddocky: folds 
Duke Croix: calls 100
*** FLOP *** [Ah 2h Kd]
Duke Croix: checks 
color_singleton: bets 307
HighCardJasper: folds 
Duke Croix: folds 
Uncalled bet (307) returned to color_singleton
color_singleton collected 614 from pot
color_singleton: doesn't show hand 
*** SUMMARY ***
Total pot 650 | Rake 36 
Board [Ah 2h Kd]
Seat 1: dddocky (small blind) folded before Flop
Seat 2: Duke Croix (big blind) folded on the Flop
Seat 3: color_singleton collected (614)
Seat 5: Klemtonius folded before Flop (didn't bet)
Seat 9: HighCardJasper (button) folded on the Flop



PokerStars Home Game Hand #218538250960: {Club #3225207}  Hold'em No Limit (50/100) - 2020/09/17 15:41:13 ET
Table 'fun time' 9-max (Play Money) Seat #1 is the button
Seat 1: dddocky (8590 in chips) 
Seat 2: Duke Croix (5171 in chips) 
Seat 3: color_singleton (21207 in chips) 
Seat 5: Klemtonius (10421 in chips) 
Seat 9: HighCardJasper (8951 in chips) 
Duke Croix: posts small blind 50
color_singleton: posts big blind 100
*** HOLE CARDS ***
Dealt to Duke Croix [5c As]
Klemtonius: calls 100
HighCardJasper: folds 
dddocky: calls 100
Duke Croix: calls 50
color_singleton: checks 
*** FLOP *** [6h 5h 4s]
Duke Croix: bets 200
color_singleton: calls 200
Klemtonius: calls 200
dddocky: calls 200
*** TURN *** [6h 5h 4s] [2h]
Duke Croix: checks 
color_singleton: checks 
Klemtonius: checks 
dddocky: bets 300
Duke Croix: folds 
color_singleton: folds 
Klemtonius: calls 300
*** RIVER *** [6h 5h 4s 2h] [8d]
Klemtonius: bets 1701
dddocky: calls 1701
*** SHOW DOWN ***
Klemtonius: shows [Ks 5d] (a pair of Fives)
dddocky: shows [6s Kd] (a pair of Sixes)
dddocky collected 4916 from pot
*** SUMMARY ***
Total pot 5202 | Rake 286 
Board [6h 5h 4s 2h 8d]
Seat 1: dddocky (button) showed [6s Kd] and won (4916) with a pair of Sixes
Seat 2: Duke Croix (small blind) folded on the Turn
Seat 3: color_singleton (big blind) folded on the Turn
Seat 5: Klemtonius showed [Ks 5d] and lost with a pair of Fives
Seat 9: HighCardJasper folded before Flop (didn't bet)



PokerStars Home Game Hand #218538296938: {Club #3225207}  Hold'em No Limit (50/100) - 2020/09/17 15:42:25 ET
Table 'fun time' 9-max (Play Money) Seat #2 is the button
Seat 1: dddocky (11205 in chips) 
Seat 2: Duke Croix (4871 in chips) 
Seat 3: color_singleton (20907 in chips) 
Seat 5: Klemtonius (8120 in chips) 
Seat 9: HighCardJasper (8951 in chips) 
color_singleton: posts small blind 50
Klemtonius: posts big blind 100
*** HOLE CARDS ***
Dealt to Duke Croix [Kc Jh]
HighCardJasper: raises 100 to 200
dddocky: folds 
Duke Croix: raises 300 to 500
color_singleton: calls 450
Klemtonius: folds 
HighCardJasper: calls 300
*** FLOP *** [6h 4h 7s]
color_singleton: checks 
HighCardJasper: checks 
Duke Croix: checks 
*** TURN *** [6h 4h 7s] [5d]
color_singleton: checks 
HighCardJasper: checks 
Duke Croix: bets 800
color_singleton: folds 
HighCardJasper: calls 800
*** RIVER *** [6h 4h 7s 5d] [Ts]
HighCardJasper: checks 
Duke Croix: checks 
*** SHOW DOWN ***
HighCardJasper: shows [8s 8h] (a straight, Four to Eight)
Duke Croix: mucks hand 
HighCardJasper collected 3024 from pot
*** SUMMARY ***
Total pot 3200 | Rake 176 
Board [6h 4h 7s 5d Ts]
Seat 1: dddocky folded before Flop (didn't bet)
Seat 2: Duke Croix (button) mucked [Kc Jh]
Seat 3: color_singleton (small blind) folded on the Turn
Seat 5: Klemtonius (big blind) folded before Flop
Seat 9: HighCardJasper showed [8s 8h] and won (3024) with a straight, Four to Eight



PokerStars Home Game Hand #218538337687: {Club #3225207}  Hold'em No Limit (50/100) - 2020/09/17 15:43:28 ET
Table 'fun time' 9-max (Play Money) Seat #3 is the button
Seat 1: dddocky (11205 in chips) 
Seat 2: Duke Croix (3571 in chips) 
Seat 3: color_singleton (20407 in chips) 
Seat 5: Klemtonius (8020 in chips) 
Seat 9: HighCardJasper (10675 in chips) 
Klemtonius: posts small blind 50
HighCardJasper: posts big blind 100
*** HOLE CARDS ***
Dealt to Duke Croix [7h 9d]
dddocky: folds 
Duke Croix: folds 
color_singleton: folds 
Klemtonius: calls 50
HighCardJasper: checks 
*** FLOP *** [Tc Ks 9h]
Klemtonius: bets 189
HighCardJasper: calls 189
*** TURN *** [Tc Ks 9h] [5d]
Klemtonius: checks 
HighCardJasper: checks 
*** RIVER *** [Tc Ks 9h 5d] [Kc]
Klemtonius: bets 546
HighCardJasper: folds 
Uncalled bet (546) returned to Klemtonius
Klemtonius collected 546 from pot
Klemtonius: doesn't show hand 
*** SUMMARY ***
Total pot 578 | Rake 32 
Board [Tc Ks 9h 5d Kc]
Seat 1: dddocky folded before Flop (didn't bet)
Seat 2: Duke Croix folded before Flop (didn't bet)
Seat 3: color_singleton (button) folded before Flop (didn't bet)
Seat 5: Klemtonius (small blind) collected (546)
Seat 9: HighCardJasper (big blind) folded on the River



PokerStars Home Game Hand #218538360919: {Club #3225207}  Hold'em No Limit (50/100) - 2020/09/17 15:44:04 ET
Table 'fun time' 9-max (Play Money) Seat #5 is the button
Seat 1: dddocky (11205 in chips) 
Seat 2: Duke Croix (3571 in chips) 
Seat 3: color_singleton (20407 in chips) 
Seat 5: Klemtonius (8277 in chips) 
Seat 9: HighCardJasper (10386 in chips) 
HighCardJasper: posts small blind 50
dddocky: posts big blind 100
*** HOLE CARDS ***
Dealt to Duke Croix [9c Th]
Duke Croix: calls 100
color_singleton: raises 100 to 200
Klemtonius: folds 
HighCardJasper: calls 150
dddocky: calls 100
Duke Croix: calls 100
*** FLOP *** [Kc 4c Ac]
HighCardJasper: checks 
dddocky: bets 700
Duke Croix: folds 
color_singleton: folds 
HighCardJasper: folds 
Uncalled bet (700) returned to dddocky
dddocky collected 756 from pot
dddocky: doesn't show hand 
*** SUMMARY ***
Total pot 800 | Rake 44 
Board [Kc 4c Ac]
Seat 1: dddocky (big blind) collected (756)
Seat 2: Duke Croix folded on the Flop
Seat 3: color_singleton folded on the Flop
Seat 5: Klemtonius (button) folded before Flop (didn't bet)
Seat 9: HighCardJasper (small blind) folded on the Flop



PokerStars Home Game Hand #218538380050: {Club #3225207}  Hold'em No Limit (50/100) - 2020/09/17 15:44:34 ET
Table 'fun time' 9-max (Play Money) Seat #9 is the button
Seat 1: dddocky (11761 in chips) 
Seat 2: Duke Croix (3371 in chips) 
Seat 3: color_singleton (20207 in chips) 
Seat 5: Klemtonius (8277 in chips) 
Seat 9: HighCardJasper (10186 in chips) 
dddocky: posts small blind 50
Duke Croix: posts big blind 100
*** HOLE CARDS ***
Dealt to Duke Croix [Qd 7d]
color_singleton: folds 
Klemtonius: calls 100
HighCardJasper: calls 100
dddocky: calls 50
Duke Croix: checks 
*** FLOP *** [2d Qc 3d]
dddocky: checks 
Duke Croix: bets 300
Klemtonius: folds 
HighCardJasper: folds 
dddocky: folds 
Uncalled bet (300) returned to Duke Croix
Duke Croix collected 378 from pot
*** SUMMARY ***
Total pot 400 | Rake 22 
Board [2d Qc 3d]
Seat 1: dddocky (small blind) folded on the Flop
Seat 2: Duke Croix (big blind) collected (378)
Seat 3: color_singleton folded before Flop (didn't bet)
Seat 5: Klemtonius folded on the Flop
Seat 9: HighCardJasper (button) folded on the Flop



PokerStars Home Game Hand #218538401702: {Club #3225207}  Hold'em No Limit (50/100) - 2020/09/17 15:45:08 ET
Table 'fun time' 9-max (Play Money) Seat #1 is the button
Seat 1: dddocky (11661 in chips) 
Seat 2: Duke Croix (3649 in chips) 
Seat 3: color_singleton (20207 in chips) 
Seat 5: Klemtonius (8177 in chips) 
Seat 9: HighCardJasper (10086 in chips) 
Duke Croix: posts small blind 50
color_singleton: posts big blind 100
*** HOLE CARDS ***
Dealt to Duke Croix [4c 6h]
Klemtonius: folds 
HighCardJasper: calls 100
dddocky: calls 100
Duke Croix: calls 50
color_singleton: checks 
*** FLOP *** [Qs 6c 5c]
Duke Croix: bets 200
color_singleton: folds 
HighCardJasper: calls 200
dddocky: folds 
*** TURN *** [Qs 6c 5c] [5d]
Duke Croix: checks 
HighCardJasper: checks 
*** RIVER *** [Qs 6c 5c 5d] [Tc]
Duke Croix: checks 
HighCardJasper: checks 
*** SHOW DOWN ***
Duke Croix: shows [4c 6h] (two pair, Sixes and Fives)
HighCardJasper: shows [2d Th] (two pair, Tens and Fives)
HighCardJasper collected 756 from pot
*** SUMMARY ***
Total pot 800 | Rake 44 
Board [Qs 6c 5c 5d Tc]
Seat 1: dddocky (button) folded on the Flop
Seat 2: Duke Croix (small blind) showed [4c 6h] and lost with two pair, Sixes and Fives
Seat 3: color_singleton (big blind) folded on the Flop
Seat 5: Klemtonius folded before Flop (didn't bet)
Seat 9: HighCardJasper showed [2d Th] and won (756) with two pair, Tens and Fives



PokerStars Home Game Hand #218538425514: {Club #3225207}  Hold'em No Limit (50/100) - 2020/09/17 15:45:45 ET
Table 'fun time' 9-max (Play Money) Seat #2 is the button
Seat 1: dddocky (11561 in chips) 
Seat 2: Duke Croix (3349 in chips) 
Seat 3: color_singleton (20107 in chips) 
Seat 5: Klemtonius (8177 in chips) 
Seat 9: HighCardJasper (10542 in chips) 
color_singleton: posts small blind 50
Klemtonius: posts big blind 100
*** HOLE CARDS ***
Dealt to Duke Croix [4d 9c]
HighCardJasper: calls 100
dddocky: calls 100
Duke Croix: folds 
color_singleton: calls 50
Klemtonius: raises 233 to 333
HighCardJasper: folds 
dddocky: folds 
color_singleton: calls 233
*** FLOP *** [9h 6d 4h]
color_singleton: bets 409
Klemtonius: calls 409
*** TURN *** [9h 6d 4h] [Js]
color_singleton: checks 
Klemtonius: bets 795
color_singleton: folds 
Uncalled bet (795) returned to Klemtonius
Klemtonius collected 1591 from pot
Klemtonius: doesn't show hand 
*** SUMMARY ***
Total pot 1684 | Rake 93 
Board [9h 6d 4h Js]
Seat 1: dddocky folded before Flop
Seat 2: Duke Croix (button) folded before Flop (didn't bet)
Seat 3: color_singleton (small blind) folded on the Turn
Seat 5: Klemtonius (big blind) collected (1591)
Seat 9: HighCardJasper folded before Flop



PokerStars Home Game Hand #218538464032: {Club #3225207}  Hold'em No Limit (50/100) - 2020/09/17 15:46:45 ET
Table 'fun time' 9-max (Play Money) Seat #3 is the button
Seat 1: dddocky (11461 in chips) 
Seat 2: Duke Croix (3349 in chips) 
Seat 3: color_singleton (19365 in chips) 
Seat 5: Klemtonius (9026 in chips) 
Seat 9: HighCardJasper (10442 in chips) 
Klemtonius: posts small blind 50
HighCardJasper: posts big blind 100
*** HOLE CARDS ***
Dealt to Duke Croix [3d 8h]
dddocky: calls 100
Duke Croix has timed out
Duke Croix: folds 
color_singleton: calls 100
Klemtonius: calls 50
HighCardJasper: checks 
*** FLOP *** [Ah 5d Ks]
Klemtonius: checks 
HighCardJasper: checks 
dddocky: checks 
color_singleton: checks 
*** TURN *** [Ah 5d Ks] [2c]
Klemtonius: checks 
HighCardJasper: checks 
dddocky: checks 
color_singleton: checks 
*** RIVER *** [Ah 5d Ks 2c] [8c]
Klemtonius: checks 
HighCardJasper: bets 200
dddocky: folds 
color_singleton: folds 
Klemtonius: folds 
Uncalled bet (200) returned to HighCardJasper
HighCardJasper collected 378 from pot
HighCardJasper: doesn't show hand 
*** SUMMARY ***
Total pot 400 | Rake 22 
Board [Ah 5d Ks 2c 8c]
Seat 1: dddocky folded on the River
Seat 2: Duke Croix folded before Flop (didn't bet)
Seat 3: color_singleton (button) folded on the River
Seat 5: Klemtonius (small blind) folded on the River
Seat 9: HighCardJasper (big blind) collected (378)



PokerStars Home Game Hand #218538513419: {Club #3225207}  Hold'em No Limit (50/100) - 2020/09/17 15:47:59 ET
Table 'fun time' 9-max (Play Money) Seat #5 is the button
Seat 1: dddocky (11361 in chips) 
Seat 2: Duke Croix (3349 in chips) 
Seat 3: color_singleton (19265 in chips) 
Seat 5: Klemtonius (8926 in chips) 
Seat 9: HighCardJasper (10720 in chips) 
HighCardJasper: posts small blind 50
dddocky: posts big blind 100
*** HOLE CARDS ***
Dealt to Duke Croix [4d 8h]
Duke Croix: folds 
color_singleton: raises 200 to 300
Klemtonius: folds 
HighCardJasper: calls 250
dddocky: calls 200
*** FLOP *** [3h 6h 5d]
HighCardJasper: checks 
dddocky: bets 200
color_singleton: calls 200
HighCardJasper: calls 200
*** TURN *** [3h 6h 5d] [7s]
HighCardJasper: checks 
dddocky: bets 708
color_singleton: folds 
HighCardJasper: folds 
Uncalled bet (708) returned to dddocky
dddocky collected 1417 from pot
dddocky: doesn't show hand 
*** SUMMARY ***
Total pot 1500 | Rake 83 
Board [3h 6h 5d 7s]
Seat 1: dddocky (big blind) collected (1417)
Seat 2: Duke Croix folded before Flop (didn't bet)
Seat 3: color_singleton folded on the Turn
Seat 5: Klemtonius (button) folded before Flop (didn't bet)
Seat 9: HighCardJasper (small blind) folded on the Turn



PokerStars Home Game Hand #218538539938: {Club #3225207}  Hold'em No Limit (50/100) - 2020/09/17 15:48:41 ET
Table 'fun time' 9-max (Play Money) Seat #9 is the button
Seat 1: dddocky (12278 in chips) 
Seat 2: Duke Croix (3349 in chips) 
Seat 3: color_singleton (18765 in chips) 
Seat 5: Klemtonius (8926 in chips) 
Seat 9: HighCardJasper (10220 in chips) 
dddocky: posts small blind 50
Duke Croix: posts big blind 100
*** HOLE CARDS ***
Dealt to Duke Croix [Jc 6h]
color_singleton: folds 
Klemtonius: raises 677 to 777
HighCardJasper: folds 
dddocky: folds 
Duke Croix: folds 
Uncalled bet (677) returned to Klemtonius
Klemtonius collected 250 from pot
Klemtonius: doesn't show hand 
*** SUMMARY ***
Total pot 250 | Rake 0 
Seat 1: dddocky (small blind) folded before Flop
Seat 2: Duke Croix (big blind) folded before Flop
Seat 3: color_singleton folded before Flop (didn't bet)
Seat 5: Klemtonius collected (250)
Seat 9: HighCardJasper (button) folded before Flop (didn't bet)



PokerStars Home Game Hand #218538553700: {Club #3225207}  Hold'em No Limit (50/100) - 2020/09/17 15:49:02 ET
Table 'fun time' 9-max (Play Money) Seat #1 is the button
Seat 1: dddocky (12228 in chips) 
Seat 2: Duke Croix (3249 in chips) 
Seat 3: color_singleton (18765 in chips) 
Seat 5: Klemtonius (9076 in chips) 
Seat 9: HighCardJasper (10220 in chips) 
Duke Croix: posts small blind 50
color_singleton: posts big blind 100
*** HOLE CARDS ***
Dealt to Duke Croix [7h 5d]
Klemtonius: raises 677 to 777
HighCardJasper: folds 
dddocky: folds 
Duke Croix: folds 
color_singleton has timed out
color_singleton: folds 
Uncalled bet (677) returned to Klemtonius
Klemtonius collected 250 from pot
Klemtonius: doesn't show hand 
*** SUMMARY ***
Total pot 250 | Rake 0 
Seat 1: dddocky (button) folded before Flop (didn't bet)
Seat 2: Duke Croix (small blind) folded before Flop
Seat 3: color_singleton (big blind) folded before Flop
Seat 5: Klemtonius collected (250)
Seat 9: HighCardJasper folded before Flop (didn't bet)



PokerStars Home Game Hand #218538573587: {Club #3225207}  Hold'em No Limit (50/100) - 2020/09/17 15:49:34 ET
Table 'fun time' 9-max (Play Money) Seat #2 is the button
Seat 1: dddocky (12228 in chips) 
Seat 2: Duke Croix (3199 in chips) 
Seat 5: Klemtonius (9226 in chips) 
Seat 9: HighCardJasper (10220 in chips) 
Klemtonius: posts small blind 50
HighCardJasper: posts big blind 100
*** HOLE CARDS ***
Dealt to Duke Croix [9c 4h]
dddocky: calls 100
Duke Croix: folds 
Klemtonius: raises 122 to 222
HighCardJasper: calls 122
dddocky: calls 122
*** FLOP *** [3h 7s 8s]
Klemtonius: checks 
HighCardJasper: checks 
dddocky: bets 100
Klemtonius: calls 100
HighCardJasper: calls 100
*** TURN *** [3h 7s 8s] [2d]
Klemtonius: checks 
HighCardJasper: checks 
dddocky: bets 300
Klemtonius: calls 300
HighCardJasper: folds 
*** RIVER *** [3h 7s 8s 2d] [Qd]
Klemtonius: checks 
dddocky: bets 740
Klemtonius: raises 3360 to 4100
dddocky: calls 3360
*** SHOW DOWN ***
Klemtonius: shows [2c 2s] (three of a kind, Deuces)
dddocky: mucks hand 
Klemtonius collected 9229 from pot
*** SUMMARY ***
Total pot 9766 | Rake 537 
Board [3h 7s 8s 2d Qd]
Seat 1: dddocky mucked [7d 3d]
Seat 2: Duke Croix (button) folded before Flop (didn't bet)
Seat 5: Klemtonius (small blind) showed [2c 2s] and won (9229) with three of a kind, Deuces
Seat 9: HighCardJasper (big blind) folded on the Turn



PokerStars Home Game Hand #218538627727: {Club #3225207}  Hold'em No Limit (50/100) - 2020/09/17 15:51:00 ET
Table 'fun time' 9-max (Play Money) Seat #5 is the button
Seat 1: dddocky (7506 in chips) 
Seat 2: Duke Croix (3199 in chips) 
Seat 3: color_singleton (18665 in chips) 
Seat 5: Klemtonius (13733 in chips) 
Seat 9: HighCardJasper (9898 in chips) 
HighCardJasper: posts small blind 50
dddocky: posts big blind 100
color_singleton: posts small blind 50
*** HOLE CARDS ***
Dealt to Duke Croix [3d Ac]
Duke Croix: calls 100
color_singleton: raises 100 to 200
Klemtonius: calls 200
HighCardJasper: calls 150
dddocky: folds 
Duke Croix: calls 100
*** FLOP *** [Qh Ah Jh]
HighCardJasper: checks 
Duke Croix: bets 400
color_singleton: folds 
Klemtonius: calls 400
HighCardJasper: calls 400
*** TURN *** [Qh Ah Jh] [6d]
HighCardJasper: checks 
Duke Croix: checks 
Klemtonius: checks 
*** RIVER *** [Qh Ah Jh 6d] [Tc]
HighCardJasper: bets 500
Duke Croix: calls 500
Klemtonius: raises 1300 to 1800
HighCardJasper: raises 1300 to 3100
Duke Croix: folds 
Klemtonius: raises 3900 to 7000
HighCardJasper: calls 3900
*** SHOW DOWN ***
Klemtonius: shows [Ks 4c] (a straight, Ten to Ace)
HighCardJasper: shows [Kc 2c] (a straight, Ten to Ace)
HighCardJasper collected 7867 from pot
Klemtonius collected 7867 from pot
*** SUMMARY ***
Total pot 16650 | Rake 916 
Board [Qh Ah Jh 6d Tc]
Seat 1: dddocky (big blind) folded before Flop
Seat 2: Duke Croix folded on the River
Seat 3: color_singleton folded on the Flop
Seat 5: Klemtonius (button) showed [Ks 4c] and won (7867) with a straight, Ten to Ace
Seat 9: HighCardJasper (small blind) showed [Kc 2c] and won (7867) with a straight, Ten to Ace



PokerStars Home Game Hand #218538675960: {Club #3225207}  Hold'em No Limit (50/100) - 2020/09/17 15:52:16 ET
Table 'fun time' 9-max (Play Money) Seat #9 is the button
Seat 1: dddocky (7406 in chips) 
Seat 2: Duke Croix (2099 in chips) 
Seat 3: color_singleton (18415 in chips) 
Seat 5: Klemtonius (14000 in chips) 
Seat 9: HighCardJasper (10165 in chips) 
dddocky: posts small blind 50
Duke Croix: posts big blind 100
*** HOLE CARDS ***
Dealt to Duke Croix [3c 8s]
color_singleton: folds 
Klemtonius: raises 300 to 400
HighCardJasper: calls 400
dddocky: folds 
Duke Croix: folds 
*** FLOP *** [Qd 6c 6h]
Klemtonius: bets 800
HighCardJasper: folds 
Uncalled bet (800) returned to Klemtonius
Klemtonius collected 898 from pot
Klemtonius: doesn't show hand 
*** SUMMARY ***
Total pot 950 | Rake 52 
Board [Qd 6c 6h]
Seat 1: dddocky (small blind) folded before Flop
Seat 2: Duke Croix (big blind) folded before Flop
Seat 3: color_singleton folded before Flop (didn't bet)
Seat 5: Klemtonius collected (898)
Seat 9: HighCardJasper (button) folded on the Flop



PokerStars Home Game Hand #218538699367: {Club #3225207}  Hold'em No Limit (50/100) - 2020/09/17 15:52:53 ET
Table 'fun time' 9-max (Play Money) Seat #1 is the button
Seat 1: dddocky (7356 in chips) 
Seat 2: Duke Croix (1999 in chips) 
Seat 3: color_singleton (18415 in chips) 
Seat 5: Klemtonius (14498 in chips) 
Seat 9: HighCardJasper (9765 in chips) 
Duke Croix: posts small blind 50
color_singleton: posts big blind 100
*** HOLE CARDS ***
Dealt to Duke Croix [5s 2h]
Klemtonius: raises 300 to 400
HighCardJasper: folds 
dddocky: calls 400
Duke Croix: folds 
color_singleton: calls 300
*** FLOP *** [3s 4s Jd]
color_singleton: bets 590
Klemtonius: calls 590
dddocky: folds 
*** TURN *** [3s 4s Jd] [Js]
color_singleton: bets 1148
Klemtonius: calls 1148
*** RIVER *** [3s 4s Jd Js] [7h]
color_singleton: bets 2233
Klemtonius: folds 
Uncalled bet (2233) returned to color_singleton
color_singleton collected 4466 from pot
color_singleton: doesn't show hand 
*** SUMMARY ***
Total pot 4726 | Rake 260 
Board [3s 4s Jd Js 7h]
Seat 1: dddocky (button) folded on the Flop
Seat 2: Duke Croix (small blind) folded before Flop
Seat 3: color_singleton (big blind) collected (4466)
Seat 5: Klemtonius folded on the River
Seat 9: HighCardJasper folded before Flop (didn't bet)



PokerStars Home Game Hand #218538729054: {Club #3225207}  Hold'em No Limit (50/100) - 2020/09/17 15:53:40 ET
Table 'fun time' 9-max (Play Money) Seat #2 is the button
Seat 1: dddocky (6956 in chips) 
Seat 2: Duke Croix (1949 in chips) 
Seat 3: color_singleton (20743 in chips) 
Seat 5: Klemtonius (12360 in chips) 
Seat 9: HighCardJasper (9765 in chips) 
color_singleton: posts small blind 50
Klemtonius: posts big blind 100
*** HOLE CARDS ***
Dealt to Duke Croix [7d 7c]
HighCardJasper: calls 100
dddocky: calls 100
Duke Croix has timed out
Duke Croix: folds 
color_singleton: calls 50
Klemtonius: checks 
*** FLOP *** [9d 2h 3h]
color_singleton: bets 189
Klemtonius: raises 189 to 378
HighCardJasper: folds 
dddocky: calls 378
color_singleton: calls 189
*** TURN *** [9d 2h 3h] [Jh]
color_singleton: bets 1450
Klemtonius: calls 1450
dddocky: calls 1450
*** RIVER *** [9d 2h 3h Jh] [Ah]
color_singleton: checks 
Klemtonius: bets 5560
dddocky: calls 5028 and is all-in
color_singleton: folds 
Uncalled bet (532) returned to Klemtonius
*** SHOW DOWN ***
Klemtonius: shows [9s 5h] (a flush, Ace high)
dddocky: shows [Ad Ac] (three of a kind, Aces)
Klemtonius collected 15063 from pot
*** SUMMARY ***
Total pot 15940 | Rake 877 
Board [9d 2h 3h Jh Ah]
Seat 1: dddocky showed [Ad Ac] and lost with three of a kind, Aces
Seat 2: Duke Croix (button) folded before Flop (didn't bet)
Seat 3: color_singleton (small blind) folded on the River
Seat 5: Klemtonius (big blind) showed [9s 5h] and won (15063) with a flush, Ace high
Seat 9: HighCardJasper folded on the Flop



PokerStars Home Game Hand #218538788429: {Club #3225207}  Hold'em No Limit (50/100) - 2020/09/17 15:55:20 ET
Table 'fun time' 9-max (Play Money) Seat #3 is the button
Seat 2: Duke Croix (1949 in chips) 
Seat 3: color_singleton (18815 in chips) 
Seat 5: Klemtonius (20467 in chips) 
Seat 9: HighCardJasper (9665 in chips) 
Klemtonius: posts small blind 50
HighCardJasper: posts big blind 100
*** HOLE CARDS ***
Dealt to Duke Croix [6s Ah]
Duke Croix has timed out
Duke Croix: folds 
color_singleton: raises 100 to 200
Klemtonius: calls 150
HighCardJasper: calls 100
*** FLOP *** [8c Ad 4h]
Klemtonius: checks 
HighCardJasper: bets 100
color_singleton: folds 
Klemtonius: calls 100
*** TURN *** [8c Ad 4h] [Td]
Klemtonius: checks 
HighCardJasper: checks 
*** RIVER *** [8c Ad 4h Td] [Jd]
Klemtonius: checks 
HighCardJasper: bets 500
Klemtonius: folds 
Uncalled bet (500) returned to HighCardJasper
HighCardJasper collected 756 from pot
HighCardJasper: doesn't show hand 
*** SUMMARY ***
Total pot 800 | Rake 44 
Board [8c Ad 4h Td Jd]
Seat 2: Duke Croix folded before Flop (didn't bet)
Seat 3: color_singleton (button) folded on the Flop
Seat 5: Klemtonius (small blind) folded on the River
Seat 9: HighCardJasper (big blind) collected (756)



PokerStars Home Game Hand #218538822548: {Club #3225207}  Hold'em No Limit (50/100) - 2020/09/17 15:56:37 ET
Table 'fun time' 9-max (Play Money) Seat #5 is the button
Seat 1: dddocky (10000 in chips) 
Seat 2: Duke Croix (1949 in chips) 
Seat 3: color_singleton (18615 in chips) 
Seat 5: Klemtonius (20167 in chips) 
Seat 9: HighCardJasper (10121 in chips) 
HighCardJasper: posts small blind 50
dddocky: posts big blind 100
*** HOLE CARDS ***
Dealt to Duke Croix [3h Qs]
Duke Croix: folds 
color_singleton: raises 200 to 300
Klemtonius: folds 
HighCardJasper: calls 250
dddocky: calls 200
*** FLOP *** [7d Th Kc]
HighCardJasper: bets 300
dddocky: folds 
color_singleton: raises 400 to 700
HighCardJasper: calls 400
*** TURN *** [7d Th Kc] [Jd]
HighCardJasper: checks 
color_singleton: bets 1086
HighCardJasper: calls 1086
*** RIVER *** [7d Th Kc Jd] [9c]
HighCardJasper: checks 
color_singleton: checks 
*** SHOW DOWN ***
HighCardJasper: shows [As Kh] (a pair of Kings)
color_singleton: shows [Ks 9d] (two pair, Kings and Nines)
color_singleton collected 4226 from pot
*** SUMMARY ***
Total pot 4472 | Rake 246 
Board [7d Th Kc Jd 9c]
Seat 1: dddocky (big blind) folded on the Flop
Seat 2: Duke Croix folded before Flop (didn't bet)
Seat 3: color_singleton showed [Ks 9d] and won (4226) with two pair, Kings and Nines
Seat 5: Klemtonius (button) folded before Flop (didn't bet)
Seat 9: HighCardJasper (small blind) showed [As Kh] and lost with a pair of Kings



PokerStars Home Game Hand #218538847457: {Club #3225207}  Hold'em No Limit (50/100) - 2020/09/17 15:57:31 ET
Table 'fun time' 9-max (Play Money) Seat #9 is the button
Seat 1: dddocky (9700 in chips) 
Seat 2: Duke Croix (1949 in chips) 
Seat 3: color_singleton (20755 in chips) 
Seat 5: Klemtonius (20167 in chips) 
Seat 9: HighCardJasper (8035 in chips) 
dddocky: posts small blind 50
Duke Croix: posts big blind 100
*** HOLE CARDS ***
Dealt to Duke Croix [6d 5c]
color_singleton: raises 200 to 300
Klemtonius: raises 200 to 500
HighCardJasper: folds 
dddocky: folds 
Duke Croix: folds 
color_singleton: calls 200
*** FLOP *** [Qh Ts 2c]
color_singleton: checks 
Klemtonius: checks 
*** TURN *** [Qh Ts 2c] [4h]
color_singleton: checks 
Klemtonius: bets 543
color_singleton: folds 
Uncalled bet (543) returned to Klemtonius
Klemtonius collected 1087 from pot
Klemtonius: doesn't show hand 
*** SUMMARY ***
Total pot 1150 | Rake 63 
Board [Qh Ts 2c 4h]
Seat 1: dddocky (small blind) folded before Flop
Seat 2: Duke Croix (big blind) folded before Flop
Seat 3: color_singleton folded on the Turn
Seat 5: Klemtonius collected (1087)
Seat 9: HighCardJasper (button) folded before Flop (didn't bet)



PokerStars Home Game Hand #218538876233: {Club #3225207}  Hold'em No Limit (50/100) - 2020/09/17 15:58:31 ET
Table 'fun time' 9-max (Play Money) Seat #1 is the button
Seat 1: dddocky (9650 in chips) 
Seat 2: Duke Croix (1849 in chips) 
Seat 3: color_singleton (20255 in chips) 
Seat 5: Klemtonius (20754 in chips) 
Seat 9: HighCardJasper (8035 in chips) 
Duke Croix: posts small blind 50
color_singleton: posts big blind 100
*** HOLE CARDS ***
Dealt to Duke Croix [4c 3d]
Klemtonius: raises 100 to 200
HighCardJasper: calls 200
dddocky: calls 200
Duke Croix: calls 150
color_singleton: calls 100
*** FLOP *** [3c 9h Ts]
Duke Croix: checks 
color_singleton: checks 
Klemtonius: checks 
HighCardJasper: checks 
dddocky: checks 
*** TURN *** [3c 9h Ts] [5d]
Duke Croix: checks 
color_singleton: checks 
Klemtonius: checks 
HighCardJasper: checks 
dddocky: checks 
*** RIVER *** [3c 9h Ts 5d] [Kh]
Duke Croix: checks 
color_singleton: checks 
Klemtonius: checks 
HighCardJasper: checks 
dddocky: checks 
*** SHOW DOWN ***
Duke Croix: shows [4c 3d] (a pair of Threes)
color_singleton: mucks hand 
Klemtonius: mucks hand 
HighCardJasper: mucks hand 
dddocky: shows [5c Qs] (a pair of Fives)
dddocky collected 945 from pot
*** SUMMARY ***
Total pot 1000 | Rake 55 
Board [3c 9h Ts 5d Kh]
Seat 1: dddocky (button) showed [5c Qs] and won (945) with a pair of Fives
Seat 2: Duke Croix (small blind) showed [4c 3d] and lost with a pair of Threes
Seat 3: color_singleton (big blind) mucked [Jd Ac]
Seat 5: Klemtonius mucked [Ad 2c]
Seat 9: HighCardJasper mucked [6h Js]



PokerStars Home Game Hand #218538907286: {Club #3225207}  Hold'em No Limit (50/100) - 2020/09/17 15:59:39 ET
Table 'fun time' 9-max (Play Money) Seat #2 is the button
Seat 1: dddocky (10395 in chips) 
Seat 2: Duke Croix (1649 in chips) 
Seat 3: color_singleton (20055 in chips) 
Seat 5: Klemtonius (20554 in chips) 
Seat 9: HighCardJasper (7835 in chips) 
color_singleton: posts small blind 50
Klemtonius: posts big blind 100
*** HOLE CARDS ***
Dealt to Duke Croix [Jd 8h]
HighCardJasper: calls 100
dddocky: calls 100
Duke Croix: folds 
color_singleton: calls 50
Klemtonius: checks 
*** FLOP *** [Ts 3d 9h]
color_singleton: checks 
Klemtonius: checks 
HighCardJasper: checks 
dddocky: checks 
*** TURN *** [Ts 3d 9h] [8d]
color_singleton: checks 
Klemtonius: checks 
HighCardJasper: checks 
dddocky: bets 378
color_singleton: folds 
Klemtonius: folds 
HighCardJasper: folds 
Uncalled bet (378) returned to dddocky
dddocky collected 378 from pot
dddocky: doesn't show hand 
*** SUMMARY ***
Total pot 400 | Rake 22 
Board [Ts 3d 9h 8d]
Seat 1: dddocky collected (378)
Seat 2: Duke Croix (button) folded before Flop (didn't bet)
Seat 3: color_singleton (small blind) folded on the Turn
Seat 5: Klemtonius (big blind) folded on the Turn
Seat 9: HighCardJasper folded on the Turn



PokerStars Home Game Hand #218538929681: {Club #3225207}  Hold'em No Limit (50/100) - 2020/09/17 16:00:26 ET
Table 'fun time' 9-max (Play Money) Seat #3 is the button
Seat 1: dddocky (10673 in chips) 
Seat 2: Duke Croix (1649 in chips) 
Seat 3: color_singleton (19955 in chips) 
Seat 5: Klemtonius (20454 in chips) 
Seat 9: HighCardJasper (7735 in chips) 
Klemtonius: posts small blind 50
HighCardJasper: posts big blind 100
*** HOLE CARDS ***
Dealt to Duke Croix [7d Qc]
dddocky: calls 100
Duke Croix: calls 100
color_singleton: raises 100 to 200
Klemtonius: calls 150
HighCardJasper: calls 100
dddocky: calls 100
Duke Croix: calls 100
*** FLOP *** [2s Kd Qs]
Klemtonius: checks 
HighCardJasper: checks 
dddocky: bets 100
Duke Croix: calls 100
color_singleton: folds 
Klemtonius: calls 100
HighCardJasper: folds 
*** TURN *** [2s Kd Qs] [9h]
Klemtonius: checks 
dddocky: checks 
Duke Croix: checks 
*** RIVER *** [2s Kd Qs 9h] [4c]
Klemtonius: checks 
dddocky: checks 
Duke Croix: bets 1349 and is all-in
Klemtonius: folds 
dddocky: folds 
Uncalled bet (1349) returned to Duke Croix
Duke Croix collected 1228 from pot
*** SUMMARY ***
Total pot 1300 | Rake 72 
Board [2s Kd Qs 9h 4c]
Seat 1: dddocky folded on the River
Seat 2: Duke Croix collected (1228)
Seat 3: color_singleton (button) folded on the Flop
Seat 5: Klemtonius (small blind) folded on the River
Seat 9: HighCardJasper (big blind) folded on the Flop



PokerStars Home Game Hand #218538962541: {Club #3225207}  Hold'em No Limit (50/100) - 2020/09/17 16:01:28 ET
Table 'fun time' 9-max (Play Money) Seat #5 is the button
Seat 1: dddocky (10373 in chips) 
Seat 2: Duke Croix (2577 in chips) 
Seat 3: color_singleton (19755 in chips) 
Seat 5: Klemtonius (20154 in chips) 
Seat 9: HighCardJasper (7535 in chips) 
HighCardJasper: posts small blind 50
dddocky: posts big blind 100
*** HOLE CARDS ***
Dealt to Duke Croix [Tc Kc]
Duke Croix: raises 200 to 300
color_singleton: folds 
Klemtonius: calls 300
HighCardJasper: folds 
dddocky: calls 200
*** FLOP *** [6c 8d As]
dddocky: checks 
Duke Croix: checks 
Klemtonius: checks 
*** TURN *** [6c 8d As] [7h]
dddocky: checks 
Duke Croix: checks 
Klemtonius: bets 449
dddocky: folds 
Duke Croix: folds 
Uncalled bet (449) returned to Klemtonius
Klemtonius collected 898 from pot
Klemtonius: doesn't show hand 
*** SUMMARY ***
Total pot 950 | Rake 52 
Board [6c 8d As 7h]
Seat 1: dddocky (big blind) folded on the Turn
Seat 2: Duke Croix folded on the Turn
Seat 3: color_singleton folded before Flop (didn't bet)
Seat 5: Klemtonius (button) collected (898)
Seat 9: HighCardJasper (small blind) folded before Flop



PokerStars Home Game Hand #218538987093: {Club #3225207}  Hold'em No Limit (50/100) - 2020/09/17 16:02:09 ET
Table 'fun time' 9-max (Play Money) Seat #9 is the button
Seat 1: dddocky (10073 in chips) 
Seat 2: Duke Croix (2277 in chips) 
Seat 3: color_singleton (19755 in chips) 
Seat 5: Klemtonius (20752 in chips) 
Seat 9: HighCardJasper (7485 in chips) 
dddocky: posts small blind 50
Duke Croix: posts big blind 100
*** HOLE CARDS ***
Dealt to Duke Croix [5h Kh]
color_singleton: raises 200 to 300
Klemtonius: calls 300
HighCardJasper: calls 300
dddocky: folds 
Duke Croix: folds 
*** FLOP *** [6d 7d 2c]
color_singleton: checks 
Klemtonius: bets 992
HighCardJasper: folds 
color_singleton: folds 
Uncalled bet (992) returned to Klemtonius
Klemtonius collected 992 from pot
Klemtonius: doesn't show hand 
*** SUMMARY ***
Total pot 1050 | Rake 58 
Board [6d 7d 2c]
Seat 1: dddocky (small blind) folded before Flop
Seat 2: Duke Croix (big blind) folded before Flop
Seat 3: color_singleton folded on the Flop
Seat 5: Klemtonius collected (992)
Seat 9: HighCardJasper (button) folded on the Flop



PokerStars Home Game Hand #218539005484: {Club #3225207}  Hold'em No Limit (50/100) - 2020/09/17 16:02:39 ET
Table 'fun time' 9-max (Play Money) Seat #1 is the button
Seat 1: dddocky (10023 in chips) 
Seat 2: Duke Croix (2177 in chips) 
Seat 3: color_singleton (19455 in chips) 
Seat 5: Klemtonius (21444 in chips) 
Seat 9: HighCardJasper (7185 in chips) 
Duke Croix: posts small blind 50
color_singleton: posts big blind 100
*** HOLE CARDS ***
Dealt to Duke Croix [5c 9d]
Klemtonius: raises 100 to 200
HighCardJasper: calls 200
dddocky: calls 200
Duke Croix: folds 
color_singleton: calls 100
*** FLOP *** [3s Qh Ah]
color_singleton: checks 
Klemtonius: bets 803
HighCardJasper: folds 
dddocky: folds 
color_singleton: folds 
Uncalled bet (803) returned to Klemtonius
Klemtonius collected 803 from pot
Klemtonius: doesn't show hand 
*** SUMMARY ***
Total pot 850 | Rake 47 
Board [3s Qh Ah]
Seat 1: dddocky (button) folded on the Flop
Seat 2: Duke Croix (small blind) folded before Flop
Seat 3: color_singleton (big blind) folded on the Flop
Seat 5: Klemtonius collected (803)
Seat 9: HighCardJasper folded on the Flop



PokerStars Home Game Hand #218539022261: {Club #3225207}  Hold'em No Limit (50/100) - 2020/09/17 16:03:06 ET
Table 'fun time' 9-max (Play Money) Seat #2 is the button
Seat 1: dddocky (9823 in chips) 
Seat 2: Duke Croix (2127 in chips) 
Seat 3: color_singleton (19255 in chips) 
Seat 5: Klemtonius (22047 in chips) 
Seat 9: HighCardJasper (6985 in chips) 
color_singleton: posts small blind 50
Klemtonius: posts big blind 100
*** HOLE CARDS ***
Dealt to Duke Croix [9c 3s]
HighCardJasper: calls 100
dddocky: calls 100
Duke Croix: folds 
color_singleton: folds 
Klemtonius: checks 
*** FLOP *** [Ac 3c 5h]
Klemtonius: checks 
HighCardJasper: checks 
dddocky: checks 
*** TURN *** [Ac 3c 5h] [Tc]
Klemtonius: bets 331
HighCardJasper: folds 
dddocky: folds 
Uncalled bet (331) returned to Klemtonius
Klemtonius collected 331 from pot
Klemtonius: doesn't show hand 
*** SUMMARY ***
Total pot 350 | Rake 19 
Board [Ac 3c 5h Tc]
Seat 1: dddocky folded on the Turn
Seat 2: Duke Croix (button) folded before Flop (didn't bet)
Seat 3: color_singleton (small blind) folded before Flop
Seat 5: Klemtonius (big blind) collected (331)
Seat 9: HighCardJasper folded on the Turn



PokerStars Home Game Hand #218539042945: {Club #3225207}  Hold'em No Limit (50/100) - 2020/09/17 16:03:39 ET
Table 'fun time' 9-max (Play Money) Seat #3 is the button
Seat 1: dddocky (9723 in chips) 
Seat 2: Duke Croix (2127 in chips) 
Seat 3: color_singleton (19205 in chips) 
Seat 5: Klemtonius (22278 in chips) 
Seat 9: HighCardJasper (6885 in chips) 
Klemtonius: posts small blind 50
HighCardJasper: posts big blind 100
*** HOLE CARDS ***
Dealt to Duke Croix [4h 3c]
dddocky: calls 100
Duke Croix: folds 
color_singleton: raises 100 to 200
Klemtonius: calls 150
HighCardJasper: folds 
dddocky: folds 
*** FLOP *** [2c 6h Qd]
Klemtonius: checks 
color_singleton: checks 
*** TURN *** [2c 6h Qd] [Ks]
Klemtonius: checks 
color_singleton: bets 283
Klemtonius: folds 
Uncalled bet (283) returned to color_singleton
color_singleton collected 567 from pot
color_singleton: doesn't show hand 
*** SUMMARY ***
Total pot 600 | Rake 33 
Board [2c 6h Qd Ks]
Seat 1: dddocky folded before Flop
Seat 2: Duke Croix folded before Flop (didn't bet)
Seat 3: color_singleton (button) collected (567)
Seat 5: Klemtonius (small blind) folded on the Turn
Seat 9: HighCardJasper (big blind) folded before Flop



PokerStars Home Game Hand #218539064418: {Club #3225207}  Hold'em No Limit (50/100) - 2020/09/17 16:04:13 ET
Table 'fun time' 9-max (Play Money) Seat #5 is the button
Seat 1: dddocky (9623 in chips) 
Seat 2: Duke Croix (2127 in chips) 
Seat 3: color_singleton (19572 in chips) 
Seat 5: Klemtonius (22078 in chips) 
Seat 9: HighCardJasper (6785 in chips) 
HighCardJasper: posts small blind 50
dddocky: posts big blind 100
*** HOLE CARDS ***
Dealt to Duke Croix [Td 9c]
Duke Croix: calls 100
color_singleton: folds 
Klemtonius: raises 100 to 200
HighCardJasper: calls 150
dddocky: calls 100
Duke Croix: calls 100
*** FLOP *** [5d 2h Ad]
HighCardJasper: checks 
dddocky: checks 
Duke Croix: checks 
Klemtonius: bets 756
HighCardJasper: folds 
dddocky: folds 
Duke Croix: folds 
Uncalled bet (756) returned to Klemtonius
Klemtonius collected 756 from pot
Klemtonius: doesn't show hand 
*** SUMMARY ***
Total pot 800 | Rake 44 
Board [5d 2h Ad]
Seat 1: dddocky (big blind) folded on the Flop
Seat 2: Duke Croix folded on the Flop
Seat 3: color_singleton folded before Flop (didn't bet)
Seat 5: Klemtonius (button) collected (756)
Seat 9: HighCardJasper (small blind) folded on the Flop



PokerStars Home Game Hand #218539101316: {Club #3225207}  Hold'em No Limit (50/100) - 2020/09/17 16:04:55 ET
Table 'fun time' 9-max (Play Money) Seat #9 is the button
Seat 1: dddocky (9423 in chips) 
Seat 2: Duke Croix (1927 in chips) 
Seat 3: color_singleton (19572 in chips) 
Seat 5: Klemtonius (22634 in chips) 
Seat 9: HighCardJasper (6585 in chips) 
dddocky: posts small blind 50
Duke Croix: posts big blind 100
*** HOLE CARDS ***
Dealt to Duke Croix [9c 2c]
color_singleton: raises 200 to 300
Klemtonius: raises 200 to 500
HighCardJasper: folds 
dddocky: calls 450
Duke Croix: folds 
color_singleton: calls 200
*** FLOP *** [2d Jc Tc]
dddocky: checks 
color_singleton: bets 756
Klemtonius: calls 756
dddocky: folds 
*** TURN *** [2d Jc Tc] [Ks]
color_singleton: checks 
Klemtonius: checks 
*** RIVER *** [2d Jc Tc Ks] [6d]
color_singleton: checks 
Klemtonius: bets 1470
color_singleton: calls 1470
*** SHOW DOWN ***
Klemtonius: shows [Qd Ad] (a straight, Ten to Ace)
color_singleton: mucks hand 
Klemtonius collected 5719 from pot
*** SUMMARY ***
Total pot 6052 | Rake 333 
Board [2d Jc Tc Ks 6d]
Seat 1: dddocky (small blind) folded on the Flop
Seat 2: Duke Croix (big blind) folded before Flop
Seat 3: color_singleton mucked [Ac Td]
Seat 5: Klemtonius showed [Qd Ad] and won (5719) with a straight, Ten to Ace
Seat 9: HighCardJasper (button) folded before Flop (didn't bet)



PokerStars Home Game Hand #218539144218: {Club #3225207}  Hold'em No Limit (50/100) - 2020/09/17 16:05:52 ET
Table 'fun time' 9-max (Play Money) Seat #1 is the button
Seat 1: dddocky (8923 in chips) 
Seat 2: Duke Croix (1827 in chips) 
Seat 3: color_singleton (16846 in chips) 
Seat 5: Klemtonius (25627 in chips) 
Seat 9: HighCardJasper (6585 in chips) 
Duke Croix: posts small blind 50
color_singleton: posts big blind 100
*** HOLE CARDS ***
Dealt to Duke Croix [3h 7h]
Klemtonius: calls 100
HighCardJasper: folds 
dddocky: calls 100
Duke Croix: calls 50
color_singleton: checks 
*** FLOP *** [7d 5s 4c]
Duke Croix: bets 300
color_singleton: folds 
Klemtonius: folds 
dddocky: folds 
Uncalled bet (300) returned to Duke Croix
Duke Croix collected 378 from pot
*** SUMMARY ***
Total pot 400 | Rake 22 
Board [7d 5s 4c]
Seat 1: dddocky (button) folded on the Flop
Seat 2: Duke Croix (small blind) collected (378)
Seat 3: color_singleton (big blind) folded on the Flop
Seat 5: Klemtonius folded on the Flop
Seat 9: HighCardJasper folded before Flop (didn't bet)



PokerStars Home Game Hand #218539167265: {Club #3225207}  Hold'em No Limit (50/100) - 2020/09/17 16:06:28 ET
Table 'fun time' 9-max (Play Money) Seat #2 is the button
Seat 1: dddocky (8823 in chips) 
Seat 2: Duke Croix (2105 in chips) 
Seat 3: color_singleton (16746 in chips) 
Seat 5: Klemtonius (25527 in chips) 
Seat 9: HighCardJasper (6585 in chips) 
color_singleton: posts small blind 50
Klemtonius: posts big blind 100
*** HOLE CARDS ***
Dealt to Duke Croix [4d 8h]
HighCardJasper: calls 100
dddocky: calls 100
Duke Croix: folds 
color_singleton: raises 200 to 300
Klemtonius: folds 
HighCardJasper: folds 
dddocky: calls 200
*** FLOP *** [4s 8s 6c]
color_singleton: checks 
dddocky: checks 
*** TURN *** [4s 8s 6c] [Js]
color_singleton: checks 
dddocky: checks 
*** RIVER *** [4s 8s 6c Js] [2c]
color_singleton: bets 378
dddocky: folds 
Uncalled bet (378) returned to color_singleton
color_singleton collected 756 from pot
color_singleton: doesn't show hand 
*** SUMMARY ***
Total pot 800 | Rake 44 
Board [4s 8s 6c Js 2c]
Seat 1: dddocky folded on the River
Seat 2: Duke Croix (button) folded before Flop (didn't bet)
Seat 3: color_singleton (small blind) collected (756)
Seat 5: Klemtonius (big blind) folded before Flop
Seat 9: HighCardJasper folded before Flop



PokerStars Home Game Hand #218539187283: {Club #3225207}  Hold'em No Limit (50/100) - 2020/09/17 16:07:00 ET
Table 'fun time' 9-max (Play Money) Seat #3 is the button
Seat 1: dddocky (8523 in chips) 
Seat 2: Duke Croix (2105 in chips) 
Seat 3: color_singleton (17202 in chips) 
Seat 5: Klemtonius (25427 in chips) 
Seat 9: HighCardJasper (6485 in chips) 
Klemtonius: posts small blind 50
HighCardJasper: posts big blind 100
*** HOLE CARDS ***
Dealt to Duke Croix [4s 7d]
dddocky: calls 100
Duke Croix has timed out
Duke Croix: folds 
color_singleton: raises 200 to 300
Klemtonius: folds 
HighCardJasper: calls 200
dddocky: calls 200
*** FLOP *** [Qd 6d 9c]
HighCardJasper: checks 
dddocky: checks 
color_singleton: bets 449
HighCardJasper: calls 449
dddocky: folds 
*** TURN *** [Qd 6d 9c] [5c]
HighCardJasper: checks 
color_singleton: checks 
*** RIVER *** [Qd 6d 9c 5c] [6h]
HighCardJasper: bets 400
color_singleton: calls 400
*** SHOW DOWN ***
HighCardJasper: shows [Qs Th] (two pair, Queens and Sixes)
color_singleton: mucks hand 
HighCardJasper collected 2502 from pot
*** SUMMARY ***
Total pot 2648 | Rake 146 
Board [Qd 6d 9c 5c 6h]
Seat 1: dddocky folded on the Flop
Seat 2: Duke Croix folded before Flop (didn't bet)
Seat 3: color_singleton (button) mucked [Jd Jc]
Seat 5: Klemtonius (small blind) folded before Flop
Seat 9: HighCardJasper (big blind) showed [Qs Th] and won (2502) with two pair, Queens and Sixes



PokerStars Home Game Hand #218539225020: {Club #3225207}  Hold'em No Limit (50/100) - 2020/09/17 16:07:59 ET
Table 'fun time' 9-max (Play Money) Seat #5 is the button
Seat 1: dddocky (8223 in chips) 
Seat 2: Duke Croix (2105 in chips) 
Seat 3: color_singleton (16053 in chips) 
Seat 5: Klemtonius (25377 in chips) 
Seat 9: HighCardJasper (7838 in chips) 
HighCardJasper: posts small blind 50
dddocky: posts big blind 100
*** HOLE CARDS ***
Dealt to Duke Croix [Kc Ts]
Duke Croix: raises 300 to 400
color_singleton: calls 400
Klemtonius: folds 
HighCardJasper: calls 350
dddocky: folds 
*** FLOP *** [6c 6d 2d]
HighCardJasper: checks 
Duke Croix: checks 
color_singleton: checks 
*** TURN *** [6c 6d 2d] [4d]
HighCardJasper: bets 200
Duke Croix: folds 
color_singleton: raises 200 to 400
HighCardJasper: calls 200
*** RIVER *** [6c 6d 2d 4d] [9s]
HighCardJasper: checks 
color_singleton: bets 992
HighCardJasper: raises 992 to 1984
color_singleton: calls 992
*** SHOW DOWN ***
HighCardJasper: shows [Qd Td] (a flush, Queen high)
color_singleton: mucks hand 
HighCardJasper collected 5734 from pot
*** SUMMARY ***
Total pot 6068 | Rake 334 
Board [6c 6d 2d 4d 9s]
Seat 1: dddocky (big blind) folded before Flop
Seat 2: Duke Croix folded on the Turn
Seat 3: color_singleton mucked [6h 7h]
Seat 5: Klemtonius (button) folded before Flop (didn't bet)
Seat 9: HighCardJasper (small blind) showed [Qd Td] and won (5734) with a flush, Queen high



PokerStars Home Game Hand #218539261872: {Club #3225207}  Hold'em No Limit (50/100) - 2020/09/17 16:08:58 ET
Table 'fun time' 9-max (Play Money) Seat #9 is the button
Seat 1: dddocky (8123 in chips) 
Seat 2: Duke Croix (1705 in chips) 
Seat 3: color_singleton (13269 in chips) 
Seat 5: Klemtonius (25377 in chips) 
Seat 9: HighCardJasper (10788 in chips) 
dddocky: posts small blind 50
Duke Croix: posts big blind 100
*** HOLE CARDS ***
Dealt to Duke Croix [7s As]
color_singleton: folds 
Klemtonius: calls 100
HighCardJasper: calls 100
dddocky: folds 
Duke Croix: raises 200 to 300
Klemtonius: calls 200
HighCardJasper: folds 
*** FLOP *** [Ad Td Qs]
Duke Croix: bets 1405 and is all-in
Klemtonius: folds 
Uncalled bet (1405) returned to Duke Croix
Duke Croix collected 709 from pot
*** SUMMARY ***
Total pot 750 | Rake 41 
Board [Ad Td Qs]
Seat 1: dddocky (small blind) folded before Flop
Seat 2: Duke Croix (big blind) collected (709)
Seat 3: color_singleton folded before Flop (didn't bet)
Seat 5: Klemtonius folded on the Flop
Seat 9: HighCardJasper (button) folded before Flop



PokerStars Home Game Hand #218539290742: {Club #3225207}  Hold'em No Limit (50/100) - 2020/09/17 16:09:43 ET
Table 'fun time' 9-max (Play Money) Seat #1 is the button
Seat 1: dddocky (8073 in chips) 
Seat 2: Duke Croix (2114 in chips) 
Seat 3: color_singleton (13269 in chips) 
Seat 5: Klemtonius (25077 in chips) 
Seat 9: HighCardJasper (10688 in chips) 
Duke Croix: posts small blind 50
color_singleton: posts big blind 100
*** HOLE CARDS ***
Dealt to Duke Croix [8s 8c]
Klemtonius: folds 
HighCardJasper: calls 100
dddocky: calls 100
Duke Croix: raises 400 to 500
color_singleton: folds 
HighCardJasper: folds 
dddocky: calls 400
*** FLOP *** [5d Qc Kh]
Duke Croix: checks 
dddocky: bets 100
Duke Croix: raises 1514 to 1614 and is all-in
dddocky: folds 
Uncalled bet (1514) returned to Duke Croix
Duke Croix collected 1323 from pot
*** SUMMARY ***
Total pot 1400 | Rake 77 
Board [5d Qc Kh]
Seat 1: dddocky (button) folded on the Flop
Seat 2: Duke Croix (small blind) collected (1323)
Seat 3: color_singleton (big blind) folded before Flop
Seat 5: Klemtonius folded before Flop (didn't bet)
Seat 9: HighCardJasper folded before Flop



PokerStars Home Game Hand #218539319473: {Club #3225207}  Hold'em No Limit (50/100) - 2020/09/17 16:10:29 ET
Table 'fun time' 9-max (Play Money) Seat #2 is the button
Seat 1: dddocky (7473 in chips) 
Seat 2: Duke Croix (2837 in chips) 
Seat 3: color_singleton (13169 in chips) 
Seat 5: Klemtonius (25077 in chips) 
Seat 9: HighCardJasper (10588 in chips) 
color_singleton: posts small blind 50
Klemtonius: posts big blind 100
*** HOLE CARDS ***
Dealt to Duke Croix [2s 8d]
HighCardJasper: calls 100
dddocky: calls 100
Duke Croix: folds 
color_singleton: calls 50
Klemtonius: checks 
*** FLOP *** [7c 7d Qh]
color_singleton: checks 
Klemtonius: checks 
HighCardJasper: checks 
dddocky: checks 
*** TURN *** [7c 7d Qh] [2c]
color_singleton: checks 
Klemtonius: checks 
HighCardJasper: checks 
dddocky: bets 200
color_singleton: raises 200 to 400
Klemtonius: folds 
HighCardJasper: folds 
dddocky: calls 200
*** RIVER *** [7c 7d Qh 2c] [9s]
color_singleton: bets 1134
dddocky: folds 
Uncalled bet (1134) returned to color_singleton
color_singleton collected 1134 from pot
color_singleton: doesn't show hand 
*** SUMMARY ***
Total pot 1200 | Rake 66 
Board [7c 7d Qh 2c 9s]
Seat 1: dddocky folded on the River
Seat 2: Duke Croix (button) folded before Flop (didn't bet)
Seat 3: color_singleton (small blind) collected (1134)
Seat 5: Klemtonius (big blind) folded on the Turn
Seat 9: HighCardJasper folded on the Turn



PokerStars Home Game Hand #218539350703: {Club #3225207}  Hold'em No Limit (50/100) - 2020/09/17 16:11:18 ET
Table 'fun time' 9-max (Play Money) Seat #3 is the button
Seat 1: dddocky (6973 in chips) 
Seat 2: Duke Croix (2837 in chips) 
Seat 3: color_singleton (13803 in chips) 
Seat 5: Klemtonius (24977 in chips) 
Seat 9: HighCardJasper (10488 in chips) 
Klemtonius: posts small blind 50
HighCardJasper: posts big blind 100
*** HOLE CARDS ***
Dealt to Duke Croix [Ts 9d]
dddocky: calls 100
Duke Croix: calls 100
color_singleton: folds 
Klemtonius: calls 50
HighCardJasper: checks 
*** FLOP *** [8d 3s Ac]
Klemtonius: checks 
HighCardJasper: checks 
dddocky: bets 100
Duke Croix: folds 
Klemtonius: folds 
HighCardJasper: folds 
Uncalled bet (100) returned to dddocky
dddocky collected 378 from pot
dddocky: doesn't show hand 
*** SUMMARY ***
Total pot 400 | Rake 22 
Board [8d 3s Ac]
Seat 1: dddocky collected (378)
Seat 2: Duke Croix folded on the Flop
Seat 3: color_singleton (button) folded before Flop (didn't bet)
Seat 5: Klemtonius (small blind) folded on the Flop
Seat 9: HighCardJasper (big blind) folded on the Flop



PokerStars Home Game Hand #218539369195: {Club #3225207}  Hold'em No Limit (50/100) - 2020/09/17 16:11:48 ET
Table 'fun time' 9-max (Play Money) Seat #5 is the button
Seat 1: dddocky (7251 in chips) 
Seat 2: Duke Croix (2737 in chips) 
Seat 3: color_singleton (13803 in chips) 
Seat 5: Klemtonius (24877 in chips) 
Seat 9: HighCardJasper (10388 in chips) 
HighCardJasper: posts small blind 50
dddocky: posts big blind 100
*** HOLE CARDS ***
Dealt to Duke Croix [9c Th]
Duke Croix: calls 100
color_singleton: folds 
Klemtonius: calls 100
HighCardJasper: calls 50
dddocky: checks 
*** FLOP *** [Js 4h 2d]
HighCardJasper: checks 
dddocky: bets 100
Duke Croix: folds 
Klemtonius: raises 100 to 200
HighCardJasper: calls 200
dddocky: calls 100
*** TURN *** [Js 4h 2d] [6d]
HighCardJasper: checks 
dddocky: checks 
Klemtonius: bets 945
HighCardJasper: folds 
dddocky: folds 
Uncalled bet (945) returned to Klemtonius
Klemtonius collected 945 from pot
Klemtonius: doesn't show hand 
*** SUMMARY ***
Total pot 1000 | Rake 55 
Board [Js 4h 2d 6d]
Seat 1: dddocky (big blind) folded on the Turn
Seat 2: Duke Croix folded on the Flop
Seat 3: color_singleton folded before Flop (didn't bet)
Seat 5: Klemtonius (button) collected (945)
Seat 9: HighCardJasper (small blind) folded on the Turn



PokerStars Home Game Hand #218539400059: {Club #3225207}  Hold'em No Limit (50/100) - 2020/09/17 16:12:37 ET
Table 'fun time' 9-max (Play Money) Seat #9 is the button
Seat 1: dddocky (6951 in chips) 
Seat 2: Duke Croix (2637 in chips) 
Seat 3: color_singleton (13803 in chips) 
Seat 5: Klemtonius (25522 in chips) 
Seat 9: HighCardJasper (10088 in chips) 
dddocky: posts small blind 50
Duke Croix: posts big blind 100
*** HOLE CARDS ***
Dealt to Duke Croix [7s Ac]
color_singleton: folds 
Klemtonius: raises 100 to 200
HighCardJasper: calls 200
dddocky: calls 150
Duke Croix: calls 100
*** FLOP *** [3d 6d 5h]
dddocky: checks 
Duke Croix: checks 
Klemtonius: checks 
HighCardJasper: checks 
*** TURN *** [3d 6d 5h] [6c]
dddocky: checks 
Duke Croix: checks 
Klemtonius: checks 
HighCardJasper: checks 
*** RIVER *** [3d 6d 5h 6c] [As]
dddocky: checks 
Duke Croix: bets 500
Klemtonius: folds 
HighCardJasper: folds 
dddocky: folds 
Uncalled bet (500) returned to Duke Croix
Duke Croix collected 756 from pot
*** SUMMARY ***
Total pot 800 | Rake 44 
Board [3d 6d 5h 6c As]
Seat 1: dddocky (small blind) folded on the River
Seat 2: Duke Croix (big blind) collected (756)
Seat 3: color_singleton folded before Flop (didn't bet)
Seat 5: Klemtonius folded on the River
Seat 9: HighCardJasper (button) folded on the River



PokerStars Home Game Hand #218539425488: {Club #3225207}  Hold'em No Limit (50/100) - 2020/09/17 16:13:18 ET
Table 'fun time' 9-max (Play Money) Seat #1 is the button
Seat 1: dddocky (6751 in chips) 
Seat 2: Duke Croix (3193 in chips) 
Seat 3: color_singleton (13803 in chips) 
Seat 5: Klemtonius (25322 in chips) 
Seat 9: HighCardJasper (9888 in chips) 
Duke Croix: posts small blind 50
color_singleton: posts big blind 100
*** HOLE CARDS ***
Dealt to Duke Croix [3h 3c]
Klemtonius: calls 100
HighCardJasper: calls 100
dddocky: calls 100
Duke Croix: calls 50
color_singleton: raises 200 to 300
Klemtonius: calls 200
HighCardJasper: folds 
dddocky: calls 200
Duke Croix: calls 200
*** FLOP *** [6s Qh 7c]
Duke Croix: checks 
color_singleton: checks 
Klemtonius: bets 614
dddocky: raises 614 to 1228
Duke Croix: folds 
color_singleton: folds 
Klemtonius: raises 614 to 1842
dddocky: calls 614
*** TURN *** [6s Qh 7c] [Ad]
Klemtonius: bets 4700
dddocky: calls 4609 and is all-in
Uncalled bet (91) returned to Klemtonius
*** RIVER *** [6s Qh 7c Ad] [Jc]
*** SHOW DOWN ***
Klemtonius: shows [Qd 7h] (two pair, Queens and Sevens)
dddocky: shows [Qc 2s] (a pair of Queens)
Klemtonius collected 13421 from pot
*** SUMMARY ***
Total pot 14202 | Rake 781 
Board [6s Qh 7c Ad Jc]
Seat 1: dddocky (button) showed [Qc 2s] and lost with a pair of Queens
Seat 2: Duke Croix (small blind) folded on the Flop
Seat 3: color_singleton (big blind) folded on the Flop
Seat 5: Klemtonius showed [Qd 7h] and won (13421) with two pair, Queens and Sevens
Seat 9: HighCardJasper folded before Flop



PokerStars Home Game Hand #218539459794: {Club #3225207}  Hold'em No Limit (50/100) - 2020/09/17 16:14:13 ET
Table 'fun time' 9-max (Play Money) Seat #2 is the button
Seat 2: Duke Croix (2893 in chips) 
Seat 3: color_singleton (13503 in chips) 
Seat 5: Klemtonius (31992 in chips) 
Seat 9: HighCardJasper (9788 in chips) 
color_singleton: posts small blind 50
Klemtonius: posts big blind 100
*** HOLE CARDS ***
Dealt to Duke Croix [5c 8s]
HighCardJasper: calls 100
Duke Croix: folds 
color_singleton: raises 100 to 200
Klemtonius: folds 
HighCardJasper: calls 100
*** FLOP *** [4c 3h 6h]
color_singleton: bets 472
HighCardJasper: folds 
Uncalled bet (472) returned to color_singleton
color_singleton collected 472 from pot
color_singleton: doesn't show hand 
*** SUMMARY ***
Total pot 500 | Rake 28 
Board [4c 3h 6h]
Seat 2: Duke Croix (button) folded before Flop (didn't bet)
Seat 3: color_singleton (small blind) collected (472)
Seat 5: Klemtonius (big blind) folded before Flop
Seat 9: HighCardJasper folded on the Flop



PokerStars Home Game Hand #218539480578: {Club #3225207}  Hold'em No Limit (50/100) - 2020/09/17 16:14:46 ET
Table 'fun time' 9-max (Play Money) Seat #3 is the button
Seat 1: dddocky (10000 in chips) 
Seat 2: Duke Croix (2893 in chips) 
Seat 3: color_singleton (13775 in chips) 
Seat 5: Klemtonius (31892 in chips) 
Seat 9: HighCardJasper (9588 in chips) 
Klemtonius: posts small blind 50
HighCardJasper: posts big blind 100
*** HOLE CARDS ***
Dealt to Duke Croix [6d 8c]
dddocky: folds 
Duke Croix: folds 
color_singleton: raises 200 to 300
Klemtonius: folds 
HighCardJasper: folds 
Uncalled bet (200) returned to color_singleton
color_singleton collected 250 from pot
color_singleton: doesn't show hand 
*** SUMMARY ***
Total pot 250 | Rake 0 
Seat 1: dddocky folded before Flop (didn't bet)
Seat 2: Duke Croix folded before Flop (didn't bet)
Seat 3: color_singleton (button) collected (250)
Seat 5: Klemtonius (small blind) folded before Flop
Seat 9: HighCardJasper (big blind) folded before Flop



PokerStars Home Game Hand #218539497265: {Club #3225207}  Hold'em No Limit (50/100) - 2020/09/17 16:15:12 ET
Table 'fun time' 9-max (Play Money) Seat #5 is the button
Seat 1: dddocky (10000 in chips) 
Seat 2: Duke Croix (2893 in chips) 
Seat 3: color_singleton (13925 in chips) 
Seat 5: Klemtonius (31842 in chips) 
Seat 9: HighCardJasper (9488 in chips) 
HighCardJasper: posts small blind 50
dddocky: posts big blind 100
*** HOLE CARDS ***
Dealt to Duke Croix [Kd Th]
Duke Croix: raises 200 to 300
color_singleton: folds 
Klemtonius: folds 
HighCardJasper: calls 250
dddocky: calls 200
*** FLOP *** [6s Qh Ts]
HighCardJasper: checks 
dddocky: bets 100
Duke Croix: calls 100
HighCardJasper: calls 100
*** TURN *** [6s Qh Ts] [8c]
HighCardJasper: checks 
dddocky: checks 
Duke Croix: bets 500
HighCardJasper: calls 500
dddocky: folds 
*** RIVER *** [6s Qh Ts 8c] [Ks]
HighCardJasper: bets 1000
Duke Croix: raises 993 to 1993 and is all-in
HighCardJasper: calls 993
*** SHOW DOWN ***
Duke Croix: shows [Kd Th] (two pair, Kings and Tens)
HighCardJasper: shows [Kh Qd] (two pair, Kings and Queens)
HighCardJasper collected 5846 from pot
*** SUMMARY ***
Total pot 6186 | Rake 340 
Board [6s Qh Ts 8c Ks]
Seat 1: dddocky (big blind) folded on the Turn
Seat 2: Duke Croix showed [Kd Th] and lost with two pair, Kings and Tens
Seat 3: color_singleton folded before Flop (didn't bet)
Seat 5: Klemtonius (button) folded before Flop (didn't bet)
Seat 9: HighCardJasper (small blind) showed [Kh Qd] and won (5846) with two pair, Kings and Queens



PokerStars Home Game Hand #218539604304: {Club #3225207}  Hold'em No Limit (50/100) - 2020/09/17 16:17:59 ET
Table 'fun time' 9-max (Play Money) Seat #3 is the button
Seat 1: dddocky (9350 in chips) 
Seat 2: Duke Croix (10000 in chips) 
Seat 3: color_singleton (14717 in chips) 
Seat 5: Klemtonius (31495 in chips) 
Seat 9: HighCardJasper (12141 in chips) 
Klemtonius: posts small blind 50
HighCardJasper: posts big blind 100
Duke Croix: posts small & big blinds 150
*** HOLE CARDS ***
Dealt to Duke Croix [5s Jh]
dddocky: folds 
Duke Croix: checks 
color_singleton: folds 
Klemtonius: raises 566 to 666
HighCardJasper: folds 
Duke Croix: folds 
Uncalled bet (566) returned to Klemtonius
Klemtonius collected 350 from pot
Klemtonius: doesn't show hand 
*** SUMMARY ***
Total pot 350 | Rake 0 
Seat 1: dddocky folded before Flop (didn't bet)
Seat 2: Duke Croix folded before Flop (didn't bet)
Seat 3: color_singleton (button) folded before Flop (didn't bet)
Seat 5: Klemtonius (small blind) collected (350)
Seat 9: HighCardJasper (big blind) folded before Flop



PokerStars Home Game Hand #218539625054: {Club #3225207}  Hold'em No Limit (50/100) - 2020/09/17 16:18:31 ET
Table 'fun time' 9-max (Play Money) Seat #5 is the button
Seat 1: dddocky (9350 in chips) 
Seat 2: Duke Croix (9850 in chips) 
Seat 3: color_singleton (14717 in chips) 
Seat 5: Klemtonius (31745 in chips) 
Seat 9: HighCardJasper (12041 in chips) 
HighCardJasper: posts small blind 50
dddocky: posts big blind 100
*** HOLE CARDS ***
Dealt to Duke Croix [3c 3h]
Duke Croix: raises 200 to 300
color_singleton: calls 300
Klemtonius: calls 300
HighCardJasper: folds 
dddocky: calls 200
*** FLOP *** [2d Ac Jh]
dddocky: checks 
Duke Croix: checks 
color_singleton: checks 
Klemtonius: checks 
*** TURN *** [2d Ac Jh] [6s]
dddocky: checks 
Duke Croix: bets 500
color_singleton: calls 500
Klemtonius: folds 
dddocky: folds 
*** RIVER *** [2d Ac Jh 6s] [Kd]
Duke Croix: checks 
color_singleton: bets 1063
Duke Croix: folds 
Uncalled bet (1063) returned to color_singleton
color_singleton collected 2126 from pot
color_singleton: doesn't show hand 
*** SUMMARY ***
Total pot 2250 | Rake 124 
Board [2d Ac Jh 6s Kd]
Seat 1: dddocky (big blind) folded on the Turn
Seat 2: Duke Croix folded on the River
Seat 3: color_singleton collected (2126)
Seat 5: Klemtonius (button) folded on the Turn
Seat 9: HighCardJasper (small blind) folded before Flop



PokerStars Home Game Hand #218539674341: {Club #3225207}  Hold'em No Limit (50/100) - 2020/09/17 16:19:47 ET
Table 'fun time' 9-max (Play Money) Seat #9 is the button
Seat 1: dddocky (9050 in chips) 
Seat 2: Duke Croix (9050 in chips) 
Seat 3: color_singleton (16043 in chips) 
Seat 5: Klemtonius (31445 in chips) 
Seat 9: HighCardJasper (11991 in chips) 
dddocky: posts small blind 50
Duke Croix: posts big blind 100
*** HOLE CARDS ***
Dealt to Duke Croix [8s 4h]
color_singleton: calls 100
Klemtonius: folds 
HighCardJasper: calls 100
dddocky: calls 50
Duke Croix: checks 
*** FLOP *** [Jh Ks Th]
dddocky: checks 
Duke Croix: checks 
color_singleton: checks 
HighCardJasper: checks 
*** TURN *** [Jh Ks Th] [9h]
dddocky: checks 
Duke Croix: checks 
color_singleton: checks 
HighCardJasper: bets 200
dddocky: folds 
Duke Croix: folds 
color_singleton: calls 200
*** RIVER *** [Jh Ks Th 9h] [2c]
color_singleton: checks 
HighCardJasper: bets 500
color_singleton: folds 
Uncalled bet (500) returned to HighCardJasper
HighCardJasper collected 756 from pot
HighCardJasper: doesn't show hand 
*** SUMMARY ***
Total pot 800 | Rake 44 
Board [Jh Ks Th 9h 2c]
Seat 1: dddocky (small blind) folded on the Turn
Seat 2: Duke Croix (big blind) folded on the Turn
Seat 3: color_singleton folded on the River
Seat 5: Klemtonius folded before Flop (didn't bet)
Seat 9: HighCardJasper (button) collected (756)



PokerStars Home Game Hand #218539707073: {Club #3225207}  Hold'em No Limit (50/100) - 2020/09/17 16:20:38 ET
Table 'fun time' 9-max (Play Money) Seat #1 is the button
Seat 1: dddocky (8950 in chips) 
Seat 2: Duke Croix (8950 in chips) 
Seat 3: color_singleton (15743 in chips) 
Seat 5: Klemtonius (31445 in chips) 
Seat 9: HighCardJasper (12447 in chips) 
Duke Croix: posts small blind 50
color_singleton: posts big blind 100
*** HOLE CARDS ***
Dealt to Duke Croix [Qc 5c]
Klemtonius: calls 100
HighCardJasper: calls 100
dddocky: calls 100
Duke Croix: calls 50
color_singleton: raises 300 to 400
Klemtonius: folds 
HighCardJasper: folds 
dddocky: calls 300
Duke Croix: folds 
*** FLOP *** [Js 7d 6h]
color_singleton: bets 519
dddocky: folds 
Uncalled bet (519) returned to color_singleton
color_singleton collected 1039 from pot
color_singleton: doesn't show hand 
*** SUMMARY ***
Total pot 1100 | Rake 61 
Board [Js 7d 6h]
Seat 1: dddocky (button) folded on the Flop
Seat 2: Duke Croix (small blind) folded before Flop
Seat 3: color_singleton (big blind) collected (1039)
Seat 5: Klemtonius folded before Flop
Seat 9: HighCardJasper folded before Flop



PokerStars Home Game Hand #218539728951: {Club #3225207}  Hold'em No Limit (50/100) - 2020/09/17 16:21:12 ET
Table 'fun time' 9-max (Play Money) Seat #2 is the button
Seat 1: dddocky (8550 in chips) 
Seat 2: Duke Croix (8850 in chips) 
Seat 3: color_singleton (16382 in chips) 
Seat 5: Klemtonius (31345 in chips) 
Seat 9: HighCardJasper (12347 in chips) 
color_singleton: posts small blind 50
Klemtonius: posts big blind 100
*** HOLE CARDS ***
Dealt to Duke Croix [Jc 8d]
HighCardJasper: calls 100
dddocky: calls 100
Duke Croix: folds 
color_singleton: calls 50
Klemtonius: checks 
*** FLOP *** [7d 6c Jh]
color_singleton: bets 189
Klemtonius: calls 189
HighCardJasper: calls 189
dddocky: folds 
*** TURN *** [7d 6c Jh] [2s]
color_singleton: bets 457
Klemtonius: folds 
HighCardJasper: folds 
Uncalled bet (457) returned to color_singleton
color_singleton collected 914 from pot
color_singleton: doesn't show hand 
*** SUMMARY ***
Total pot 967 | Rake 53 
Board [7d 6c Jh 2s]
Seat 1: dddocky folded on the Flop
Seat 2: Duke Croix (button) folded before Flop (didn't bet)
Seat 3: color_singleton (small blind) collected (914)
Seat 5: Klemtonius (big blind) folded on the Turn
Seat 9: HighCardJasper folded on the Turn



PokerStars Home Game Hand #218539750174: {Club #3225207}  Hold'em No Limit (50/100) - 2020/09/17 16:21:45 ET
Table 'fun time' 9-max (Play Money) Seat #3 is the button
Seat 1: dddocky (8450 in chips) 
Seat 2: Duke Croix (8850 in chips) 
Seat 3: color_singleton (17007 in chips) 
Seat 5: Klemtonius (31056 in chips) 
Seat 9: HighCardJasper (12058 in chips) 
Klemtonius: posts small blind 50
HighCardJasper: posts big blind 100
*** HOLE CARDS ***
Dealt to Duke Croix [Qs Ad]
dddocky: folds 
Duke Croix: raises 200 to 300
color_singleton: folds 
Klemtonius: calls 250
HighCardJasper: calls 200
*** FLOP *** [7c 5s 8s]
Klemtonius: bets 850
HighCardJasper: folds 
Duke Croix: folds 
Uncalled bet (850) returned to Klemtonius
Klemtonius collected 850 from pot
Klemtonius: doesn't show hand 
*** SUMMARY ***
Total pot 900 | Rake 50 
Board [7c 5s 8s]
Seat 1: dddocky folded before Flop (didn't bet)
Seat 2: Duke Croix folded on the Flop
Seat 3: color_singleton (button) folded before Flop (didn't bet)
Seat 5: Klemtonius (small blind) collected (850)
Seat 9: HighCardJasper (big blind) folded on the Flop



PokerStars Home Game Hand #218539767050: {Club #3225207}  Hold'em No Limit (50/100) - 2020/09/17 16:22:10 ET
Table 'fun time' 9-max (Play Money) Seat #5 is the button
Seat 1: dddocky (8450 in chips) 
Seat 2: Duke Croix (8550 in chips) 
Seat 3: color_singleton (17007 in chips) 
Seat 5: Klemtonius (31606 in chips) 
Seat 9: HighCardJasper (11758 in chips) 
HighCardJasper: posts small blind 50
dddocky: posts big blind 100
*** HOLE CARDS ***
Dealt to Duke Croix [2s 2c]
Duke Croix: raises 200 to 300
color_singleton: folds 
Klemtonius: folds 
HighCardJasper: calls 250
dddocky: calls 200
*** FLOP *** [9d 2d 4s]
HighCardJasper: checks 
dddocky: bets 100
Duke Croix: raises 300 to 400
HighCardJasper: folds 
dddocky: calls 300
*** TURN *** [9d 2d 4s] [Ac]
dddocky: checks 
Duke Croix: bets 700
dddocky: folds 
Uncalled bet (700) returned to Duke Croix
Duke Croix collected 1606 from pot
*** SUMMARY ***
Total pot 1700 | Rake 94 
Board [9d 2d 4s Ac]
Seat 1: dddocky (big blind) folded on the Turn
Seat 2: Duke Croix collected (1606)
Seat 3: color_singleton folded before Flop (didn't bet)
Seat 5: Klemtonius (button) folded before Flop (didn't bet)
Seat 9: HighCardJasper (small blind) folded on the Flop



PokerStars Home Game Hand #218539788058: {Club #3225207}  Hold'em No Limit (50/100) - 2020/09/17 16:22:43 ET
Table 'fun time' 9-max (Play Money) Seat #9 is the button
Seat 1: dddocky (7750 in chips) 
Seat 2: Duke Croix (9456 in chips) 
Seat 3: color_singleton (17007 in chips) 
Seat 5: Klemtonius (31606 in chips) 
Seat 9: HighCardJasper (11458 in chips) 
dddocky: posts small blind 50
Duke Croix: posts big blind 100
*** HOLE CARDS ***
Dealt to Duke Croix [5h Ks]
color_singleton: raises 200 to 300
Klemtonius: raises 200 to 500
HighCardJasper: folds 
dddocky: calls 450
Duke Croix: folds 
color_singleton: calls 200
*** FLOP *** [Jd 8c 9d]
dddocky: checks 
color_singleton: checks 
MaFak2019 joins the table at seat #4 
Klemtonius: bets 756
dddocky: folds 
color_singleton: folds 
Uncalled bet (756) returned to Klemtonius
Klemtonius collected 1512 from pot
Klemtonius: doesn't show hand 
*** SUMMARY ***
Total pot 1600 | Rake 88 
Board [Jd 8c 9d]
Seat 1: dddocky (small blind) folded on the Flop
Seat 2: Duke Croix (big blind) folded before Flop
Seat 3: color_singleton folded on the Flop
Seat 5: Klemtonius collected (1512)
Seat 9: HighCardJasper (button) folded before Flop (didn't bet)



PokerStars Home Game Hand #218539809241: {Club #3225207}  Hold'em No Limit (50/100) - 2020/09/17 16:23:15 ET
Table 'fun time' 9-max (Play Money) Seat #1 is the button
Seat 1: dddocky (7250 in chips) 
Seat 2: Duke Croix (9356 in chips) 
Seat 3: color_singleton (16507 in chips) 
Seat 4: MaFak2019 (10000 in chips) 
Seat 9: HighCardJasper (11458 in chips) 
Duke Croix: posts small blind 50
color_singleton: posts big blind 100
MaFak2019: posts big blind 100
*** HOLE CARDS ***
Dealt to Duke Croix [6d 6c]
MaFak2019: raises 400 to 500
HighCardJasper: calls 500
dddocky: calls 500
Duke Croix: calls 450
color_singleton: folds 
*** FLOP *** [Qh Kd Qs]
Duke Croix: checks 
MaFak2019: bets 1200
HighCardJasper: calls 1200
dddocky: calls 1200
Duke Croix: folds 
*** TURN *** [Qh Kd Qs] [Ad]
MaFak2019: bets 8300 and is all-in
HighCardJasper: calls 8300
dddocky: calls 5550 and is all-in
*** RIVER *** [Qh Kd Qs Ad] [9s]
*** SHOW DOWN ***
MaFak2019: shows [Ac Ah] (a full house, Aces full of Queens)
HighCardJasper: shows [Qd Jh] (three of a kind, Queens)
MaFak2019 collected 5197 from side pot
dddocky: shows [2c Kc] (two pair, Kings and Queens)
MaFak2019 collected 21121 from main pot
*** SUMMARY ***
Total pot 27850 Main pot 21121. Side pot 5197. | Rake 1532 
Board [Qh Kd Qs Ad 9s]
Seat 1: dddocky (button) showed [2c Kc] and lost with two pair, Kings and Queens
Seat 2: Duke Croix (small blind) folded on the Flop
Seat 3: color_singleton (big blind) folded before Flop
Seat 4: MaFak2019 showed [Ac Ah] and won (26318) with a full house, Aces full of Queens
Seat 9: HighCardJasper showed [Qd Jh] and lost with three of a kind, Queens



PokerStars Home Game Hand #218539843884: {Club #3225207}  Hold'em No Limit (50/100) - 2020/09/17 16:24:09 ET
Table 'fun time' 9-max (Play Money) Seat #2 is the button
Seat 2: Duke Croix (8856 in chips) 
Seat 3: color_singleton (16407 in chips) 
Seat 4: MaFak2019 (26318 in chips) 
Seat 9: HighCardJasper (1458 in chips) 
color_singleton: posts small blind 50
MaFak2019: posts big blind 100
*** HOLE CARDS ***
Dealt to Duke Croix [Jh Ts]
HighCardJasper: calls 100
Duke Croix: raises 300 to 400
color_singleton: folds 
MaFak2019: calls 300
HighCardJasper: folds 
*** FLOP *** [2h Qd Kd]
MaFak2019: bets 400
Duke Croix: calls 400
*** TURN *** [2h Qd Kd] [Kc]
MaFak2019: bets 400
Duke Croix: calls 400
*** RIVER *** [2h Qd Kd Kc] [9s]
MaFak2019: bets 300
Duke Croix: raises 1200 to 1500
MaFak2019: calls 1200
*** SHOW DOWN ***
Duke Croix: shows [Jh Ts] (a straight, Nine to King)
MaFak2019: mucks hand 
Duke Croix collected 5245 from pot
*** SUMMARY ***
Total pot 5550 | Rake 305 
Board [2h Qd Kd Kc 9s]
Seat 2: Duke Croix (button) showed [Jh Ts] and won (5245) with a straight, Nine to King
Seat 3: color_singleton (small blind) folded before Flop
Seat 4: MaFak2019 (big blind) mucked [Qh 6d]
Seat 9: HighCardJasper folded before Flop



PokerStars Home Game Hand #218539888207: {Club #3225207}  Hold'em No Limit (50/100) - 2020/09/17 16:25:19 ET
Table 'fun time' 9-max (Play Money) Seat #3 is the button
Seat 1: dddocky (10000 in chips) 
Seat 2: Duke Croix (11401 in chips) 
Seat 3: color_singleton (16357 in chips) 
Seat 4: MaFak2019 (23618 in chips) 
Seat 9: HighCardJasper (1358 in chips) 
MaFak2019: posts small blind 50
HighCardJasper: posts big blind 100
*** HOLE CARDS ***
Dealt to Duke Croix [Jd 7c]
dddocky: folds 
Duke Croix: folds 
color_singleton: folds 
MaFak2019: calls 50
HighCardJasper: checks 
*** FLOP *** [9s 7d 3c]
MaFak2019: checks 
HighCardJasper: checks 
*** TURN *** [9s 7d 3c] [7h]
MaFak2019: checks 
HighCardJasper: checks 
*** RIVER *** [9s 7d 3c 7h] [3s]
MaFak2019: checks 
HighCardJasper: checks 
*** SHOW DOWN ***
MaFak2019: shows [Qh 8c] (two pair, Sevens and Threes)
HighCardJasper: mucks hand 
MaFak2019 collected 189 from pot
*** SUMMARY ***
Total pot 200 | Rake 11 
Board [9s 7d 3c 7h 3s]
Seat 1: dddocky folded before Flop (didn't bet)
Seat 2: Duke Croix folded before Flop (didn't bet)
Seat 3: color_singleton (button) folded before Flop (didn't bet)
Seat 4: MaFak2019 (small blind) showed [Qh 8c] and won (189) with two pair, Sevens and Threes
Seat 9: HighCardJasper (big blind) mucked [Js 2s]



PokerStars Home Game Hand #218539911445: {Club #3225207}  Hold'em No Limit (50/100) - 2020/09/17 16:25:56 ET
Table 'fun time' 9-max (Play Money) Seat #4 is the button
Seat 1: dddocky (10000 in chips) 
Seat 2: Duke Croix (11401 in chips) 
Seat 3: color_singleton (16357 in chips) 
Seat 4: MaFak2019 (23707 in chips) 
Seat 9: HighCardJasper (1258 in chips) 
HighCardJasper: posts small blind 50
dddocky: posts big blind 100
*** HOLE CARDS ***
Dealt to Duke Croix [9s Kc]
Duke Croix: raises 300 to 400
color_singleton: folds 
MaFak2019: calls 400
HighCardJasper: calls 350
dddocky: calls 300
*** FLOP *** [5h Jd 5s]
HighCardJasper: checks 
dddocky: checks 
Duke Croix: checks 
MaFak2019: checks 
*** TURN *** [5h Jd 5s] [2d]
HighCardJasper: checks 
dddocky: checks 
Duke Croix: checks 
MaFak2019: checks 
*** RIVER *** [5h Jd 5s 2d] [2s]
HighCardJasper: checks 
dddocky: checks 
Duke Croix: checks 
MaFak2019: checks 
*** SHOW DOWN ***
HighCardJasper: shows [Qd Td] (two pair, Fives and Deuces)
dddocky: shows [Qc 9d] (two pair, Fives and Deuces)
Duke Croix: shows [9s Kc] (two pair, Fives and Deuces - King kicker)
MaFak2019: shows [3s Ac] (two pair, Fives and Deuces - Ace kicker)
MaFak2019 collected 1512 from pot
*** SUMMARY ***
Total pot 1600 | Rake 88 
Board [5h Jd 5s 2d 2s]
Seat 1: dddocky (big blind) showed [Qc 9d] and lost with two pair, Fives and Deuces
Seat 2: Duke Croix showed [9s Kc] and lost with two pair, Fives and Deuces
Seat 3: color_singleton folded before Flop (didn't bet)
Seat 4: MaFak2019 (button) showed [3s Ac] and won (1512) with two pair, Fives and Deuces
Seat 9: HighCardJasper (small blind) showed [Qd Td] and lost with two pair, Fives and Deuces



PokerStars Home Game Hand #218539947850: {Club #3225207}  Hold'em No Limit (50/100) - 2020/09/17 16:26:53 ET
Table 'fun time' 9-max (Play Money) Seat #9 is the button
Seat 1: dddocky (9600 in chips) 
Seat 2: Duke Croix (11001 in chips) 
Seat 3: color_singleton (16357 in chips) 
Seat 4: MaFak2019 (24819 in chips) 
Seat 9: HighCardJasper (858 in chips) 
dddocky: posts small blind 50
Duke Croix: posts big blind 100
*** HOLE CARDS ***
Dealt to Duke Croix [Ks 9h]
color_singleton: folds 
MaFak2019: folds 
HighCardJasper: raises 758 to 858 and is all-in
dddocky: calls 808
Duke Croix: folds 
*** FLOP *** [Tc Kc 5s]
*** TURN *** [Tc Kc 5s] [Qs]
*** RIVER *** [Tc Kc 5s Qs] [3d]
*** SHOW DOWN ***
dddocky: shows [As 9s] (high card Ace)
HighCardJasper: shows [Ah Js] (a straight, Ten to Ace)
HighCardJasper collected 1716 from pot
*** SUMMARY ***
Total pot 1816 | Rake 100 
Board [Tc Kc 5s Qs 3d]
Seat 1: dddocky (small blind) showed [As 9s] and lost with high card Ace
Seat 2: Duke Croix (big blind) folded before Flop
Seat 3: color_singleton folded before Flop (didn't bet)
Seat 4: MaFak2019 folded before Flop (didn't bet)
Seat 9: HighCardJasper (button) showed [Ah Js] and won (1716) with a straight, Ten to Ace



PokerStars Home Game Hand #218539964484: {Club #3225207}  Hold'em No Limit (50/100) - 2020/09/17 16:27:19 ET
Table 'fun time' 9-max (Play Money) Seat #1 is the button
Seat 1: dddocky (8742 in chips) 
Seat 2: Duke Croix (10901 in chips) 
Seat 3: color_singleton (16357 in chips) 
Seat 4: MaFak2019 (24819 in chips) 
Seat 9: HighCardJasper (1716 in chips) 
Duke Croix: posts small blind 50
color_singleton: posts big blind 100
*** HOLE CARDS ***
Dealt to Duke Croix [Qd 2c]
MaFak2019: folds 
HighCardJasper: folds 
dddocky: calls 100
Duke Croix: calls 50
color_singleton: checks 
*** FLOP *** [Ad 8d 4h]
Duke Croix: checks 
color_singleton: checks 
dddocky: checks 
*** TURN *** [Ad 8d 4h] [Th]
Duke Croix: checks 
color_singleton: bets 141
dddocky: calls 141
Duke Croix: folds 
*** RIVER *** [Ad 8d 4h Th] [3c]
color_singleton: checks 
dddocky: checks 
*** SHOW DOWN ***
color_singleton: shows [Td Jc] (a pair of Tens)
dddocky: mucks hand 
color_singleton collected 550 from pot
*** SUMMARY ***
Total pot 582 | Rake 32 
Board [Ad 8d 4h Th 3c]
Seat 1: dddocky (button) mucked [Js 4d]
Seat 2: Duke Croix (small blind) folded on the Turn
Seat 3: color_singleton (big blind) showed [Td Jc] and won (550) with a pair of Tens
Seat 4: MaFak2019 folded before Flop (didn't bet)
Seat 9: HighCardJasper folded before Flop (didn't bet)



PokerStars Home Game Hand #218539989536: {Club #3225207}  Hold'em No Limit (50/100) - 2020/09/17 16:27:58 ET
Table 'fun time' 9-max (Play Money) Seat #2 is the button
Seat 1: dddocky (8501 in chips) 
Seat 2: Duke Croix (10801 in chips) 
Seat 3: color_singleton (16666 in chips) 
Seat 4: MaFak2019 (24819 in chips) 
Seat 9: HighCardJasper (1716 in chips) 
color_singleton: posts small blind 50
MaFak2019: posts big blind 100
*** HOLE CARDS ***
Dealt to Duke Croix [6c 4d]
HighCardJasper: calls 100
dddocky: calls 100
Duke Croix: folds 
color_singleton: folds 
MaFak2019: raises 300 to 400
HighCardJasper: folds 
dddocky: calls 300
*** FLOP *** [Ad 8c 8h]
MaFak2019: bets 400
dddocky: folds 
Uncalled bet (400) returned to MaFak2019
MaFak2019 collected 898 from pot
MaFak2019: doesn't show hand 
*** SUMMARY ***
Total pot 950 | Rake 52 
Board [Ad 8c 8h]
Seat 1: dddocky folded on the Flop
Seat 2: Duke Croix (button) folded before Flop (didn't bet)
Seat 3: color_singleton (small blind) folded before Flop
Seat 4: MaFak2019 (big blind) collected (898)
Seat 9: HighCardJasper folded before Flop



PokerStars Home Game Hand #218540011506: {Club #3225207}  Hold'em No Limit (50/100) - 2020/09/17 16:28:33 ET
Table 'fun time' 9-max (Play Money) Seat #3 is the button
Seat 1: dddocky (8101 in chips) 
Seat 2: Duke Croix (10801 in chips) 
Seat 3: color_singleton (16616 in chips) 
Seat 4: MaFak2019 (25317 in chips) 
Seat 9: HighCardJasper (1616 in chips) 
MaFak2019: posts small blind 50
HighCardJasper: posts big blind 100
*** HOLE CARDS ***
Dealt to Duke Croix [Ac Js]
dddocky: calls 100
Duke Croix: raises 300 to 400
color_singleton: folds 
MaFak2019: raises 300 to 700
HighCardJasper: folds 
dddocky: folds 
Duke Croix: calls 300
*** FLOP *** [9d Th 5d]
MaFak2019: checks 
Duke Croix: checks 
*** TURN *** [9d Th 5d] [7s]
MaFak2019: checks 
Duke Croix: checks 
*** RIVER *** [9d Th 5d 7s] [Kd]
MaFak2019: checks 
Duke Croix: checks 
*** SHOW DOWN ***
MaFak2019: shows [Ah Ks] (a pair of Kings)
Duke Croix: mucks hand 
MaFak2019 collected 1512 from pot
*** SUMMARY ***
Total pot 1600 | Rake 88 
Board [9d Th 5d 7s Kd]
Seat 1: dddocky folded before Flop
Seat 2: Duke Croix mucked [Ac Js]
Seat 3: color_singleton (button) folded before Flop (didn't bet)
Seat 4: MaFak2019 (small blind) showed [Ah Ks] and won (1512) with a pair of Kings
Seat 9: HighCardJasper (big blind) folded before Flop



PokerStars Home Game Hand #218540034289: {Club #3225207}  Hold'em No Limit (50/100) - 2020/09/17 16:29:08 ET
Table 'fun time' 9-max (Play Money) Seat #4 is the button
Seat 1: dddocky (8001 in chips) 
Seat 2: Duke Croix (10101 in chips) 
Seat 3: color_singleton (16616 in chips) 
Seat 4: MaFak2019 (26129 in chips) 
Seat 9: HighCardJasper (1516 in chips) 
HighCardJasper: posts small blind 50
dddocky: posts big blind 100
*** HOLE CARDS ***
Dealt to Duke Croix [9d 3h]
Duke Croix: folds 
color_singleton: folds 
MaFak2019: calls 100
HighCardJasper: calls 50
dddocky: checks 
*** FLOP *** [6h 3s 5h]
HighCardJasper: checks 
dddocky: checks 
MaFak2019: checks 
*** TURN *** [6h 3s 5h] [Jh]
HighCardJasper: checks 
dddocky: checks 
MaFak2019: checks 
*** RIVER *** [6h 3s 5h Jh] [4s]
HighCardJasper: bets 400
dddocky: raises 400 to 800
MaFak2019: folds 
HighCardJasper: raises 616 to 1416 and is all-in
dddocky: calls 616
*** SHOW DOWN ***
HighCardJasper: shows [7d Ad] (a straight, Three to Seven)
dddocky: shows [2c Ks] (a straight, Deuce to Six)
HighCardJasper collected 2960 from pot
*** SUMMARY ***
Total pot 3132 | Rake 172 
Board [6h 3s 5h Jh 4s]
Seat 1: dddocky (big blind) showed [2c Ks] and lost with a straight, Deuce to Six
Seat 2: Duke Croix folded before Flop (didn't bet)
Seat 3: color_singleton folded before Flop (didn't bet)
Seat 4: MaFak2019 (button) folded on the River
Seat 9: HighCardJasper (small blind) showed [7d Ad] and won (2960) with a straight, Three to Seven



PokerStars Home Game Hand #218540074625: {Club #3225207}  Hold'em No Limit (50/100) - 2020/09/17 16:30:11 ET
Table 'fun time' 9-max (Play Money) Seat #9 is the button
Seat 1: dddocky (6485 in chips) 
Seat 2: Duke Croix (10101 in chips) 
Seat 3: color_singleton (16616 in chips) 
Seat 4: MaFak2019 (26029 in chips) 
Seat 5: Klemtonius (32618 in chips) 
Seat 9: HighCardJasper (2960 in chips) 
dddocky: posts small blind 50
Duke Croix: posts big blind 100
Klemtonius: posts small & big blinds 150
*** HOLE CARDS ***
Dealt to Duke Croix [9c 4d]
color_singleton: folds 
MaFak2019: calls 100
Klemtonius: raises 300 to 400
HighCardJasper: calls 400
dddocky: folds 
Duke Croix: folds 
MaFak2019: calls 300
*** FLOP *** [6d Tc 4s]
MaFak2019: checks 
Klemtonius: bets 661
HighCardJasper: folds 
MaFak2019: folds 
Uncalled bet (661) returned to Klemtonius
Klemtonius collected 1323 from pot
Klemtonius: doesn't show hand 
*** SUMMARY ***
Total pot 1400 | Rake 77 
Board [6d Tc 4s]
Seat 1: dddocky (small blind) folded before Flop
Seat 2: Duke Croix (big blind) folded before Flop
Seat 3: color_singleton folded before Flop (didn't bet)
Seat 4: MaFak2019 folded on the Flop
Seat 5: Klemtonius collected (1323)
Seat 9: HighCardJasper (button) folded on the Flop



PokerStars Home Game Hand #218540119624: {Club #3225207}  Hold'em No Limit (50/100) - 2020/09/17 16:31:22 ET
Table 'fun time' 9-max (Play Money) Seat #1 is the button
Seat 1: dddocky (6435 in chips) 
Seat 2: Duke Croix (10001 in chips) 
Seat 3: color_singleton (16616 in chips) 
Seat 4: MaFak2019 (25629 in chips) 
Seat 5: Klemtonius (33491 in chips) 
Seat 9: HighCardJasper (2560 in chips) 
Duke Croix: posts small blind 50
color_singleton: posts big blind 100
*** HOLE CARDS ***
Dealt to Duke Croix [Jh 3h]
MaFak2019: calls 100
Klemtonius: calls 100
HighCardJasper: calls 100
dddocky: calls 100
Duke Croix: calls 50
color_singleton: raises 100 to 200
MaFak2019: calls 100
Klemtonius: calls 100
HighCardJasper: calls 100
dddocky: calls 100
Duke Croix: folds 
*** FLOP *** [5s Td 7h]
color_singleton: checks 
MaFak2019: checks 
Klemtonius: checks 
HighCardJasper: checks 
dddocky: checks 
*** TURN *** [5s Td 7h] [8s]
color_singleton: checks 
MaFak2019: bets 300
Klemtonius: folds 
HighCardJasper: calls 300
dddocky: calls 300
color_singleton: calls 300
*** RIVER *** [5s Td 7h 8s] [5d]
color_singleton: checks 
MaFak2019: checks 
HighCardJasper: bets 900
dddocky: calls 900
color_singleton: folds 
MaFak2019: calls 900
*** SHOW DOWN ***
HighCardJasper: shows [Jd 9h] (a straight, Seven to Jack)
dddocky: shows [9s Jc] (a straight, Seven to Jack)
MaFak2019: mucks hand 
HighCardJasper collected 2363 from pot
dddocky collected 2362 from pot
*** SUMMARY ***
Total pot 5000 | Rake 275 
Board [5s Td 7h 8s 5d]
Seat 1: dddocky (button) showed [9s Jc] and won (2362) with a straight, Seven to Jack
Seat 2: Duke Croix (small blind) folded before Flop
Seat 3: color_singleton (big blind) folded on the River
Seat 4: MaFak2019 mucked [Ts As]
Seat 5: Klemtonius folded on the Turn
Seat 9: HighCardJasper showed [Jd 9h] and won (2363) with a straight, Seven to Jack



PokerStars Home Game Hand #218540185976: {Club #3225207}  Hold'em No Limit (50/100) - 2020/09/17 16:33:06 ET
Table 'fun time' 9-max (Play Money) Seat #2 is the button
Seat 1: dddocky (7397 in chips) 
Seat 2: Duke Croix (9901 in chips) 
Seat 3: color_singleton (16116 in chips) 
Seat 4: MaFak2019 (24229 in chips) 
Seat 5: Klemtonius (33291 in chips) 
Seat 9: HighCardJasper (3523 in chips) 
color_singleton: posts small blind 50
MaFak2019: posts big blind 100
*** HOLE CARDS ***
Dealt to Duke Croix [Qd 7d]
Klemtonius: calls 100
HighCardJasper: calls 100
dddocky: folds 
Duke Croix: folds 
color_singleton: raises 100 to 200
MaFak2019: calls 100
Klemtonius: calls 100
HighCardJasper: calls 100
*** FLOP *** [2h 6h 4s]
color_singleton: checks 
MaFak2019: checks 
Klemtonius: checks 
HighCardJasper: bets 200
color_singleton: calls 200
MaFak2019: folds 
Klemtonius: calls 200
*** TURN *** [2h 6h 4s] [7s]
color_singleton: checks 
Klemtonius: checks 
HighCardJasper: bets 300
color_singleton: folds 
Klemtonius: calls 300
*** RIVER *** [2h 6h 4s 7s] [Kc]
Klemtonius: checks 
HighCardJasper: bets 800
Klemtonius: folds 
Uncalled bet (800) returned to HighCardJasper
HighCardJasper collected 1890 from pot
HighCardJasper: doesn't show hand 
*** SUMMARY ***
Total pot 2000 | Rake 110 
Board [2h 6h 4s 7s Kc]
Seat 1: dddocky folded before Flop (didn't bet)
Seat 2: Duke Croix (button) folded before Flop (didn't bet)
Seat 3: color_singleton (small blind) folded on the Turn
Seat 4: MaFak2019 (big blind) folded on the Flop
Seat 5: Klemtonius folded on the River
Seat 9: HighCardJasper collected (1890)



PokerStars Home Game Hand #218540258389: {Club #3225207}  Hold'em No Limit (50/100) - 2020/09/17 16:35:01 ET
Table 'fun time' 9-max (Play Money) Seat #3 is the button
Seat 1: dddocky (7397 in chips) 
Seat 2: Duke Croix (9901 in chips) 
Seat 3: color_singleton (15716 in chips) 
Seat 4: MaFak2019 (24029 in chips) 
Seat 5: Klemtonius (32591 in chips) 
Seat 9: HighCardJasper (4713 in chips) 
MaFak2019: posts small blind 50
Klemtonius: posts big blind 100
*** HOLE CARDS ***
Dealt to Duke Croix [7c 4c]
HighCardJasper: calls 100
dddocky: calls 100
Duke Croix: calls 100
color_singleton: calls 100
MaFak2019: calls 50
Klemtonius: checks 
*** FLOP *** [6d 8c Ks]
MaFak2019: bets 400
Klemtonius: folds 
HighCardJasper: folds 
dddocky: folds 
Duke Croix: folds 
color_singleton: calls 400
*** TURN *** [6d 8c Ks] [Qd]
MaFak2019: bets 600
color_singleton: folds 
Uncalled bet (600) returned to MaFak2019
MaFak2019 collected 1323 from pot
MaFak2019: doesn't show hand 
*** SUMMARY ***
Total pot 1400 | Rake 77 
Board [6d 8c Ks Qd]
Seat 1: dddocky folded on the Flop
Seat 2: Duke Croix folded on the Flop
Seat 3: color_singleton (button) folded on the Turn
Seat 4: MaFak2019 (small blind) collected (1323)
Seat 5: Klemtonius (big blind) folded on the Flop
Seat 9: HighCardJasper folded on the Flop



PokerStars Home Game Hand #218540297916: {Club #3225207}  Hold'em No Limit (50/100) - 2020/09/17 16:36:03 ET
Table 'fun time' 9-max (Play Money) Seat #4 is the button
Seat 1: dddocky (7297 in chips) 
Seat 2: Duke Croix (9801 in chips) 
Seat 3: color_singleton (15216 in chips) 
Seat 4: MaFak2019 (24852 in chips) 
Seat 5: Klemtonius (32491 in chips) 
Seat 9: HighCardJasper (4613 in chips) 
Klemtonius: posts small blind 50
HighCardJasper: posts big blind 100
*** HOLE CARDS ***
Dealt to Duke Croix [Ac 7c]
dddocky: calls 100
Duke Croix: raises 400 to 500
color_singleton: calls 500
MaFak2019: folds 
Klemtonius: calls 450
HighCardJasper: folds 
dddocky: folds 
*** FLOP *** [9d As Ks]
Klemtonius: checks 
Duke Croix: bets 700
color_singleton: calls 700
Klemtonius: folds 
*** TURN *** [9d As Ks] [6d]
Duke Croix: bets 1100
color_singleton: folds 
Uncalled bet (1100) returned to Duke Croix
Duke Croix collected 2929 from pot
*** SUMMARY ***
Total pot 3100 | Rake 171 
Board [9d As Ks 6d]
Seat 1: dddocky folded before Flop
Seat 2: Duke Croix collected (2929)
Seat 3: color_singleton folded on the Turn
Seat 4: MaFak2019 (button) folded before Flop (didn't bet)
Seat 5: Klemtonius (small blind) folded on the Flop
Seat 9: HighCardJasper (big blind) folded before Flop



PokerStars Home Game Hand #218540332827: {Club #3225207}  Hold'em No Limit (50/100) - 2020/09/17 16:36:58 ET
Table 'fun time' 9-max (Play Money) Seat #5 is the button
Seat 1: dddocky (7197 in chips) 
Seat 2: Duke Croix (11530 in chips) 
Seat 3: color_singleton (14016 in chips) 
Seat 4: MaFak2019 (24852 in chips) 
Seat 5: Klemtonius (31991 in chips) 
Seat 9: HighCardJasper (4513 in chips) 
HighCardJasper: posts small blind 50
dddocky: posts big blind 100
*** HOLE CARDS ***
Dealt to Duke Croix [Qs 9s]
Duke Croix: raises 300 to 400
color_singleton: folds 
MaFak2019: calls 400
Klemtonius: calls 400
HighCardJasper: folds 
dddocky: folds 
*** FLOP *** [Ks 4h Qh]
Duke Croix: checks 
MaFak2019: checks 
Klemtonius: checks 
*** TURN *** [Ks 4h Qh] [Kh]
Duke Croix: bets 600
MaFak2019: folds 
Klemtonius: folds 
Uncalled bet (600) returned to Duke Croix
Duke Croix collected 1276 from pot
*** SUMMARY ***
Total pot 1350 | Rake 74 
Board [Ks 4h Qh Kh]
Seat 1: dddocky (big blind) folded before Flop
Seat 2: Duke Croix collected (1276)
Seat 3: color_singleton folded before Flop (didn't bet)
Seat 4: MaFak2019 folded on the Turn
Seat 5: Klemtonius (button) folded on the Turn
Seat 9: HighCardJasper (small blind) folded before Flop



PokerStars Home Game Hand #218540370614: {Club #3225207}  Hold'em No Limit (50/100) - 2020/09/17 16:37:57 ET
Table 'fun time' 9-max (Play Money) Seat #9 is the button
Seat 1: dddocky (7097 in chips) 
Seat 2: Duke Croix (12406 in chips) 
Seat 3: color_singleton (14016 in chips) 
Seat 4: MaFak2019 (24452 in chips) 
Seat 5: Klemtonius (31591 in chips) 
Seat 9: HighCardJasper (4463 in chips) 
dddocky: posts small blind 50
Duke Croix: posts big blind 100
*** HOLE CARDS ***
Dealt to Duke Croix [As Qs]
color_singleton: raises 100 to 200
MaFak2019: calls 200
Klemtonius: calls 200
HighCardJasper: folds 
dddocky: calls 150
Duke Croix: raises 8100 to 8300
color_singleton: folds 
MaFak2019: folds 
Klemtonius: folds 
dddocky: folds 
Uncalled bet (8100) returned to Duke Croix
Duke Croix collected 1000 from pot
*** SUMMARY ***
Total pot 1000 | Rake 0 
Seat 1: dddocky (small blind) folded before Flop
Seat 2: Duke Croix (big blind) collected (1000)
Seat 3: color_singleton folded before Flop
Seat 4: MaFak2019 folded before Flop
Seat 5: Klemtonius folded before Flop
Seat 9: HighCardJasper (button) folded before Flop (didn't bet)



PokerStars Home Game Hand #218540396256: {Club #3225207}  Hold'em No Limit (50/100) - 2020/09/17 16:38:38 ET
Table 'fun time' 9-max (Play Money) Seat #1 is the button
Seat 1: dddocky (6897 in chips) 
Seat 2: Duke Croix (13206 in chips) 
Seat 3: color_singleton (13816 in chips) 
Seat 4: MaFak2019 (24252 in chips) 
Seat 5: Klemtonius (31391 in chips) 
Seat 9: HighCardJasper (4463 in chips) 
Duke Croix: posts small blind 50
color_singleton: posts big blind 100
*** HOLE CARDS ***
Dealt to Duke Croix [Qd As]
MaFak2019: calls 100
Klemtonius: folds 
HighCardJasper: calls 100
dddocky: calls 100
Duke Croix: raises 400 to 500
color_singleton: calls 400
MaFak2019: calls 400
HighCardJasper: folds 
dddocky: calls 400
*** FLOP *** [5c Th Ad]
Duke Croix: bets 800
color_singleton: calls 800
MaFak2019: calls 800
dddocky: calls 800
*** TURN *** [5c Th Ad] [Js]
Duke Croix: checks 
color_singleton: checks 
MaFak2019: checks 
dddocky: checks 
*** RIVER *** [5c Th Ad Js] [Kh]
Duke Croix: bets 2750
color_singleton: folds 
MaFak2019: folds 
dddocky: calls 2750
*** SHOW DOWN ***
Duke Croix: shows [Qd As] (a straight, Ten to Ace)
dddocky: shows [Qc Qs] (a straight, Ten to Ace)
Duke Croix collected 5103 from pot
dddocky collected 5103 from pot
*** SUMMARY ***
Total pot 10800 | Rake 594 
Board [5c Th Ad Js Kh]
Seat 1: dddocky (button) showed [Qc Qs] and won (5103) with a straight, Ten to Ace
Seat 2: Duke Croix (small blind) showed [Qd As] and won (5103) with a straight, Ten to Ace
Seat 3: color_singleton (big blind) folded on the River
Seat 4: MaFak2019 folded on the River
Seat 5: Klemtonius folded before Flop (didn't bet)
Seat 9: HighCardJasper folded before Flop



PokerStars Home Game Hand #218540453693: {Club #3225207}  Hold'em No Limit (50/100) - 2020/09/17 16:40:10 ET
Table 'fun time' 9-max (Play Money) Seat #2 is the button
Seat 1: dddocky (7950 in chips) 
Seat 2: Duke Croix (14259 in chips) 
Seat 3: color_singleton (12516 in chips) 
Seat 4: MaFak2019 (22952 in chips) 
Seat 5: Klemtonius (31391 in chips) 
Seat 9: HighCardJasper (4363 in chips) 
color_singleton: posts small blind 50
MaFak2019: posts big blind 100
*** HOLE CARDS ***
Dealt to Duke Croix [5h 9c]
Klemtonius: folds 
HighCardJasper: calls 100
dddocky: calls 100
Duke Croix: folds 
color_singleton: calls 50
MaFak2019: checks 
*** FLOP *** [4d Qd Qs]
color_singleton: bets 200
MaFak2019: calls 200
HighCardJasper: folds 
dddocky: calls 200
*** TURN *** [4d Qd Qs] [Qh]
color_singleton: bets 472
MaFak2019: calls 472
dddocky: calls 472
*** RIVER *** [4d Qd Qs Qh] [Ks]
color_singleton: checks 
MaFak2019: bets 2180
dddocky: folds 
color_singleton: calls 2180
*** SHOW DOWN ***
MaFak2019: shows [7c Kd] (a full house, Queens full of Kings)
color_singleton: mucks hand 
MaFak2019 collected 6403 from pot
*** SUMMARY ***
Total pot 6776 | Rake 373 
Board [4d Qd Qs Qh Ks]
Seat 1: dddocky folded on the River
Seat 2: Duke Croix (button) folded before Flop (didn't bet)
Seat 3: color_singleton (small blind) mucked [7s 4s]
Seat 4: MaFak2019 (big blind) showed [7c Kd] and won (6403) with a full house, Queens full of Kings
Seat 5: Klemtonius folded before Flop (didn't bet)
Seat 9: HighCardJasper folded on the Flop



PokerStars Home Game Hand #218540499810: {Club #3225207}  Hold'em No Limit (50/100) - 2020/09/17 16:41:14 ET
Table 'fun time' 9-max (Play Money) Seat #3 is the button
Seat 1: dddocky (7178 in chips) 
Seat 2: Duke Croix (14259 in chips) 
Seat 3: color_singleton (9564 in chips) 
Seat 4: MaFak2019 (26403 in chips) 
Seat 5: Klemtonius (31391 in chips) 
Seat 9: HighCardJasper (4263 in chips) 
MaFak2019: posts small blind 50
Klemtonius: posts big blind 100
*** HOLE CARDS ***
Dealt to Duke Croix [Kc 5s]
HighCardJasper: raises 300 to 400
dddocky: folds 
Duke Croix: folds 
color_singleton: folds 
MaFak2019: calls 350
Klemtonius: calls 300
*** FLOP *** [4s Js Td]
MaFak2019: checks 
Klemtonius: checks 
HighCardJasper: checks 
*** TURN *** [4s Js Td] [2h]
MaFak2019: checks 
Klemtonius: bets 1134
HighCardJasper: folds 
MaFak2019: calls 1134
*** RIVER *** [4s Js Td 2h] [Qd]
MaFak2019: bets 24869 and is all-in
Klemtonius: folds 
Uncalled bet (24869) returned to MaFak2019
MaFak2019 collected 3277 from pot
MaFak2019: doesn't show hand 
*** SUMMARY ***
Total pot 3468 | Rake 191 
Board [4s Js Td 2h Qd]
Seat 1: dddocky folded before Flop (didn't bet)
Seat 2: Duke Croix folded before Flop (didn't bet)
Seat 3: color_singleton (button) folded before Flop (didn't bet)
Seat 4: MaFak2019 (small blind) collected (3277)
Seat 5: Klemtonius (big blind) folded on the River
Seat 9: HighCardJasper folded on the Turn



PokerStars Home Game Hand #218540534668: {Club #3225207}  Hold'em No Limit (50/100) - 2020/09/17 16:42:09 ET
Table 'fun time' 9-max (Play Money) Seat #4 is the button
Seat 1: dddocky (7178 in chips) 
Seat 2: Duke Croix (14259 in chips) 
Seat 3: color_singleton (9564 in chips) 
Seat 4: MaFak2019 (28146 in chips) 
Seat 5: Klemtonius (29857 in chips) 
Seat 9: HighCardJasper (3863 in chips) 
Klemtonius: posts small blind 50
HighCardJasper: posts big blind 100
*** HOLE CARDS ***
Dealt to Duke Croix [3s 4s]
dddocky: calls 100
Duke Croix: calls 100
color_singleton: raises 200 to 300
MaFak2019: calls 300
Klemtonius: calls 250
HighCardJasper: calls 200
dddocky: calls 200
Duke Croix: calls 200
*** FLOP *** [5s Qs 9h]
Klemtonius: checks 
HighCardJasper: checks 
dddocky: checks 
Duke Croix: bets 900
color_singleton: folds 
MaFak2019: calls 900
Klemtonius: folds 
HighCardJasper: folds 
dddocky: folds 
*** TURN *** [5s Qs 9h] [Ts]
Duke Croix: bets 1800
MaFak2019: calls 1800
*** RIVER *** [5s Qs 9h Ts] [6c]
Duke Croix: bets 3300
MaFak2019: folds 
Uncalled bet (3300) returned to Duke Croix
Duke Croix collected 6804 from pot
*** SUMMARY ***
Total pot 7200 | Rake 396 
Board [5s Qs 9h Ts 6c]
Seat 1: dddocky folded on the Flop
Seat 2: Duke Croix collected (6804)
Seat 3: color_singleton folded on the Flop
Seat 4: MaFak2019 (button) folded on the River
Seat 5: Klemtonius (small blind) folded on the Flop
Seat 9: HighCardJasper (big blind) folded on the Flop



PokerStars Home Game Hand #218540579055: {Club #3225207}  Hold'em No Limit (50/100) - 2020/09/17 16:43:21 ET
Table 'fun time' 9-max (Play Money) Seat #5 is the button
Seat 1: dddocky (6878 in chips) 
Seat 2: Duke Croix (18063 in chips) 
Seat 3: color_singleton (9264 in chips) 
Seat 4: MaFak2019 (25146 in chips) 
Seat 5: Klemtonius (29557 in chips) 
Seat 9: HighCardJasper (3563 in chips) 
HighCardJasper: posts small blind 50
dddocky: posts big blind 100
*** HOLE CARDS ***
Dealt to Duke Croix [Kh 4s]
Duke Croix: folds 
color_singleton: folds 
MaFak2019: folds 
Klemtonius: folds 
HighCardJasper: calls 50
dddocky: checks 
*** FLOP *** [Qd 2h Kc]
HighCardJasper: checks 
dddocky: bets 100
HighCardJasper: folds 
Uncalled bet (100) returned to dddocky
dddocky collected 189 from pot
dddocky: doesn't show hand 
*** SUMMARY ***
Total pot 200 | Rake 11 
Board [Qd 2h Kc]
Seat 1: dddocky (big blind) collected (189)
Seat 2: Duke Croix folded before Flop (didn't bet)
Seat 3: color_singleton folded before Flop (didn't bet)
Seat 4: MaFak2019 folded before Flop (didn't bet)
Seat 5: Klemtonius (button) folded before Flop (didn't bet)
Seat 9: HighCardJasper (small blind) folded on the Flop



PokerStars Home Game Hand #218540594967: {Club #3225207}  Hold'em No Limit (50/100) - 2020/09/17 16:43:46 ET
Table 'fun time' 9-max (Play Money) Seat #9 is the button
Seat 1: dddocky (6967 in chips) 
Seat 2: Duke Croix (18063 in chips) 
Seat 3: color_singleton (9264 in chips) 
Seat 4: MaFak2019 (25146 in chips) 
Seat 5: Klemtonius (29557 in chips) 
Seat 9: HighCardJasper (3463 in chips) 
dddocky: posts small blind 50
Duke Croix: posts big blind 100
*** HOLE CARDS ***
Dealt to Duke Croix [2c 9d]
color_singleton: folds 
MaFak2019: calls 100
Klemtonius: raises 221 to 321
HighCardJasper: calls 321
dddocky: folds 
Duke Croix: folds 
MaFak2019: calls 221
*** FLOP *** [8d Ks 6d]
MaFak2019: bets 600
Klemtonius: folds 
HighCardJasper: folds 
Uncalled bet (600) returned to MaFak2019
MaFak2019 collected 1052 from pot
MaFak2019: doesn't show hand 
*** SUMMARY ***
Total pot 1113 | Rake 61 
Board [8d Ks 6d]
Seat 1: dddocky (small blind) folded before Flop
Seat 2: Duke Croix (big blind) folded before Flop
Seat 3: color_singleton folded before Flop (didn't bet)
Seat 4: MaFak2019 collected (1052)
Seat 5: Klemtonius folded on the Flop
Seat 9: HighCardJasper (button) folded on the Flop



PokerStars Home Game Hand #218540626186: {Club #3225207}  Hold'em No Limit (50/100) - 2020/09/17 16:44:36 ET
Table 'fun time' 9-max (Play Money) Seat #1 is the button
Seat 1: dddocky (6917 in chips) 
Seat 2: Duke Croix (17963 in chips) 
Seat 3: color_singleton (9264 in chips) 
Seat 4: MaFak2019 (25877 in chips) 
Seat 5: Klemtonius (29236 in chips) 
Seat 9: HighCardJasper (3142 in chips) 
Duke Croix: posts small blind 50
color_singleton: posts big blind 100
*** HOLE CARDS ***
Dealt to Duke Croix [5h 7c]
MaFak2019: calls 100
Klemtonius: raises 100 to 200
HighCardJasper: folds 
dddocky: calls 200
Duke Croix: folds 
color_singleton: calls 100
MaFak2019: calls 100
*** FLOP *** [7h Th 8s]
color_singleton: checks 
MaFak2019: checks 
Klemtonius: bets 650
dddocky: folds 
color_singleton: folds 
MaFak2019: calls 650
*** TURN *** [7h Th 8s] [3h]
MaFak2019: checks 
Klemtonius: bets 2032
MaFak2019: calls 2032
*** RIVER *** [7h Th 8s 3h] [5s]
MaFak2019: checks 
Klemtonius: checks 
*** SHOW DOWN ***
MaFak2019: shows [Qh 7s] (a pair of Sevens)
Klemtonius: mucks hand 
MaFak2019 collected 5872 from pot
*** SUMMARY ***
Total pot 6214 | Rake 342 
Board [7h Th 8s 3h 5s]
Seat 1: dddocky (button) folded on the Flop
Seat 2: Duke Croix (small blind) folded before Flop
Seat 3: color_singleton (big blind) folded on the Flop
Seat 4: MaFak2019 showed [Qh 7s] and won (5872) with a pair of Sevens
Seat 5: Klemtonius mucked [Qc 4h]
Seat 9: HighCardJasper folded before Flop (didn't bet)



PokerStars Home Game Hand #218540675006: {Club #3225207}  Hold'em No Limit (50/100) - 2020/09/17 16:45:54 ET
Table 'fun time' 9-max (Play Money) Seat #2 is the button
Seat 1: dddocky (6717 in chips) 
Seat 2: Duke Croix (17913 in chips) 
Seat 3: color_singleton (9064 in chips) 
Seat 4: MaFak2019 (28867 in chips) 
Seat 5: Klemtonius (26354 in chips) 
Seat 9: HighCardJasper (3142 in chips) 
color_singleton: posts small blind 50
MaFak2019: posts big blind 100
*** HOLE CARDS ***
Dealt to Duke Croix [Kc Qc]
Klemtonius: calls 100
HighCardJasper: calls 100
dddocky: calls 100
Duke Croix: raises 500 to 600
color_singleton: folds 
MaFak2019: calls 500
Klemtonius: calls 500
HighCardJasper: folds 
dddocky: folds 
*** FLOP *** [4s 6d 2s]
MaFak2019: checks 
Klemtonius: checks 
Duke Croix: bets 1000
MaFak2019: folds 
Klemtonius: folds 
Uncalled bet (1000) returned to Duke Croix
Duke Croix collected 1937 from pot
*** SUMMARY ***
Total pot 2050 | Rake 113 
Board [4s 6d 2s]
Seat 1: dddocky folded before Flop
Seat 2: Duke Croix (button) collected (1937)
Seat 3: color_singleton (small blind) folded before Flop
Seat 4: MaFak2019 (big blind) folded on the Flop
Seat 5: Klemtonius folded on the Flop
Seat 9: HighCardJasper folded before Flop



PokerStars Home Game Hand #218540709961: {Club #3225207}  Hold'em No Limit (50/100) - 2020/09/17 16:46:50 ET
Table 'fun time' 9-max (Play Money) Seat #3 is the button
Seat 1: dddocky (6617 in chips) 
Seat 2: Duke Croix (19250 in chips) 
Seat 3: color_singleton (9014 in chips) 
Seat 4: MaFak2019 (28267 in chips) 
Seat 5: Klemtonius (25754 in chips) 
Seat 9: HighCardJasper (3042 in chips) 
MaFak2019: posts small blind 50
Klemtonius: posts big blind 100
*** HOLE CARDS ***
Dealt to Duke Croix [4s Jh]
HighCardJasper: calls 100
dddocky: folds 
Duke Croix: folds 
color_singleton: raises 100 to 200
MaFak2019: calls 150
Klemtonius: calls 100
HighCardJasper: calls 100
*** FLOP *** [6h Qd 8c]
MaFak2019: checks 
Klemtonius: bets 756
HighCardJasper: folds 
color_singleton: folds 
MaFak2019: folds 
Uncalled bet (756) returned to Klemtonius
Klemtonius collected 756 from pot
Klemtonius: doesn't show hand 
*** SUMMARY ***
Total pot 800 | Rake 44 
Board [6h Qd 8c]
Seat 1: dddocky folded before Flop (didn't bet)
Seat 2: Duke Croix folded before Flop (didn't bet)
Seat 3: color_singleton (button) folded on the Flop
Seat 4: MaFak2019 (small blind) folded on the Flop
Seat 5: Klemtonius (big blind) collected (756)
Seat 9: HighCardJasper folded on the Flop



PokerStars Home Game Hand #218540729608: {Club #3225207}  Hold'em No Limit (50/100) - 2020/09/17 16:47:22 ET
Table 'fun time' 9-max (Play Money) Seat #4 is the button
Seat 1: dddocky (6617 in chips) 
Seat 2: Duke Croix (19250 in chips) 
Seat 3: color_singleton (8814 in chips) 
Seat 4: MaFak2019 (28067 in chips) 
Seat 5: Klemtonius (26310 in chips) 
Seat 9: HighCardJasper (2842 in chips) 
Klemtonius: posts small blind 50
HighCardJasper: posts big blind 100
*** HOLE CARDS ***
Dealt to Duke Croix [Ac 5s]
dddocky: folds 
Duke Croix: calls 100
color_singleton: folds 
MaFak2019: calls 100
Klemtonius: raises 100 to 200
HighCardJasper: calls 100
Duke Croix: calls 100
MaFak2019: calls 100
*** FLOP *** [6c 9s 2c]
Klemtonius: bets 756
HighCardJasper: folds 
Duke Croix: folds 
MaFak2019: folds 
Uncalled bet (756) returned to Klemtonius
Klemtonius collected 756 from pot
Klemtonius: doesn't show hand 
*** SUMMARY ***
Total pot 800 | Rake 44 
Board [6c 9s 2c]
Seat 1: dddocky folded before Flop (didn't bet)
Seat 2: Duke Croix folded on the Flop
Seat 3: color_singleton folded before Flop (didn't bet)
Seat 4: MaFak2019 (button) folded on the Flop
Seat 5: Klemtonius (small blind) collected (756)
Seat 9: HighCardJasper (big blind) folded on the Flop



PokerStars Home Game Hand #218540754885: {Club #3225207}  Hold'em No Limit (50/100) - 2020/09/17 16:48:02 ET
Table 'fun time' 9-max (Play Money) Seat #5 is the button
Seat 1: dddocky (6617 in chips) 
Seat 2: Duke Croix (19050 in chips) 
Seat 3: color_singleton (8814 in chips) 
Seat 4: MaFak2019 (27867 in chips) 
Seat 5: Klemtonius (26866 in chips) 
Seat 9: HighCardJasper (2642 in chips) 
HighCardJasper: posts small blind 50
dddocky: posts big blind 100
*** HOLE CARDS ***
Dealt to Duke Croix [6s 5c]
Duke Croix: folds 
color_singleton: raises 100 to 200
MaFak2019: calls 200
Klemtonius: calls 200
HighCardJasper: folds 
dddocky: folds 
*** FLOP *** [Qc 2d 5d]
color_singleton: checks 
MaFak2019: checks 
Klemtonius: checks 
*** TURN *** [Qc 2d 5d] [Js]
color_singleton: bets 354
MaFak2019: calls 354
Klemtonius: raises 1046 to 1400
color_singleton: calls 1046
MaFak2019: folds 
*** RIVER *** [Qc 2d 5d Js] [Qd]
color_singleton: checks 
Klemtonius: checks 
*** SHOW DOWN ***
color_singleton: shows [7s Jh] (two pair, Queens and Jacks)
Klemtonius: shows [Jc Kh] (two pair, Queens and Jacks - King kicker)
Klemtonius collected 3689 from pot
*** SUMMARY ***
Total pot 3904 | Rake 215 
Board [Qc 2d 5d Js Qd]
Seat 1: dddocky (big blind) folded before Flop
Seat 2: Duke Croix folded before Flop (didn't bet)
Seat 3: color_singleton showed [7s Jh] and lost with two pair, Queens and Jacks
Seat 4: MaFak2019 folded on the Turn
Seat 5: Klemtonius (button) showed [Jc Kh] and won (3689) with two pair, Queens and Jacks
Seat 9: HighCardJasper (small blind) folded before Flop



PokerStars Home Game Hand #218540788549: {Club #3225207}  Hold'em No Limit (50/100) - 2020/09/17 16:48:56 ET
Table 'fun time' 9-max (Play Money) Seat #9 is the button
Seat 1: dddocky (6517 in chips) 
Seat 2: Duke Croix (19050 in chips) 
Seat 3: color_singleton (7214 in chips) 
Seat 4: MaFak2019 (27313 in chips) 
Seat 5: Klemtonius (28955 in chips) 
Seat 9: HighCardJasper (2592 in chips) 
dddocky: posts small blind 50
Duke Croix: posts big blind 100
*** HOLE CARDS ***
Dealt to Duke Croix [8s 7d]
color_singleton: raises 100 to 200
MaFak2019: folds 
Klemtonius: raises 300 to 500
HighCardJasper: calls 500
dddocky: calls 450
Duke Croix: folds 
color_singleton: calls 300
*** FLOP *** [9c Ks Qh]
dddocky: checks 
color_singleton: checks 
Klemtonius: bets 1700
HighCardJasper: folds 
dddocky: calls 1700
color_singleton: folds 
*** TURN *** [9c Ks Qh] [3c]
dddocky: checks 
Klemtonius: checks 
*** RIVER *** [9c Ks Qh 3c] [Td]
dddocky: bets 4317 and is all-in
Klemtonius: calls 4317
*** SHOW DOWN ***
dddocky: shows [Kd 9s] (two pair, Kings and Nines)
Klemtonius: shows [Jh As] (a straight, Ten to Ace)
Klemtonius collected 13357 from pot
*** SUMMARY ***
Total pot 14134 | Rake 777 
Board [9c Ks Qh 3c Td]
Seat 1: dddocky (small blind) showed [Kd 9s] and lost with two pair, Kings and Nines
Seat 2: Duke Croix (big blind) folded before Flop
Seat 3: color_singleton folded on the Flop
Seat 4: MaFak2019 folded before Flop (didn't bet)
Seat 5: Klemtonius showed [Jh As] and won (13357) with a straight, Ten to Ace
Seat 9: HighCardJasper (button) folded on the Flop



PokerStars Home Game Hand #218540814961: {Club #3225207}  Hold'em No Limit (50/100) - 2020/09/17 16:49:38 ET
Table 'fun time' 9-max (Play Money) Seat #2 is the button
Seat 2: Duke Croix (18950 in chips) 
Seat 3: color_singleton (6714 in chips) 
Seat 4: MaFak2019 (27313 in chips) 
Seat 5: Klemtonius (35795 in chips) 
Seat 9: HighCardJasper (2092 in chips) 
color_singleton: posts small blind 50
MaFak2019: posts big blind 100
*** HOLE CARDS ***
Dealt to Duke Croix [3h Tc]
Klemtonius: calls 100
HighCardJasper: calls 100
Duke Croix: folds 
color_singleton: folds 
MaFak2019: checks 
*** FLOP *** [Kh 4s 2s]
MaFak2019: checks 
Klemtonius: checks 
HighCardJasper: checks 
*** TURN *** [Kh 4s 2s] [6h]
MaFak2019: checks 
Klemtonius: checks 
HighCardJasper: bets 200
MaFak2019: calls 200
Klemtonius: folds 
*** RIVER *** [Kh 4s 2s 6h] [Td]
MaFak2019: checks 
HighCardJasper: checks 
*** SHOW DOWN ***
MaFak2019: shows [Jh 7c] (high card King)
HighCardJasper: shows [6s 9d] (a pair of Sixes)
HighCardJasper collected 709 from pot
*** SUMMARY ***
Total pot 750 | Rake 41 
Board [Kh 4s 2s 6h Td]
Seat 2: Duke Croix (button) folded before Flop (didn't bet)
Seat 3: color_singleton (small blind) folded before Flop
Seat 4: MaFak2019 (big blind) showed [Jh 7c] and lost with high card King
Seat 5: Klemtonius folded on the Turn
Seat 9: HighCardJasper showed [6s 9d] and won (709) with a pair of Sixes



PokerStars Home Game Hand #218540845223: {Club #3225207}  Hold'em No Limit (50/100) - 2020/09/17 16:50:27 ET
Table 'fun time' 9-max (Play Money) Seat #3 is the button
Seat 1: dddocky (10000 in chips) 
Seat 2: Duke Croix (18950 in chips) 
Seat 3: color_singleton (6664 in chips) 
Seat 4: MaFak2019 (27013 in chips) 
Seat 5: Klemtonius (35695 in chips) 
Seat 9: HighCardJasper (2501 in chips) 
MaFak2019: posts small blind 50
Klemtonius: posts big blind 100
*** HOLE CARDS ***
Dealt to Duke Croix [2c 7h]
HighCardJasper: folds 
dddocky: folds 
Duke Croix: folds 
color_singleton has timed out
color_singleton: folds 
MaFak2019: calls 50
Klemtonius: checks 
*** FLOP *** [Kh Ad Qd]
MaFak2019: bets 300
Klemtonius: raises 300 to 600
MaFak2019: calls 300
*** TURN *** [Kh Ad Qd] [Js]
MaFak2019: checks 
Klemtonius: bets 2300
MaFak2019: calls 2300
*** RIVER *** [Kh Ad Qd Js] [Qc]
MaFak2019: checks 
Klemtonius: bets 7400
MaFak2019: calls 7400
*** SHOW DOWN ***
Klemtonius: shows [Td 2d] (a straight, Ten to Ace)
MaFak2019: mucks hand 
Klemtonius collected 19656 from pot
*** SUMMARY ***
Total pot 20800 | Rake 1144 
Board [Kh Ad Qd Js Qc]
Seat 1: dddocky folded before Flop (didn't bet)
Seat 2: Duke Croix folded before Flop (didn't bet)
Seat 3: color_singleton (button) folded before Flop (didn't bet)
Seat 4: MaFak2019 (small blind) mucked [Ah 4s]
Seat 5: Klemtonius (big blind) showed [Td 2d] and won (19656) with a straight, Ten to Ace
Seat 9: HighCardJasper folded before Flop (didn't bet)



PokerStars Home Game Hand #218540898314: {Club #3225207}  Hold'em No Limit (50/100) - 2020/09/17 16:51:54 ET
Table 'fun time' 9-max (Play Money) Seat #4 is the button
Seat 1: dddocky (10000 in chips) 
Seat 2: Duke Croix (18950 in chips) 
Seat 4: MaFak2019 (16613 in chips) 
Seat 5: Klemtonius (44951 in chips) 
Seat 9: HighCardJasper (2501 in chips) 
Klemtonius: posts small blind 50
HighCardJasper: posts big blind 100
*** HOLE CARDS ***
Dealt to Duke Croix [5c Kh]
dddocky: folds 
Duke Croix: folds 
MaFak2019: calls 100
Klemtonius: raises 300 to 400
HighCardJasper: calls 300
MaFak2019: calls 300
*** FLOP *** [Kd 2s Tc]
Klemtonius: bets 567
HighCardJasper: calls 567
MaFak2019: folds 
*** TURN *** [Kd 2s Tc] [Jd]
Klemtonius: checks 
HighCardJasper: checks 
*** RIVER *** [Kd 2s Tc Jd] [9s]
Klemtonius: bets 1600
HighCardJasper: calls 1534 and is all-in
Uncalled bet (66) returned to Klemtonius
*** SHOW DOWN ***
Klemtonius: shows [Qh Ah] (a straight, Ten to Ace)
HighCardJasper: shows [Kc Th] (two pair, Kings and Tens)
Klemtonius collected 5105 from pot
*** SUMMARY ***
Total pot 5402 | Rake 297 
Board [Kd 2s Tc Jd 9s]
Seat 1: dddocky folded before Flop (didn't bet)
Seat 2: Duke Croix folded before Flop (didn't bet)
Seat 4: MaFak2019 (button) folded on the Flop
Seat 5: Klemtonius (small blind) showed [Qh Ah] and won (5105) with a straight, Ten to Ace
Seat 9: HighCardJasper (big blind) showed [Kc Th] and lost with two pair, Kings and Tens



PokerStars Home Game Hand #218540939708: {Club #3225207}  Hold'em No Limit (50/100) - 2020/09/17 16:53:01 ET
Table 'fun time' 9-max (Play Money) Seat #5 is the button
Seat 1: dddocky (10000 in chips) 
Seat 2: Duke Croix (18950 in chips) 
Seat 4: MaFak2019 (16213 in chips) 
Seat 5: Klemtonius (47555 in chips) 
dddocky: posts small blind 50
Duke Croix: posts big blind 100
*** HOLE CARDS ***
Dealt to Duke Croix [9s 6h]
MaFak2019: calls 100
Klemtonius: calls 100
dddocky: calls 50
Duke Croix: checks 
*** FLOP *** [Ks 3h As]
dddocky: checks 
Duke Croix: checks 
MaFak2019: checks 
Klemtonius: checks 
*** TURN *** [Ks 3h As] [Qd]
dddocky: checks 
Duke Croix: checks 
MaFak2019: checks 
Klemtonius: bets 378
dddocky: folds 
Duke Croix: folds 
MaFak2019 has timed out
MaFak2019: folds 
Uncalled bet (378) returned to Klemtonius
Klemtonius collected 378 from pot
Klemtonius: doesn't show hand 
*** SUMMARY ***
Total pot 400 | Rake 22 
Board [Ks 3h As Qd]
Seat 1: dddocky (small blind) folded on the Turn
Seat 2: Duke Croix (big blind) folded on the Turn
Seat 4: MaFak2019 folded on the Turn
Seat 5: Klemtonius (button) collected (378)



PokerStars Home Game Hand #218540986954: {Club #3225207}  Hold'em No Limit (50/100) - 2020/09/17 16:54:19 ET
Table 'fun time' 9-max (Play Money) Seat #1 is the button
Seat 1: dddocky (9900 in chips) 
Seat 2: Duke Croix (18850 in chips) 
Seat 5: Klemtonius (47833 in chips) 
Seat 9: HighCardJasper (10000 in chips) 
Duke Croix: posts small blind 50
Klemtonius: posts big blind 100
HighCardJasper: posts small blind 50
*** HOLE CARDS ***
Dealt to Duke Croix [8c Js]
HighCardJasper: calls 100
dddocky: calls 100
Duke Croix: calls 50
Klemtonius: checks 
*** FLOP *** [Ah Th 2d]
Duke Croix: checks 
Klemtonius: bets 425
HighCardJasper: calls 425
dddocky: folds 
Duke Croix: folds 
*** TURN *** [Ah Th 2d] [9d]
Klemtonius: bets 614
HighCardJasper: raises 614 to 1228
Klemtonius: calls 614
*** RIVER *** [Ah Th 2d 9d] [Td]
Klemtonius: checks 
HighCardJasper: checks 
*** SHOW DOWN ***
Klemtonius: shows [Qh 5h] (a pair of Tens)
HighCardJasper: shows [As 2s] (two pair, Aces and Tens)
HighCardJasper collected 3549 from pot
*** SUMMARY ***
Total pot 3756 | Rake 207 
Board [Ah Th 2d 9d Td]
Seat 1: dddocky (button) folded on the Flop
Seat 2: Duke Croix (small blind) folded on the Flop
Seat 5: Klemtonius (big blind) showed [Qh 5h] and lost with a pair of Tens
Seat 9: HighCardJasper showed [As 2s] and won (3549) with two pair, Aces and Tens



PokerStars Home Game Hand #218541011964: {Club #3225207}  Hold'em No Limit (50/100) - 2020/09/17 16:55:00 ET
Table 'fun time' 9-max (Play Money) Seat #2 is the button
Seat 1: dddocky (9800 in chips) 
Seat 2: Duke Croix (18750 in chips) 
Seat 5: Klemtonius (46080 in chips) 
Seat 9: HighCardJasper (11746 in chips) 
Klemtonius: posts small blind 50
HighCardJasper: posts big blind 100
*** HOLE CARDS ***
Dealt to Duke Croix [4h 7c]
dddocky: calls 100
Duke Croix: folds 
Klemtonius: calls 50
HighCardJasper: checks 
*** FLOP *** [3d Kh Ah]
Klemtonius: checks 
HighCardJasper: checks 
dddocky: checks 
*** TURN *** [3d Kh Ah] [Qd]
Klemtonius: checks 
HighCardJasper: checks 
dddocky: bets 283
Klemtonius: folds 
HighCardJasper: calls 283
*** RIVER *** [3d Kh Ah Qd] [8c]
HighCardJasper: checks 
dddocky: bets 818
HighCardJasper: folds 
Uncalled bet (818) returned to dddocky
dddocky collected 818 from pot
dddocky: doesn't show hand 
*** SUMMARY ***
Total pot 866 | Rake 48 
Board [3d Kh Ah Qd 8c]
Seat 1: dddocky collected (818)
Seat 2: Duke Croix (button) folded before Flop (didn't bet)
Seat 5: Klemtonius (small blind) folded on the Turn
Seat 9: HighCardJasper (big blind) folded on the River



PokerStars Home Game Hand #218541037970: {Club #3225207}  Hold'em No Limit (50/100) - 2020/09/17 16:56:00 ET
Table 'fun time' 9-max (Play Money) Seat #5 is the button
Seat 1: dddocky (10235 in chips) 
Seat 2: Duke Croix (18750 in chips) 
Seat 3: color_singleton (6664 in chips) 
Seat 4: MaFak2019 (16113 in chips) 
Seat 5: Klemtonius (45980 in chips) 
Seat 9: HighCardJasper (11363 in chips) 
HighCardJasper: posts small blind 50
dddocky: posts big blind 100
color_singleton: posts small & big blinds 150
MaFak2019: posts small & big blinds 150
*** HOLE CARDS ***
Dealt to Duke Croix [9c 6s]
Duke Croix: folds 
color_singleton: checks 
MaFak2019: checks 
Klemtonius: calls 100
HighCardJasper: calls 50
dddocky: checks 
*** FLOP *** [9s 3h 4s]
HighCardJasper: checks 
dddocky: checks 
color_singleton: checks 
MaFak2019: checks 
Klemtonius: checks 
*** TURN *** [9s 3h 4s] [Ac]
HighCardJasper: checks 
dddocky: checks 
color_singleton: checks 
MaFak2019: checks 
Klemtonius: bets 567
HighCardJasper: folds 
dddocky: folds 
color_singleton: folds 
MaFak2019: folds 
Uncalled bet (567) returned to Klemtonius
Klemtonius collected 567 from pot
Klemtonius: doesn't show hand 
*** SUMMARY ***
Total pot 600 | Rake 33 
Board [9s 3h 4s Ac]
Seat 1: dddocky (big blind) folded on the Turn
Seat 2: Duke Croix folded before Flop (didn't bet)
Seat 3: color_singleton folded on the Turn (didn't bet)
Seat 4: MaFak2019 folded on the Turn (didn't bet)
Seat 5: Klemtonius (button) collected (567)
Seat 9: HighCardJasper (small blind) folded on the Turn



PokerStars Home Game Hand #218541062930: {Club #3225207}  Hold'em No Limit (50/100) - 2020/09/17 16:56:57 ET
Table 'fun time' 9-max (Play Money) Seat #9 is the button
Seat 1: dddocky (10135 in chips) 
Seat 2: Duke Croix (18750 in chips) 
Seat 3: color_singleton (6514 in chips) 
Seat 4: MaFak2019 (15963 in chips) 
Seat 5: Klemtonius (46447 in chips) 
Seat 9: HighCardJasper (11263 in chips) 
dddocky: posts small blind 50
Duke Croix: posts big blind 100
*** HOLE CARDS ***
Dealt to Duke Croix [5c 2h]
color_singleton: raises 200 to 300
MaFak2019: folds 
Klemtonius: raises 200 to 500
HighCardJasper: folds 
dddocky: calls 450
Duke Croix: folds 
color_singleton: calls 200
*** FLOP *** [Qc Js Th]
dddocky: bets 1512
color_singleton: folds 
Klemtonius: raises 7988 to 9500
dddocky: calls 7988
*** TURN *** [Qc Js Th] [Td]
dddocky: bets 135 and is all-in
Klemtonius: calls 135
*** RIVER *** [Qc Js Th Td] [5d]
*** SHOW DOWN ***
dddocky: shows [Qd 8d] (two pair, Queens and Tens)
Klemtonius: shows [Kc Qs] (two pair, Queens and Tens - King kicker)
Klemtonius collected 19722 from pot
*** SUMMARY ***
Total pot 20870 | Rake 1148 
Board [Qc Js Th Td 5d]
Seat 1: dddocky (small blind) showed [Qd 8d] and lost with two pair, Queens and Tens
Seat 2: Duke Croix (big blind) folded before Flop
Seat 3: color_singleton folded on the Flop
Seat 4: MaFak2019 folded before Flop (didn't bet)
Seat 5: Klemtonius showed [Kc Qs] and won (19722) with two pair, Queens and Tens
Seat 9: HighCardJasper (button) folded before Flop (didn't bet)



PokerStars Home Game Hand #218541097474: {Club #3225207}  Hold'em No Limit (50/100) - 2020/09/17 16:57:52 ET
Table 'fun time' 9-max (Play Money) Seat #2 is the button
Seat 2: Duke Croix (18650 in chips) 
Seat 3: color_singleton (6014 in chips) 
Seat 4: MaFak2019 (15963 in chips) 
Seat 5: Klemtonius (56034 in chips) 
Seat 9: HighCardJasper (11263 in chips) 
color_singleton: posts small blind 50
MaFak2019: posts big blind 100
*** HOLE CARDS ***
Dealt to Duke Croix [Qh 2d]
Klemtonius: calls 100
HighCardJasper: calls 100
Duke Croix has timed out
Duke Croix: folds 
color_singleton: raises 200 to 300
MaFak2019: folds 
Klemtonius: calls 200
HighCardJasper: calls 200
*** FLOP *** [Kc Ts 7h]
color_singleton: bets 472
Klemtonius: folds 
HighCardJasper: folds 
Uncalled bet (472) returned to color_singleton
color_singleton collected 945 from pot
color_singleton: doesn't show hand 
*** SUMMARY ***
Total pot 1000 | Rake 55 
Board [Kc Ts 7h]
Seat 2: Duke Croix (button) folded before Flop (didn't bet)
Seat 3: color_singleton (small blind) collected (945)
Seat 4: MaFak2019 (big blind) folded before Flop
Seat 5: Klemtonius folded on the Flop
Seat 9: HighCardJasper folded on the Flop



PokerStars Home Game Hand #218541146249: {Club #3225207}  Hold'em No Limit (50/100) - 2020/09/17 16:59:43 ET
Table 'fun time' 9-max (Play Money) Seat #4 is the button
Seat 1: dddocky (9569 in chips) 
Seat 2: Duke Croix (18650 in chips) 
Seat 3: color_singleton (6659 in chips) 
Seat 4: MaFak2019 (15813 in chips) 
Seat 5: Klemtonius (56259 in chips) 
Seat 9: HighCardJasper (10863 in chips) 
Klemtonius: posts small blind 50
HighCardJasper: posts big blind 100
*** HOLE CARDS ***
Dealt to Duke Croix [8s 9s]
dddocky: folds 
Duke Croix: raises 200 to 300
color_singleton: folds 
MaFak2019: calls 300
Klemtonius: calls 250
HighCardJasper: calls 200
*** FLOP *** [9d 6h 4h]
Klemtonius: checks 
HighCardJasper: checks 
Duke Croix: bets 700
MaFak2019: folds 
Klemtonius: folds 
HighCardJasper: folds 
Uncalled bet (700) returned to Duke Croix
Duke Croix collected 1134 from pot
*** SUMMARY ***
Total pot 1200 | Rake 66 
Board [9d 6h 4h]
Seat 1: dddocky folded before Flop (didn't bet)
Seat 2: Duke Croix collected (1134)
Seat 3: color_singleton folded before Flop (didn't bet)
Seat 4: MaFak2019 (button) folded on the Flop
Seat 5: Klemtonius (small blind) folded on the Flop
Seat 9: HighCardJasper (big blind) folded on the Flop



PokerStars Home Game Hand #218541165146: {Club #3225207}  Hold'em No Limit (50/100) - 2020/09/17 17:00:24 ET
Table 'fun time' 9-max (Play Money) Seat #5 is the button
Seat 1: dddocky (9569 in chips) 
Seat 2: Duke Croix (19484 in chips) 
Seat 3: color_singleton (6659 in chips) 
Seat 4: MaFak2019 (15513 in chips) 
Seat 5: Klemtonius (55959 in chips) 
Seat 9: HighCardJasper (10563 in chips) 
HighCardJasper: posts small blind 50
dddocky: posts big blind 100
*** HOLE CARDS ***
Dealt to Duke Croix [8s Tc]
Duke Croix: folds 
color_singleton: folds 
MaFak2019: calls 100
Klemtonius: folds 
HighCardJasper: calls 50
dddocky: checks 
*** FLOP *** [Jc Qc 2c]
HighCardJasper: checks 
dddocky: checks 
MaFak2019: checks 
*** TURN *** [Jc Qc 2c] [7d]
HighCardJasper: checks 
dddocky: checks 
MaFak2019: checks 
*** RIVER *** [Jc Qc 2c 7d] [Th]
HighCardJasper: checks 
dddocky: checks 
MaFak2019: bets 500
HighCardJasper: folds 
dddocky: calls 500
*** SHOW DOWN ***
MaFak2019: shows [Ah Kh] (a straight, Ten to Ace)
dddocky: mucks hand 
MaFak2019 collected 1228 from pot
*** SUMMARY ***
Total pot 1300 | Rake 72 
Board [Jc Qc 2c 7d Th]
Seat 1: dddocky (big blind) mucked [Js 7h]
Seat 2: Duke Croix folded before Flop (didn't bet)
Seat 3: color_singleton folded before Flop (didn't bet)
Seat 4: MaFak2019 showed [Ah Kh] and won (1228) with a straight, Ten to Ace
Seat 5: Klemtonius (button) folded before Flop (didn't bet)
Seat 9: HighCardJasper (small blind) folded on the River



PokerStars Home Game Hand #218541184336: {Club #3225207}  Hold'em No Limit (50/100) - 2020/09/17 17:01:02 ET
Table 'fun time' 9-max (Play Money) Seat #9 is the button
Seat 1: dddocky (8969 in chips) 
Seat 2: Duke Croix (19484 in chips) 
Seat 3: color_singleton (6659 in chips) 
Seat 4: MaFak2019 (16141 in chips) 
Seat 5: Klemtonius (55959 in chips) 
Seat 9: HighCardJasper (10463 in chips) 
dddocky: posts small blind 50
Duke Croix: posts big blind 100
*** HOLE CARDS ***
Dealt to Duke Croix [4c Jh]
color_singleton: raises 200 to 300
MaFak2019: calls 300
Klemtonius: raises 221 to 521
HighCardJasper: calls 521
dddocky: folds 
Duke Croix: folds 
color_singleton: calls 221
MaFak2019: calls 221
*** FLOP *** [8s 2h Jd]
color_singleton: checks 
MaFak2019: checks 
Klemtonius: bets 700
HighCardJasper: calls 700
color_singleton: calls 700
MaFak2019: folds 
*** TURN *** [8s 2h Jd] [5d]
color_singleton: checks 
Klemtonius: checks 
HighCardJasper: bets 1000
color_singleton: folds 
Klemtonius: calls 1000
*** RIVER *** [8s 2h Jd 5d] [7s]
Klemtonius: checks 
HighCardJasper: checks 
*** SHOW DOWN ***
Klemtonius: shows [9d 8d] (a pair of Eights)
HighCardJasper: shows [Kh Js] (a pair of Jacks)
HighCardJasper collected 5986 from pot
*** SUMMARY ***
Total pot 6334 | Rake 348 
Board [8s 2h Jd 5d 7s]
Seat 1: dddocky (small blind) folded before Flop
Seat 2: Duke Croix (big blind) folded before Flop
Seat 3: color_singleton folded on the Turn
Seat 4: MaFak2019 folded on the Flop
Seat 5: Klemtonius showed [9d 8d] and lost with a pair of Eights
Seat 9: HighCardJasper (button) showed [Kh Js] and won (5986) with a pair of Jacks



PokerStars Home Game Hand #218541232148: {Club #3225207}  Hold'em No Limit (50/100) - 2020/09/17 17:02:26 ET
Table 'fun time' 9-max (Play Money) Seat #1 is the button
Seat 1: dddocky (8919 in chips) 
Seat 2: Duke Croix (19384 in chips) 
Seat 3: color_singleton (5438 in chips) 
Seat 4: MaFak2019 (15620 in chips) 
Seat 5: Klemtonius (53738 in chips) 
Seat 9: HighCardJasper (14228 in chips) 
Duke Croix: posts small blind 50
color_singleton: posts big blind 100
*** HOLE CARDS ***
Dealt to Duke Croix [8h 9s]
MaFak2019: folds 
Klemtonius: calls 100
HighCardJasper: calls 100
dddocky: calls 100
Duke Croix: calls 50
color_singleton: raises 400 to 500
Klemtonius: folds 
HighCardJasper: folds 
dddocky: calls 400
Duke Croix: folds 
*** FLOP *** [6c 2d 9c]
color_singleton: bets 1228
dddocky: folds 
Uncalled bet (1228) returned to color_singleton
color_singleton collected 1228 from pot
color_singleton: doesn't show hand 
*** SUMMARY ***
Total pot 1300 | Rake 72 
Board [6c 2d 9c]
Seat 1: dddocky (button) folded on the Flop
Seat 2: Duke Croix (small blind) folded before Flop
Seat 3: color_singleton (big blind) collected (1228)
Seat 4: MaFak2019 folded before Flop (didn't bet)
Seat 5: Klemtonius folded before Flop
Seat 9: HighCardJasper folded before Flop



PokerStars Home Game Hand #218541254546: {Club #3225207}  Hold'em No Limit (50/100) - 2020/09/17 17:03:04 ET
Table 'fun time' 9-max (Play Money) Seat #2 is the button
Seat 1: dddocky (8419 in chips) 
Seat 2: Duke Croix (19284 in chips) 
Seat 3: color_singleton (6166 in chips) 
Seat 4: MaFak2019 (15620 in chips) 
Seat 5: Klemtonius (53638 in chips) 
Seat 9: HighCardJasper (14128 in chips) 
color_singleton: posts small blind 50
MaFak2019: posts big blind 100
*** HOLE CARDS ***
Dealt to Duke Croix [3s Tc]
Klemtonius: calls 100
HighCardJasper: calls 100
dddocky: folds 
Duke Croix: folds 
color_singleton: raises 300 to 400
MaFak2019: folds 
Klemtonius: calls 300
HighCardJasper: calls 300
*** FLOP *** [6c 9d Jc]
color_singleton: checks 
Klemtonius: checks 
HighCardJasper: checks 
*** TURN *** [6c 9d Jc] [6h]
color_singleton: checks 
Klemtonius: checks 
HighCardJasper: checks 
*** RIVER *** [6c 9d Jc 6h] [Qc]
color_singleton: bets 700
Klemtonius: folds 
HighCardJasper: folds 
Uncalled bet (700) returned to color_singleton
color_singleton collected 1228 from pot
color_singleton: doesn't show hand 
*** SUMMARY ***
Total pot 1300 | Rake 72 
Board [6c 9d Jc 6h Qc]
Seat 1: dddocky folded before Flop (didn't bet)
Seat 2: Duke Croix (button) folded before Flop (didn't bet)
Seat 3: color_singleton (small blind) collected (1228)
Seat 4: MaFak2019 (big blind) folded before Flop
Seat 5: Klemtonius folded on the River
Seat 9: HighCardJasper folded on the River



PokerStars Home Game Hand #218541286989: {Club #3225207}  Hold'em No Limit (50/100) - 2020/09/17 17:03:56 ET
Table 'fun time' 9-max (Play Money) Seat #3 is the button
Seat 1: dddocky (8419 in chips) 
Seat 2: Duke Croix (19284 in chips) 
Seat 3: color_singleton (6994 in chips) 
Seat 4: MaFak2019 (15520 in chips) 
Seat 5: Klemtonius (53238 in chips) 
Seat 9: HighCardJasper (13728 in chips) 
MaFak2019: posts small blind 50
Klemtonius: posts big blind 100
*** HOLE CARDS ***
Dealt to Duke Croix [7s Kh]
HighCardJasper: calls 100
dddocky has timed out
dddocky: folds 
Duke Croix: raises 200 to 300
color_singleton: calls 300
MaFak2019: folds 
Klemtonius: calls 200
HighCardJasper: calls 200
*** FLOP *** [5s 7h Qs]
Klemtonius: checks 
HighCardJasper: checks 
Duke Croix: checks 
color_singleton: checks 
*** TURN *** [5s 7h Qs] [3c]
Klemtonius: checks 
HighCardJasper: checks 
Duke Croix: bets 650
MnnM150 joins the table at seat #8 
color_singleton: folds 
Klemtonius: folds 
HighCardJasper: folds 
Uncalled bet (650) returned to Duke Croix
Duke Croix collected 1181 from pot
*** SUMMARY ***
Total pot 1250 | Rake 69 
Board [5s 7h Qs 3c]
Seat 1: dddocky folded before Flop (didn't bet)
Seat 2: Duke Croix collected (1181)
Seat 3: color_singleton (button) folded on the Turn
Seat 4: MaFak2019 (small blind) folded before Flop
Seat 5: Klemtonius (big blind) folded on the Turn
Seat 9: HighCardJasper folded on the Turn



PokerStars Home Game Hand #218541337421: {Club #3225207}  Hold'em No Limit (50/100) - 2020/09/17 17:05:18 ET
Table 'fun time' 9-max (Play Money) Seat #4 is the button
Seat 2: Duke Croix (20165 in chips) 
Seat 3: color_singleton (6694 in chips) 
Seat 4: MaFak2019 (15470 in chips) 
Seat 5: Klemtonius (52938 in chips) 
Seat 8: MnnM150 (10000 in chips) 
Seat 9: HighCardJasper (13428 in chips) 
Klemtonius: posts small blind 50
MnnM150: posts big blind 100
*** HOLE CARDS ***
Dealt to Duke Croix [5s 2s]
HighCardJasper: folds 
Duke Croix: folds 
color_singleton: folds 
MaFak2019: calls 100
Klemtonius: calls 50
MnnM150: checks 
*** FLOP *** [Td 9s 5c]
Klemtonius: checks 
MnnM150: checks 
MaFak2019: checks 
*** TURN *** [Td 9s 5c] [Qd]
Klemtonius: checks 
MnnM150: checks 
MaFak2019: checks 
*** RIVER *** [Td 9s 5c Qd] [7c]
Klemtonius: bets 283
MnnM150: folds 
MaFak2019: folds 
Uncalled bet (283) returned to Klemtonius
Klemtonius collected 283 from pot
Klemtonius: doesn't show hand 
*** SUMMARY ***
Total pot 300 | Rake 17 
Board [Td 9s 5c Qd 7c]
Seat 2: Duke Croix folded before Flop (didn't bet)
Seat 3: color_singleton folded before Flop (didn't bet)
Seat 4: MaFak2019 (button) folded on the River
Seat 5: Klemtonius (small blind) collected (283)
Seat 8: MnnM150 (big blind) folded on the River
Seat 9: HighCardJasper folded before Flop (didn't bet)



PokerStars Home Game Hand #218541377556: {Club #3225207}  Hold'em No Limit (50/100) - 2020/09/17 17:06:21 ET
Table 'fun time' 9-max (Play Money) Seat #5 is the button
Seat 2: Duke Croix (20165 in chips) 
Seat 3: color_singleton (6694 in chips) 
Seat 4: MaFak2019 (15370 in chips) 
Seat 5: Klemtonius (53121 in chips) 
Seat 8: MnnM150 (9900 in chips) 
Seat 9: HighCardJasper (13428 in chips) 
MnnM150: posts small blind 50
HighCardJasper: posts big blind 100
*** HOLE CARDS ***
Dealt to Duke Croix [9h Th]
Duke Croix: raises 300 to 400
color_singleton: folds 
MaFak2019: calls 400
Klemtonius: folds 
MnnM150: calls 350
HighCardJasper: calls 300
*** FLOP *** [8h 2d 4d]
MnnM150: checks 
HighCardJasper: checks 
Duke Croix: bets 699
MaFak2019: calls 699
MnnM150: folds 
HighCardJasper: folds 
*** TURN *** [8h 2d 4d] [As]
Duke Croix: checks 
MaFak2019: bets 1200
Duke Croix: folds 
Uncalled bet (1200) returned to MaFak2019
MaFak2019 collected 2833 from pot
MaFak2019: doesn't show hand 
*** SUMMARY ***
Total pot 2998 | Rake 165 
Board [8h 2d 4d As]
Seat 2: Duke Croix folded on the Turn
Seat 3: color_singleton folded before Flop (didn't bet)
Seat 4: MaFak2019 collected (2833)
Seat 5: Klemtonius (button) folded before Flop (didn't bet)
Seat 8: MnnM150 (small blind) folded on the Flop
Seat 9: HighCardJasper (big blind) folded on the Flop



PokerStars Home Game Hand #218541406638: {Club #3225207}  Hold'em No Limit (50/100) - 2020/09/17 17:07:08 ET
Table 'fun time' 9-max (Play Money) Seat #8 is the button
Seat 2: Duke Croix (19066 in chips) 
Seat 3: color_singleton (6694 in chips) 
Seat 4: MaFak2019 (17104 in chips) 
Seat 5: Klemtonius (53121 in chips) 
Seat 8: MnnM150 (9500 in chips) 
Seat 9: HighCardJasper (13028 in chips) 
HighCardJasper: posts small blind 50
Duke Croix: posts big blind 100
*** HOLE CARDS ***
Dealt to Duke Croix [Qh Ac]
color_singleton: raises 100 to 200
MaFak2019: calls 200
Klemtonius: calls 200
MnnM150: calls 200
HighCardJasper: calls 150
Duke Croix: calls 100
*** FLOP *** [4s 2c Js]
HighCardJasper: bets 400
Duke Croix: folds 
color_singleton: folds 
MaFak2019: folds 
Klemtonius: raises 400 to 800
MnnM150 is disconnected 
MnnM150 is connected 
MnnM150 has timed out
MnnM150: folds 
HighCardJasper: calls 400
*** TURN *** [4s 2c Js] [2s]
HighCardJasper: checks 
Klemtonius: bets 3700
HighCardJasper: folds 
Uncalled bet (3700) returned to Klemtonius
Klemtonius collected 2646 from pot
Klemtonius: doesn't show hand 
*** SUMMARY ***
Total pot 2800 | Rake 154 
Board [4s 2c Js 2s]
Seat 2: Duke Croix (big blind) folded on the Flop
Seat 3: color_singleton folded on the Flop
Seat 4: MaFak2019 folded on the Flop
Seat 5: Klemtonius collected (2646)
Seat 8: MnnM150 (button) folded on the Flop
Seat 9: HighCardJasper (small blind) folded on the Turn



PokerStars Home Game Hand #218541457623: {Club #3225207}  Hold'em No Limit (50/100) - 2020/09/17 17:08:33 ET
Table 'fun time' 9-max (Play Money) Seat #9 is the button
Seat 2: Duke Croix (18866 in chips) 
Seat 3: color_singleton (6494 in chips) 
Seat 4: MaFak2019 (16904 in chips) 
Seat 5: Klemtonius (54767 in chips) 
Seat 8: MnnM150 (9300 in chips) 
Seat 9: HighCardJasper (12028 in chips) 
Duke Croix: posts small blind 50
color_singleton: posts big blind 100
*** HOLE CARDS ***
Dealt to Duke Croix [7h 5d]
Duke Croix said, "manon, check your mail for zoom link"
MaFak2019: calls 100
Klemtonius: calls 100
MnnM150: folds 
HighCardJasper: calls 100
Duke Croix: calls 50
color_singleton: checks 
*** FLOP *** [Td 8c 8h]
Duke Croix: checks 
color_singleton: checks 
MaFak2019: checks 
Klemtonius: bets 472
HighCardJasper: calls 472
Duke Croix: folds 
color_singleton: folds 
MaFak2019: folds 
*** TURN *** [Td 8c 8h] [As]
Klemtonius: checks 
HighCardJasper: bets 400
Klemtonius: calls 400
*** RIVER *** [Td 8c 8h As] [3h]
Klemtonius: checks 
HighCardJasper: checks 
*** SHOW DOWN ***
Klemtonius: shows [9h Js] (a pair of Eights)
HighCardJasper: shows [Th 2c] (two pair, Tens and Eights)
HighCardJasper collected 2121 from pot
*** SUMMARY ***
Total pot 2244 | Rake 123 
Board [Td 8c 8h As 3h]
Seat 2: Duke Croix (small blind) folded on the Flop
Seat 3: color_singleton (big blind) folded on the Flop
Seat 4: MaFak2019 folded on the Flop
Seat 5: Klemtonius showed [9h Js] and lost with a pair of Eights
Seat 8: MnnM150 folded before Flop (didn't bet)
Seat 9: HighCardJasper (button) showed [Th 2c] and won (2121) with two pair, Tens and Eights



PokerStars Home Game Hand #218541509974: {Club #3225207}  Hold'em No Limit (50/100) - 2020/09/17 17:10:00 ET
Table 'fun time' 9-max (Play Money) Seat #2 is the button
Seat 1: dddocky (8419 in chips) 
Seat 2: Duke Croix (18766 in chips) 
Seat 3: color_singleton (6394 in chips) 
Seat 4: MaFak2019 (16804 in chips) 
Seat 5: Klemtonius (53795 in chips) 
Seat 8: MnnM150 (9300 in chips) 
Seat 9: HighCardJasper (13177 in chips) 
color_singleton: posts small blind 50
MaFak2019: posts big blind 100
dddocky: posts small & big blinds 150
*** HOLE CARDS ***
Dealt to Duke Croix [As 8h]
Klemtonius: raises 100 to 200
MnnM150: calls 200
HighCardJasper: calls 200
dddocky: calls 100
Duke Croix: calls 200
color_singleton: calls 150
MaFak2019: folds 
*** FLOP *** [Tc Ts 6c]
color_singleton: checks 
Klemtonius: bets 1276
MnnM150: folds 
HighCardJasper: folds 
dddocky: raises 1276 to 2552
Duke Croix: folds 
color_singleton: folds 
Klemtonius: folds 
Uncalled bet (1276) returned to dddocky
dddocky collected 3687 from pot
dddocky: doesn't show hand 
*** SUMMARY ***
Total pot 3902 | Rake 215 
Board [Tc Ts 6c]
Seat 1: dddocky collected (3687)
Seat 2: Duke Croix (button) folded on the Flop
Seat 3: color_singleton (small blind) folded on the Flop
Seat 4: MaFak2019 (big blind) folded before Flop
Seat 5: Klemtonius folded on the Flop
Seat 8: MnnM150 folded on the Flop
Seat 9: HighCardJasper folded on the Flop



PokerStars Home Game Hand #218541548144: {Club #3225207}  Hold'em No Limit (50/100) - 2020/09/17 17:11:03 ET
Table 'fun time' 9-max (Play Money) Seat #3 is the button
Seat 1: dddocky (10580 in chips) 
Seat 2: Duke Croix (18566 in chips) 
Seat 3: color_singleton (6194 in chips) 
Seat 4: MaFak2019 (16704 in chips) 
Seat 5: Klemtonius (52319 in chips) 
Seat 8: MnnM150 (9100 in chips) 
Seat 9: HighCardJasper (12977 in chips) 
MaFak2019: posts small blind 50
Klemtonius: posts big blind 100
*** HOLE CARDS ***
Dealt to Duke Croix [2h Qd]
MnnM150: calls 100
HighCardJasper: calls 100
dddocky: calls 100
Duke Croix: folds 
color_singleton: raises 100 to 200
MaFak2019: calls 150
Klemtonius: calls 100
MnnM150: calls 100
HighCardJasper: calls 100
dddocky: calls 100
*** FLOP *** [5h 8d Qc]
MaFak2019: checks 
Klemtonius: checks 
MnnM150: checks 
HighCardJasper: checks 
dddocky: checks 
color_singleton: checks 
*** TURN *** [5h 8d Qc] [6c]
MaFak2019: bets 700
Klemtonius: folds 
MnnM150: calls 700
HighCardJasper: folds 
dddocky: folds 
color_singleton: folds 
*** RIVER *** [5h 8d Qc 6c] [6d]
MaFak2019: bets 1600
MnnM150 is disconnected 
MnnM150 has timed out while disconnected
MnnM150: folds 
Uncalled bet (1600) returned to MaFak2019
MaFak2019 collected 2457 from pot
MaFak2019: doesn't show hand 
*** SUMMARY ***
Total pot 2600 | Rake 143 
Board [5h 8d Qc 6c 6d]
Seat 1: dddocky folded on the Turn
Seat 2: Duke Croix folded before Flop (didn't bet)
Seat 3: color_singleton (button) folded on the Turn
Seat 4: MaFak2019 (small blind) collected (2457)
Seat 5: Klemtonius (big blind) folded on the Turn
Seat 8: MnnM150 folded on the River
Seat 9: HighCardJasper folded on the Turn



PokerStars Home Game Hand #218541608362: {Club #3225207}  Hold'em No Limit (50/100) - 2020/09/17 17:12:44 ET
Table 'fun time' 9-max (Play Money) Seat #4 is the button
Seat 1: dddocky (10380 in chips) 
Seat 2: Duke Croix (18566 in chips) 
Seat 3: color_singleton (5994 in chips) 
Seat 4: MaFak2019 (18261 in chips) 
Seat 5: Klemtonius (52119 in chips) 
Seat 9: HighCardJasper (12777 in chips) 
Klemtonius: posts small blind 50
HighCardJasper: posts big blind 100
*** HOLE CARDS ***
Dealt to Duke Croix [2s 3s]
dddocky: folds 
Duke Croix: calls 100
color_singleton: raises 200 to 300
MaFak2019: calls 300
Klemtonius: folds 
HighCardJasper: folds 
Duke Croix: calls 200
*** FLOP *** [Qc 5d 7d]
Duke Croix: checks 
color_singleton: checks 
MaFak2019: checks 
*** TURN *** [Qc 5d 7d] [Ad]
Duke Croix: checks 
color_singleton: checks 
MaFak2019: checks 
*** RIVER *** [Qc 5d 7d Ad] [8d]
Duke Croix: checks 
color_singleton: checks 
MaFak2019: bets 600
Duke Croix: folds 
color_singleton: folds 
Uncalled bet (600) returned to MaFak2019
MaFak2019 collected 992 from pot
MaFak2019: doesn't show hand 
*** SUMMARY ***
Total pot 1050 | Rake 58 
Board [Qc 5d 7d Ad 8d]
Seat 1: dddocky folded before Flop (didn't bet)
Seat 2: Duke Croix folded on the River
Seat 3: color_singleton folded on the River
Seat 4: MaFak2019 (button) collected (992)
Seat 5: Klemtonius (small blind) folded before Flop
Seat 9: HighCardJasper (big blind) folded before Flop



PokerStars Home Game Hand #218541661412: {Club #3225207}  Hold'em No Limit (50/100) - 2020/09/17 17:14:13 ET
Table 'fun time' 9-max (Play Money) Seat #5 is the button
Seat 1: dddocky (10380 in chips) 
Seat 2: Duke Croix (18266 in chips) 
Seat 3: color_singleton (5694 in chips) 
Seat 4: MaFak2019 (18953 in chips) 
Seat 5: Klemtonius (52069 in chips) 
Seat 9: HighCardJasper (12677 in chips) 
HighCardJasper: posts small blind 50
dddocky: posts big blind 100
*** HOLE CARDS ***
Dealt to Duke Croix [Qc 4h]
Duke Croix: folds 
color_singleton: calls 100
MaFak2019: calls 100
Klemtonius: calls 100
HighCardJasper: calls 50
dddocky: checks 
*** FLOP *** [8d Td Ts]
HighCardJasper: checks 
dddocky: checks 
color_singleton: checks 
MaFak2019: checks 
Klemtonius: checks 
*** TURN *** [8d Td Ts] [Ad]
HighCardJasper: checks 
dddocky: checks 
color_singleton: checks 
MaFak2019: checks 
Klemtonius: checks 
*** RIVER *** [8d Td Ts Ad] [Kh]
HighCardJasper: checks 
dddocky: checks 
color_singleton: checks 
MaFak2019: bets 800
Klemtonius: folds 
HighCardJasper: folds 
dddocky: folds 
color_singleton: folds 
Uncalled bet (800) returned to MaFak2019
MaFak2019 collected 472 from pot
MaFak2019: doesn't show hand 
*** SUMMARY ***
Total pot 500 | Rake 28 
Board [8d Td Ts Ad Kh]
Seat 1: dddocky (big blind) folded on the River
Seat 2: Duke Croix folded before Flop (didn't bet)
Seat 3: color_singleton folded on the River
Seat 4: MaFak2019 collected (472)
Seat 5: Klemtonius (button) folded on the River
Seat 9: HighCardJasper (small blind) folded on the River



PokerStars Home Game Hand #218541717360: {Club #3225207}  Hold'em No Limit (50/100) - 2020/09/17 17:15:36 ET
Table 'fun time' 9-max (Play Money) Seat #9 is the button
Seat 1: dddocky (10280 in chips) 
Seat 2: Duke Croix (18266 in chips) 
Seat 3: color_singleton (5594 in chips) 
Seat 4: MaFak2019 (19325 in chips) 
Seat 5: Klemtonius (51969 in chips) 
Seat 8: MnnM150 (8200 in chips) 
Seat 9: HighCardJasper (12577 in chips) 
dddocky: posts small blind 50
Duke Croix: posts big blind 100
MnnM150: posts small & big blinds 150
*** HOLE CARDS ***
Dealt to Duke Croix [5h 4d]
color_singleton: raises 200 to 300
MaFak2019: calls 300
Klemtonius: folds 
MnnM150: calls 200
HighCardJasper: folds 
dddocky: calls 250
Duke Croix: calls 200
*** FLOP *** [8c 3c Js]
dddocky: checks 
Duke Croix: checks 
color_singleton: bets 732
MaFak2019: calls 732
MnnM150: calls 732
dddocky: folds 
Duke Croix: folds 
*** TURN *** [8c 3c Js] [9c]
color_singleton: checks 
MaFak2019: bets 18293 and is all-in
MnnM150: folds 
color_singleton: folds 
Uncalled bet (18293) returned to MaFak2019
MaFak2019 collected 3540 from pot
MaFak2019: doesn't show hand 
*** SUMMARY ***
Total pot 3746 | Rake 206 
Board [8c 3c Js 9c]
Seat 1: dddocky (small blind) folded on the Flop
Seat 2: Duke Croix (big blind) folded on the Flop
Seat 3: color_singleton folded on the Turn
Seat 4: MaFak2019 collected (3540)
Seat 5: Klemtonius folded before Flop (didn't bet)
Seat 8: MnnM150 folded on the Turn
Seat 9: HighCardJasper (button) folded before Flop (didn't bet)



PokerStars Home Game Hand #218541758921: {Club #3225207}  Hold'em No Limit (50/100) - 2020/09/17 17:16:46 ET
Table 'fun time' 9-max (Play Money) Seat #1 is the button
Seat 1: dddocky (9980 in chips) 
Seat 2: Duke Croix (17966 in chips) 
Seat 3: color_singleton (4562 in chips) 
Seat 4: MaFak2019 (21833 in chips) 
Seat 5: Klemtonius (51969 in chips) 
Seat 8: MnnM150 (7118 in chips) 
Seat 9: HighCardJasper (12577 in chips) 
Duke Croix: posts small blind 50
color_singleton: posts big blind 100
*** HOLE CARDS ***
Dealt to Duke Croix [6h 3c]
MaFak2019: calls 100
Klemtonius: calls 100
MnnM150: calls 100
HighCardJasper: calls 100
dddocky: calls 100
Duke Croix: calls 50
color_singleton: checks 
*** FLOP *** [Kc 4s Ah]
Duke Croix: checks 
color_singleton: checks 
MaFak2019: checks 
Klemtonius: checks 
MnnM150: bets 100
HighCardJasper: folds 
dddocky: folds 
Duke Croix: folds 
color_singleton: folds 
MaFak2019: folds 
Klemtonius: calls 100
*** TURN *** [Kc 4s Ah] [7h]
Klemtonius: checks 
MnnM150: bets 425
Klemtonius: folds 
Uncalled bet (425) returned to MnnM150
MnnM150 collected 850 from pot
*** SUMMARY ***
Total pot 900 | Rake 50 
Board [Kc 4s Ah 7h]
Seat 1: dddocky (button) folded on the Flop
Seat 2: Duke Croix (small blind) folded on the Flop
Seat 3: color_singleton (big blind) folded on the Flop
Seat 4: MaFak2019 folded on the Flop
Seat 5: Klemtonius folded on the Turn
Seat 8: MnnM150 collected (850)
Seat 9: HighCardJasper folded on the Flop



PokerStars Home Game Hand #218541811739: {Club #3225207}  Hold'em No Limit (50/100) - 2020/09/17 17:18:15 ET
Table 'fun time' 9-max (Play Money) Seat #2 is the button
Seat 1: dddocky (9880 in chips) 
Seat 2: Duke Croix (17866 in chips) 
Seat 3: color_singleton (4462 in chips) 
Seat 5: Klemtonius (51769 in chips) 
Seat 8: MnnM150 (7768 in chips) 
Seat 9: HighCardJasper (12477 in chips) 
color_singleton: posts small blind 50
MaFak2019: is sitting out 
Klemtonius: posts big blind 100
*** HOLE CARDS ***
Dealt to Duke Croix [Jd 2d]
MnnM150: calls 100
HighCardJasper: calls 100
dddocky: calls 100
Duke Croix: folds 
color_singleton: raises 200 to 300
Klemtonius: raises 200 to 500
MnnM150: calls 400
HighCardJasper: folds 
dddocky: folds 
color_singleton: calls 200
*** FLOP *** [9s 8s 2h]
color_singleton: checks 
Klemtonius: checks 
MnnM150: checks 
*** TURN *** [9s 8s 2h] [Qc]
color_singleton: checks 
Klemtonius: checks 
MnnM150: checks 
*** RIVER *** [9s 8s 2h Qc] [8d]
color_singleton: checks 
Klemtonius: bets 803
MnnM150: folds 
color_singleton: folds 
Uncalled bet (803) returned to Klemtonius
Klemtonius collected 1606 from pot
Klemtonius: doesn't show hand 
*** SUMMARY ***
Total pot 1700 | Rake 94 
Board [9s 8s 2h Qc 8d]
Seat 1: dddocky folded before Flop
Seat 2: Duke Croix (button) folded before Flop (didn't bet)
Seat 3: color_singleton (small blind) folded on the River
Seat 5: Klemtonius (big blind) collected (1606)
Seat 8: MnnM150 folded on the River
Seat 9: HighCardJasper folded before Flop



PokerStars Home Game Hand #218541853861: {Club #3225207}  Hold'em No Limit (50/100) - 2020/09/17 17:19:26 ET
Table 'fun time' 9-max (Play Money) Seat #3 is the button
Seat 1: dddocky (9780 in chips) 
Seat 2: Duke Croix (17866 in chips) 
Seat 3: color_singleton (3962 in chips) 
Seat 5: Klemtonius (52875 in chips) 
Seat 8: MnnM150 (7268 in chips) 
Seat 9: HighCardJasper (12377 in chips) 
Klemtonius: posts small blind 50
MnnM150: posts big blind 100
*** HOLE CARDS ***
Dealt to Duke Croix [Th Jc]
HighCardJasper: calls 100
dddocky: calls 100
Duke Croix: raises 400 to 500
color_singleton: folds 
Klemtonius: calls 450
MnnM150: calls 400
HighCardJasper: calls 400
dddocky: folds 
*** FLOP *** [Ah 9d 8h]
Klemtonius: checks 
MnnM150: bets 992
HighCardJasper: folds 
Duke Croix: calls 992
Klemtonius: folds 
*** TURN *** [Ah 9d 8h] [4d]
MnnM150: bets 1929
Duke Croix: calls 1929
*** RIVER *** [Ah 9d 8h 4d] [5h]
MnnM150: checks 
Duke Croix: checks 
*** SHOW DOWN ***
MnnM150: shows [4s Ac] (two pair, Aces and Fours)
Duke Croix: mucks hand 
MnnM150 collected 7505 from pot
*** SUMMARY ***
Total pot 7942 | Rake 437 
Board [Ah 9d 8h 4d 5h]
Seat 1: dddocky folded before Flop
Seat 2: Duke Croix mucked [Th Jc]
Seat 3: color_singleton (button) folded before Flop (didn't bet)
Seat 5: Klemtonius (small blind) folded on the Flop
Seat 8: MnnM150 (big blind) showed [4s Ac] and won (7505) with two pair, Aces and Fours
Seat 9: HighCardJasper folded on the Flop



PokerStars Home Game Hand #218541901761: {Club #3225207}  Hold'em No Limit (50/100) - 2020/09/17 17:20:47 ET
Table 'fun time' 9-max (Play Money) Seat #5 is the button
Seat 1: dddocky (9680 in chips) 
Seat 2: Duke Croix (14445 in chips) 
Seat 3: color_singleton (3962 in chips) 
Seat 5: Klemtonius (52375 in chips) 
Seat 8: MnnM150 (11352 in chips) 
Seat 9: HighCardJasper (11877 in chips) 
MnnM150: posts small blind 50
HighCardJasper: posts big blind 100
*** HOLE CARDS ***
Dealt to Duke Croix [Ts 8h]
dddocky: folds 
Duke Croix: folds 
color_singleton: folds 
Klemtonius: calls 100
MnnM150: calls 50
HighCardJasper: checks 
*** FLOP *** [5s 7c 3d]
MnnM150: checks 
HighCardJasper: checks 
Klemtonius: bets 283
MnnM150: calls 283
HighCardJasper: calls 283
*** TURN *** [5s 7c 3d] [Jd]
MnnM150: checks 
HighCardJasper: checks 
Klemtonius: bets 543
MnnM150: calls 543
HighCardJasper: folds 
*** RIVER *** [5s 7c 3d Jd] [Qd]
MnnM150: bets 2112
Klemtonius: folds 
Uncalled bet (2112) returned to MnnM150
MnnM150 collected 2112 from pot
*** SUMMARY ***
Total pot 2235 | Rake 123 
Board [5s 7c 3d Jd Qd]
Seat 1: dddocky folded before Flop (didn't bet)
Seat 2: Duke Croix folded before Flop (didn't bet)
Seat 3: color_singleton folded before Flop (didn't bet)
Seat 5: Klemtonius (button) folded on the River
Seat 8: MnnM150 (small blind) collected (2112)
Seat 9: HighCardJasper (big blind) folded on the Turn



PokerStars Home Game Hand #218541939388: {Club #3225207}  Hold'em No Limit (50/100) - 2020/09/17 17:21:52 ET
Table 'fun time' 9-max (Play Money) Seat #8 is the button
Seat 1: dddocky (9680 in chips) 
Seat 2: Duke Croix (14445 in chips) 
Seat 3: color_singleton (3962 in chips) 
Seat 5: Klemtonius (51449 in chips) 
Seat 8: MnnM150 (12538 in chips) 
Seat 9: HighCardJasper (11494 in chips) 
HighCardJasper: posts small blind 50
dddocky: posts big blind 100
*** HOLE CARDS ***
Dealt to Duke Croix [4h 2h]
Duke Croix: folds 
color_singleton: folds 
Klemtonius: folds 
MnnM150: folds 
HighCardJasper: calls 50
dddocky: checks 
*** FLOP *** [7h 8s 8c]
HighCardJasper: bets 100
dddocky: raises 389 to 489
HighCardJasper: raises 389 to 878
dddocky: calls 389
*** TURN *** [7h 8s 8c] [6c]
HighCardJasper: bets 1000
dddocky: raises 1000 to 2000
HighCardJasper: calls 1000
*** RIVER *** [7h 8s 8c 6c] [3s]
HighCardJasper: checks 
dddocky: checks 
*** SHOW DOWN ***
HighCardJasper: shows [Ks 8d] (three of a kind, Eights)
dddocky: mucks hand 
HighCardJasper collected 5628 from pot
*** SUMMARY ***
Total pot 5956 | Rake 328 
Board [7h 8s 8c 6c 3s]
Seat 1: dddocky (big blind) mucked [Jh 7s]
Seat 2: Duke Croix folded before Flop (didn't bet)
Seat 3: color_singleton folded before Flop (didn't bet)
Seat 5: Klemtonius folded before Flop (didn't bet)
Seat 8: MnnM150 (button) folded before Flop (didn't bet)
Seat 9: HighCardJasper (small blind) showed [Ks 8d] and won (5628) with three of a kind, Eights



PokerStars Home Game Hand #218541979734: {Club #3225207}  Hold'em No Limit (50/100) - 2020/09/17 17:23:02 ET
Table 'fun time' 9-max (Play Money) Seat #9 is the button
Seat 1: dddocky (6702 in chips) 
Seat 2: Duke Croix (14445 in chips) 
Seat 3: color_singleton (3962 in chips) 
Seat 5: Klemtonius (51449 in chips) 
Seat 8: MnnM150 (12538 in chips) 
Seat 9: HighCardJasper (14144 in chips) 
dddocky: posts small blind 50
Duke Croix: posts big blind 100
*** HOLE CARDS ***
Dealt to Duke Croix [Kh 8s]
color_singleton: folds 
Klemtonius: calls 100
MnnM150: calls 100
HighCardJasper: calls 100
dddocky: folds 
Duke Croix has timed out
Duke Croix: checks 
*** FLOP *** [Ad Jc Qh]
Duke Croix has timed out
Duke Croix: checks 
Klemtonius: checks 
MnnM150: checks 
HighCardJasper: checks 
*** TURN *** [Ad Jc Qh] [4d]
Duke Croix has timed out
Duke Croix: checks 
Klemtonius: checks 
MnnM150: bets 212
HighCardJasper: folds 
Duke Croix: folds 
Klemtonius: folds 
Uncalled bet (212) returned to MnnM150
MnnM150 collected 425 from pot
*** SUMMARY ***
Total pot 450 | Rake 25 
Board [Ad Jc Qh 4d]
Seat 1: dddocky (small blind) folded before Flop
Seat 2: Duke Croix (big blind) folded on the Turn
Seat 3: color_singleton folded before Flop (didn't bet)
Seat 5: Klemtonius folded on the Turn
Seat 8: MnnM150 collected (425)
Seat 9: HighCardJasper (button) folded on the Turn



PokerStars Home Game Hand #218542036085: {Club #3225207}  Hold'em No Limit (50/100) - 2020/09/17 17:24:39 ET
Table 'fun time' 9-max (Play Money) Seat #1 is the button
Seat 1: dddocky (6652 in chips) 
Seat 2: Duke Croix (14345 in chips) 
Seat 3: color_singleton (3962 in chips) 
Seat 5: Klemtonius (51349 in chips) 
Seat 8: MnnM150 (12863 in chips) 
Seat 9: HighCardJasper (14044 in chips) 
Duke Croix: posts small blind 50
color_singleton: posts big blind 100
*** HOLE CARDS ***
Dealt to Duke Croix [2d 9h]
Klemtonius: raises 300 to 400
MnnM150: folds 
MaFak2019 leaves the table
HighCardJasper: calls 400
dddocky: calls 400
Duke Croix: folds 
color_singleton: calls 300
*** FLOP *** [9d 6s 6h]
color_singleton: checks 
Klemtonius: checks 
HighCardJasper: checks 
dddocky: checks 
*** TURN *** [9d 6s 6h] [4s]
color_singleton: bets 779
Klemtonius: folds 
HighCardJasper: folds 
dddocky: folds 
Uncalled bet (779) returned to color_singleton
color_singleton collected 1559 from pot
color_singleton: doesn't show hand 
*** SUMMARY ***
Total pot 1650 | Rake 91 
Board [9d 6s 6h 4s]
Seat 1: dddocky (button) folded on the Turn
Seat 2: Duke Croix (small blind) folded before Flop
Seat 3: color_singleton (big blind) collected (1559)
Seat 5: Klemtonius folded on the Turn
Seat 8: MnnM150 folded before Flop (didn't bet)
Seat 9: HighCardJasper folded on the Turn



PokerStars Home Game Hand #218542066987: {Club #3225207}  Hold'em No Limit (50/100) - 2020/09/17 17:25:32 ET
Table 'fun time' 9-max (Play Money) Seat #2 is the button
Seat 1: dddocky (6252 in chips) 
Seat 2: Duke Croix (14295 in chips) 
Seat 3: color_singleton (5121 in chips) 
Seat 5: Klemtonius (50949 in chips) 
Seat 8: MnnM150 (12863 in chips) 
Seat 9: HighCardJasper (13644 in chips) 
color_singleton: posts small blind 50
Klemtonius: posts big blind 100
*** HOLE CARDS ***
Dealt to Duke Croix [Qh 7c]
MnnM150: calls 100
HighCardJasper: calls 100
dddocky: folds 
Duke Croix: folds 
color_singleton: folds 
Klemtonius: checks 
*** FLOP *** [8h Ad 2s]
Klemtonius: bets 331
MnnM150: folds 
HighCardJasper: calls 331
*** TURN *** [8h Ad 2s] [Ac]
Klemtonius: bets 100
HighCardJasper: calls 100
*** RIVER *** [8h Ad 2s Ac] [3s]
Klemtonius: checks 
HighCardJasper: checks 
*** SHOW DOWN ***
Klemtonius: shows [5d 3c] (two pair, Aces and Threes)
HighCardJasper: mucks hand 
Klemtonius collected 1145 from pot
*** SUMMARY ***
Total pot 1212 | Rake 67 
Board [8h Ad 2s Ac 3s]
Seat 1: dddocky folded before Flop (didn't bet)
Seat 2: Duke Croix (button) folded before Flop (didn't bet)
Seat 3: color_singleton (small blind) folded before Flop
Seat 5: Klemtonius (big blind) showed [5d 3c] and won (1145) with two pair, Aces and Threes
Seat 8: MnnM150 folded on the Flop
Seat 9: HighCardJasper mucked [2c Kc]



PokerStars Home Game Hand #218542099849: {Club #3225207}  Hold'em No Limit (50/100) - 2020/09/17 17:26:29 ET
Table 'fun time' 9-max (Play Money) Seat #3 is the button
Seat 1: dddocky (6252 in chips) 
Seat 2: Duke Croix (14295 in chips) 
Seat 3: color_singleton (5071 in chips) 
Seat 5: Klemtonius (51563 in chips) 
Seat 8: MnnM150 (12763 in chips) 
Seat 9: HighCardJasper (13113 in chips) 
Klemtonius: posts small blind 50
MnnM150: posts big blind 100
*** HOLE CARDS ***
Dealt to Duke Croix [6d 5h]
HighCardJasper: calls 100
dddocky: calls 100
Duke Croix: folds 
color_singleton: raises 100 to 200
Klemtonius: folds 
MnnM150: calls 100
HighCardJasper: calls 100
dddocky: calls 100
*** FLOP *** [8c 2d 7h]
MnnM150: checks 
HighCardJasper: checks 
dddocky: bets 401
color_singleton: calls 401
MnnM150: folds 
HighCardJasper: folds 
*** TURN *** [8c 2d 7h] [6s]
dddocky: bets 780
color_singleton: calls 780
*** RIVER *** [8c 2d 7h 6s] [Qs]
dddocky: checks 
color_singleton: checks 
*** SHOW DOWN ***
dddocky: shows [Tc Td] (a pair of Tens)
color_singleton: mucks hand 
dddocky collected 3035 from pot
*** SUMMARY ***
Total pot 3212 | Rake 177 
Board [8c 2d 7h 6s Qs]
Seat 1: dddocky showed [Tc Td] and won (3035) with a pair of Tens
Seat 2: Duke Croix folded before Flop (didn't bet)
Seat 3: color_singleton (button) mucked [Ks 7d]
Seat 5: Klemtonius (small blind) folded before Flop
Seat 8: MnnM150 (big blind) folded on the Flop
Seat 9: HighCardJasper folded on the Flop



PokerStars Home Game Hand #218542136148: {Club #3225207}  Hold'em No Limit (50/100) - 2020/09/17 17:27:32 ET
Table 'fun time' 9-max (Play Money) Seat #5 is the button
Seat 1: dddocky (7906 in chips) 
Seat 2: Duke Croix (14295 in chips) 
Seat 3: color_singleton (3690 in chips) 
Seat 5: Klemtonius (51513 in chips) 
Seat 8: MnnM150 (12563 in chips) 
Seat 9: HighCardJasper (12913 in chips) 
MnnM150: posts small blind 50
HighCardJasper: posts big blind 100
*** HOLE CARDS ***
Dealt to Duke Croix [9c Ks]
dddocky: calls 100
Duke Croix has timed out
Duke Croix: folds 
color_singleton: folds 
Klemtonius: calls 100
MnnM150: folds 
HighCardJasper: checks 
*** FLOP *** [3h Jh 5s]
HighCardJasper: checks 
dddocky: checks 
Klemtonius: bets 331
HighCardJasper: folds 
dddocky: calls 331
*** TURN *** [3h Jh 5s] [4d]
dddocky: checks 
Klemtonius: bets 956
dddocky: folds 
Uncalled bet (956) returned to Klemtonius
Klemtonius collected 956 from pot
Klemtonius: doesn't show hand 
*** SUMMARY ***
Total pot 1012 | Rake 56 
Board [3h Jh 5s 4d]
Seat 1: dddocky folded on the Turn
Seat 2: Duke Croix folded before Flop (didn't bet)
Seat 3: color_singleton folded before Flop (didn't bet)
Seat 5: Klemtonius (button) collected (956)
Seat 8: MnnM150 (small blind) folded before Flop
Seat 9: HighCardJasper (big blind) folded on the Flop



PokerStars Home Game Hand #218542170345: {Club #3225207}  Hold'em No Limit (50/100) - 2020/09/17 17:28:32 ET
Table 'fun time' 9-max (Play Money) Seat #8 is the button
Seat 1: dddocky (7475 in chips) 
Seat 2: Duke Croix (14295 in chips) 
Seat 3: color_singleton (3690 in chips) 
Seat 5: Klemtonius (52038 in chips) 
Seat 8: MnnM150 (12513 in chips) 
Seat 9: HighCardJasper (12813 in chips) 
HighCardJasper: posts small blind 50
dddocky: posts big blind 100
*** HOLE CARDS ***
Dealt to Duke Croix [Qs 2s]
Duke Croix: folds 
color_singleton: raises 100 to 200
Klemtonius: raises 100 to 300
MnnM150: calls 300
HighCardJasper: folds 
dddocky: calls 200
color_singleton: calls 100
*** FLOP *** [3c Tc 6c]
dddocky: checks 
color_singleton: checks 
Klemtonius: checks 
MnnM150: checks 
*** TURN *** [3c Tc 6c] [9c]
dddocky: bets 100
color_singleton: folds 
Klemtonius: calls 100
MnnM150: calls 100
*** RIVER *** [3c Tc 6c 9c] [5d]
dddocky: bets 100
Klemtonius: folds 
MnnM150: calls 100
*** SHOW DOWN ***
dddocky: shows [Jh 8c] (a flush, Ten high)
MnnM150: mucks hand 
dddocky collected 1654 from pot
*** SUMMARY ***
Total pot 1750 | Rake 96 
Board [3c Tc 6c 9c 5d]
Seat 1: dddocky (big blind) showed [Jh 8c] and won (1654) with a flush, Ten high
Seat 2: Duke Croix folded before Flop (didn't bet)
Seat 3: color_singleton folded on the Turn
Seat 5: Klemtonius folded on the River
Seat 8: MnnM150 (button) mucked [Ts As]
Seat 9: HighCardJasper (small blind) folded before Flop



PokerStars Home Game Hand #218542213747: {Club #3225207}  Hold'em No Limit (50/100) - 2020/09/17 17:29:48 ET
Table 'fun time' 9-max (Play Money) Seat #9 is the button
Seat 1: dddocky (8629 in chips) 
Seat 2: Duke Croix (14295 in chips) 
Seat 3: color_singleton (3390 in chips) 
Seat 5: Klemtonius (51638 in chips) 
Seat 8: MnnM150 (12013 in chips) 
Seat 9: HighCardJasper (12763 in chips) 
dddocky: posts small blind 50
Duke Croix: posts big blind 100
*** HOLE CARDS ***
Dealt to Duke Croix [6s Th]
color_singleton: folds 
Klemtonius: calls 100
MnnM150: calls 100
HighCardJasper: calls 100
dddocky: folds 
Duke Croix: checks 
*** FLOP *** [Ad 7h Kd]
Duke Croix: checks 
Klemtonius: checks 
MnnM150: checks 
HighCardJasper: checks 
*** TURN *** [Ad 7h Kd] [5h]
Duke Croix: checks 
Klemtonius: checks 
MnnM150: checks 
HighCardJasper: checks 
*** RIVER *** [Ad 7h Kd 5h] [8c]
Duke Croix: checks 
Klemtonius has timed out
Klemtonius: checks 
MnnM150: checks 
HighCardJasper: checks 
*** SHOW DOWN ***
Duke Croix: shows [6s Th] (high card Ace)
Klemtonius: shows [7c 3c] (a pair of Sevens)
MnnM150: mucks hand 
HighCardJasper: shows [2c 7d] (a pair of Sevens)
Klemtonius collected 213 from pot
HighCardJasper collected 212 from pot
*** SUMMARY ***
Total pot 450 | Rake 25 
Board [Ad 7h Kd 5h 8c]
Seat 1: dddocky (small blind) folded before Flop
Seat 2: Duke Croix (big blind) showed [6s Th] and lost with high card Ace
Seat 3: color_singleton folded before Flop (didn't bet)
Seat 5: Klemtonius showed [7c 3c] and won (213) with a pair of Sevens
Seat 8: MnnM150 mucked [2h Qd]
Seat 9: HighCardJasper (button) showed [2c 7d] and won (212) with a pair of Sevens



PokerStars Home Game Hand #218542259120: {Club #3225207}  Hold'em No Limit (50/100) - 2020/09/17 17:31:08 ET
Table 'fun time' 9-max (Play Money) Seat #1 is the button
Seat 1: dddocky (8579 in chips) 
Seat 2: Duke Croix (14195 in chips) 
Seat 3: color_singleton (3390 in chips) 
Seat 5: Klemtonius (51751 in chips) 
Seat 8: MnnM150 (11913 in chips) 
Seat 9: HighCardJasper (12875 in chips) 
Duke Croix: posts small blind 50
color_singleton: posts big blind 100
*** HOLE CARDS ***
Dealt to Duke Croix [6d 6h]
Klemtonius: raises 100 to 200
MnnM150: calls 200
HighCardJasper: calls 200
dddocky: calls 200
Duke Croix: calls 150
color_singleton: calls 100
*** FLOP *** [2d Th 7s]
Duke Croix: bets 600
color_singleton: folds 
Klemtonius: folds 
MnnM150: folds 
HighCardJasper: folds 
dddocky: folds 
Uncalled bet (600) returned to Duke Croix
Duke Croix collected 1134 from pot
*** SUMMARY ***
Total pot 1200 | Rake 66 
Board [2d Th 7s]
Seat 1: dddocky (button) folded on the Flop
Seat 2: Duke Croix (small blind) collected (1134)
Seat 3: color_singleton (big blind) folded on the Flop
Seat 5: Klemtonius folded on the Flop
Seat 8: MnnM150 folded on the Flop
Seat 9: HighCardJasper folded on the Flop



PokerStars Home Game Hand #218542280194: {Club #3225207}  Hold'em No Limit (50/100) - 2020/09/17 17:31:45 ET
Table 'fun time' 9-max (Play Money) Seat #2 is the button
Seat 1: dddocky (8379 in chips) 
Seat 2: Duke Croix (15129 in chips) 
Seat 3: color_singleton (3190 in chips) 
Seat 5: Klemtonius (51551 in chips) 
Seat 8: MnnM150 (11713 in chips) 
Seat 9: HighCardJasper (12675 in chips) 
color_singleton: posts small blind 50
Klemtonius: posts big blind 100
*** HOLE CARDS ***
Dealt to Duke Croix [8s Kh]
MnnM150: calls 100
HighCardJasper has timed out
HighCardJasper: folds 
dddocky: folds 
Duke Croix: calls 100
color_singleton: raises 200 to 300
Klemtonius: folds 
MnnM150: calls 200
Duke Croix: calls 200
*** FLOP *** [6s Tc 9d]
color_singleton: checks 
MnnM150: checks 
Duke Croix: checks 
*** TURN *** [6s Tc 9d] [Ks]
color_singleton: checks 
MnnM150: checks 
Duke Croix: bets 500
color_singleton: folds 
MnnM150: folds 
Uncalled bet (500) returned to Duke Croix
Duke Croix collected 945 from pot
*** SUMMARY ***
Total pot 1000 | Rake 55 
Board [6s Tc 9d Ks]
Seat 1: dddocky folded before Flop (didn't bet)
Seat 2: Duke Croix (button) collected (945)
Seat 3: color_singleton (small blind) folded on the Turn
Seat 5: Klemtonius (big blind) folded before Flop
Seat 8: MnnM150 folded on the Turn
Seat 9: HighCardJasper folded before Flop (didn't bet)



PokerStars Home Game Hand #218542320161: {Club #3225207}  Hold'em No Limit (50/100) - 2020/09/17 17:32:55 ET
Table 'fun time' 9-max (Play Money) Seat #3 is the button
Seat 1: dddocky (8379 in chips) 
Seat 2: Duke Croix (15774 in chips) 
Seat 3: color_singleton (2890 in chips) 
Seat 5: Klemtonius (51451 in chips) 
Seat 8: MnnM150 (11413 in chips) 
Klemtonius: posts small blind 50
MnnM150: posts big blind 100
*** HOLE CARDS ***
Dealt to Duke Croix [Jh 8c]
dddocky: calls 100
Duke Croix: raises 300 to 400
color_singleton: folds 
Klemtonius: raises 300 to 700
MnnM150: calls 600
dddocky: calls 600
Duke Croix: calls 300
*** FLOP *** [4c 3s As]
Klemtonius: checks 
MnnM150: checks 
dddocky: checks 
Duke Croix: checks 
*** TURN *** [4c 3s As] [3h]
Klemtonius: checks 
MnnM150: checks 
dddocky: checks 
Duke Croix: bets 1000
Klemtonius: raises 1000 to 2000
MnnM150: folds 
dddocky: folds 
Duke Croix: folds 
Uncalled bet (1000) returned to Klemtonius
Klemtonius collected 4536 from pot
Klemtonius: doesn't show hand 
*** SUMMARY ***
Total pot 4800 | Rake 264 
Board [4c 3s As 3h]
Seat 1: dddocky folded on the Turn
Seat 2: Duke Croix folded on the Turn
Seat 3: color_singleton (button) folded before Flop (didn't bet)
Seat 5: Klemtonius (small blind) collected (4536)
Seat 8: MnnM150 (big blind) folded on the Turn



PokerStars Home Game Hand #218542351624: {Club #3225207}  Hold'em No Limit (50/100) - 2020/09/17 17:33:51 ET
Table 'fun time' 9-max (Play Money) Seat #5 is the button
Seat 1: dddocky (7679 in chips) 
Seat 2: Duke Croix (14074 in chips) 
Seat 3: color_singleton (2890 in chips) 
Seat 5: Klemtonius (54287 in chips) 
Seat 8: MnnM150 (10713 in chips) 
MnnM150: posts small blind 50
dddocky: posts big blind 100
*** HOLE CARDS ***
Dealt to Duke Croix [7d Ts]
Duke Croix: folds 
color_singleton: folds 
Klemtonius: folds 
MnnM150: raises 100 to 200
dddocky: calls 100
*** FLOP *** [Qh 6s 3h]
MnnM150: checks 
dddocky: checks 
*** TURN *** [Qh 6s 3h] [6d]
MnnM150: bets 189
dddocky: folds 
Uncalled bet (189) returned to MnnM150
MnnM150 collected 378 from pot
*** SUMMARY ***
Total pot 400 | Rake 22 
Board [Qh 6s 3h 6d]
Seat 1: dddocky (big blind) folded on the Turn
Seat 2: Duke Croix folded before Flop (didn't bet)
Seat 3: color_singleton folded before Flop (didn't bet)
Seat 5: Klemtonius (button) folded before Flop (didn't bet)
Seat 8: MnnM150 (small blind) collected (378)



PokerStars Home Game Hand #218542375249: {Club #3225207}  Hold'em No Limit (50/100) - 2020/09/17 17:34:33 ET
Table 'fun time' 9-max (Play Money) Seat #8 is the button
Seat 1: dddocky (7479 in chips) 
Seat 2: Duke Croix (14074 in chips) 
Seat 3: color_singleton (2890 in chips) 
Seat 5: Klemtonius (54287 in chips) 
Seat 8: MnnM150 (10891 in chips) 
dddocky: posts small blind 50
Duke Croix: posts big blind 100
*** HOLE CARDS ***
Dealt to Duke Croix [2s Ks]
color_singleton has timed out
color_singleton: folds 
Klemtonius: calls 100
MnnM150: folds 
dddocky: raises 400 to 500
Duke Croix: folds 
Klemtonius: calls 400
*** FLOP *** [9d Ac 5s]
dddocky: bets 100
Klemtonius: calls 100
*** TURN *** [9d Ac 5s] [Jd]
dddocky: bets 1228
Klemtonius: folds 
Uncalled bet (1228) returned to dddocky
dddocky collected 1228 from pot
dddocky: doesn't show hand 
*** SUMMARY ***
Total pot 1300 | Rake 72 
Board [9d Ac 5s Jd]
Seat 1: dddocky (small blind) collected (1228)
Seat 2: Duke Croix (big blind) folded before Flop
Seat 3: color_singleton folded before Flop (didn't bet)
Seat 5: Klemtonius folded on the Turn
Seat 8: MnnM150 (button) folded before Flop (didn't bet)



PokerStars Home Game Hand #218542407336: {Club #3225207}  Hold'em No Limit (50/100) - 2020/09/17 17:35:30 ET
Table 'fun time' 9-max (Play Money) Seat #1 is the button
Seat 1: dddocky (8107 in chips) 
Seat 2: Duke Croix (13974 in chips) 
Seat 5: Klemtonius (53687 in chips) 
Seat 8: MnnM150 (10891 in chips) 
Seat 9: HighCardJasper (12675 in chips) 
Duke Croix: posts small blind 50
Klemtonius: posts big blind 100
HighCardJasper: posts small & big blinds 150
*** HOLE CARDS ***
Dealt to Duke Croix [6c 3d]
MnnM150: calls 100
HighCardJasper: checks 
dddocky: calls 100
Duke Croix: calls 50
Klemtonius: raises 217 to 317
MnnM150: calls 217
HighCardJasper: calls 217
dddocky: calls 217
Duke Croix: folds 
*** FLOP *** [7d 3h Jc]
Klemtonius: checks 
MnnM150: checks 
HighCardJasper: checks 
dddocky: checks 
*** TURN *** [7d 3h Jc] [8h]
Klemtonius: checks 
MnnM150: checks 
HighCardJasper: checks 
dddocky: checks 
*** RIVER *** [7d 3h Jc 8h] [5s]
Klemtonius: bets 108
MnnM150: folds 
HighCardJasper: calls 108
dddocky: calls 108
*** SHOW DOWN ***
Klemtonius: shows [Qd Kh] (high card King)
HighCardJasper: shows [Kd 8s] (a pair of Eights)
dddocky: mucks hand 
HighCardJasper collected 1646 from pot
*** SUMMARY ***
Total pot 1742 | Rake 96 
Board [7d 3h Jc 8h 5s]
Seat 1: dddocky (button) mucked [Qh 5h]
Seat 2: Duke Croix (small blind) folded before Flop
Seat 5: Klemtonius (big blind) showed [Qd Kh] and lost with high card King
Seat 8: MnnM150 folded on the River
Seat 9: HighCardJasper showed [Kd 8s] and won (1646) with a pair of Eights



PokerStars Home Game Hand #218542447416: {Club #3225207}  Hold'em No Limit (50/100) - 2020/09/17 17:36:42 ET
Table 'fun time' 9-max (Play Money) Seat #2 is the button
Seat 1: dddocky (7682 in chips) 
Seat 2: Duke Croix (13874 in chips) 
Seat 5: Klemtonius (53262 in chips) 
Seat 8: MnnM150 (10574 in chips) 
Seat 9: HighCardJasper (13846 in chips) 
Klemtonius: posts small blind 50
MnnM150: posts big blind 100
*** HOLE CARDS ***
Dealt to Duke Croix [8h 4h]
HighCardJasper: calls 100
dddocky: folds 
Duke Croix: calls 100
Klemtonius: raises 100 to 200
MnnM150: calls 100
HighCardJasper: calls 100
Duke Croix: calls 100
*** FLOP *** [Ac 9s 7c]
Klemtonius: checks 
MnnM150: bets 378
HighCardJasper: folds 
Duke Croix: folds 
Klemtonius: calls 378
*** TURN *** [Ac 9s 7c] [4s]
Klemtonius: checks 
MnnM150: bets 735
Klemtonius: calls 735
*** RIVER *** [Ac 9s 7c 4s] [Kh]
Klemtonius: checks 
MnnM150: bets 2860
Klemtonius: raises 10960 to 13820
MnnM150: folds 
Uncalled bet (10960) returned to Klemtonius
Klemtonius collected 8265 from pot
Klemtonius: doesn't show hand 
*** SUMMARY ***
Total pot 8746 | Rake 481 
Board [Ac 9s 7c 4s Kh]
Seat 1: dddocky folded before Flop (didn't bet)
Seat 2: Duke Croix (button) folded on the Flop
Seat 5: Klemtonius (small blind) collected (8265)
Seat 8: MnnM150 (big blind) folded on the River
Seat 9: HighCardJasper folded on the Flop



PokerStars Home Game Hand #218542480073: {Club #3225207}  Hold'em No Limit (50/100) - 2020/09/17 17:37:40 ET
Table 'fun time' 9-max (Play Money) Seat #5 is the button
Seat 1: dddocky (7682 in chips) 
Seat 2: Duke Croix (13674 in chips) 
Seat 3: color_singleton (2890 in chips) 
Seat 5: Klemtonius (57354 in chips) 
Seat 8: MnnM150 (6401 in chips) 
Seat 9: HighCardJasper (13646 in chips) 
MnnM150: posts small blind 50
HighCardJasper: posts big blind 100
color_singleton: posts small & big blinds 150
*** HOLE CARDS ***
Dealt to Duke Croix [5d 7d]
dddocky: folds 
Duke Croix: calls 100
color_singleton: checks 
Klemtonius: calls 100
MnnM150: calls 50
HighCardJasper: checks 
*** FLOP *** [Kd Qh Td]
MnnM150: checks 
HighCardJasper: checks 
Duke Croix: bets 400
color_singleton: folds 
Klemtonius: raises 400 to 800
MnnM150 has timed out
MnnM150: folds 
HighCardJasper: folds 
Duke Croix: calls 400
*** TURN *** [Kd Qh Td] [6d]
Duke Croix: bets 1100
Klemtonius: calls 1100
*** RIVER *** [Kd Qh Td 6d] [2s]
Duke Croix: bets 2300
Klemtonius: folds 
Uncalled bet (2300) returned to Duke Croix
Duke Croix collected 4111 from pot
*** SUMMARY ***
Total pot 4350 | Rake 239 
Board [Kd Qh Td 6d 2s]
Seat 1: dddocky folded before Flop (didn't bet)
Seat 2: Duke Croix collected (4111)
Seat 3: color_singleton folded on the Flop (didn't bet)
Seat 5: Klemtonius (button) folded on the River
Seat 8: MnnM150 (small blind) folded on the Flop
Seat 9: HighCardJasper (big blind) folded on the Flop



PokerStars Home Game Hand #218542534837: {Club #3225207}  Hold'em No Limit (50/100) - 2020/09/17 17:39:19 ET
Table 'fun time' 9-max (Play Money) Seat #8 is the button
Seat 1: dddocky (7682 in chips) 
Seat 2: Duke Croix (15785 in chips) 
Seat 3: color_singleton (2740 in chips) 
Seat 5: Klemtonius (55354 in chips) 
Seat 8: MnnM150 (6301 in chips) 
Seat 9: HighCardJasper (13546 in chips) 
HighCardJasper: posts small blind 50
dddocky: posts big blind 100
*** HOLE CARDS ***
Dealt to Duke Croix [8d 2s]
Duke Croix: folds 
color_singleton: folds 
Klemtonius: raises 100 to 200
MnnM150: calls 200
HighCardJasper: calls 150
dddocky: calls 100
*** FLOP *** [9h Th 4h]
HighCardJasper: checks 
dddocky: checks 
Klemtonius: checks 
MnnM150: checks 
*** TURN *** [9h Th 4h] [9s]
HighCardJasper: bets 300
dddocky: folds 
Klemtonius: calls 300
MnnM150: folds 
*** RIVER *** [9h Th 4h 9s] [4c]
HighCardJasper: bets 1000
Klemtonius: folds 
Uncalled bet (1000) returned to HighCardJasper
HighCardJasper collected 1323 from pot
HighCardJasper: doesn't show hand 
*** SUMMARY ***
Total pot 1400 | Rake 77 
Board [9h Th 4h 9s 4c]
Seat 1: dddocky (big blind) folded on the Turn
Seat 2: Duke Croix folded before Flop (didn't bet)
Seat 3: color_singleton folded before Flop (didn't bet)
Seat 5: Klemtonius folded on the River
Seat 8: MnnM150 (button) folded on the Turn
Seat 9: HighCardJasper (small blind) collected (1323)



PokerStars Home Game Hand #218542574643: {Club #3225207}  Hold'em No Limit (50/100) - 2020/09/17 17:40:31 ET
Table 'fun time' 9-max (Play Money) Seat #9 is the button
Seat 1: dddocky (7482 in chips) 
Seat 2: Duke Croix (15785 in chips) 
Seat 3: color_singleton (2740 in chips) 
Seat 5: Klemtonius (54854 in chips) 
Seat 8: MnnM150 (6101 in chips) 
Seat 9: HighCardJasper (14369 in chips) 
dddocky: posts small blind 50
Duke Croix: posts big blind 100
*** HOLE CARDS ***
Dealt to Duke Croix [7d 9s]
color_singleton: raises 100 to 200
Klemtonius: raises 100 to 300
MnnM150: folds 
HighCardJasper: calls 300
dddocky: folds 
Duke Croix: folds 
color_singleton: calls 100
*** FLOP *** [3h Kc Qc]
color_singleton: checks 
Klemtonius: bets 1500
MnnM150 is disconnected 
HighCardJasper: folds 
color_singleton: folds 
Uncalled bet (1500) returned to Klemtonius
Klemtonius collected 992 from pot
Klemtonius: doesn't show hand 
*** SUMMARY ***
Total pot 1050 | Rake 58 
Board [3h Kc Qc]
Seat 1: dddocky (small blind) folded before Flop
Seat 2: Duke Croix (big blind) folded before Flop
Seat 3: color_singleton folded on the Flop
Seat 5: Klemtonius collected (992)
Seat 8: MnnM150 folded before Flop (didn't bet)
Seat 9: HighCardJasper (button) folded on the Flop



PokerStars Home Game Hand #218542596025: {Club #3225207}  Hold'em No Limit (50/100) - 2020/09/17 17:41:10 ET
Table 'fun time' 9-max (Play Money) Seat #1 is the button
Seat 1: dddocky (7432 in chips) 
Seat 2: Duke Croix (15685 in chips) 
Seat 3: color_singleton (2440 in chips) 
Seat 5: Klemtonius (55546 in chips) 
Seat 8: MnnM150 (6101 in chips) 
Seat 9: HighCardJasper (14069 in chips) 
Duke Croix: posts small blind 50
color_singleton: posts big blind 100
*** HOLE CARDS ***
Dealt to Duke Croix [5c Ad]
Klemtonius: calls 100
MnnM150 has timed out while disconnected
MnnM150: folds 
HighCardJasper: calls 100
dddocky: calls 100
Duke Croix: calls 50
color_singleton: raises 200 to 300
Klemtonius: folds 
HighCardJasper: calls 200
dddocky: calls 200
Duke Croix: calls 200
*** FLOP *** [Td Js 8h]
Duke Croix: checks 
color_singleton: bets 1228
HighCardJasper: folds 
dddocky: calls 1228
Duke Croix: folds 
*** TURN *** [Td Js 8h] [6s]
color_singleton: bets 912 and is all-in
dddocky: folds 
Uncalled bet (912) returned to color_singleton
color_singleton collected 3549 from pot
color_singleton: doesn't show hand 
*** SUMMARY ***
Total pot 3756 | Rake 207 
Board [Td Js 8h 6s]
Seat 1: dddocky (button) folded on the Turn
Seat 2: Duke Croix (small blind) folded on the Flop
Seat 3: color_singleton (big blind) collected (3549)
Seat 5: Klemtonius folded before Flop
Seat 8: MnnM150 folded before Flop (didn't bet)
Seat 9: HighCardJasper folded on the Flop



PokerStars Home Game Hand #218542641292: {Club #3225207}  Hold'em No Limit (50/100) - 2020/09/17 17:42:21 ET
Table 'fun time' 9-max (Play Money) Seat #2 is the button
Seat 1: dddocky (5904 in chips) 
Seat 2: Duke Croix (15385 in chips) 
Seat 3: color_singleton (4461 in chips) 
Seat 5: Klemtonius (55446 in chips) 
Seat 9: HighCardJasper (13769 in chips) 
color_singleton: posts small blind 50
Klemtonius: posts big blind 100
*** HOLE CARDS ***
Dealt to Duke Croix [Jh 4d]
HighCardJasper: calls 100
dddocky: folds 
Duke Croix: folds 
color_singleton: raises 200 to 300
Klemtonius: folds 
HighCardJasper: folds 
Uncalled bet (200) returned to color_singleton
color_singleton collected 300 from pot
color_singleton: doesn't show hand 
*** SUMMARY ***
Total pot 300 | Rake 0 
Seat 1: dddocky folded before Flop (didn't bet)
Seat 2: Duke Croix (button) folded before Flop (didn't bet)
Seat 3: color_singleton (small blind) collected (300)
Seat 5: Klemtonius (big blind) folded before Flop
Seat 9: HighCardJasper folded before Flop



PokerStars Home Game Hand #218542653014: {Club #3225207}  Hold'em No Limit (50/100) - 2020/09/17 17:42:42 ET
Table 'fun time' 9-max (Play Money) Seat #3 is the button
Seat 1: dddocky (5904 in chips) 
Seat 2: Duke Croix (15385 in chips) 
Seat 3: color_singleton (4661 in chips) 
Seat 5: Klemtonius (55346 in chips) 
Seat 9: HighCardJasper (13669 in chips) 
Klemtonius: posts small blind 50
HighCardJasper: posts big blind 100
*** HOLE CARDS ***
Dealt to Duke Croix [Ac 4d]
dddocky: calls 100
Duke Croix: calls 100
color_singleton: folds 
Klemtonius: folds 
HighCardJasper: checks 
*** FLOP *** [3h 6h Jc]
HighCardJasper: checks 
dddocky: checks 
Duke Croix: checks 
*** TURN *** [3h 6h Jc] [9d]
HighCardJasper: checks 
dddocky: checks 
Duke Croix: checks 
*** RIVER *** [3h 6h Jc 9d] [8d]
HighCardJasper: bets 500
dddocky: calls 500
Duke Croix: folds 
*** SHOW DOWN ***
HighCardJasper: shows [7h 5c] (a straight, Five to Nine)
dddocky: mucks hand 
HighCardJasper collected 1276 from pot
*** SUMMARY ***
Total pot 1350 | Rake 74 
Board [3h 6h Jc 9d 8d]
Seat 1: dddocky mucked [6c As]
Seat 2: Duke Croix folded on the River
Seat 3: color_singleton (button) folded before Flop (didn't bet)
Seat 5: Klemtonius (small blind) folded before Flop
Seat 9: HighCardJasper (big blind) showed [7h 5c] and won (1276) with a straight, Five to Nine



PokerStars Home Game Hand #218542669953: {Club #3225207}  Hold'em No Limit (50/100) - 2020/09/17 17:43:13 ET
Table 'fun time' 9-max (Play Money) Seat #5 is the button
Seat 1: dddocky (5304 in chips) 
Seat 2: Duke Croix (15285 in chips) 
Seat 3: color_singleton (4661 in chips) 
Seat 5: Klemtonius (55296 in chips) 
Seat 9: HighCardJasper (14345 in chips) 
HighCardJasper: posts small blind 50
dddocky: posts big blind 100
*** HOLE CARDS ***
Dealt to Duke Croix [Kh 5c]
Duke Croix: folds 
color_singleton: raises 200 to 300
Klemtonius: calls 300
HighCardJasper: calls 250
dddocky: calls 200
*** FLOP *** [5d 2s Kd]
HighCardJasper: checks 
dddocky: checks 
color_singleton: checks 
Klemtonius: checks 
*** TURN *** [5d 2s Kd] [Td]
HighCardJasper: checks 
dddocky: checks 
color_singleton: bets 567
Klemtonius: folds 
HighCardJasper: folds 
dddocky: folds 
Uncalled bet (567) returned to color_singleton
color_singleton collected 1134 from pot
color_singleton: doesn't show hand 
*** SUMMARY ***
Total pot 1200 | Rake 66 
Board [5d 2s Kd Td]
Seat 1: dddocky (big blind) folded on the Turn
Seat 2: Duke Croix folded before Flop (didn't bet)
Seat 3: color_singleton collected (1134)
Seat 5: Klemtonius (button) folded on the Turn
Seat 9: HighCardJasper (small blind) folded on the Turn



PokerStars Home Game Hand #218542696718: {Club #3225207}  Hold'em No Limit (50/100) - 2020/09/17 17:44:02 ET
Table 'fun time' 9-max (Play Money) Seat #9 is the button
Seat 1: dddocky (5004 in chips) 
Seat 2: Duke Croix (15285 in chips) 
Seat 3: color_singleton (5495 in chips) 
Seat 5: Klemtonius (54996 in chips) 
Seat 9: HighCardJasper (14045 in chips) 
dddocky: posts small blind 50
Duke Croix: posts big blind 100
*** HOLE CARDS ***
Dealt to Duke Croix [Ts Th]
color_singleton: folds 
Klemtonius: calls 100
HighCardJasper: raises 100 to 200
dddocky: folds 
Duke Croix: raises 400 to 600
Klemtonius: calls 500
HighCardJasper: calls 400
*** FLOP *** [Td Kc 7s]
Duke Croix: checks 
Klemtonius: bets 1748
HighCardJasper: calls 1748
Duke Croix: raises 2752 to 4500
Klemtonius: folds 
HighCardJasper: calls 2752
*** TURN *** [Td Kc 7s] [8c]
Duke Croix: bets 10185 and is all-in
HighCardJasper: calls 8945 and is all-in
Uncalled bet (1240) returned to Duke Croix
*** RIVER *** [Td Kc 7s 8c] [4c]
*** SHOW DOWN ***
Duke Croix: shows [Ts Th] (three of a kind, Tens)
HighCardJasper: shows [Ks Kd] (three of a kind, Kings)
HighCardJasper collected 28811 from pot
*** SUMMARY ***
Total pot 30488 | Rake 1677 
Board [Td Kc 7s 8c 4c]
Seat 1: dddocky (small blind) folded before Flop
Seat 2: Duke Croix (big blind) showed [Ts Th] and lost with three of a kind, Tens
Seat 3: color_singleton folded before Flop (didn't bet)
Seat 5: Klemtonius folded on the Flop
Seat 9: HighCardJasper (button) showed [Ks Kd] and won (28811) with three of a kind, Kings



PokerStars Home Game Hand #218542738664: {Club #3225207}  Hold'em No Limit (50/100) - 2020/09/17 17:45:20 ET
Table 'fun time' 9-max (Play Money) Seat #1 is the button
Seat 1: dddocky (4954 in chips) 
Seat 2: Duke Croix (1240 in chips) 
Seat 3: color_singleton (5495 in chips) 
Seat 5: Klemtonius (52648 in chips) 
Seat 9: HighCardJasper (28811 in chips) 
Duke Croix: posts small blind 50
color_singleton: posts big blind 100
*** HOLE CARDS ***
Dealt to Duke Croix [9h 8s]
Klemtonius: calls 100
HighCardJasper: calls 100
dddocky: folds 
Duke Croix: calls 50
color_singleton: checks 
*** FLOP *** [3c As Kd]
Duke Croix: checks 
color_singleton: checks 
Klemtonius: checks 
HighCardJasper: checks 
*** TURN *** [3c As Kd] [5c]
Duke Croix: checks 
color_singleton: checks 
Klemtonius: checks 
HighCardJasper: checks 
*** RIVER *** [3c As Kd 5c] [4s]
Duke Croix: checks 
color_singleton: checks 
Klemtonius: checks 
HighCardJasper: checks 
*** SHOW DOWN ***
Duke Croix: shows [9h 8s] (high card Ace)
color_singleton: shows [3h Jc] (a pair of Threes)
Klemtonius: mucks hand 
HighCardJasper: shows [5s 8c] (a pair of Fives)
HighCardJasper collected 378 from pot
*** SUMMARY ***
Total pot 400 | Rake 22 
Board [3c As Kd 5c 4s]
Seat 1: dddocky (button) folded before Flop (didn't bet)
Seat 2: Duke Croix (small blind) showed [9h 8s] and lost with high card Ace
Seat 3: color_singleton (big blind) showed [3h Jc] and lost with a pair of Threes
Seat 5: Klemtonius mucked [6s Td]
Seat 9: HighCardJasper showed [5s 8c] and won (378) with a pair of Fives



PokerStars Home Game Hand #218542771351: {Club #3225207}  Hold'em No Limit (50/100) - 2020/09/17 17:46:21 ET
Table 'fun time' 9-max (Play Money) Seat #2 is the button
Seat 1: dddocky (4954 in chips) 
Seat 2: Duke Croix (1140 in chips) 
Seat 3: color_singleton (5395 in chips) 
Seat 5: Klemtonius (52548 in chips) 
Seat 9: HighCardJasper (29089 in chips) 
color_singleton: posts small blind 50
Klemtonius: posts big blind 100
*** HOLE CARDS ***
Dealt to Duke Croix [7h 9s]
HighCardJasper: calls 100
dddocky: folds 
Duke Croix: folds 
color_singleton: folds 
Klemtonius: raises 100 to 200
HighCardJasper: calls 100
*** FLOP *** [7d Td Js]
Klemtonius: checks 
HighCardJasper: checks 
*** TURN *** [7d Td Js] [Ah]
Klemtonius: bets 425
HighCardJasper: folds 
Uncalled bet (425) returned to Klemtonius
Klemtonius collected 425 from pot
Klemtonius: doesn't show hand 
*** SUMMARY ***
Total pot 450 | Rake 25 
Board [7d Td Js Ah]
Seat 1: dddocky folded before Flop (didn't bet)
Seat 2: Duke Croix (button) folded before Flop (didn't bet)
Seat 3: color_singleton (small blind) folded before Flop
Seat 5: Klemtonius (big blind) collected (425)
Seat 9: HighCardJasper folded on the Turn



PokerStars Home Game Hand #218542787167: {Club #3225207}  Hold'em No Limit (50/100) - 2020/09/17 17:46:50 ET
Table 'fun time' 9-max (Play Money) Seat #3 is the button
Seat 1: dddocky (4954 in chips) 
Seat 2: Duke Croix (1140 in chips) 
Seat 3: color_singleton (5345 in chips) 
Seat 5: Klemtonius (52773 in chips) 
Seat 9: HighCardJasper (28889 in chips) 
Klemtonius: posts small blind 50
HighCardJasper: posts big blind 100
*** HOLE CARDS ***
Dealt to Duke Croix [Jc 2s]
dddocky: folds 
Duke Croix: raises 200 to 300
color_singleton: folds 
Klemtonius: raises 200 to 500
HighCardJasper: calls 400
Duke Croix: folds 
*** FLOP *** [5d Kc Qs]
Klemtonius: checks 
HighCardJasper: checks 
*** TURN *** [5d Kc Qs] [7h]
Klemtonius: checks 
HighCardJasper: checks 
*** RIVER *** [5d Kc Qs 7h] [2c]
Klemtonius: bets 1228
HighCardJasper: folds 
Uncalled bet (1228) returned to Klemtonius
Klemtonius collected 1228 from pot
Klemtonius: doesn't show hand 
*** SUMMARY ***
Total pot 1300 | Rake 72 
Board [5d Kc Qs 7h 2c]
Seat 1: dddocky folded before Flop (didn't bet)
Seat 2: Duke Croix folded before Flop
Seat 3: color_singleton (button) folded before Flop (didn't bet)
Seat 5: Klemtonius (small blind) collected (1228)
Seat 9: HighCardJasper (big blind) folded on the River



PokerStars Home Game Hand #218542815712: {Club #3225207}  Hold'em No Limit (50/100) - 2020/09/17 17:47:44 ET
Table 'fun time' 9-max (Play Money) Seat #5 is the button
Seat 1: dddocky (4954 in chips) 
Seat 2: Duke Croix (840 in chips) 
Seat 3: color_singleton (5345 in chips) 
Seat 5: Klemtonius (53501 in chips) 
Seat 9: HighCardJasper (28389 in chips) 
HighCardJasper: posts small blind 50
dddocky: posts big blind 100
*** HOLE CARDS ***
Dealt to Duke Croix [2h 7c]
Duke Croix: folds 
color_singleton: raises 100 to 200
Klemtonius: calls 200
HighCardJasper: calls 150
dddocky: calls 100
*** FLOP *** [7h Kd 2d]
HighCardJasper: checks 
dddocky: checks 
color_singleton: bets 378
Klemtonius: folds 
HighCardJasper: folds 
dddocky: calls 378
*** TURN *** [7h Kd 2d] [5s]
dddocky: checks 
color_singleton: checks 
*** RIVER *** [7h Kd 2d 5s] [2c]
dddocky: checks 
color_singleton: checks 
*** SHOW DOWN ***
dddocky: shows [4h Kc] (two pair, Kings and Deuces)
color_singleton: mucks hand 
dddocky collected 1470 from pot
*** SUMMARY ***
Total pot 1556 | Rake 86 
Board [7h Kd 2d 5s 2c]
Seat 1: dddocky (big blind) showed [4h Kc] and won (1470) with two pair, Kings and Deuces
Seat 2: Duke Croix folded before Flop (didn't bet)
Seat 3: color_singleton mucked [9s Ac]
Seat 5: Klemtonius (button) folded on the Flop
Seat 9: HighCardJasper (small blind) folded on the Flop



PokerStars Home Game Hand #218542850941: {Club #3225207}  Hold'em No Limit (50/100) - 2020/09/17 17:48:50 ET
Table 'fun time' 9-max (Play Money) Seat #9 is the button
Seat 1: dddocky (5846 in chips) 
Seat 2: Duke Croix (840 in chips) 
Seat 3: color_singleton (4767 in chips) 
Seat 5: Klemtonius (53301 in chips) 
Seat 9: HighCardJasper (28189 in chips) 
dddocky: posts small blind 50
Duke Croix: posts big blind 100
*** HOLE CARDS ***
Dealt to Duke Croix [5d 2c]
color_singleton: raises 200 to 300
Klemtonius: folds 
HighCardJasper: calls 300
dddocky: calls 250
Duke Croix: folds 
*** FLOP *** [Td 7s 5h]
dddocky: checks 
color_singleton: bets 472
HighCardJasper: folds 
dddocky: folds 
Uncalled bet (472) returned to color_singleton
color_singleton collected 945 from pot
color_singleton: doesn't show hand 
*** SUMMARY ***
Total pot 1000 | Rake 55 
Board [Td 7s 5h]
Seat 1: dddocky (small blind) folded on the Flop
Seat 2: Duke Croix (big blind) folded before Flop
Seat 3: color_singleton collected (945)
Seat 5: Klemtonius folded before Flop (didn't bet)
Seat 9: HighCardJasper (button) folded on the Flop



PokerStars Home Game Hand #218542864881: {Club #3225207}  Hold'em No Limit (50/100) - 2020/09/17 17:49:17 ET
Table 'fun time' 9-max (Play Money) Seat #1 is the button
Seat 1: dddocky (5546 in chips) 
Seat 2: Duke Croix (740 in chips) 
Seat 3: color_singleton (5412 in chips) 
Seat 5: Klemtonius (53301 in chips) 
Seat 9: HighCardJasper (27889 in chips) 
Duke Croix: posts small blind 50
color_singleton: posts big blind 100
*** HOLE CARDS ***
Dealt to Duke Croix [Kh 8d]
Klemtonius: raises 100 to 200
HighCardJasper: calls 200
dddocky: folds 
Duke Croix: folds 
color_singleton: calls 100
*** FLOP *** [6d Td 2s]
color_singleton: checks 
Klemtonius: bets 614
HighCardJasper: calls 614
color_singleton: folds 
*** TURN *** [6d Td 2s] [Tc]
Klemtonius: checks 
HighCardJasper: bets 1000
Klemtonius: calls 1000
*** RIVER *** [6d Td 2s Tc] [Ad]
Klemtonius: checks 
HighCardJasper: checks 
*** SHOW DOWN ***
Klemtonius: shows [Jd 4d] (a flush, Ace high)
HighCardJasper: mucks hand 
Klemtonius collected 3665 from pot
*** SUMMARY ***
Total pot 3878 | Rake 213 
Board [6d Td 2s Tc Ad]
Seat 1: dddocky (button) folded before Flop (didn't bet)
Seat 2: Duke Croix (small blind) folded before Flop
Seat 3: color_singleton (big blind) folded on the Flop
Seat 5: Klemtonius showed [Jd 4d] and won (3665) with a flush, Ace high
Seat 9: HighCardJasper mucked [Th 7c]



PokerStars Home Game Hand #218542897128: {Club #3225207}  Hold'em No Limit (50/100) - 2020/09/17 17:50:18 ET
Table 'fun time' 9-max (Play Money) Seat #2 is the button
Seat 1: dddocky (5546 in chips) 
Seat 2: Duke Croix (690 in chips) 
Seat 3: color_singleton (5212 in chips) 
Seat 5: Klemtonius (55152 in chips) 
Seat 9: HighCardJasper (26075 in chips) 
color_singleton: posts small blind 50
Klemtonius: posts big blind 100
*** HOLE CARDS ***
Dealt to Duke Croix [Ah Td]
HighCardJasper: calls 100
dddocky: folds 
Duke Croix: raises 590 to 690 and is all-in
color_singleton: folds 
Klemtonius: calls 590
HighCardJasper: folds 
*** FLOP *** [7d 5s Jd]
*** TURN *** [7d 5s Jd] [6d]
*** RIVER *** [7d 5s Jd 6d] [5h]
*** SHOW DOWN ***
Klemtonius: shows [6s Qd] (two pair, Sixes and Fives)
Duke Croix: shows [Ah Td] (a pair of Fives)
Klemtonius collected 1446 from pot
*** SUMMARY ***
Total pot 1530 | Rake 84 
Board [7d 5s Jd 6d 5h]
Seat 1: dddocky folded before Flop (didn't bet)
Seat 2: Duke Croix (button) showed [Ah Td] and lost with a pair of Fives
Seat 3: color_singleton (small blind) folded before Flop
Seat 5: Klemtonius (big blind) showed [6s Qd] and won (1446) with two pair, Sixes and Fives
Seat 9: HighCardJasper folded before Flop



PokerStars Home Game Hand #218542952176: {Club #3225207}  Hold'em No Limit (50/100) - 2020/09/17 17:52:03 ET
Table 'fun time' 9-max (Play Money) Seat #5 is the button
Seat 1: dddocky (5246 in chips) 
Seat 2: Duke Croix (10000 in chips) 
Seat 3: color_singleton (4295 in chips) 
Seat 5: Klemtonius (57247 in chips) 
Seat 9: HighCardJasper (25675 in chips) 
HighCardJasper: posts small blind 50
dddocky: posts big blind 100
*** HOLE CARDS ***
Dealt to Duke Croix [9h 2c]
Duke Croix: folds 
color_singleton: raises 100 to 200
Klemtonius: calls 200
HighCardJasper: calls 150
dddocky: folds 
*** FLOP *** [7s Qh 7c]
HighCardJasper: checks 
color_singleton: checks 
Klemtonius: checks 
*** TURN *** [7s Qh 7c] [Qc]
HighCardJasper: checks 
color_singleton: checks 
Klemtonius: checks 
*** RIVER *** [7s Qh 7c Qc] [2s]
HighCardJasper: bets 100
color_singleton: folds 
Klemtonius: folds 
Uncalled bet (100) returned to HighCardJasper
HighCardJasper collected 661 from pot
HighCardJasper: doesn't show hand 
*** SUMMARY ***
Total pot 700 | Rake 39 
Board [7s Qh 7c Qc 2s]
Seat 1: dddocky (big blind) folded before Flop
Seat 2: Duke Croix folded before Flop (didn't bet)
Seat 3: color_singleton folded on the River
Seat 5: Klemtonius (button) folded on the River
Seat 9: HighCardJasper (small blind) collected (661)



PokerStars Home Game Hand #218542975787: {Club #3225207}  Hold'em No Limit (50/100) - 2020/09/17 17:52:48 ET
Table 'fun time' 9-max (Play Money) Seat #9 is the button
Seat 1: dddocky (5146 in chips) 
Seat 2: Duke Croix (10000 in chips) 
Seat 3: color_singleton (4095 in chips) 
Seat 5: Klemtonius (57047 in chips) 
Seat 9: HighCardJasper (26136 in chips) 
dddocky: posts small blind 50
Duke Croix: posts big blind 100
*** HOLE CARDS ***
Dealt to Duke Croix [Td Jd]
color_singleton: folds 
Klemtonius: raises 400 to 500
HighCardJasper: folds 
dddocky: folds 
Duke Croix: calls 400
*** FLOP *** [8s 2h Qh]
Duke Croix: checks 
Klemtonius: bets 496
Duke Croix: folds 
Uncalled bet (496) returned to Klemtonius
Klemtonius collected 992 from pot
Klemtonius: doesn't show hand 
*** SUMMARY ***
Total pot 1050 | Rake 58 
Board [8s 2h Qh]
Seat 1: dddocky (small blind) folded before Flop
Seat 2: Duke Croix (big blind) folded on the Flop
Seat 3: color_singleton folded before Flop (didn't bet)
Seat 5: Klemtonius collected (992)
Seat 9: HighCardJasper (button) folded before Flop (didn't bet)



PokerStars Home Game Hand #218542994404: {Club #3225207}  Hold'em No Limit (50/100) - 2020/09/17 17:53:24 ET
Table 'fun time' 9-max (Play Money) Seat #1 is the button
Seat 1: dddocky (5096 in chips) 
Seat 2: Duke Croix (9500 in chips) 
Seat 3: color_singleton (4095 in chips) 
Seat 5: Klemtonius (57539 in chips) 
Seat 9: HighCardJasper (26136 in chips) 
Duke Croix: posts small blind 50
color_singleton: posts big blind 100
*** HOLE CARDS ***
Dealt to Duke Croix [9h 2s]
Klemtonius: calls 100
HighCardJasper: raises 300 to 400
dddocky: folds 
Duke Croix: folds 
color_singleton: folds 
Klemtonius: calls 300
*** FLOP *** [Jd Ks 9d]
Klemtonius: bets 898
HighCardJasper: calls 898
*** TURN *** [Jd Ks 9d] [2c]
Klemtonius: bets 2595
HighCardJasper: folds 
Uncalled bet (2595) returned to Klemtonius
Klemtonius collected 2595 from pot
Klemtonius: doesn't show hand 
*** SUMMARY ***
Total pot 2746 | Rake 151 
Board [Jd Ks 9d 2c]
Seat 1: dddocky (button) folded before Flop (didn't bet)
Seat 2: Duke Croix (small blind) folded before Flop
Seat 3: color_singleton (big blind) folded before Flop
Seat 5: Klemtonius collected (2595)
Seat 9: HighCardJasper folded on the Turn



PokerStars Home Game Hand #218543015932: {Club #3225207}  Hold'em No Limit (50/100) - 2020/09/17 17:54:05 ET
Table 'fun time' 9-max (Play Money) Seat #2 is the button
Seat 1: dddocky (5096 in chips) 
Seat 2: Duke Croix (9450 in chips) 
Seat 3: color_singleton (3995 in chips) 
Seat 5: Klemtonius (58836 in chips) 
Seat 9: HighCardJasper (24838 in chips) 
color_singleton: posts small blind 50
Klemtonius: posts big blind 100
*** HOLE CARDS ***
Dealt to Duke Croix [4h 3h]
HighCardJasper: calls 100
dddocky: calls 100
Duke Croix: raises 300 to 400
color_singleton: folds 
Klemtonius: folds 
HighCardJasper: calls 300
dddocky: calls 300
*** FLOP *** [Tc 7h 3d]
HighCardJasper: bets 500
dddocky: folds 
Duke Croix: folds 
Uncalled bet (500) returned to HighCardJasper
HighCardJasper collected 1276 from pot
HighCardJasper: doesn't show hand 
*** SUMMARY ***
Total pot 1350 | Rake 74 
Board [Tc 7h 3d]
Seat 1: dddocky folded on the Flop
Seat 2: Duke Croix (button) folded on the Flop
Seat 3: color_singleton (small blind) folded before Flop
Seat 5: Klemtonius (big blind) folded before Flop
Seat 9: HighCardJasper collected (1276)



PokerStars Home Game Hand #218543031681: {Club #3225207}  Hold'em No Limit (50/100) - 2020/09/17 17:54:36 ET
Table 'fun time' 9-max (Play Money) Seat #3 is the button
Seat 1: dddocky (4696 in chips) 
Seat 2: Duke Croix (9050 in chips) 
Seat 3: color_singleton (3945 in chips) 
Seat 5: Klemtonius (58736 in chips) 
Seat 9: HighCardJasper (25714 in chips) 
Klemtonius: posts small blind 50
HighCardJasper: posts big blind 100
*** HOLE CARDS ***
Dealt to Duke Croix [Qd 5c]
dddocky: raises 100 to 200
Duke Croix: folds 
color_singleton: folds 
Klemtonius: raises 100 to 300
HighCardJasper: calls 200
dddocky: calls 100
*** FLOP *** [9h 4h 8c]
Klemtonius: checks 
HighCardJasper: bets 400
dddocky: calls 400
Klemtonius: folds 
*** TURN *** [9h 4h 8c] [Jh]
HighCardJasper: checks 
dddocky: checks 
*** RIVER *** [9h 4h 8c Jh] [7s]
HighCardJasper: bets 1000
dddocky: folds 
Uncalled bet (1000) returned to HighCardJasper
HighCardJasper collected 1606 from pot
HighCardJasper: doesn't show hand 
*** SUMMARY ***
Total pot 1700 | Rake 94 
Board [9h 4h 8c Jh 7s]
Seat 1: dddocky folded on the River
Seat 2: Duke Croix folded before Flop (didn't bet)
Seat 3: color_singleton (button) folded before Flop (didn't bet)
Seat 5: Klemtonius (small blind) folded on the Flop
Seat 9: HighCardJasper (big blind) collected (1606)



PokerStars Home Game Hand #218543055409: {Club #3225207}  Hold'em No Limit (50/100) - 2020/09/17 17:55:29 ET
Table 'fun time' 9-max (Play Money) Seat #5 is the button
Seat 1: dddocky (3996 in chips) 
Seat 2: Duke Croix (9050 in chips) 
Seat 3: color_singleton (3945 in chips) 
Seat 5: Klemtonius (58436 in chips) 
Seat 9: HighCardJasper (26620 in chips) 
HighCardJasper: posts small blind 50
dddocky: posts big blind 100
*** HOLE CARDS ***
Dealt to Duke Croix [8c 6c]
Duke Croix: folds 
color_singleton: raises 200 to 300
Klemtonius: raises 200 to 500
HighCardJasper: calls 450
dddocky: folds 
color_singleton: calls 200
*** FLOP *** [Ks Qd 3s]
HighCardJasper: checks 
color_singleton: checks 
Klemtonius: bets 1512
HighCardJasper: calls 1512
color_singleton: calls 1512
*** TURN *** [Ks Qd 3s] [Qh]
HighCardJasper: bets 1000
color_singleton: raises 933 to 1933 and is all-in
Klemtonius: calls 1933
HighCardJasper: calls 933
*** RIVER *** [Ks Qd 3s Qh] [Jh]
HighCardJasper: checks 
Klemtonius: bets 3300
HighCardJasper: calls 3300
*** SHOW DOWN ***
Klemtonius: shows [Ad Th] (a straight, Ten to Ace)
HighCardJasper: mucks hand 
Klemtonius collected 6237 from side pot
color_singleton: mucks hand 
Klemtonius collected 11279 from main pot
*** SUMMARY ***
Total pot 18535 Main pot 11279. Side pot 6237. | Rake 1019 
Board [Ks Qd 3s Qh Jh]
Seat 1: dddocky (big blind) folded before Flop
Seat 2: Duke Croix folded before Flop (didn't bet)
Seat 3: color_singleton mucked [Kd Js]
Seat 5: Klemtonius (button) showed [Ad Th] and won (17516) with a straight, Ten to Ace
Seat 9: HighCardJasper (small blind) mucked [5s Qs]



PokerStars Home Game Hand #218543085724: {Club #3225207}  Hold'em No Limit (50/100) - 2020/09/17 17:56:48 ET
Table 'fun time' 9-max (Play Money) Seat #9 is the button
Seat 1: dddocky (3896 in chips) 
Seat 2: Duke Croix (9050 in chips) 
Seat 5: Klemtonius (68707 in chips) 
Seat 9: HighCardJasper (19375 in chips) 
dddocky: posts small blind 50
Duke Croix: posts big blind 100
*** HOLE CARDS ***
Dealt to Duke Croix [Qs 6d]
Klemtonius: calls 100
HighCardJasper: calls 100
dddocky: calls 50
Duke Croix: checks 
*** FLOP *** [2c As Ts]
dddocky: bets 100
Duke Croix: folds 
Klemtonius: folds 
HighCardJasper: calls 100
*** TURN *** [2c As Ts] [3d]
dddocky: bets 567
HighCardJasper: calls 567
*** RIVER *** [2c As Ts 3d] [3c]
dddocky: checks 
HighCardJasper: checks 
*** SHOW DOWN ***
dddocky: shows [Kd Ks] (two pair, Kings and Threes)
HighCardJasper: mucks hand 
dddocky collected 1639 from pot
*** SUMMARY ***
Total pot 1734 | Rake 95 
Board [2c As Ts 3d 3c]
Seat 1: dddocky (small blind) showed [Kd Ks] and won (1639) with two pair, Kings and Threes
Seat 2: Duke Croix (big blind) folded on the Flop
Seat 5: Klemtonius folded on the Flop
Seat 9: HighCardJasper (button) mucked [7h 5c]



PokerStars Home Game Hand #218543112617: {Club #3225207}  Hold'em No Limit (50/100) - 2020/09/17 17:57:57 ET
Table 'fun time' 9-max (Play Money) Seat #1 is the button
Seat 1: dddocky (4768 in chips) 
Seat 2: Duke Croix (8950 in chips) 
Seat 3: color_singleton (10000 in chips) 
Seat 5: Klemtonius (68607 in chips) 
Seat 9: HighCardJasper (18608 in chips) 
Duke Croix: posts small blind 50
color_singleton: posts big blind 100
*** HOLE CARDS ***
Dealt to Duke Croix [Td 8s]
Klemtonius: raises 100 to 200
HighCardJasper: calls 200
dddocky: calls 200
Duke Croix: folds 
color_singleton: calls 100
*** FLOP *** [Kc 6c 8c]
color_singleton: checks 
Klemtonius: bets 543
HighCardJasper: calls 543
dddocky: folds 
color_singleton: folds 
*** TURN *** [Kc 6c 8c] [2s]
Klemtonius: checks 
HighCardJasper: checks 
*** RIVER *** [Kc 6c 8c 2s] [9c]
Klemtonius: bets 1830
HighCardJasper: raises 5730 to 7560
Klemtonius: calls 5730
*** SHOW DOWN ***
HighCardJasper: shows [Jh Ac] (a flush, Ace high)
Klemtonius: mucks hand 
HighCardJasper collected 16118 from pot
*** SUMMARY ***
Total pot 17056 | Rake 938 
Board [Kc 6c 8c 2s 9c]
Seat 1: dddocky (button) folded on the Flop
Seat 2: Duke Croix (small blind) folded before Flop
Seat 3: color_singleton (big blind) folded on the Flop
Seat 5: Klemtonius mucked [Qc Th]
Seat 9: HighCardJasper showed [Jh Ac] and won (16118) with a flush, Ace high



PokerStars Home Game Hand #218543137864: {Club #3225207}  Hold'em No Limit (50/100) - 2020/09/17 17:59:03 ET
Table 'fun time' 9-max (Play Money) Seat #2 is the button
Seat 1: dddocky (4568 in chips) 
Seat 2: Duke Croix (8900 in chips) 
Seat 3: color_singleton (9800 in chips) 
Seat 5: Klemtonius (60304 in chips) 
Seat 9: HighCardJasper (26423 in chips) 
color_singleton: posts small blind 50
Klemtonius: posts big blind 100
*** HOLE CARDS ***
Dealt to Duke Croix [Ac Qh]
HighCardJasper: calls 100
dddocky: folds 
Duke Croix: raises 300 to 400
color_singleton: calls 350
Klemtonius: calls 300
HighCardJasper: calls 300
*** FLOP *** [Kc 6c 7c]
color_singleton: checks 
Klemtonius: bets 1512
HighCardJasper: folds 
Duke Croix: calls 1512
color_singleton: folds 
*** TURN *** [Kc 6c 7c] [6d]
Klemtonius: bets 4370
Duke Croix: calls 4370
*** RIVER *** [Kc 6c 7c 6d] [Jc]
Klemtonius: bets 12629
Duke Croix: calls 2618 and is all-in
Uncalled bet (10011) returned to Klemtonius
*** SHOW DOWN ***
Klemtonius: shows [9c Ad] (a flush, King high)
Duke Croix: shows [Ac Qh] (a flush, Ace high)
Duke Croix collected 17577 from pot
*** SUMMARY ***
Total pot 18600 | Rake 1023 
Board [Kc 6c 7c 6d Jc]
Seat 1: dddocky folded before Flop (didn't bet)
Seat 2: Duke Croix (button) showed [Ac Qh] and won (17577) with a flush, Ace high
Seat 3: color_singleton (small blind) folded on the Flop
Seat 5: Klemtonius (big blind) showed [9c Ad] and lost with a flush, King high
Seat 9: HighCardJasper folded on the Flop



PokerStars Home Game Hand #218543170242: {Club #3225207}  Hold'em No Limit (50/100) - 2020/09/17 18:00:25 ET
Table 'fun time' 9-max (Play Money) Seat #3 is the button
Seat 1: dddocky (4568 in chips) 
Seat 2: Duke Croix (17577 in chips) 
Seat 3: color_singleton (9400 in chips) 
Seat 5: Klemtonius (51404 in chips) 
Seat 9: HighCardJasper (26023 in chips) 
Klemtonius: posts small blind 50
HighCardJasper: posts big blind 100
*** HOLE CARDS ***
Dealt to Duke Croix [8s 6s]
dddocky: calls 100
Duke Croix: folds 
color_singleton: raises 100 to 200
Klemtonius: calls 150
HighCardJasper: raises 300 to 500
dddocky: folds 
color_singleton: folds 
Klemtonius: folds 
Uncalled bet (300) returned to HighCardJasper
HighCardJasper collected 700 from pot
HighCardJasper: doesn't show hand 
*** SUMMARY ***
Total pot 700 | Rake 0 
Seat 1: dddocky folded before Flop
Seat 2: Duke Croix folded before Flop (didn't bet)
Seat 3: color_singleton (button) folded before Flop
Seat 5: Klemtonius (small blind) folded before Flop
Seat 9: HighCardJasper (big blind) collected (700)



PokerStars Home Game Hand #218543189374: {Club #3225207}  Hold'em No Limit (50/100) - 2020/09/17 18:01:09 ET
Table 'fun time' 9-max (Play Money) Seat #5 is the button
Seat 1: dddocky (4468 in chips) 
Seat 2: Duke Croix (17577 in chips) 
Seat 3: color_singleton (9200 in chips) 
Seat 5: Klemtonius (51204 in chips) 
Seat 9: HighCardJasper (26523 in chips) 
HighCardJasper: posts small blind 50
dddocky: posts big blind 100
*** HOLE CARDS ***
Dealt to Duke Croix [Jd Js]
Duke Croix: raises 300 to 400
color_singleton: folds 
Klemtonius: calls 400
HighCardJasper: folds 
dddocky: folds 
*** FLOP *** [4c 2c Qc]
Duke Croix: bets 400
Klemtonius: calls 400
*** TURN *** [4c 2c Qc] [6d]
Duke Croix: checks 
Klemtonius: checks 
*** RIVER *** [4c 2c Qc 6d] [Qs]
Duke Croix: bets 700
Klemtonius: folds 
Uncalled bet (700) returned to Duke Croix
Duke Croix collected 1654 from pot
*** SUMMARY ***
Total pot 1750 | Rake 96 
Board [4c 2c Qc 6d Qs]
Seat 1: dddocky (big blind) folded before Flop
Seat 2: Duke Croix collected (1654)
Seat 3: color_singleton folded before Flop (didn't bet)
Seat 5: Klemtonius (button) folded on the River
Seat 9: HighCardJasper (small blind) folded before Flop



PokerStars Home Game Hand #218543204785: {Club #3225207}  Hold'em No Limit (50/100) - 2020/09/17 18:01:42 ET
Table 'fun time' 9-max (Play Money) Seat #9 is the button
Seat 1: dddocky (4368 in chips) 
Seat 2: Duke Croix (18431 in chips) 
Seat 3: color_singleton (9200 in chips) 
Seat 5: Klemtonius (50404 in chips) 
Seat 9: HighCardJasper (26473 in chips) 
dddocky: posts small blind 50
Duke Croix: posts big blind 100
*** HOLE CARDS ***
Dealt to Duke Croix [Ac Kd]
color_singleton: raises 100 to 200
Klemtonius: calls 200
HighCardJasper: calls 200
dddocky: folds 
Duke Croix: raises 500 to 700
color_singleton: calls 500
Klemtonius: calls 500
HighCardJasper: folds 
*** FLOP *** [Kc 9c Td]
Duke Croix: bets 1000
color_singleton: calls 1000
Klemtonius: calls 1000
*** TURN *** [Kc 9c Td] [9d]
Duke Croix: bets 1800
color_singleton: raises 1800 to 3600
Klemtonius: folds 
Duke Croix: calls 1800
*** RIVER *** [Kc 9c Td 9d] [7h]
Duke Croix: checks 
color_singleton: bets 3900 and is all-in
Duke Croix: folds 
Uncalled bet (3900) returned to color_singleton
color_singleton collected 11860 from pot
color_singleton: doesn't show hand 
*** SUMMARY ***
Total pot 12550 | Rake 690 
Board [Kc 9c Td 9d 7h]
Seat 1: dddocky (small blind) folded before Flop
Seat 2: Duke Croix (big blind) folded on the River
Seat 3: color_singleton collected (11860)
Seat 5: Klemtonius folded on the Turn
Seat 9: HighCardJasper (button) folded before Flop



PokerStars Home Game Hand #218543246787: {Club #3225207}  Hold'em No Limit (50/100) - 2020/09/17 18:03:07 ET
Table 'fun time' 9-max (Play Money) Seat #1 is the button
Seat 1: dddocky (4318 in chips) 
Seat 2: Duke Croix (13131 in chips) 
Seat 3: color_singleton (15760 in chips) 
Seat 5: Klemtonius (48704 in chips) 
Seat 9: HighCardJasper (26273 in chips) 
Duke Croix: posts small blind 50
color_singleton: posts big blind 100
*** HOLE CARDS ***
Dealt to Duke Croix [3h 4c]
Klemtonius: calls 100
HighCardJasper: raises 300 to 400
dddocky: calls 400
Duke Croix: folds 
color_singleton: calls 300
Klemtonius: calls 300
*** FLOP *** [9c 5h 7h]
color_singleton: checks 
Klemtonius: bets 1559
HighCardJasper: folds 
dddocky: folds 
color_singleton: folds 
Uncalled bet (1559) returned to Klemtonius
Klemtonius collected 1559 from pot
Klemtonius: doesn't show hand 
*** SUMMARY ***
Total pot 1650 | Rake 91 
Board [9c 5h 7h]
Seat 1: dddocky (button) folded on the Flop
Seat 2: Duke Croix (small blind) folded before Flop
Seat 3: color_singleton (big blind) folded on the Flop
Seat 5: Klemtonius collected (1559)
Seat 9: HighCardJasper folded on the Flop



PokerStars Home Game Hand #218543263904: {Club #3225207}  Hold'em No Limit (50/100) - 2020/09/17 18:03:41 ET
Table 'fun time' 9-max (Play Money) Seat #2 is the button
Seat 1: dddocky (3918 in chips) 
Seat 2: Duke Croix (13081 in chips) 
Seat 3: color_singleton (15360 in chips) 
Seat 5: Klemtonius (49863 in chips) 
Seat 9: HighCardJasper (25873 in chips) 
color_singleton: posts small blind 50
Klemtonius: posts big blind 100
*** HOLE CARDS ***
Dealt to Duke Croix [7s Qc]
HighCardJasper: raises 200 to 300
dddocky: calls 300
Duke Croix: folds 
color_singleton: folds 
Klemtonius: raises 200 to 500
HighCardJasper: calls 200
dddocky: folds 
*** FLOP *** [3c 8h As]
Klemtonius: checks 
HighCardJasper: bets 300
Klemtonius: calls 300
*** TURN *** [3c 8h As] [5h]
Klemtonius: checks 
HighCardJasper: bets 400
Klemtonius: folds 
Uncalled bet (400) returned to HighCardJasper
HighCardJasper collected 1843 from pot
HighCardJasper: doesn't show hand 
*** SUMMARY ***
Total pot 1950 | Rake 107 
Board [3c 8h As 5h]
Seat 1: dddocky folded before Flop
Seat 2: Duke Croix (button) folded before Flop (didn't bet)
Seat 3: color_singleton (small blind) folded before Flop
Seat 5: Klemtonius (big blind) folded on the Turn
Seat 9: HighCardJasper collected (1843)



PokerStars Home Game Hand #218543282218: {Club #3225207}  Hold'em No Limit (50/100) - 2020/09/17 18:04:17 ET
Table 'fun time' 9-max (Play Money) Seat #3 is the button
Seat 1: dddocky (3618 in chips) 
Seat 2: Duke Croix (13081 in chips) 
Seat 3: color_singleton (15310 in chips) 
Seat 5: Klemtonius (49063 in chips) 
Seat 9: HighCardJasper (26916 in chips) 
Klemtonius: posts small blind 50
HighCardJasper: posts big blind 100
*** HOLE CARDS ***
Dealt to Duke Croix [2c Ah]
dddocky has timed out
dddocky: folds 
Duke Croix: calls 100
color_singleton: folds 
Klemtonius: calls 50
HighCardJasper: checks 
*** FLOP *** [6d Qc Tc]
Klemtonius: bets 100
HighCardJasper: calls 100
Duke Croix: folds 
*** TURN *** [6d Qc Tc] [Ac]
Klemtonius: bets 100
HighCardJasper: calls 100
*** RIVER *** [6d Qc Tc Ac] [8h]
Klemtonius: bets 100
HighCardJasper: raises 400 to 500
Klemtonius: calls 400
*** SHOW DOWN ***
HighCardJasper: shows [8s Ad] (two pair, Aces and Eights)
Klemtonius: mucks hand 
HighCardJasper collected 1606 from pot
*** SUMMARY ***
Total pot 1700 | Rake 94 
Board [6d Qc Tc Ac 8h]
Seat 1: dddocky folded before Flop (didn't bet)
Seat 2: Duke Croix folded on the Flop
Seat 3: color_singleton (button) folded before Flop (didn't bet)
Seat 5: Klemtonius (small blind) mucked [Qh 4c]
Seat 9: HighCardJasper (big blind) showed [8s Ad] and won (1606) with two pair, Aces and Eights



PokerStars Home Game Hand #218543310845: {Club #3225207}  Hold'em No Limit (50/100) - 2020/09/17 18:05:13 ET
Table 'fun time' 9-max (Play Money) Seat #5 is the button
Seat 1: dddocky (3618 in chips) 
Seat 2: Duke Croix (12981 in chips) 
Seat 3: color_singleton (15310 in chips) 
Seat 5: Klemtonius (48263 in chips) 
Seat 9: HighCardJasper (27722 in chips) 
HighCardJasper: posts small blind 50
dddocky: posts big blind 100
*** HOLE CARDS ***
Dealt to Duke Croix [Ks 7h]
Duke Croix: calls 100
color_singleton: folds 
Klemtonius: raises 500 to 600
HighCardJasper: calls 550
dddocky: folds 
Duke Croix: folds 
*** FLOP *** [Th 6d 4s]
HighCardJasper: checks 
Klemtonius: bets 1323
HighCardJasper: folds 
Uncalled bet (1323) returned to Klemtonius
Klemtonius collected 1323 from pot
Klemtonius: doesn't show hand 
*** SUMMARY ***
Total pot 1400 | Rake 77 
Board [Th 6d 4s]
Seat 1: dddocky (big blind) folded before Flop
Seat 2: Duke Croix folded before Flop
Seat 3: color_singleton folded before Flop (didn't bet)
Seat 5: Klemtonius (button) collected (1323)
Seat 9: HighCardJasper (small blind) folded on the Flop



PokerStars Home Game Hand #218543321955: {Club #3225207}  Hold'em No Limit (50/100) - 2020/09/17 18:05:35 ET
Table 'fun time' 9-max (Play Money) Seat #9 is the button
Seat 1: dddocky (3518 in chips) 
Seat 2: Duke Croix (12881 in chips) 
Seat 3: color_singleton (15310 in chips) 
Seat 5: Klemtonius (48986 in chips) 
Seat 9: HighCardJasper (27122 in chips) 
dddocky: posts small blind 50
Duke Croix: posts big blind 100
*** HOLE CARDS ***
Dealt to Duke Croix [Qs Th]
color_singleton: folds 
Klemtonius: raises 500 to 600
HighCardJasper: folds 
dddocky: folds 
Duke Croix: folds 
Uncalled bet (500) returned to Klemtonius
Klemtonius collected 250 from pot
Klemtonius: doesn't show hand 
*** SUMMARY ***
Total pot 250 | Rake 0 
Seat 1: dddocky (small blind) folded before Flop
Seat 2: Duke Croix (big blind) folded before Flop
Seat 3: color_singleton folded before Flop (didn't bet)
Seat 5: Klemtonius collected (250)
Seat 9: HighCardJasper (button) folded before Flop (didn't bet)



PokerStars Home Game Hand #218543332074: {Club #3225207}  Hold'em No Limit (50/100) - 2020/09/17 18:05:55 ET
Table 'fun time' 9-max (Play Money) Seat #1 is the button
Seat 1: dddocky (3468 in chips) 
Seat 2: Duke Croix (12781 in chips) 
Seat 3: color_singleton (15310 in chips) 
Seat 5: Klemtonius (49136 in chips) 
Seat 9: HighCardJasper (27122 in chips) 
Duke Croix: posts small blind 50
color_singleton: posts big blind 100
*** HOLE CARDS ***
Dealt to Duke Croix [5h 3c]
Klemtonius: folds 
HighCardJasper: raises 100 to 200
dddocky: folds 
Duke Croix: folds 
color_singleton: calls 100
*** FLOP *** [Qh 7c Ah]
color_singleton: checks 
HighCardJasper: bets 400
color_singleton: folds 
Uncalled bet (400) returned to HighCardJasper
HighCardJasper collected 425 from pot
HighCardJasper: doesn't show hand 
*** SUMMARY ***
Total pot 450 | Rake 25 
Board [Qh 7c Ah]
Seat 1: dddocky (button) folded before Flop (didn't bet)
Seat 2: Duke Croix (small blind) folded before Flop
Seat 3: color_singleton (big blind) folded on the Flop
Seat 5: Klemtonius folded before Flop (didn't bet)
Seat 9: HighCardJasper collected (425)



PokerStars Home Game Hand #218543346347: {Club #3225207}  Hold'em No Limit (50/100) - 2020/09/17 18:06:23 ET
Table 'fun time' 9-max (Play Money) Seat #2 is the button
Seat 1: dddocky (3468 in chips) 
Seat 2: Duke Croix (12731 in chips) 
Seat 3: color_singleton (15110 in chips) 
Seat 5: Klemtonius (49136 in chips) 
Seat 9: HighCardJasper (27347 in chips) 
color_singleton: posts small blind 50
Klemtonius: posts big blind 100
*** HOLE CARDS ***
Dealt to Duke Croix [9h 5c]
HighCardJasper: calls 100
dddocky: calls 100
Duke Croix: folds 
color_singleton: folds 
Klemtonius: raises 400 to 500
HighCardJasper: folds 
dddocky: folds 
Uncalled bet (400) returned to Klemtonius
Klemtonius collected 350 from pot
Klemtonius: doesn't show hand 
*** SUMMARY ***
Total pot 350 | Rake 0 
Seat 1: dddocky folded before Flop
Seat 2: Duke Croix (button) folded before Flop (didn't bet)
Seat 3: color_singleton (small blind) folded before Flop
Seat 5: Klemtonius (big blind) collected (350)
Seat 9: HighCardJasper folded before Flop



PokerStars Home Game Hand #218543353599: {Club #3225207}  Hold'em No Limit (50/100) - 2020/09/17 18:06:37 ET
Table 'fun time' 9-max (Play Money) Seat #3 is the button
Seat 1: dddocky (3368 in chips) 
Seat 2: Duke Croix (12731 in chips) 
Seat 3: color_singleton (15060 in chips) 
Seat 5: Klemtonius (49386 in chips) 
Seat 9: HighCardJasper (27247 in chips) 
Klemtonius: posts small blind 50
HighCardJasper: posts big blind 100
*** HOLE CARDS ***
Dealt to Duke Croix [7s 6h]
dddocky: folds 
Duke Croix: calls 100
color_singleton: folds 
Klemtonius: raises 400 to 500
HighCardJasper: calls 400
Duke Croix: folds 
*** FLOP *** [2d 2s 9c]
Klemtonius: checks 
HighCardJasper: checks 
*** TURN *** [2d 2s 9c] [4c]
Klemtonius: checks 
HighCardJasper: bets 500
Klemtonius: folds 
Uncalled bet (500) returned to HighCardJasper
HighCardJasper collected 1039 from pot
HighCardJasper: doesn't show hand 
*** SUMMARY ***
Total pot 1100 | Rake 61 
Board [2d 2s 9c 4c]
Seat 1: dddocky folded before Flop (didn't bet)
Seat 2: Duke Croix folded before Flop
Seat 3: color_singleton (button) folded before Flop (didn't bet)
Seat 5: Klemtonius (small blind) folded on the Turn
Seat 9: HighCardJasper (big blind) collected (1039)



PokerStars Home Game Hand #218543382446: {Club #3225207}  Hold'em No Limit (50/100) - 2020/09/17 18:07:32 ET
Table 'fun time' 9-max (Play Money) Seat #5 is the button
Seat 1: dddocky (3368 in chips) 
Seat 2: Duke Croix (12631 in chips) 
Seat 3: color_singleton (15060 in chips) 
Seat 5: Klemtonius (48886 in chips) 
Seat 9: HighCardJasper (27786 in chips) 
HighCardJasper: posts small blind 50
dddocky: posts big blind 100
*** HOLE CARDS ***
Dealt to Duke Croix [Td Kd]
Duke Croix: raises 300 to 400
color_singleton: calls 400
Klemtonius: calls 400
HighCardJasper: calls 350
dddocky: folds 
*** FLOP *** [9h 9d Js]
HighCardJasper: checks 
Duke Croix: checks 
color_singleton: checks 
Klemtonius: checks 
*** TURN *** [9h 9d Js] [3c]
HighCardJasper: checks 
Duke Croix: checks 
color_singleton: checks 
Klemtonius: checks 
*** RIVER *** [9h 9d Js 3c] [8s]
HighCardJasper: checks 
Duke Croix: checks 
color_singleton: checks 
Klemtonius: checks 
*** SHOW DOWN ***
HighCardJasper: shows [Ks 6s] (a pair of Nines)
Duke Croix: shows [Td Kd] (a pair of Nines - King+Jack+Ten kicker)
color_singleton: shows [Kc 8d] (two pair, Nines and Eights)
Klemtonius: mucks hand 
color_singleton collected 1606 from pot
*** SUMMARY ***
Total pot 1700 | Rake 94 
Board [9h 9d Js 3c 8s]
Seat 1: dddocky (big blind) folded before Flop
Seat 2: Duke Croix showed [Td Kd] and lost with a pair of Nines
Seat 3: color_singleton showed [Kc 8d] and won (1606) with two pair, Nines and Eights
Seat 5: Klemtonius (button) mucked [5c Qc]
Seat 9: HighCardJasper (small blind) showed [Ks 6s] and lost with a pair of Nines



PokerStars Home Game Hand #218543401924: {Club #3225207}  Hold'em No Limit (50/100) - 2020/09/17 18:08:12 ET
Table 'fun time' 9-max (Play Money) Seat #9 is the button
Seat 1: dddocky (3268 in chips) 
Seat 2: Duke Croix (12231 in chips) 
Seat 3: color_singleton (16266 in chips) 
Seat 5: Klemtonius (48486 in chips) 
Seat 9: HighCardJasper (27386 in chips) 
dddocky: posts small blind 50
Duke Croix: posts big blind 100
*** HOLE CARDS ***
Dealt to Duke Croix [8h 6s]
color_singleton: raises 100 to 200
Klemtonius: raises 200 to 400
HighCardJasper: calls 400
dddocky: calls 350
Duke Croix: folds 
color_singleton: calls 200
*** FLOP *** [Jd Qs 8s]
dddocky: checks 
color_singleton: checks 
Klemtonius: bets 803
HighCardJasper: folds 
dddocky: folds 
color_singleton: calls 803
*** TURN *** [Jd Qs 8s] [6c]
color_singleton: checks 
Klemtonius: bets 3124
color_singleton: folds 
Uncalled bet (3124) returned to Klemtonius
Klemtonius collected 3124 from pot
Klemtonius: doesn't show hand 
*** SUMMARY ***
Total pot 3306 | Rake 182 
Board [Jd Qs 8s 6c]
Seat 1: dddocky (small blind) folded on the Flop
Seat 2: Duke Croix (big blind) folded before Flop
Seat 3: color_singleton folded on the Turn
Seat 5: Klemtonius collected (3124)
Seat 9: HighCardJasper (button) folded on the Flop



PokerStars Home Game Hand #218543423036: {Club #3225207}  Hold'em No Limit (50/100) - 2020/09/17 18:08:54 ET
Table 'fun time' 9-max (Play Money) Seat #1 is the button
Seat 1: dddocky (2868 in chips) 
Seat 2: Duke Croix (12131 in chips) 
Seat 3: color_singleton (15063 in chips) 
Seat 5: Klemtonius (50407 in chips) 
Seat 9: HighCardJasper (26986 in chips) 
Duke Croix: posts small blind 50
color_singleton: posts big blind 100
*** HOLE CARDS ***
Dealt to Duke Croix [Ts Ac]
Klemtonius: calls 100
HighCardJasper: calls 100
dddocky: calls 100
Duke Croix: raises 300 to 400
color_singleton: calls 300
Klemtonius: calls 300
HighCardJasper: folds 
dddocky: folds 
*** FLOP *** [6c 2d 6s]
Duke Croix: checks 
color_singleton: bets 661
Klemtonius: folds 
Duke Croix: folds 
Uncalled bet (661) returned to color_singleton
color_singleton collected 1323 from pot
color_singleton: doesn't show hand 
*** SUMMARY ***
Total pot 1400 | Rake 77 
Board [6c 2d 6s]
Seat 1: dddocky (button) folded before Flop
Seat 2: Duke Croix (small blind) folded on the Flop
Seat 3: color_singleton (big blind) collected (1323)
Seat 5: Klemtonius folded on the Flop
Seat 9: HighCardJasper folded before Flop



PokerStars Home Game Hand #218543436760: {Club #3225207}  Hold'em No Limit (50/100) - 2020/09/17 18:09:22 ET
Table 'fun time' 9-max (Play Money) Seat #2 is the button
Seat 1: dddocky (2768 in chips) 
Seat 2: Duke Croix (11731 in chips) 
Seat 3: color_singleton (15986 in chips) 
Seat 5: Klemtonius (50007 in chips) 
Seat 9: HighCardJasper (26886 in chips) 
color_singleton: posts small blind 50
Klemtonius: posts big blind 100
*** HOLE CARDS ***
Dealt to Duke Croix [4c 7d]
HighCardJasper: calls 100
dddocky: calls 100
Duke Croix: folds 
color_singleton: calls 50
Klemtonius: checks 
*** FLOP *** [7c 8c 3h]
color_singleton: checks 
Klemtonius: checks 
HighCardJasper: bets 400
dddocky: folds 
color_singleton: calls 400
Klemtonius: folds 
*** TURN *** [7c 8c 3h] [2h]
color_singleton: checks 
HighCardJasper: checks 
*** RIVER *** [7c 8c 3h 2h] [Qh]
color_singleton: bets 567
HighCardJasper: folds 
Uncalled bet (567) returned to color_singleton
color_singleton collected 1134 from pot
color_singleton: doesn't show hand 
*** SUMMARY ***
Total pot 1200 | Rake 66 
Board [7c 8c 3h 2h Qh]
Seat 1: dddocky folded on the Flop
Seat 2: Duke Croix (button) folded before Flop (didn't bet)
Seat 3: color_singleton (small blind) collected (1134)
Seat 5: Klemtonius (big blind) folded on the Flop
Seat 9: HighCardJasper folded on the River



PokerStars Home Game Hand #218543455755: {Club #3225207}  Hold'em No Limit (50/100) - 2020/09/17 18:10:00 ET
Table 'fun time' 9-max (Play Money) Seat #3 is the button
Seat 1: dddocky (2668 in chips) 
Seat 2: Duke Croix (11731 in chips) 
Seat 3: color_singleton (16620 in chips) 
Seat 5: Klemtonius (49907 in chips) 
Seat 9: HighCardJasper (26386 in chips) 
Klemtonius: posts small blind 50
HighCardJasper: posts big blind 100
*** HOLE CARDS ***
Dealt to Duke Croix [Kc Td]
dddocky: calls 100
Duke Croix: raises 300 to 400
color_singleton: calls 400
Klemtonius: raises 599 to 999
HighCardJasper: calls 899
dddocky: folds 
Duke Croix: calls 599
color_singleton: calls 599
*** FLOP *** [3s Jd 2s]
Klemtonius: checks 
HighCardJasper: checks 
Duke Croix: checks 
color_singleton: checks 
*** TURN *** [3s Jd 2s] [Tc]
Klemtonius: checks 
HighCardJasper: checks 
Duke Croix: checks 
color_singleton: checks 
*** RIVER *** [3s Jd 2s Tc] [6h]
Klemtonius: bets 1935
HighCardJasper: folds 
Duke Croix: calls 1935
color_singleton: folds 
*** SHOW DOWN ***
Klemtonius: shows [9h 9c] (a pair of Nines)
Duke Croix: shows [Kc Td] (a pair of Tens)
Duke Croix collected 7528 from pot
*** SUMMARY ***
Total pot 7966 | Rake 438 
Board [3s Jd 2s Tc 6h]
Seat 1: dddocky folded before Flop
Seat 2: Duke Croix showed [Kc Td] and won (7528) with a pair of Tens
Seat 3: color_singleton (button) folded on the River
Seat 5: Klemtonius (small blind) showed [9h 9c] and lost with a pair of Nines
Seat 9: HighCardJasper (big blind) folded on the River



PokerStars Home Game Hand #218543489618: {Club #3225207}  Hold'em No Limit (50/100) - 2020/09/17 18:11:09 ET
Table 'fun time' 9-max (Play Money) Seat #5 is the button
Seat 1: dddocky (2568 in chips) 
Seat 2: Duke Croix (16325 in chips) 
Seat 3: color_singleton (15621 in chips) 
Seat 5: Klemtonius (46973 in chips) 
Seat 9: HighCardJasper (25387 in chips) 
HighCardJasper: posts small blind 50
dddocky: posts big blind 100
*** HOLE CARDS ***
Dealt to Duke Croix [Th Ks]
Duke Croix: raises 300 to 400
color_singleton: folds 
Klemtonius: folds 
HighCardJasper: calls 350
dddocky: calls 300
*** FLOP *** [5c 3s 9d]
HighCardJasper: checks 
dddocky: bets 567
Duke Croix: calls 567
HighCardJasper: folds 
*** TURN *** [5c 3s 9d] [9s]
dddocky: bets 1601 and is all-in
Duke Croix: folds 
Uncalled bet (1601) returned to dddocky
dddocky collected 2206 from pot
dddocky: doesn't show hand 
*** SUMMARY ***
Total pot 2334 | Rake 128 
Board [5c 3s 9d 9s]
Seat 1: dddocky (big blind) collected (2206)
Seat 2: Duke Croix folded on the Turn
Seat 3: color_singleton folded before Flop (didn't bet)
Seat 5: Klemtonius (button) folded before Flop (didn't bet)
Seat 9: HighCardJasper (small blind) folded on the Flop



PokerStars Home Game Hand #218543511126: {Club #3225207}  Hold'em No Limit (50/100) - 2020/09/17 18:11:52 ET
Table 'fun time' 9-max (Play Money) Seat #9 is the button
Seat 1: dddocky (3807 in chips) 
Seat 2: Duke Croix (15358 in chips) 
Seat 3: color_singleton (15621 in chips) 
Seat 5: Klemtonius (46973 in chips) 
Seat 9: HighCardJasper (24987 in chips) 
dddocky: posts small blind 50
Duke Croix: posts big blind 100
*** HOLE CARDS ***
Dealt to Duke Croix [7s 4c]
color_singleton: raises 200 to 300
Klemtonius: calls 300
HighCardJasper: folds 
dddocky: calls 250
Duke Croix: folds 
*** FLOP *** [8h Jh Ts]
dddocky: bets 945
color_singleton: calls 945
Klemtonius: folds 
*** TURN *** [8h Jh Ts] [9d]
dddocky: bets 100
color_singleton: calls 100
*** RIVER *** [8h Jh Ts 9d] [5c]
dddocky: bets 100
color_singleton: calls 100
*** SHOW DOWN ***
dddocky: shows [5s Js] (two pair, Jacks and Fives)
color_singleton: mucks hand 
dddocky collected 3109 from pot
*** SUMMARY ***
Total pot 3290 | Rake 181 
Board [8h Jh Ts 9d 5c]
Seat 1: dddocky (small blind) showed [5s Js] and won (3109) with two pair, Jacks and Fives
Seat 2: Duke Croix (big blind) folded before Flop
Seat 3: color_singleton mucked [9h Ac]
Seat 5: Klemtonius folded on the Flop
Seat 9: HighCardJasper (button) folded before Flop (didn't bet)



PokerStars Home Game Hand #218543545718: {Club #3225207}  Hold'em No Limit (50/100) - 2020/09/17 18:13:03 ET
Table 'fun time' 9-max (Play Money) Seat #1 is the button
Seat 1: dddocky (5471 in chips) 
Seat 2: Duke Croix (15258 in chips) 
Seat 3: color_singleton (14176 in chips) 
Seat 5: Klemtonius (46673 in chips) 
Seat 9: HighCardJasper (24987 in chips) 
Duke Croix: posts small blind 50
color_singleton: posts big blind 100
*** HOLE CARDS ***
Dealt to Duke Croix [Qc 8s]
Klemtonius: calls 100
HighCardJasper: calls 100
dddocky: folds 
Duke Croix: calls 50
color_singleton: checks 
*** FLOP *** [3d 7c Js]
Duke Croix: checks 
color_singleton: checks 
Klemtonius: checks 
HighCardJasper: checks 
*** TURN *** [3d 7c Js] [4c]
Duke Croix: checks 
color_singleton: checks 
Klemtonius: checks 
HighCardJasper: bets 300
Duke Croix: folds 
color_singleton: folds 
Klemtonius: calls 300
*** RIVER *** [3d 7c Js 4c] [8h]
Klemtonius: checks 
HighCardJasper: bets 600
Klemtonius: folds 
Uncalled bet (600) returned to HighCardJasper
HighCardJasper collected 945 from pot
HighCardJasper: doesn't show hand 
*** SUMMARY ***
Total pot 1000 | Rake 55 
Board [3d 7c Js 4c 8h]
Seat 1: dddocky (button) folded before Flop (didn't bet)
Seat 2: Duke Croix (small blind) folded on the Turn
Seat 3: color_singleton (big blind) folded on the Turn
Seat 5: Klemtonius folded on the River
Seat 9: HighCardJasper collected (945)



PokerStars Home Game Hand #218543584551: {Club #3225207}  Hold'em No Limit (50/100) - 2020/09/17 18:14:10 ET
Table 'fun time' 9-max (Play Money) Seat #2 is the button
Seat 1: dddocky (5471 in chips) 
Seat 2: Duke Croix (15158 in chips) 
Seat 3: color_singleton (14076 in chips) 
Seat 5: Klemtonius (46273 in chips) 
Seat 9: HighCardJasper (25532 in chips) 
color_singleton: posts small blind 50
Klemtonius: posts big blind 100
*** HOLE CARDS ***
Dealt to Duke Croix [6h Ah]
HighCardJasper: calls 100
dddocky: calls 100
Duke Croix: raises 400 to 500
color_singleton: folds 
Klemtonius: folds 
HighCardJasper: folds 
dddocky: calls 400
*** FLOP *** [2h 6d Kh]
dddocky: checks 
Duke Croix: bets 600
dddocky: folds 
Uncalled bet (600) returned to Duke Croix
Duke Croix collected 1181 from pot
*** SUMMARY ***
Total pot 1250 | Rake 69 
Board [2h 6d Kh]
Seat 1: dddocky folded on the Flop
Seat 2: Duke Croix (button) collected (1181)
Seat 3: color_singleton (small blind) folded before Flop
Seat 5: Klemtonius (big blind) folded before Flop
Seat 9: HighCardJasper folded before Flop



PokerStars Home Game Hand #218543603486: {Club #3225207}  Hold'em No Limit (50/100) - 2020/09/17 18:14:41 ET
Table 'fun time' 9-max (Play Money) Seat #3 is the button
Seat 1: dddocky (4971 in chips) 
Seat 2: Duke Croix (15839 in chips) 
Seat 3: color_singleton (14026 in chips) 
Seat 5: Klemtonius (46173 in chips) 
Seat 9: HighCardJasper (25432 in chips) 
Klemtonius: posts small blind 50
HighCardJasper: posts big blind 100
*** HOLE CARDS ***
Dealt to Duke Croix [6c Jd]
dddocky: folds 
Duke Croix: folds 
color_singleton: raises 100 to 200
Klemtonius: calls 150
HighCardJasper: calls 100
*** FLOP *** [4d Js 7d]
Klemtonius: checks 
HighCardJasper: checks 
color_singleton: bets 300
Klemtonius: folds 
HighCardJasper: calls 300
*** TURN *** [4d Js 7d] [7c]
HighCardJasper: checks 
color_singleton: bets 567
HighCardJasper: folds 
Uncalled bet (567) returned to color_singleton
color_singleton collected 1134 from pot
color_singleton: doesn't show hand 
*** SUMMARY ***
Total pot 1200 | Rake 66 
Board [4d Js 7d 7c]
Seat 1: dddocky folded before Flop (didn't bet)
Seat 2: Duke Croix folded before Flop (didn't bet)
Seat 3: color_singleton (button) collected (1134)
Seat 5: Klemtonius (small blind) folded on the Flop
Seat 9: HighCardJasper (big blind) folded on the Turn



PokerStars Home Game Hand #218543625273: {Club #3225207}  Hold'em No Limit (50/100) - 2020/09/17 18:15:26 ET
Table 'fun time' 9-max (Play Money) Seat #5 is the button
Seat 1: dddocky (4971 in chips) 
Seat 2: Duke Croix (15839 in chips) 
Seat 3: color_singleton (14660 in chips) 
Seat 5: Klemtonius (45973 in chips) 
Seat 9: HighCardJasper (24932 in chips) 
HighCardJasper: posts small blind 50
dddocky: posts big blind 100
*** HOLE CARDS ***
Dealt to Duke Croix [Qc 6s]
Duke Croix: folds 
color_singleton: folds 
Klemtonius: raises 233 to 333
HighCardJasper: calls 283
dddocky: folds 
*** FLOP *** [8d 8c 2c]
HighCardJasper: checks 
Klemtonius: checks 
*** TURN *** [8d 8c 2c] [Qh]
HighCardJasper: checks 
Klemtonius: bets 362
HighCardJasper: folds 
Uncalled bet (362) returned to Klemtonius
Klemtonius collected 724 from pot
Klemtonius: doesn't show hand 
*** SUMMARY ***
Total pot 766 | Rake 42 
Board [8d 8c 2c Qh]
Seat 1: dddocky (big blind) folded before Flop
Seat 2: Duke Croix folded before Flop (didn't bet)
Seat 3: color_singleton folded before Flop (didn't bet)
Seat 5: Klemtonius (button) collected (724)
Seat 9: HighCardJasper (small blind) folded on the Turn



PokerStars Home Game Hand #218543644605: {Club #3225207}  Hold'em No Limit (50/100) - 2020/09/17 18:16:06 ET
Table 'fun time' 9-max (Play Money) Seat #9 is the button
Seat 1: dddocky (4871 in chips) 
Seat 2: Duke Croix (15839 in chips) 
Seat 3: color_singleton (14660 in chips) 
Seat 5: Klemtonius (46364 in chips) 
Seat 9: HighCardJasper (24599 in chips) 
dddocky: posts small blind 50
Duke Croix: posts big blind 100
*** HOLE CARDS ***
Dealt to Duke Croix [Qs Ts]
color_singleton: folds 
Klemtonius: raises 250 to 350
HighCardJasper: calls 350
dddocky: folds 
Duke Croix: calls 250
*** FLOP *** [Jh 8s Jd]
Duke Croix: checks 
Klemtonius: checks 
HighCardJasper: checks 
*** TURN *** [Jh 8s Jd] [5h]
Duke Croix: checks 
Klemtonius: checks 
HighCardJasper: checks 
*** RIVER *** [Jh 8s Jd 5h] [5s]
Duke Croix: checks 
Klemtonius: checks 
HighCardJasper: bets 500
Duke Croix has timed out
Duke Croix: folds 
Klemtonius: folds 
Uncalled bet (500) returned to HighCardJasper
HighCardJasper collected 1039 from pot
HighCardJasper: doesn't show hand 
*** SUMMARY ***
Total pot 1100 | Rake 61 
Board [Jh 8s Jd 5h 5s]
Seat 1: dddocky (small blind) folded before Flop
Seat 2: Duke Croix (big blind) folded on the River
Seat 3: color_singleton folded before Flop (didn't bet)
Seat 5: Klemtonius folded on the River
Seat 9: HighCardJasper (button) collected (1039)



PokerStars Home Game Hand #218543688781: {Club #3225207}  Hold'em No Limit (50/100) - 2020/09/17 18:17:38 ET
Table 'fun time' 9-max (Play Money) Seat #1 is the button
Seat 1: dddocky (4821 in chips) 
Seat 2: Duke Croix (15489 in chips) 
Seat 3: color_singleton (14660 in chips) 
Seat 5: Klemtonius (46014 in chips) 
Seat 9: HighCardJasper (25288 in chips) 
Duke Croix: posts small blind 50
color_singleton: posts big blind 100
*** HOLE CARDS ***
Dealt to Duke Croix [2h 9s]
Klemtonius: calls 100
HighCardJasper: calls 100
dddocky: calls 100
Duke Croix: folds 
color_singleton: checks 
*** FLOP *** [5h Ah 6h]
color_singleton: bets 425
Klemtonius: folds 
HighCardJasper: folds 
dddocky: folds 
Uncalled bet (425) returned to color_singleton
color_singleton collected 425 from pot
color_singleton: doesn't show hand 
*** SUMMARY ***
Total pot 450 | Rake 25 
Board [5h Ah 6h]
Seat 1: dddocky (button) folded on the Flop
Seat 2: Duke Croix (small blind) folded before Flop
Seat 3: color_singleton (big blind) collected (425)
Seat 5: Klemtonius folded on the Flop
Seat 9: HighCardJasper folded on the Flop



PokerStars Home Game Hand #218543705267: {Club #3225207}  Hold'em No Limit (50/100) - 2020/09/17 18:18:12 ET
Table 'fun time' 9-max (Play Money) Seat #2 is the button
Seat 1: dddocky (4721 in chips) 
Seat 2: Duke Croix (15439 in chips) 
Seat 3: color_singleton (14985 in chips) 
Seat 5: Klemtonius (45914 in chips) 
Seat 9: HighCardJasper (25188 in chips) 
color_singleton: posts small blind 50
Klemtonius: posts big blind 100
*** HOLE CARDS ***
Dealt to Duke Croix [6h 3s]
HighCardJasper: raises 100 to 200
dddocky: folds 
Duke Croix: folds 
color_singleton: folds 
Klemtonius: calls 100
*** FLOP *** [8c 7s 4c]
Klemtonius: checks 
HighCardJasper: bets 200
Klemtonius: calls 200
*** TURN *** [8c 7s 4c] [Jd]
Klemtonius: bets 803
HighCardJasper: calls 803
*** RIVER *** [8c 7s 4c Jd] [8h]
Klemtonius: checks 
HighCardJasper: bets 1000
Klemtonius: calls 1000
*** SHOW DOWN ***
HighCardJasper: shows [Tc 9c] (a straight, Seven to Jack)
Klemtonius: mucks hand 
HighCardJasper collected 4211 from pot
*** SUMMARY ***
Total pot 4456 | Rake 245 
Board [8c 7s 4c Jd 8h]
Seat 1: dddocky folded before Flop (didn't bet)
Seat 2: Duke Croix (button) folded before Flop (didn't bet)
Seat 3: color_singleton (small blind) folded before Flop
Seat 5: Klemtonius (big blind) mucked [Js 2s]
Seat 9: HighCardJasper showed [Tc 9c] and won (4211) with a straight, Seven to Jack



PokerStars Home Game Hand #218543725460: {Club #3225207}  Hold'em No Limit (50/100) - 2020/09/17 18:18:55 ET
Table 'fun time' 9-max (Play Money) Seat #3 is the button
Seat 1: dddocky (4721 in chips) 
Seat 2: Duke Croix (15439 in chips) 
Seat 3: color_singleton (14935 in chips) 
Seat 5: Klemtonius (43711 in chips) 
Seat 9: HighCardJasper (27196 in chips) 
Klemtonius: posts small blind 50
HighCardJasper: posts big blind 100
*** HOLE CARDS ***
Dealt to Duke Croix [Jh Ks]
dddocky: folds 
Duke Croix: raises 300 to 400
color_singleton: calls 400
Klemtonius: calls 350
HighCardJasper: folds 
*** FLOP *** [5s 5h 8d]
Klemtonius: checks 
Duke Croix: checks 
color_singleton: checks 
*** TURN *** [5s 5h 8d] [Qc]
Klemtonius: checks 
Duke Croix: checks 
color_singleton: checks 
*** RIVER *** [5s 5h 8d Qc] [6c]
Klemtonius: checks 
Duke Croix: checks 
color_singleton: checks 
*** SHOW DOWN ***
Klemtonius: shows [4c Kd] (a pair of Fives)
Duke Croix: shows [Jh Ks] (a pair of Fives - King+Queen+Jack kicker)
color_singleton: shows [Ad Jc] (a pair of Fives - Ace kicker)
color_singleton collected 1228 from pot
*** SUMMARY ***
Total pot 1300 | Rake 72 
Board [5s 5h 8d Qc 6c]
Seat 1: dddocky folded before Flop (didn't bet)
Seat 2: Duke Croix showed [Jh Ks] and lost with a pair of Fives
Seat 3: color_singleton (button) showed [Ad Jc] and won (1228) with a pair of Fives
Seat 5: Klemtonius (small blind) showed [4c Kd] and lost with a pair of Fives
Seat 9: HighCardJasper (big blind) folded before Flop



PokerStars Home Game Hand #218543739820: {Club #3225207}  Hold'em No Limit (50/100) - 2020/09/17 18:19:26 ET
Table 'fun time' 9-max (Play Money) Seat #5 is the button
Seat 1: dddocky (4721 in chips) 
Seat 2: Duke Croix (15039 in chips) 
Seat 3: color_singleton (15763 in chips) 
Seat 5: Klemtonius (43311 in chips) 
Seat 9: HighCardJasper (27096 in chips) 
HighCardJasper: posts small blind 50
dddocky: posts big blind 100
*** HOLE CARDS ***
Dealt to Duke Croix [4d Td]
Duke Croix: folds 
color_singleton: raises 100 to 200
Klemtonius: calls 200
HighCardJasper: calls 150
dddocky: folds 
*** FLOP *** [4h Th 9c]
HighCardJasper: bets 200
color_singleton: folds 
Klemtonius: calls 200
*** TURN *** [4h Th 9c] [6h]
HighCardJasper: bets 400
Klemtonius: calls 400
*** RIVER *** [4h Th 9c 6h] [Jc]
HighCardJasper: checks 
Klemtonius: bets 1795
HighCardJasper: calls 1795
*** SHOW DOWN ***
Klemtonius: shows [Ah Qd] (high card Ace)
HighCardJasper: shows [9s 6d] (two pair, Nines and Sixes)
HighCardJasper collected 5188 from pot
*** SUMMARY ***
Total pot 5490 | Rake 302 
Board [4h Th 9c 6h Jc]
Seat 1: dddocky (big blind) folded before Flop
Seat 2: Duke Croix folded before Flop (didn't bet)
Seat 3: color_singleton folded on the Flop
Seat 5: Klemtonius (button) showed [Ah Qd] and lost with high card Ace
Seat 9: HighCardJasper (small blind) showed [9s 6d] and won (5188) with two pair, Nines and Sixes



PokerStars Home Game Hand #218543765191: {Club #3225207}  Hold'em No Limit (50/100) - 2020/09/17 18:20:20 ET
Table 'fun time' 9-max (Play Money) Seat #9 is the button
Seat 1: dddocky (4621 in chips) 
Seat 2: Duke Croix (15039 in chips) 
Seat 3: color_singleton (15563 in chips) 
Seat 5: Klemtonius (40716 in chips) 
Seat 9: HighCardJasper (29689 in chips) 
dddocky: posts small blind 50
Duke Croix: posts big blind 100
*** HOLE CARDS ***
Dealt to Duke Croix [6s 5h]
color_singleton: folds 
Klemtonius: calls 100
HighCardJasper: calls 100
dddocky: calls 50
Duke Croix has timed out
Duke Croix: checks 
*** FLOP *** [As 6h 7h]
dddocky: checks 
Duke Croix has timed out
Duke Croix: checks 
Klemtonius: bets 100
HighCardJasper: calls 100
dddocky: folds 
Duke Croix: calls 100
*** TURN *** [As 6h 7h] [4d]
Duke Croix: bets 400
Klemtonius: folds 
HighCardJasper: folds 
Uncalled bet (400) returned to Duke Croix
Duke Croix collected 661 from pot
*** SUMMARY ***
Total pot 700 | Rake 39 
Board [As 6h 7h 4d]
Seat 1: dddocky (small blind) folded on the Flop
Seat 2: Duke Croix (big blind) collected (661)
Seat 3: color_singleton folded before Flop (didn't bet)
Seat 5: Klemtonius folded on the Turn
Seat 9: HighCardJasper (button) folded on the Turn



PokerStars Home Game Hand #218543803547: {Club #3225207}  Hold'em No Limit (50/100) - 2020/09/17 18:21:41 ET
Table 'fun time' 9-max (Play Money) Seat #1 is the button
Seat 1: dddocky (4521 in chips) 
Seat 2: Duke Croix (15500 in chips) 
Seat 3: color_singleton (15563 in chips) 
Seat 5: Klemtonius (40516 in chips) 
Seat 9: HighCardJasper (29489 in chips) 
Duke Croix: posts small blind 50
color_singleton: posts big blind 100
*** HOLE CARDS ***
Dealt to Duke Croix [8c Ts]
Klemtonius: raises 500 to 600
HighCardJasper: folds 
dddocky: folds 
Duke Croix: folds 
color_singleton: calls 500
*** FLOP *** [9s Qc Kd]
color_singleton: checks 
Klemtonius: bets 590
color_singleton: raises 590 to 1180
Klemtonius: calls 590
*** TURN *** [9s Qc Kd] [3d]
color_singleton: bets 3411
Klemtonius: folds 
Uncalled bet (3411) returned to color_singleton
color_singleton collected 3411 from pot
color_singleton: doesn't show hand 
*** SUMMARY ***
Total pot 3610 | Rake 199 
Board [9s Qc Kd 3d]
Seat 1: dddocky (button) folded before Flop (didn't bet)
Seat 2: Duke Croix (small blind) folded before Flop
Seat 3: color_singleton (big blind) collected (3411)
Seat 5: Klemtonius folded on the Turn
Seat 9: HighCardJasper folded before Flop (didn't bet)



PokerStars Home Game Hand #218543826254: {Club #3225207}  Hold'em No Limit (50/100) - 2020/09/17 18:22:29 ET
Table 'fun time' 9-max (Play Money) Seat #2 is the button
Seat 1: dddocky (4521 in chips) 
Seat 2: Duke Croix (15450 in chips) 
Seat 3: color_singleton (17194 in chips) 
Seat 5: Klemtonius (38736 in chips) 
Seat 9: HighCardJasper (29489 in chips) 
color_singleton: posts small blind 50
Klemtonius: posts big blind 100
*** HOLE CARDS ***
Dealt to Duke Croix [Jh 9h]
HighCardJasper: raises 200 to 300
dddocky: calls 300
Duke Croix: calls 300
color_singleton: calls 250
Klemtonius: calls 200
*** FLOP *** [6c 6s 9c]
color_singleton: checks 
Klemtonius: checks 
HighCardJasper: bets 300
dddocky: calls 300
Duke Croix: raises 9300 to 9600
color_singleton: calls 9600
Klemtonius: folds 
HighCardJasper: calls 9300
dddocky: folds 
*** TURN *** [6c 6s 9c] [Qs]
color_singleton: checks 
HighCardJasper: checks 
Duke Croix: checks 
*** RIVER *** [6c 6s 9c Qs] [6h]
color_singleton: bets 7294 and is all-in
HighCardJasper: calls 7294
Duke Croix: calls 5550 and is all-in
*** SHOW DOWN ***
color_singleton: shows [8s 6d] (four of a kind, Sixes)
HighCardJasper: shows [Ks Kc] (a full house, Sixes full of Kings)
color_singleton collected 3296 from side pot
Duke Croix: shows [Jh 9h] (a full house, Sixes full of Nines)
color_singleton collected 44651 from main pot
*** SUMMARY ***
Total pot 50738 Main pot 44651. Side pot 3296. | Rake 2791 
Board [6c 6s 9c Qs 6h]
Seat 1: dddocky folded on the Flop
Seat 2: Duke Croix (button) showed [Jh 9h] and lost with a full house, Sixes full of Nines
Seat 3: color_singleton (small blind) showed [8s 6d] and won (47947) with four of a kind, Sixes
Seat 5: Klemtonius (big blind) folded on the Flop
Seat 9: HighCardJasper showed [Ks Kc] and lost with a full house, Sixes full of Kings



