PokerStars Home Game Hand #218083188115: {Club #3225207}  Hold'em No Limit (50/100) - 2020/09/03 14:45:47 ET
Table 'fun gamez' 9-max (Play Money) Seat #8 is the button
Seat 1: dddocky (10000 in chips) 
Seat 2: FragileMemory (10000 in chips) 
Seat 3: Duke Croix (10000 in chips) 
Seat 8: JeBoyDirk (10000 in chips) 
dddocky: posts small blind 50
FragileMemory: posts big blind 100
*** HOLE CARDS ***
Dealt to Duke Croix [2d 5h]
Duke Croix: folds 
JeBoyDirk: calls 100
dddocky: calls 50
FragileMemory: checks 
*** FLOP *** [Jh 3d Ad]
dddocky: bets 100
FragileMemory said, "Can someone share the zoom-mail"
FragileMemory: folds 
JeBoyDirk: calls 100
*** TURN *** [Jh 3d Ad] [Qs]
dddocky: checks 
yairpinto joins the table at seat #4 
JeBoyDirk: bets 300
dddocky: calls 300
*** RIVER *** [Jh 3d Ad Qs] [6c]
dddocky: bets 500
JeBoyDirk: raises 500 to 1000
dddocky: raises 500 to 1500
JeBoyDirk: calls 500
*** SHOW DOWN ***
dddocky: shows [Jd 3h] (two pair, Jacks and Threes)
JeBoyDirk: shows [6s Ah] (two pair, Aces and Sixes)
JeBoyDirk collected 3874 from pot
*** SUMMARY ***
Total pot 4100 | Rake 226 
Board [Jh 3d Ad Qs 6c]
Seat 1: dddocky (small blind) showed [Jd 3h] and lost with two pair, Jacks and Threes
Seat 2: FragileMemory (big blind) folded on the Flop
Seat 3: Duke Croix folded before Flop (didn't bet)
Seat 8: JeBoyDirk (button) showed [6s Ah] and won (3874) with two pair, Aces and Sixes



PokerStars Home Game Hand #218083220236: {Club #3225207}  Hold'em No Limit (50/100) - 2020/09/03 14:46:41 ET
Table 'fun gamez' 9-max (Play Money) Seat #1 is the button
Seat 1: dddocky (8000 in chips) 
Seat 2: FragileMemory (9900 in chips) 
Seat 3: Duke Croix (10000 in chips) 
Seat 4: yairpinto (10000 in chips) 
Seat 8: JeBoyDirk (11874 in chips) 
Seat 9: Manon541 (10000 in chips) 
FragileMemory: posts small blind 50
Duke Croix: posts big blind 100
yairpinto: posts big blind 100
Manon541: posts big blind 100
*** HOLE CARDS ***
Dealt to Duke Croix [Tc Qd]
yairpinto: checks 
JeBoyDirk: calls 100
Manon541: checks 
dddocky: calls 100
FragileMemory: calls 50
Duke Croix: checks 
*** FLOP *** [3c 5s 2h]
FragileMemory: checks 
Duke Croix: checks 
color_singleton joins the table at seat #6 
yairpinto: checks 
JeBoyDirk: checks 
Manon541: checks 
dddocky: checks 
*** TURN *** [3c 5s 2h] [5c]
FragileMemory said, "Zoom-link, please?"
FragileMemory: checks 
Duke Croix: checks 
yairpinto has timed out
yairpinto: checks 
JeBoyDirk: checks 
Manon541: checks 
dddocky: checks 
*** RIVER *** [3c 5s 2h 5c] [7s]
FragileMemory: checks 
Duke Croix has timed out
Duke Croix: checks 
yairpinto: bets 283
JeBoyDirk: folds 
Manon541: folds 
dddocky: calls 283
FragileMemory: folds 
Duke Croix: folds 
*** SHOW DOWN ***
yairpinto: shows [Td Jc] (a pair of Fives)
dddocky: shows [As 3h] (two pair, Fives and Threes)
dddocky collected 1102 from pot
*** SUMMARY ***
Total pot 1166 | Rake 64 
Board [3c 5s 2h 5c 7s]
Seat 1: dddocky (button) showed [As 3h] and won (1102) with two pair, Fives and Threes
Seat 2: FragileMemory (small blind) folded on the River
Seat 3: Duke Croix (big blind) folded on the River
Seat 4: yairpinto showed [Td Jc] and lost with a pair of Fives
Seat 8: JeBoyDirk folded on the River
Seat 9: Manon541 folded on the River (didn't bet)



PokerStars Home Game Hand #218083283116: {Club #3225207}  Hold'em No Limit (50/100) - 2020/09/03 14:48:27 ET
Table 'fun gamez' 9-max (Play Money) Seat #2 is the button
Seat 1: dddocky (8719 in chips) 
Seat 2: FragileMemory (9800 in chips) 
Seat 3: Duke Croix (9900 in chips) 
Seat 4: yairpinto (9617 in chips) 
Seat 6: color_singleton (10000 in chips) 
Seat 8: JeBoyDirk (11774 in chips) 
Seat 9: Manon541 (9900 in chips) 
Duke Croix: posts small blind 50
yairpinto: posts big blind 100
color_singleton: posts big blind 100
*** HOLE CARDS ***
Dealt to Duke Croix [3c 4c]
color_singleton: checks 
JeBoyDirk: folds 
Manon541: calls 100
dddocky: folds 
FragileMemory: calls 100
Duke Croix: calls 50
yairpinto: checks 
*** FLOP *** [5h Kh 5c]
Duke Croix: checks 
yairpinto: checks 
color_singleton has timed out
color_singleton: checks 
Manon541: checks 
FragileMemory: bets 236
Duke Croix: folds 
yairpinto: calls 236
color_singleton: folds 
Manon541: calls 236
*** TURN *** [5h Kh 5c] [Ac]
yairpinto: checks 
Manon541: checks 
FragileMemory: bets 571
yairpinto: calls 571
Manon541: folds 
*** RIVER *** [5h Kh 5c Ac] [Ad]
yairpinto: checks 
FragileMemory: bets 1110
yairpinto: calls 1110
*** SHOW DOWN ***
FragileMemory: shows [Kd 8d] (two pair, Aces and Kings)
yairpinto: shows [5s Ks] (a full house, Fives full of Aces)
yairpinto collected 4319 from pot
*** SUMMARY ***
Total pot 4570 | Rake 251 
Board [5h Kh 5c Ac Ad]
Seat 1: dddocky folded before Flop (didn't bet)
Seat 2: FragileMemory (button) showed [Kd 8d] and lost with two pair, Aces and Kings
Seat 3: Duke Croix (small blind) folded on the Flop
Seat 4: yairpinto (big blind) showed [5s Ks] and won (4319) with a full house, Fives full of Aces
Seat 6: color_singleton folded on the Flop (didn't bet)
Seat 8: JeBoyDirk folded before Flop (didn't bet)
Seat 9: Manon541 folded on the Turn



PokerStars Home Game Hand #218083342438: {Club #3225207}  Hold'em No Limit (50/100) - 2020/09/03 14:50:05 ET
Table 'fun gamez' 9-max (Play Money) Seat #3 is the button
Seat 1: dddocky (8719 in chips) 
Seat 2: FragileMemory (7783 in chips) 
Seat 3: Duke Croix (9800 in chips) 
Seat 4: yairpinto (11919 in chips) 
Seat 6: color_singleton (9900 in chips) 
Seat 8: JeBoyDirk (11774 in chips) 
Seat 9: Manon541 (9564 in chips) 
yairpinto: posts small blind 50
color_singleton: posts big blind 100
*** HOLE CARDS ***
Dealt to Duke Croix [3c 4c]
JeBoyDirk: calls 100
FragileMemory said, "Wow"
Manon541: calls 100
dddocky: folds 
FragileMemory: folds 
Duke Croix: calls 100
yairpinto said, "yes, flopped it"
yairpinto: calls 50
color_singleton: checks 
*** FLOP *** [Ts 6c 6h]
yairpinto said, "but the two aces kind of killed it"
yairpinto: checks 
color_singleton: checks 
JeBoyDirk: checks 
Manon541: bets 236
yairpinto said, "get on the zoom Ilja!"
Duke Croix: folds 
yairpinto: folds 
FragileMemory said, "Send link"
color_singleton: calls 236
JeBoyDirk: folds 
*** TURN *** [Ts 6c 6h] [Kc]
color_singleton: checks 
FragileMemory said, "Or forward email"
Manon541: bets 459
color_singleton: raises 459 to 918
Manon541: calls 459
*** RIVER *** [Ts 6c 6h Kc] [Ac]
color_singleton: checks 
Manon541: bets 2654
color_singleton: calls 2654
*** SHOW DOWN ***
Manon541: shows [Th Ks] (two pair, Kings and Tens)
color_singleton: shows [5d 6s] (three of a kind, Sixes)
color_singleton collected 7670 from pot
*** SUMMARY ***
Total pot 8116 | Rake 446 
Board [Ts 6c 6h Kc Ac]
Seat 1: dddocky folded before Flop (didn't bet)
Seat 2: FragileMemory folded before Flop (didn't bet)
Seat 3: Duke Croix (button) folded on the Flop
Seat 4: yairpinto (small blind) folded on the Flop
Seat 6: color_singleton (big blind) showed [5d 6s] and won (7670) with three of a kind, Sixes
Seat 8: JeBoyDirk folded on the Flop
Seat 9: Manon541 showed [Th Ks] and lost with two pair, Kings and Tens



PokerStars Home Game Hand #218083384250: {Club #3225207}  Hold'em No Limit (50/100) - 2020/09/03 14:51:16 ET
Table 'fun gamez' 9-max (Play Money) Seat #4 is the button
Seat 1: dddocky (8719 in chips) 
Seat 2: FragileMemory (7783 in chips) 
Seat 3: Duke Croix (9700 in chips) 
Seat 4: yairpinto (11819 in chips) 
Seat 6: color_singleton (13662 in chips) 
Seat 8: JeBoyDirk (11674 in chips) 
Seat 9: Manon541 (5656 in chips) 
color_singleton: posts small blind 50
JeBoyDirk: posts big blind 100
*** HOLE CARDS ***
Dealt to Duke Croix [Jc 6s]
Manon541: folds 
dddocky: calls 100
FragileMemory: folds 
Duke Croix: folds 
yairpinto: calls 100
color_singleton: calls 50
JeBoyDirk: checks 
*** FLOP *** [9d Qs 7h]
color_singleton: checks 
JeBoyDirk: checks 
dddocky: checks 
yairpinto: checks 
*** TURN *** [9d Qs 7h] [3s]
color_singleton: checks 
JeBoyDirk: bets 200
dddocky: folds 
yairpinto: folds 
color_singleton: folds 
Uncalled bet (200) returned to JeBoyDirk
JeBoyDirk collected 378 from pot
*** SUMMARY ***
Total pot 400 | Rake 22 
Board [9d Qs 7h 3s]
Seat 1: dddocky folded on the Turn
Seat 2: FragileMemory folded before Flop (didn't bet)
Seat 3: Duke Croix folded before Flop (didn't bet)
Seat 4: yairpinto (button) folded on the Turn
Seat 6: color_singleton (small blind) folded on the Turn
Seat 8: JeBoyDirk (big blind) collected (378)
Seat 9: Manon541 folded before Flop (didn't bet)



PokerStars Home Game Hand #218083418397: {Club #3225207}  Hold'em No Limit (50/100) - 2020/09/03 14:52:14 ET
Table 'fun gamez' 9-max (Play Money) Seat #6 is the button
Seat 1: dddocky (8619 in chips) 
Seat 2: FragileMemory (7783 in chips) 
Seat 3: Duke Croix (9700 in chips) 
Seat 4: yairpinto (11719 in chips) 
Seat 6: color_singleton (13562 in chips) 
Seat 8: JeBoyDirk (11952 in chips) 
Seat 9: Manon541 (5656 in chips) 
JeBoyDirk: posts small blind 50
Manon541: posts big blind 100
*** HOLE CARDS ***
Dealt to Duke Croix [Ts 2d]
dddocky: calls 100
FragileMemory: calls 100
Duke Croix: folds 
yairpinto: calls 100
color_singleton: calls 100
JeBoyDirk: folds 
Manon541: checks 
*** FLOP *** [Ad 5c Ac]
Manon541: checks 
dddocky: bets 520
FragileMemory: folds 
yairpinto: folds 
color_singleton: folds 
Manon541: folds 
Uncalled bet (520) returned to dddocky
dddocky collected 520 from pot
dddocky: doesn't show hand 
*** SUMMARY ***
Total pot 550 | Rake 30 
Board [Ad 5c Ac]
Seat 1: dddocky collected (520)
Seat 2: FragileMemory folded on the Flop
Seat 3: Duke Croix folded before Flop (didn't bet)
Seat 4: yairpinto folded on the Flop
Seat 6: color_singleton (button) folded on the Flop
Seat 8: JeBoyDirk (small blind) folded before Flop
Seat 9: Manon541 (big blind) folded on the Flop



PokerStars Home Game Hand #218083443443: {Club #3225207}  Hold'em No Limit (50/100) - 2020/09/03 14:52:56 ET
Table 'fun gamez' 9-max (Play Money) Seat #8 is the button
Seat 1: dddocky (9039 in chips) 
Seat 2: FragileMemory (7683 in chips) 
Seat 3: Duke Croix (9700 in chips) 
Seat 4: yairpinto (11619 in chips) 
Seat 6: color_singleton (13462 in chips) 
Seat 8: JeBoyDirk (11902 in chips) 
Seat 9: Manon541 (5556 in chips) 
Manon541: posts small blind 50
dddocky: posts big blind 100
*** HOLE CARDS ***
Dealt to Duke Croix [Js 8s]
FragileMemory: calls 100
Duke Croix: folds 
yairpinto: folds 
FragileMemory said, "Thx"
color_singleton: calls 100
JeBoyDirk: calls 100
FragileMemory said, "Theeuwes"
FragileMemory said, "Let me in!"
Manon541: calls 50
dddocky: checks 
*** FLOP *** [Ad Tc 8h]
Manon541: bets 236
dddocky: folds 
FragileMemory: folds 
color_singleton: calls 236
JeBoyDirk: folds 
*** TURN *** [Ad Tc 8h] [Td]
Manon541: bets 459
color_singleton: calls 459
*** RIVER *** [Ad Tc 8h Td] [5h]
Manon541: bets 893
color_singleton: folds 
Uncalled bet (893) returned to Manon541
Manon541 collected 1786 from pot
*** SUMMARY ***
Total pot 1890 | Rake 104 
Board [Ad Tc 8h Td 5h]
Seat 1: dddocky (big blind) folded on the Flop
Seat 2: FragileMemory folded on the Flop
Seat 3: Duke Croix folded before Flop (didn't bet)
Seat 4: yairpinto folded before Flop (didn't bet)
Seat 6: color_singleton folded on the River
Seat 8: JeBoyDirk (button) folded on the Flop
Seat 9: Manon541 (small blind) collected (1786)



PokerStars Home Game Hand #218083482694: {Club #3225207}  Hold'em No Limit (50/100) - 2020/09/03 14:54:02 ET
Table 'fun gamez' 9-max (Play Money) Seat #9 is the button
Seat 1: dddocky (8939 in chips) 
Seat 2: FragileMemory (7583 in chips) 
Seat 3: Duke Croix (9700 in chips) 
Seat 4: yairpinto (11619 in chips) 
Seat 6: color_singleton (12667 in chips) 
Seat 8: JeBoyDirk (11802 in chips) 
Seat 9: Manon541 (6547 in chips) 
dddocky: posts small blind 50
FragileMemory: posts big blind 100
*** HOLE CARDS ***
Dealt to Duke Croix [7s 6h]
Duke Croix: calls 100
yairpinto: folds 
color_singleton: folds 
JeBoyDirk: folds 
Manon541: calls 100
dddocky: calls 50
FragileMemory: raises 100 to 200
Duke Croix: calls 100
Manon541: calls 100
dddocky: calls 100
*** FLOP *** [Ts As Ah]
dddocky: bets 756
FragileMemory: calls 756
Duke Croix: folds 
Manon541: folds 
*** TURN *** [Ts As Ah] [Ac]
dddocky: checks 
FragileMemory: bets 1092
dddocky: calls 1092
*** RIVER *** [Ts As Ah Ac] [Qh]
dddocky: bets 4249
FragileMemory: calls 4249
*** SHOW DOWN ***
dddocky: shows [9s 9d] (a full house, Aces full of Nines)
FragileMemory: mucks hand 
dddocky collected 12279 from pot
*** SUMMARY ***
Total pot 12994 | Rake 715 
Board [Ts As Ah Ac Qh]
Seat 1: dddocky (small blind) showed [9s 9d] and won (12279) with a full house, Aces full of Nines
Seat 2: FragileMemory (big blind) mucked [4c 4h]
Seat 3: Duke Croix folded on the Flop
Seat 4: yairpinto folded before Flop (didn't bet)
Seat 6: color_singleton folded before Flop (didn't bet)
Seat 8: JeBoyDirk folded before Flop (didn't bet)
Seat 9: Manon541 (button) folded on the Flop



PokerStars Home Game Hand #218083527880: {Club #3225207}  Hold'em No Limit (50/100) - 2020/09/03 14:55:19 ET
Table 'fun gamez' 9-max (Play Money) Seat #1 is the button
Seat 1: dddocky (14921 in chips) 
Seat 2: FragileMemory (1286 in chips) 
Seat 3: Duke Croix (9500 in chips) 
Seat 4: yairpinto (11619 in chips) 
Seat 6: color_singleton (12667 in chips) 
Seat 8: JeBoyDirk (11802 in chips) 
Seat 9: Manon541 (6347 in chips) 
FragileMemory: posts small blind 50
Duke Croix: posts big blind 100
*** HOLE CARDS ***
Dealt to Duke Croix [5c Ks]
yairpinto: raises 200 to 300
color_singleton: folds 
JeBoyDirk: folds 
Manon541: folds 
dddocky: calls 300
FragileMemory: folds 
Duke Croix: calls 200
*** FLOP *** [As Jd 9h]
Duke Croix: checks 
yairpinto: bets 449
dddocky: calls 449
Duke Croix: folds 
*** TURN *** [As Jd 9h] [8d]
yairpinto: checks 
dddocky: checks 
*** RIVER *** [As Jd 9h 8d] [8h]
yairpinto: bets 873
dddocky: folds 
Uncalled bet (873) returned to yairpinto
yairpinto collected 1746 from pot
yairpinto: doesn't show hand 
*** SUMMARY ***
Total pot 1848 | Rake 102 
Board [As Jd 9h 8d 8h]
Seat 1: dddocky (button) folded on the River
Seat 2: FragileMemory (small blind) folded before Flop
Seat 3: Duke Croix (big blind) folded on the Flop
Seat 4: yairpinto collected (1746)
Seat 6: color_singleton folded before Flop (didn't bet)
Seat 8: JeBoyDirk folded before Flop (didn't bet)
Seat 9: Manon541 folded before Flop (didn't bet)



PokerStars Home Game Hand #218083546158: {Club #3225207}  Hold'em No Limit (50/100) - 2020/09/03 14:56:02 ET
Table 'fun gamez' 9-max (Play Money) Seat #2 is the button
Seat 1: dddocky (14172 in chips) 
Seat 2: FragileMemory (1236 in chips) 
Seat 3: Duke Croix (9200 in chips) 
Seat 4: yairpinto (12616 in chips) 
Seat 6: color_singleton (12667 in chips) 
Seat 8: JeBoyDirk (11802 in chips) 
Seat 9: Manon541 (6347 in chips) 
Duke Croix: posts small blind 50
yairpinto: posts big blind 100
*** HOLE CARDS ***
Dealt to Duke Croix [5h 8d]
color_singleton: calls 100
JeBoyDirk: folds 
Manon541: raises 100 to 200
dddocky: calls 200
FragileMemory: folds 
Duke Croix: folds 
yairpinto: calls 100
color_singleton: calls 100
*** FLOP *** [Js 2s 6c]
yairpinto: checks 
color_singleton: checks 
Manon541: bets 401
dddocky: raises 401 to 802
yairpinto: folds 
color_singleton: calls 802
Manon541: calls 401
*** TURN *** [Js 2s 6c] [4c]
color_singleton: checks 
Manon541: checks 
dddocky: bets 100
color_singleton: calls 100
Manon541: raises 1688 to 1788
dddocky: calls 1688
color_singleton: folds 
*** RIVER *** [Js 2s 6c 4c] [Jc]
Manon541: checks 
dddocky: checks 
*** SHOW DOWN ***
Manon541: shows [As Ac] (two pair, Aces and Jacks)
dddocky: shows [Ah Jh] (three of a kind, Jacks)
dddocky collected 6551 from pot
*** SUMMARY ***
Total pot 6932 | Rake 381 
Board [Js 2s 6c 4c Jc]
Seat 1: dddocky showed [Ah Jh] and won (6551) with three of a kind, Jacks
Seat 2: FragileMemory (button) folded before Flop (didn't bet)
Seat 3: Duke Croix (small blind) folded before Flop
Seat 4: yairpinto (big blind) folded on the Flop
Seat 6: color_singleton folded on the Turn
Seat 8: JeBoyDirk folded before Flop (didn't bet)
Seat 9: Manon541 showed [As Ac] and lost with two pair, Aces and Jacks



PokerStars Home Game Hand #218083590007: {Club #3225207}  Hold'em No Limit (50/100) - 2020/09/03 14:57:45 ET
Table 'fun gamez' 9-max (Play Money) Seat #3 is the button
Seat 1: dddocky (17933 in chips) 
Seat 2: FragileMemory (1236 in chips) 
Seat 3: Duke Croix (9150 in chips) 
Seat 4: yairpinto (12416 in chips) 
Seat 6: color_singleton (11565 in chips) 
Seat 8: JeBoyDirk (11802 in chips) 
Seat 9: Manon541 (3557 in chips) 
yairpinto: posts small blind 50
color_singleton: posts big blind 100
*** HOLE CARDS ***
Dealt to Duke Croix [Tc 6d]
JeBoyDirk: folds 
Manon541: calls 100
dddocky: calls 100
FragileMemory: folds 
Duke Croix: folds 
yairpinto: calls 50
color_singleton: checks 
*** FLOP *** [9s 2h Jc]
yairpinto: checks 
color_singleton has timed out
color_singleton: checks 
Manon541: checks 
dddocky: checks 
*** TURN *** [9s 2h Jc] [9d]
yairpinto: checks 
color_singleton: checks 
Manon541: checks 
dddocky: checks 
*** RIVER *** [9s 2h Jc 9d] [4s]
yairpinto: checks 
color_singleton: checks 
Manon541: checks 
dddocky: checks 
*** SHOW DOWN ***
yairpinto: shows [5d 3s] (a pair of Nines)
color_singleton: shows [8h 3c] (a pair of Nines - Jack+Eight kicker)
Manon541: shows [Qd 6s] (a pair of Nines - Queen kicker)
dddocky: shows [Qs Ks] (a pair of Nines - King kicker)
dddocky collected 378 from pot
*** SUMMARY ***
Total pot 400 | Rake 22 
Board [9s 2h Jc 9d 4s]
Seat 1: dddocky showed [Qs Ks] and won (378) with a pair of Nines
Seat 2: FragileMemory folded before Flop (didn't bet)
Seat 3: Duke Croix (button) folded before Flop (didn't bet)
Seat 4: yairpinto (small blind) showed [5d 3s] and lost with a pair of Nines
Seat 6: color_singleton (big blind) showed [8h 3c] and lost with a pair of Nines
Seat 8: JeBoyDirk folded before Flop (didn't bet)
Seat 9: Manon541 showed [Qd 6s] and lost with a pair of Nines



PokerStars Home Game Hand #218083628027: {Club #3225207}  Hold'em No Limit (50/100) - 2020/09/03 14:59:13 ET
Table 'fun gamez' 9-max (Play Money) Seat #4 is the button
Seat 1: dddocky (18211 in chips) 
Seat 2: FragileMemory (1236 in chips) 
Seat 3: Duke Croix (9150 in chips) 
Seat 4: yairpinto (12316 in chips) 
Seat 6: color_singleton (11465 in chips) 
Seat 8: JeBoyDirk (11802 in chips) 
Seat 9: Manon541 (3457 in chips) 
color_singleton: posts small blind 50
JeBoyDirk: posts big blind 100
*** HOLE CARDS ***
Dealt to Duke Croix [Js Qh]
Manon541: folds 
dddocky: calls 100
FragileMemory: folds 
Duke Croix: raises 300 to 400
yairpinto: folds 
color_singleton: folds 
JeBoyDirk: folds 
dddocky: folds 
Uncalled bet (300) returned to Duke Croix
Duke Croix collected 350 from pot
*** SUMMARY ***
Total pot 350 | Rake 0 
Seat 1: dddocky folded before Flop
Seat 2: FragileMemory folded before Flop (didn't bet)
Seat 3: Duke Croix collected (350)
Seat 4: yairpinto (button) folded before Flop (didn't bet)
Seat 6: color_singleton (small blind) folded before Flop
Seat 8: JeBoyDirk (big blind) folded before Flop
Seat 9: Manon541 folded before Flop (didn't bet)



PokerStars Home Game Hand #218083634815: {Club #3225207}  Hold'em No Limit (50/100) - 2020/09/03 14:59:29 ET
Table 'fun gamez' 9-max (Play Money) Seat #6 is the button
Seat 1: dddocky (18111 in chips) 
Seat 2: FragileMemory (1236 in chips) 
Seat 3: Duke Croix (9400 in chips) 
Seat 4: yairpinto (12316 in chips) 
Seat 6: color_singleton (11415 in chips) 
Seat 8: JeBoyDirk (11702 in chips) 
Seat 9: Manon541 (3457 in chips) 
JeBoyDirk: posts small blind 50
Manon541: posts big blind 100
*** HOLE CARDS ***
Dealt to Duke Croix [Ad 5s]
dddocky: calls 100
FragileMemory: folds 
Duke Croix: calls 100
yairpinto: calls 100
color_singleton: raises 200 to 300
JeBoyDirk: folds 
Manon541: folds 
dddocky: calls 200
Duke Croix: folds 
yairpinto: calls 200
*** FLOP *** [5d 5h 3d]
dddocky: checks 
yairpinto: checks 
color_singleton: bets 543
dddocky: folds 
yairpinto: folds 
Uncalled bet (543) returned to color_singleton
color_singleton collected 1087 from pot
color_singleton: doesn't show hand 
*** SUMMARY ***
Total pot 1150 | Rake 63 
Board [5d 5h 3d]
Seat 1: dddocky folded on the Flop
Seat 2: FragileMemory folded before Flop (didn't bet)
Seat 3: Duke Croix folded before Flop
Seat 4: yairpinto folded on the Flop
Seat 6: color_singleton (button) collected (1087)
Seat 8: JeBoyDirk (small blind) folded before Flop
Seat 9: Manon541 (big blind) folded before Flop



PokerStars Home Game Hand #218083650598: {Club #3225207}  Hold'em No Limit (50/100) - 2020/09/03 15:00:04 ET
Table 'fun gamez' 9-max (Play Money) Seat #8 is the button
Seat 1: dddocky (17811 in chips) 
Seat 2: FragileMemory (1236 in chips) 
Seat 3: Duke Croix (9300 in chips) 
Seat 4: yairpinto (12016 in chips) 
Seat 6: color_singleton (12202 in chips) 
Seat 8: JeBoyDirk (11652 in chips) 
Seat 9: Manon541 (3357 in chips) 
Manon541: posts small blind 50
dddocky: posts big blind 100
*** HOLE CARDS ***
Dealt to Duke Croix [6h 8c]
FragileMemory: calls 100
Duke Croix has timed out
Duke Croix: folds 
yairpinto: calls 100
color_singleton: folds 
JeBoyDirk: raises 300 to 400
Manon541: folds 
dddocky: calls 300
FragileMemory: raises 836 to 1236 and is all-in
yairpinto: folds 
JeBoyDirk: calls 836
dddocky: folds 
*** FLOP *** [5h Tc 4h]
*** TURN *** [5h Tc 4h] [6c]
*** RIVER *** [5h Tc 4h 6c] [7h]
*** SHOW DOWN ***
FragileMemory: shows [Ks 9s] (high card King)
JeBoyDirk: shows [Ah As] (a pair of Aces)
JeBoyDirk collected 2856 from pot
*** SUMMARY ***
Total pot 3022 | Rake 166 
Board [5h Tc 4h 6c 7h]
Seat 1: dddocky (big blind) folded before Flop
Seat 2: FragileMemory showed [Ks 9s] and lost with high card King
Seat 3: Duke Croix folded before Flop (didn't bet)
Seat 4: yairpinto folded before Flop
Seat 6: color_singleton folded before Flop (didn't bet)
Seat 8: JeBoyDirk (button) showed [Ah As] and won (2856) with a pair of Aces
Seat 9: Manon541 (small blind) folded before Flop



PokerStars Home Game Hand #218083681099: {Club #3225207}  Hold'em No Limit (50/100) - 2020/09/03 15:01:08 ET
Table 'fun gamez' 9-max (Play Money) Seat #9 is the button
Seat 1: dddocky (17411 in chips) 
Seat 3: Duke Croix (9300 in chips) 
Seat 4: yairpinto (11916 in chips) 
Seat 6: color_singleton (12202 in chips) 
Seat 8: JeBoyDirk (13272 in chips) 
Seat 9: Manon541 (3307 in chips) 
dddocky: posts small blind 50
Duke Croix: posts big blind 100
*** HOLE CARDS ***
Dealt to Duke Croix [8h Ks]
yairpinto: folds 
color_singleton: folds 
JeBoyDirk: calls 100
Manon541: calls 100
dddocky: calls 50
Duke Croix: checks 
*** FLOP *** [4c 3s 7c]
dddocky: bets 378
Duke Croix: folds 
JeBoyDirk: folds 
Manon541: calls 378
*** TURN *** [4c 3s 7c] [4d]
dddocky: bets 1092
Manon541: folds 
Uncalled bet (1092) returned to dddocky
dddocky collected 1092 from pot
dddocky: doesn't show hand 
*** SUMMARY ***
Total pot 1156 | Rake 64 
Board [4c 3s 7c 4d]
Seat 1: dddocky (small blind) collected (1092)
Seat 3: Duke Croix (big blind) folded on the Flop
Seat 4: yairpinto folded before Flop (didn't bet)
Seat 6: color_singleton folded before Flop (didn't bet)
Seat 8: JeBoyDirk folded on the Flop
Seat 9: Manon541 (button) folded on the Turn



PokerStars Home Game Hand #218083719434: {Club #3225207}  Hold'em No Limit (50/100) - 2020/09/03 15:02:09 ET
Table 'fun gamez' 9-max (Play Money) Seat #1 is the button
Seat 1: dddocky (18025 in chips) 
Seat 3: Duke Croix (9200 in chips) 
Seat 4: yairpinto (11916 in chips) 
Seat 6: color_singleton (12202 in chips) 
Seat 8: JeBoyDirk (13172 in chips) 
Seat 9: Manon541 (2829 in chips) 
Duke Croix: posts small blind 50
yairpinto: posts big blind 100
*** HOLE CARDS ***
Dealt to Duke Croix [4c Qh]
color_singleton: raises 200 to 300
JeBoyDirk: calls 300
Manon541: calls 300
dddocky: folds 
Duke Croix: folds 
yairpinto: calls 200
*** FLOP *** [9c Js As]
yairpinto: checks 
color_singleton: checks 
JeBoyDirk: bets 500
Manon541: calls 500
yairpinto: folds 
color_singleton: folds 
*** TURN *** [9c Js As] [Kh]
JeBoyDirk: bets 3300
Manon541: folds 
Uncalled bet (3300) returned to JeBoyDirk
JeBoyDirk collected 2126 from pot
*** SUMMARY ***
Total pot 2250 | Rake 124 
Board [9c Js As Kh]
Seat 1: dddocky (button) folded before Flop (didn't bet)
Seat 3: Duke Croix (small blind) folded before Flop
Seat 4: yairpinto (big blind) folded on the Flop
Seat 6: color_singleton folded on the Flop
Seat 8: JeBoyDirk collected (2126)
Seat 9: Manon541 folded on the Turn



PokerStars Home Game Hand #218083752214: {Club #3225207}  Hold'em No Limit (50/100) - 2020/09/03 15:03:03 ET
Table 'fun gamez' 9-max (Play Money) Seat #3 is the button
Seat 1: dddocky (18025 in chips) 
Seat 2: FragileMemory (10000 in chips) 
Seat 3: Duke Croix (9150 in chips) 
Seat 4: yairpinto (11616 in chips) 
Seat 6: color_singleton (11902 in chips) 
Seat 8: JeBoyDirk (14498 in chips) 
Seat 9: Manon541 (2029 in chips) 
yairpinto: posts small blind 50
color_singleton: posts big blind 100
FragileMemory: posts small & big blinds 150
*** HOLE CARDS ***
Dealt to Duke Croix [Th 7d]
JeBoyDirk: folds 
Manon541: calls 100
dddocky: folds 
FragileMemory: checks 
Duke Croix: folds 
yairpinto: calls 50
color_singleton: checks 
*** FLOP *** [6s 5h 7s]
yairpinto: bets 212
color_singleton: calls 212
Manon541: calls 212
FragileMemory: raises 636 to 848
yairpinto: calls 636
color_singleton: calls 636
Manon541: calls 636
*** TURN *** [6s 5h 7s] [Ah]
yairpinto: checks 
color_singleton: checks 
Manon541: checks 
FragileMemory: bets 1815
yairpinto: calls 1815
color_singleton: folds 
Manon541: folds 
*** RIVER *** [6s 5h 7s Ah] [Js]
yairpinto: checks 
FragileMemory: bets 7187 and is all-in
yairpinto: folds 
Uncalled bet (7187) returned to FragileMemory
FragileMemory collected 7061 from pot
FragileMemory: doesn't show hand 
*** SUMMARY ***
Total pot 7472 | Rake 411 
Board [6s 5h 7s Ah Js]
Seat 1: dddocky folded before Flop (didn't bet)
Seat 2: FragileMemory collected (7061)
Seat 3: Duke Croix (button) folded before Flop (didn't bet)
Seat 4: yairpinto (small blind) folded on the River
Seat 6: color_singleton (big blind) folded on the Turn
Seat 8: JeBoyDirk folded before Flop (didn't bet)
Seat 9: Manon541 folded on the Turn



PokerStars Home Game Hand #218083790555: {Club #3225207}  Hold'em No Limit (50/100) - 2020/09/03 15:04:08 ET
Table 'fun gamez' 9-max (Play Money) Seat #4 is the button
Seat 1: dddocky (18025 in chips) 
Seat 2: FragileMemory (14248 in chips) 
Seat 3: Duke Croix (9150 in chips) 
Seat 4: yairpinto (8853 in chips) 
Seat 6: color_singleton (10954 in chips) 
Seat 8: JeBoyDirk (14498 in chips) 
Seat 9: Manon541 (1081 in chips) 
color_singleton: posts small blind 50
JeBoyDirk: posts big blind 100
*** HOLE CARDS ***
Dealt to Duke Croix [3s Kc]
Manon541: calls 100
dddocky: calls 100
FragileMemory: folds 
Duke Croix: folds 
yairpinto: folds 
color_singleton: raises 200 to 300
JeBoyDirk: folds 
Manon541: calls 200
dddocky: calls 200
*** FLOP *** [Kh 3h 4h]
color_singleton: bets 472
Manon541: folds 
dddocky: folds 
Uncalled bet (472) returned to color_singleton
color_singleton collected 945 from pot
color_singleton: doesn't show hand 
*** SUMMARY ***
Total pot 1000 | Rake 55 
Board [Kh 3h 4h]
Seat 1: dddocky folded on the Flop
Seat 2: FragileMemory folded before Flop (didn't bet)
Seat 3: Duke Croix folded before Flop (didn't bet)
Seat 4: yairpinto (button) folded before Flop (didn't bet)
Seat 6: color_singleton (small blind) collected (945)
Seat 8: JeBoyDirk (big blind) folded before Flop
Seat 9: Manon541 folded on the Flop



PokerStars Home Game Hand #218083809783: {Club #3225207}  Hold'em No Limit (50/100) - 2020/09/03 15:04:40 ET
Table 'fun gamez' 9-max (Play Money) Seat #6 is the button
Seat 1: dddocky (17725 in chips) 
Seat 2: FragileMemory (14248 in chips) 
Seat 3: Duke Croix (9150 in chips) 
Seat 4: yairpinto (8853 in chips) 
Seat 6: color_singleton (11599 in chips) 
Seat 8: JeBoyDirk (14398 in chips) 
Seat 9: Manon541 (781 in chips) 
JeBoyDirk: posts small blind 50
Manon541: posts big blind 100
*** HOLE CARDS ***
Dealt to Duke Croix [7h 5h]
dddocky: calls 100
FragileMemory: folds 
Duke Croix: calls 100
yairpinto: raises 200 to 300
color_singleton: folds 
JeBoyDirk has timed out
JeBoyDirk: folds 
Manon541: folds 
dddocky: calls 200
Duke Croix: folds 
*** FLOP *** [Qh Ts Tc]
dddocky: bets 803
yairpinto: folds 
Uncalled bet (803) returned to dddocky
dddocky collected 803 from pot
dddocky: doesn't show hand 
*** SUMMARY ***
Total pot 850 | Rake 47 
Board [Qh Ts Tc]
Seat 1: dddocky collected (803)
Seat 2: FragileMemory folded before Flop (didn't bet)
Seat 3: Duke Croix folded before Flop
Seat 4: yairpinto folded on the Flop
Seat 6: color_singleton (button) folded before Flop (didn't bet)
Seat 8: JeBoyDirk (small blind) folded before Flop
Seat 9: Manon541 (big blind) folded before Flop



PokerStars Home Game Hand #218083841221: {Club #3225207}  Hold'em No Limit (50/100) - 2020/09/03 15:05:29 ET
Table 'fun gamez' 9-max (Play Money) Seat #8 is the button
Seat 1: dddocky (18228 in chips) 
Seat 2: FragileMemory (14248 in chips) 
Seat 3: Duke Croix (9050 in chips) 
Seat 4: yairpinto (8553 in chips) 
Seat 6: color_singleton (11599 in chips) 
Seat 8: JeBoyDirk (14348 in chips) 
Seat 9: Manon541 (681 in chips) 
Manon541: posts small blind 50
dddocky: posts big blind 100
*** HOLE CARDS ***
Dealt to Duke Croix [Qc 4c]
FragileMemory: calls 100
Duke Croix: folds 
yairpinto: folds 
color_singleton: folds 
JeBoyDirk: folds 
Manon541: calls 50
dddocky: checks 
*** FLOP *** [2d Tc 6c]
Manon541: checks 
dddocky: checks 
FragileMemory: bets 141
Manon541: folds 
dddocky: folds 
Uncalled bet (141) returned to FragileMemory
FragileMemory collected 283 from pot
FragileMemory: doesn't show hand 
*** SUMMARY ***
Total pot 300 | Rake 17 
Board [2d Tc 6c]
Seat 1: dddocky (big blind) folded on the Flop
Seat 2: FragileMemory collected (283)
Seat 3: Duke Croix folded before Flop (didn't bet)
Seat 4: yairpinto folded before Flop (didn't bet)
Seat 6: color_singleton folded before Flop (didn't bet)
Seat 8: JeBoyDirk (button) folded before Flop (didn't bet)
Seat 9: Manon541 (small blind) folded on the Flop



PokerStars Home Game Hand #218083864872: {Club #3225207}  Hold'em No Limit (50/100) - 2020/09/03 15:06:05 ET
Table 'fun gamez' 9-max (Play Money) Seat #9 is the button
Seat 1: dddocky (18128 in chips) 
Seat 2: FragileMemory (14431 in chips) 
Seat 3: Duke Croix (9050 in chips) 
Seat 4: yairpinto (8553 in chips) 
Seat 6: color_singleton (11599 in chips) 
Seat 8: JeBoyDirk (14348 in chips) 
Seat 9: Manon541 (581 in chips) 
dddocky: posts small blind 50
FragileMemory: posts big blind 100
*** HOLE CARDS ***
Dealt to Duke Croix [Qc 3d]
Duke Croix: folds 
yairpinto: folds 
color_singleton: folds 
JeBoyDirk: folds 
Manon541: calls 100
dddocky: calls 50
FragileMemory: checks 
*** FLOP *** [2s 3h Jh]
dddocky: checks 
FragileMemory: checks 
Manon541: checks 
*** TURN *** [2s 3h Jh] [Ac]
dddocky: checks 
FragileMemory: checks 
Manon541: checks 
*** RIVER *** [2s 3h Jh Ac] [7c]
dddocky: bets 400
FragileMemory: folds 
Manon541: folds 
Uncalled bet (400) returned to dddocky
dddocky collected 283 from pot
dddocky: doesn't show hand 
*** SUMMARY ***
Total pot 300 | Rake 17 
Board [2s 3h Jh Ac 7c]
Seat 1: dddocky (small blind) collected (283)
Seat 2: FragileMemory (big blind) folded on the River
Seat 3: Duke Croix folded before Flop (didn't bet)
Seat 4: yairpinto folded before Flop (didn't bet)
Seat 6: color_singleton folded before Flop (didn't bet)
Seat 8: JeBoyDirk folded before Flop (didn't bet)
Seat 9: Manon541 (button) folded on the River



PokerStars Home Game Hand #218083890777: {Club #3225207}  Hold'em No Limit (50/100) - 2020/09/03 15:06:45 ET
Table 'fun gamez' 9-max (Play Money) Seat #1 is the button
Seat 1: dddocky (18311 in chips) 
Seat 2: FragileMemory (14331 in chips) 
Seat 3: Duke Croix (9050 in chips) 
Seat 4: yairpinto (8553 in chips) 
Seat 6: color_singleton (11599 in chips) 
Seat 8: JeBoyDirk (14348 in chips) 
Seat 9: Manon541 (481 in chips) 
FragileMemory: posts small blind 50
Duke Croix: posts big blind 100
*** HOLE CARDS ***
Dealt to Duke Croix [Jd Ad]
yairpinto: raises 200 to 300
color_singleton: folds 
JeBoyDirk: folds 
Manon541: folds 
dddocky: folds 
FragileMemory: folds 
Duke Croix: calls 200
*** FLOP *** [6d 7d Qh]
Duke Croix: bets 400
yairpinto: calls 400
*** TURN *** [6d 7d Qh] [Ah]
Duke Croix: bets 800
yairpinto: folds 
Uncalled bet (800) returned to Duke Croix
Duke Croix collected 1370 from pot
*** SUMMARY ***
Total pot 1450 | Rake 80 
Board [6d 7d Qh Ah]
Seat 1: dddocky (button) folded before Flop (didn't bet)
Seat 2: FragileMemory (small blind) folded before Flop
Seat 3: Duke Croix (big blind) collected (1370)
Seat 4: yairpinto folded on the Turn
Seat 6: color_singleton folded before Flop (didn't bet)
Seat 8: JeBoyDirk folded before Flop (didn't bet)
Seat 9: Manon541 folded before Flop (didn't bet)



PokerStars Home Game Hand #218083912436: {Club #3225207}  Hold'em No Limit (50/100) - 2020/09/03 15:07:19 ET
Table 'fun gamez' 9-max (Play Money) Seat #2 is the button
Seat 1: dddocky (18311 in chips) 
Seat 2: FragileMemory (14281 in chips) 
Seat 3: Duke Croix (9720 in chips) 
Seat 4: yairpinto (7853 in chips) 
Seat 6: color_singleton (11599 in chips) 
Seat 8: JeBoyDirk (14348 in chips) 
Seat 9: Manon541 (481 in chips) 
Duke Croix: posts small blind 50
yairpinto: posts big blind 100
*** HOLE CARDS ***
Dealt to Duke Croix [Js Ah]
color_singleton: folds 
JeBoyDirk has timed out
JeBoyDirk: folds 
Manon541: folds 
dddocky: calls 100
FragileMemory: calls 100
Duke Croix: calls 50
yairpinto: checks 
*** FLOP *** [3c 8d 6s]
Duke Croix: checks 
yairpinto: bets 189
dddocky: folds 
FragileMemory: calls 189
Duke Croix: calls 189
*** TURN *** [3c 8d 6s] [7h]
Duke Croix: checks 
yairpinto: checks 
FragileMemory: checks 
*** RIVER *** [3c 8d 6s 7h] [4h]
Duke Croix: bets 700
yairpinto: folds 
FragileMemory: folds 
Uncalled bet (700) returned to Duke Croix
Duke Croix collected 914 from pot
*** SUMMARY ***
Total pot 967 | Rake 53 
Board [3c 8d 6s 7h 4h]
Seat 1: dddocky folded on the Flop
Seat 2: FragileMemory (button) folded on the River
Seat 3: Duke Croix (small blind) collected (914)
Seat 4: yairpinto (big blind) folded on the River
Seat 6: color_singleton folded before Flop (didn't bet)
Seat 8: JeBoyDirk folded before Flop (didn't bet)
Seat 9: Manon541 folded before Flop (didn't bet)



PokerStars Home Game Hand #218083948461: {Club #3225207}  Hold'em No Limit (50/100) - 2020/09/03 15:08:15 ET
Table 'fun gamez' 9-max (Play Money) Seat #3 is the button
Seat 2: FragileMemory (13992 in chips) 
Seat 3: Duke Croix (10345 in chips) 
Seat 4: yairpinto (7564 in chips) 
Seat 6: color_singleton (11599 in chips) 
Seat 8: JeBoyDirk (14348 in chips) 
Seat 9: Manon541 (481 in chips) 
yairpinto: posts small blind 50
color_singleton: posts big blind 100
*** HOLE CARDS ***
Dealt to Duke Croix [Qh 8c]
JeBoyDirk: folds 
Manon541: raises 381 to 481 and is all-in
FragileMemory: calls 481
Duke Croix: folds 
yairpinto: folds 
color_singleton: folds 
*** FLOP *** [Tc 6h 3h]
*** TURN *** [Tc 6h 3h] [7h]
*** RIVER *** [Tc 6h 3h 7h] [3s]
*** SHOW DOWN ***
Manon541: shows [Ah 3d] (three of a kind, Threes)
FragileMemory: shows [9h Td] (two pair, Tens and Threes)
Manon541 collected 1051 from pot
*** SUMMARY ***
Total pot 1112 | Rake 61 
Board [Tc 6h 3h 7h 3s]
Seat 2: FragileMemory showed [9h Td] and lost with two pair, Tens and Threes
Seat 3: Duke Croix (button) folded before Flop (didn't bet)
Seat 4: yairpinto (small blind) folded before Flop
Seat 6: color_singleton (big blind) folded before Flop
Seat 8: JeBoyDirk folded before Flop (didn't bet)
Seat 9: Manon541 showed [Ah 3d] and won (1051) with three of a kind, Threes



PokerStars Home Game Hand #218083977167: {Club #3225207}  Hold'em No Limit (50/100) - 2020/09/03 15:08:59 ET
Table 'fun gamez' 9-max (Play Money) Seat #4 is the button
Seat 2: FragileMemory (13511 in chips) 
Seat 3: Duke Croix (10345 in chips) 
Seat 4: yairpinto (7514 in chips) 
Seat 6: color_singleton (11499 in chips) 
Seat 8: JeBoyDirk (14348 in chips) 
Seat 9: Manon541 (1051 in chips) 
color_singleton: posts small blind 50
JeBoyDirk: posts big blind 100
*** HOLE CARDS ***
Dealt to Duke Croix [2d 8h]
Manon541: calls 100
FragileMemory: folds 
Duke Croix: folds 
yairpinto: folds 
color_singleton: calls 50
JeBoyDirk: checks 
*** FLOP *** [4c 4s 6h]
color_singleton: bets 141
JeBoyDirk: folds 
Manon541: folds 
Uncalled bet (141) returned to color_singleton
color_singleton collected 283 from pot
color_singleton: doesn't show hand 
*** SUMMARY ***
Total pot 300 | Rake 17 
Board [4c 4s 6h]
Seat 2: FragileMemory folded before Flop (didn't bet)
Seat 3: Duke Croix folded before Flop (didn't bet)
Seat 4: yairpinto (button) folded before Flop (didn't bet)
Seat 6: color_singleton (small blind) collected (283)
Seat 8: JeBoyDirk (big blind) folded on the Flop
Seat 9: Manon541 folded on the Flop



PokerStars Home Game Hand #218084000055: {Club #3225207}  Hold'em No Limit (50/100) - 2020/09/03 15:09:35 ET
Table 'fun gamez' 9-max (Play Money) Seat #6 is the button
Seat 1: dddocky (18211 in chips) 
Seat 2: FragileMemory (13511 in chips) 
Seat 3: Duke Croix (10345 in chips) 
Seat 4: yairpinto (7514 in chips) 
Seat 6: color_singleton (11682 in chips) 
Seat 8: JeBoyDirk (14248 in chips) 
Seat 9: Manon541 (951 in chips) 
JeBoyDirk: posts small blind 50
Manon541: posts big blind 100
*** HOLE CARDS ***
Dealt to Duke Croix [Jd Td]
dddocky: folds 
FragileMemory: folds 
Duke Croix: raises 300 to 400
yairpinto: calls 400
color_singleton: folds 
JeBoyDirk: calls 350
Manon541: calls 300
*** FLOP *** [Ad 9s Th]
JeBoyDirk: checks 
Manon541 has timed out
Manon541: checks 
Duke Croix: checks 
yairpinto: checks 
*** TURN *** [Ad 9s Th] [8c]
JeBoyDirk: checks 
Manon541: checks 
Duke Croix: bets 900
yairpinto: calls 900
JeBoyDirk: folds 
Manon541: folds 
*** RIVER *** [Ad 9s Th 8c] [5s]
Duke Croix: checks 
yairpinto: checks 
*** SHOW DOWN ***
Duke Croix: shows [Jd Td] (a pair of Tens)
yairpinto: shows [Tc Jc] (a pair of Tens)
Duke Croix collected 1607 from pot
yairpinto collected 1606 from pot
*** SUMMARY ***
Total pot 3400 | Rake 187 
Board [Ad 9s Th 8c 5s]
Seat 1: dddocky folded before Flop (didn't bet)
Seat 2: FragileMemory folded before Flop (didn't bet)
Seat 3: Duke Croix showed [Jd Td] and won (1607) with a pair of Tens
Seat 4: yairpinto showed [Tc Jc] and won (1606) with a pair of Tens
Seat 6: color_singleton (button) folded before Flop (didn't bet)
Seat 8: JeBoyDirk (small blind) folded on the Turn
Seat 9: Manon541 (big blind) folded on the Turn



PokerStars Home Game Hand #218084064926: {Club #3225207}  Hold'em No Limit (50/100) - 2020/09/03 15:11:15 ET
Table 'fun gamez' 9-max (Play Money) Seat #8 is the button
Seat 1: dddocky (18211 in chips) 
Seat 2: FragileMemory (13511 in chips) 
Seat 3: Duke Croix (10652 in chips) 
Seat 4: yairpinto (7820 in chips) 
Seat 6: color_singleton (11682 in chips) 
Seat 8: JeBoyDirk (13848 in chips) 
Seat 9: Manon541 (551 in chips) 
Manon541: posts small blind 50
dddocky: posts big blind 100
*** HOLE CARDS ***
Dealt to Duke Croix [9s 4c]
FragileMemory: folds 
Duke Croix: folds 
yairpinto: folds 
color_singleton: folds 
JeBoyDirk: folds 
Manon541: calls 50
dddocky: checks 
*** FLOP *** [Ks Ac 7d]
Manon541: checks 
dddocky: checks 
*** TURN *** [Ks Ac 7d] [5d]
Manon541: checks 
dddocky: checks 
*** RIVER *** [Ks Ac 7d 5d] [Jh]
Manon541: checks 
dddocky: checks 
*** SHOW DOWN ***
Manon541: shows [9c 3c] (high card Ace)
dddocky: shows [4h 9d] (high card Ace)
Manon541 collected 95 from pot
dddocky collected 94 from pot
*** SUMMARY ***
Total pot 200 | Rake 11 
Board [Ks Ac 7d 5d Jh]
Seat 1: dddocky (big blind) showed [4h 9d] and won (94) with high card Ace
Seat 2: FragileMemory folded before Flop (didn't bet)
Seat 3: Duke Croix folded before Flop (didn't bet)
Seat 4: yairpinto folded before Flop (didn't bet)
Seat 6: color_singleton folded before Flop (didn't bet)
Seat 8: JeBoyDirk (button) folded before Flop (didn't bet)
Seat 9: Manon541 (small blind) showed [9c 3c] and won (95) with high card Ace



PokerStars Home Game Hand #218084111104: {Club #3225207}  Hold'em No Limit (50/100) - 2020/09/03 15:12:27 ET
Table 'fun gamez' 9-max (Play Money) Seat #9 is the button
Seat 1: dddocky (18205 in chips) 
Seat 2: FragileMemory (13511 in chips) 
Seat 3: Duke Croix (10652 in chips) 
Seat 4: yairpinto (7820 in chips) 
Seat 6: color_singleton (11682 in chips) 
Seat 8: JeBoyDirk (13848 in chips) 
Seat 9: Manon541 (546 in chips) 
dddocky: posts small blind 50
FragileMemory: posts big blind 100
*** HOLE CARDS ***
Dealt to Duke Croix [Ah Qc]
Duke Croix: raises 300 to 400
yairpinto: folds 
color_singleton: folds 
JeBoyDirk: folds 
Manon541: calls 400
dddocky: folds 
FragileMemory: folds 
*** FLOP *** [Jd Kc 8d]
Duke Croix: checks 
Manon541: checks 
*** TURN *** [Jd Kc 8d] [4s]
Duke Croix: bets 200
Manon541 has timed out
Manon541: folds 
Uncalled bet (200) returned to Duke Croix
Duke Croix collected 898 from pot
*** SUMMARY ***
Total pot 950 | Rake 52 
Board [Jd Kc 8d 4s]
Seat 1: dddocky (small blind) folded before Flop
Seat 2: FragileMemory (big blind) folded before Flop
Seat 3: Duke Croix collected (898)
Seat 4: yairpinto folded before Flop (didn't bet)
Seat 6: color_singleton folded before Flop (didn't bet)
Seat 8: JeBoyDirk folded before Flop (didn't bet)
Seat 9: Manon541 (button) folded on the Turn



PokerStars Home Game Hand #218084141447: {Club #3225207}  Hold'em No Limit (50/100) - 2020/09/03 15:13:14 ET
Table 'fun gamez' 9-max (Play Money) Seat #1 is the button
Seat 1: dddocky (18155 in chips) 
Seat 2: FragileMemory (13411 in chips) 
Seat 3: Duke Croix (11150 in chips) 
Seat 4: yairpinto (7820 in chips) 
Seat 6: color_singleton (11682 in chips) 
Seat 8: JeBoyDirk (13848 in chips) 
FragileMemory: posts small blind 50
Duke Croix: posts big blind 100
*** HOLE CARDS ***
Dealt to Duke Croix [7d 4d]
yairpinto: folds 
color_singleton: folds 
JeBoyDirk: folds 
dddocky: folds 
FragileMemory: calls 50
Duke Croix: checks 
*** FLOP *** [8c 9s Qh]
FragileMemory: checks 
Duke Croix: checks 
*** TURN *** [8c 9s Qh] [7c]
FragileMemory: checks 
Duke Croix has timed out
Duke Croix: checks 
*** RIVER *** [8c 9s Qh 7c] [7h]
FragileMemory: bets 189
Duke Croix: raises 411 to 600
FragileMemory: raises 411 to 1011
Duke Croix: calls 411
*** SHOW DOWN ***
FragileMemory: shows [7s 6h] (three of a kind, Sevens)
Duke Croix: shows [7d 4d] (three of a kind, Sevens)
FragileMemory collected 1050 from pot
Duke Croix collected 1050 from pot
*** SUMMARY ***
Total pot 2222 | Rake 122 
Board [8c 9s Qh 7c 7h]
Seat 1: dddocky (button) folded before Flop (didn't bet)
Seat 2: FragileMemory (small blind) showed [7s 6h] and won (1050) with three of a kind, Sevens
Seat 3: Duke Croix (big blind) showed [7d 4d] and won (1050) with three of a kind, Sevens
Seat 4: yairpinto folded before Flop (didn't bet)
Seat 6: color_singleton folded before Flop (didn't bet)
Seat 8: JeBoyDirk folded before Flop (didn't bet)



PokerStars Home Game Hand #218084180350: {Club #3225207}  Hold'em No Limit (50/100) - 2020/09/03 15:14:15 ET
Table 'fun gamez' 9-max (Play Money) Seat #2 is the button
Seat 1: dddocky (18155 in chips) 
Seat 2: FragileMemory (13350 in chips) 
Seat 3: Duke Croix (11089 in chips) 
Seat 4: yairpinto (7820 in chips) 
Seat 6: color_singleton (11682 in chips) 
Seat 8: JeBoyDirk (13848 in chips) 
Seat 9: Manon541 (146 in chips) 
Duke Croix: posts small blind 50
yairpinto: posts big blind 100
*** HOLE CARDS ***
Dealt to Duke Croix [Js Ks]
color_singleton: folds 
JeBoyDirk: folds 
Manon541: folds 
dddocky: calls 100
FragileMemory: calls 100
Duke Croix: raises 300 to 400
yairpinto: folds 
dddocky: calls 300
FragileMemory: calls 300
*** FLOP *** [3h 4s 6s]
Duke Croix: bets 700
dddocky: folds 
FragileMemory: raises 700 to 1400
Duke Croix: calls 700
*** TURN *** [3h 4s 6s] [7s]
Duke Croix: checks 
FragileMemory: bets 11550 and is all-in
Duke Croix: calls 9289 and is all-in
Uncalled bet (2261) returned to FragileMemory
*** RIVER *** [3h 4s 6s 7s] [Qh]
*** SHOW DOWN ***
Duke Croix: shows [Js Ks] (a flush, King high)
FragileMemory: shows [7c 5c] (a straight, Three to Seven)
Duke Croix collected 21431 from pot
*** SUMMARY ***
Total pot 22678 | Rake 1247 
Board [3h 4s 6s 7s Qh]
Seat 1: dddocky folded on the Flop
Seat 2: FragileMemory (button) showed [7c 5c] and lost with a straight, Three to Seven
Seat 3: Duke Croix (small blind) showed [Js Ks] and won (21431) with a flush, King high
Seat 4: yairpinto (big blind) folded before Flop
Seat 6: color_singleton folded before Flop (didn't bet)
Seat 8: JeBoyDirk folded before Flop (didn't bet)
Seat 9: Manon541 folded before Flop (didn't bet)



PokerStars Home Game Hand #218084222763: {Club #3225207}  Hold'em No Limit (50/100) - 2020/09/03 15:15:20 ET
Table 'fun gamez' 9-max (Play Money) Seat #3 is the button
Seat 1: dddocky (17755 in chips) 
Seat 2: FragileMemory (2261 in chips) 
Seat 3: Duke Croix (21431 in chips) 
Seat 4: yairpinto (7720 in chips) 
Seat 6: color_singleton (11682 in chips) 
Seat 8: JeBoyDirk (13848 in chips) 
Seat 9: Manon541 (146 in chips) 
yairpinto: posts small blind 50
color_singleton: posts big blind 100
*** HOLE CARDS ***
Dealt to Duke Croix [9h 2s]
JeBoyDirk: folds 
Manon541: raises 46 to 146 and is all-in
dddocky: folds 
FragileMemory: calls 146
Duke Croix: folds 
yairpinto: folds 
color_singleton: calls 46
*** FLOP *** [3c Ac 4s]
color_singleton: checks 
FragileMemory: checks 
*** TURN *** [3c Ac 4s] [9c]
color_singleton: bets 230
FragileMemory: calls 230
*** RIVER *** [3c Ac 4s 9c] [Kc]
color_singleton: bets 600
FragileMemory: raises 1285 to 1885 and is all-in
color_singleton: calls 1285
*** SHOW DOWN ***
FragileMemory: shows [Jd 4c] (a flush, Ace high)
color_singleton: shows [Qc 2d] (a flush, Ace high - Queen higher)
color_singleton collected 3998 from side pot
Manon541: shows [Ad Ah] (three of a kind, Aces)
color_singleton collected 461 from main pot
*** SUMMARY ***
Total pot 4718 Main pot 461. Side pot 3998. | Rake 259 
Board [3c Ac 4s 9c Kc]
Seat 1: dddocky folded before Flop (didn't bet)
Seat 2: FragileMemory showed [Jd 4c] and lost with a flush, Ace high
Seat 3: Duke Croix (button) folded before Flop (didn't bet)
Seat 4: yairpinto (small blind) folded before Flop
Seat 6: color_singleton (big blind) showed [Qc 2d] and won (4459) with a flush, Ace high
Seat 8: JeBoyDirk folded before Flop (didn't bet)
Seat 9: Manon541 showed [Ad Ah] and lost with three of a kind, Aces



PokerStars Home Game Hand #218084266427: {Club #3225207}  Hold'em No Limit (50/100) - 2020/09/03 15:16:28 ET
Table 'fun gamez' 9-max (Play Money) Seat #4 is the button
Seat 1: dddocky (17755 in chips) 
Seat 3: Duke Croix (21431 in chips) 
Seat 4: yairpinto (7670 in chips) 
Seat 6: color_singleton (13880 in chips) 
Seat 8: JeBoyDirk (13848 in chips) 
color_singleton: posts small blind 50
JeBoyDirk: posts big blind 100
*** HOLE CARDS ***
Dealt to Duke Croix [8c Ad]
dddocky: calls 100
Duke Croix: raises 200 to 300
yairpinto: folds 
color_singleton: folds 
JeBoyDirk: folds 
dddocky: calls 200
*** FLOP *** [3d Qs 8s]
dddocky: checks 
Duke Croix: bets 400
dddocky: folds 
Uncalled bet (400) returned to Duke Croix
Duke Croix collected 709 from pot
*** SUMMARY ***
Total pot 750 | Rake 41 
Board [3d Qs 8s]
Seat 1: dddocky folded on the Flop
Seat 3: Duke Croix collected (709)
Seat 4: yairpinto (button) folded before Flop (didn't bet)
Seat 6: color_singleton (small blind) folded before Flop
Seat 8: JeBoyDirk (big blind) folded before Flop



PokerStars Home Game Hand #218084295132: {Club #3225207}  Hold'em No Limit (50/100) - 2020/09/03 15:17:13 ET
Table 'fun gamez' 9-max (Play Money) Seat #6 is the button
Seat 1: dddocky (17455 in chips) 
Seat 2: FragileMemory (10000 in chips) 
Seat 3: Duke Croix (21840 in chips) 
Seat 4: yairpinto (7670 in chips) 
Seat 6: color_singleton (13830 in chips) 
Seat 8: JeBoyDirk (13748 in chips) 
JeBoyDirk: posts small blind 50
dddocky: posts big blind 100
*** HOLE CARDS ***
Dealt to Duke Croix [Ts Tc]
Manon541 leaves the table
FragileMemory: folds 
Duke Croix: raises 300 to 400
yairpinto: folds 
color_singleton: folds 
JeBoyDirk: folds 
dddocky: folds 
Uncalled bet (300) returned to Duke Croix
Duke Croix collected 250 from pot
*** SUMMARY ***
Total pot 250 | Rake 0 
Seat 1: dddocky (big blind) folded before Flop
Seat 2: FragileMemory folded before Flop (didn't bet)
Seat 3: Duke Croix collected (250)
Seat 4: yairpinto folded before Flop (didn't bet)
Seat 6: color_singleton (button) folded before Flop (didn't bet)
Seat 8: JeBoyDirk (small blind) folded before Flop



PokerStars Home Game Hand #218084307913: {Club #3225207}  Hold'em No Limit (50/100) - 2020/09/03 15:17:33 ET
Table 'fun gamez' 9-max (Play Money) Seat #8 is the button
Seat 1: dddocky (17355 in chips) 
Seat 2: FragileMemory (10000 in chips) 
Seat 3: Duke Croix (21990 in chips) 
Seat 4: yairpinto (7670 in chips) 
Seat 6: color_singleton (13830 in chips) 
Seat 8: JeBoyDirk (13698 in chips) 
dddocky: posts small blind 50
FragileMemory: posts big blind 100
*** HOLE CARDS ***
Dealt to Duke Croix [Jc As]
Duke Croix: raises 300 to 400
yairpinto: folds 
color_singleton: folds 
JeBoyDirk: folds 
dddocky: folds 
FragileMemory: folds 
Uncalled bet (300) returned to Duke Croix
Duke Croix collected 250 from pot
*** SUMMARY ***
Total pot 250 | Rake 0 
Seat 1: dddocky (small blind) folded before Flop
Seat 2: FragileMemory (big blind) folded before Flop
Seat 3: Duke Croix collected (250)
Seat 4: yairpinto folded before Flop (didn't bet)
Seat 6: color_singleton folded before Flop (didn't bet)
Seat 8: JeBoyDirk (button) folded before Flop (didn't bet)



PokerStars Home Game Hand #218084320315: {Club #3225207}  Hold'em No Limit (50/100) - 2020/09/03 15:17:52 ET
Table 'fun gamez' 9-max (Play Money) Seat #1 is the button
Seat 1: dddocky (17305 in chips) 
Seat 2: FragileMemory (9900 in chips) 
Seat 3: Duke Croix (22140 in chips) 
Seat 4: yairpinto (7670 in chips) 
Seat 6: color_singleton (13830 in chips) 
Seat 8: JeBoyDirk (13698 in chips) 
FragileMemory: posts small blind 50
Duke Croix: posts big blind 100
*** HOLE CARDS ***
Dealt to Duke Croix [4d 6h]
yairpinto: folds 
color_singleton: folds 
JeBoyDirk: calls 100
dddocky: folds 
FragileMemory: calls 50
Duke Croix: checks 
*** FLOP *** [6s 3c 9h]
FragileMemory: checks 
Duke Croix: checks 
JeBoyDirk: checks 
*** TURN *** [6s 3c 9h] [As]
FragileMemory: bets 100
Duke Croix: calls 100
JeBoyDirk: calls 100
*** RIVER *** [6s 3c 9h As] [6c]
FragileMemory: bets 283
Duke Croix: raises 517 to 800
JeBoyDirk: raises 1100 to 1900
FragileMemory: raises 1100 to 3000
Duke Croix: calls 2200
JeBoyDirk: raises 4400 to 7400
FragileMemory: calls 4400
Duke Croix: folds 
*** SHOW DOWN ***
JeBoyDirk: shows [9s 9c] (a full house, Nines full of Sixes)
FragileMemory: mucks hand 
JeBoyDirk collected 17388 from pot
*** SUMMARY ***
Total pot 18400 | Rake 1012 
Board [6s 3c 9h As 6c]
Seat 1: dddocky (button) folded before Flop (didn't bet)
Seat 2: FragileMemory (small blind) mucked [6d Kc]
Seat 3: Duke Croix (big blind) folded on the River
Seat 4: yairpinto folded before Flop (didn't bet)
Seat 6: color_singleton folded before Flop (didn't bet)
Seat 8: JeBoyDirk showed [9s 9c] and won (17388) with a full house, Nines full of Sixes



PokerStars Home Game Hand #218084376478: {Club #3225207}  Hold'em No Limit (50/100) - 2020/09/03 15:19:20 ET
Table 'fun gamez' 9-max (Play Money) Seat #2 is the button
Seat 1: dddocky (17305 in chips) 
Seat 2: FragileMemory (2300 in chips) 
Seat 3: Duke Croix (18940 in chips) 
Seat 4: yairpinto (7670 in chips) 
Seat 6: color_singleton (13830 in chips) 
Seat 8: JeBoyDirk (23486 in chips) 
Duke Croix: posts small blind 50
yairpinto: posts big blind 100
*** HOLE CARDS ***
Dealt to Duke Croix [As Jh]
color_singleton: folds 
JeBoyDirk: folds 
dddocky: calls 100
FragileMemory: calls 100
Duke Croix: raises 300 to 400
yairpinto: folds 
dddocky: calls 300
FragileMemory: calls 300
*** FLOP *** [4c Qs 8c]
Duke Croix: checks 
dddocky: checks 
FragileMemory: bets 1900 and is all-in
Duke Croix: folds 
dddocky: folds 
Uncalled bet (1900) returned to FragileMemory
FragileMemory collected 1228 from pot
FragileMemory: doesn't show hand 
*** SUMMARY ***
Total pot 1300 | Rake 72 
Board [4c Qs 8c]
Seat 1: dddocky folded on the Flop
Seat 2: FragileMemory (button) collected (1228)
Seat 3: Duke Croix (small blind) folded on the Flop
Seat 4: yairpinto (big blind) folded before Flop
Seat 6: color_singleton folded before Flop (didn't bet)
Seat 8: JeBoyDirk folded before Flop (didn't bet)



PokerStars Home Game Hand #218084404760: {Club #3225207}  Hold'em No Limit (50/100) - 2020/09/03 15:20:04 ET
Table 'fun gamez' 9-max (Play Money) Seat #3 is the button
Seat 1: dddocky (16905 in chips) 
Seat 2: FragileMemory (3128 in chips) 
Seat 3: Duke Croix (18540 in chips) 
Seat 4: yairpinto (7570 in chips) 
Seat 6: color_singleton (13830 in chips) 
Seat 8: JeBoyDirk (23486 in chips) 
yairpinto: posts small blind 50
color_singleton: posts big blind 100
*** HOLE CARDS ***
Dealt to Duke Croix [Jd 7s]
JeBoyDirk: folds 
dddocky: calls 100
FragileMemory: folds 
Duke Croix: folds 
yairpinto: calls 50
color_singleton: checks 
*** FLOP *** [Th 3d 3h]
yairpinto: checks 
color_singleton: bets 141
dddocky: calls 141
yairpinto: folds 
*** TURN *** [Th 3d 3h] [6d]
color_singleton: bets 550
dddocky: folds 
Uncalled bet (550) returned to color_singleton
color_singleton collected 550 from pot
color_singleton: doesn't show hand 
*** SUMMARY ***
Total pot 582 | Rake 32 
Board [Th 3d 3h 6d]
Seat 1: dddocky folded on the Turn
Seat 2: FragileMemory folded before Flop (didn't bet)
Seat 3: Duke Croix (button) folded before Flop (didn't bet)
Seat 4: yairpinto (small blind) folded on the Flop
Seat 6: color_singleton (big blind) collected (550)
Seat 8: JeBoyDirk folded before Flop (didn't bet)



PokerStars Home Game Hand #218084427770: {Club #3225207}  Hold'em No Limit (50/100) - 2020/09/03 15:20:40 ET
Table 'fun gamez' 9-max (Play Money) Seat #4 is the button
Seat 1: dddocky (16664 in chips) 
Seat 2: FragileMemory (3128 in chips) 
Seat 3: Duke Croix (18540 in chips) 
Seat 4: yairpinto (7470 in chips) 
Seat 6: color_singleton (14139 in chips) 
Seat 8: JeBoyDirk (23486 in chips) 
color_singleton: posts small blind 50
JeBoyDirk: posts big blind 100
*** HOLE CARDS ***
Dealt to Duke Croix [7h 4d]
dddocky: folds 
FragileMemory: folds 
Duke Croix: folds 
yairpinto: raises 200 to 300
color_singleton: folds 
Manon947 joins the table at seat #9 
JeBoyDirk: calls 200
*** FLOP *** [7c 8c Th]
JeBoyDirk: checks 
yairpinto: bets 307
JeBoyDirk: raises 307 to 614
yairpinto: calls 307
*** TURN *** [7c 8c Th] [Kh]
JeBoyDirk: checks 
yairpinto: checks 
*** RIVER *** [7c 8c Th Kh] [3h]
JeBoyDirk: bets 1000
yairpinto: folds 
Uncalled bet (1000) returned to JeBoyDirk
JeBoyDirk collected 1775 from pot
*** SUMMARY ***
Total pot 1878 | Rake 103 
Board [7c 8c Th Kh 3h]
Seat 1: dddocky folded before Flop (didn't bet)
Seat 2: FragileMemory folded before Flop (didn't bet)
Seat 3: Duke Croix folded before Flop (didn't bet)
Seat 4: yairpinto (button) folded on the River
Seat 6: color_singleton (small blind) folded before Flop
Seat 8: JeBoyDirk (big blind) collected (1775)



PokerStars Home Game Hand #218084463295: {Club #3225207}  Hold'em No Limit (50/100) - 2020/09/03 15:21:34 ET
Table 'fun gamez' 9-max (Play Money) Seat #6 is the button
Seat 1: dddocky (16664 in chips) 
Seat 2: FragileMemory (3128 in chips) 
Seat 3: Duke Croix (18540 in chips) 
Seat 4: yairpinto (6556 in chips) 
Seat 6: color_singleton (14089 in chips) 
Seat 8: JeBoyDirk (24347 in chips) 
Seat 9: Manon947 (10000 in chips) 
JeBoyDirk: posts small blind 50
Manon947: posts big blind 100
*** HOLE CARDS ***
Dealt to Duke Croix [Ts Ks]
dddocky: folds 
FragileMemory: calls 100
Duke Croix: raises 300 to 400
yairpinto: folds 
color_singleton: folds 
JeBoyDirk: folds 
Manon947: folds 
FragileMemory: folds 
Uncalled bet (300) returned to Duke Croix
Duke Croix collected 350 from pot
*** SUMMARY ***
Total pot 350 | Rake 0 
Seat 1: dddocky folded before Flop (didn't bet)
Seat 2: FragileMemory folded before Flop
Seat 3: Duke Croix collected (350)
Seat 4: yairpinto folded before Flop (didn't bet)
Seat 6: color_singleton (button) folded before Flop (didn't bet)
Seat 8: JeBoyDirk (small blind) folded before Flop
Seat 9: Manon947 (big blind) folded before Flop



PokerStars Home Game Hand #218084481877: {Club #3225207}  Hold'em No Limit (50/100) - 2020/09/03 15:22:03 ET
Table 'fun gamez' 9-max (Play Money) Seat #8 is the button
Seat 1: dddocky (16664 in chips) 
Seat 2: FragileMemory (3028 in chips) 
Seat 3: Duke Croix (18790 in chips) 
Seat 4: yairpinto (6556 in chips) 
Seat 6: color_singleton (14089 in chips) 
Seat 8: JeBoyDirk (24297 in chips) 
Seat 9: Manon947 (9900 in chips) 
Manon947: posts small blind 50
dddocky: posts big blind 100
*** HOLE CARDS ***
Dealt to Duke Croix [5c 7d]
FragileMemory: folds 
Duke Croix: folds 
yairpinto: calls 100
color_singleton: folds 
JeBoyDirk: folds 
Manon947: calls 50
dddocky: checks 
*** FLOP *** [2s Kc 6c]
Manon947: checks 
dddocky: checks 
yairpinto: bets 141
Manon947: calls 141
dddocky: calls 141
*** TURN *** [2s Kc 6c] [Jd]
Manon947: checks 
dddocky: checks 
yairpinto: bets 683
Manon947: folds 
dddocky: folds 
Uncalled bet (683) returned to yairpinto
yairpinto collected 683 from pot
yairpinto: doesn't show hand 
*** SUMMARY ***
Total pot 723 | Rake 40 
Board [2s Kc 6c Jd]
Seat 1: dddocky (big blind) folded on the Turn
Seat 2: FragileMemory folded before Flop (didn't bet)
Seat 3: Duke Croix folded before Flop (didn't bet)
Seat 4: yairpinto collected (683)
Seat 6: color_singleton folded before Flop (didn't bet)
Seat 8: JeBoyDirk (button) folded before Flop (didn't bet)
Seat 9: Manon947 (small blind) folded on the Turn



PokerStars Home Game Hand #218084510542: {Club #3225207}  Hold'em No Limit (50/100) - 2020/09/03 15:22:48 ET
Table 'fun gamez' 9-max (Play Money) Seat #9 is the button
Seat 1: dddocky (16423 in chips) 
Seat 3: Duke Croix (18790 in chips) 
Seat 4: yairpinto (6998 in chips) 
Seat 6: color_singleton (14089 in chips) 
Seat 8: JeBoyDirk (24297 in chips) 
Seat 9: Manon947 (9659 in chips) 
dddocky: posts small blind 50
FragileMemory: is sitting out 
Duke Croix: posts big blind 100
*** HOLE CARDS ***
Dealt to Duke Croix [6s 8h]
yairpinto: folds 
color_singleton: folds 
JeBoyDirk: folds 
Manon947: folds 
dddocky: calls 50
Duke Croix: checks 
*** FLOP *** [Js 7s 6d]
dddocky: checks 
Duke Croix: checks 
*** TURN *** [Js 7s 6d] [Ac]
dddocky: checks 
Duke Croix: bets 200
dddocky: folds 
Uncalled bet (200) returned to Duke Croix
Duke Croix collected 189 from pot
*** SUMMARY ***
Total pot 200 | Rake 11 
Board [Js 7s 6d Ac]
Seat 1: dddocky (small blind) folded on the Turn
Seat 3: Duke Croix (big blind) collected (189)
Seat 4: yairpinto folded before Flop (didn't bet)
Seat 6: color_singleton folded before Flop (didn't bet)
Seat 8: JeBoyDirk folded before Flop (didn't bet)
Seat 9: Manon947 (button) folded before Flop (didn't bet)



PokerStars Home Game Hand #218084538584: {Club #3225207}  Hold'em No Limit (50/100) - 2020/09/03 15:23:20 ET
Table 'fun gamez' 9-max (Play Money) Seat #1 is the button
Seat 1: dddocky (16323 in chips) 
Seat 3: Duke Croix (18879 in chips) 
Seat 4: yairpinto (6998 in chips) 
Seat 6: color_singleton (14089 in chips) 
Seat 8: JeBoyDirk (24297 in chips) 
Seat 9: Manon947 (9659 in chips) 
Duke Croix: posts small blind 50
yairpinto: posts big blind 100
*** HOLE CARDS ***
Dealt to Duke Croix [3c 7c]
color_singleton: folds 
JeBoyDirk: folds 
Manon947: folds 
dddocky: calls 100
Duke Croix: calls 50
yairpinto: checks 
*** FLOP *** [2d Td 5c]
Duke Croix: checks 
yairpinto: bets 141
dddocky: calls 141
Duke Croix: folds 
*** TURN *** [2d Td 5c] [2h]
yairpinto: bets 275
dddocky: calls 275
*** RIVER *** [2d Td 5c 2h] [8d]
yairpinto: bets 1070
dddocky: calls 1070
*** SHOW DOWN ***
yairpinto: shows [Qd 3d] (a flush, Queen high)
dddocky: mucks hand 
yairpinto collected 3092 from pot
*** SUMMARY ***
Total pot 3272 | Rake 180 
Board [2d Td 5c 2h 8d]
Seat 1: dddocky (button) mucked [2c Qc]
Seat 3: Duke Croix (small blind) folded on the Flop
Seat 4: yairpinto (big blind) showed [Qd 3d] and won (3092) with a flush, Queen high
Seat 6: color_singleton folded before Flop (didn't bet)
Seat 8: JeBoyDirk folded before Flop (didn't bet)
Seat 9: Manon947 folded before Flop (didn't bet)



PokerStars Home Game Hand #218084562024: {Club #3225207}  Hold'em No Limit (50/100) - 2020/09/03 15:23:56 ET
Table 'fun gamez' 9-max (Play Money) Seat #3 is the button
Seat 1: dddocky (14737 in chips) 
Seat 2: FragileMemory (3028 in chips) 
Seat 3: Duke Croix (18779 in chips) 
Seat 4: yairpinto (8504 in chips) 
Seat 6: color_singleton (14089 in chips) 
Seat 8: JeBoyDirk (24297 in chips) 
Seat 9: Manon947 (9659 in chips) 
yairpinto: posts small blind 50
color_singleton: posts big blind 100
FragileMemory: posts small & big blinds 150
*** HOLE CARDS ***
Dealt to Duke Croix [Ks Qh]
JeBoyDirk: raises 200 to 300
Manon947: calls 300
dddocky: calls 300
FragileMemory: calls 200
Duke Croix: calls 300
yairpinto: folds 
color_singleton: calls 200
*** FLOP *** [8s 5s As]
color_singleton: checks 
JeBoyDirk: checks 
Manon947: checks 
dddocky: bets 1795
FragileMemory: folds 
Duke Croix: folds 
color_singleton: folds 
JeBoyDirk: folds 
Manon947: folds 
Uncalled bet (1795) returned to dddocky
dddocky collected 1795 from pot
dddocky: doesn't show hand 
*** SUMMARY ***
Total pot 1900 | Rake 105 
Board [8s 5s As]
Seat 1: dddocky collected (1795)
Seat 2: FragileMemory folded on the Flop
Seat 3: Duke Croix (button) folded on the Flop
Seat 4: yairpinto (small blind) folded before Flop
Seat 6: color_singleton (big blind) folded on the Flop
Seat 8: JeBoyDirk folded on the Flop
Seat 9: Manon947 folded on the Flop



PokerStars Home Game Hand #218084592039: {Club #3225207}  Hold'em No Limit (50/100) - 2020/09/03 15:24:43 ET
Table 'fun gamez' 9-max (Play Money) Seat #4 is the button
Seat 1: dddocky (16232 in chips) 
Seat 2: FragileMemory (2678 in chips) 
Seat 3: Duke Croix (18479 in chips) 
Seat 4: yairpinto (8454 in chips) 
Seat 6: color_singleton (13789 in chips) 
Seat 8: JeBoyDirk (23997 in chips) 
Seat 9: Manon947 (9359 in chips) 
color_singleton: posts small blind 50
JeBoyDirk: posts big blind 100
*** HOLE CARDS ***
Dealt to Duke Croix [3s 5c]
Manon947: calls 100
dddocky: calls 100
FragileMemory: folds 
Duke Croix: folds 
yairpinto: folds 
color_singleton: calls 50
JeBoyDirk: checks 
*** FLOP *** [2d 6d 9h]
color_singleton: bets 189
JeBoyDirk: calls 189
Manon947: folds 
dddocky: calls 189
*** TURN *** [2d 6d 9h] [Ts]
color_singleton: bets 457
JeBoyDirk: folds 
dddocky: folds 
Uncalled bet (457) returned to color_singleton
color_singleton collected 914 from pot
color_singleton: doesn't show hand 
*** SUMMARY ***
Total pot 967 | Rake 53 
Board [2d 6d 9h Ts]
Seat 1: dddocky folded on the Turn
Seat 2: FragileMemory folded before Flop (didn't bet)
Seat 3: Duke Croix folded before Flop (didn't bet)
Seat 4: yairpinto (button) folded before Flop (didn't bet)
Seat 6: color_singleton (small blind) collected (914)
Seat 8: JeBoyDirk (big blind) folded on the Turn
Seat 9: Manon947 folded on the Flop



PokerStars Home Game Hand #218084612138: {Club #3225207}  Hold'em No Limit (50/100) - 2020/09/03 15:25:15 ET
Table 'fun gamez' 9-max (Play Money) Seat #6 is the button
Seat 1: dddocky (15943 in chips) 
Seat 2: FragileMemory (2678 in chips) 
Seat 3: Duke Croix (18479 in chips) 
Seat 4: yairpinto (8454 in chips) 
Seat 6: color_singleton (14414 in chips) 
Seat 8: JeBoyDirk (23708 in chips) 
Seat 9: Manon947 (9259 in chips) 
JeBoyDirk: posts small blind 50
Manon947: posts big blind 100
*** HOLE CARDS ***
Dealt to Duke Croix [4s 7s]
dddocky: folds 
FragileMemory: calls 100
Duke Croix: folds 
yairpinto: folds 
color_singleton: calls 100
JeBoyDirk: calls 50
Manon947: checks 
*** FLOP *** [Ac 8d 7d]
JeBoyDirk: checks 
Manon947: bets 189
FragileMemory: folds 
color_singleton: folds 
JeBoyDirk: calls 189
*** TURN *** [Ac 8d 7d] [7h]
JeBoyDirk: checks 
Manon947: bets 367
JeBoyDirk: calls 367
*** RIVER *** [Ac 8d 7d 7h] [Jc]
JeBoyDirk: checks 
Manon947: bets 1429
JeBoyDirk: calls 1429
*** SHOW DOWN ***
Manon947: shows [9s 9h] (two pair, Nines and Sevens)
JeBoyDirk: shows [4h Ad] (two pair, Aces and Sevens)
JeBoyDirk collected 4130 from pot
*** SUMMARY ***
Total pot 4370 | Rake 240 
Board [Ac 8d 7d 7h Jc]
Seat 1: dddocky folded before Flop (didn't bet)
Seat 2: FragileMemory folded on the Flop
Seat 3: Duke Croix folded before Flop (didn't bet)
Seat 4: yairpinto folded before Flop (didn't bet)
Seat 6: color_singleton (button) folded on the Flop
Seat 8: JeBoyDirk (small blind) showed [4h Ad] and won (4130) with two pair, Aces and Sevens
Seat 9: Manon947 (big blind) showed [9s 9h] and lost with two pair, Nines and Sevens



PokerStars Home Game Hand #218084644210: {Club #3225207}  Hold'em No Limit (50/100) - 2020/09/03 15:26:05 ET
Table 'fun gamez' 9-max (Play Money) Seat #8 is the button
Seat 1: dddocky (15943 in chips) 
Seat 2: FragileMemory (2578 in chips) 
Seat 3: Duke Croix (18479 in chips) 
Seat 4: yairpinto (8454 in chips) 
Seat 6: color_singleton (14314 in chips) 
Seat 8: JeBoyDirk (25753 in chips) 
Seat 9: Manon947 (7174 in chips) 
Manon947: posts small blind 50
dddocky: posts big blind 100
*** HOLE CARDS ***
Dealt to Duke Croix [Jc Kd]
FragileMemory: calls 100
Duke Croix: raises 300 to 400
yairpinto: folds 
color_singleton: calls 400
JeBoyDirk: folds 
Manon947 has timed out
Manon947: folds 
dddocky: folds 
FragileMemory: calls 300
*** FLOP *** [Ah Ad 2c]
FragileMemory: checks 
Duke Croix: checks 
color_singleton: checks 
*** TURN *** [Ah Ad 2c] [6c]
FragileMemory: checks 
Duke Croix: checks 
color_singleton: checks 
*** RIVER *** [Ah Ad 2c 6c] [Qd]
FragileMemory: checks 
Duke Croix: checks 
color_singleton: checks 
*** SHOW DOWN ***
FragileMemory: shows [Td 4d] (a pair of Aces)
Duke Croix: shows [Jc Kd] (a pair of Aces - King kicker)
color_singleton: mucks hand 
Duke Croix collected 1276 from pot
*** SUMMARY ***
Total pot 1350 | Rake 74 
Board [Ah Ad 2c 6c Qd]
Seat 1: dddocky (big blind) folded before Flop
Seat 2: FragileMemory showed [Td 4d] and lost with a pair of Aces
Seat 3: Duke Croix showed [Jc Kd] and won (1276) with a pair of Aces
Seat 4: yairpinto folded before Flop (didn't bet)
Seat 6: color_singleton mucked [9h Kc]
Seat 8: JeBoyDirk (button) folded before Flop (didn't bet)
Seat 9: Manon947 (small blind) folded before Flop



PokerStars Home Game Hand #218084688478: {Club #3225207}  Hold'em No Limit (50/100) - 2020/09/03 15:27:06 ET
Table 'fun gamez' 9-max (Play Money) Seat #1 is the button
Seat 1: dddocky (15843 in chips) 
Seat 2: FragileMemory (2178 in chips) 
Seat 3: Duke Croix (19355 in chips) 
Seat 4: yairpinto (8454 in chips) 
Seat 6: color_singleton (13914 in chips) 
Seat 8: JeBoyDirk (25753 in chips) 
FragileMemory: posts small blind 50
Duke Croix: posts big blind 100
*** HOLE CARDS ***
Dealt to Duke Croix [6d Kh]
yairpinto: folds 
color_singleton: folds 
JeBoyDirk: calls 100
dddocky: calls 100
FragileMemory: folds 
Duke Croix: checks 
*** FLOP *** [Jh 7d 7s]
Duke Croix: checks 
JeBoyDirk: checks 
dddocky: bets 100
Duke Croix: folds 
JeBoyDirk: calls 100
*** TURN *** [Jh 7d 7s] [Qh]
JeBoyDirk: checks 
dddocky: bets 100
JeBoyDirk: calls 100
*** RIVER *** [Jh 7d 7s Qh] [8d]
JeBoyDirk: checks 
dddocky: bets 100
JeBoyDirk: raises 600 to 700
dddocky: calls 600
*** SHOW DOWN ***
JeBoyDirk: shows [7c 8c] (a full house, Sevens full of Eights)
dddocky: mucks hand 
JeBoyDirk collected 2032 from pot
*** SUMMARY ***
Total pot 2150 | Rake 118 
Board [Jh 7d 7s Qh 8d]
Seat 1: dddocky (button) mucked [3h Jd]
Seat 2: FragileMemory (small blind) folded before Flop
Seat 3: Duke Croix (big blind) folded on the Flop
Seat 4: yairpinto folded before Flop (didn't bet)
Seat 6: color_singleton folded before Flop (didn't bet)
Seat 8: JeBoyDirk showed [7c 8c] and won (2032) with a full house, Sevens full of Eights



PokerStars Home Game Hand #218084720934: {Club #3225207}  Hold'em No Limit (50/100) - 2020/09/03 15:27:58 ET
Table 'fun gamez' 9-max (Play Money) Seat #2 is the button
Seat 1: dddocky (14843 in chips) 
Seat 2: FragileMemory (2128 in chips) 
Seat 3: Duke Croix (19255 in chips) 
Seat 4: yairpinto (8454 in chips) 
Seat 6: color_singleton (13914 in chips) 
Seat 8: JeBoyDirk (26785 in chips) 
Duke Croix: posts small blind 50
yairpinto: posts big blind 100
*** HOLE CARDS ***
Dealt to Duke Croix [2d 4d]
color_singleton: folds 
JeBoyDirk: folds 
dddocky: calls 100
FragileMemory: folds 
Duke Croix: calls 50
yairpinto: checks 
*** FLOP *** [9s 8d Kd]
Duke Croix: bets 200
yairpinto: folds 
dddocky: folds 
Uncalled bet (200) returned to Duke Croix
Duke Croix collected 283 from pot
*** SUMMARY ***
Total pot 300 | Rake 17 
Board [9s 8d Kd]
Seat 1: dddocky folded on the Flop
Seat 2: FragileMemory (button) folded before Flop (didn't bet)
Seat 3: Duke Croix (small blind) collected (283)
Seat 4: yairpinto (big blind) folded on the Flop
Seat 6: color_singleton folded before Flop (didn't bet)
Seat 8: JeBoyDirk folded before Flop (didn't bet)



PokerStars Home Game Hand #218084750468: {Club #3225207}  Hold'em No Limit (50/100) - 2020/09/03 15:28:44 ET
Table 'fun gamez' 9-max (Play Money) Seat #3 is the button
Seat 1: dddocky (14743 in chips) 
Seat 2: FragileMemory (2128 in chips) 
Seat 3: Duke Croix (19438 in chips) 
Seat 4: yairpinto (8354 in chips) 
Seat 6: color_singleton (13914 in chips) 
Seat 8: JeBoyDirk (26785 in chips) 
yairpinto: posts small blind 50
color_singleton: posts big blind 100
*** HOLE CARDS ***
Dealt to Duke Croix [Jd Ad]
JeBoyDirk: calls 100
dddocky: calls 100
FragileMemory: folds 
Duke Croix: raises 400 to 500
yairpinto: folds 
color_singleton: calls 400
JeBoyDirk: calls 400
dddocky: calls 400
*** FLOP *** [Ts Qc 4h]
color_singleton: checks 
JeBoyDirk: checks 
dddocky: checks 
Duke Croix: checks 
*** TURN *** [Ts Qc 4h] [7s]
color_singleton: checks 
JeBoyDirk: bets 800
dddocky: folds 
Duke Croix: folds 
color_singleton: folds 
Uncalled bet (800) returned to JeBoyDirk
JeBoyDirk collected 1937 from pot
*** SUMMARY ***
Total pot 2050 | Rake 113 
Board [Ts Qc 4h 7s]
Seat 1: dddocky folded on the Turn
Seat 2: FragileMemory folded before Flop (didn't bet)
Seat 3: Duke Croix (button) folded on the Turn
Seat 4: yairpinto (small blind) folded before Flop
Seat 6: color_singleton (big blind) folded on the Turn
Seat 8: JeBoyDirk collected (1937)



PokerStars Home Game Hand #218084783606: {Club #3225207}  Hold'em No Limit (50/100) - 2020/09/03 15:29:37 ET
Table 'fun gamez' 9-max (Play Money) Seat #4 is the button
Seat 1: dddocky (14243 in chips) 
Seat 2: FragileMemory (2128 in chips) 
Seat 3: Duke Croix (18938 in chips) 
Seat 4: yairpinto (8304 in chips) 
Seat 6: color_singleton (13414 in chips) 
Seat 8: JeBoyDirk (28222 in chips) 
color_singleton: posts small blind 50
JeBoyDirk: posts big blind 100
*** HOLE CARDS ***
Dealt to Duke Croix [Th 7s]
dddocky: calls 100
FragileMemory: folds 
Duke Croix: folds 
yairpinto: folds 
color_singleton: calls 50
JeBoyDirk: checks 
*** FLOP *** [Qh 9d Kc]
color_singleton: checks 
JeBoyDirk: checks 
dddocky: checks 
*** TURN *** [Qh 9d Kc] [9h]
color_singleton: checks 
JeBoyDirk: checks 
dddocky: checks 
*** RIVER *** [Qh 9d Kc 9h] [3h]
color_singleton: bets 600
JeBoyDirk: folds 
dddocky: raises 600 to 1200
color_singleton: raises 1800 to 3000
dddocky: calls 1800
*** SHOW DOWN ***
color_singleton: shows [Qc 9s] (a full house, Nines full of Queens)
dddocky: mucks hand 
color_singleton collected 5953 from pot
*** SUMMARY ***
Total pot 6300 | Rake 347 
Board [Qh 9d Kc 9h 3h]
Seat 1: dddocky mucked [6h 7h]
Seat 2: FragileMemory folded before Flop (didn't bet)
Seat 3: Duke Croix folded before Flop (didn't bet)
Seat 4: yairpinto (button) folded before Flop (didn't bet)
Seat 6: color_singleton (small blind) showed [Qc 9s] and won (5953) with a full house, Nines full of Queens
Seat 8: JeBoyDirk (big blind) folded on the River



PokerStars Home Game Hand #218084826489: {Club #3225207}  Hold'em No Limit (50/100) - 2020/09/03 15:30:46 ET
Table 'fun gamez' 9-max (Play Money) Seat #6 is the button
Seat 1: dddocky (11143 in chips) 
Seat 2: FragileMemory (2128 in chips) 
Seat 3: Duke Croix (18938 in chips) 
Seat 4: yairpinto (8304 in chips) 
Seat 6: color_singleton (16267 in chips) 
Seat 8: JeBoyDirk (28122 in chips) 
JeBoyDirk: posts small blind 50
dddocky: posts big blind 100
*** HOLE CARDS ***
Dealt to Duke Croix [3h Kh]
FragileMemory: folds 
Duke Croix: folds 
yairpinto: folds 
color_singleton: raises 300 to 400
JeBoyDirk: folds 
dddocky: folds 
Uncalled bet (300) returned to color_singleton
color_singleton collected 250 from pot
color_singleton: doesn't show hand 
*** SUMMARY ***
Total pot 250 | Rake 0 
Seat 1: dddocky (big blind) folded before Flop
Seat 2: FragileMemory folded before Flop (didn't bet)
Seat 3: Duke Croix folded before Flop (didn't bet)
Seat 4: yairpinto folded before Flop (didn't bet)
Seat 6: color_singleton (button) collected (250)
Seat 8: JeBoyDirk (small blind) folded before Flop



PokerStars Home Game Hand #218084837372: {Club #3225207}  Hold'em No Limit (50/100) - 2020/09/03 15:31:03 ET
Table 'fun gamez' 9-max (Play Money) Seat #8 is the button
Seat 1: dddocky (11043 in chips) 
Seat 2: FragileMemory (2128 in chips) 
Seat 3: Duke Croix (18938 in chips) 
Seat 4: yairpinto (8304 in chips) 
Seat 6: color_singleton (16417 in chips) 
Seat 8: JeBoyDirk (28072 in chips) 
dddocky: posts small blind 50
FragileMemory: posts big blind 100
*** HOLE CARDS ***
Dealt to Duke Croix [5c 7c]
Duke Croix: calls 100
yairpinto: calls 100
color_singleton: calls 100
JeBoyDirk has timed out
JeBoyDirk: folds 
dddocky: calls 50
FragileMemory: checks 
*** FLOP *** [As Ad Ts]
dddocky: checks 
FragileMemory: checks 
Duke Croix: checks 
yairpinto: checks 
color_singleton: checks 
*** TURN *** [As Ad Ts] [3d]
dddocky: checks 
FragileMemory: checks 
Duke Croix: checks 
yairpinto: checks 
color_singleton: checks 
*** RIVER *** [As Ad Ts 3d] [4h]
dddocky: checks 
FragileMemory: checks 
Duke Croix: checks 
yairpinto: checks 
color_singleton: checks 
*** SHOW DOWN ***
dddocky: shows [9c 6c] (a pair of Aces)
FragileMemory: shows [Tc Qh] (two pair, Aces and Tens)
Duke Croix: mucks hand 
yairpinto: mucks hand 
color_singleton: mucks hand 
FragileMemory collected 472 from pot
*** SUMMARY ***
Total pot 500 | Rake 28 
Board [As Ad Ts 3d 4h]
Seat 1: dddocky (small blind) showed [9c 6c] and lost with a pair of Aces
Seat 2: FragileMemory (big blind) showed [Tc Qh] and won (472) with two pair, Aces and Tens
Seat 3: Duke Croix mucked [5c 7c]
Seat 4: yairpinto mucked [8h 6h]
Seat 6: color_singleton mucked [4c Qs]
Seat 8: JeBoyDirk (button) folded before Flop (didn't bet)



PokerStars Home Game Hand #218084895587: {Club #3225207}  Hold'em No Limit (50/100) - 2020/09/03 15:32:36 ET
Table 'fun gamez' 9-max (Play Money) Seat #1 is the button
Seat 1: dddocky (10943 in chips) 
Seat 2: FragileMemory (2500 in chips) 
Seat 3: Duke Croix (18838 in chips) 
Seat 4: yairpinto (8204 in chips) 
Seat 6: color_singleton (16317 in chips) 
Seat 8: JeBoyDirk (28072 in chips) 
Seat 9: Manon947 (7124 in chips) 
FragileMemory: posts small blind 50
Duke Croix: posts big blind 100
Manon947: posts small & big blinds 150
*** HOLE CARDS ***
Dealt to Duke Croix [As 2d]
yairpinto: folds 
color_singleton: raises 100 to 200
JeBoyDirk: folds 
Manon947: folds 
dddocky: calls 200
FragileMemory: folds 
Duke Croix: calls 100
*** FLOP *** [4d 7d 6h]
Duke Croix: checks 
color_singleton: bets 378
dddocky: folds 
Duke Croix: folds 
Uncalled bet (378) returned to color_singleton
color_singleton collected 756 from pot
color_singleton: doesn't show hand 
*** SUMMARY ***
Total pot 800 | Rake 44 
Board [4d 7d 6h]
Seat 1: dddocky (button) folded on the Flop
Seat 2: FragileMemory (small blind) folded before Flop
Seat 3: Duke Croix (big blind) folded on the Flop
Seat 4: yairpinto folded before Flop (didn't bet)
Seat 6: color_singleton collected (756)
Seat 8: JeBoyDirk folded before Flop (didn't bet)
Seat 9: Manon947 folded before Flop (didn't bet)



PokerStars Home Game Hand #218084914770: {Club #3225207}  Hold'em No Limit (50/100) - 2020/09/03 15:33:07 ET
Table 'fun gamez' 9-max (Play Money) Seat #2 is the button
Seat 1: dddocky (10743 in chips) 
Seat 2: FragileMemory (2450 in chips) 
Seat 3: Duke Croix (18638 in chips) 
Seat 4: yairpinto (8204 in chips) 
Seat 6: color_singleton (16873 in chips) 
Seat 8: JeBoyDirk (28072 in chips) 
Seat 9: Manon947 (6974 in chips) 
Duke Croix: posts small blind 50
yairpinto: posts big blind 100
*** HOLE CARDS ***
Dealt to Duke Croix [Ad 3c]
color_singleton: raises 200 to 300
JeBoyDirk: folds 
Manon947: folds 
dddocky: folds 
FragileMemory: folds 
Duke Croix: folds 
yairpinto: folds 
Uncalled bet (200) returned to color_singleton
color_singleton collected 250 from pot
color_singleton: doesn't show hand 
*** SUMMARY ***
Total pot 250 | Rake 0 
Seat 1: dddocky folded before Flop (didn't bet)
Seat 2: FragileMemory (button) folded before Flop (didn't bet)
Seat 3: Duke Croix (small blind) folded before Flop
Seat 4: yairpinto (big blind) folded before Flop
Seat 6: color_singleton collected (250)
Seat 8: JeBoyDirk folded before Flop (didn't bet)
Seat 9: Manon947 folded before Flop (didn't bet)



PokerStars Home Game Hand #218084926951: {Club #3225207}  Hold'em No Limit (50/100) - 2020/09/03 15:33:26 ET
Table 'fun gamez' 9-max (Play Money) Seat #3 is the button
Seat 1: dddocky (10743 in chips) 
Seat 2: FragileMemory (2450 in chips) 
Seat 3: Duke Croix (18588 in chips) 
Seat 4: yairpinto (8104 in chips) 
Seat 6: color_singleton (17023 in chips) 
Seat 8: JeBoyDirk (28072 in chips) 
Seat 9: Manon947 (6974 in chips) 
yairpinto: posts small blind 50
color_singleton: posts big blind 100
*** HOLE CARDS ***
Dealt to Duke Croix [Qc 4d]
JeBoyDirk: folds 
Manon947: folds 
dddocky: folds 
FragileMemory: folds 
Duke Croix: folds 
yairpinto: calls 50
color_singleton: checks 
*** FLOP *** [Ad 8s 9c]
yairpinto: bets 189
color_singleton: folds 
Uncalled bet (189) returned to yairpinto
yairpinto collected 189 from pot
yairpinto: doesn't show hand 
*** SUMMARY ***
Total pot 200 | Rake 11 
Board [Ad 8s 9c]
Seat 1: dddocky folded before Flop (didn't bet)
Seat 2: FragileMemory folded before Flop (didn't bet)
Seat 3: Duke Croix (button) folded before Flop (didn't bet)
Seat 4: yairpinto (small blind) collected (189)
Seat 6: color_singleton (big blind) folded on the Flop
Seat 8: JeBoyDirk folded before Flop (didn't bet)
Seat 9: Manon947 folded before Flop (didn't bet)



PokerStars Home Game Hand #218084944838: {Club #3225207}  Hold'em No Limit (50/100) - 2020/09/03 15:33:55 ET
Table 'fun gamez' 9-max (Play Money) Seat #4 is the button
Seat 1: dddocky (10743 in chips) 
Seat 2: FragileMemory (2450 in chips) 
Seat 3: Duke Croix (18588 in chips) 
Seat 4: yairpinto (8193 in chips) 
Seat 6: color_singleton (16923 in chips) 
Seat 8: JeBoyDirk (28072 in chips) 
Seat 9: Manon947 (6974 in chips) 
color_singleton: posts small blind 50
JeBoyDirk: posts big blind 100
*** HOLE CARDS ***
Dealt to Duke Croix [Ac 9d]
Manon947: folds 
dddocky: calls 100
FragileMemory: calls 100
Duke Croix: calls 100
yairpinto: calls 100
color_singleton: calls 50
JeBoyDirk: checks 
*** FLOP *** [9c Ks Th]
color_singleton: checks 
JeBoyDirk: checks 
dddocky: checks 
FragileMemory: bets 100
Duke Croix: calls 100
yairpinto: folds 
color_singleton: calls 100
JeBoyDirk: folds 
dddocky: calls 100
*** TURN *** [9c Ks Th] [Kh]
color_singleton: checks 
dddocky: checks 
FragileMemory: bets 472
Duke Croix: folds 
color_singleton: folds 
dddocky: folds 
Uncalled bet (472) returned to FragileMemory
FragileMemory collected 945 from pot
FragileMemory: doesn't show hand 
*** SUMMARY ***
Total pot 1000 | Rake 55 
Board [9c Ks Th Kh]
Seat 1: dddocky folded on the Turn
Seat 2: FragileMemory collected (945)
Seat 3: Duke Croix folded on the Turn
Seat 4: yairpinto (button) folded on the Flop
Seat 6: color_singleton (small blind) folded on the Turn
Seat 8: JeBoyDirk (big blind) folded on the Flop
Seat 9: Manon947 folded before Flop (didn't bet)



PokerStars Home Game Hand #218084989415: {Club #3225207}  Hold'em No Limit (50/100) - 2020/09/03 15:35:06 ET
Table 'fun gamez' 9-max (Play Money) Seat #6 is the button
Seat 1: dddocky (10543 in chips) 
Seat 2: FragileMemory (3195 in chips) 
Seat 3: Duke Croix (18388 in chips) 
Seat 4: yairpinto (8093 in chips) 
Seat 6: color_singleton (16723 in chips) 
Seat 8: JeBoyDirk (27972 in chips) 
Seat 9: Manon947 (6974 in chips) 
JeBoyDirk: posts small blind 50
Manon947: posts big blind 100
*** HOLE CARDS ***
Dealt to Duke Croix [4c Ks]
dddocky: folds 
FragileMemory: calls 100
Duke Croix: folds 
yairpinto: folds 
color_singleton: folds 
JeBoyDirk: raises 100 to 200
Manon947: calls 100
FragileMemory: calls 100
*** FLOP *** [5h 7s 2s]
JeBoyDirk: bets 300
Manon947: folds 
FragileMemory: folds 
Uncalled bet (300) returned to JeBoyDirk
JeBoyDirk collected 567 from pot
*** SUMMARY ***
Total pot 600 | Rake 33 
Board [5h 7s 2s]
Seat 1: dddocky folded before Flop (didn't bet)
Seat 2: FragileMemory folded on the Flop
Seat 3: Duke Croix folded before Flop (didn't bet)
Seat 4: yairpinto folded before Flop (didn't bet)
Seat 6: color_singleton (button) folded before Flop (didn't bet)
Seat 8: JeBoyDirk (small blind) collected (567)
Seat 9: Manon947 (big blind) folded on the Flop



PokerStars Home Game Hand #218085010562: {Club #3225207}  Hold'em No Limit (50/100) - 2020/09/03 15:35:39 ET
Table 'fun gamez' 9-max (Play Money) Seat #8 is the button
Seat 1: dddocky (10543 in chips) 
Seat 2: FragileMemory (2995 in chips) 
Seat 3: Duke Croix (18388 in chips) 
Seat 4: yairpinto (8093 in chips) 
Seat 6: color_singleton (16723 in chips) 
Seat 8: JeBoyDirk (28339 in chips) 
Seat 9: Manon947 (6774 in chips) 
Manon947: posts small blind 50
dddocky: posts big blind 100
*** HOLE CARDS ***
Dealt to Duke Croix [4d 8c]
FragileMemory: folds 
Duke Croix: folds 
yairpinto: folds 
color_singleton: folds 
JeBoyDirk: calls 100
Manon947: calls 50
dddocky: checks 
*** FLOP *** [2c Qd 8s]
Manon947: checks 
dddocky: checks 
JeBoyDirk: checks 
*** TURN *** [2c Qd 8s] [Tc]
Manon947: checks 
dddocky: checks 
JeBoyDirk: checks 
*** RIVER *** [2c Qd 8s Tc] [Jc]
Manon947: checks 
dddocky: bets 283
JeBoyDirk: folds 
Manon947: folds 
Uncalled bet (283) returned to dddocky
dddocky collected 283 from pot
dddocky: doesn't show hand 
*** SUMMARY ***
Total pot 300 | Rake 17 
Board [2c Qd 8s Tc Jc]
Seat 1: dddocky (big blind) collected (283)
Seat 2: FragileMemory folded before Flop (didn't bet)
Seat 3: Duke Croix folded before Flop (didn't bet)
Seat 4: yairpinto folded before Flop (didn't bet)
Seat 6: color_singleton folded before Flop (didn't bet)
Seat 8: JeBoyDirk (button) folded on the River
Seat 9: Manon947 (small blind) folded on the River



PokerStars Home Game Hand #218085038309: {Club #3225207}  Hold'em No Limit (50/100) - 2020/09/03 15:36:23 ET
Table 'fun gamez' 9-max (Play Money) Seat #9 is the button
Seat 1: dddocky (10726 in chips) 
Seat 2: FragileMemory (2995 in chips) 
Seat 3: Duke Croix (18388 in chips) 
Seat 4: yairpinto (8093 in chips) 
Seat 6: color_singleton (16723 in chips) 
Seat 8: JeBoyDirk (28239 in chips) 
Seat 9: Manon947 (6674 in chips) 
dddocky: posts small blind 50
FragileMemory: posts big blind 100
*** HOLE CARDS ***
Dealt to Duke Croix [4d Ad]
Duke Croix: raises 200 to 300
yairpinto: folds 
color_singleton: folds 
JeBoyDirk: folds 
Manon947: calls 300
dddocky: folds 
FragileMemory: folds 
*** FLOP *** [Jh Qd 8h]
Duke Croix: checks 
Manon947: checks 
*** TURN *** [Jh Qd 8h] [6c]
Duke Croix: bets 400
Manon947: folds 
Uncalled bet (400) returned to Duke Croix
Duke Croix collected 709 from pot
*** SUMMARY ***
Total pot 750 | Rake 41 
Board [Jh Qd 8h 6c]
Seat 1: dddocky (small blind) folded before Flop
Seat 2: FragileMemory (big blind) folded before Flop
Seat 3: Duke Croix collected (709)
Seat 4: yairpinto folded before Flop (didn't bet)
Seat 6: color_singleton folded before Flop (didn't bet)
Seat 8: JeBoyDirk folded before Flop (didn't bet)
Seat 9: Manon947 (button) folded on the Turn



PokerStars Home Game Hand #218085052901: {Club #3225207}  Hold'em No Limit (50/100) - 2020/09/03 15:36:45 ET
Table 'fun gamez' 9-max (Play Money) Seat #1 is the button
Seat 1: dddocky (10676 in chips) 
Seat 2: FragileMemory (2895 in chips) 
Seat 3: Duke Croix (18797 in chips) 
Seat 4: yairpinto (8093 in chips) 
Seat 6: color_singleton (16723 in chips) 
Seat 8: JeBoyDirk (28239 in chips) 
Seat 9: Manon947 (6374 in chips) 
FragileMemory: posts small blind 50
Duke Croix: posts big blind 100
*** HOLE CARDS ***
Dealt to Duke Croix [4h 3s]
yairpinto: calls 100
color_singleton has timed out
color_singleton: folds 
JeBoyDirk: calls 100
Manon947: folds 
dddocky: folds 
FragileMemory: calls 50
Duke Croix: checks 
*** FLOP *** [6c 6s 2s]
FragileMemory: checks 
Duke Croix: checks 
yairpinto: bets 189
JeBoyDirk: folds 
FragileMemory: folds 
Duke Croix: calls 189
*** TURN *** [6c 6s 2s] [Ts]
Duke Croix: checks 
yairpinto: bets 367
Duke Croix: folds 
Uncalled bet (367) returned to yairpinto
yairpinto collected 735 from pot
yairpinto: doesn't show hand 
*** SUMMARY ***
Total pot 778 | Rake 43 
Board [6c 6s 2s Ts]
Seat 1: dddocky (button) folded before Flop (didn't bet)
Seat 2: FragileMemory (small blind) folded on the Flop
Seat 3: Duke Croix (big blind) folded on the Turn
Seat 4: yairpinto collected (735)
Seat 6: color_singleton folded before Flop (didn't bet)
Seat 8: JeBoyDirk folded on the Flop
Seat 9: Manon947 folded before Flop (didn't bet)



PokerStars Home Game Hand #218085084227: {Club #3225207}  Hold'em No Limit (50/100) - 2020/09/03 15:37:35 ET
Table 'fun gamez' 9-max (Play Money) Seat #2 is the button
Seat 1: dddocky (10676 in chips) 
Seat 2: FragileMemory (2795 in chips) 
Seat 3: Duke Croix (18508 in chips) 
Seat 4: yairpinto (8539 in chips) 
Seat 8: JeBoyDirk (28139 in chips) 
Seat 9: Manon947 (6374 in chips) 
Duke Croix: posts small blind 50
yairpinto: posts big blind 100
*** HOLE CARDS ***
Dealt to Duke Croix [4h 5c]
JeBoyDirk: folds 
Manon947: calls 100
dddocky: calls 100
FragileMemory: folds 
Duke Croix: calls 50
yairpinto: checks 
*** FLOP *** [6h 6d 4s]
Duke Croix: bets 200
yairpinto: calls 200
Manon947: calls 200
dddocky: raises 200 to 400
Duke Croix: calls 200
yairpinto: calls 200
Manon947: calls 200
*** TURN *** [6h 6d 4s] [Ac]
Duke Croix: checks 
yairpinto: checks 
Manon947: checks 
dddocky: bets 1890
Duke Croix: folds 
yairpinto: folds 
Manon947: folds 
Uncalled bet (1890) returned to dddocky
dddocky collected 1890 from pot
dddocky: doesn't show hand 
*** SUMMARY ***
Total pot 2000 | Rake 110 
Board [6h 6d 4s Ac]
Seat 1: dddocky collected (1890)
Seat 2: FragileMemory (button) folded before Flop (didn't bet)
Seat 3: Duke Croix (small blind) folded on the Turn
Seat 4: yairpinto (big blind) folded on the Turn
Seat 8: JeBoyDirk folded before Flop (didn't bet)
Seat 9: Manon947 folded on the Turn



PokerStars Home Game Hand #218085121281: {Club #3225207}  Hold'em No Limit (50/100) - 2020/09/03 15:38:33 ET
Table 'fun gamez' 9-max (Play Money) Seat #3 is the button
Seat 1: dddocky (12066 in chips) 
Seat 2: FragileMemory (2795 in chips) 
Seat 3: Duke Croix (18008 in chips) 
Seat 4: yairpinto (8039 in chips) 
Seat 8: JeBoyDirk (28139 in chips) 
Seat 9: Manon947 (5874 in chips) 
yairpinto: posts small blind 50
JeBoyDirk: posts big blind 100
*** HOLE CARDS ***
Dealt to Duke Croix [Qs 6s]
Manon947: folds 
dddocky: calls 100
FragileMemory: calls 100
Duke Croix: folds 
yairpinto: calls 50
JeBoyDirk: checks 
*** FLOP *** [Jd Kh 9h]
yairpinto: checks 
JeBoyDirk: checks 
dddocky: checks 
FragileMemory: checks 
*** TURN *** [Jd Kh 9h] [Ad]
yairpinto: checks 
JeBoyDirk: checks 
dddocky: checks 
FragileMemory: bets 189
yairpinto: calls 189
JeBoyDirk: folds 
dddocky: calls 189
*** RIVER *** [Jd Kh 9h Ad] [2h]
yairpinto: checks 
dddocky: bets 100
FragileMemory: raises 100 to 200
yairpinto: calls 200
dddocky: raises 100 to 300
FragileMemory: raises 100 to 400
yairpinto: folds 
dddocky: calls 100
*** SHOW DOWN ***
FragileMemory: shows [2s As] (two pair, Aces and Deuces)
dddocky: mucks hand 
FragileMemory collected 1859 from pot
*** SUMMARY ***
Total pot 1967 | Rake 108 
Board [Jd Kh 9h Ad 2h]
Seat 1: dddocky mucked [Js Ks]
Seat 2: FragileMemory showed [2s As] and won (1859) with two pair, Aces and Deuces
Seat 3: Duke Croix (button) folded before Flop (didn't bet)
Seat 4: yairpinto (small blind) folded on the River
Seat 8: JeBoyDirk (big blind) folded on the Turn
Seat 9: Manon947 folded before Flop (didn't bet)



PokerStars Home Game Hand #218085154363: {Club #3225207}  Hold'em No Limit (50/100) - 2020/09/03 15:39:26 ET
Table 'fun gamez' 9-max (Play Money) Seat #4 is the button
Seat 1: dddocky (11377 in chips) 
Seat 2: FragileMemory (3965 in chips) 
Seat 3: Duke Croix (18008 in chips) 
Seat 4: yairpinto (7550 in chips) 
Seat 8: JeBoyDirk (28039 in chips) 
Seat 9: Manon947 (5874 in chips) 
JeBoyDirk: posts small blind 50
Manon947: posts big blind 100
*** HOLE CARDS ***
Dealt to Duke Croix [Kh Jd]
dddocky: calls 100
FragileMemory: folds 
Duke Croix: raises 300 to 400
yairpinto: folds 
JeBoyDirk: calls 350
Manon947: folds 
dddocky: calls 300
*** FLOP *** [5c 6s Td]
JeBoyDirk: checks 
dddocky: bets 1228
Duke Croix: folds 
JeBoyDirk: folds 
Uncalled bet (1228) returned to dddocky
dddocky collected 1228 from pot
dddocky: doesn't show hand 
*** SUMMARY ***
Total pot 1300 | Rake 72 
Board [5c 6s Td]
Seat 1: dddocky collected (1228)
Seat 2: FragileMemory folded before Flop (didn't bet)
Seat 3: Duke Croix folded on the Flop
Seat 4: yairpinto (button) folded before Flop (didn't bet)
Seat 8: JeBoyDirk (small blind) folded on the Flop
Seat 9: Manon947 (big blind) folded before Flop



PokerStars Home Game Hand #218085179970: {Club #3225207}  Hold'em No Limit (50/100) - 2020/09/03 15:40:06 ET
Table 'fun gamez' 9-max (Play Money) Seat #8 is the button
Seat 1: dddocky (12205 in chips) 
Seat 2: FragileMemory (3965 in chips) 
Seat 3: Duke Croix (17608 in chips) 
Seat 4: yairpinto (7550 in chips) 
Seat 6: color_singleton (16723 in chips) 
Seat 8: JeBoyDirk (27639 in chips) 
Seat 9: Manon947 (5774 in chips) 
Manon947: posts small blind 50
dddocky: posts big blind 100
color_singleton: posts small & big blinds 150
*** HOLE CARDS ***
Dealt to Duke Croix [6s 2h]
FragileMemory: folds 
Duke Croix: folds 
yairpinto: folds 
color_singleton: checks 
JeBoyDirk: folds 
Manon947: folds 
dddocky: checks 
*** FLOP *** [2d 4d Tc]
dddocky: checks 
color_singleton: checks 
*** TURN *** [2d 4d Tc] [Ac]
dddocky: checks 
color_singleton: checks 
*** RIVER *** [2d 4d Tc Ac] [Kd]
dddocky: checks 
color_singleton: checks 
*** SHOW DOWN ***
dddocky: shows [Jd 8c] (high card Ace)
color_singleton: mucks hand 
dddocky collected 283 from pot
*** SUMMARY ***
Total pot 300 | Rake 17 
Board [2d 4d Tc Ac Kd]
Seat 1: dddocky (big blind) showed [Jd 8c] and won (283) with high card Ace
Seat 2: FragileMemory folded before Flop (didn't bet)
Seat 3: Duke Croix folded before Flop (didn't bet)
Seat 4: yairpinto folded before Flop (didn't bet)
Seat 6: color_singleton mucked [5s 8h]
Seat 8: JeBoyDirk (button) folded before Flop (didn't bet)
Seat 9: Manon947 (small blind) folded before Flop



PokerStars Home Game Hand #218085197957: {Club #3225207}  Hold'em No Limit (50/100) - 2020/09/03 15:40:35 ET
Table 'fun gamez' 9-max (Play Money) Seat #9 is the button
Seat 1: dddocky (12388 in chips) 
Seat 2: FragileMemory (3965 in chips) 
Seat 3: Duke Croix (17608 in chips) 
Seat 4: yairpinto (7550 in chips) 
Seat 6: color_singleton (16573 in chips) 
Seat 8: JeBoyDirk (27639 in chips) 
Seat 9: Manon947 (5724 in chips) 
dddocky: posts small blind 50
FragileMemory: posts big blind 100
*** HOLE CARDS ***
Dealt to Duke Croix [Jc Qc]
Duke Croix: raises 200 to 300
yairpinto: calls 300
color_singleton: folds 
JeBoyDirk: folds 
Manon947: folds 
dddocky: folds 
FragileMemory: folds 
*** FLOP *** [5c Td Qd]
Duke Croix: bets 300
yairpinto: folds 
Uncalled bet (300) returned to Duke Croix
Duke Croix collected 709 from pot
*** SUMMARY ***
Total pot 750 | Rake 41 
Board [5c Td Qd]
Seat 1: dddocky (small blind) folded before Flop
Seat 2: FragileMemory (big blind) folded before Flop
Seat 3: Duke Croix collected (709)
Seat 4: yairpinto folded on the Flop
Seat 6: color_singleton folded before Flop (didn't bet)
Seat 8: JeBoyDirk folded before Flop (didn't bet)
Seat 9: Manon947 (button) folded before Flop (didn't bet)



PokerStars Home Game Hand #218085211030: {Club #3225207}  Hold'em No Limit (50/100) - 2020/09/03 15:40:55 ET
Table 'fun gamez' 9-max (Play Money) Seat #1 is the button
Seat 1: dddocky (12338 in chips) 
Seat 2: FragileMemory (3865 in chips) 
Seat 3: Duke Croix (18017 in chips) 
Seat 4: yairpinto (7250 in chips) 
Seat 6: color_singleton (16573 in chips) 
Seat 8: JeBoyDirk (27639 in chips) 
Seat 9: Manon947 (5724 in chips) 
FragileMemory: posts small blind 50
Duke Croix: posts big blind 100
*** HOLE CARDS ***
Dealt to Duke Croix [4s Qs]
yairpinto: folds 
color_singleton: folds 
JeBoyDirk: calls 100
Manon947: calls 100
dddocky: calls 100
FragileMemory: calls 50
Duke Croix: checks 
*** FLOP *** [Ks 4d Kc]
FragileMemory: checks 
Duke Croix: bets 300
JeBoyDirk: calls 300
Manon947: calls 300
dddocky: folds 
FragileMemory: folds 
*** TURN *** [Ks 4d Kc] [Jd]
Duke Croix: checks 
JeBoyDirk: bets 500
Manon947: calls 500
Duke Croix: folds 
*** RIVER *** [Ks 4d Kc Jd] [Ts]
JeBoyDirk: checks 
Manon947: checks 
*** SHOW DOWN ***
JeBoyDirk: shows [9h Kh] (three of a kind, Kings)
Manon947: mucks hand 
JeBoyDirk collected 2268 from pot
*** SUMMARY ***
Total pot 2400 | Rake 132 
Board [Ks 4d Kc Jd Ts]
Seat 1: dddocky (button) folded on the Flop
Seat 2: FragileMemory (small blind) folded on the Flop
Seat 3: Duke Croix (big blind) folded on the Turn
Seat 4: yairpinto folded before Flop (didn't bet)
Seat 6: color_singleton folded before Flop (didn't bet)
Seat 8: JeBoyDirk showed [9h Kh] and won (2268) with three of a kind, Kings
Seat 9: Manon947 mucked [4c As]



PokerStars Home Game Hand #218085238557: {Club #3225207}  Hold'em No Limit (50/100) - 2020/09/03 15:41:39 ET
Table 'fun gamez' 9-max (Play Money) Seat #2 is the button
Seat 1: dddocky (12238 in chips) 
Seat 2: FragileMemory (3765 in chips) 
Seat 3: Duke Croix (17617 in chips) 
Seat 4: yairpinto (7250 in chips) 
Seat 6: color_singleton (16573 in chips) 
Seat 8: JeBoyDirk (29007 in chips) 
Seat 9: Manon947 (4824 in chips) 
Duke Croix: posts small blind 50
yairpinto: posts big blind 100
*** HOLE CARDS ***
Dealt to Duke Croix [2s Ks]
color_singleton: folds 
JeBoyDirk: folds 
Manon947: calls 100
dddocky: folds 
FragileMemory: folds 
Duke Croix: calls 50
yairpinto: checks 
*** FLOP *** [3s 4h 4s]
Duke Croix: bets 200
yairpinto: folds 
Manon947: calls 200
*** TURN *** [3s 4h 4s] [5d]
Duke Croix: bets 400
Manon947: raises 400 to 800
Duke Croix: calls 400
*** RIVER *** [3s 4h 4s 5d] [Ts]
Duke Croix: checks 
Manon947: checks 
*** SHOW DOWN ***
Duke Croix: shows [2s Ks] (a flush, King high)
Manon947: mucks hand 
Duke Croix collected 2173 from pot
*** SUMMARY ***
Total pot 2300 | Rake 127 
Board [3s 4h 4s 5d Ts]
Seat 1: dddocky folded before Flop (didn't bet)
Seat 2: FragileMemory (button) folded before Flop (didn't bet)
Seat 3: Duke Croix (small blind) showed [2s Ks] and won (2173) with a flush, King high
Seat 4: yairpinto (big blind) folded on the Flop
Seat 6: color_singleton folded before Flop (didn't bet)
Seat 8: JeBoyDirk folded before Flop (didn't bet)
Seat 9: Manon947 mucked [4d Ac]



PokerStars Home Game Hand #218085268202: {Club #3225207}  Hold'em No Limit (50/100) - 2020/09/03 15:42:26 ET
Table 'fun gamez' 9-max (Play Money) Seat #3 is the button
Seat 1: dddocky (12238 in chips) 
Seat 2: FragileMemory (3765 in chips) 
Seat 3: Duke Croix (18690 in chips) 
Seat 4: yairpinto (7150 in chips) 
Seat 6: color_singleton (16573 in chips) 
Seat 8: JeBoyDirk (29007 in chips) 
Seat 9: Manon947 (3724 in chips) 
yairpinto: posts small blind 50
color_singleton: posts big blind 100
*** HOLE CARDS ***
Dealt to Duke Croix [Jh Ac]
JeBoyDirk: folds 
Manon947: calls 100
dddocky: calls 100
FragileMemory: folds 
Duke Croix: raises 400 to 500
yairpinto: folds 
color_singleton: calls 400
Manon947: folds 
dddocky: folds 
*** FLOP *** [8d 5c 5d]
color_singleton: checks 
Duke Croix: checks 
*** TURN *** [8d 5c 5d] [9s]
color_singleton: checks 
Duke Croix: checks 
*** RIVER *** [8d 5c 5d 9s] [4h]
color_singleton: checks 
Duke Croix: checks 
*** SHOW DOWN ***
color_singleton: shows [Qs Ah] (a pair of Fives)
Duke Croix: mucks hand 
color_singleton collected 1181 from pot
*** SUMMARY ***
Total pot 1250 | Rake 69 
Board [8d 5c 5d 9s 4h]
Seat 1: dddocky folded before Flop
Seat 2: FragileMemory folded before Flop (didn't bet)
Seat 3: Duke Croix (button) mucked [Jh Ac]
Seat 4: yairpinto (small blind) folded before Flop
Seat 6: color_singleton (big blind) showed [Qs Ah] and won (1181) with a pair of Fives
Seat 8: JeBoyDirk folded before Flop (didn't bet)
Seat 9: Manon947 folded before Flop



PokerStars Home Game Hand #218085297242: {Club #3225207}  Hold'em No Limit (50/100) - 2020/09/03 15:43:12 ET
Table 'fun gamez' 9-max (Play Money) Seat #4 is the button
Seat 1: dddocky (12138 in chips) 
Seat 2: FragileMemory (3765 in chips) 
Seat 3: Duke Croix (18190 in chips) 
Seat 4: yairpinto (7100 in chips) 
Seat 6: color_singleton (17254 in chips) 
Seat 8: JeBoyDirk (29007 in chips) 
Seat 9: Manon947 (3624 in chips) 
color_singleton: posts small blind 50
JeBoyDirk: posts big blind 100
*** HOLE CARDS ***
Dealt to Duke Croix [As 6d]
Manon947: calls 100
dddocky: calls 100
FragileMemory: calls 100
Duke Croix: calls 100
yairpinto: folds 
color_singleton: calls 50
JeBoyDirk: checks 
*** FLOP *** [8d Ah Ts]
color_singleton: checks 
JeBoyDirk: checks 
Manon947: checks 
dddocky: checks 
FragileMemory: checks 
Duke Croix: bets 400
color_singleton: folds 
JeBoyDirk: folds 
Manon947: calls 400
dddocky: folds 
FragileMemory: folds 
*** TURN *** [8d Ah Ts] [3d]
Manon947: checks 
Duke Croix: bets 700
Manon947: folds 
Uncalled bet (700) returned to Duke Croix
Duke Croix collected 1323 from pot
*** SUMMARY ***
Total pot 1400 | Rake 77 
Board [8d Ah Ts 3d]
Seat 1: dddocky folded on the Flop
Seat 2: FragileMemory folded on the Flop
Seat 3: Duke Croix collected (1323)
Seat 4: yairpinto (button) folded before Flop (didn't bet)
Seat 6: color_singleton (small blind) folded on the Flop
Seat 8: JeBoyDirk (big blind) folded on the Flop
Seat 9: Manon947 folded on the Turn



PokerStars Home Game Hand #218085330629: {Club #3225207}  Hold'em No Limit (50/100) - 2020/09/03 15:44:05 ET
Table 'fun gamez' 9-max (Play Money) Seat #6 is the button
Seat 1: dddocky (12038 in chips) 
Seat 2: FragileMemory (3665 in chips) 
Seat 3: Duke Croix (19013 in chips) 
Seat 4: yairpinto (7100 in chips) 
Seat 6: color_singleton (17154 in chips) 
Seat 8: JeBoyDirk (28907 in chips) 
Seat 9: Manon947 (3124 in chips) 
JeBoyDirk: posts small blind 50
Manon947: posts big blind 100
*** HOLE CARDS ***
Dealt to Duke Croix [2d 3d]
dddocky: calls 100
FragileMemory: folds 
Duke Croix: calls 100
yairpinto: folds 
color_singleton: calls 100
JeBoyDirk: calls 50
Manon947: checks 
*** FLOP *** [7c Jc Ad]
JeBoyDirk: checks 
Manon947: checks 
dddocky: checks 
Duke Croix: checks 
color_singleton: checks 
*** TURN *** [7c Jc Ad] [6c]
JeBoyDirk: checks 
Manon947: checks 
dddocky: checks 
Duke Croix: checks 
color_singleton: checks 
*** RIVER *** [7c Jc Ad 6c] [Tc]
JeBoyDirk: checks 
Manon947: checks 
dddocky: checks 
Duke Croix: checks 
color_singleton: checks 
*** SHOW DOWN ***
JeBoyDirk: shows [6h 9h] (a pair of Sixes)
Manon947: shows [Qd Th] (a pair of Tens)
dddocky: shows [Kd Td] (a pair of Tens - Ace+King kicker)
Duke Croix: mucks hand 
color_singleton: shows [Kh 8c] (a flush, Jack high)
color_singleton collected 472 from pot
*** SUMMARY ***
Total pot 500 | Rake 28 
Board [7c Jc Ad 6c Tc]
Seat 1: dddocky showed [Kd Td] and lost with a pair of Tens
Seat 2: FragileMemory folded before Flop (didn't bet)
Seat 3: Duke Croix mucked [2d 3d]
Seat 4: yairpinto folded before Flop (didn't bet)
Seat 6: color_singleton (button) showed [Kh 8c] and won (472) with a flush, Jack high
Seat 8: JeBoyDirk (small blind) showed [6h 9h] and lost with a pair of Sixes
Seat 9: Manon947 (big blind) showed [Qd Th] and lost with a pair of Tens



PokerStars Home Game Hand #218085362273: {Club #3225207}  Hold'em No Limit (50/100) - 2020/09/03 15:44:55 ET
Table 'fun gamez' 9-max (Play Money) Seat #8 is the button
Seat 1: dddocky (11938 in chips) 
Seat 2: FragileMemory (3665 in chips) 
Seat 3: Duke Croix (18913 in chips) 
Seat 4: yairpinto (7100 in chips) 
Seat 6: color_singleton (17526 in chips) 
Seat 8: JeBoyDirk (28807 in chips) 
Seat 9: Manon947 (3024 in chips) 
Manon947: posts small blind 50
dddocky: posts big blind 100
*** HOLE CARDS ***
Dealt to Duke Croix [6h 4c]
FragileMemory: calls 100
Duke Croix: folds 
yairpinto: folds 
color_singleton: folds 
JeBoyDirk: raises 100 to 200
Manon947: folds 
dddocky: folds 
FragileMemory: calls 100
*** FLOP *** [2d Qc 4d]
FragileMemory: checks 
JeBoyDirk: checks 
*** TURN *** [2d Qc 4d] [7d]
FragileMemory: checks 
JeBoyDirk: checks 
*** RIVER *** [2d Qc 4d 7d] [Th]
FragileMemory: checks 
JeBoyDirk: checks 
*** SHOW DOWN ***
FragileMemory: shows [6s Ac] (high card Ace)
JeBoyDirk: shows [Kh Ad] (high card Ace - King kicker)
JeBoyDirk collected 520 from pot
*** SUMMARY ***
Total pot 550 | Rake 30 
Board [2d Qc 4d 7d Th]
Seat 1: dddocky (big blind) folded before Flop
Seat 2: FragileMemory showed [6s Ac] and lost with high card Ace
Seat 3: Duke Croix folded before Flop (didn't bet)
Seat 4: yairpinto folded before Flop (didn't bet)
Seat 6: color_singleton folded before Flop (didn't bet)
Seat 8: JeBoyDirk (button) showed [Kh Ad] and won (520) with high card Ace
Seat 9: Manon947 (small blind) folded before Flop



PokerStars Home Game Hand #218085389287: {Club #3225207}  Hold'em No Limit (50/100) - 2020/09/03 15:45:29 ET
Table 'fun gamez' 9-max (Play Money) Seat #9 is the button
Seat 1: dddocky (11838 in chips) 
Seat 2: FragileMemory (3465 in chips) 
Seat 3: Duke Croix (18913 in chips) 
Seat 4: yairpinto (7100 in chips) 
Seat 6: color_singleton (17526 in chips) 
Seat 8: JeBoyDirk (29127 in chips) 
Seat 9: Manon947 (2974 in chips) 
dddocky: posts small blind 50
FragileMemory: posts big blind 100
*** HOLE CARDS ***
Dealt to Duke Croix [3d 6h]
Duke Croix: folds 
yairpinto: folds 
color_singleton: calls 100
JeBoyDirk: folds 
Manon947: calls 100
dddocky: calls 50
FragileMemory: checks 
*** FLOP *** [Jc 5h 2d]
dddocky: checks 
FragileMemory: checks 
color_singleton: bets 189
Manon947: folds 
dddocky: calls 189
FragileMemory: folds 
*** TURN *** [Jc 5h 2d] [8d]
dddocky: checks 
color_singleton: checks 
*** RIVER *** [Jc 5h 2d 8d] [9h]
dddocky: checks 
color_singleton: checks 
*** SHOW DOWN ***
dddocky: shows [7s 7c] (a pair of Sevens)
color_singleton: mucks hand 
dddocky collected 735 from pot
*** SUMMARY ***
Total pot 778 | Rake 43 
Board [Jc 5h 2d 8d 9h]
Seat 1: dddocky (small blind) showed [7s 7c] and won (735) with a pair of Sevens
Seat 2: FragileMemory (big blind) folded on the Flop
Seat 3: Duke Croix folded before Flop (didn't bet)
Seat 4: yairpinto folded before Flop (didn't bet)
Seat 6: color_singleton mucked [Kd 2s]
Seat 8: JeBoyDirk folded before Flop (didn't bet)
Seat 9: Manon947 (button) folded on the Flop



PokerStars Home Game Hand #218085415845: {Club #3225207}  Hold'em No Limit (50/100) - 2020/09/03 15:46:11 ET
Table 'fun gamez' 9-max (Play Money) Seat #1 is the button
Seat 1: dddocky (12284 in chips) 
Seat 2: FragileMemory (3365 in chips) 
Seat 3: Duke Croix (18913 in chips) 
Seat 4: yairpinto (7100 in chips) 
Seat 6: color_singleton (17237 in chips) 
Seat 8: JeBoyDirk (29127 in chips) 
Seat 9: Manon947 (2874 in chips) 
FragileMemory: posts small blind 50
Duke Croix: posts big blind 100
*** HOLE CARDS ***
Dealt to Duke Croix [6c 2s]
yairpinto: raises 200 to 300
color_singleton: folds 
JeBoyDirk: folds 
Manon947: calls 300
dddocky: calls 300
FragileMemory: folds 
Duke Croix: folds 
*** FLOP *** [4s 6s 2d]
yairpinto: bets 496
Manon947: folds 
dddocky: calls 496
*** TURN *** [4s 6s 2d] [7d]
yairpinto: checks 
dddocky: checks 
*** RIVER *** [4s 6s 2d 7d] [Tc]
yairpinto: checks 
dddocky: checks 
*** SHOW DOWN ***
yairpinto: shows [7c Ac] (a pair of Sevens)
dddocky: mucks hand 
yairpinto collected 1930 from pot
*** SUMMARY ***
Total pot 2042 | Rake 112 
Board [4s 6s 2d 7d Tc]
Seat 1: dddocky (button) mucked [Ad 6d]
Seat 2: FragileMemory (small blind) folded before Flop
Seat 3: Duke Croix (big blind) folded before Flop
Seat 4: yairpinto showed [7c Ac] and won (1930) with a pair of Sevens
Seat 6: color_singleton folded before Flop (didn't bet)
Seat 8: JeBoyDirk folded before Flop (didn't bet)
Seat 9: Manon947 folded on the Flop



PokerStars Home Game Hand #218085438228: {Club #3225207}  Hold'em No Limit (50/100) - 2020/09/03 15:46:47 ET
Table 'fun gamez' 9-max (Play Money) Seat #2 is the button
Seat 1: dddocky (11488 in chips) 
Seat 2: FragileMemory (3315 in chips) 
Seat 3: Duke Croix (18813 in chips) 
Seat 4: yairpinto (8234 in chips) 
Seat 6: color_singleton (17237 in chips) 
Seat 8: JeBoyDirk (29127 in chips) 
Seat 9: Manon947 (2574 in chips) 
Duke Croix: posts small blind 50
yairpinto: posts big blind 100
*** HOLE CARDS ***
Dealt to Duke Croix [9s 5h]
color_singleton: folds 
JeBoyDirk: folds 
Manon947: calls 100
dddocky: calls 100
FragileMemory: folds 
Duke Croix: calls 50
yairpinto: checks 
*** FLOP *** [Ts 6h 9h]
Duke Croix: bets 200
yairpinto: raises 389 to 589
Manon947: calls 589
dddocky: folds 
Duke Croix: folds 
*** TURN *** [Ts 6h 9h] [Jd]
yairpinto: checks 
Manon947: checks 
*** RIVER *** [Ts 6h 9h Jd] [Ac]
yairpinto: checks 
Manon947: checks 
*** SHOW DOWN ***
yairpinto: shows [Kc Th] (a pair of Tens)
Manon947: shows [Ah Kh] (a pair of Aces)
Manon947 collected 1680 from pot
*** SUMMARY ***
Total pot 1778 | Rake 98 
Board [Ts 6h 9h Jd Ac]
Seat 1: dddocky folded on the Flop
Seat 2: FragileMemory (button) folded before Flop (didn't bet)
Seat 3: Duke Croix (small blind) folded on the Flop
Seat 4: yairpinto (big blind) showed [Kc Th] and lost with a pair of Tens
Seat 6: color_singleton folded before Flop (didn't bet)
Seat 8: JeBoyDirk folded before Flop (didn't bet)
Seat 9: Manon947 showed [Ah Kh] and won (1680) with a pair of Aces



PokerStars Home Game Hand #218085465331: {Club #3225207}  Hold'em No Limit (50/100) - 2020/09/03 15:47:30 ET
Table 'fun gamez' 9-max (Play Money) Seat #3 is the button
Seat 1: dddocky (11388 in chips) 
Seat 2: FragileMemory (3315 in chips) 
Seat 3: Duke Croix (18513 in chips) 
Seat 4: yairpinto (7545 in chips) 
Seat 6: color_singleton (17237 in chips) 
Seat 8: JeBoyDirk (29127 in chips) 
Seat 9: Manon947 (3565 in chips) 
yairpinto: posts small blind 50
color_singleton: posts big blind 100
*** HOLE CARDS ***
Dealt to Duke Croix [5c Ac]
JeBoyDirk: folds 
Manon947: folds 
dddocky: calls 100
FragileMemory: folds 
Duke Croix: raises 300 to 400
yairpinto: folds 
color_singleton: calls 300
dddocky: calls 300
*** FLOP *** [5d 2d 4s]
color_singleton: checks 
dddocky: checks 
Duke Croix: bets 600
color_singleton: raises 600 to 1200
dddocky: folds 
Duke Croix: calls 600
*** TURN *** [5d 2d 4s] [8d]
color_singleton: bets 1724
Duke Croix: folds 
Uncalled bet (1724) returned to color_singleton
color_singleton collected 3449 from pot
color_singleton: doesn't show hand 
*** SUMMARY ***
Total pot 3650 | Rake 201 
Board [5d 2d 4s 8d]
Seat 1: dddocky folded on the Flop
Seat 2: FragileMemory folded before Flop (didn't bet)
Seat 3: Duke Croix (button) folded on the Turn
Seat 4: yairpinto (small blind) folded before Flop
Seat 6: color_singleton (big blind) collected (3449)
Seat 8: JeBoyDirk folded before Flop (didn't bet)
Seat 9: Manon947 folded before Flop (didn't bet)



PokerStars Home Game Hand #218085494395: {Club #3225207}  Hold'em No Limit (50/100) - 2020/09/03 15:48:16 ET
Table 'fun gamez' 9-max (Play Money) Seat #4 is the button
Seat 1: dddocky (10988 in chips) 
Seat 2: FragileMemory (3315 in chips) 
Seat 3: Duke Croix (16913 in chips) 
Seat 4: yairpinto (7495 in chips) 
Seat 6: color_singleton (19086 in chips) 
Seat 8: JeBoyDirk (29127 in chips) 
Seat 9: Manon947 (3565 in chips) 
color_singleton: posts small blind 50
JeBoyDirk: posts big blind 100
*** HOLE CARDS ***
Dealt to Duke Croix [Ah Jd]
Manon947: calls 100
dddocky: calls 100
FragileMemory: calls 100
Duke Croix: raises 400 to 500
yairpinto: folds 
color_singleton: folds 
JeBoyDirk: folds 
Manon947: calls 400
dddocky: calls 400
FragileMemory: folds 
*** FLOP *** [6c Kd 7d]
Manon947: checks 
dddocky: checks 
Duke Croix: bets 900
Manon947: folds 
dddocky: folds 
Uncalled bet (900) returned to Duke Croix
Duke Croix collected 1654 from pot
*** SUMMARY ***
Total pot 1750 | Rake 96 
Board [6c Kd 7d]
Seat 1: dddocky folded on the Flop
Seat 2: FragileMemory folded before Flop
Seat 3: Duke Croix collected (1654)
Seat 4: yairpinto (button) folded before Flop (didn't bet)
Seat 6: color_singleton (small blind) folded before Flop
Seat 8: JeBoyDirk (big blind) folded before Flop
Seat 9: Manon947 folded on the Flop



PokerStars Home Game Hand #218085526646: {Club #3225207}  Hold'em No Limit (50/100) - 2020/09/03 15:49:08 ET
Table 'fun gamez' 9-max (Play Money) Seat #6 is the button
Seat 1: dddocky (10488 in chips) 
Seat 2: FragileMemory (3215 in chips) 
Seat 3: Duke Croix (18067 in chips) 
Seat 4: yairpinto (7495 in chips) 
Seat 6: color_singleton (19036 in chips) 
Seat 8: JeBoyDirk (29027 in chips) 
Seat 9: Manon947 (3065 in chips) 
JeBoyDirk: posts small blind 50
Manon947: posts big blind 100
*** HOLE CARDS ***
Dealt to Duke Croix [5h 8h]
dddocky: calls 100
FragileMemory: calls 100
Duke Croix: calls 100
yairpinto: folds 
color_singleton: calls 100
JeBoyDirk: folds 
Manon947: checks 
*** FLOP *** [9d 4d Jd]
Manon947: checks 
dddocky: checks 
FragileMemory: checks 
Duke Croix: checks 
color_singleton: checks 
*** TURN *** [9d 4d Jd] [3h]
Manon947: checks 
dddocky: checks 
FragileMemory: checks 
Duke Croix: checks 
color_singleton: checks 
*** RIVER *** [9d 4d Jd 3h] [Ac]
Manon947: checks 
dddocky: checks 
FragileMemory: checks 
Duke Croix: checks 
color_singleton: checks 
*** SHOW DOWN ***
Manon947: shows [Qs Js] (a pair of Jacks)
dddocky: mucks hand 
FragileMemory: mucks hand 
Duke Croix: mucks hand 
color_singleton: mucks hand 
Manon947 collected 520 from pot
*** SUMMARY ***
Total pot 550 | Rake 30 
Board [9d 4d Jd 3h Ac]
Seat 1: dddocky mucked [7c Qc]
Seat 2: FragileMemory mucked [2h 2d]
Seat 3: Duke Croix mucked [5h 8h]
Seat 4: yairpinto folded before Flop (didn't bet)
Seat 6: color_singleton (button) mucked [8s 3s]
Seat 8: JeBoyDirk (small blind) folded before Flop
Seat 9: Manon947 (big blind) showed [Qs Js] and won (520) with a pair of Jacks



PokerStars Home Game Hand #218085555401: {Club #3225207}  Hold'em No Limit (50/100) - 2020/09/03 15:49:54 ET
Table 'fun gamez' 9-max (Play Money) Seat #8 is the button
Seat 1: dddocky (10388 in chips) 
Seat 2: FragileMemory (3115 in chips) 
Seat 3: Duke Croix (17967 in chips) 
Seat 4: yairpinto (7495 in chips) 
Seat 6: color_singleton (18936 in chips) 
Seat 8: JeBoyDirk (28977 in chips) 
Seat 9: Manon947 (3485 in chips) 
Manon947: posts small blind 50
dddocky: posts big blind 100
*** HOLE CARDS ***
Dealt to Duke Croix [As 2h]
FragileMemory: folds 
Duke Croix: folds 
yairpinto: folds 
color_singleton: calls 100
JeBoyDirk: raises 200 to 300
Manon947: folds 
dddocky: calls 200
color_singleton: calls 200
*** FLOP *** [Ac Tc 9h]
dddocky: checks 
color_singleton: checks 
JeBoyDirk: checks 
*** TURN *** [Ac Tc 9h] [Jh]
dddocky: checks 
color_singleton: checks 
JeBoyDirk: checks 
*** RIVER *** [Ac Tc 9h Jh] [9s]
dddocky: checks 
color_singleton: checks 
JeBoyDirk: checks 
*** SHOW DOWN ***
dddocky: shows [3h 4h] (a pair of Nines)
color_singleton: shows [4s 5s] (a pair of Nines)
JeBoyDirk: shows [Qh Qs] (two pair, Queens and Nines)
JeBoyDirk collected 898 from pot
*** SUMMARY ***
Total pot 950 | Rake 52 
Board [Ac Tc 9h Jh 9s]
Seat 1: dddocky (big blind) showed [3h 4h] and lost with a pair of Nines
Seat 2: FragileMemory folded before Flop (didn't bet)
Seat 3: Duke Croix folded before Flop (didn't bet)
Seat 4: yairpinto folded before Flop (didn't bet)
Seat 6: color_singleton showed [4s 5s] and lost with a pair of Nines
Seat 8: JeBoyDirk (button) showed [Qh Qs] and won (898) with two pair, Queens and Nines
Seat 9: Manon947 (small blind) folded before Flop



PokerStars Home Game Hand #218085584857: {Club #3225207}  Hold'em No Limit (50/100) - 2020/09/03 15:50:42 ET
Table 'fun gamez' 9-max (Play Money) Seat #9 is the button
Seat 1: dddocky (10088 in chips) 
Seat 2: FragileMemory (3115 in chips) 
Seat 3: Duke Croix (17967 in chips) 
Seat 4: yairpinto (7495 in chips) 
Seat 6: color_singleton (18636 in chips) 
Seat 8: JeBoyDirk (29575 in chips) 
Seat 9: Manon947 (3435 in chips) 
dddocky: posts small blind 50
FragileMemory: posts big blind 100
*** HOLE CARDS ***
Dealt to Duke Croix [9c As]
Duke Croix: raises 300 to 400
yairpinto: folds 
color_singleton: folds 
JeBoyDirk: folds 
Manon947: folds 
dddocky: calls 350
FragileMemory: folds 
*** FLOP *** [8d 9h Jh]
dddocky: checks 
Duke Croix: bets 500
dddocky: folds 
Uncalled bet (500) returned to Duke Croix
Duke Croix collected 850 from pot
*** SUMMARY ***
Total pot 900 | Rake 50 
Board [8d 9h Jh]
Seat 1: dddocky (small blind) folded on the Flop
Seat 2: FragileMemory (big blind) folded before Flop
Seat 3: Duke Croix collected (850)
Seat 4: yairpinto folded before Flop (didn't bet)
Seat 6: color_singleton folded before Flop (didn't bet)
Seat 8: JeBoyDirk folded before Flop (didn't bet)
Seat 9: Manon947 (button) folded before Flop (didn't bet)



PokerStars Home Game Hand #218085602983: {Club #3225207}  Hold'em No Limit (50/100) - 2020/09/03 15:51:11 ET
Table 'fun gamez' 9-max (Play Money) Seat #1 is the button
Seat 1: dddocky (9688 in chips) 
Seat 2: FragileMemory (3015 in chips) 
Seat 3: Duke Croix (18417 in chips) 
Seat 4: yairpinto (7495 in chips) 
Seat 6: color_singleton (18636 in chips) 
Seat 8: JeBoyDirk (29575 in chips) 
Seat 9: Manon947 (3435 in chips) 
FragileMemory: posts small blind 50
Duke Croix: posts big blind 100
*** HOLE CARDS ***
Dealt to Duke Croix [Kd Th]
yairpinto: folds 
color_singleton: raises 200 to 300
JeBoyDirk: folds 
Manon947: calls 300
dddocky: calls 300
FragileMemory: folds 
Duke Croix: calls 200
*** FLOP *** [Ks Js 2h]
Duke Croix: bets 700
color_singleton: calls 700
Manon947: folds 
dddocky: folds 
*** TURN *** [Ks Js 2h] [2c]
Duke Croix: bets 1300
color_singleton: folds 
Uncalled bet (1300) returned to Duke Croix
Duke Croix collected 2504 from pot
*** SUMMARY ***
Total pot 2650 | Rake 146 
Board [Ks Js 2h 2c]
Seat 1: dddocky (button) folded on the Flop
Seat 2: FragileMemory (small blind) folded before Flop
Seat 3: Duke Croix (big blind) collected (2504)
Seat 4: yairpinto folded before Flop (didn't bet)
Seat 6: color_singleton folded on the Turn
Seat 8: JeBoyDirk folded before Flop (didn't bet)
Seat 9: Manon947 folded on the Flop



PokerStars Home Game Hand #218085628815: {Club #3225207}  Hold'em No Limit (50/100) - 2020/09/03 15:51:53 ET
Table 'fun gamez' 9-max (Play Money) Seat #2 is the button
Seat 1: dddocky (9388 in chips) 
Seat 2: FragileMemory (2965 in chips) 
Seat 3: Duke Croix (19921 in chips) 
Seat 4: yairpinto (7495 in chips) 
Seat 6: color_singleton (17636 in chips) 
Seat 8: JeBoyDirk (29575 in chips) 
Seat 9: Manon947 (3135 in chips) 
Duke Croix: posts small blind 50
yairpinto: posts big blind 100
*** HOLE CARDS ***
Dealt to Duke Croix [Js 8d]
color_singleton: folds 
JeBoyDirk: calls 100
Manon947: folds 
dddocky: calls 100
FragileMemory: calls 100
Duke Croix: calls 50
yairpinto: checks 
*** FLOP *** [5s 4c Kh]
Duke Croix: checks 
yairpinto: checks 
JeBoyDirk: checks 
dddocky: checks 
FragileMemory: checks 
*** TURN *** [5s 4c Kh] [4s]
Duke Croix: checks 
yairpinto: checks 
JeBoyDirk: checks 
dddocky: checks 
FragileMemory: checks 
*** RIVER *** [5s 4c Kh 4s] [Qh]
Duke Croix: checks 
yairpinto: checks 
JeBoyDirk: checks 
dddocky: checks 
FragileMemory: checks 
*** SHOW DOWN ***
Duke Croix: shows [Js 8d] (a pair of Fours)
yairpinto: mucks hand 
JeBoyDirk: mucks hand 
dddocky: shows [Jc 8h] (a pair of Fours)
FragileMemory: mucks hand 
Duke Croix collected 236 from pot
dddocky collected 236 from pot
*** SUMMARY ***
Total pot 500 | Rake 28 
Board [5s 4c Kh 4s Qh]
Seat 1: dddocky showed [Jc 8h] and won (236) with a pair of Fours
Seat 2: FragileMemory (button) mucked [9h 7h]
Seat 3: Duke Croix (small blind) showed [Js 8d] and won (236) with a pair of Fours
Seat 4: yairpinto (big blind) mucked [6s 2h]
Seat 6: color_singleton folded before Flop (didn't bet)
Seat 8: JeBoyDirk mucked [7c Tc]
Seat 9: Manon947 folded before Flop (didn't bet)



PokerStars Home Game Hand #218085661322: {Club #3225207}  Hold'em No Limit (50/100) - 2020/09/03 15:52:45 ET
Table 'fun gamez' 9-max (Play Money) Seat #3 is the button
Seat 1: dddocky (9524 in chips) 
Seat 2: FragileMemory (2865 in chips) 
Seat 3: Duke Croix (20057 in chips) 
Seat 4: yairpinto (7395 in chips) 
Seat 6: color_singleton (17636 in chips) 
Seat 8: JeBoyDirk (29475 in chips) 
Seat 9: Manon947 (3135 in chips) 
yairpinto: posts small blind 50
color_singleton: posts big blind 100
*** HOLE CARDS ***
Dealt to Duke Croix [2h 6h]
JeBoyDirk: folds 
Manon947: calls 100
dddocky: calls 100
FragileMemory: raises 100 to 200
Duke Croix: folds 
yairpinto: calls 150
color_singleton: calls 100
Manon947: calls 100
dddocky: calls 100
*** FLOP *** [Ah 6d Jh]
yairpinto: checks 
color_singleton: checks 
Manon947: checks 
dddocky: bets 945
FragileMemory: raises 945 to 1890
yairpinto: folds 
color_singleton: folds 
Manon947: folds 
dddocky: calls 945
*** TURN *** [Ah 6d Jh] [Kd]
dddocky: bets 100
FragileMemory: raises 675 to 775 and is all-in
dddocky: calls 675
*** RIVER *** [Ah 6d Jh Kd] [4s]
*** SHOW DOWN ***
dddocky: shows [Js Qh] (a pair of Jacks)
FragileMemory: shows [Ad Ac] (three of a kind, Aces)
FragileMemory collected 5982 from pot
*** SUMMARY ***
Total pot 6330 | Rake 348 
Board [Ah 6d Jh Kd 4s]
Seat 1: dddocky showed [Js Qh] and lost with a pair of Jacks
Seat 2: FragileMemory showed [Ad Ac] and won (5982) with three of a kind, Aces
Seat 3: Duke Croix (button) folded before Flop (didn't bet)
Seat 4: yairpinto (small blind) folded on the Flop
Seat 6: color_singleton (big blind) folded on the Flop
Seat 8: JeBoyDirk folded before Flop (didn't bet)
Seat 9: Manon947 folded on the Flop



PokerStars Home Game Hand #218085688511: {Club #3225207}  Hold'em No Limit (50/100) - 2020/09/03 15:53:30 ET
Table 'fun gamez' 9-max (Play Money) Seat #4 is the button
Seat 1: dddocky (6659 in chips) 
Seat 2: FragileMemory (5982 in chips) 
Seat 3: Duke Croix (20057 in chips) 
Seat 4: yairpinto (7195 in chips) 
Seat 6: color_singleton (17436 in chips) 
Seat 8: JeBoyDirk (29475 in chips) 
Seat 9: Manon947 (2935 in chips) 
color_singleton: posts small blind 50
JeBoyDirk: posts big blind 100
*** HOLE CARDS ***
Dealt to Duke Croix [7s 2c]
Manon947: calls 100
dddocky: calls 100
FragileMemory: folds 
Duke Croix: folds 
yairpinto: folds 
color_singleton: calls 50
JeBoyDirk: checks 
*** FLOP *** [2d 2s Qd]
color_singleton: checks 
JeBoyDirk: checks 
Manon947: checks 
dddocky: checks 
*** TURN *** [2d 2s Qd] [4h]
color_singleton: checks 
JeBoyDirk: checks 
Manon947: checks 
dddocky: checks 
*** RIVER *** [2d 2s Qd 4h] [5d]
color_singleton: checks 
JeBoyDirk: checks 
Manon947: checks 
dddocky: checks 
*** SHOW DOWN ***
color_singleton: shows [Tc 8d] (a pair of Deuces)
JeBoyDirk: shows [4d 6c] (two pair, Fours and Deuces)
Manon947: shows [8s 8h] (two pair, Eights and Deuces)
dddocky: mucks hand 
Manon947 collected 378 from pot
*** SUMMARY ***
Total pot 400 | Rake 22 
Board [2d 2s Qd 4h 5d]
Seat 1: dddocky mucked [7d Ac]
Seat 2: FragileMemory folded before Flop (didn't bet)
Seat 3: Duke Croix folded before Flop (didn't bet)
Seat 4: yairpinto (button) folded before Flop (didn't bet)
Seat 6: color_singleton (small blind) showed [Tc 8d] and lost with a pair of Deuces
Seat 8: JeBoyDirk (big blind) showed [4d 6c] and lost with two pair, Fours and Deuces
Seat 9: Manon947 showed [8s 8h] and won (378) with two pair, Eights and Deuces



PokerStars Home Game Hand #218085712680: {Club #3225207}  Hold'em No Limit (50/100) - 2020/09/03 15:54:09 ET
Table 'fun gamez' 9-max (Play Money) Seat #6 is the button
Seat 1: dddocky (6559 in chips) 
Seat 2: FragileMemory (5982 in chips) 
Seat 3: Duke Croix (20057 in chips) 
Seat 4: yairpinto (7195 in chips) 
Seat 6: color_singleton (17336 in chips) 
Seat 8: JeBoyDirk (29375 in chips) 
Seat 9: Manon947 (3213 in chips) 
JeBoyDirk: posts small blind 50
Manon947: posts big blind 100
*** HOLE CARDS ***
Dealt to Duke Croix [Th 2c]
dddocky: calls 100
FragileMemory: folds 
Duke Croix: folds 
yairpinto: folds 
color_singleton: raises 200 to 300
JeBoyDirk: folds 
Manon947: folds 
dddocky: calls 200
*** FLOP *** [7c 5h 2s]
dddocky: checks 
color_singleton: bets 354
dddocky: folds 
Uncalled bet (354) returned to color_singleton
color_singleton collected 709 from pot
color_singleton: doesn't show hand 
*** SUMMARY ***
Total pot 750 | Rake 41 
Board [7c 5h 2s]
Seat 1: dddocky folded on the Flop
Seat 2: FragileMemory folded before Flop (didn't bet)
Seat 3: Duke Croix folded before Flop (didn't bet)
Seat 4: yairpinto folded before Flop (didn't bet)
Seat 6: color_singleton (button) collected (709)
Seat 8: JeBoyDirk (small blind) folded before Flop
Seat 9: Manon947 (big blind) folded before Flop



PokerStars Home Game Hand #218085733793: {Club #3225207}  Hold'em No Limit (50/100) - 2020/09/03 15:54:44 ET
Table 'fun gamez' 9-max (Play Money) Seat #8 is the button
Seat 1: dddocky (6259 in chips) 
Seat 2: FragileMemory (5982 in chips) 
Seat 3: Duke Croix (20057 in chips) 
Seat 4: yairpinto (7195 in chips) 
Seat 6: color_singleton (17745 in chips) 
Seat 8: JeBoyDirk (29325 in chips) 
Seat 9: Manon947 (3113 in chips) 
Manon947: posts small blind 50
dddocky: posts big blind 100
*** HOLE CARDS ***
Dealt to Duke Croix [Td Js]
FragileMemory: folds 
Duke Croix: raises 300 to 400
yairpinto: folds 
color_singleton: folds 
JeBoyDirk: calls 400
Manon947: folds 
dddocky: folds 
*** FLOP *** [8s 8h 4s]
Duke Croix: checks 
JeBoyDirk: checks 
*** TURN *** [8s 8h 4s] [Qc]
Duke Croix: checks 
JeBoyDirk: bets 200
Duke Croix: calls 200
*** RIVER *** [8s 8h 4s Qc] [Jd]
Duke Croix: checks 
JeBoyDirk: bets 1000
Duke Croix: calls 1000
*** SHOW DOWN ***
JeBoyDirk: shows [Jc 8c] (a full house, Eights full of Jacks)
Duke Croix: mucks hand 
JeBoyDirk collected 3166 from pot
*** SUMMARY ***
Total pot 3350 | Rake 184 
Board [8s 8h 4s Qc Jd]
Seat 1: dddocky (big blind) folded before Flop
Seat 2: FragileMemory folded before Flop (didn't bet)
Seat 3: Duke Croix mucked [Td Js]
Seat 4: yairpinto folded before Flop (didn't bet)
Seat 6: color_singleton folded before Flop (didn't bet)
Seat 8: JeBoyDirk (button) showed [Jc 8c] and won (3166) with a full house, Eights full of Jacks
Seat 9: Manon947 (small blind) folded before Flop



PokerStars Home Game Hand #218085757769: {Club #3225207}  Hold'em No Limit (50/100) - 2020/09/03 15:55:36 ET
Table 'fun gamez' 9-max (Play Money) Seat #9 is the button
Seat 1: dddocky (6159 in chips) 
Seat 2: FragileMemory (5982 in chips) 
Seat 3: Duke Croix (18457 in chips) 
Seat 4: yairpinto (7195 in chips) 
Seat 6: color_singleton (17745 in chips) 
Seat 8: JeBoyDirk (30891 in chips) 
Seat 9: Manon947 (3063 in chips) 
dddocky: posts small blind 50
FragileMemory: posts big blind 100
*** HOLE CARDS ***
Dealt to Duke Croix [7d 5d]
Duke Croix: calls 100
yairpinto: folds 
color_singleton: calls 100
JeBoyDirk: folds 
Manon947: folds 
dddocky: calls 50
FragileMemory: checks 
*** FLOP *** [2c 4d 3c]
dddocky: checks 
FragileMemory: checks 
Duke Croix: bets 200
color_singleton: folds 
dddocky: folds 
FragileMemory: calls 200
*** TURN *** [2c 4d 3c] [Kd]
FragileMemory: checks 
Duke Croix: bets 400
FragileMemory: calls 400
*** RIVER *** [2c 4d 3c Kd] [Ah]
FragileMemory: bets 756
Duke Croix: raises 844 to 1600
FragileMemory: raises 3682 to 5282 and is all-in
Duke Croix: calls 3682
*** SHOW DOWN ***
FragileMemory: shows [5h Qh] (a straight, Ace to Five)
Duke Croix: shows [7d 5d] (a straight, Ace to Five)
FragileMemory collected 5748 from pot
Duke Croix collected 5747 from pot
*** SUMMARY ***
Total pot 12164 | Rake 669 
Board [2c 4d 3c Kd Ah]
Seat 1: dddocky (small blind) folded on the Flop
Seat 2: FragileMemory (big blind) showed [5h Qh] and won (5748) with a straight, Ace to Five
Seat 3: Duke Croix showed [7d 5d] and won (5747) with a straight, Ace to Five
Seat 4: yairpinto folded before Flop (didn't bet)
Seat 6: color_singleton folded on the Flop
Seat 8: JeBoyDirk folded before Flop (didn't bet)
Seat 9: Manon947 (button) folded before Flop (didn't bet)



PokerStars Home Game Hand #218085784019: {Club #3225207}  Hold'em No Limit (50/100) - 2020/09/03 15:56:36 ET
Table 'fun gamez' 9-max (Play Money) Seat #1 is the button
Seat 1: dddocky (6059 in chips) 
Seat 2: FragileMemory (5748 in chips) 
Seat 3: Duke Croix (18222 in chips) 
Seat 4: yairpinto (7195 in chips) 
Seat 6: color_singleton (17645 in chips) 
Seat 8: JeBoyDirk (30891 in chips) 
Seat 9: Manon947 (3063 in chips) 
FragileMemory: posts small blind 50
Duke Croix: posts big blind 100
*** HOLE CARDS ***
Dealt to Duke Croix [2d 5h]
yairpinto: folds 
color_singleton: raises 200 to 300
JeBoyDirk: folds 
Manon947: folds 
dddocky: folds 
FragileMemory: raises 200 to 500
Duke Croix: folds 
color_singleton: calls 200
*** FLOP *** [7c 8h Th]
FragileMemory: bets 519
color_singleton: calls 519
*** TURN *** [7c 8h Th] [6s]
FragileMemory: bets 4729 and is all-in
color_singleton: folds 
Uncalled bet (4729) returned to FragileMemory
FragileMemory collected 2020 from pot
FragileMemory: doesn't show hand 
*** SUMMARY ***
Total pot 2138 | Rake 118 
Board [7c 8h Th 6s]
Seat 1: dddocky (button) folded before Flop (didn't bet)
Seat 2: FragileMemory (small blind) collected (2020)
Seat 3: Duke Croix (big blind) folded before Flop
Seat 4: yairpinto folded before Flop (didn't bet)
Seat 6: color_singleton folded on the Turn
Seat 8: JeBoyDirk folded before Flop (didn't bet)
Seat 9: Manon947 folded before Flop (didn't bet)



PokerStars Home Game Hand #218085806871: {Club #3225207}  Hold'em No Limit (50/100) - 2020/09/03 15:57:27 ET
Table 'fun gamez' 9-max (Play Money) Seat #2 is the button
Seat 1: dddocky (6059 in chips) 
Seat 2: FragileMemory (6749 in chips) 
Seat 3: Duke Croix (18122 in chips) 
Seat 4: yairpinto (7195 in chips) 
Seat 6: color_singleton (16626 in chips) 
Seat 8: JeBoyDirk (30891 in chips) 
Seat 9: Manon947 (3063 in chips) 
Duke Croix: posts small blind 50
yairpinto: posts big blind 100
*** HOLE CARDS ***
Dealt to Duke Croix [2d 7h]
color_singleton: folds 
JeBoyDirk: folds 
Manon947: raises 100 to 200
dddocky: folds 
FragileMemory: calls 200
Duke Croix: folds 
yairpinto: calls 100
*** FLOP *** [8d 2c Td]
yairpinto: checks 
Manon947: bets 307
FragileMemory: folds 
yairpinto: calls 307
*** TURN *** [8d 2c Td] [9c]
yairpinto: checks 
Manon947: bets 1194
yairpinto: folds 
Uncalled bet (1194) returned to Manon947
Manon947 collected 1194 from pot
*** SUMMARY ***
Total pot 1264 | Rake 70 
Board [8d 2c Td 9c]
Seat 1: dddocky folded before Flop (didn't bet)
Seat 2: FragileMemory (button) folded on the Flop
Seat 3: Duke Croix (small blind) folded before Flop
Seat 4: yairpinto (big blind) folded on the Turn
Seat 6: color_singleton folded before Flop (didn't bet)
Seat 8: JeBoyDirk folded before Flop (didn't bet)
Seat 9: Manon947 collected (1194)



PokerStars Home Game Hand #218085826765: {Club #3225207}  Hold'em No Limit (50/100) - 2020/09/03 15:58:12 ET
Table 'fun gamez' 9-max (Play Money) Seat #3 is the button
Seat 1: dddocky (6059 in chips) 
Seat 2: FragileMemory (6549 in chips) 
Seat 3: Duke Croix (18072 in chips) 
Seat 4: yairpinto (6688 in chips) 
Seat 6: color_singleton (16626 in chips) 
Seat 8: JeBoyDirk (30891 in chips) 
Seat 9: Manon947 (3750 in chips) 
yairpinto: posts small blind 50
color_singleton: posts big blind 100
*** HOLE CARDS ***
Dealt to Duke Croix [3c Ad]
JeBoyDirk: folds 
Manon947: folds 
dddocky: folds 
FragileMemory: raises 100 to 200
Duke Croix: calls 200
yairpinto: folds 
color_singleton: calls 100
*** FLOP *** [5h 4h 6s]
color_singleton: checks 
FragileMemory: bets 100
Duke Croix: raises 400 to 500
color_singleton: folds 
FragileMemory: folds 
Uncalled bet (400) returned to Duke Croix
Duke Croix collected 803 from pot
*** SUMMARY ***
Total pot 850 | Rake 47 
Board [5h 4h 6s]
Seat 1: dddocky folded before Flop (didn't bet)
Seat 2: FragileMemory folded on the Flop
Seat 3: Duke Croix (button) collected (803)
Seat 4: yairpinto (small blind) folded before Flop
Seat 6: color_singleton (big blind) folded on the Flop
Seat 8: JeBoyDirk folded before Flop (didn't bet)
Seat 9: Manon947 folded before Flop (didn't bet)



PokerStars Home Game Hand #218085845511: {Club #3225207}  Hold'em No Limit (50/100) - 2020/09/03 15:58:54 ET
Table 'fun gamez' 9-max (Play Money) Seat #4 is the button
Seat 1: dddocky (6059 in chips) 
Seat 2: FragileMemory (6249 in chips) 
Seat 3: Duke Croix (18575 in chips) 
Seat 4: yairpinto (6638 in chips) 
Seat 6: color_singleton (16426 in chips) 
Seat 8: JeBoyDirk (30891 in chips) 
Seat 9: Manon947 (3750 in chips) 
color_singleton: posts small blind 50
JeBoyDirk: posts big blind 100
*** HOLE CARDS ***
Dealt to Duke Croix [Tc 6s]
Manon947: calls 100
dddocky: folds 
FragileMemory: folds 
Duke Croix: folds 
yairpinto: calls 100
color_singleton: raises 100 to 200
JeBoyDirk: raises 100 to 300
Manon947: folds 
yairpinto: calls 200
color_singleton: calls 100
*** FLOP *** [9d 9h 6c]
color_singleton: checks 
JeBoyDirk: bets 600
yairpinto: folds 
color_singleton: folds 
Uncalled bet (600) returned to JeBoyDirk
JeBoyDirk collected 945 from pot
*** SUMMARY ***
Total pot 1000 | Rake 55 
Board [9d 9h 6c]
Seat 1: dddocky folded before Flop (didn't bet)
Seat 2: FragileMemory folded before Flop (didn't bet)
Seat 3: Duke Croix folded before Flop (didn't bet)
Seat 4: yairpinto (button) folded on the Flop
Seat 6: color_singleton (small blind) folded on the Flop
Seat 8: JeBoyDirk (big blind) collected (945)
Seat 9: Manon947 folded before Flop



PokerStars Home Game Hand #218085862523: {Club #3225207}  Hold'em No Limit (50/100) - 2020/09/03 15:59:32 ET
Table 'fun gamez' 9-max (Play Money) Seat #6 is the button
Seat 1: dddocky (6059 in chips) 
Seat 2: FragileMemory (6249 in chips) 
Seat 3: Duke Croix (18575 in chips) 
Seat 4: yairpinto (6338 in chips) 
Seat 6: color_singleton (16126 in chips) 
Seat 8: JeBoyDirk (31536 in chips) 
Seat 9: Manon947 (3650 in chips) 
JeBoyDirk: posts small blind 50
Manon947: posts big blind 100
*** HOLE CARDS ***
Dealt to Duke Croix [Kd As]
dddocky: calls 100
FragileMemory: calls 100
Duke Croix: raises 400 to 500
yairpinto: calls 500
color_singleton: folds 
JeBoyDirk: folds 
Manon947: calls 400
dddocky: calls 400
FragileMemory: raises 400 to 900
Duke Croix: calls 400
yairpinto: calls 400
Manon947: folds 
dddocky: folds 
*** FLOP *** [5c Td 2d]
FragileMemory: bets 100
Duke Croix: calls 100
yairpinto: calls 100
*** TURN *** [5c Td 2d] [Jh]
FragileMemory: bets 100
Duke Croix: calls 100
yairpinto: raises 4127 to 4227
FragileMemory: folds 
Duke Croix: folds 
Uncalled bet (4127) returned to yairpinto
yairpinto collected 4111 from pot
yairpinto: doesn't show hand 
*** SUMMARY ***
Total pot 4350 | Rake 239 
Board [5c Td 2d Jh]
Seat 1: dddocky folded before Flop
Seat 2: FragileMemory folded on the Turn
Seat 3: Duke Croix folded on the Turn
Seat 4: yairpinto collected (4111)
Seat 6: color_singleton (button) folded before Flop (didn't bet)
Seat 8: JeBoyDirk (small blind) folded before Flop
Seat 9: Manon947 (big blind) folded before Flop



PokerStars Home Game Hand #218085894826: {Club #3225207}  Hold'em No Limit (50/100) - 2020/09/03 16:00:40 ET
Table 'fun gamez' 9-max (Play Money) Seat #8 is the button
Seat 1: dddocky (5559 in chips) 
Seat 2: FragileMemory (5149 in chips) 
Seat 3: Duke Croix (17475 in chips) 
Seat 4: yairpinto (9349 in chips) 
Seat 6: color_singleton (16126 in chips) 
Seat 8: JeBoyDirk (31486 in chips) 
Seat 9: Manon947 (3150 in chips) 
Manon947: posts small blind 50
dddocky: posts big blind 100
*** HOLE CARDS ***
Dealt to Duke Croix [As Td]
FragileMemory: calls 100
Duke Croix: calls 100
yairpinto: folds 
color_singleton: folds 
JeBoyDirk: folds 
Manon947: calls 50
dddocky: checks 
*** FLOP *** [Qh Jh Ks]
Manon947: bets 100
dddocky: calls 100
FragileMemory: raises 339 to 439
Duke Croix: raises 661 to 1100
Manon947: calls 1000
dddocky: folds 
FragileMemory: raises 661 to 1761
Duke Croix: raises 1039 to 2800
Manon947: calls 1700
FragileMemory: raises 2249 to 5049 and is all-in
Duke Croix: raises 12326 to 17375 and is all-in
Manon947: calls 250 and is all-in
Uncalled bet (12326) returned to Duke Croix
*** TURN *** [Qh Jh Ks] [Ad]
*** RIVER *** [Qh Jh Ks Ad] [8h]
*** SHOW DOWN ***
FragileMemory: shows [Qc Jc] (two pair, Queens and Jacks)
Duke Croix: shows [As Td] (a straight, Ten to Ace)
Duke Croix collected 3778 from side pot
Manon947: shows [Qs Kh] (two pair, Kings and Queens)
Duke Croix collected 9119 from main pot
*** SUMMARY ***
Total pot 13648 Main pot 9119. Side pot 3778. | Rake 751 
Board [Qh Jh Ks Ad 8h]
Seat 1: dddocky (big blind) folded on the Flop
Seat 2: FragileMemory showed [Qc Jc] and lost with two pair, Queens and Jacks
Seat 3: Duke Croix showed [As Td] and won (12897) with a straight, Ten to Ace
Seat 4: yairpinto folded before Flop (didn't bet)
Seat 6: color_singleton folded before Flop (didn't bet)
Seat 8: JeBoyDirk (button) folded before Flop (didn't bet)
Seat 9: Manon947 (small blind) showed [Qs Kh] and lost with two pair, Kings and Queens



PokerStars Home Game Hand #218085932284: {Club #3225207}  Hold'em No Limit (50/100) - 2020/09/03 16:01:50 ET
Table 'fun gamez' 9-max (Play Money) Seat #1 is the button
Seat 1: dddocky (5359 in chips) 
Seat 3: Duke Croix (25223 in chips) 
Seat 4: yairpinto (9349 in chips) 
Seat 6: color_singleton (16126 in chips) 
Seat 8: JeBoyDirk (31486 in chips) 
Duke Croix: posts small blind 50
yairpinto: posts big blind 100
*** HOLE CARDS ***
Dealt to Duke Croix [Th 2s]
color_singleton: folds 
JeBoyDirk: folds 
dddocky: calls 100
Duke Croix: folds 
yairpinto: checks 
*** FLOP *** [Ah Kc 4s]
yairpinto: checks 
dddocky: checks 
*** TURN *** [Ah Kc 4s] [8h]
yairpinto: checks 
dddocky: checks 
*** RIVER *** [Ah Kc 4s 8h] [4c]
yairpinto: bets 118
dddocky: calls 118
*** SHOW DOWN ***
yairpinto: shows [Td Qc] (a pair of Fours)
dddocky: mucks hand 
yairpinto collected 459 from pot
*** SUMMARY ***
Total pot 486 | Rake 27 
Board [Ah Kc 4s 8h 4c]
Seat 1: dddocky (button) mucked [Jc 2d]
Seat 3: Duke Croix (small blind) folded before Flop
Seat 4: yairpinto (big blind) showed [Td Qc] and won (459) with a pair of Fours
Seat 6: color_singleton folded before Flop (didn't bet)
Seat 8: JeBoyDirk folded before Flop (didn't bet)



PokerStars Home Game Hand #218085949968: {Club #3225207}  Hold'em No Limit (50/100) - 2020/09/03 16:02:19 ET
Table 'fun gamez' 9-max (Play Money) Seat #3 is the button
Seat 1: dddocky (5141 in chips) 
Seat 2: FragileMemory (10000 in chips) 
Seat 3: Duke Croix (25173 in chips) 
Seat 4: yairpinto (9590 in chips) 
Seat 6: color_singleton (16126 in chips) 
Seat 8: JeBoyDirk (31486 in chips) 
yairpinto: posts small blind 50
color_singleton: posts big blind 100
FragileMemory: posts small blind 50
*** HOLE CARDS ***
Dealt to Duke Croix [Ad Th]
JeBoyDirk: folds 
dddocky: calls 100
FragileMemory: calls 100
Duke Croix: raises 400 to 500
yairpinto: folds 
color_singleton: folds 
dddocky: folds 
FragileMemory: folds 
Uncalled bet (400) returned to Duke Croix
Duke Croix collected 500 from pot
*** SUMMARY ***
Total pot 500 | Rake 0 
Seat 1: dddocky folded before Flop
Seat 2: FragileMemory folded before Flop
Seat 3: Duke Croix (button) collected (500)
Seat 4: yairpinto (small blind) folded before Flop
Seat 6: color_singleton (big blind) folded before Flop
Seat 8: JeBoyDirk folded before Flop (didn't bet)



PokerStars Home Game Hand #218085963775: {Club #3225207}  Hold'em No Limit (50/100) - 2020/09/03 16:02:41 ET
Table 'fun gamez' 9-max (Play Money) Seat #4 is the button
Seat 1: dddocky (5041 in chips) 
Seat 2: FragileMemory (9850 in chips) 
Seat 3: Duke Croix (25573 in chips) 
Seat 4: yairpinto (9540 in chips) 
Seat 6: color_singleton (16026 in chips) 
Seat 8: JeBoyDirk (31486 in chips) 
color_singleton: posts small blind 50
JeBoyDirk: posts big blind 100
*** HOLE CARDS ***
Dealt to Duke Croix [2d Ah]
dddocky: calls 100
FragileMemory: calls 100
Duke Croix: raises 400 to 500
yairpinto: folds 
color_singleton: folds 
JeBoyDirk: folds 
dddocky: calls 400
FragileMemory: calls 400
*** FLOP *** [4h 5s 8s]
dddocky: bets 1559
FragileMemory: folds 
Duke Croix: folds 
Uncalled bet (1559) returned to dddocky
dddocky collected 1559 from pot
dddocky: doesn't show hand 
*** SUMMARY ***
Total pot 1650 | Rake 91 
Board [4h 5s 8s]
Seat 1: dddocky collected (1559)
Seat 2: FragileMemory folded on the Flop
Seat 3: Duke Croix folded on the Flop
Seat 4: yairpinto (button) folded before Flop (didn't bet)
Seat 6: color_singleton (small blind) folded before Flop
Seat 8: JeBoyDirk (big blind) folded before Flop



PokerStars Home Game Hand #218085981497: {Club #3225207}  Hold'em No Limit (50/100) - 2020/09/03 16:03:11 ET
Table 'fun gamez' 9-max (Play Money) Seat #6 is the button
Seat 1: dddocky (6100 in chips) 
Seat 2: FragileMemory (9350 in chips) 
Seat 3: Duke Croix (25073 in chips) 
Seat 4: yairpinto (9540 in chips) 
Seat 6: color_singleton (15976 in chips) 
Seat 8: JeBoyDirk (31386 in chips) 
JeBoyDirk: posts small blind 50
dddocky: posts big blind 100
*** HOLE CARDS ***
Dealt to Duke Croix [9c 7s]
FragileMemory: calls 100
Duke Croix: calls 100
yairpinto: folds 
color_singleton: folds 
JeBoyDirk: folds 
dddocky: checks 
*** FLOP *** [6s 3d Ts]
dddocky: checks 
FragileMemory: checks 
Duke Croix: checks 
*** TURN *** [6s 3d Ts] [7h]
dddocky: checks 
FragileMemory: bets 165
Duke Croix: calls 165
dddocky: folds 
*** RIVER *** [6s 3d Ts 7h] [8c]
FragileMemory: checks 
Duke Croix: bets 500
Manon947 leaves the table
FragileMemory: calls 500
*** SHOW DOWN ***
Duke Croix: shows [9c 7s] (a straight, Six to Ten)
FragileMemory: mucks hand 
Duke Croix collected 1588 from pot
*** SUMMARY ***
Total pot 1680 | Rake 92 
Board [6s 3d Ts 7h 8c]
Seat 1: dddocky (big blind) folded on the Turn
Seat 2: FragileMemory mucked [Ad 7c]
Seat 3: Duke Croix showed [9c 7s] and won (1588) with a straight, Six to Ten
Seat 4: yairpinto folded before Flop (didn't bet)
Seat 6: color_singleton (button) folded before Flop (didn't bet)
Seat 8: JeBoyDirk (small blind) folded before Flop



PokerStars Home Game Hand #218086013707: {Club #3225207}  Hold'em No Limit (50/100) - 2020/09/03 16:04:04 ET
Table 'fun gamez' 9-max (Play Money) Seat #8 is the button
Seat 1: dddocky (6000 in chips) 
Seat 2: FragileMemory (8585 in chips) 
Seat 3: Duke Croix (25896 in chips) 
Seat 4: yairpinto (9540 in chips) 
Seat 6: color_singleton (15976 in chips) 
Seat 8: JeBoyDirk (31336 in chips) 
dddocky: posts small blind 50
FragileMemory: posts big blind 100
*** HOLE CARDS ***
Dealt to Duke Croix [5c 2d]
Duke Croix: folds 
yairpinto: folds 
color_singleton: raises 200 to 300
JeBoyDirk: calls 300
dddocky: folds 
FragileMemory: calls 200
*** FLOP *** [Ts Ad Kc]
FragileMemory: checks 
color_singleton: checks 
JeBoyDirk: checks 
*** TURN *** [Ts Ad Kc] [Jd]
FragileMemory: checks 
color_singleton: checks 
JeBoyDirk: bets 500
FragileMemory: raises 500 to 1000
color_singleton: folds 
JeBoyDirk: calls 500
*** RIVER *** [Ts Ad Kc Jd] [7h]
FragileMemory: bets 1394
JeBoyDirk: calls 1394
*** SHOW DOWN ***
FragileMemory: shows [Qd Td] (a straight, Ten to Ace)
JeBoyDirk: shows [Qh Js] (a straight, Ten to Ace)
FragileMemory collected 2711 from pot
JeBoyDirk collected 2711 from pot
*** SUMMARY ***
Total pot 5738 | Rake 316 
Board [Ts Ad Kc Jd 7h]
Seat 1: dddocky (small blind) folded before Flop
Seat 2: FragileMemory (big blind) showed [Qd Td] and won (2711) with a straight, Ten to Ace
Seat 3: Duke Croix folded before Flop (didn't bet)
Seat 4: yairpinto folded before Flop (didn't bet)
Seat 6: color_singleton folded on the Turn
Seat 8: JeBoyDirk (button) showed [Qh Js] and won (2711) with a straight, Ten to Ace



PokerStars Home Game Hand #218086045456: {Club #3225207}  Hold'em No Limit (50/100) - 2020/09/03 16:04:55 ET
Table 'fun gamez' 9-max (Play Money) Seat #1 is the button
Seat 1: dddocky (5950 in chips) 
Seat 2: FragileMemory (8602 in chips) 
Seat 3: Duke Croix (25896 in chips) 
Seat 4: yairpinto (9540 in chips) 
Seat 6: color_singleton (15676 in chips) 
Seat 8: JeBoyDirk (31353 in chips) 
FragileMemory: posts small blind 50
Duke Croix: posts big blind 100
*** HOLE CARDS ***
Dealt to Duke Croix [Qd Th]
yairpinto: folds 
color_singleton: folds 
JeBoyDirk: folds 
dddocky: folds 
FragileMemory: calls 50
Duke Croix: raises 400 to 500
FragileMemory: folds 
Uncalled bet (400) returned to Duke Croix
Duke Croix collected 200 from pot
*** SUMMARY ***
Total pot 200 | Rake 0 
Seat 1: dddocky (button) folded before Flop (didn't bet)
Seat 2: FragileMemory (small blind) folded before Flop
Seat 3: Duke Croix (big blind) collected (200)
Seat 4: yairpinto folded before Flop (didn't bet)
Seat 6: color_singleton folded before Flop (didn't bet)
Seat 8: JeBoyDirk folded before Flop (didn't bet)



PokerStars Home Game Hand #218086059554: {Club #3225207}  Hold'em No Limit (50/100) - 2020/09/03 16:05:17 ET
Table 'fun gamez' 9-max (Play Money) Seat #2 is the button
Seat 1: dddocky (5950 in chips) 
Seat 2: FragileMemory (8502 in chips) 
Seat 3: Duke Croix (25996 in chips) 
Seat 4: yairpinto (9540 in chips) 
Seat 6: color_singleton (15676 in chips) 
Seat 8: JeBoyDirk (31353 in chips) 
Duke Croix: posts small blind 50
yairpinto: posts big blind 100
*** HOLE CARDS ***
Dealt to Duke Croix [5c 2c]
color_singleton: raises 200 to 300
JeBoyDirk: folds 
dddocky: folds 
FragileMemory: calls 300
Duke Croix: folds 
yairpinto: folds 
*** FLOP *** [4s Js Th]
color_singleton: bets 354
FragileMemory: folds 
Uncalled bet (354) returned to color_singleton
color_singleton collected 709 from pot
color_singleton: doesn't show hand 
*** SUMMARY ***
Total pot 750 | Rake 41 
Board [4s Js Th]
Seat 1: dddocky folded before Flop (didn't bet)
Seat 2: FragileMemory (button) folded on the Flop
Seat 3: Duke Croix (small blind) folded before Flop
Seat 4: yairpinto (big blind) folded before Flop
Seat 6: color_singleton collected (709)
Seat 8: JeBoyDirk folded before Flop (didn't bet)



PokerStars Home Game Hand #218086074913: {Club #3225207}  Hold'em No Limit (50/100) - 2020/09/03 16:05:42 ET
Table 'fun gamez' 9-max (Play Money) Seat #3 is the button
Seat 1: dddocky (5950 in chips) 
Seat 2: FragileMemory (8202 in chips) 
Seat 3: Duke Croix (25946 in chips) 
Seat 4: yairpinto (9440 in chips) 
Seat 6: color_singleton (16085 in chips) 
Seat 8: JeBoyDirk (31353 in chips) 
yairpinto: posts small blind 50
color_singleton: posts big blind 100
*** HOLE CARDS ***
Dealt to Duke Croix [3h Tc]
JeBoyDirk: folds 
dddocky: calls 100
FragileMemory: folds 
Duke Croix: folds 
yairpinto: raises 200 to 300
color_singleton: calls 200
dddocky: calls 200
*** FLOP *** [Th 5d 8d]
yairpinto: bets 425
color_singleton: calls 425
dddocky: calls 425
*** TURN *** [Th 5d 8d] [Kd]
yairpinto: checks 
color_singleton: checks 
dddocky: checks 
*** RIVER *** [Th 5d 8d Kd] [8s]
yairpinto: bets 2055
color_singleton: calls 2055
dddocky: folds 
*** SHOW DOWN ***
yairpinto: shows [Td Ts] (a full house, Tens full of Eights)
color_singleton: mucks hand 
yairpinto collected 5939 from pot
*** SUMMARY ***
Total pot 6285 | Rake 346 
Board [Th 5d 8d Kd 8s]
Seat 1: dddocky folded on the River
Seat 2: FragileMemory folded before Flop (didn't bet)
Seat 3: Duke Croix (button) folded before Flop (didn't bet)
Seat 4: yairpinto (small blind) showed [Td Ts] and won (5939) with a full house, Tens full of Eights
Seat 6: color_singleton (big blind) mucked [8c Jh]
Seat 8: JeBoyDirk folded before Flop (didn't bet)



PokerStars Home Game Hand #218086115993: {Club #3225207}  Hold'em No Limit (50/100) - 2020/09/03 16:06:37 ET
Table 'fun gamez' 9-max (Play Money) Seat #4 is the button
Seat 1: dddocky (5225 in chips) 
Seat 2: FragileMemory (8202 in chips) 
Seat 3: Duke Croix (25946 in chips) 
Seat 4: yairpinto (12599 in chips) 
Seat 6: color_singleton (13305 in chips) 
Seat 8: JeBoyDirk (31353 in chips) 
color_singleton: posts small blind 50
JeBoyDirk: posts big blind 100
*** HOLE CARDS ***
Dealt to Duke Croix [5s 4d]
dddocky: calls 100
FragileMemory: calls 100
Duke Croix: calls 100
yairpinto: raises 550 to 650
color_singleton: folds 
JeBoyDirk: folds 
dddocky: folds 
FragileMemory: folds 
Duke Croix: calls 550
*** FLOP *** [4s Td Ac]
Duke Croix: checks 
yairpinto: bets 779
Duke Croix: folds 
Uncalled bet (779) returned to yairpinto
yairpinto collected 1559 from pot
yairpinto: doesn't show hand 
*** SUMMARY ***
Total pot 1650 | Rake 91 
Board [4s Td Ac]
Seat 1: dddocky folded before Flop
Seat 2: FragileMemory folded before Flop
Seat 3: Duke Croix folded on the Flop
Seat 4: yairpinto (button) collected (1559)
Seat 6: color_singleton (small blind) folded before Flop
Seat 8: JeBoyDirk (big blind) folded before Flop



PokerStars Home Game Hand #218086137993: {Club #3225207}  Hold'em No Limit (50/100) - 2020/09/03 16:07:12 ET
Table 'fun gamez' 9-max (Play Money) Seat #6 is the button
Seat 1: dddocky (5125 in chips) 
Seat 2: FragileMemory (8102 in chips) 
Seat 3: Duke Croix (25296 in chips) 
Seat 4: yairpinto (13508 in chips) 
Seat 6: color_singleton (13255 in chips) 
Seat 8: JeBoyDirk (31253 in chips) 
JeBoyDirk: posts small blind 50
dddocky: posts big blind 100
*** HOLE CARDS ***
Dealt to Duke Croix [5d Ah]
FragileMemory: folds 
Duke Croix: raises 200 to 300
yairpinto: folds 
color_singleton: folds 
JeBoyDirk: folds 
dddocky: folds 
Uncalled bet (200) returned to Duke Croix
Duke Croix collected 250 from pot
*** SUMMARY ***
Total pot 250 | Rake 0 
Seat 1: dddocky (big blind) folded before Flop
Seat 2: FragileMemory folded before Flop (didn't bet)
Seat 3: Duke Croix collected (250)
Seat 4: yairpinto folded before Flop (didn't bet)
Seat 6: color_singleton (button) folded before Flop (didn't bet)
Seat 8: JeBoyDirk (small blind) folded before Flop



PokerStars Home Game Hand #218086147164: {Club #3225207}  Hold'em No Limit (50/100) - 2020/09/03 16:07:27 ET
Table 'fun gamez' 9-max (Play Money) Seat #8 is the button
Seat 1: dddocky (5025 in chips) 
Seat 2: FragileMemory (8102 in chips) 
Seat 3: Duke Croix (25446 in chips) 
Seat 4: yairpinto (13508 in chips) 
Seat 6: color_singleton (13255 in chips) 
Seat 8: JeBoyDirk (31203 in chips) 
dddocky: posts small blind 50
FragileMemory: posts big blind 100
*** HOLE CARDS ***
Dealt to Duke Croix [Ks 8s]
Duke Croix: raises 200 to 300
yairpinto: folds 
color_singleton: calls 300
JeBoyDirk: folds 
dddocky: folds 
FragileMemory: folds 
*** FLOP *** [Kc Ts Js]
Duke Croix: bets 400
color_singleton: calls 400
*** TURN *** [Kc Ts Js] [5s]
Duke Croix: checks 
color_singleton: bets 732
Duke Croix: raises 968 to 1700
color_singleton: calls 968
*** RIVER *** [Kc Ts Js 5s] [Jd]
Duke Croix: checks 
color_singleton: checks 
*** SHOW DOWN ***
Duke Croix: shows [Ks 8s] (a flush, King high)
color_singleton: mucks hand 
Duke Croix collected 4678 from pot
*** SUMMARY ***
Total pot 4950 | Rake 272 
Board [Kc Ts Js 5s Jd]
Seat 1: dddocky (small blind) folded before Flop
Seat 2: FragileMemory (big blind) folded before Flop
Seat 3: Duke Croix showed [Ks 8s] and won (4678) with a flush, King high
Seat 4: yairpinto folded before Flop (didn't bet)
Seat 6: color_singleton mucked [5c As]
Seat 8: JeBoyDirk (button) folded before Flop (didn't bet)



PokerStars Home Game Hand #218086169180: {Club #3225207}  Hold'em No Limit (50/100) - 2020/09/03 16:08:03 ET
Table 'fun gamez' 9-max (Play Money) Seat #1 is the button
Seat 1: dddocky (4975 in chips) 
Seat 2: FragileMemory (8002 in chips) 
Seat 3: Duke Croix (27724 in chips) 
Seat 4: yairpinto (13508 in chips) 
Seat 6: color_singleton (10855 in chips) 
Seat 8: JeBoyDirk (31203 in chips) 
FragileMemory: posts small blind 50
Duke Croix: posts big blind 100
*** HOLE CARDS ***
Dealt to Duke Croix [2d 7d]
yairpinto: folds 
color_singleton: folds 
JeBoyDirk: folds 
dddocky: calls 100
FragileMemory: calls 50
Duke Croix: checks 
*** FLOP *** [8s Qs 9s]
FragileMemory: checks 
Duke Croix: checks 
dddocky: checks 
*** TURN *** [8s Qs 9s] [6s]
FragileMemory: bets 141
Duke Croix: folds 
dddocky: calls 141
*** RIVER *** [8s Qs 9s 6s] [4c]
FragileMemory: checks 
dddocky: checks 
*** SHOW DOWN ***
FragileMemory: shows [3s 5d] (a flush, Queen high)
dddocky: mucks hand 
FragileMemory collected 550 from pot
*** SUMMARY ***
Total pot 582 | Rake 32 
Board [8s Qs 9s 6s 4c]
Seat 1: dddocky (button) mucked [Jc Ac]
Seat 2: FragileMemory (small blind) showed [3s 5d] and won (550) with a flush, Queen high
Seat 3: Duke Croix (big blind) folded on the Turn
Seat 4: yairpinto folded before Flop (didn't bet)
Seat 6: color_singleton folded before Flop (didn't bet)
Seat 8: JeBoyDirk folded before Flop (didn't bet)



PokerStars Home Game Hand #218086193106: {Club #3225207}  Hold'em No Limit (50/100) - 2020/09/03 16:08:41 ET
Table 'fun gamez' 9-max (Play Money) Seat #2 is the button
Seat 1: dddocky (4734 in chips) 
Seat 2: FragileMemory (8311 in chips) 
Seat 3: Duke Croix (27624 in chips) 
Seat 4: yairpinto (13508 in chips) 
Seat 6: color_singleton (10855 in chips) 
Seat 8: JeBoyDirk (31203 in chips) 
Duke Croix: posts small blind 50
yairpinto: posts big blind 100
*** HOLE CARDS ***
Dealt to Duke Croix [Ac Qh]
color_singleton: folds 
JeBoyDirk: calls 100
dddocky: calls 100
FragileMemory: calls 100
Duke Croix: calls 50
yairpinto: checks 
*** FLOP *** [Jd Tc Qd]
Duke Croix: bets 300
yairpinto: folds 
JeBoyDirk: calls 300
dddocky: raises 300 to 600
FragileMemory: folds 
Duke Croix: calls 300
JeBoyDirk: calls 300
*** TURN *** [Jd Tc Qd] [Ah]
Duke Croix: checks 
JeBoyDirk: checks 
dddocky: checks 
*** RIVER *** [Jd Tc Qd Ah] [8h]
Duke Croix: bets 1000
JeBoyDirk: raises 1000 to 2000
dddocky: raises 1000 to 3000
Duke Croix: folds 
JeBoyDirk: raises 1000 to 4000
dddocky: calls 1000
*** SHOW DOWN ***
JeBoyDirk: shows [Jc Ks] (a straight, Ten to Ace)
dddocky: shows [Qs Kd] (a straight, Ten to Ace)
JeBoyDirk collected 5339 from pot
dddocky collected 5339 from pot
*** SUMMARY ***
Total pot 11300 | Rake 622 
Board [Jd Tc Qd Ah 8h]
Seat 1: dddocky showed [Qs Kd] and won (5339) with a straight, Ten to Ace
Seat 2: FragileMemory (button) folded on the Flop
Seat 3: Duke Croix (small blind) folded on the River
Seat 4: yairpinto (big blind) folded on the Flop
Seat 6: color_singleton folded before Flop (didn't bet)
Seat 8: JeBoyDirk showed [Jc Ks] and won (5339) with a straight, Ten to Ace



PokerStars Home Game Hand #218086231682: {Club #3225207}  Hold'em No Limit (50/100) - 2020/09/03 16:09:43 ET
Table 'fun gamez' 9-max (Play Money) Seat #3 is the button
Seat 1: dddocky (5373 in chips) 
Seat 2: FragileMemory (8211 in chips) 
Seat 3: Duke Croix (25924 in chips) 
Seat 4: yairpinto (13408 in chips) 
Seat 6: color_singleton (10855 in chips) 
Seat 8: JeBoyDirk (31842 in chips) 
yairpinto: posts small blind 50
color_singleton: posts big blind 100
*** HOLE CARDS ***
Dealt to Duke Croix [Jc 5s]
JeBoyDirk: folds 
dddocky: calls 100
FragileMemory: calls 100
Duke Croix: folds 
yairpinto: calls 50
color_singleton: checks 
*** FLOP *** [Qd Qs 3s]
yairpinto: checks 
color_singleton: checks 
dddocky: checks 
FragileMemory: checks 
*** TURN *** [Qd Qs 3s] [Th]
yairpinto: bets 189
color_singleton: folds 
dddocky: calls 189
FragileMemory: folds 
*** RIVER *** [Qd Qs 3s Th] [Ad]
yairpinto: checks 
dddocky: checks 
*** SHOW DOWN ***
yairpinto: shows [7h Td] (two pair, Queens and Tens)
dddocky: shows [Tc 5c] (two pair, Queens and Tens)
yairpinto collected 368 from pot
dddocky collected 367 from pot
*** SUMMARY ***
Total pot 778 | Rake 43 
Board [Qd Qs 3s Th Ad]
Seat 1: dddocky showed [Tc 5c] and won (367) with two pair, Queens and Tens
Seat 2: FragileMemory folded on the Turn
Seat 3: Duke Croix (button) folded before Flop (didn't bet)
Seat 4: yairpinto (small blind) showed [7h Td] and won (368) with two pair, Queens and Tens
Seat 6: color_singleton (big blind) folded on the Turn
Seat 8: JeBoyDirk folded before Flop (didn't bet)



PokerStars Home Game Hand #218086261770: {Club #3225207}  Hold'em No Limit (50/100) - 2020/09/03 16:10:32 ET
Table 'fun gamez' 9-max (Play Money) Seat #4 is the button
Seat 1: dddocky (5451 in chips) 
Seat 2: FragileMemory (8111 in chips) 
Seat 3: Duke Croix (25924 in chips) 
Seat 4: yairpinto (13487 in chips) 
Seat 6: color_singleton (10755 in chips) 
Seat 8: JeBoyDirk (31842 in chips) 
color_singleton: posts small blind 50
JeBoyDirk: posts big blind 100
*** HOLE CARDS ***
Dealt to Duke Croix [Qs 7d]
dddocky: folds 
FragileMemory: folds 
Duke Croix: folds 
yairpinto: raises 200 to 300
color_singleton: folds 
JeBoyDirk: folds 
Uncalled bet (200) returned to yairpinto
yairpinto collected 250 from pot
yairpinto: doesn't show hand 
*** SUMMARY ***
Total pot 250 | Rake 0 
Seat 1: dddocky folded before Flop (didn't bet)
Seat 2: FragileMemory folded before Flop (didn't bet)
Seat 3: Duke Croix folded before Flop (didn't bet)
Seat 4: yairpinto (button) collected (250)
Seat 6: color_singleton (small blind) folded before Flop
Seat 8: JeBoyDirk (big blind) folded before Flop



PokerStars Home Game Hand #218086268723: {Club #3225207}  Hold'em No Limit (50/100) - 2020/09/03 16:10:43 ET
Table 'fun gamez' 9-max (Play Money) Seat #6 is the button
Seat 1: dddocky (5451 in chips) 
Seat 2: FragileMemory (8111 in chips) 
Seat 3: Duke Croix (25924 in chips) 
Seat 4: yairpinto (13637 in chips) 
Seat 6: color_singleton (10705 in chips) 
Seat 8: JeBoyDirk (31742 in chips) 
JeBoyDirk: posts small blind 50
dddocky: posts big blind 100
*** HOLE CARDS ***
Dealt to Duke Croix [Qc 6d]
FragileMemory: folds 
Duke Croix: folds 
yairpinto: raises 200 to 300
color_singleton: calls 300
JeBoyDirk: folds 
dddocky: calls 200
*** FLOP *** [5d Ah 8d]
dddocky: bets 100
yairpinto: raises 549 to 649
color_singleton: calls 649
dddocky: calls 549
*** TURN *** [5d Ah 8d] [Jh]
dddocky: bets 1369
yairpinto: folds 
color_singleton: folds 
Uncalled bet (1369) returned to dddocky
dddocky collected 2738 from pot
*** SUMMARY ***
Total pot 2897 | Rake 159 
Board [5d Ah 8d Jh]
Seat 1: dddocky (big blind) collected (2738)
Seat 2: FragileMemory folded before Flop (didn't bet)
Seat 3: Duke Croix folded before Flop (didn't bet)
Seat 4: yairpinto folded on the Turn
Seat 6: color_singleton (button) folded on the Turn
Seat 8: JeBoyDirk (small blind) folded before Flop



PokerStars Home Game Hand #218086294233: {Club #3225207}  Hold'em No Limit (50/100) - 2020/09/03 16:11:24 ET
Table 'fun gamez' 9-max (Play Money) Seat #8 is the button
Seat 1: dddocky (7240 in chips) 
Seat 2: FragileMemory (8111 in chips) 
Seat 3: Duke Croix (25924 in chips) 
Seat 4: yairpinto (12688 in chips) 
Seat 6: color_singleton (9756 in chips) 
Seat 8: JeBoyDirk (31692 in chips) 
dddocky: posts small blind 50
FragileMemory: posts big blind 100
*** HOLE CARDS ***
Dealt to Duke Croix [4d Qs]
Duke Croix: folds 
yairpinto: calls 100
color_singleton: folds 
JeBoyDirk: folds 
dddocky: folds 
FragileMemory: checks 
*** FLOP *** [Ks Td Th]
FragileMemory: checks 
yairpinto: bets 118
FragileMemory: calls 118
*** TURN *** [Ks Td Th] [6c]
FragileMemory: checks 
yairpinto: bets 229
FragileMemory: calls 229
*** RIVER *** [Ks Td Th 6c] [Qd]
FragileMemory: checks 
yairpinto: bets 446
FragileMemory: folds 
Uncalled bet (446) returned to yairpinto
yairpinto collected 892 from pot
yairpinto: doesn't show hand 
*** SUMMARY ***
Total pot 944 | Rake 52 
Board [Ks Td Th 6c Qd]
Seat 1: dddocky (small blind) folded before Flop
Seat 2: FragileMemory (big blind) folded on the River
Seat 3: Duke Croix folded before Flop (didn't bet)
Seat 4: yairpinto collected (892)
Seat 6: color_singleton folded before Flop (didn't bet)
Seat 8: JeBoyDirk (button) folded before Flop (didn't bet)



PokerStars Home Game Hand #218086323748: {Club #3225207}  Hold'em No Limit (50/100) - 2020/09/03 16:12:12 ET
Table 'fun gamez' 9-max (Play Money) Seat #2 is the button
Seat 2: FragileMemory (7664 in chips) 
Seat 3: Duke Croix (25924 in chips) 
Seat 4: yairpinto (13133 in chips) 
Seat 6: color_singleton (9756 in chips) 
Seat 8: JeBoyDirk (31692 in chips) 
Duke Croix: posts small blind 50
yairpinto: posts big blind 100
*** HOLE CARDS ***
Dealt to Duke Croix [9h 2d]
color_singleton: folds 
JeBoyDirk: calls 100
FragileMemory: folds 
Duke Croix: folds 
yairpinto: checks 
*** FLOP *** [5s 7h 7c]
yairpinto: bets 118
JeBoyDirk: folds 
Uncalled bet (118) returned to yairpinto
yairpinto collected 236 from pot
yairpinto: doesn't show hand 
*** SUMMARY ***
Total pot 250 | Rake 14 
Board [5s 7h 7c]
Seat 2: FragileMemory (button) folded before Flop (didn't bet)
Seat 3: Duke Croix (small blind) folded before Flop
Seat 4: yairpinto (big blind) collected (236)
Seat 6: color_singleton folded before Flop (didn't bet)
Seat 8: JeBoyDirk folded on the Flop



PokerStars Home Game Hand #218086338935: {Club #3225207}  Hold'em No Limit (50/100) - 2020/09/03 16:12:37 ET
Table 'fun gamez' 9-max (Play Money) Seat #3 is the button
Seat 2: FragileMemory (7664 in chips) 
Seat 3: Duke Croix (25874 in chips) 
Seat 4: yairpinto (13269 in chips) 
Seat 6: color_singleton (9756 in chips) 
Seat 8: JeBoyDirk (31592 in chips) 
yairpinto: posts small blind 50
color_singleton: posts big blind 100
*** HOLE CARDS ***
Dealt to Duke Croix [2d 6d]
JeBoyDirk: folds 
FragileMemory: calls 100
Duke Croix: calls 100
yairpinto: calls 50
color_singleton: raises 200 to 300
FragileMemory: calls 200
Duke Croix: calls 200
yairpinto: calls 200
*** FLOP *** [As Qc 3s]
yairpinto: checks 
color_singleton: bets 567
FragileMemory: calls 567
Duke Croix: folds 
yairpinto: folds 
*** TURN *** [As Qc 3s] [2h]
color_singleton: bets 1103
FragileMemory: calls 1103
*** RIVER *** [As Qc 3s 2h] [5c]
color_singleton: checks 
FragileMemory: checks 
*** SHOW DOWN ***
color_singleton: shows [Ks Td] (high card Ace)
FragileMemory: shows [Ac 9s] (a pair of Aces)
FragileMemory collected 4290 from pot
*** SUMMARY ***
Total pot 4540 | Rake 250 
Board [As Qc 3s 2h 5c]
Seat 2: FragileMemory showed [Ac 9s] and won (4290) with a pair of Aces
Seat 3: Duke Croix (button) folded on the Flop
Seat 4: yairpinto (small blind) folded on the Flop
Seat 6: color_singleton (big blind) showed [Ks Td] and lost with high card Ace
Seat 8: JeBoyDirk folded before Flop (didn't bet)



PokerStars Home Game Hand #218086360749: {Club #3225207}  Hold'em No Limit (50/100) - 2020/09/03 16:13:12 ET
Table 'fun gamez' 9-max (Play Money) Seat #4 is the button
Seat 2: FragileMemory (9984 in chips) 
Seat 3: Duke Croix (25574 in chips) 
Seat 4: yairpinto (12969 in chips) 
Seat 6: color_singleton (7786 in chips) 
Seat 8: JeBoyDirk (31592 in chips) 
color_singleton: posts small blind 50
JeBoyDirk: posts big blind 100
*** HOLE CARDS ***
Dealt to Duke Croix [Kc 5c]
FragileMemory: folds 
Duke Croix: raises 200 to 300
yairpinto: folds 
color_singleton: folds 
JeBoyDirk: folds 
Uncalled bet (200) returned to Duke Croix
Duke Croix collected 250 from pot
*** SUMMARY ***
Total pot 250 | Rake 0 
Seat 2: FragileMemory folded before Flop (didn't bet)
Seat 3: Duke Croix collected (250)
Seat 4: yairpinto (button) folded before Flop (didn't bet)
Seat 6: color_singleton (small blind) folded before Flop
Seat 8: JeBoyDirk (big blind) folded before Flop



PokerStars Home Game Hand #218086370891: {Club #3225207}  Hold'em No Limit (50/100) - 2020/09/03 16:13:28 ET
Table 'fun gamez' 9-max (Play Money) Seat #6 is the button
Seat 2: FragileMemory (9984 in chips) 
Seat 3: Duke Croix (25724 in chips) 
Seat 4: yairpinto (12969 in chips) 
Seat 6: color_singleton (7736 in chips) 
Seat 8: JeBoyDirk (31492 in chips) 
JeBoyDirk: posts small blind 50
FragileMemory: posts big blind 100
*** HOLE CARDS ***
Dealt to Duke Croix [Jd 5h]
Duke Croix: folds 
yairpinto: folds 
color_singleton: raises 100 to 200
JeBoyDirk: folds 
FragileMemory: calls 100
*** FLOP *** [Td 3h 4h]
FragileMemory: checks 
color_singleton: bets 212
FragileMemory: calls 212
*** TURN *** [Td 3h 4h] [7h]
FragileMemory: checks 
color_singleton: checks 
*** RIVER *** [Td 3h 4h 7h] [Ah]
FragileMemory: bets 826
color_singleton: calls 826
*** SHOW DOWN ***
FragileMemory: shows [2s 5s] (a straight, Ace to Five)
color_singleton: shows [9h Ad] (a flush, Ace high)
color_singleton collected 2387 from pot
*** SUMMARY ***
Total pot 2526 | Rake 139 
Board [Td 3h 4h 7h Ah]
Seat 2: FragileMemory (big blind) showed [2s 5s] and lost with a straight, Ace to Five
Seat 3: Duke Croix folded before Flop (didn't bet)
Seat 4: yairpinto folded before Flop (didn't bet)
Seat 6: color_singleton (button) showed [9h Ad] and won (2387) with a flush, Ace high
Seat 8: JeBoyDirk (small blind) folded before Flop



PokerStars Home Game Hand #218086393335: {Club #3225207}  Hold'em No Limit (50/100) - 2020/09/03 16:14:04 ET
Table 'fun gamez' 9-max (Play Money) Seat #8 is the button
Seat 2: FragileMemory (8746 in chips) 
Seat 3: Duke Croix (25724 in chips) 
Seat 4: yairpinto (12969 in chips) 
Seat 6: color_singleton (8885 in chips) 
Seat 8: JeBoyDirk (31442 in chips) 
FragileMemory: posts small blind 50
Duke Croix: posts big blind 100
*** HOLE CARDS ***
Dealt to Duke Croix [4s 3s]
yairpinto: calls 100
color_singleton: folds 
JeBoyDirk: folds 
FragileMemory: calls 50
Duke Croix: checks 
*** FLOP *** [Tc Ks 7c]
FragileMemory: bets 100
Duke Croix: folds 
yairpinto: raises 483 to 583
FragileMemory: raises 483 to 1066
yairpinto: raises 11803 to 12869 and is all-in
FragileMemory: calls 7580 and is all-in
Uncalled bet (4223) returned to yairpinto
*** TURN *** [Tc Ks 7c] [7d]
*** RIVER *** [Tc Ks 7c 7d] [9c]
*** SHOW DOWN ***
FragileMemory: shows [Ac Jc] (a flush, Ace high)
yairpinto: shows [Kh Th] (two pair, Kings and Tens)
FragileMemory collected 16624 from pot
*** SUMMARY ***
Total pot 17592 | Rake 968 
Board [Tc Ks 7c 7d 9c]
Seat 2: FragileMemory (small blind) showed [Ac Jc] and won (16624) with a flush, Ace high
Seat 3: Duke Croix (big blind) folded on the Flop
Seat 4: yairpinto showed [Kh Th] and lost with two pair, Kings and Tens
Seat 6: color_singleton folded before Flop (didn't bet)
Seat 8: JeBoyDirk (button) folded before Flop (didn't bet)



PokerStars Home Game Hand #218086420317: {Club #3225207}  Hold'em No Limit (50/100) - 2020/09/03 16:14:48 ET
Table 'fun gamez' 9-max (Play Money) Seat #2 is the button
Seat 1: dddocky (7190 in chips) 
Seat 2: FragileMemory (16624 in chips) 
Seat 3: Duke Croix (25624 in chips) 
Seat 4: yairpinto (4223 in chips) 
Seat 6: color_singleton (8885 in chips) 
Seat 8: JeBoyDirk (31442 in chips) 
Duke Croix: posts small blind 50
yairpinto: posts big blind 100
dddocky: posts small & big blinds 150
*** HOLE CARDS ***
Dealt to Duke Croix [8s 2h]
color_singleton: folds 
JeBoyDirk: folds 
dddocky: checks 
FragileMemory: calls 100
Duke Croix: folds 
yairpinto: checks 
*** FLOP *** [9h Qd Qh]
yairpinto: checks 
dddocky: checks 
FragileMemory: bets 189
yairpinto: folds 
dddocky: folds 
Uncalled bet (189) returned to FragileMemory
FragileMemory collected 378 from pot
FragileMemory: doesn't show hand 
*** SUMMARY ***
Total pot 400 | Rake 22 
Board [9h Qd Qh]
Seat 1: dddocky folded on the Flop (didn't bet)
Seat 2: FragileMemory (button) collected (378)
Seat 3: Duke Croix (small blind) folded before Flop
Seat 4: yairpinto (big blind) folded on the Flop
Seat 6: color_singleton folded before Flop (didn't bet)
Seat 8: JeBoyDirk folded before Flop (didn't bet)



PokerStars Home Game Hand #218086446749: {Club #3225207}  Hold'em No Limit (50/100) - 2020/09/03 16:15:30 ET
Table 'fun gamez' 9-max (Play Money) Seat #3 is the button
Seat 1: dddocky (7040 in chips) 
Seat 2: FragileMemory (16902 in chips) 
Seat 3: Duke Croix (25574 in chips) 
Seat 4: yairpinto (4123 in chips) 
Seat 6: color_singleton (8885 in chips) 
Seat 8: JeBoyDirk (31442 in chips) 
yairpinto: posts small blind 50
color_singleton: posts big blind 100
*** HOLE CARDS ***
Dealt to Duke Croix [9s Kh]
JeBoyDirk: folds 
dddocky: calls 100
FragileMemory: calls 100
Duke Croix: calls 100
yairpinto: calls 50
color_singleton: checks 
*** FLOP *** [7d 7s Ac]
MnnM150 joins the table at seat #9 
yairpinto: checks 
color_singleton: checks 
dddocky: bets 236
FragileMemory: folds 
Duke Croix: folds 
yairpinto: folds 
color_singleton: calls 236
*** TURN *** [7d 7s Ac] [Td]
color_singleton: checks 
dddocky: bets 459
color_singleton: folds 
Uncalled bet (459) returned to dddocky
dddocky collected 919 from pot
dddocky: doesn't show hand 
*** SUMMARY ***
Total pot 972 | Rake 53 
Board [7d 7s Ac Td]
Seat 1: dddocky collected (919)
Seat 2: FragileMemory folded on the Flop
Seat 3: Duke Croix (button) folded on the Flop
Seat 4: yairpinto (small blind) folded on the Flop
Seat 6: color_singleton (big blind) folded on the Turn
Seat 8: JeBoyDirk folded before Flop (didn't bet)



PokerStars Home Game Hand #218086488055: {Club #3225207}  Hold'em No Limit (50/100) - 2020/09/03 16:16:35 ET
Table 'fun gamez' 9-max (Play Money) Seat #4 is the button
Seat 1: dddocky (7623 in chips) 
Seat 2: FragileMemory (16802 in chips) 
Seat 3: Duke Croix (25474 in chips) 
Seat 4: yairpinto (4023 in chips) 
Seat 6: color_singleton (8549 in chips) 
Seat 8: JeBoyDirk (31442 in chips) 
Seat 9: MnnM150 (10000 in chips) 
color_singleton: posts small blind 50
JeBoyDirk: posts big blind 100
MnnM150: posts big blind 100
*** HOLE CARDS ***
Dealt to Duke Croix [8c 4c]
MnnM150: checks 
dddocky: folds 
FragileMemory: calls 100
Duke Croix: folds 
yairpinto: calls 100
color_singleton: folds 
JeBoyDirk: checks 
*** FLOP *** [Th 8h 5s]
JeBoyDirk: checks 
MnnM150: checks 
FragileMemory: checks 
yairpinto: bets 212
JeBoyDirk: folds 
MnnM150: calls 212
FragileMemory: calls 212
*** TURN *** [Th 8h 5s] [2h]
MnnM150: checks 
FragileMemory: checks 
yairpinto: bets 513
MnnM150: folds 
FragileMemory: folds 
Uncalled bet (513) returned to yairpinto
yairpinto collected 1026 from pot
yairpinto: doesn't show hand 
*** SUMMARY ***
Total pot 1086 | Rake 60 
Board [Th 8h 5s 2h]
Seat 1: dddocky folded before Flop (didn't bet)
Seat 2: FragileMemory folded on the Turn
Seat 3: Duke Croix folded before Flop (didn't bet)
Seat 4: yairpinto (button) collected (1026)
Seat 6: color_singleton (small blind) folded before Flop
Seat 8: JeBoyDirk (big blind) folded on the Flop
Seat 9: MnnM150 folded on the Turn



PokerStars Home Game Hand #218086522577: {Club #3225207}  Hold'em No Limit (50/100) - 2020/09/03 16:17:30 ET
Table 'fun gamez' 9-max (Play Money) Seat #6 is the button
Seat 1: dddocky (7623 in chips) 
Seat 2: FragileMemory (16490 in chips) 
Seat 3: Duke Croix (25474 in chips) 
Seat 4: yairpinto (4737 in chips) 
Seat 6: color_singleton (8499 in chips) 
Seat 8: JeBoyDirk (31342 in chips) 
Seat 9: MnnM150 (9688 in chips) 
JeBoyDirk: posts small blind 50
MnnM150: posts big blind 100
*** HOLE CARDS ***
Dealt to Duke Croix [6d 4h]
dddocky: folds 
FragileMemory: calls 100
Duke Croix: folds 
yairpinto: folds 
color_singleton: calls 100
JeBoyDirk: calls 50
MnnM150: checks 
*** FLOP *** [6h Js Tc]
JeBoyDirk: checks 
MnnM150: checks 
FragileMemory: bets 189
color_singleton: calls 189
JeBoyDirk: folds 
MnnM150: folds 
*** TURN *** [6h Js Tc] [Qc]
FragileMemory: bets 100
color_singleton: raises 400 to 500
FragileMemory: calls 400
*** RIVER *** [6h Js Tc Qc] [Jh]
FragileMemory: checks 
color_singleton: checks 
*** SHOW DOWN ***
FragileMemory: shows [Ah 6c] (two pair, Jacks and Sixes)
color_singleton: shows [Qh 8d] (two pair, Queens and Jacks)
color_singleton collected 1680 from pot
*** SUMMARY ***
Total pot 1778 | Rake 98 
Board [6h Js Tc Qc Jh]
Seat 1: dddocky folded before Flop (didn't bet)
Seat 2: FragileMemory showed [Ah 6c] and lost with two pair, Jacks and Sixes
Seat 3: Duke Croix folded before Flop (didn't bet)
Seat 4: yairpinto folded before Flop (didn't bet)
Seat 6: color_singleton (button) showed [Qh 8d] and won (1680) with two pair, Queens and Jacks
Seat 8: JeBoyDirk (small blind) folded on the Flop
Seat 9: MnnM150 (big blind) folded on the Flop



PokerStars Home Game Hand #218086557311: {Club #3225207}  Hold'em No Limit (50/100) - 2020/09/03 16:18:26 ET
Table 'fun gamez' 9-max (Play Money) Seat #8 is the button
Seat 1: dddocky (7623 in chips) 
Seat 2: FragileMemory (15701 in chips) 
Seat 3: Duke Croix (25474 in chips) 
Seat 4: yairpinto (4737 in chips) 
Seat 6: color_singleton (9390 in chips) 
Seat 8: JeBoyDirk (31242 in chips) 
Seat 9: MnnM150 (9588 in chips) 
MnnM150: posts small blind 50
dddocky: posts big blind 100
*** HOLE CARDS ***
Dealt to Duke Croix [2s 5s]
FragileMemory: calls 100
Duke Croix: folds 
yairpinto: folds 
color_singleton: raises 100 to 200
JeBoyDirk: folds 
MnnM150: calls 150
dddocky: folds 
FragileMemory: calls 100
*** FLOP *** [Th 9d 3d]
MnnM150: checks 
FragileMemory: checks 
color_singleton: bets 330
MnnM150: folds 
FragileMemory: calls 330
*** TURN *** [Th 9d 3d] [4d]
FragileMemory: checks 
color_singleton: bets 700
FragileMemory: folds 
Uncalled bet (700) returned to color_singleton
color_singleton collected 1285 from pot
color_singleton: doesn't show hand 
*** SUMMARY ***
Total pot 1360 | Rake 75 
Board [Th 9d 3d 4d]
Seat 1: dddocky (big blind) folded before Flop
Seat 2: FragileMemory folded on the Turn
Seat 3: Duke Croix folded before Flop (didn't bet)
Seat 4: yairpinto folded before Flop (didn't bet)
Seat 6: color_singleton collected (1285)
Seat 8: JeBoyDirk (button) folded before Flop (didn't bet)
Seat 9: MnnM150 (small blind) folded on the Flop



PokerStars Home Game Hand #218086589039: {Club #3225207}  Hold'em No Limit (50/100) - 2020/09/03 16:19:16 ET
Table 'fun gamez' 9-max (Play Money) Seat #9 is the button
Seat 1: dddocky (7523 in chips) 
Seat 2: FragileMemory (15171 in chips) 
Seat 3: Duke Croix (25474 in chips) 
Seat 4: yairpinto (4737 in chips) 
Seat 6: color_singleton (10145 in chips) 
Seat 8: JeBoyDirk (31242 in chips) 
Seat 9: MnnM150 (9388 in chips) 
dddocky: posts small blind 50
FragileMemory: posts big blind 100
*** HOLE CARDS ***
Dealt to Duke Croix [3s Tc]
Duke Croix: folds 
yairpinto: folds 
color_singleton: raises 100 to 200
JeBoyDirk: folds 
MnnM150: calls 200
dddocky: folds 
FragileMemory: folds 
*** FLOP *** [6c 5h Qs]
color_singleton: checks 
MnnM150: checks 
*** TURN *** [6c 5h Qs] [8c]
color_singleton: bets 260
MnnM150: folds 
Uncalled bet (260) returned to color_singleton
color_singleton collected 520 from pot
color_singleton: doesn't show hand 
*** SUMMARY ***
Total pot 550 | Rake 30 
Board [6c 5h Qs 8c]
Seat 1: dddocky (small blind) folded before Flop
Seat 2: FragileMemory (big blind) folded before Flop
Seat 3: Duke Croix folded before Flop (didn't bet)
Seat 4: yairpinto folded before Flop (didn't bet)
Seat 6: color_singleton collected (520)
Seat 8: JeBoyDirk folded before Flop (didn't bet)
Seat 9: MnnM150 (button) folded on the Turn



PokerStars Home Game Hand #218086611007: {Club #3225207}  Hold'em No Limit (50/100) - 2020/09/03 16:19:51 ET
Table 'fun gamez' 9-max (Play Money) Seat #1 is the button
Seat 1: dddocky (7473 in chips) 
Seat 2: FragileMemory (15071 in chips) 
Seat 3: Duke Croix (25474 in chips) 
Seat 4: yairpinto (4737 in chips) 
Seat 6: color_singleton (10465 in chips) 
Seat 8: JeBoyDirk (31242 in chips) 
Seat 9: MnnM150 (9188 in chips) 
FragileMemory: posts small blind 50
Duke Croix: posts big blind 100
*** HOLE CARDS ***
Dealt to Duke Croix [6s Kh]
yairpinto: folds 
color_singleton: calls 100
JeBoyDirk: raises 300 to 400
MnnM150: folds 
dddocky: folds 
FragileMemory: folds 
Duke Croix: folds 
color_singleton: folds 
Uncalled bet (300) returned to JeBoyDirk
JeBoyDirk collected 350 from pot
*** SUMMARY ***
Total pot 350 | Rake 0 
Seat 1: dddocky (button) folded before Flop (didn't bet)
Seat 2: FragileMemory (small blind) folded before Flop
Seat 3: Duke Croix (big blind) folded before Flop
Seat 4: yairpinto folded before Flop (didn't bet)
Seat 6: color_singleton folded before Flop
Seat 8: JeBoyDirk collected (350)
Seat 9: MnnM150 folded before Flop (didn't bet)



PokerStars Home Game Hand #218086627686: {Club #3225207}  Hold'em No Limit (50/100) - 2020/09/03 16:20:17 ET
Table 'fun gamez' 9-max (Play Money) Seat #2 is the button
Seat 1: dddocky (7473 in chips) 
Seat 2: FragileMemory (15021 in chips) 
Seat 3: Duke Croix (25374 in chips) 
Seat 4: yairpinto (4737 in chips) 
Seat 6: color_singleton (10365 in chips) 
Seat 8: JeBoyDirk (31492 in chips) 
Seat 9: MnnM150 (9188 in chips) 
Duke Croix: posts small blind 50
yairpinto: posts big blind 100
*** HOLE CARDS ***
Dealt to Duke Croix [Ah 3c]
color_singleton: folds 
JeBoyDirk: folds 
MnnM150: folds 
dddocky: calls 100
FragileMemory: raises 100 to 200
Duke Croix: folds 
yairpinto: calls 100
dddocky: folds 
*** FLOP *** [8c 2c As]
yairpinto: checks 
FragileMemory: checks 
*** TURN *** [8c 2c As] [2d]
yairpinto: bets 260
FragileMemory: raises 260 to 520
yairpinto: raises 1560 to 2080
FragileMemory: calls 1560
*** RIVER *** [8c 2c As 2d] [Td]
yairpinto: bets 2457 and is all-in
FragileMemory: calls 2457
*** SHOW DOWN ***
yairpinto: shows [6h 2h] (three of a kind, Deuces)
FragileMemory: shows [9c 9d] (two pair, Nines and Deuces)
yairpinto collected 9095 from pot
*** SUMMARY ***
Total pot 9624 | Rake 529 
Board [8c 2c As 2d Td]
Seat 1: dddocky folded before Flop
Seat 2: FragileMemory (button) showed [9c 9d] and lost with two pair, Nines and Deuces
Seat 3: Duke Croix (small blind) folded before Flop
Seat 4: yairpinto (big blind) showed [6h 2h] and won (9095) with three of a kind, Deuces
Seat 6: color_singleton folded before Flop (didn't bet)
Seat 8: JeBoyDirk folded before Flop (didn't bet)
Seat 9: MnnM150 folded before Flop (didn't bet)



PokerStars Home Game Hand #218086662158: {Club #3225207}  Hold'em No Limit (50/100) - 2020/09/03 16:21:11 ET
Table 'fun gamez' 9-max (Play Money) Seat #3 is the button
Seat 1: dddocky (7373 in chips) 
Seat 2: FragileMemory (10284 in chips) 
Seat 3: Duke Croix (25324 in chips) 
Seat 4: yairpinto (9095 in chips) 
Seat 6: color_singleton (10365 in chips) 
Seat 8: JeBoyDirk (31492 in chips) 
Seat 9: MnnM150 (9188 in chips) 
yairpinto: posts small blind 50
color_singleton: posts big blind 100
*** HOLE CARDS ***
Dealt to Duke Croix [Ts 9h]
JeBoyDirk: folds 
MnnM150: folds 
dddocky: folds 
FragileMemory: calls 100
Duke Croix: calls 100
yairpinto: calls 50
color_singleton: checks 
*** FLOP *** [7h As 4s]
yairpinto: checks 
color_singleton: checks 
FragileMemory: checks 
Duke Croix: checks 
*** TURN *** [7h As 4s] [Kc]
yairpinto: checks 
color_singleton: checks 
FragileMemory: checks 
Duke Croix: checks 
*** RIVER *** [7h As 4s Kc] [5d]
yairpinto: bets 189
color_singleton: folds 
FragileMemory: folds 
Duke Croix: folds 
Uncalled bet (189) returned to yairpinto
yairpinto collected 378 from pot
yairpinto: doesn't show hand 
*** SUMMARY ***
Total pot 400 | Rake 22 
Board [7h As 4s Kc 5d]
Seat 1: dddocky folded before Flop (didn't bet)
Seat 2: FragileMemory folded on the River
Seat 3: Duke Croix (button) folded on the River
Seat 4: yairpinto (small blind) collected (378)
Seat 6: color_singleton (big blind) folded on the River
Seat 8: JeBoyDirk folded before Flop (didn't bet)
Seat 9: MnnM150 folded before Flop (didn't bet)



PokerStars Home Game Hand #218086694834: {Club #3225207}  Hold'em No Limit (50/100) - 2020/09/03 16:22:03 ET
Table 'fun gamez' 9-max (Play Money) Seat #4 is the button
Seat 1: dddocky (7373 in chips) 
Seat 2: FragileMemory (10184 in chips) 
Seat 3: Duke Croix (25224 in chips) 
Seat 4: yairpinto (9373 in chips) 
Seat 6: color_singleton (10265 in chips) 
Seat 8: JeBoyDirk (31492 in chips) 
Seat 9: MnnM150 (9188 in chips) 
color_singleton: posts small blind 50
JeBoyDirk: posts big blind 100
*** HOLE CARDS ***
Dealt to Duke Croix [Qs As]
MnnM150: folds 
dddocky: folds 
FragileMemory: calls 100
Duke Croix: raises 300 to 400
yairpinto: folds 
color_singleton: folds 
JeBoyDirk: folds 
FragileMemory: raises 300 to 700
Duke Croix: calls 300
*** FLOP *** [6h 5s 4s]
FragileMemory: bets 732
Duke Croix: calls 732
*** TURN *** [6h 5s 4s] [3s]
FragileMemory: checks 
Duke Croix: bets 1000
FragileMemory: calls 1000
*** RIVER *** [6h 5s 4s 3s] [8d]
FragileMemory: checks 
Duke Croix: bets 2000
FragileMemory: folds 
Uncalled bet (2000) returned to Duke Croix
Duke Croix collected 4738 from pot
*** SUMMARY ***
Total pot 5014 | Rake 276 
Board [6h 5s 4s 3s 8d]
Seat 1: dddocky folded before Flop (didn't bet)
Seat 2: FragileMemory folded on the River
Seat 3: Duke Croix collected (4738)
Seat 4: yairpinto (button) folded before Flop (didn't bet)
Seat 6: color_singleton (small blind) folded before Flop
Seat 8: JeBoyDirk (big blind) folded before Flop
Seat 9: MnnM150 folded before Flop (didn't bet)



PokerStars Home Game Hand #218086724329: {Club #3225207}  Hold'em No Limit (50/100) - 2020/09/03 16:22:50 ET
Table 'fun gamez' 9-max (Play Money) Seat #6 is the button
Seat 1: dddocky (7373 in chips) 
Seat 2: FragileMemory (7752 in chips) 
Seat 3: Duke Croix (27530 in chips) 
Seat 4: yairpinto (9373 in chips) 
Seat 6: color_singleton (10215 in chips) 
Seat 8: JeBoyDirk (31392 in chips) 
Seat 9: MnnM150 (9188 in chips) 
JeBoyDirk: posts small blind 50
MnnM150: posts big blind 100
*** HOLE CARDS ***
Dealt to Duke Croix [7c Ts]
dddocky: calls 100
FragileMemory: folds 
Duke Croix: folds 
yairpinto: folds 
color_singleton: folds 
JeBoyDirk: folds 
MnnM150: checks 
*** FLOP *** [2s 9d Ac]
MnnM150: checks 
dddocky: checks 
*** TURN *** [2s 9d Ac] [Ks]
MnnM150: checks 
dddocky: checks 
*** RIVER *** [2s 9d Ac Ks] [Th]
MnnM150: bets 118
dddocky: folds 
Uncalled bet (118) returned to MnnM150
MnnM150 collected 236 from pot
*** SUMMARY ***
Total pot 250 | Rake 14 
Board [2s 9d Ac Ks Th]
Seat 1: dddocky folded on the River
Seat 2: FragileMemory folded before Flop (didn't bet)
Seat 3: Duke Croix folded before Flop (didn't bet)
Seat 4: yairpinto folded before Flop (didn't bet)
Seat 6: color_singleton (button) folded before Flop (didn't bet)
Seat 8: JeBoyDirk (small blind) folded before Flop
Seat 9: MnnM150 (big blind) collected (236)



PokerStars Home Game Hand #218086753666: {Club #3225207}  Hold'em No Limit (50/100) - 2020/09/03 16:23:36 ET
Table 'fun gamez' 9-max (Play Money) Seat #8 is the button
Seat 1: dddocky (7273 in chips) 
Seat 2: FragileMemory (7752 in chips) 
Seat 3: Duke Croix (27530 in chips) 
Seat 4: yairpinto (9373 in chips) 
Seat 6: color_singleton (10215 in chips) 
Seat 8: JeBoyDirk (31342 in chips) 
Seat 9: MnnM150 (9324 in chips) 
MnnM150: posts small blind 50
dddocky: posts big blind 100
*** HOLE CARDS ***
Dealt to Duke Croix [6c 9d]
FragileMemory: calls 100
Duke Croix: folds 
yairpinto: folds 
color_singleton: folds 
JeBoyDirk: calls 100
MnnM150: calls 50
dddocky: checks 
*** FLOP *** [Qc 5d 8s]
MnnM150: bets 189
dddocky: folds 
FragileMemory: raises 189 to 378
JeBoyDirk: folds 
MnnM150: calls 189
*** TURN *** [Qc 5d 8s] [Ac]
MnnM150: checks 
FragileMemory: bets 546
MnnM150: calls 546
*** RIVER *** [Qc 5d 8s Ac] [Kh]
MnnM150: checks 
FragileMemory: bets 1062
MnnM150: calls 1062
*** SHOW DOWN ***
FragileMemory: shows [Td Qd] (a pair of Queens)
MnnM150: shows [5s 5h] (three of a kind, Fives)
MnnM150 collected 4132 from pot
*** SUMMARY ***
Total pot 4372 | Rake 240 
Board [Qc 5d 8s Ac Kh]
Seat 1: dddocky (big blind) folded on the Flop
Seat 2: FragileMemory showed [Td Qd] and lost with a pair of Queens
Seat 3: Duke Croix folded before Flop (didn't bet)
Seat 4: yairpinto folded before Flop (didn't bet)
Seat 6: color_singleton folded before Flop (didn't bet)
Seat 8: JeBoyDirk (button) folded on the Flop
Seat 9: MnnM150 (small blind) showed [5s 5h] and won (4132) with three of a kind, Fives



PokerStars Home Game Hand #218086789635: {Club #3225207}  Hold'em No Limit (50/100) - 2020/09/03 16:24:20 ET
Table 'fun gamez' 9-max (Play Money) Seat #9 is the button
Seat 1: dddocky (7173 in chips) 
Seat 2: FragileMemory (5666 in chips) 
Seat 3: Duke Croix (27530 in chips) 
Seat 4: yairpinto (9373 in chips) 
Seat 6: color_singleton (10215 in chips) 
Seat 8: JeBoyDirk (31242 in chips) 
Seat 9: MnnM150 (11370 in chips) 
dddocky: posts small blind 50
FragileMemory: posts big blind 100
*** HOLE CARDS ***
Dealt to Duke Croix [Jd 4c]
Duke Croix: folds 
yairpinto: calls 100
color_singleton has timed out
color_singleton: folds 
JeBoyDirk: folds 
MnnM150: folds 
dddocky: calls 50
FragileMemory: checks 
*** FLOP *** [3s 9s Qs]
dddocky: bets 100
FragileMemory: raises 100 to 200
yairpinto: folds 
dddocky: calls 100
*** TURN *** [3s 9s Qs] [9c]
dddocky: bets 661
FragileMemory: calls 661
*** RIVER *** [3s 9s Qs 9c] [Jc]
dddocky: checks 
FragileMemory: checks 
*** SHOW DOWN ***
dddocky: shows [9h 8d] (three of a kind, Nines)
FragileMemory: mucks hand 
dddocky collected 1911 from pot
*** SUMMARY ***
Total pot 2022 | Rake 111 
Board [3s 9s Qs 9c Jc]
Seat 1: dddocky (small blind) showed [9h 8d] and won (1911) with three of a kind, Nines
Seat 2: FragileMemory (big blind) mucked [Qh 5h]
Seat 3: Duke Croix folded before Flop (didn't bet)
Seat 4: yairpinto folded on the Flop
Seat 6: color_singleton folded before Flop (didn't bet)
Seat 8: JeBoyDirk folded before Flop (didn't bet)
Seat 9: MnnM150 (button) folded before Flop (didn't bet)



PokerStars Home Game Hand #218086822485: {Club #3225207}  Hold'em No Limit (50/100) - 2020/09/03 16:25:11 ET
Table 'fun gamez' 9-max (Play Money) Seat #1 is the button
Seat 1: dddocky (8123 in chips) 
Seat 2: FragileMemory (4705 in chips) 
Seat 3: Duke Croix (27530 in chips) 
Seat 4: yairpinto (9273 in chips) 
Seat 8: JeBoyDirk (31242 in chips) 
Seat 9: MnnM150 (11370 in chips) 
FragileMemory: posts small blind 50
Duke Croix: posts big blind 100
*** HOLE CARDS ***
Dealt to Duke Croix [9c Kh]
yairpinto: raises 200 to 300
JeBoyDirk: folds 
MnnM150: calls 300
dddocky: folds 
FragileMemory: folds 
Duke Croix: calls 200
*** FLOP *** [Js 5c 2s]
Duke Croix: checks 
yairpinto: bets 449
MnnM150: folds 
Duke Croix: folds 
Uncalled bet (449) returned to yairpinto
yairpinto collected 898 from pot
yairpinto: doesn't show hand 
*** SUMMARY ***
Total pot 950 | Rake 52 
Board [Js 5c 2s]
Seat 1: dddocky (button) folded before Flop (didn't bet)
Seat 2: FragileMemory (small blind) folded before Flop
Seat 3: Duke Croix (big blind) folded on the Flop
Seat 4: yairpinto collected (898)
Seat 8: JeBoyDirk folded before Flop (didn't bet)
Seat 9: MnnM150 folded on the Flop



PokerStars Home Game Hand #218086839928: {Club #3225207}  Hold'em No Limit (50/100) - 2020/09/03 16:25:39 ET
Table 'fun gamez' 9-max (Play Money) Seat #2 is the button
Seat 1: dddocky (8123 in chips) 
Seat 2: FragileMemory (4655 in chips) 
Seat 3: Duke Croix (27230 in chips) 
Seat 4: yairpinto (9871 in chips) 
Seat 6: color_singleton (10215 in chips) 
Seat 8: JeBoyDirk (31242 in chips) 
Seat 9: MnnM150 (11070 in chips) 
Duke Croix: posts small blind 50
yairpinto: posts big blind 100
*** HOLE CARDS ***
Dealt to Duke Croix [2h 2s]
color_singleton: folds 
JeBoyDirk: folds 
MnnM150: folds 
dddocky: calls 100
FragileMemory: calls 100
Duke Croix: calls 50
yairpinto: checks 
*** FLOP *** [Jd 8d Tc]
Duke Croix: checks 
yairpinto: checks 
dddocky: bets 189
FragileMemory: raises 189 to 378
Duke Croix: folds 
yairpinto: folds 
dddocky: calls 189
*** TURN *** [Jd 8d Tc] [7d]
dddocky: checks 
FragileMemory: bets 546
dddocky: calls 546
*** RIVER *** [Jd 8d Tc 7d] [5d]
dddocky: checks 
FragileMemory: checks 
*** SHOW DOWN ***
dddocky: shows [8s 8h] (three of a kind, Eights)
FragileMemory: mucks hand 
dddocky collected 2124 from pot
*** SUMMARY ***
Total pot 2248 | Rake 124 
Board [Jd 8d Tc 7d 5d]
Seat 1: dddocky showed [8s 8h] and won (2124) with three of a kind, Eights
Seat 2: FragileMemory (button) mucked [As Js]
Seat 3: Duke Croix (small blind) folded on the Flop
Seat 4: yairpinto (big blind) folded on the Flop
Seat 6: color_singleton folded before Flop (didn't bet)
Seat 8: JeBoyDirk folded before Flop (didn't bet)
Seat 9: MnnM150 folded before Flop (didn't bet)



PokerStars Home Game Hand #218086890042: {Club #3225207}  Hold'em No Limit (50/100) - 2020/09/03 16:26:58 ET
Table 'fun gamez' 9-max (Play Money) Seat #3 is the button
Seat 1: dddocky (9223 in chips) 
Seat 2: FragileMemory (3631 in chips) 
Seat 3: Duke Croix (27130 in chips) 
Seat 4: yairpinto (9771 in chips) 
Seat 6: color_singleton (10215 in chips) 
Seat 8: JeBoyDirk (31242 in chips) 
Seat 9: MnnM150 (11070 in chips) 
yairpinto: posts small blind 50
color_singleton: posts big blind 100
*** HOLE CARDS ***
Dealt to Duke Croix [7h 2h]
JeBoyDirk: calls 100
MnnM150: calls 100
dddocky: calls 100
FragileMemory: calls 100
Duke Croix: calls 100
yairpinto: calls 50
color_singleton: checks 
*** FLOP *** [4h Qs Ad]
yairpinto: bets 330
color_singleton: folds 
JeBoyDirk: calls 330
MnnM150: calls 330
dddocky: folds 
FragileMemory: folds 
Duke Croix: folds 
*** TURN *** [4h Qs Ad] [9c]
yairpinto: checks 
JeBoyDirk: checks 
MnnM150: checks 
*** RIVER *** [4h Qs Ad 9c] [7c]
yairpinto: checks 
JeBoyDirk: checks 
MnnM150: checks 
*** SHOW DOWN ***
yairpinto: shows [Qh 3s] (a pair of Queens)
JeBoyDirk: shows [As 8s] (a pair of Aces)
MnnM150: mucks hand 
JeBoyDirk collected 1597 from pot
*** SUMMARY ***
Total pot 1690 | Rake 93 
Board [4h Qs Ad 9c 7c]
Seat 1: dddocky folded on the Flop
Seat 2: FragileMemory folded on the Flop
Seat 3: Duke Croix (button) folded on the Flop
Seat 4: yairpinto (small blind) showed [Qh 3s] and lost with a pair of Queens
Seat 6: color_singleton (big blind) folded on the Flop
Seat 8: JeBoyDirk showed [As 8s] and won (1597) with a pair of Aces
Seat 9: MnnM150 mucked [Th Jc]



PokerStars Home Game Hand #218086926249: {Club #3225207}  Hold'em No Limit (50/100) - 2020/09/03 16:27:54 ET
Table 'fun gamez' 9-max (Play Money) Seat #4 is the button
Seat 1: dddocky (9123 in chips) 
Seat 2: FragileMemory (3531 in chips) 
Seat 3: Duke Croix (27030 in chips) 
Seat 4: yairpinto (9341 in chips) 
Seat 6: color_singleton (10115 in chips) 
Seat 8: JeBoyDirk (32409 in chips) 
Seat 9: MnnM150 (10640 in chips) 
color_singleton: posts small blind 50
JeBoyDirk: posts big blind 100
*** HOLE CARDS ***
Dealt to Duke Croix [Qh Jc]
MnnM150: folds 
dddocky: calls 100
FragileMemory: folds 
Duke Croix: raises 300 to 400
yairpinto: folds 
color_singleton: folds 
JeBoyDirk: folds 
dddocky: calls 300
*** FLOP *** [2s 3s Jh]
dddocky: checks 
Duke Croix: bets 449
dddocky: calls 449
*** TURN *** [2s 3s Jh] [Kc]
dddocky: checks 
Duke Croix: checks 
*** RIVER *** [2s 3s Jh Kc] [Ah]
dddocky: bets 873
Duke Croix: folds 
Uncalled bet (873) returned to dddocky
dddocky collected 1746 from pot
dddocky: doesn't show hand 
*** SUMMARY ***
Total pot 1848 | Rake 102 
Board [2s 3s Jh Kc Ah]
Seat 1: dddocky collected (1746)
Seat 2: FragileMemory folded before Flop (didn't bet)
Seat 3: Duke Croix folded on the River
Seat 4: yairpinto (button) folded before Flop (didn't bet)
Seat 6: color_singleton (small blind) folded before Flop
Seat 8: JeBoyDirk (big blind) folded before Flop
Seat 9: MnnM150 folded before Flop (didn't bet)



PokerStars Home Game Hand #218086950287: {Club #3225207}  Hold'em No Limit (50/100) - 2020/09/03 16:28:33 ET
Table 'fun gamez' 9-max (Play Money) Seat #6 is the button
Seat 1: dddocky (10020 in chips) 
Seat 2: FragileMemory (3531 in chips) 
Seat 3: Duke Croix (26181 in chips) 
Seat 4: yairpinto (9341 in chips) 
Seat 6: color_singleton (10065 in chips) 
Seat 8: JeBoyDirk (32309 in chips) 
Seat 9: MnnM150 (10640 in chips) 
JeBoyDirk: posts small blind 50
MnnM150: posts big blind 100
*** HOLE CARDS ***
Dealt to Duke Croix [Kh Th]
dddocky: calls 100
FragileMemory: folds 
Duke Croix: raises 300 to 400
yairpinto: folds 
color_singleton: folds 
JeBoyDirk: calls 350
MnnM150: folds 
dddocky: calls 300
*** FLOP *** [6d Kd 9h]
JeBoyDirk: checks 
dddocky: checks 
Duke Croix: bets 800
JeBoyDirk: folds 
dddocky: folds 
Uncalled bet (800) returned to Duke Croix
Duke Croix collected 1228 from pot
*** SUMMARY ***
Total pot 1300 | Rake 72 
Board [6d Kd 9h]
Seat 1: dddocky folded on the Flop
Seat 2: FragileMemory folded before Flop (didn't bet)
Seat 3: Duke Croix collected (1228)
Seat 4: yairpinto folded before Flop (didn't bet)
Seat 6: color_singleton (button) folded before Flop (didn't bet)
Seat 8: JeBoyDirk (small blind) folded on the Flop
Seat 9: MnnM150 (big blind) folded before Flop



PokerStars Home Game Hand #218086970332: {Club #3225207}  Hold'em No Limit (50/100) - 2020/09/03 16:29:04 ET
Table 'fun gamez' 9-max (Play Money) Seat #8 is the button
Seat 1: dddocky (9620 in chips) 
Seat 2: FragileMemory (3531 in chips) 
Seat 3: Duke Croix (27009 in chips) 
Seat 4: yairpinto (9341 in chips) 
Seat 6: color_singleton (10065 in chips) 
Seat 8: JeBoyDirk (31909 in chips) 
Seat 9: MnnM150 (10540 in chips) 
MnnM150: posts small blind 50
dddocky: posts big blind 100
*** HOLE CARDS ***
Dealt to Duke Croix [4s As]
FragileMemory: folds 
Duke Croix: raises 300 to 400
yairpinto: folds 
color_singleton: calls 400
JeBoyDirk: folds 
MnnM150: folds 
dddocky: folds 
*** FLOP *** [Qh 2s Th]
Duke Croix: checks 
color_singleton: bets 449
Duke Croix: folds 
Uncalled bet (449) returned to color_singleton
color_singleton collected 898 from pot
color_singleton: doesn't show hand 
*** SUMMARY ***
Total pot 950 | Rake 52 
Board [Qh 2s Th]
Seat 1: dddocky (big blind) folded before Flop
Seat 2: FragileMemory folded before Flop (didn't bet)
Seat 3: Duke Croix folded on the Flop
Seat 4: yairpinto folded before Flop (didn't bet)
Seat 6: color_singleton collected (898)
Seat 8: JeBoyDirk (button) folded before Flop (didn't bet)
Seat 9: MnnM150 (small blind) folded before Flop



PokerStars Home Game Hand #218086982575: {Club #3225207}  Hold'em No Limit (50/100) - 2020/09/03 16:29:24 ET
Table 'fun gamez' 9-max (Play Money) Seat #9 is the button
Seat 1: dddocky (9520 in chips) 
Seat 2: FragileMemory (3531 in chips) 
Seat 3: Duke Croix (26609 in chips) 
Seat 4: yairpinto (9341 in chips) 
Seat 6: color_singleton (10563 in chips) 
Seat 8: JeBoyDirk (31909 in chips) 
Seat 9: MnnM150 (10490 in chips) 
dddocky: posts small blind 50
FragileMemory: posts big blind 100
*** HOLE CARDS ***
Dealt to Duke Croix [Tc 3s]
Duke Croix: folds 
yairpinto: folds 
color_singleton: folds 
JeBoyDirk: calls 100
MnnM150: calls 100
dddocky: calls 50
FragileMemory: checks 
*** FLOP *** [8s Ks 2h]
dddocky: checks 
FragileMemory: checks 
JeBoyDirk: checks 
MnnM150: checks 
*** TURN *** [8s Ks 2h] [2c]
dddocky: checks 
FragileMemory: bets 189
JeBoyDirk: folds 
MnnM150: calls 189
dddocky: folds 
*** RIVER *** [8s Ks 2h 2c] [9c]
FragileMemory: bets 735
MnnM150: folds 
Uncalled bet (735) returned to FragileMemory
FragileMemory collected 735 from pot
FragileMemory: doesn't show hand 
*** SUMMARY ***
Total pot 778 | Rake 43 
Board [8s Ks 2h 2c 9c]
Seat 1: dddocky (small blind) folded on the Turn
Seat 2: FragileMemory (big blind) collected (735)
Seat 3: Duke Croix folded before Flop (didn't bet)
Seat 4: yairpinto folded before Flop (didn't bet)
Seat 6: color_singleton folded before Flop (didn't bet)
Seat 8: JeBoyDirk folded on the Turn
Seat 9: MnnM150 (button) folded on the River



PokerStars Home Game Hand #218087014581: {Club #3225207}  Hold'em No Limit (50/100) - 2020/09/03 16:30:08 ET
Table 'fun gamez' 9-max (Play Money) Seat #1 is the button
Seat 1: dddocky (9420 in chips) 
Seat 2: FragileMemory (3977 in chips) 
Seat 3: Duke Croix (26609 in chips) 
Seat 4: yairpinto (9341 in chips) 
Seat 6: color_singleton (10563 in chips) 
Seat 8: JeBoyDirk (31809 in chips) 
Seat 9: MnnM150 (10201 in chips) 
FragileMemory: posts small blind 50
Duke Croix: posts big blind 100
*** HOLE CARDS ***
Dealt to Duke Croix [Ks 8s]
yairpinto: raises 200 to 300
color_singleton: folds 
JeBoyDirk: folds 
MnnM150: folds 
dddocky: calls 300
FragileMemory: folds 
Duke Croix: calls 200
*** FLOP *** [Qc 2d Ac]
Duke Croix: checks 
yairpinto: bets 449
dddocky: calls 449
Duke Croix: folds 
*** TURN *** [Qc 2d Ac] [7s]
yairpinto: checks 
dddocky: bets 100
yairpinto: calls 100
*** RIVER *** [Qc 2d Ac 7s] [5d]
yairpinto: checks 
dddocky: bets 967
yairpinto: folds 
Uncalled bet (967) returned to dddocky
dddocky collected 1935 from pot
*** SUMMARY ***
Total pot 2048 | Rake 113 
Board [Qc 2d Ac 7s 5d]
Seat 1: dddocky (button) collected (1935)
Seat 2: FragileMemory (small blind) folded before Flop
Seat 3: Duke Croix (big blind) folded on the Flop
Seat 4: yairpinto folded on the River
Seat 6: color_singleton folded before Flop (didn't bet)
Seat 8: JeBoyDirk folded before Flop (didn't bet)
Seat 9: MnnM150 folded before Flop (didn't bet)



PokerStars Home Game Hand #218087051631: {Club #3225207}  Hold'em No Limit (50/100) - 2020/09/03 16:31:08 ET
Table 'fun gamez' 9-max (Play Money) Seat #2 is the button
Seat 1: dddocky (10506 in chips) 
Seat 2: FragileMemory (3927 in chips) 
Seat 3: Duke Croix (26309 in chips) 
Seat 4: yairpinto (8492 in chips) 
Seat 6: color_singleton (10563 in chips) 
Seat 8: JeBoyDirk (31809 in chips) 
Seat 9: MnnM150 (10201 in chips) 
Duke Croix: posts small blind 50
yairpinto: posts big blind 100
*** HOLE CARDS ***
Dealt to Duke Croix [Ad 5s]
color_singleton: raises 100 to 200
JeBoyDirk: folds 
MnnM150: folds 
dddocky: folds 
FragileMemory: folds 
Duke Croix: folds 
yairpinto: folds 
Uncalled bet (100) returned to color_singleton
color_singleton collected 250 from pot
color_singleton: doesn't show hand 
*** SUMMARY ***
Total pot 250 | Rake 0 
Seat 1: dddocky folded before Flop (didn't bet)
Seat 2: FragileMemory (button) folded before Flop (didn't bet)
Seat 3: Duke Croix (small blind) folded before Flop
Seat 4: yairpinto (big blind) folded before Flop
Seat 6: color_singleton collected (250)
Seat 8: JeBoyDirk folded before Flop (didn't bet)
Seat 9: MnnM150 folded before Flop (didn't bet)



PokerStars Home Game Hand #218087063444: {Club #3225207}  Hold'em No Limit (50/100) - 2020/09/03 16:31:27 ET
Table 'fun gamez' 9-max (Play Money) Seat #3 is the button
Seat 1: dddocky (10506 in chips) 
Seat 2: FragileMemory (3927 in chips) 
Seat 3: Duke Croix (26259 in chips) 
Seat 4: yairpinto (8392 in chips) 
Seat 6: color_singleton (10713 in chips) 
Seat 8: JeBoyDirk (31809 in chips) 
Seat 9: MnnM150 (10201 in chips) 
yairpinto: posts small blind 50
color_singleton: posts big blind 100
*** HOLE CARDS ***
Dealt to Duke Croix [7h Qd]
JeBoyDirk: folds 
MnnM150: calls 100
dddocky: folds 
FragileMemory: calls 100
Duke Croix: folds 
yairpinto: calls 50
color_singleton: checks 
*** FLOP *** [5h 6d 2d]
yairpinto: checks 
color_singleton: checks 
MnnM150: checks 
FragileMemory: bets 189
yairpinto: folds 
color_singleton: calls 189
MnnM150: calls 189
*** TURN *** [5h 6d 2d] [6s]
color_singleton: checks 
MnnM150: checks 
FragileMemory: bets 457
color_singleton: folds 
MnnM150: folds 
Uncalled bet (457) returned to FragileMemory
FragileMemory collected 914 from pot
FragileMemory: doesn't show hand 
*** SUMMARY ***
Total pot 967 | Rake 53 
Board [5h 6d 2d 6s]
Seat 1: dddocky folded before Flop (didn't bet)
Seat 2: FragileMemory collected (914)
Seat 3: Duke Croix (button) folded before Flop (didn't bet)
Seat 4: yairpinto (small blind) folded on the Flop
Seat 6: color_singleton (big blind) folded on the Turn
Seat 8: JeBoyDirk folded before Flop (didn't bet)
Seat 9: MnnM150 folded on the Turn



PokerStars Home Game Hand #218087110529: {Club #3225207}  Hold'em No Limit (50/100) - 2020/09/03 16:32:42 ET
Table 'fun gamez' 9-max (Play Money) Seat #4 is the button
Seat 1: dddocky (10506 in chips) 
Seat 2: FragileMemory (4552 in chips) 
Seat 3: Duke Croix (26259 in chips) 
Seat 4: yairpinto (8292 in chips) 
Seat 6: color_singleton (10424 in chips) 
Seat 8: JeBoyDirk (31809 in chips) 
Seat 9: MnnM150 (9912 in chips) 
color_singleton: posts small blind 50
JeBoyDirk: posts big blind 100
*** HOLE CARDS ***
Dealt to Duke Croix [5s As]
MnnM150: folds 
dddocky: calls 100
FragileMemory: folds 
Duke Croix: raises 300 to 400
yairpinto: folds 
color_singleton: calls 350
JeBoyDirk: folds 
dddocky: calls 300
*** FLOP *** [5c 2s 5d]
color_singleton: checks 
dddocky: checks 
Duke Croix: bets 700
color_singleton: folds 
dddocky: folds 
Uncalled bet (700) returned to Duke Croix
Duke Croix collected 1228 from pot
*** SUMMARY ***
Total pot 1300 | Rake 72 
Board [5c 2s 5d]
Seat 1: dddocky folded on the Flop
Seat 2: FragileMemory folded before Flop (didn't bet)
Seat 3: Duke Croix collected (1228)
Seat 4: yairpinto (button) folded before Flop (didn't bet)
Seat 6: color_singleton (small blind) folded on the Flop
Seat 8: JeBoyDirk (big blind) folded before Flop
Seat 9: MnnM150 folded before Flop (didn't bet)



PokerStars Home Game Hand #218087131051: {Club #3225207}  Hold'em No Limit (50/100) - 2020/09/03 16:33:15 ET
Table 'fun gamez' 9-max (Play Money) Seat #6 is the button
Seat 1: dddocky (10106 in chips) 
Seat 2: FragileMemory (4552 in chips) 
Seat 3: Duke Croix (27087 in chips) 
Seat 4: yairpinto (8292 in chips) 
Seat 6: color_singleton (10024 in chips) 
Seat 8: JeBoyDirk (31709 in chips) 
Seat 9: MnnM150 (9912 in chips) 
JeBoyDirk: posts small blind 50
MnnM150: posts big blind 100
*** HOLE CARDS ***
Dealt to Duke Croix [6d Jd]
dddocky: calls 100
FragileMemory: calls 100
Duke Croix: folds 
yairpinto: calls 100
color_singleton: raises 200 to 300
JeBoyDirk: calls 250
MnnM150: folds 
dddocky: calls 200
FragileMemory: calls 200
yairpinto: calls 200
*** FLOP *** [Qc Jh 3s]
JeBoyDirk: checks 
dddocky: checks 
FragileMemory: checks 
yairpinto: checks 
color_singleton: bets 756
JeBoyDirk: folds 
dddocky: folds 
FragileMemory: folds 
yairpinto: folds 
Uncalled bet (756) returned to color_singleton
color_singleton collected 1512 from pot
color_singleton: doesn't show hand 
*** SUMMARY ***
Total pot 1600 | Rake 88 
Board [Qc Jh 3s]
Seat 1: dddocky folded on the Flop
Seat 2: FragileMemory folded on the Flop
Seat 3: Duke Croix folded before Flop (didn't bet)
Seat 4: yairpinto folded on the Flop
Seat 6: color_singleton (button) collected (1512)
Seat 8: JeBoyDirk (small blind) folded on the Flop
Seat 9: MnnM150 (big blind) folded before Flop



PokerStars Home Game Hand #218087156786: {Club #3225207}  Hold'em No Limit (50/100) - 2020/09/03 16:33:56 ET
Table 'fun gamez' 9-max (Play Money) Seat #8 is the button
Seat 1: dddocky (9806 in chips) 
Seat 2: FragileMemory (4252 in chips) 
Seat 3: Duke Croix (27087 in chips) 
Seat 4: yairpinto (7992 in chips) 
Seat 6: color_singleton (11236 in chips) 
Seat 8: JeBoyDirk (31409 in chips) 
Seat 9: MnnM150 (9812 in chips) 
MnnM150: posts small blind 50
dddocky: posts big blind 100
*** HOLE CARDS ***
Dealt to Duke Croix [7h As]
FragileMemory: folds 
Duke Croix: raises 200 to 300
yairpinto: folds 
color_singleton: calls 300
JeBoyDirk: calls 300
MnnM150: folds 
dddocky: folds 
*** FLOP *** [Kc 4s 2c]
Duke Croix: checks 
color_singleton: checks 
JeBoyDirk: checks 
*** TURN *** [Kc 4s 2c] [Td]
Duke Croix: checks 
color_singleton: checks 
JeBoyDirk: checks 
*** RIVER *** [Kc 4s 2c Td] [9c]
Duke Croix: checks 
color_singleton: checks 
JeBoyDirk: bets 700
Duke Croix: folds 
color_singleton: folds 
Uncalled bet (700) returned to JeBoyDirk
JeBoyDirk collected 992 from pot
*** SUMMARY ***
Total pot 1050 | Rake 58 
Board [Kc 4s 2c Td 9c]
Seat 1: dddocky (big blind) folded before Flop
Seat 2: FragileMemory folded before Flop (didn't bet)
Seat 3: Duke Croix folded on the River
Seat 4: yairpinto folded before Flop (didn't bet)
Seat 6: color_singleton folded on the River
Seat 8: JeBoyDirk (button) collected (992)
Seat 9: MnnM150 (small blind) folded before Flop



PokerStars Home Game Hand #218087184284: {Club #3225207}  Hold'em No Limit (50/100) - 2020/09/03 16:34:40 ET
Table 'fun gamez' 9-max (Play Money) Seat #9 is the button
Seat 1: dddocky (9706 in chips) 
Seat 2: FragileMemory (4252 in chips) 
Seat 3: Duke Croix (26787 in chips) 
Seat 4: yairpinto (7992 in chips) 
Seat 6: color_singleton (10936 in chips) 
Seat 8: JeBoyDirk (32101 in chips) 
Seat 9: MnnM150 (9762 in chips) 
dddocky: posts small blind 50
FragileMemory: posts big blind 100
*** HOLE CARDS ***
Dealt to Duke Croix [Js 3h]
Duke Croix: folds 
yairpinto: calls 100
color_singleton: folds 
JeBoyDirk: raises 200 to 300
MnnM150: calls 300
dddocky: calls 250
FragileMemory: folds 
yairpinto: calls 200
*** FLOP *** [6c 2c Qh]
dddocky: checks 
yairpinto: checks 
JeBoyDirk: bets 800
MnnM150: folds 
dddocky: folds 
yairpinto: calls 800
*** TURN *** [6c 2c Qh] [3c]
yairpinto: checks 
JeBoyDirk: checks 
*** RIVER *** [6c 2c Qh 3c] [4s]
yairpinto: bets 1370
JeBoyDirk: folds 
Uncalled bet (1370) returned to yairpinto
yairpinto collected 2740 from pot
yairpinto: doesn't show hand 
*** SUMMARY ***
Total pot 2900 | Rake 160 
Board [6c 2c Qh 3c 4s]
Seat 1: dddocky (small blind) folded on the Flop
Seat 2: FragileMemory (big blind) folded before Flop
Seat 3: Duke Croix folded before Flop (didn't bet)
Seat 4: yairpinto collected (2740)
Seat 6: color_singleton folded before Flop (didn't bet)
Seat 8: JeBoyDirk folded on the River
Seat 9: MnnM150 (button) folded on the Flop



PokerStars Home Game Hand #218087228639: {Club #3225207}  Hold'em No Limit (50/100) - 2020/09/03 16:35:52 ET
Table 'fun gamez' 9-max (Play Money) Seat #1 is the button
Seat 1: dddocky (9406 in chips) 
Seat 2: FragileMemory (4152 in chips) 
Seat 3: Duke Croix (26787 in chips) 
Seat 4: yairpinto (9632 in chips) 
Seat 6: color_singleton (10936 in chips) 
Seat 8: JeBoyDirk (31001 in chips) 
Seat 9: MnnM150 (9462 in chips) 
FragileMemory: posts small blind 50
Duke Croix: posts big blind 100
*** HOLE CARDS ***
Dealt to Duke Croix [8d 6h]
yairpinto: raises 200 to 300
color_singleton: calls 300
JeBoyDirk: folds 
MnnM150: folds 
dddocky: calls 300
FragileMemory: calls 250
Duke Croix: calls 200
*** FLOP *** [5s Ac 8h]
FragileMemory: bets 100
Duke Croix: calls 100
yairpinto: calls 100
color_singleton: calls 100
dddocky: raises 100 to 200
FragileMemory: raises 100 to 300
Duke Croix: folds 
yairpinto: folds 
color_singleton: folds 
dddocky: raises 100 to 400
FragileMemory: calls 100
*** TURN *** [5s Ac 8h] [Kh]
FragileMemory: checks 
dddocky: bets 100
FragileMemory: calls 100
*** RIVER *** [5s Ac 8h Kh] [5c]
FragileMemory: checks 
dddocky: bets 1323
FragileMemory: folds 
Uncalled bet (1323) returned to dddocky
dddocky collected 2646 from pot
dddocky: doesn't show hand 
*** SUMMARY ***
Total pot 2800 | Rake 154 
Board [5s Ac 8h Kh 5c]
Seat 1: dddocky (button) collected (2646)
Seat 2: FragileMemory (small blind) folded on the River
Seat 3: Duke Croix (big blind) folded on the Flop
Seat 4: yairpinto folded on the Flop
Seat 6: color_singleton folded on the Flop
Seat 8: JeBoyDirk folded before Flop (didn't bet)
Seat 9: MnnM150 folded before Flop (didn't bet)



PokerStars Home Game Hand #218087267953: {Club #3225207}  Hold'em No Limit (50/100) - 2020/09/03 16:36:56 ET
Table 'fun gamez' 9-max (Play Money) Seat #2 is the button
Seat 1: dddocky (11252 in chips) 
Seat 2: FragileMemory (3352 in chips) 
Seat 3: Duke Croix (26387 in chips) 
Seat 4: yairpinto (9232 in chips) 
Seat 6: color_singleton (10536 in chips) 
Seat 8: JeBoyDirk (31001 in chips) 
Seat 9: MnnM150 (9462 in chips) 
Duke Croix: posts small blind 50
yairpinto: posts big blind 100
*** HOLE CARDS ***
Dealt to Duke Croix [6c 8s]
color_singleton: raises 200 to 300
JeBoyDirk: folds 
MnnM150: folds 
dddocky: calls 300
FragileMemory: raises 1050 to 1350
Duke Croix: folds 
yairpinto: folds 
color_singleton: folds 
dddocky: folds 
Uncalled bet (1050) returned to FragileMemory
FragileMemory collected 1050 from pot
FragileMemory: doesn't show hand 
*** SUMMARY ***
Total pot 1050 | Rake 0 
Seat 1: dddocky folded before Flop
Seat 2: FragileMemory (button) collected (1050)
Seat 3: Duke Croix (small blind) folded before Flop
Seat 4: yairpinto (big blind) folded before Flop
Seat 6: color_singleton folded before Flop
Seat 8: JeBoyDirk folded before Flop (didn't bet)
Seat 9: MnnM150 folded before Flop (didn't bet)



PokerStars Home Game Hand #218087286921: {Club #3225207}  Hold'em No Limit (50/100) - 2020/09/03 16:37:27 ET
Table 'fun gamez' 9-max (Play Money) Seat #3 is the button
Seat 1: dddocky (10952 in chips) 
Seat 2: FragileMemory (4102 in chips) 
Seat 3: Duke Croix (26337 in chips) 
Seat 4: yairpinto (9132 in chips) 
Seat 6: color_singleton (10236 in chips) 
Seat 8: JeBoyDirk (31001 in chips) 
Seat 9: MnnM150 (9462 in chips) 
yairpinto: posts small blind 50
color_singleton: posts big blind 100
*** HOLE CARDS ***
Dealt to Duke Croix [Jc 8d]
JeBoyDirk: calls 100
MnnM150: calls 100
dddocky: folds 
FragileMemory: calls 100
Duke Croix: folds 
yairpinto: calls 50
color_singleton: checks 
*** FLOP *** [Ac 9h 7s]
yairpinto: checks 
color_singleton: checks 
JeBoyDirk: checks 
MnnM150: checks 
FragileMemory: checks 
*** TURN *** [Ac 9h 7s] [Qh]
yairpinto: checks 
color_singleton: checks 
JeBoyDirk: checks 
MnnM150: bets 236
FragileMemory: calls 236
yairpinto: folds 
color_singleton: folds 
JeBoyDirk: calls 236
*** RIVER *** [Ac 9h 7s Qh] [Jh]
JeBoyDirk: checks 
MnnM150: bets 571
FragileMemory: calls 571
JeBoyDirk: calls 571
*** SHOW DOWN ***
MnnM150: shows [Kh Qs] (a pair of Queens)
FragileMemory: shows [As 5c] (a pair of Aces)
JeBoyDirk: shows [8s Ts] (a straight, Eight to Queen)
JeBoyDirk collected 2760 from pot
*** SUMMARY ***
Total pot 2921 | Rake 161 
Board [Ac 9h 7s Qh Jh]
Seat 1: dddocky folded before Flop (didn't bet)
Seat 2: FragileMemory showed [As 5c] and lost with a pair of Aces
Seat 3: Duke Croix (button) folded before Flop (didn't bet)
Seat 4: yairpinto (small blind) folded on the Turn
Seat 6: color_singleton (big blind) folded on the Turn
Seat 8: JeBoyDirk showed [8s Ts] and won (2760) with a straight, Eight to Queen
Seat 9: MnnM150 showed [Kh Qs] and lost with a pair of Queens



PokerStars Home Game Hand #218087332863: {Club #3225207}  Hold'em No Limit (50/100) - 2020/09/03 16:38:43 ET
Table 'fun gamez' 9-max (Play Money) Seat #4 is the button
Seat 1: dddocky (10952 in chips) 
Seat 2: FragileMemory (3195 in chips) 
Seat 3: Duke Croix (26337 in chips) 
Seat 4: yairpinto (9032 in chips) 
Seat 6: color_singleton (10136 in chips) 
Seat 8: JeBoyDirk (32854 in chips) 
Seat 9: MnnM150 (8555 in chips) 
color_singleton: posts small blind 50
JeBoyDirk: posts big blind 100
*** HOLE CARDS ***
Dealt to Duke Croix [3h 8s]
MnnM150: folds 
dddocky: folds 
FragileMemory: calls 100
Duke Croix: folds 
yairpinto: calls 100
color_singleton: raises 200 to 300
JeBoyDirk: folds 
FragileMemory: folds 
yairpinto: calls 200
*** FLOP *** [9h 6c Qc]
color_singleton: bets 378
yairpinto: calls 378
*** TURN *** [9h 6c Qc] [5d]
color_singleton: checks 
yairpinto: checks 
*** RIVER *** [9h 6c Qc 5d] [Jd]
color_singleton: bets 1470
yairpinto: folds 
Uncalled bet (1470) returned to color_singleton
color_singleton collected 1470 from pot
color_singleton: doesn't show hand 
*** SUMMARY ***
Total pot 1556 | Rake 86 
Board [9h 6c Qc 5d Jd]
Seat 1: dddocky folded before Flop (didn't bet)
Seat 2: FragileMemory folded before Flop
Seat 3: Duke Croix folded before Flop (didn't bet)
Seat 4: yairpinto (button) folded on the River
Seat 6: color_singleton (small blind) collected (1470)
Seat 8: JeBoyDirk (big blind) folded before Flop
Seat 9: MnnM150 folded before Flop (didn't bet)



PokerStars Home Game Hand #218087366684: {Club #3225207}  Hold'em No Limit (50/100) - 2020/09/03 16:39:39 ET
Table 'fun gamez' 9-max (Play Money) Seat #6 is the button
Seat 1: dddocky (10952 in chips) 
Seat 2: FragileMemory (3095 in chips) 
Seat 3: Duke Croix (26337 in chips) 
Seat 4: yairpinto (8354 in chips) 
Seat 6: color_singleton (10928 in chips) 
Seat 8: JeBoyDirk (32754 in chips) 
Seat 9: MnnM150 (8555 in chips) 
JeBoyDirk: posts small blind 50
MnnM150: posts big blind 100
*** HOLE CARDS ***
Dealt to Duke Croix [3h Ah]
dddocky: calls 100
FragileMemory: folds 
Duke Croix: raises 200 to 300
yairpinto: folds 
color_singleton: folds 
JeBoyDirk: folds 
MnnM150: folds 
dddocky: folds 
Uncalled bet (200) returned to Duke Croix
Duke Croix collected 350 from pot
*** SUMMARY ***
Total pot 350 | Rake 0 
Seat 1: dddocky folded before Flop
Seat 2: FragileMemory folded before Flop (didn't bet)
Seat 3: Duke Croix collected (350)
Seat 4: yairpinto folded before Flop (didn't bet)
Seat 6: color_singleton (button) folded before Flop (didn't bet)
Seat 8: JeBoyDirk (small blind) folded before Flop
Seat 9: MnnM150 (big blind) folded before Flop



PokerStars Home Game Hand #218087378592: {Club #3225207}  Hold'em No Limit (50/100) - 2020/09/03 16:39:58 ET
Table 'fun gamez' 9-max (Play Money) Seat #8 is the button
Seat 1: dddocky (10852 in chips) 
Seat 2: FragileMemory (3095 in chips) 
Seat 3: Duke Croix (26587 in chips) 
Seat 4: yairpinto (8354 in chips) 
Seat 6: color_singleton (10928 in chips) 
Seat 8: JeBoyDirk (32704 in chips) 
Seat 9: MnnM150 (8455 in chips) 
MnnM150: posts small blind 50
dddocky: posts big blind 100
*** HOLE CARDS ***
Dealt to Duke Croix [2d Th]
FragileMemory: calls 100
Duke Croix: folds 
yairpinto: folds 
color_singleton: folds 
JeBoyDirk: folds 
MnnM150: folds 
dddocky: checks 
*** FLOP *** [Ac 5d 8d]
dddocky: checks 
FragileMemory: checks 
*** TURN *** [Ac 5d 8d] [Ad]
dddocky: checks 
FragileMemory: checks 
*** RIVER *** [Ac 5d 8d Ad] [7s]
dddocky: bets 236
FragileMemory: folds 
Uncalled bet (236) returned to dddocky
dddocky collected 236 from pot
dddocky: doesn't show hand 
*** SUMMARY ***
Total pot 250 | Rake 14 
Board [Ac 5d 8d Ad 7s]
Seat 1: dddocky (big blind) collected (236)
Seat 2: FragileMemory folded on the River
Seat 3: Duke Croix folded before Flop (didn't bet)
Seat 4: yairpinto folded before Flop (didn't bet)
Seat 6: color_singleton folded before Flop (didn't bet)
Seat 8: JeBoyDirk (button) folded before Flop (didn't bet)
Seat 9: MnnM150 (small blind) folded before Flop



PokerStars Home Game Hand #218087394581: {Club #3225207}  Hold'em No Limit (50/100) - 2020/09/03 16:40:24 ET
Table 'fun gamez' 9-max (Play Money) Seat #9 is the button
Seat 1: dddocky (10988 in chips) 
Seat 2: FragileMemory (2995 in chips) 
Seat 3: Duke Croix (26587 in chips) 
Seat 4: yairpinto (8354 in chips) 
Seat 6: color_singleton (10928 in chips) 
Seat 8: JeBoyDirk (32704 in chips) 
Seat 9: MnnM150 (8405 in chips) 
dddocky: posts small blind 50
FragileMemory: posts big blind 100
*** HOLE CARDS ***
Dealt to Duke Croix [5h Qs]
Duke Croix: folds 
yairpinto: calls 100
color_singleton: folds 
JeBoyDirk: folds 
MnnM150: folds 
dddocky: folds 
FragileMemory: checks 
*** FLOP *** [Qc 2s Kh]
FragileMemory: bets 100
yairpinto: calls 100
*** TURN *** [Qc 2s Kh] [5s]
FragileMemory: checks 
yairpinto: bets 212
FragileMemory: calls 212
*** RIVER *** [Qc 2s Kh 5s] [8c]
FragileMemory: checks 
yairpinto: bets 413
FragileMemory: calls 413
*** SHOW DOWN ***
yairpinto: shows [5c Kc] (two pair, Kings and Fives)
FragileMemory: mucks hand 
yairpinto collected 1606 from pot
*** SUMMARY ***
Total pot 1700 | Rake 94 
Board [Qc 2s Kh 5s 8c]
Seat 1: dddocky (small blind) folded before Flop
Seat 2: FragileMemory (big blind) mucked [Kd 7d]
Seat 3: Duke Croix folded before Flop (didn't bet)
Seat 4: yairpinto showed [5c Kc] and won (1606) with two pair, Kings and Fives
Seat 6: color_singleton folded before Flop (didn't bet)
Seat 8: JeBoyDirk folded before Flop (didn't bet)
Seat 9: MnnM150 (button) folded before Flop (didn't bet)



PokerStars Home Game Hand #218087415701: {Club #3225207}  Hold'em No Limit (50/100) - 2020/09/03 16:40:58 ET
Table 'fun gamez' 9-max (Play Money) Seat #1 is the button
Seat 1: dddocky (10938 in chips) 
Seat 2: FragileMemory (2170 in chips) 
Seat 3: Duke Croix (26587 in chips) 
Seat 4: yairpinto (9135 in chips) 
Seat 6: color_singleton (10928 in chips) 
Seat 8: JeBoyDirk (32704 in chips) 
Seat 9: MnnM150 (8405 in chips) 
FragileMemory: posts small blind 50
Duke Croix: posts big blind 100
*** HOLE CARDS ***
Dealt to Duke Croix [5d 5s]
yairpinto: folds 
color_singleton: calls 100
JeBoyDirk: calls 100
MnnM150: calls 100
dddocky: calls 100
FragileMemory: folds 
Duke Croix: raises 300 to 400
color_singleton: calls 300
JeBoyDirk: calls 300
MnnM150: folds 
dddocky: calls 300
*** FLOP *** [2d Qs Jd]
Duke Croix: bets 800
color_singleton: raises 800 to 1600
JeBoyDirk: folds 
dddocky: folds 
Duke Croix: folds 
Uncalled bet (800) returned to color_singleton
color_singleton collected 3166 from pot
color_singleton: doesn't show hand 
*** SUMMARY ***
Total pot 3350 | Rake 184 
Board [2d Qs Jd]
Seat 1: dddocky (button) folded on the Flop
Seat 2: FragileMemory (small blind) folded before Flop
Seat 3: Duke Croix (big blind) folded on the Flop
Seat 4: yairpinto folded before Flop (didn't bet)
Seat 6: color_singleton collected (3166)
Seat 8: JeBoyDirk folded on the Flop
Seat 9: MnnM150 folded before Flop



PokerStars Home Game Hand #218087454123: {Club #3225207}  Hold'em No Limit (50/100) - 2020/09/03 16:41:50 ET
Table 'fun gamez' 9-max (Play Money) Seat #2 is the button
Seat 1: dddocky (10538 in chips) 
Seat 2: FragileMemory (2120 in chips) 
Seat 3: Duke Croix (25387 in chips) 
Seat 4: yairpinto (9135 in chips) 
Seat 6: color_singleton (12894 in chips) 
Seat 8: JeBoyDirk (32304 in chips) 
Seat 9: MnnM150 (8305 in chips) 
Duke Croix: posts small blind 50
yairpinto: posts big blind 100
*** HOLE CARDS ***
Dealt to Duke Croix [Qh 6h]
color_singleton: raises 100 to 200
JeBoyDirk: folds 
MnnM150: folds 
dddocky: calls 200
FragileMemory: folds 
Duke Croix: folds 
yairpinto: calls 100
*** FLOP *** [5s As 2c]
yairpinto: checks 
color_singleton: checks 
dddocky: checks 
*** TURN *** [5s As 2c] [2h]
yairpinto: checks 
color_singleton: checks 
dddocky: bets 614
yairpinto: folds 
color_singleton: folds 
Uncalled bet (614) returned to dddocky
dddocky collected 614 from pot
dddocky: doesn't show hand 
*** SUMMARY ***
Total pot 650 | Rake 36 
Board [5s As 2c 2h]
Seat 1: dddocky collected (614)
Seat 2: FragileMemory (button) folded before Flop (didn't bet)
Seat 3: Duke Croix (small blind) folded before Flop
Seat 4: yairpinto (big blind) folded on the Turn
Seat 6: color_singleton folded on the Turn
Seat 8: JeBoyDirk folded before Flop (didn't bet)
Seat 9: MnnM150 folded before Flop (didn't bet)



PokerStars Home Game Hand #218087474472: {Club #3225207}  Hold'em No Limit (50/100) - 2020/09/03 16:42:24 ET
Table 'fun gamez' 9-max (Play Money) Seat #3 is the button
Seat 1: dddocky (10952 in chips) 
Seat 2: FragileMemory (2120 in chips) 
Seat 3: Duke Croix (25337 in chips) 
Seat 4: yairpinto (8935 in chips) 
Seat 6: color_singleton (12694 in chips) 
Seat 8: JeBoyDirk (32304 in chips) 
Seat 9: MnnM150 (8305 in chips) 
yairpinto: posts small blind 50
color_singleton: posts big blind 100
*** HOLE CARDS ***
Dealt to Duke Croix [6h Qs]
JeBoyDirk: folds 
MnnM150: calls 100
dddocky: calls 100
FragileMemory: folds 
Duke Croix: calls 100
yairpinto: calls 50
color_singleton: checks 
*** FLOP *** [As Ts Tc]
yairpinto: checks 
color_singleton: checks 
MnnM150: checks 
dddocky: checks 
Duke Croix: bets 250
yairpinto: folds 
color_singleton: folds 
MnnM150: calls 250
dddocky: folds 
*** TURN *** [As Ts Tc] [Ah]
MnnM150: checks 
Duke Croix: bets 400
MnnM150: folds 
Uncalled bet (400) returned to Duke Croix
Duke Croix collected 945 from pot
*** SUMMARY ***
Total pot 1000 | Rake 55 
Board [As Ts Tc Ah]
Seat 1: dddocky folded on the Flop
Seat 2: FragileMemory folded before Flop (didn't bet)
Seat 3: Duke Croix (button) collected (945)
Seat 4: yairpinto (small blind) folded on the Flop
Seat 6: color_singleton (big blind) folded on the Flop
Seat 8: JeBoyDirk folded before Flop (didn't bet)
Seat 9: MnnM150 folded on the Turn



PokerStars Home Game Hand #218087506136: {Club #3225207}  Hold'em No Limit (50/100) - 2020/09/03 16:43:16 ET
Table 'fun gamez' 9-max (Play Money) Seat #4 is the button
Seat 1: dddocky (10852 in chips) 
Seat 2: FragileMemory (2120 in chips) 
Seat 3: Duke Croix (25932 in chips) 
Seat 4: yairpinto (8835 in chips) 
Seat 6: color_singleton (12594 in chips) 
Seat 8: JeBoyDirk (32304 in chips) 
Seat 9: MnnM150 (7955 in chips) 
color_singleton: posts small blind 50
JeBoyDirk: posts big blind 100
*** HOLE CARDS ***
Dealt to Duke Croix [Ks 5h]
MnnM150: folds 
dddocky: calls 100
FragileMemory: folds 
Duke Croix: folds 
yairpinto: raises 200 to 300
color_singleton: folds 
JeBoyDirk: folds 
dddocky: calls 200
*** FLOP *** [Ah As Kd]
dddocky: checks 
yairpinto: bets 354
dddocky: calls 354
*** TURN *** [Ah As Kd] [5c]
dddocky: bets 100
yairpinto: raises 789 to 889
dddocky: calls 789
*** RIVER *** [Ah As Kd 5c] [4c]
dddocky: bets 100
yairpinto: calls 100
*** SHOW DOWN ***
dddocky: shows [Ad Qc] (three of a kind, Aces)
yairpinto: shows [3c 2c] (a straight, Ace to Five)
yairpinto collected 3247 from pot
*** SUMMARY ***
Total pot 3436 | Rake 189 
Board [Ah As Kd 5c 4c]
Seat 1: dddocky showed [Ad Qc] and lost with three of a kind, Aces
Seat 2: FragileMemory folded before Flop (didn't bet)
Seat 3: Duke Croix folded before Flop (didn't bet)
Seat 4: yairpinto (button) showed [3c 2c] and won (3247) with a straight, Ace to Five
Seat 6: color_singleton (small blind) folded before Flop
Seat 8: JeBoyDirk (big blind) folded before Flop
Seat 9: MnnM150 folded before Flop (didn't bet)



PokerStars Home Game Hand #218087534910: {Club #3225207}  Hold'em No Limit (50/100) - 2020/09/03 16:44:03 ET
Table 'fun gamez' 9-max (Play Money) Seat #6 is the button
Seat 1: dddocky (9209 in chips) 
Seat 2: FragileMemory (2120 in chips) 
Seat 3: Duke Croix (25932 in chips) 
Seat 4: yairpinto (10439 in chips) 
Seat 6: color_singleton (12544 in chips) 
Seat 8: JeBoyDirk (32204 in chips) 
Seat 9: MnnM150 (7955 in chips) 
JeBoyDirk: posts small blind 50
MnnM150: posts big blind 100
*** HOLE CARDS ***
Dealt to Duke Croix [Js Tc]
dddocky: folds 
FragileMemory: calls 100
Duke Croix: raises 300 to 400
yairpinto: folds 
color_singleton: calls 400
JeBoyDirk: folds 
MnnM150: folds 
FragileMemory: calls 300
*** FLOP *** [3s 4h Ah]
FragileMemory: bets 1720 and is all-in
Duke Croix: folds 
color_singleton: folds 
Uncalled bet (1720) returned to FragileMemory
FragileMemory collected 1276 from pot
FragileMemory: doesn't show hand 
*** SUMMARY ***
Total pot 1350 | Rake 74 
Board [3s 4h Ah]
Seat 1: dddocky folded before Flop (didn't bet)
Seat 2: FragileMemory collected (1276)
Seat 3: Duke Croix folded on the Flop
Seat 4: yairpinto folded before Flop (didn't bet)
Seat 6: color_singleton (button) folded on the Flop
Seat 8: JeBoyDirk (small blind) folded before Flop
Seat 9: MnnM150 (big blind) folded before Flop



PokerStars Home Game Hand #218087553960: {Club #3225207}  Hold'em No Limit (50/100) - 2020/09/03 16:44:35 ET
Table 'fun gamez' 9-max (Play Money) Seat #8 is the button
Seat 1: dddocky (9209 in chips) 
Seat 2: FragileMemory (2996 in chips) 
Seat 3: Duke Croix (25532 in chips) 
Seat 4: yairpinto (10439 in chips) 
Seat 6: color_singleton (12144 in chips) 
Seat 8: JeBoyDirk (32154 in chips) 
Seat 9: MnnM150 (7855 in chips) 
MnnM150: posts small blind 50
dddocky: posts big blind 100
*** HOLE CARDS ***
Dealt to Duke Croix [3s 4c]
FragileMemory: calls 100
Duke Croix: calls 100
yairpinto: folds 
color_singleton: folds 
JeBoyDirk: folds 
MnnM150: folds 
dddocky: checks 
*** FLOP *** [8c Ks 8d]
dddocky: checks 
FragileMemory: bets 100
Duke Croix: folds 
dddocky: folds 
Uncalled bet (100) returned to FragileMemory
FragileMemory collected 331 from pot
FragileMemory: doesn't show hand 
*** SUMMARY ***
Total pot 350 | Rake 19 
Board [8c Ks 8d]
Seat 1: dddocky (big blind) folded on the Flop
Seat 2: FragileMemory collected (331)
Seat 3: Duke Croix folded on the Flop
Seat 4: yairpinto folded before Flop (didn't bet)
Seat 6: color_singleton folded before Flop (didn't bet)
Seat 8: JeBoyDirk (button) folded before Flop (didn't bet)
Seat 9: MnnM150 (small blind) folded before Flop



PokerStars Home Game Hand #218087571539: {Club #3225207}  Hold'em No Limit (50/100) - 2020/09/03 16:45:03 ET
Table 'fun gamez' 9-max (Play Money) Seat #9 is the button
Seat 1: dddocky (9109 in chips) 
Seat 2: FragileMemory (3227 in chips) 
Seat 3: Duke Croix (25432 in chips) 
Seat 4: yairpinto (10439 in chips) 
Seat 6: color_singleton (12144 in chips) 
Seat 8: JeBoyDirk (32154 in chips) 
Seat 9: MnnM150 (7805 in chips) 
dddocky: posts small blind 50
FragileMemory: posts big blind 100
*** HOLE CARDS ***
Dealt to Duke Croix [8s 2d]
Duke Croix: folds 
yairpinto: folds 
color_singleton: folds 
JeBoyDirk: folds 
MnnM150: folds 
dddocky: calls 50
FragileMemory: checks 
*** FLOP *** [Jc 8c Js]
dddocky: checks 
FragileMemory: checks 
*** TURN *** [Jc 8c Js] [7s]
dddocky: checks 
FragileMemory: checks 
*** RIVER *** [Jc 8c Js 7s] [8h]
dddocky: checks 
FragileMemory: checks 
*** SHOW DOWN ***
dddocky: shows [Ts Ac] (two pair, Jacks and Eights)
FragileMemory: mucks hand 
dddocky collected 189 from pot
*** SUMMARY ***
Total pot 200 | Rake 11 
Board [Jc 8c Js 7s 8h]
Seat 1: dddocky (small blind) showed [Ts Ac] and won (189) with two pair, Jacks and Eights
Seat 2: FragileMemory (big blind) mucked [6h Kd]
Seat 3: Duke Croix folded before Flop (didn't bet)
Seat 4: yairpinto folded before Flop (didn't bet)
Seat 6: color_singleton folded before Flop (didn't bet)
Seat 8: JeBoyDirk folded before Flop (didn't bet)
Seat 9: MnnM150 (button) folded before Flop (didn't bet)



PokerStars Home Game Hand #218087591631: {Club #3225207}  Hold'em No Limit (50/100) - 2020/09/03 16:45:35 ET
Table 'fun gamez' 9-max (Play Money) Seat #1 is the button
Seat 1: dddocky (9198 in chips) 
Seat 2: FragileMemory (3127 in chips) 
Seat 3: Duke Croix (25432 in chips) 
Seat 4: yairpinto (10439 in chips) 
Seat 6: color_singleton (12144 in chips) 
Seat 8: JeBoyDirk (32154 in chips) 
Seat 9: MnnM150 (7805 in chips) 
FragileMemory: posts small blind 50
Duke Croix: posts big blind 100
*** HOLE CARDS ***
Dealt to Duke Croix [2h 5c]
yairpinto: folds 
color_singleton: calls 100
JeBoyDirk: raises 200 to 300
MnnM150: folds 
dddocky: folds 
FragileMemory: folds 
Duke Croix: folds 
color_singleton: calls 200
*** FLOP *** [7h As Ts]
color_singleton: checks 
JeBoyDirk: checks 
*** TURN *** [7h As Ts] [2s]
color_singleton: bets 354
JeBoyDirk: calls 354
*** RIVER *** [7h As Ts 2s] [Kd]
color_singleton: checks 
JeBoyDirk: checks 
*** SHOW DOWN ***
color_singleton: shows [Ah 4d] (a pair of Aces)
JeBoyDirk: shows [Ad Ac] (three of a kind, Aces)
JeBoyDirk collected 1378 from pot
*** SUMMARY ***
Total pot 1458 | Rake 80 
Board [7h As Ts 2s Kd]
Seat 1: dddocky (button) folded before Flop (didn't bet)
Seat 2: FragileMemory (small blind) folded before Flop
Seat 3: Duke Croix (big blind) folded before Flop
Seat 4: yairpinto folded before Flop (didn't bet)
Seat 6: color_singleton showed [Ah 4d] and lost with a pair of Aces
Seat 8: JeBoyDirk showed [Ad Ac] and won (1378) with three of a kind, Aces
Seat 9: MnnM150 folded before Flop (didn't bet)



PokerStars Home Game Hand #218087615793: {Club #3225207}  Hold'em No Limit (50/100) - 2020/09/03 16:46:14 ET
Table 'fun gamez' 9-max (Play Money) Seat #2 is the button
Seat 1: dddocky (9198 in chips) 
Seat 2: FragileMemory (3077 in chips) 
Seat 3: Duke Croix (25332 in chips) 
Seat 4: yairpinto (10439 in chips) 
Seat 6: color_singleton (11490 in chips) 
Seat 8: JeBoyDirk (32878 in chips) 
Seat 9: MnnM150 (7805 in chips) 
Duke Croix: posts small blind 50
yairpinto: posts big blind 100
*** HOLE CARDS ***
Dealt to Duke Croix [8s 3d]
color_singleton: raises 100 to 200
JeBoyDirk: folds 
MnnM150: calls 200
dddocky: calls 200
FragileMemory: calls 200
Duke Croix: folds 
yairpinto: calls 100
*** FLOP *** [Ts 9s Th]
yairpinto: bets 496
color_singleton: calls 496
MnnM150: folds 
dddocky: folds 
FragileMemory: folds 
*** TURN *** [Ts 9s Th] [Qs]
yairpinto: bets 965
color_singleton: calls 965
*** RIVER *** [Ts 9s Th Qs] [7c]
yairpinto: bets 1877
color_singleton: raises 2523 to 4400
yairpinto: calls 2523
*** SHOW DOWN ***
color_singleton: shows [9c 9h] (a full house, Nines full of Tens)
yairpinto: mucks hand 
color_singleton collected 12070 from pot
*** SUMMARY ***
Total pot 12772 | Rake 702 
Board [Ts 9s Th Qs 7c]
Seat 1: dddocky folded on the Flop
Seat 2: FragileMemory (button) folded on the Flop
Seat 3: Duke Croix (small blind) folded before Flop
Seat 4: yairpinto (big blind) mucked [As Js]
Seat 6: color_singleton showed [9c 9h] and won (12070) with a full house, Nines full of Tens
Seat 8: JeBoyDirk folded before Flop (didn't bet)
Seat 9: MnnM150 folded on the Flop



PokerStars Home Game Hand #218087653007: {Club #3225207}  Hold'em No Limit (50/100) - 2020/09/03 16:47:15 ET
Table 'fun gamez' 9-max (Play Money) Seat #3 is the button
Seat 1: dddocky (8998 in chips) 
Seat 2: FragileMemory (2877 in chips) 
Seat 3: Duke Croix (25282 in chips) 
Seat 4: yairpinto (4378 in chips) 
Seat 6: color_singleton (17499 in chips) 
Seat 8: JeBoyDirk (32878 in chips) 
Seat 9: MnnM150 (7605 in chips) 
yairpinto: posts small blind 50
color_singleton: posts big blind 100
*** HOLE CARDS ***
Dealt to Duke Croix [5c 3c]
JeBoyDirk: folds 
MnnM150: folds 
dddocky: folds 
FragileMemory: folds 
Duke Croix: calls 100
yairpinto: calls 50
color_singleton: checks 
*** FLOP *** [Ad Js 4d]
yairpinto: checks 
color_singleton: checks 
Duke Croix: checks 
*** TURN *** [Ad Js 4d] [Qd]
yairpinto: checks 
color_singleton: checks 
Duke Croix: checks 
*** RIVER *** [Ad Js 4d Qd] [5s]
yairpinto: checks 
color_singleton: checks 
Duke Croix: bets 200
yairpinto: folds 
color_singleton: folds 
Uncalled bet (200) returned to Duke Croix
Duke Croix collected 283 from pot
*** SUMMARY ***
Total pot 300 | Rake 17 
Board [Ad Js 4d Qd 5s]
Seat 1: dddocky folded before Flop (didn't bet)
Seat 2: FragileMemory folded before Flop (didn't bet)
Seat 3: Duke Croix (button) collected (283)
Seat 4: yairpinto (small blind) folded on the River
Seat 6: color_singleton (big blind) folded on the River
Seat 8: JeBoyDirk folded before Flop (didn't bet)
Seat 9: MnnM150 folded before Flop (didn't bet)



PokerStars Home Game Hand #218087677946: {Club #3225207}  Hold'em No Limit (50/100) - 2020/09/03 16:47:55 ET
Table 'fun gamez' 9-max (Play Money) Seat #4 is the button
Seat 1: dddocky (8998 in chips) 
Seat 2: FragileMemory (2877 in chips) 
Seat 3: Duke Croix (25465 in chips) 
Seat 4: yairpinto (4278 in chips) 
Seat 6: color_singleton (17399 in chips) 
Seat 8: JeBoyDirk (32878 in chips) 
Seat 9: MnnM150 (7605 in chips) 
color_singleton: posts small blind 50
JeBoyDirk: posts big blind 100
*** HOLE CARDS ***
Dealt to Duke Croix [8d 9s]
MnnM150: folds 
dddocky: folds 
FragileMemory: calls 100
Duke Croix: raises 300 to 400
yairpinto: folds 
color_singleton: folds 
JeBoyDirk: calls 300
FragileMemory: raises 1250 to 1650
Duke Croix: calls 1250
JeBoyDirk: calls 1250
*** FLOP *** [Qh 3s 6s]
JeBoyDirk: bets 2100
FragileMemory: calls 1227 and is all-in
Duke Croix: folds 
Uncalled bet (873) returned to JeBoyDirk
*** TURN *** [Qh 3s 6s] [3d]
*** RIVER *** [Qh 3s 6s 3d] [Ac]
*** SHOW DOWN ***
JeBoyDirk: shows [Qd Qc] (a full house, Queens full of Threes)
FragileMemory: shows [Ad Ah] (a full house, Aces full of Threes)
FragileMemory collected 7044 from pot
*** SUMMARY ***
Total pot 7454 | Rake 410 
Board [Qh 3s 6s 3d Ac]
Seat 1: dddocky folded before Flop (didn't bet)
Seat 2: FragileMemory showed [Ad Ah] and won (7044) with a full house, Aces full of Threes
Seat 3: Duke Croix folded on the Flop
Seat 4: yairpinto (button) folded before Flop (didn't bet)
Seat 6: color_singleton (small blind) folded before Flop
Seat 8: JeBoyDirk (big blind) showed [Qd Qc] and lost with a full house, Queens full of Threes
Seat 9: MnnM150 folded before Flop (didn't bet)



PokerStars Home Game Hand #218087706303: {Club #3225207}  Hold'em No Limit (50/100) - 2020/09/03 16:48:40 ET
Table 'fun gamez' 9-max (Play Money) Seat #6 is the button
Seat 1: dddocky (8998 in chips) 
Seat 2: FragileMemory (7044 in chips) 
Seat 3: Duke Croix (23815 in chips) 
Seat 4: yairpinto (4278 in chips) 
Seat 6: color_singleton (17349 in chips) 
Seat 8: JeBoyDirk (30001 in chips) 
Seat 9: MnnM150 (7605 in chips) 
JeBoyDirk: posts small blind 50
MnnM150: posts big blind 100
*** HOLE CARDS ***
Dealt to Duke Croix [7d 7h]
dddocky: calls 100
FragileMemory: folds 
Duke Croix: raises 300 to 400
yairpinto: folds 
color_singleton: folds 
JeBoyDirk: folds 
MnnM150: calls 300
dddocky: calls 300
*** FLOP *** [4h 2h 6s]
MnnM150: checks 
dddocky: checks 
Duke Croix: bets 700
MnnM150: folds 
dddocky: calls 700
*** TURN *** [4h 2h 6s] [2d]
dddocky: checks 
Duke Croix: bets 1000
dddocky: folds 
Uncalled bet (1000) returned to Duke Croix
Duke Croix collected 2504 from pot
*** SUMMARY ***
Total pot 2650 | Rake 146 
Board [4h 2h 6s 2d]
Seat 1: dddocky folded on the Turn
Seat 2: FragileMemory folded before Flop (didn't bet)
Seat 3: Duke Croix collected (2504)
Seat 4: yairpinto folded before Flop (didn't bet)
Seat 6: color_singleton (button) folded before Flop (didn't bet)
Seat 8: JeBoyDirk (small blind) folded before Flop
Seat 9: MnnM150 (big blind) folded on the Flop



PokerStars Home Game Hand #218087733855: {Club #3225207}  Hold'em No Limit (50/100) - 2020/09/03 16:49:24 ET
Table 'fun gamez' 9-max (Play Money) Seat #8 is the button
Seat 1: dddocky (7898 in chips) 
Seat 2: FragileMemory (7044 in chips) 
Seat 3: Duke Croix (25219 in chips) 
Seat 4: yairpinto (4278 in chips) 
Seat 6: color_singleton (17349 in chips) 
Seat 8: JeBoyDirk (29951 in chips) 
Seat 9: MnnM150 (7205 in chips) 
MnnM150: posts small blind 50
dddocky: posts big blind 100
*** HOLE CARDS ***
Dealt to Duke Croix [2d Kd]
FragileMemory: raises 100 to 200
Duke Croix: folds 
yairpinto: folds 
color_singleton: calls 200
JeBoyDirk: folds 
MnnM150: folds 
dddocky: folds 
*** FLOP *** [As 5d Js]
FragileMemory: checks 
color_singleton: checks 
*** TURN *** [As 5d Js] [Qs]
FragileMemory: checks 
color_singleton: checks 
*** RIVER *** [As 5d Js Qs] [Ts]
FragileMemory: checks 
color_singleton: checks 
*** SHOW DOWN ***
FragileMemory: shows [7d 7h] (a pair of Sevens)
color_singleton: shows [9c Td] (a pair of Tens)
color_singleton collected 520 from pot
*** SUMMARY ***
Total pot 550 | Rake 30 
Board [As 5d Js Qs Ts]
Seat 1: dddocky (big blind) folded before Flop
Seat 2: FragileMemory showed [7d 7h] and lost with a pair of Sevens
Seat 3: Duke Croix folded before Flop (didn't bet)
Seat 4: yairpinto folded before Flop (didn't bet)
Seat 6: color_singleton showed [9c Td] and won (520) with a pair of Tens
Seat 8: JeBoyDirk (button) folded before Flop (didn't bet)
Seat 9: MnnM150 (small blind) folded before Flop



PokerStars Home Game Hand #218087754258: {Club #3225207}  Hold'em No Limit (50/100) - 2020/09/03 16:49:57 ET
Table 'fun gamez' 9-max (Play Money) Seat #9 is the button
Seat 1: dddocky (7798 in chips) 
Seat 2: FragileMemory (6844 in chips) 
Seat 3: Duke Croix (25219 in chips) 
Seat 4: yairpinto (4278 in chips) 
Seat 6: color_singleton (17669 in chips) 
Seat 8: JeBoyDirk (29951 in chips) 
Seat 9: MnnM150 (7155 in chips) 
dddocky: posts small blind 50
FragileMemory: posts big blind 100
*** HOLE CARDS ***
Dealt to Duke Croix [Kc 2s]
Duke Croix: folds 
yairpinto: folds 
color_singleton: raises 100 to 200
JeBoyDirk: calls 200
MnnM150: folds 
dddocky: folds 
FragileMemory: folds 
*** FLOP *** [Ah 4s Qh]
color_singleton: checks 
JeBoyDirk: checks 
*** TURN *** [Ah 4s Qh] [8d]
color_singleton: checks 
JeBoyDirk: bets 200
color_singleton: calls 200
*** RIVER *** [Ah 4s Qh 8d] [5d]
color_singleton: checks 
JeBoyDirk: bets 800
color_singleton: folds 
Uncalled bet (800) returned to JeBoyDirk
JeBoyDirk collected 898 from pot
*** SUMMARY ***
Total pot 950 | Rake 52 
Board [Ah 4s Qh 8d 5d]
Seat 1: dddocky (small blind) folded before Flop
Seat 2: FragileMemory (big blind) folded before Flop
Seat 3: Duke Croix folded before Flop (didn't bet)
Seat 4: yairpinto folded before Flop (didn't bet)
Seat 6: color_singleton folded on the River
Seat 8: JeBoyDirk collected (898)
Seat 9: MnnM150 (button) folded before Flop (didn't bet)



PokerStars Home Game Hand #218087784104: {Club #3225207}  Hold'em No Limit (50/100) - 2020/09/03 16:50:45 ET
Table 'fun gamez' 9-max (Play Money) Seat #2 is the button
Seat 2: FragileMemory (6744 in chips) 
Seat 3: Duke Croix (25219 in chips) 
Seat 4: yairpinto (4278 in chips) 
Seat 6: color_singleton (17269 in chips) 
Seat 8: JeBoyDirk (30449 in chips) 
Seat 9: MnnM150 (7155 in chips) 
Duke Croix: posts small blind 50
yairpinto: posts big blind 100
*** HOLE CARDS ***
Dealt to Duke Croix [5c 4h]
color_singleton: raises 100 to 200
JeBoyDirk: folds 
MnnM150: calls 200
FragileMemory: folds 
Duke Croix: folds 
yairpinto: folds 
*** FLOP *** [3s Qd Ts]
color_singleton: checks 
MnnM150: checks 
*** TURN *** [3s Qd Ts] [Ah]
color_singleton: checks 
MnnM150: bets 520
color_singleton: raises 520 to 1040
MnnM150: raises 520 to 1560
color_singleton: calls 520
*** RIVER *** [3s Qd Ts Ah] [Jc]
color_singleton: checks 
MnnM150: bets 5395 and is all-in
color_singleton: folds 
Uncalled bet (5395) returned to MnnM150
MnnM150 collected 3468 from pot
*** SUMMARY ***
Total pot 3670 | Rake 202 
Board [3s Qd Ts Ah Jc]
Seat 2: FragileMemory (button) folded before Flop (didn't bet)
Seat 3: Duke Croix (small blind) folded before Flop
Seat 4: yairpinto (big blind) folded before Flop
Seat 6: color_singleton folded on the River
Seat 8: JeBoyDirk folded before Flop (didn't bet)
Seat 9: MnnM150 collected (3468)



PokerStars Home Game Hand #218087827321: {Club #3225207}  Hold'em No Limit (50/100) - 2020/09/03 16:51:54 ET
Table 'fun gamez' 9-max (Play Money) Seat #3 is the button
Seat 2: FragileMemory (6744 in chips) 
Seat 3: Duke Croix (25169 in chips) 
Seat 4: yairpinto (4178 in chips) 
Seat 6: color_singleton (15509 in chips) 
Seat 8: JeBoyDirk (30449 in chips) 
Seat 9: MnnM150 (8863 in chips) 
yairpinto: posts small blind 50
color_singleton: posts big blind 100
*** HOLE CARDS ***
Dealt to Duke Croix [7d Jd]
JeBoyDirk: folds 
MnnM150: calls 100
FragileMemory: calls 100
Duke Croix: folds 
yairpinto: calls 50
color_singleton: raises 200 to 300
MnnM150: folds 
FragileMemory: folds 
yairpinto: calls 200
*** FLOP *** [9s 2c 2h]
yairpinto: checks 
color_singleton: bets 400
yairpinto: folds 
Uncalled bet (400) returned to color_singleton
color_singleton collected 756 from pot
color_singleton: doesn't show hand 
*** SUMMARY ***
Total pot 800 | Rake 44 
Board [9s 2c 2h]
Seat 2: FragileMemory folded before Flop
Seat 3: Duke Croix (button) folded before Flop (didn't bet)
Seat 4: yairpinto (small blind) folded on the Flop
Seat 6: color_singleton (big blind) collected (756)
Seat 8: JeBoyDirk folded before Flop (didn't bet)
Seat 9: MnnM150 folded before Flop



PokerStars Home Game Hand #218087859215: {Club #3225207}  Hold'em No Limit (50/100) - 2020/09/03 16:52:46 ET
Table 'fun gamez' 9-max (Play Money) Seat #4 is the button
Seat 2: FragileMemory (6644 in chips) 
Seat 3: Duke Croix (25169 in chips) 
Seat 4: yairpinto (3878 in chips) 
Seat 6: color_singleton (15965 in chips) 
Seat 8: JeBoyDirk (30449 in chips) 
Seat 9: MnnM150 (8763 in chips) 
color_singleton: posts small blind 50
JeBoyDirk: posts big blind 100
*** HOLE CARDS ***
Dealt to Duke Croix [6c 7d]
MnnM150: folds 
FragileMemory: calls 100
Duke Croix: calls 100
yairpinto: raises 200 to 300
color_singleton: calls 250
JeBoyDirk: calls 200
FragileMemory: folds 
Duke Croix: calls 200
*** FLOP *** [8s 5s Ad]
color_singleton: checks 
JeBoyDirk: checks 
Duke Croix: bets 700
yairpinto: folds 
color_singleton: folds 
JeBoyDirk: calls 700
*** TURN *** [8s 5s Ad] [Th]
JeBoyDirk: checks 
Duke Croix: checks 
*** RIVER *** [8s 5s Ad Th] [3h]
JeBoyDirk: checks 
Duke Croix: bets 1200
JeBoyDirk: folds 
Uncalled bet (1200) returned to Duke Croix
Duke Croix collected 2551 from pot
*** SUMMARY ***
Total pot 2700 | Rake 149 
Board [8s 5s Ad Th 3h]
Seat 2: FragileMemory folded before Flop
Seat 3: Duke Croix collected (2551)
Seat 4: yairpinto (button) folded on the Flop
Seat 6: color_singleton (small blind) folded on the Flop
Seat 8: JeBoyDirk (big blind) folded on the River
Seat 9: MnnM150 folded before Flop (didn't bet)



PokerStars Home Game Hand #218087897077: {Club #3225207}  Hold'em No Limit (50/100) - 2020/09/03 16:53:47 ET
Table 'fun gamez' 9-max (Play Money) Seat #6 is the button
Seat 1: dddocky (7748 in chips) 
Seat 2: FragileMemory (6544 in chips) 
Seat 3: Duke Croix (26720 in chips) 
Seat 4: yairpinto (3578 in chips) 
Seat 6: color_singleton (15665 in chips) 
Seat 8: JeBoyDirk (29449 in chips) 
Seat 9: MnnM150 (8763 in chips) 
JeBoyDirk: posts small blind 50
MnnM150: posts big blind 100
*** HOLE CARDS ***
Dealt to Duke Croix [8s Qd]
dddocky: calls 100
FragileMemory: folds 
Duke Croix: folds 
yairpinto: raises 200 to 300
color_singleton: folds 
JeBoyDirk: folds 
MnnM150: folds 
dddocky: folds 
Uncalled bet (200) returned to yairpinto
yairpinto collected 350 from pot
yairpinto: doesn't show hand 
*** SUMMARY ***
Total pot 350 | Rake 0 
Seat 1: dddocky folded before Flop
Seat 2: FragileMemory folded before Flop (didn't bet)
Seat 3: Duke Croix folded before Flop (didn't bet)
Seat 4: yairpinto collected (350)
Seat 6: color_singleton (button) folded before Flop (didn't bet)
Seat 8: JeBoyDirk (small blind) folded before Flop
Seat 9: MnnM150 (big blind) folded before Flop



PokerStars Home Game Hand #218087911407: {Club #3225207}  Hold'em No Limit (50/100) - 2020/09/03 16:54:10 ET
Table 'fun gamez' 9-max (Play Money) Seat #8 is the button
Seat 1: dddocky (7648 in chips) 
Seat 2: FragileMemory (6544 in chips) 
Seat 3: Duke Croix (26720 in chips) 
Seat 4: yairpinto (3828 in chips) 
Seat 6: color_singleton (15665 in chips) 
Seat 8: JeBoyDirk (29399 in chips) 
Seat 9: MnnM150 (8663 in chips) 
MnnM150: posts small blind 50
dddocky: posts big blind 100
*** HOLE CARDS ***
Dealt to Duke Croix [7s Th]
FragileMemory: folds 
Duke Croix: folds 
yairpinto: folds 
color_singleton: folds 
JeBoyDirk: folds 
MnnM150: calls 50
dddocky: checks 
*** FLOP *** [Qc 8d 3s]
MnnM150: checks 
dddocky: checks 
*** TURN *** [Qc 8d 3s] [Ac]
MnnM150: bets 189
dddocky: calls 189
*** RIVER *** [Qc 8d 3s Ac] [6d]
MnnM150: checks 
dddocky: bets 100
MnnM150: calls 100
*** SHOW DOWN ***
dddocky: shows [6h 8h] (two pair, Eights and Sixes)
MnnM150: mucks hand 
dddocky collected 735 from pot
*** SUMMARY ***
Total pot 778 | Rake 43 
Board [Qc 8d 3s Ac 6d]
Seat 1: dddocky (big blind) showed [6h 8h] and won (735) with two pair, Eights and Sixes
Seat 2: FragileMemory folded before Flop (didn't bet)
Seat 3: Duke Croix folded before Flop (didn't bet)
Seat 4: yairpinto folded before Flop (didn't bet)
Seat 6: color_singleton folded before Flop (didn't bet)
Seat 8: JeBoyDirk (button) folded before Flop (didn't bet)
Seat 9: MnnM150 (small blind) mucked [9d Qh]



PokerStars Home Game Hand #218087934150: {Club #3225207}  Hold'em No Limit (50/100) - 2020/09/03 16:54:47 ET
Table 'fun gamez' 9-max (Play Money) Seat #9 is the button
Seat 1: dddocky (7994 in chips) 
Seat 2: FragileMemory (6544 in chips) 
Seat 3: Duke Croix (26720 in chips) 
Seat 4: yairpinto (3828 in chips) 
Seat 6: color_singleton (15665 in chips) 
Seat 8: JeBoyDirk (29399 in chips) 
Seat 9: MnnM150 (8274 in chips) 
dddocky: posts small blind 50
FragileMemory: posts big blind 100
*** HOLE CARDS ***
Dealt to Duke Croix [7d Qd]
Duke Croix has timed out
Duke Croix: folds 
yairpinto: folds 
color_singleton: folds 
JeBoyDirk: folds 
MnnM150: folds 
dddocky: calls 50
FragileMemory: checks 
*** FLOP *** [2d Ks 4s]
dddocky: checks 
FragileMemory: checks 
*** TURN *** [2d Ks 4s] [7c]
dddocky: checks 
FragileMemory: checks 
*** RIVER *** [2d Ks 4s 7c] [6h]
dddocky: bets 100
FragileMemory: calls 100
*** SHOW DOWN ***
dddocky: shows [Ad 7h] (a pair of Sevens)
FragileMemory: mucks hand 
dddocky collected 378 from pot
*** SUMMARY ***
Total pot 400 | Rake 22 
Board [2d Ks 4s 7c 6h]
Seat 1: dddocky (small blind) showed [Ad 7h] and won (378) with a pair of Sevens
Seat 2: FragileMemory (big blind) mucked [Ac Th]
Seat 3: Duke Croix folded before Flop (didn't bet)
Seat 4: yairpinto folded before Flop (didn't bet)
Seat 6: color_singleton folded before Flop (didn't bet)
Seat 8: JeBoyDirk folded before Flop (didn't bet)
Seat 9: MnnM150 (button) folded before Flop (didn't bet)



PokerStars Home Game Hand #218087952204: {Club #3225207}  Hold'em No Limit (50/100) - 2020/09/03 16:55:26 ET
Table 'fun gamez' 9-max (Play Money) Seat #1 is the button
Seat 1: dddocky (8172 in chips) 
Seat 2: FragileMemory (6344 in chips) 
Seat 3: Duke Croix (26720 in chips) 
Seat 4: yairpinto (3828 in chips) 
Seat 6: color_singleton (15665 in chips) 
Seat 8: JeBoyDirk (29399 in chips) 
Seat 9: MnnM150 (8274 in chips) 
FragileMemory: posts small blind 50
Duke Croix: posts big blind 100
*** HOLE CARDS ***
Dealt to Duke Croix [9c Kd]
yairpinto: folds 
color_singleton: folds 
JeBoyDirk: folds 
MnnM150: folds 
dddocky: calls 100
FragileMemory: folds 
Duke Croix: checks 
*** FLOP *** [5c Jh 9d]
Duke Croix: checks 
dddocky: checks 
*** TURN *** [5c Jh 9d] [Kc]
Duke Croix: bets 400
dddocky: calls 400
*** RIVER *** [5c Jh 9d Kc] [Qd]
Duke Croix: checks 
dddocky: checks 
*** SHOW DOWN ***
Duke Croix: shows [9c Kd] (two pair, Kings and Nines)
dddocky: mucks hand 
Duke Croix collected 992 from pot
*** SUMMARY ***
Total pot 1050 | Rake 58 
Board [5c Jh 9d Kc Qd]
Seat 1: dddocky (button) mucked [4c Ac]
Seat 2: FragileMemory (small blind) folded before Flop
Seat 3: Duke Croix (big blind) showed [9c Kd] and won (992) with two pair, Kings and Nines
Seat 4: yairpinto folded before Flop (didn't bet)
Seat 6: color_singleton folded before Flop (didn't bet)
Seat 8: JeBoyDirk folded before Flop (didn't bet)
Seat 9: MnnM150 folded before Flop (didn't bet)



PokerStars Home Game Hand #218087969877: {Club #3225207}  Hold'em No Limit (50/100) - 2020/09/03 16:56:05 ET
Table 'fun gamez' 9-max (Play Money) Seat #2 is the button
Seat 1: dddocky (7672 in chips) 
Seat 2: FragileMemory (6294 in chips) 
Seat 3: Duke Croix (27212 in chips) 
Seat 4: yairpinto (3828 in chips) 
Seat 6: color_singleton (15665 in chips) 
Seat 8: JeBoyDirk (29399 in chips) 
Duke Croix: posts small blind 50
yairpinto: posts big blind 100
*** HOLE CARDS ***
Dealt to Duke Croix [Jh Kc]
color_singleton: folds 
JeBoyDirk: folds 
dddocky: calls 100
FragileMemory: folds 
Duke Croix: raises 300 to 400
yairpinto: folds 
dddocky: calls 300
*** FLOP *** [8s Ad Qc]
Duke Croix: checks 
dddocky: checks 
*** TURN *** [8s Ad Qc] [4h]
Duke Croix: bets 500
dddocky: folds 
Uncalled bet (500) returned to Duke Croix
Duke Croix collected 850 from pot
*** SUMMARY ***
Total pot 900 | Rake 50 
Board [8s Ad Qc 4h]
Seat 1: dddocky folded on the Turn
Seat 2: FragileMemory (button) folded before Flop (didn't bet)
Seat 3: Duke Croix (small blind) collected (850)
Seat 4: yairpinto (big blind) folded before Flop
Seat 6: color_singleton folded before Flop (didn't bet)
Seat 8: JeBoyDirk folded before Flop (didn't bet)



PokerStars Home Game Hand #218087979911: {Club #3225207}  Hold'em No Limit (50/100) - 2020/09/03 16:56:28 ET
Table 'fun gamez' 9-max (Play Money) Seat #3 is the button
Seat 1: dddocky (7272 in chips) 
Seat 2: FragileMemory (6294 in chips) 
Seat 3: Duke Croix (27662 in chips) 
Seat 4: yairpinto (3728 in chips) 
Seat 6: color_singleton (15665 in chips) 
Seat 8: JeBoyDirk (29399 in chips) 
yairpinto: posts small blind 50
color_singleton: posts big blind 100
*** HOLE CARDS ***
Dealt to Duke Croix [Js Jc]
JeBoyDirk: folds 
dddocky: calls 100
FragileMemory: folds 
Duke Croix: raises 300 to 400
yairpinto: folds 
color_singleton: calls 300
dddocky: calls 300
*** FLOP *** [Ad Ah 9h]
color_singleton: checks 
dddocky: checks 
Duke Croix: bets 700
color_singleton: folds 
dddocky: folds 
Uncalled bet (700) returned to Duke Croix
Duke Croix collected 1181 from pot
*** SUMMARY ***
Total pot 1250 | Rake 69 
Board [Ad Ah 9h]
Seat 1: dddocky folded on the Flop
Seat 2: FragileMemory folded before Flop (didn't bet)
Seat 3: Duke Croix (button) collected (1181)
Seat 4: yairpinto (small blind) folded before Flop
Seat 6: color_singleton (big blind) folded on the Flop
Seat 8: JeBoyDirk folded before Flop (didn't bet)



PokerStars Home Game Hand #218087992317: {Club #3225207}  Hold'em No Limit (50/100) - 2020/09/03 16:56:55 ET
Table 'fun gamez' 9-max (Play Money) Seat #4 is the button
Seat 1: dddocky (6872 in chips) 
Seat 2: FragileMemory (6294 in chips) 
Seat 3: Duke Croix (28443 in chips) 
Seat 4: yairpinto (3678 in chips) 
Seat 6: color_singleton (15265 in chips) 
Seat 8: JeBoyDirk (29399 in chips) 
color_singleton: posts small blind 50
JeBoyDirk: posts big blind 100
*** HOLE CARDS ***
Dealt to Duke Croix [5h 5c]
dddocky: calls 100
FragileMemory: folds 
Duke Croix: raises 300 to 400
yairpinto: calls 400
color_singleton: folds 
JeBoyDirk: folds 
dddocky: calls 300
*** FLOP *** [9s As 8c]
dddocky: checks 
Duke Croix: checks 
yairpinto: checks 
*** TURN *** [9s As 8c] [4s]
dddocky: checks 
Duke Croix: bets 700
yairpinto: folds 
dddocky: folds 
Uncalled bet (700) returned to Duke Croix
Duke Croix collected 1276 from pot
*** SUMMARY ***
Total pot 1350 | Rake 74 
Board [9s As 8c 4s]
Seat 1: dddocky folded on the Turn
Seat 2: FragileMemory folded before Flop (didn't bet)
Seat 3: Duke Croix collected (1276)
Seat 4: yairpinto (button) folded on the Turn
Seat 6: color_singleton (small blind) folded before Flop
Seat 8: JeBoyDirk (big blind) folded before Flop



PokerStars Home Game Hand #218088007094: {Club #3225207}  Hold'em No Limit (50/100) - 2020/09/03 16:57:28 ET
Table 'fun gamez' 9-max (Play Money) Seat #6 is the button
Seat 1: dddocky (6472 in chips) 
Seat 2: FragileMemory (6294 in chips) 
Seat 3: Duke Croix (29319 in chips) 
Seat 4: yairpinto (3278 in chips) 
Seat 6: color_singleton (15215 in chips) 
Seat 8: JeBoyDirk (29299 in chips) 
JeBoyDirk: posts small blind 50
dddocky: posts big blind 100
*** HOLE CARDS ***
Dealt to Duke Croix [6d 9h]
FragileMemory: calls 100
Duke Croix: folds 
yairpinto: folds 
color_singleton: folds 
JeBoyDirk: folds 
dddocky: checks 
*** FLOP *** [2s As 9c]
dddocky: checks 
FragileMemory: bets 100
dddocky: folds 
Uncalled bet (100) returned to FragileMemory
FragileMemory collected 236 from pot
FragileMemory: doesn't show hand 
*** SUMMARY ***
Total pot 250 | Rake 14 
Board [2s As 9c]
Seat 1: dddocky (big blind) folded on the Flop
Seat 2: FragileMemory collected (236)
Seat 3: Duke Croix folded before Flop (didn't bet)
Seat 4: yairpinto folded before Flop (didn't bet)
Seat 6: color_singleton (button) folded before Flop (didn't bet)
Seat 8: JeBoyDirk (small blind) folded before Flop



PokerStars Home Game Hand #218088015147: {Club #3225207}  Hold'em No Limit (50/100) - 2020/09/03 16:57:46 ET
Table 'fun gamez' 9-max (Play Money) Seat #8 is the button
Seat 1: dddocky (6372 in chips) 
Seat 2: FragileMemory (6430 in chips) 
Seat 3: Duke Croix (29319 in chips) 
Seat 4: yairpinto (3278 in chips) 
Seat 6: color_singleton (15215 in chips) 
Seat 8: JeBoyDirk (29249 in chips) 
dddocky: posts small blind 50
FragileMemory: posts big blind 100
*** HOLE CARDS ***
Dealt to Duke Croix [6c Qs]
Duke Croix: folds 
yairpinto: folds 
color_singleton: folds 
JeBoyDirk: calls 100
dddocky: folds 
FragileMemory: checks 
*** FLOP *** [Qc Td 5c]
FragileMemory: bets 100
JeBoyDirk: raises 100 to 200
FragileMemory: calls 100
*** TURN *** [Qc Td 5c] [Jh]
FragileMemory: checks 
JeBoyDirk: checks 
*** RIVER *** [Qc Td 5c Jh] [9h]
FragileMemory: checks 
JeBoyDirk: bets 300
FragileMemory: folds 
Uncalled bet (300) returned to JeBoyDirk
JeBoyDirk collected 614 from pot
*** SUMMARY ***
Total pot 650 | Rake 36 
Board [Qc Td 5c Jh 9h]
Seat 1: dddocky (small blind) folded before Flop
Seat 2: FragileMemory (big blind) folded on the River
Seat 3: Duke Croix folded before Flop (didn't bet)
Seat 4: yairpinto folded before Flop (didn't bet)
Seat 6: color_singleton folded before Flop (didn't bet)
Seat 8: JeBoyDirk (button) collected (614)



PokerStars Home Game Hand #218088031714: {Club #3225207}  Hold'em No Limit (50/100) - 2020/09/03 16:58:22 ET
Table 'fun gamez' 9-max (Play Money) Seat #1 is the button
Seat 1: dddocky (6322 in chips) 
Seat 2: FragileMemory (6130 in chips) 
Seat 3: Duke Croix (29319 in chips) 
Seat 4: yairpinto (3278 in chips) 
Seat 6: color_singleton (15215 in chips) 
Seat 8: JeBoyDirk (29563 in chips) 
FragileMemory: posts small blind 50
Duke Croix: posts big blind 100
*** HOLE CARDS ***
Dealt to Duke Croix [8s 4s]
yairpinto: folds 
color_singleton: folds 
JeBoyDirk: folds 
dddocky: folds 
FragileMemory: calls 50
Duke Croix: checks 
*** FLOP *** [Qh Qd 7h]
FragileMemory: checks 
Duke Croix: checks 
*** TURN *** [Qh Qd 7h] [3c]
FragileMemory: checks 
Duke Croix: checks 
*** RIVER *** [Qh Qd 7h 3c] [8d]
FragileMemory: bets 100
Duke Croix: raises 400 to 500
FragileMemory: calls 400
*** SHOW DOWN ***
Duke Croix: shows [8s 4s] (two pair, Queens and Eights)
FragileMemory: shows [Th 8c] (two pair, Queens and Eights - Ten kicker)
FragileMemory collected 1134 from pot
*** SUMMARY ***
Total pot 1200 | Rake 66 
Board [Qh Qd 7h 3c 8d]
Seat 1: dddocky (button) folded before Flop (didn't bet)
Seat 2: FragileMemory (small blind) showed [Th 8c] and won (1134) with two pair, Queens and Eights
Seat 3: Duke Croix (big blind) showed [8s 4s] and lost with two pair, Queens and Eights
Seat 4: yairpinto folded before Flop (didn't bet)
Seat 6: color_singleton folded before Flop (didn't bet)
Seat 8: JeBoyDirk folded before Flop (didn't bet)



PokerStars Home Game Hand #218088043556: {Club #3225207}  Hold'em No Limit (50/100) - 2020/09/03 16:58:49 ET
Table 'fun gamez' 9-max (Play Money) Seat #2 is the button
Seat 1: dddocky (6322 in chips) 
Seat 2: FragileMemory (6664 in chips) 
Seat 3: Duke Croix (28719 in chips) 
Seat 4: yairpinto (3278 in chips) 
Seat 6: color_singleton (15215 in chips) 
Seat 8: JeBoyDirk (29563 in chips) 
Duke Croix: posts small blind 50
yairpinto: posts big blind 100
*** HOLE CARDS ***
Dealt to Duke Croix [5d 4d]
color_singleton: folds 
JeBoyDirk: folds 
dddocky: calls 100
FragileMemory: calls 100
Duke Croix: raises 200 to 300
yairpinto: folds 
dddocky: calls 200
FragileMemory: calls 200
*** FLOP *** [Th 2h Qc]
Duke Croix: checks 
dddocky: checks 
FragileMemory: checks 
*** TURN *** [Th 2h Qc] [6h]
Duke Croix: bets 500
dddocky: calls 500
FragileMemory: folds 
*** RIVER *** [Th 2h Qc 6h] [Ks]
Duke Croix: checks 
dddocky: checks 
*** SHOW DOWN ***
Duke Croix: shows [5d 4d] (high card King)
dddocky: shows [Kd 6s] (two pair, Kings and Sixes)
dddocky collected 1890 from pot
*** SUMMARY ***
Total pot 2000 | Rake 110 
Board [Th 2h Qc 6h Ks]
Seat 1: dddocky showed [Kd 6s] and won (1890) with two pair, Kings and Sixes
Seat 2: FragileMemory (button) folded on the Turn
Seat 3: Duke Croix (small blind) showed [5d 4d] and lost with high card King
Seat 4: yairpinto (big blind) folded before Flop
Seat 6: color_singleton folded before Flop (didn't bet)
Seat 8: JeBoyDirk folded before Flop (didn't bet)



PokerStars Home Game Hand #218088060776: {Club #3225207}  Hold'em No Limit (50/100) - 2020/09/03 16:59:27 ET
Table 'fun gamez' 9-max (Play Money) Seat #3 is the button
Seat 1: dddocky (7412 in chips) 
Seat 2: FragileMemory (6364 in chips) 
Seat 3: Duke Croix (27919 in chips) 
Seat 4: yairpinto (3178 in chips) 
Seat 6: color_singleton (15215 in chips) 
Seat 8: JeBoyDirk (29563 in chips) 
Seat 9: MnnM150 (8274 in chips) 
yairpinto: posts small blind 50
color_singleton: posts big blind 100
MnnM150: posts small & big blinds 150
*** HOLE CARDS ***
Dealt to Duke Croix [2c Qc]
JeBoyDirk: folds 
MnnM150: checks 
dddocky: folds 
FragileMemory: calls 100
Duke Croix: folds 
yairpinto: calls 50
color_singleton: checks 
*** FLOP *** [Kh 5d As]
yairpinto: checks 
color_singleton: checks 
MnnM150: checks 
FragileMemory: bets 100
yairpinto: calls 100
color_singleton: folds 
MnnM150: folds 
*** TURN *** [Kh 5d As] [6c]
yairpinto: checks 
FragileMemory: bets 307
yairpinto: folds 
Uncalled bet (307) returned to FragileMemory
FragileMemory collected 614 from pot
FragileMemory: doesn't show hand 
*** SUMMARY ***
Total pot 650 | Rake 36 
Board [Kh 5d As 6c]
Seat 1: dddocky folded before Flop (didn't bet)
Seat 2: FragileMemory collected (614)
Seat 3: Duke Croix (button) folded before Flop (didn't bet)
Seat 4: yairpinto (small blind) folded on the Turn
Seat 6: color_singleton (big blind) folded on the Flop
Seat 8: JeBoyDirk folded before Flop (didn't bet)
Seat 9: MnnM150 folded on the Flop (didn't bet)



PokerStars Home Game Hand #218088081615: {Club #3225207}  Hold'em No Limit (50/100) - 2020/09/03 17:00:12 ET
Table 'fun gamez' 9-max (Play Money) Seat #4 is the button
Seat 1: dddocky (7412 in chips) 
Seat 2: FragileMemory (6778 in chips) 
Seat 3: Duke Croix (27919 in chips) 
Seat 4: yairpinto (2978 in chips) 
Seat 6: color_singleton (15115 in chips) 
Seat 8: JeBoyDirk (29563 in chips) 
Seat 9: MnnM150 (8124 in chips) 
color_singleton: posts small blind 50
JeBoyDirk: posts big blind 100
*** HOLE CARDS ***
Dealt to Duke Croix [7d 4d]
MnnM150: calls 100
dddocky: calls 100
FragileMemory: folds 
Duke Croix: folds 
yairpinto: calls 100
color_singleton: calls 50
JeBoyDirk: checks 
*** FLOP *** [Ac 5h 9c]
color_singleton: bets 236
JeBoyDirk: folds 
MnnM150: calls 236
dddocky: calls 236
yairpinto: folds 
*** TURN *** [Ac 5h 9c] [8c]
color_singleton: bets 1142
MnnM150: calls 1142
dddocky: folds 
*** RIVER *** [Ac 5h 9c 8c] [2d]
color_singleton: checks 
MnnM150: bets 3300
color_singleton: calls 3300
*** SHOW DOWN ***
MnnM150: shows [3c 5c] (a flush, Ace high)
color_singleton: shows [7c Qc] (a flush, Ace high - Queen higher)
color_singleton collected 9537 from pot
*** SUMMARY ***
Total pot 10092 | Rake 555 
Board [Ac 5h 9c 8c 2d]
Seat 1: dddocky folded on the Turn
Seat 2: FragileMemory folded before Flop (didn't bet)
Seat 3: Duke Croix folded before Flop (didn't bet)
Seat 4: yairpinto (button) folded on the Flop
Seat 6: color_singleton (small blind) showed [7c Qc] and won (9537) with a flush, Ace high
Seat 8: JeBoyDirk (big blind) folded on the Flop
Seat 9: MnnM150 showed [3c 5c] and lost with a flush, Ace high



PokerStars Home Game Hand #218088111235: {Club #3225207}  Hold'em No Limit (50/100) - 2020/09/03 17:01:10 ET
Table 'fun gamez' 9-max (Play Money) Seat #6 is the button
Seat 1: dddocky (7076 in chips) 
Seat 2: FragileMemory (6778 in chips) 
Seat 3: Duke Croix (27919 in chips) 
Seat 4: yairpinto (2878 in chips) 
Seat 6: color_singleton (19874 in chips) 
Seat 8: JeBoyDirk (29463 in chips) 
Seat 9: MnnM150 (3346 in chips) 
JeBoyDirk: posts small blind 50
MnnM150: posts big blind 100
*** HOLE CARDS ***
Dealt to Duke Croix [3s Ac]
dddocky: calls 100
FragileMemory: folds 
Duke Croix: raises 300 to 400
yairpinto: folds 
color_singleton: folds 
JeBoyDirk: folds 
MnnM150: calls 300
dddocky: calls 300
*** FLOP *** [Ad 3d 9s]
MnnM150: checks 
dddocky: checks 
Duke Croix: bets 600
MnnM150: folds 
dddocky: folds 
Uncalled bet (600) returned to Duke Croix
Duke Croix collected 1181 from pot
*** SUMMARY ***
Total pot 1250 | Rake 69 
Board [Ad 3d 9s]
Seat 1: dddocky folded on the Flop
Seat 2: FragileMemory folded before Flop (didn't bet)
Seat 3: Duke Croix collected (1181)
Seat 4: yairpinto folded before Flop (didn't bet)
Seat 6: color_singleton (button) folded before Flop (didn't bet)
Seat 8: JeBoyDirk (small blind) folded before Flop
Seat 9: MnnM150 (big blind) folded on the Flop



PokerStars Home Game Hand #218088141470: {Club #3225207}  Hold'em No Limit (50/100) - 2020/09/03 17:02:03 ET
Table 'fun gamez' 9-max (Play Money) Seat #8 is the button
Seat 1: dddocky (6676 in chips) 
Seat 2: FragileMemory (6778 in chips) 
Seat 3: Duke Croix (28700 in chips) 
Seat 4: yairpinto (2878 in chips) 
Seat 6: color_singleton (19874 in chips) 
Seat 8: JeBoyDirk (29413 in chips) 
Seat 9: MnnM150 (2946 in chips) 
MnnM150: posts small blind 50
dddocky: posts big blind 100
*** HOLE CARDS ***
Dealt to Duke Croix [9c 6h]
FragileMemory: folds 
Duke Croix: folds 
yairpinto: calls 100
color_singleton: folds 
JeBoyDirk: calls 100
MnnM150: folds 
dddocky: checks 
*** FLOP *** [9h Jd Ks]
dddocky: checks 
yairpinto: checks 
JeBoyDirk: checks 
*** TURN *** [9h Jd Ks] [7c]
dddocky: bets 100
yairpinto: raises 265 to 365
JeBoyDirk: folds 
dddocky: folds 
Uncalled bet (265) returned to yairpinto
yairpinto collected 520 from pot
yairpinto: doesn't show hand 
*** SUMMARY ***
Total pot 550 | Rake 30 
Board [9h Jd Ks 7c]
Seat 1: dddocky (big blind) folded on the Turn
Seat 2: FragileMemory folded before Flop (didn't bet)
Seat 3: Duke Croix folded before Flop (didn't bet)
Seat 4: yairpinto collected (520)
Seat 6: color_singleton folded before Flop (didn't bet)
Seat 8: JeBoyDirk (button) folded on the Turn
Seat 9: MnnM150 (small blind) folded before Flop



PokerStars Home Game Hand #218088172984: {Club #3225207}  Hold'em No Limit (50/100) - 2020/09/03 17:02:55 ET
Table 'fun gamez' 9-max (Play Money) Seat #9 is the button
Seat 1: dddocky (6476 in chips) 
Seat 2: FragileMemory (6778 in chips) 
Seat 3: Duke Croix (28700 in chips) 
Seat 4: yairpinto (3198 in chips) 
Seat 6: color_singleton (19874 in chips) 
Seat 8: JeBoyDirk (29313 in chips) 
Seat 9: MnnM150 (2896 in chips) 
dddocky: posts small blind 50
FragileMemory: posts big blind 100
*** HOLE CARDS ***
Dealt to Duke Croix [Ts 7s]
Duke Croix: folds 
yairpinto: calls 100
color_singleton: folds 
JeBoyDirk: calls 100
MnnM150: folds 
dddocky: calls 50
FragileMemory: checks 
*** FLOP *** [5d 6c 2d]
dddocky: checks 
FragileMemory: checks 
yairpinto: checks 
JeBoyDirk: checks 
*** TURN *** [5d 6c 2d] [4c]
dddocky: checks 
FragileMemory: checks 
yairpinto: checks 
JeBoyDirk: checks 
*** RIVER *** [5d 6c 2d 4c] [4d]
dddocky: checks 
FragileMemory: checks 
yairpinto: checks 
JeBoyDirk: bets 100
dddocky: calls 100
FragileMemory: folds 
yairpinto: folds 
*** SHOW DOWN ***
JeBoyDirk: shows [Ac Qc] (a pair of Fours)
dddocky: shows [Kh Ah] (a pair of Fours - Ace+King kicker)
dddocky collected 567 from pot
*** SUMMARY ***
Total pot 600 | Rake 33 
Board [5d 6c 2d 4c 4d]
Seat 1: dddocky (small blind) showed [Kh Ah] and won (567) with a pair of Fours
Seat 2: FragileMemory (big blind) folded on the River
Seat 3: Duke Croix folded before Flop (didn't bet)
Seat 4: yairpinto folded on the River
Seat 6: color_singleton folded before Flop (didn't bet)
Seat 8: JeBoyDirk showed [Ac Qc] and lost with a pair of Fours
Seat 9: MnnM150 (button) folded before Flop (didn't bet)



PokerStars Home Game Hand #218088203636: {Club #3225207}  Hold'em No Limit (50/100) - 2020/09/03 17:03:39 ET
Table 'fun gamez' 9-max (Play Money) Seat #1 is the button
Seat 1: dddocky (6843 in chips) 
Seat 2: FragileMemory (6678 in chips) 
Seat 3: Duke Croix (28700 in chips) 
Seat 4: yairpinto (3098 in chips) 
Seat 6: color_singleton (19874 in chips) 
Seat 8: JeBoyDirk (29113 in chips) 
Seat 9: MnnM150 (2896 in chips) 
FragileMemory: posts small blind 50
Duke Croix: posts big blind 100
*** HOLE CARDS ***
Dealt to Duke Croix [3d 8s]
yairpinto: folds 
color_singleton: raises 200 to 300
JeBoyDirk: folds 
MnnM150: folds 
dddocky: calls 300
FragileMemory: folds 
Duke Croix: folds 
*** FLOP *** [8h 8c Qh]
color_singleton: bets 354
dddocky: folds 
Uncalled bet (354) returned to color_singleton
color_singleton collected 709 from pot
color_singleton: doesn't show hand 
*** SUMMARY ***
Total pot 750 | Rake 41 
Board [8h 8c Qh]
Seat 1: dddocky (button) folded on the Flop
Seat 2: FragileMemory (small blind) folded before Flop
Seat 3: Duke Croix (big blind) folded before Flop
Seat 4: yairpinto folded before Flop (didn't bet)
Seat 6: color_singleton collected (709)
Seat 8: JeBoyDirk folded before Flop (didn't bet)
Seat 9: MnnM150 folded before Flop (didn't bet)



PokerStars Home Game Hand #218088218702: {Club #3225207}  Hold'em No Limit (50/100) - 2020/09/03 17:04:04 ET
Table 'fun gamez' 9-max (Play Money) Seat #2 is the button
Seat 1: dddocky (6543 in chips) 
Seat 2: FragileMemory (6628 in chips) 
Seat 3: Duke Croix (28600 in chips) 
Seat 4: yairpinto (3098 in chips) 
Seat 6: color_singleton (20283 in chips) 
Seat 8: JeBoyDirk (29113 in chips) 
Seat 9: MnnM150 (2896 in chips) 
Duke Croix: posts small blind 50
yairpinto: posts big blind 100
*** HOLE CARDS ***
Dealt to Duke Croix [Ks Jh]
color_singleton: folds 
JeBoyDirk: folds 
MnnM150: folds 
dddocky: folds 
FragileMemory: raises 100 to 200
Duke Croix: raises 300 to 500
yairpinto has timed out
yairpinto: folds 
FragileMemory: calls 300
*** FLOP *** [6d 4c 9h]
Duke Croix: checks 
FragileMemory: bets 1039
Duke Croix: folds 
Uncalled bet (1039) returned to FragileMemory
FragileMemory collected 1039 from pot
FragileMemory: doesn't show hand 
*** SUMMARY ***
Total pot 1100 | Rake 61 
Board [6d 4c 9h]
Seat 1: dddocky folded before Flop (didn't bet)
Seat 2: FragileMemory (button) collected (1039)
Seat 3: Duke Croix (small blind) folded on the Flop
Seat 4: yairpinto (big blind) folded before Flop
Seat 6: color_singleton folded before Flop (didn't bet)
Seat 8: JeBoyDirk folded before Flop (didn't bet)
Seat 9: MnnM150 folded before Flop (didn't bet)



PokerStars Home Game Hand #218088252803: {Club #3225207}  Hold'em No Limit (50/100) - 2020/09/03 17:04:59 ET
Table 'fun gamez' 9-max (Play Money) Seat #3 is the button
Seat 1: dddocky (6543 in chips) 
Seat 2: FragileMemory (7167 in chips) 
Seat 3: Duke Croix (28100 in chips) 
Seat 6: color_singleton (20283 in chips) 
Seat 8: JeBoyDirk (29113 in chips) 
Seat 9: MnnM150 (2896 in chips) 
color_singleton: posts small blind 50
JeBoyDirk: posts big blind 100
*** HOLE CARDS ***
Dealt to Duke Croix [5h 3s]
MnnM150: folds 
dddocky: folds 
FragileMemory: folds 
Duke Croix: folds 
color_singleton: raises 200 to 300
JeBoyDirk: calls 200
*** FLOP *** [4h As 9h]
color_singleton: bets 283
JeBoyDirk: raises 317 to 600
color_singleton: folds 
Uncalled bet (317) returned to JeBoyDirk
JeBoyDirk collected 1102 from pot
*** SUMMARY ***
Total pot 1166 | Rake 64 
Board [4h As 9h]
Seat 1: dddocky folded before Flop (didn't bet)
Seat 2: FragileMemory folded before Flop (didn't bet)
Seat 3: Duke Croix (button) folded before Flop (didn't bet)
Seat 6: color_singleton (small blind) folded on the Flop
Seat 8: JeBoyDirk (big blind) collected (1102)
Seat 9: MnnM150 folded before Flop (didn't bet)



PokerStars Home Game Hand #218088278845: {Club #3225207}  Hold'em No Limit (50/100) - 2020/09/03 17:05:41 ET
Table 'fun gamez' 9-max (Play Money) Seat #6 is the button
Seat 1: dddocky (6543 in chips) 
Seat 2: FragileMemory (7167 in chips) 
Seat 3: Duke Croix (28100 in chips) 
Seat 4: yairpinto (2998 in chips) 
Seat 6: color_singleton (19700 in chips) 
Seat 8: JeBoyDirk (29632 in chips) 
Seat 9: MnnM150 (2896 in chips) 
JeBoyDirk: posts small blind 50
MnnM150: posts big blind 100
yairpinto: posts small blind 50
*** HOLE CARDS ***
Dealt to Duke Croix [7s 4d]
dddocky: calls 100
FragileMemory: folds 
Duke Croix: folds 
yairpinto: folds 
color_singleton: raises 100 to 200
JeBoyDirk: calls 150
MnnM150: calls 100
dddocky: folds 
*** FLOP *** [2c Kh 9s]
JeBoyDirk: checks 
MnnM150: checks 
color_singleton: checks 
*** TURN *** [2c Kh 9s] [Kc]
JeBoyDirk: checks 
MnnM150: bets 354
color_singleton: calls 354
JeBoyDirk: folds 
*** RIVER *** [2c Kh 9s Kc] [Td]
MnnM150: bets 689
color_singleton: calls 689
*** SHOW DOWN ***
MnnM150: shows [6c Ks] (three of a kind, Kings)
color_singleton: mucks hand 
MnnM150 collected 2680 from pot
*** SUMMARY ***
Total pot 2836 | Rake 156 
Board [2c Kh 9s Kc Td]
Seat 1: dddocky folded before Flop
Seat 2: FragileMemory folded before Flop (didn't bet)
Seat 3: Duke Croix folded before Flop (didn't bet)
Seat 4: yairpinto folded before Flop (didn't bet)
Seat 6: color_singleton (button) mucked [Tc Qc]
Seat 8: JeBoyDirk (small blind) folded on the Turn
Seat 9: MnnM150 (big blind) showed [6c Ks] and won (2680) with three of a kind, Kings



PokerStars Home Game Hand #218088308810: {Club #3225207}  Hold'em No Limit (50/100) - 2020/09/03 17:06:30 ET
Table 'fun gamez' 9-max (Play Money) Seat #8 is the button
Seat 1: dddocky (6443 in chips) 
Seat 2: FragileMemory (7167 in chips) 
Seat 3: Duke Croix (28100 in chips) 
Seat 4: yairpinto (2948 in chips) 
Seat 6: color_singleton (18457 in chips) 
Seat 8: JeBoyDirk (29432 in chips) 
Seat 9: MnnM150 (4333 in chips) 
MnnM150: posts small blind 50
dddocky: posts big blind 100
*** HOLE CARDS ***
Dealt to Duke Croix [6c Qc]
FragileMemory: folds 
Duke Croix: folds 
yairpinto: folds 
color_singleton: folds 
JeBoyDirk: folds 
MnnM150: calls 50
dddocky: checks 
*** FLOP *** [Kd 6d 2c]
MnnM150: checks 
dddocky: checks 
*** TURN *** [Kd 6d 2c] [3h]
MnnM150: bets 100
dddocky: calls 100
*** RIVER *** [Kd 6d 2c 3h] [Kh]
MnnM150: bets 378
dddocky: folds 
Uncalled bet (378) returned to MnnM150
MnnM150 collected 378 from pot
*** SUMMARY ***
Total pot 400 | Rake 22 
Board [Kd 6d 2c 3h Kh]
Seat 1: dddocky (big blind) folded on the River
Seat 2: FragileMemory folded before Flop (didn't bet)
Seat 3: Duke Croix folded before Flop (didn't bet)
Seat 4: yairpinto folded before Flop (didn't bet)
Seat 6: color_singleton folded before Flop (didn't bet)
Seat 8: JeBoyDirk (button) folded before Flop (didn't bet)
Seat 9: MnnM150 (small blind) collected (378)



PokerStars Home Game Hand #218088328282: {Club #3225207}  Hold'em No Limit (50/100) - 2020/09/03 17:07:01 ET
Table 'fun gamez' 9-max (Play Money) Seat #9 is the button
Seat 1: dddocky (6243 in chips) 
Seat 2: FragileMemory (7167 in chips) 
Seat 3: Duke Croix (28100 in chips) 
Seat 4: yairpinto (2948 in chips) 
Seat 6: color_singleton (18457 in chips) 
Seat 8: JeBoyDirk (29432 in chips) 
Seat 9: MnnM150 (4511 in chips) 
dddocky: posts small blind 50
FragileMemory: posts big blind 100
*** HOLE CARDS ***
Dealt to Duke Croix [3h 2d]
Duke Croix: folds 
yairpinto: folds 
color_singleton: folds 
JeBoyDirk: folds 
MnnM150: calls 100
dddocky: calls 50
FragileMemory: checks 
*** FLOP *** [7s As 6s]
dddocky: checks 
FragileMemory: checks 
MnnM150: checks 
*** TURN *** [7s As 6s] [Qs]
dddocky: bets 141
FragileMemory: folds 
MnnM150: folds 
Uncalled bet (141) returned to dddocky
dddocky collected 283 from pot
dddocky: doesn't show hand 
*** SUMMARY ***
Total pot 300 | Rake 17 
Board [7s As 6s Qs]
Seat 1: dddocky (small blind) collected (283)
Seat 2: FragileMemory (big blind) folded on the Turn
Seat 3: Duke Croix folded before Flop (didn't bet)
Seat 4: yairpinto folded before Flop (didn't bet)
Seat 6: color_singleton folded before Flop (didn't bet)
Seat 8: JeBoyDirk folded before Flop (didn't bet)
Seat 9: MnnM150 (button) folded on the Turn



PokerStars Home Game Hand #218088354506: {Club #3225207}  Hold'em No Limit (50/100) - 2020/09/03 17:07:45 ET
Table 'fun gamez' 9-max (Play Money) Seat #1 is the button
Seat 1: dddocky (6426 in chips) 
Seat 2: FragileMemory (7067 in chips) 
Seat 3: Duke Croix (28100 in chips) 
Seat 4: yairpinto (2948 in chips) 
Seat 6: color_singleton (18457 in chips) 
Seat 8: JeBoyDirk (29432 in chips) 
Seat 9: MnnM150 (4411 in chips) 
FragileMemory: posts small blind 50
Duke Croix: posts big blind 100
*** HOLE CARDS ***
Dealt to Duke Croix [7s Jd]
yairpinto: folds 
color_singleton has timed out
color_singleton: folds 
JeBoyDirk: folds 
MnnM150: calls 100
dddocky: calls 100
FragileMemory: calls 50
Duke Croix: checks 
*** FLOP *** [2h Tc 3d]
FragileMemory: bets 100
Duke Croix has timed out
Duke Croix: folds 
MnnM150: calls 100
dddocky: calls 100
*** TURN *** [2h Tc 3d] [Ad]
FragileMemory: checks 
MnnM150: checks 
dddocky: checks 
*** RIVER *** [2h Tc 3d Ad] [Qh]
FragileMemory: bets 330
MnnM150: folds 
dddocky: folds 
Uncalled bet (330) returned to FragileMemory
FragileMemory collected 661 from pot
FragileMemory: doesn't show hand 
*** SUMMARY ***
Total pot 700 | Rake 39 
Board [2h Tc 3d Ad Qh]
Seat 1: dddocky (button) folded on the River
Seat 2: FragileMemory (small blind) collected (661)
Seat 3: Duke Croix (big blind) folded on the Flop
Seat 4: yairpinto folded before Flop (didn't bet)
Seat 6: color_singleton folded before Flop (didn't bet)
Seat 8: JeBoyDirk folded before Flop (didn't bet)
Seat 9: MnnM150 folded on the River



PokerStars Home Game Hand #218088403104: {Club #3225207}  Hold'em No Limit (50/100) - 2020/09/03 17:09:04 ET
Table 'fun gamez' 9-max (Play Money) Seat #2 is the button
Seat 1: dddocky (6226 in chips) 
Seat 2: FragileMemory (7528 in chips) 
Seat 3: Duke Croix (28000 in chips) 
Seat 4: yairpinto (2948 in chips) 
Seat 6: color_singleton (18457 in chips) 
Seat 8: JeBoyDirk (29432 in chips) 
Seat 9: MnnM150 (4211 in chips) 
Duke Croix: posts small blind 50
yairpinto: posts big blind 100
*** HOLE CARDS ***
Dealt to Duke Croix [Kh 5d]
color_singleton: folds 
JeBoyDirk: folds 
MnnM150: folds 
dddocky: folds 
FragileMemory: folds 
Duke Croix: calls 50
yairpinto: checks 
*** FLOP *** [7s 5c Jd]
Duke Croix: bets 200
yairpinto: calls 200
*** TURN *** [7s 5c Jd] [Kc]
Duke Croix: bets 400
yairpinto: folds 
Uncalled bet (400) returned to Duke Croix
Duke Croix collected 567 from pot
*** SUMMARY ***
Total pot 600 | Rake 33 
Board [7s 5c Jd Kc]
Seat 1: dddocky folded before Flop (didn't bet)
Seat 2: FragileMemory (button) folded before Flop (didn't bet)
Seat 3: Duke Croix (small blind) collected (567)
Seat 4: yairpinto (big blind) folded on the Turn
Seat 6: color_singleton folded before Flop (didn't bet)
Seat 8: JeBoyDirk folded before Flop (didn't bet)
Seat 9: MnnM150 folded before Flop (didn't bet)



PokerStars Home Game Hand #218088424345: {Club #3225207}  Hold'em No Limit (50/100) - 2020/09/03 17:09:39 ET
Table 'fun gamez' 9-max (Play Money) Seat #3 is the button
Seat 1: dddocky (6226 in chips) 
Seat 2: FragileMemory (7528 in chips) 
Seat 3: Duke Croix (28267 in chips) 
Seat 4: yairpinto (2648 in chips) 
Seat 6: color_singleton (18457 in chips) 
Seat 8: JeBoyDirk (29432 in chips) 
Seat 9: MnnM150 (4211 in chips) 
yairpinto: posts small blind 50
color_singleton: posts big blind 100
*** HOLE CARDS ***
Dealt to Duke Croix [6c Qd]
JeBoyDirk: folds 
MnnM150: calls 100
dddocky: calls 100
FragileMemory: calls 100
Duke Croix: folds 
yairpinto: calls 50
color_singleton: checks 
*** FLOP *** [5h Kh Qs]
yairpinto: checks 
color_singleton: checks 
MnnM150: checks 
dddocky: checks 
FragileMemory: checks 
*** TURN *** [5h Kh Qs] [Qh]
yairpinto: checks 
color_singleton: checks 
MnnM150: checks 
dddocky: checks 
FragileMemory: checks 
*** RIVER *** [5h Kh Qs Qh] [9s]
yairpinto: checks 
color_singleton: checks 
MnnM150: checks 
dddocky: checks 
FragileMemory: checks 
*** SHOW DOWN ***
yairpinto: shows [Js 6d] (a pair of Queens)
color_singleton: shows [2d 2h] (two pair, Queens and Deuces)
MnnM150: mucks hand 
dddocky: mucks hand 
FragileMemory: mucks hand 
color_singleton collected 472 from pot
*** SUMMARY ***
Total pot 500 | Rake 28 
Board [5h Kh Qs Qh 9s]
Seat 1: dddocky mucked [3s 4s]
Seat 2: FragileMemory mucked [3h Ac]
Seat 3: Duke Croix (button) folded before Flop (didn't bet)
Seat 4: yairpinto (small blind) showed [Js 6d] and lost with a pair of Queens
Seat 6: color_singleton (big blind) showed [2d 2h] and won (472) with two pair, Queens and Deuces
Seat 8: JeBoyDirk folded before Flop (didn't bet)
Seat 9: MnnM150 mucked [Ad 2s]



PokerStars Home Game Hand #218088457621: {Club #3225207}  Hold'em No Limit (50/100) - 2020/09/03 17:10:34 ET
Table 'fun gamez' 9-max (Play Money) Seat #4 is the button
Seat 1: dddocky (6126 in chips) 
Seat 2: FragileMemory (7428 in chips) 
Seat 3: Duke Croix (28267 in chips) 
Seat 4: yairpinto (2548 in chips) 
Seat 6: color_singleton (18829 in chips) 
Seat 8: JeBoyDirk (29432 in chips) 
Seat 9: MnnM150 (4111 in chips) 
color_singleton: posts small blind 50
JeBoyDirk: posts big blind 100
*** HOLE CARDS ***
Dealt to Duke Croix [3d Th]
MnnM150: folds 
dddocky: calls 100
FragileMemory: calls 100
Duke Croix: folds 
yairpinto: folds 
color_singleton: calls 50
JeBoyDirk: checks 
*** FLOP *** [Ad 6s 4h]
color_singleton: bets 189
JeBoyDirk: folds 
dddocky: folds 
FragileMemory: folds 
Uncalled bet (189) returned to color_singleton
color_singleton collected 378 from pot
color_singleton: doesn't show hand 
*** SUMMARY ***
Total pot 400 | Rake 22 
Board [Ad 6s 4h]
Seat 1: dddocky folded on the Flop
Seat 2: FragileMemory folded on the Flop
Seat 3: Duke Croix folded before Flop (didn't bet)
Seat 4: yairpinto (button) folded before Flop (didn't bet)
Seat 6: color_singleton (small blind) collected (378)
Seat 8: JeBoyDirk (big blind) folded on the Flop
Seat 9: MnnM150 folded before Flop (didn't bet)



PokerStars Home Game Hand #218088476699: {Club #3225207}  Hold'em No Limit (50/100) - 2020/09/03 17:11:05 ET
Table 'fun gamez' 9-max (Play Money) Seat #6 is the button
Seat 1: dddocky (6026 in chips) 
Seat 2: FragileMemory (7328 in chips) 
Seat 3: Duke Croix (28267 in chips) 
Seat 4: yairpinto (2548 in chips) 
Seat 6: color_singleton (19107 in chips) 
Seat 8: JeBoyDirk (29332 in chips) 
Seat 9: MnnM150 (4111 in chips) 
JeBoyDirk: posts small blind 50
MnnM150: posts big blind 100
*** HOLE CARDS ***
Dealt to Duke Croix [Qs 8h]
dddocky: calls 100
FragileMemory: calls 100
Duke Croix: folds 
yairpinto: folds 
color_singleton: raises 100 to 200
JeBoyDirk: folds 
MnnM150: folds 
dddocky: calls 100
FragileMemory: calls 100
*** FLOP *** [2c Qd 9s]
dddocky: checks 
FragileMemory: checks 
color_singleton: bets 354
dddocky: folds 
FragileMemory: folds 
Uncalled bet (354) returned to color_singleton
color_singleton collected 709 from pot
color_singleton: doesn't show hand 
*** SUMMARY ***
Total pot 750 | Rake 41 
Board [2c Qd 9s]
Seat 1: dddocky folded on the Flop
Seat 2: FragileMemory folded on the Flop
Seat 3: Duke Croix folded before Flop (didn't bet)
Seat 4: yairpinto folded before Flop (didn't bet)
Seat 6: color_singleton (button) collected (709)
Seat 8: JeBoyDirk (small blind) folded before Flop
Seat 9: MnnM150 (big blind) folded before Flop



PokerStars Home Game Hand #218088499019: {Club #3225207}  Hold'em No Limit (50/100) - 2020/09/03 17:11:42 ET
Table 'fun gamez' 9-max (Play Money) Seat #8 is the button
Seat 1: dddocky (5826 in chips) 
Seat 2: FragileMemory (7128 in chips) 
Seat 3: Duke Croix (28267 in chips) 
Seat 4: yairpinto (2548 in chips) 
Seat 6: color_singleton (19616 in chips) 
Seat 8: JeBoyDirk (29282 in chips) 
Seat 9: MnnM150 (4011 in chips) 
MnnM150: posts small blind 50
dddocky: posts big blind 100
*** HOLE CARDS ***
Dealt to Duke Croix [Js 5s]
FragileMemory: calls 100
Duke Croix: folds 
yairpinto: calls 100
color_singleton: calls 100
JeBoyDirk: folds 
MnnM150: folds 
dddocky: checks 
*** FLOP *** [5c 3c 2s]
dddocky: checks 
FragileMemory: checks 
yairpinto: checks 
color_singleton: checks 
*** TURN *** [5c 3c 2s] [Qh]
dddocky: checks 
FragileMemory: checks 
yairpinto: bets 212
color_singleton: folds 
dddocky: folds 
FragileMemory: folds 
Uncalled bet (212) returned to yairpinto
yairpinto collected 425 from pot
yairpinto: doesn't show hand 
*** SUMMARY ***
Total pot 450 | Rake 25 
Board [5c 3c 2s Qh]
Seat 1: dddocky (big blind) folded on the Turn
Seat 2: FragileMemory folded on the Turn
Seat 3: Duke Croix folded before Flop (didn't bet)
Seat 4: yairpinto collected (425)
Seat 6: color_singleton folded on the Turn
Seat 8: JeBoyDirk (button) folded before Flop (didn't bet)
Seat 9: MnnM150 (small blind) folded before Flop



PokerStars Home Game Hand #218088520892: {Club #3225207}  Hold'em No Limit (50/100) - 2020/09/03 17:12:18 ET
Table 'fun gamez' 9-max (Play Money) Seat #9 is the button
Seat 1: dddocky (5726 in chips) 
Seat 2: FragileMemory (7028 in chips) 
Seat 3: Duke Croix (28267 in chips) 
Seat 4: yairpinto (2873 in chips) 
Seat 6: color_singleton (19516 in chips) 
Seat 8: JeBoyDirk (29282 in chips) 
Seat 9: MnnM150 (3961 in chips) 
dddocky: posts small blind 50
FragileMemory: posts big blind 100
*** HOLE CARDS ***
Dealt to Duke Croix [Ah Js]
Duke Croix: raises 300 to 400
yairpinto: folds 
color_singleton: folds 
JeBoyDirk: folds 
MnnM150: folds 
dddocky: folds 
FragileMemory: calls 300
*** FLOP *** [Jc 4h 8h]
FragileMemory: checks 
Duke Croix: bets 500
FragileMemory: folds 
Uncalled bet (500) returned to Duke Croix
Duke Croix collected 803 from pot
*** SUMMARY ***
Total pot 850 | Rake 47 
Board [Jc 4h 8h]
Seat 1: dddocky (small blind) folded before Flop
Seat 2: FragileMemory (big blind) folded on the Flop
Seat 3: Duke Croix collected (803)
Seat 4: yairpinto folded before Flop (didn't bet)
Seat 6: color_singleton folded before Flop (didn't bet)
Seat 8: JeBoyDirk folded before Flop (didn't bet)
Seat 9: MnnM150 (button) folded before Flop (didn't bet)



PokerStars Home Game Hand #218088535357: {Club #3225207}  Hold'em No Limit (50/100) - 2020/09/03 17:12:42 ET
Table 'fun gamez' 9-max (Play Money) Seat #1 is the button
Seat 1: dddocky (5676 in chips) 
Seat 2: FragileMemory (6628 in chips) 
Seat 3: Duke Croix (28670 in chips) 
Seat 4: yairpinto (2873 in chips) 
Seat 6: color_singleton (19516 in chips) 
Seat 8: JeBoyDirk (29282 in chips) 
Seat 9: MnnM150 (3961 in chips) 
FragileMemory: posts small blind 50
Duke Croix: posts big blind 100
*** HOLE CARDS ***
Dealt to Duke Croix [2c 5s]
yairpinto: folds 
color_singleton: folds 
JeBoyDirk: folds 
MnnM150: calls 100
dddocky: folds 
FragileMemory: folds 
Duke Croix: raises 300 to 400
MnnM150: folds 
Uncalled bet (300) returned to Duke Croix
Duke Croix collected 250 from pot
*** SUMMARY ***
Total pot 250 | Rake 0 
Seat 1: dddocky (button) folded before Flop (didn't bet)
Seat 2: FragileMemory (small blind) folded before Flop
Seat 3: Duke Croix (big blind) collected (250)
Seat 4: yairpinto folded before Flop (didn't bet)
Seat 6: color_singleton folded before Flop (didn't bet)
Seat 8: JeBoyDirk folded before Flop (didn't bet)
Seat 9: MnnM150 folded before Flop



PokerStars Home Game Hand #218088547676: {Club #3225207}  Hold'em No Limit (50/100) - 2020/09/03 17:13:02 ET
Table 'fun gamez' 9-max (Play Money) Seat #2 is the button
Seat 1: dddocky (5676 in chips) 
Seat 2: FragileMemory (6578 in chips) 
Seat 3: Duke Croix (28820 in chips) 
Seat 4: yairpinto (2873 in chips) 
Seat 6: color_singleton (19516 in chips) 
Seat 8: JeBoyDirk (29282 in chips) 
Seat 9: MnnM150 (3861 in chips) 
Duke Croix: posts small blind 50
yairpinto: posts big blind 100
*** HOLE CARDS ***
Dealt to Duke Croix [4h 9h]
color_singleton: raises 100 to 200
JeBoyDirk: folds 
MnnM150: folds 
dddocky: calls 200
FragileMemory: folds 
Duke Croix: calls 150
yairpinto: calls 100
*** FLOP *** [8s 2c 5h]
Duke Croix: checks 
yairpinto: checks 
color_singleton: checks 
dddocky: checks 
*** TURN *** [8s 2c 5h] [Td]
Duke Croix: checks 
yairpinto: checks 
color_singleton: bets 378
dddocky: folds 
Duke Croix: folds 
yairpinto: folds 
Uncalled bet (378) returned to color_singleton
color_singleton collected 756 from pot
color_singleton: doesn't show hand 
*** SUMMARY ***
Total pot 800 | Rake 44 
Board [8s 2c 5h Td]
Seat 1: dddocky folded on the Turn
Seat 2: FragileMemory (button) folded before Flop (didn't bet)
Seat 3: Duke Croix (small blind) folded on the Turn
Seat 4: yairpinto (big blind) folded on the Turn
Seat 6: color_singleton collected (756)
Seat 8: JeBoyDirk folded before Flop (didn't bet)
Seat 9: MnnM150 folded before Flop (didn't bet)



PokerStars Home Game Hand #218088573170: {Club #3225207}  Hold'em No Limit (50/100) - 2020/09/03 17:13:44 ET
Table 'fun gamez' 9-max (Play Money) Seat #3 is the button
Seat 1: dddocky (5476 in chips) 
Seat 2: FragileMemory (6578 in chips) 
Seat 3: Duke Croix (28620 in chips) 
Seat 4: yairpinto (2673 in chips) 
Seat 6: color_singleton (20072 in chips) 
Seat 8: JeBoyDirk (29282 in chips) 
Seat 9: MnnM150 (3861 in chips) 
yairpinto: posts small blind 50
color_singleton: posts big blind 100
*** HOLE CARDS ***
Dealt to Duke Croix [5h 8c]
JeBoyDirk: folds 
MnnM150: folds 
dddocky: calls 100
FragileMemory: folds 
Duke Croix: folds 
yairpinto: calls 50
color_singleton: checks 
*** FLOP *** [7h 9h Kh]
yairpinto: bets 141
color_singleton: folds 
dddocky: folds 
Uncalled bet (141) returned to yairpinto
yairpinto collected 283 from pot
yairpinto: doesn't show hand 
*** SUMMARY ***
Total pot 300 | Rake 17 
Board [7h 9h Kh]
Seat 1: dddocky folded on the Flop
Seat 2: FragileMemory folded before Flop (didn't bet)
Seat 3: Duke Croix (button) folded before Flop (didn't bet)
Seat 4: yairpinto (small blind) collected (283)
Seat 6: color_singleton (big blind) folded on the Flop
Seat 8: JeBoyDirk folded before Flop (didn't bet)
Seat 9: MnnM150 folded before Flop (didn't bet)



PokerStars Home Game Hand #218088588292: {Club #3225207}  Hold'em No Limit (50/100) - 2020/09/03 17:14:10 ET
Table 'fun gamez' 9-max (Play Money) Seat #4 is the button
Seat 1: dddocky (5376 in chips) 
Seat 2: FragileMemory (6578 in chips) 
Seat 3: Duke Croix (28620 in chips) 
Seat 4: yairpinto (2856 in chips) 
Seat 6: color_singleton (19972 in chips) 
Seat 8: JeBoyDirk (29282 in chips) 
Seat 9: MnnM150 (3861 in chips) 
color_singleton: posts small blind 50
JeBoyDirk: posts big blind 100
*** HOLE CARDS ***
Dealt to Duke Croix [Tc 7s]
MnnM150: calls 100
dddocky: folds 
FragileMemory: calls 100
Duke Croix: folds 
yairpinto: folds 
color_singleton: calls 50
JeBoyDirk: checks 
*** FLOP *** [9c 2h 8h]
color_singleton: checks 
JeBoyDirk: checks 
MnnM150: checks 
FragileMemory: checks 
*** TURN *** [9c 2h 8h] [Qh]
color_singleton: bets 189
JeBoyDirk: folds 
MnnM150: folds 
FragileMemory: calls 189
*** RIVER *** [9c 2h 8h Qh] [5h]
color_singleton: checks 
FragileMemory: checks 
*** SHOW DOWN ***
color_singleton: shows [Jc 5s] (a pair of Fives)
FragileMemory: shows [8d Ac] (a pair of Eights)
FragileMemory collected 735 from pot
*** SUMMARY ***
Total pot 778 | Rake 43 
Board [9c 2h 8h Qh 5h]
Seat 1: dddocky folded before Flop (didn't bet)
Seat 2: FragileMemory showed [8d Ac] and won (735) with a pair of Eights
Seat 3: Duke Croix folded before Flop (didn't bet)
Seat 4: yairpinto (button) folded before Flop (didn't bet)
Seat 6: color_singleton (small blind) showed [Jc 5s] and lost with a pair of Fives
Seat 8: JeBoyDirk (big blind) folded on the Turn
Seat 9: MnnM150 folded on the Turn



PokerStars Home Game Hand #218088615235: {Club #3225207}  Hold'em No Limit (50/100) - 2020/09/03 17:14:55 ET
Table 'fun gamez' 9-max (Play Money) Seat #6 is the button
Seat 1: dddocky (5376 in chips) 
Seat 2: FragileMemory (7024 in chips) 
Seat 3: Duke Croix (28620 in chips) 
Seat 4: yairpinto (2856 in chips) 
Seat 6: color_singleton (19683 in chips) 
Seat 8: JeBoyDirk (29182 in chips) 
Seat 9: MnnM150 (3761 in chips) 
JeBoyDirk: posts small blind 50
MnnM150: posts big blind 100
*** HOLE CARDS ***
Dealt to Duke Croix [Ts 6d]
dddocky: calls 100
FragileMemory: folds 
Duke Croix: folds 
yairpinto: folds 
color_singleton: raises 200 to 300
JeBoyDirk: folds 
MnnM150: calls 200
dddocky: calls 200
*** FLOP *** [9h Ks Ah]
MnnM150: bets 449
dddocky: folds 
color_singleton: calls 449
*** TURN *** [9h Ks Ah] [7h]
MnnM150: checks 
color_singleton: checks 
*** RIVER *** [9h Ks Ah 7h] [Jd]
MnnM150: bets 1746
color_singleton: folds 
Uncalled bet (1746) returned to MnnM150
MnnM150 collected 1746 from pot
*** SUMMARY ***
Total pot 1848 | Rake 102 
Board [9h Ks Ah 7h Jd]
Seat 1: dddocky folded on the Flop
Seat 2: FragileMemory folded before Flop (didn't bet)
Seat 3: Duke Croix folded before Flop (didn't bet)
Seat 4: yairpinto folded before Flop (didn't bet)
Seat 6: color_singleton (button) folded on the River
Seat 8: JeBoyDirk (small blind) folded before Flop
Seat 9: MnnM150 (big blind) collected (1746)



PokerStars Home Game Hand #218088646542: {Club #3225207}  Hold'em No Limit (50/100) - 2020/09/03 17:15:46 ET
Table 'fun gamez' 9-max (Play Money) Seat #8 is the button
Seat 1: dddocky (5076 in chips) 
Seat 2: FragileMemory (7024 in chips) 
Seat 3: Duke Croix (28620 in chips) 
Seat 4: yairpinto (2856 in chips) 
Seat 6: color_singleton (18934 in chips) 
Seat 8: JeBoyDirk (29132 in chips) 
Seat 9: MnnM150 (4758 in chips) 
MnnM150: posts small blind 50
dddocky: posts big blind 100
*** HOLE CARDS ***
Dealt to Duke Croix [4s 3d]
FragileMemory: calls 100
Duke Croix: folds 
yairpinto: calls 100
color_singleton: calls 100
JeBoyDirk: folds 
MnnM150: calls 50
dddocky: checks 
*** FLOP *** [5s 7c Js]
MnnM150: checks 
dddocky: bets 100
FragileMemory: calls 100
yairpinto: calls 100
color_singleton: raises 400 to 500
MnnM150: folds 
dddocky: calls 400
FragileMemory: folds 
yairpinto: folds 
*** TURN *** [5s 7c Js] [2d]
dddocky: checks 
color_singleton: bets 1606
dddocky: folds 
Uncalled bet (1606) returned to color_singleton
color_singleton collected 1606 from pot
color_singleton: doesn't show hand 
*** SUMMARY ***
Total pot 1700 | Rake 94 
Board [5s 7c Js 2d]
Seat 1: dddocky (big blind) folded on the Turn
Seat 2: FragileMemory folded on the Flop
Seat 3: Duke Croix folded before Flop (didn't bet)
Seat 4: yairpinto folded on the Flop
Seat 6: color_singleton collected (1606)
Seat 8: JeBoyDirk (button) folded before Flop (didn't bet)
Seat 9: MnnM150 (small blind) folded on the Flop



PokerStars Home Game Hand #218088681792: {Club #3225207}  Hold'em No Limit (50/100) - 2020/09/03 17:16:32 ET
Table 'fun gamez' 9-max (Play Money) Seat #9 is the button
Seat 1: dddocky (4476 in chips) 
Seat 2: FragileMemory (6824 in chips) 
Seat 3: Duke Croix (28620 in chips) 
Seat 4: yairpinto (2656 in chips) 
Seat 6: color_singleton (19940 in chips) 
Seat 8: JeBoyDirk (29132 in chips) 
Seat 9: MnnM150 (4658 in chips) 
dddocky: posts small blind 50
FragileMemory: posts big blind 100
*** HOLE CARDS ***
Dealt to Duke Croix [As Qd]
Duke Croix: raises 300 to 400
yairpinto: folds 
color_singleton: folds 
JeBoyDirk: folds 
MnnM150: folds 
dddocky: calls 350
FragileMemory: folds 
*** FLOP *** [8d 2c 6h]
dddocky: checks 
Duke Croix: bets 500
dddocky: folds 
Uncalled bet (500) returned to Duke Croix
Duke Croix collected 850 from pot
*** SUMMARY ***
Total pot 900 | Rake 50 
Board [8d 2c 6h]
Seat 1: dddocky (small blind) folded on the Flop
Seat 2: FragileMemory (big blind) folded before Flop
Seat 3: Duke Croix collected (850)
Seat 4: yairpinto folded before Flop (didn't bet)
Seat 6: color_singleton folded before Flop (didn't bet)
Seat 8: JeBoyDirk folded before Flop (didn't bet)
Seat 9: MnnM150 (button) folded before Flop (didn't bet)



PokerStars Home Game Hand #218088693981: {Club #3225207}  Hold'em No Limit (50/100) - 2020/09/03 17:16:53 ET
Table 'fun gamez' 9-max (Play Money) Seat #1 is the button
Seat 1: dddocky (4076 in chips) 
Seat 2: FragileMemory (6724 in chips) 
Seat 3: Duke Croix (29070 in chips) 
Seat 4: yairpinto (2656 in chips) 
Seat 6: color_singleton (19940 in chips) 
Seat 8: JeBoyDirk (29132 in chips) 
Seat 9: MnnM150 (4658 in chips) 
FragileMemory: posts small blind 50
Duke Croix: posts big blind 100
*** HOLE CARDS ***
Dealt to Duke Croix [Tc Jc]
yairpinto: folds 
color_singleton: raises 100 to 200
JeBoyDirk: calls 200
MnnM150: calls 200
dddocky: calls 200
FragileMemory: folds 
Duke Croix: raises 300 to 500
color_singleton: calls 300
JeBoyDirk: calls 300
MnnM150: calls 300
dddocky: calls 300
*** FLOP *** [9s 5c Jh]
Duke Croix: bets 1300
color_singleton: calls 1300
JeBoyDirk: folds 
MnnM150: folds 
dddocky: folds 
*** TURN *** [9s 5c Jh] [6c]
Duke Croix: checks 
color_singleton: checks 
*** RIVER *** [9s 5c Jh 6c] [7d]
Duke Croix: checks 
color_singleton: bets 2433
Duke Croix: calls 2433
*** SHOW DOWN ***
color_singleton: shows [Ks Qc] (high card King)
Duke Croix: shows [Tc Jc] (a pair of Jacks)
Duke Croix collected 9465 from pot
*** SUMMARY ***
Total pot 10016 | Rake 551 
Board [9s 5c Jh 6c 7d]
Seat 1: dddocky (button) folded on the Flop
Seat 2: FragileMemory (small blind) folded before Flop
Seat 3: Duke Croix (big blind) showed [Tc Jc] and won (9465) with a pair of Jacks
Seat 4: yairpinto folded before Flop (didn't bet)
Seat 6: color_singleton showed [Ks Qc] and lost with high card King
Seat 8: JeBoyDirk folded on the Flop
Seat 9: MnnM150 folded on the Flop



PokerStars Home Game Hand #218088738710: {Club #3225207}  Hold'em No Limit (50/100) - 2020/09/03 17:18:08 ET
Table 'fun gamez' 9-max (Play Money) Seat #2 is the button
Seat 1: dddocky (3576 in chips) 
Seat 2: FragileMemory (6674 in chips) 
Seat 3: Duke Croix (34302 in chips) 
Seat 4: yairpinto (2656 in chips) 
Seat 6: color_singleton (15707 in chips) 
Seat 8: JeBoyDirk (28632 in chips) 
Seat 9: MnnM150 (4158 in chips) 
Duke Croix: posts small blind 50
yairpinto: posts big blind 100
*** HOLE CARDS ***
Dealt to Duke Croix [7h Ad]
color_singleton: folds 
JeBoyDirk: folds 
MnnM150: calls 100
dddocky: folds 
FragileMemory: calls 100
Duke Croix: calls 50
yairpinto: checks 
*** FLOP *** [Ac Ah 8c]
Duke Croix: checks 
yairpinto: checks 
MnnM150: bets 100
FragileMemory: calls 100
Duke Croix: raises 300 to 400
yairpinto: folds 
MnnM150: raises 300 to 700
FragileMemory: folds 
Duke Croix: calls 300
*** TURN *** [Ac Ah 8c] [4c]
Duke Croix: checks 
MnnM150: bets 897
Duke Croix: calls 897
*** RIVER *** [Ac Ah 8c 4c] [6c]
Duke Croix: checks 
MnnM150: bets 2461 and is all-in
Duke Croix: folds 
Uncalled bet (2461) returned to MnnM150
MnnM150 collected 3491 from pot
*** SUMMARY ***
Total pot 3694 | Rake 203 
Board [Ac Ah 8c 4c 6c]
Seat 1: dddocky folded before Flop (didn't bet)
Seat 2: FragileMemory (button) folded on the Flop
Seat 3: Duke Croix (small blind) folded on the River
Seat 4: yairpinto (big blind) folded on the Flop
Seat 6: color_singleton folded before Flop (didn't bet)
Seat 8: JeBoyDirk folded before Flop (didn't bet)
Seat 9: MnnM150 collected (3491)



PokerStars Home Game Hand #218088787247: {Club #3225207}  Hold'em No Limit (50/100) - 2020/09/03 17:19:29 ET
Table 'fun gamez' 9-max (Play Money) Seat #3 is the button
Seat 1: dddocky (3576 in chips) 
Seat 2: FragileMemory (6474 in chips) 
Seat 3: Duke Croix (32605 in chips) 
Seat 4: yairpinto (2556 in chips) 
Seat 6: color_singleton (15707 in chips) 
Seat 8: JeBoyDirk (28632 in chips) 
Seat 9: MnnM150 (5952 in chips) 
yairpinto: posts small blind 50
color_singleton: posts big blind 100
*** HOLE CARDS ***
Dealt to Duke Croix [Ah Ks]
JeBoyDirk: folds 
MnnM150: folds 
dddocky: folds 
FragileMemory: raises 100 to 200
Duke Croix: raises 300 to 500
yairpinto: folds 
color_singleton: folds 
FragileMemory: calls 300
*** FLOP *** [Kc 4c Td]
FragileMemory: checks 
Duke Croix: bets 500
FragileMemory: folds 
Uncalled bet (500) returned to Duke Croix
Duke Croix collected 1087 from pot
*** SUMMARY ***
Total pot 1150 | Rake 63 
Board [Kc 4c Td]
Seat 1: dddocky folded before Flop (didn't bet)
Seat 2: FragileMemory folded on the Flop
Seat 3: Duke Croix (button) collected (1087)
Seat 4: yairpinto (small blind) folded before Flop
Seat 6: color_singleton (big blind) folded before Flop
Seat 8: JeBoyDirk folded before Flop (didn't bet)
Seat 9: MnnM150 folded before Flop (didn't bet)



PokerStars Home Game Hand #218088808844: {Club #3225207}  Hold'em No Limit (50/100) - 2020/09/03 17:20:06 ET
Table 'fun gamez' 9-max (Play Money) Seat #4 is the button
Seat 1: dddocky (3576 in chips) 
Seat 2: FragileMemory (5974 in chips) 
Seat 3: Duke Croix (33192 in chips) 
Seat 4: yairpinto (2506 in chips) 
Seat 6: color_singleton (15607 in chips) 
Seat 8: JeBoyDirk (28632 in chips) 
Seat 9: MnnM150 (5952 in chips) 
color_singleton: posts small blind 50
JeBoyDirk: posts big blind 100
*** HOLE CARDS ***
Dealt to Duke Croix [9c 6d]
MnnM150: calls 100
dddocky: calls 100
FragileMemory: folds 
Duke Croix: folds 
yairpinto: folds 
color_singleton: calls 50
JeBoyDirk: checks 
*** FLOP *** [2d Qs 2s]
color_singleton: checks 
JeBoyDirk: checks 
MnnM150: checks 
dddocky: checks 
*** TURN *** [2d Qs 2s] [As]
color_singleton: bets 189
JeBoyDirk: folds 
MnnM150: folds 
dddocky: folds 
Uncalled bet (189) returned to color_singleton
color_singleton collected 378 from pot
color_singleton: doesn't show hand 
*** SUMMARY ***
Total pot 400 | Rake 22 
Board [2d Qs 2s As]
Seat 1: dddocky folded on the Turn
Seat 2: FragileMemory folded before Flop (didn't bet)
Seat 3: Duke Croix folded before Flop (didn't bet)
Seat 4: yairpinto (button) folded before Flop (didn't bet)
Seat 6: color_singleton (small blind) collected (378)
Seat 8: JeBoyDirk (big blind) folded on the Turn
Seat 9: MnnM150 folded on the Turn



PokerStars Home Game Hand #218088828673: {Club #3225207}  Hold'em No Limit (50/100) - 2020/09/03 17:20:39 ET
Table 'fun gamez' 9-max (Play Money) Seat #6 is the button
Seat 1: dddocky (3476 in chips) 
Seat 2: FragileMemory (5974 in chips) 
Seat 3: Duke Croix (33192 in chips) 
Seat 4: yairpinto (2506 in chips) 
Seat 6: color_singleton (15885 in chips) 
Seat 8: JeBoyDirk (28532 in chips) 
Seat 9: MnnM150 (5852 in chips) 
JeBoyDirk: posts small blind 50
MnnM150: posts big blind 100
*** HOLE CARDS ***
Dealt to Duke Croix [5d Qs]
dddocky: folds 
FragileMemory: folds 
Duke Croix: folds 
yairpinto: folds 
color_singleton: folds 
JeBoyDirk: calls 50
MnnM150: checks 
*** FLOP *** [Th Qc 2d]
JeBoyDirk: bets 200
MnnM150: folds 
Uncalled bet (200) returned to JeBoyDirk
JeBoyDirk collected 189 from pot
*** SUMMARY ***
Total pot 200 | Rake 11 
Board [Th Qc 2d]
Seat 1: dddocky folded before Flop (didn't bet)
Seat 2: FragileMemory folded before Flop (didn't bet)
Seat 3: Duke Croix folded before Flop (didn't bet)
Seat 4: yairpinto folded before Flop (didn't bet)
Seat 6: color_singleton (button) folded before Flop (didn't bet)
Seat 8: JeBoyDirk (small blind) collected (189)
Seat 9: MnnM150 (big blind) folded on the Flop



PokerStars Home Game Hand #218088847706: {Club #3225207}  Hold'em No Limit (50/100) - 2020/09/03 17:21:12 ET
Table 'fun gamez' 9-max (Play Money) Seat #8 is the button
Seat 1: dddocky (3476 in chips) 
Seat 2: FragileMemory (5974 in chips) 
Seat 3: Duke Croix (33192 in chips) 
Seat 4: yairpinto (2506 in chips) 
Seat 6: color_singleton (15885 in chips) 
Seat 8: JeBoyDirk (28621 in chips) 
Seat 9: MnnM150 (5752 in chips) 
MnnM150: posts small blind 50
dddocky: posts big blind 100
*** HOLE CARDS ***
Dealt to Duke Croix [3s 3h]
FragileMemory: calls 100
Duke Croix: raises 300 to 400
yairpinto: folds 
color_singleton: folds 
JeBoyDirk: folds 
MnnM150: folds 
dddocky: calls 300
FragileMemory: calls 300
*** FLOP *** [8h Ac 3d]
dddocky: checks 
FragileMemory: checks 
Duke Croix: checks 
*** TURN *** [8h Ac 3d] [Qh]
dddocky: checks 
FragileMemory: checks 
Duke Croix: bets 750
dddocky: folds 
FragileMemory: folds 
Uncalled bet (750) returned to Duke Croix
Duke Croix collected 1181 from pot
*** SUMMARY ***
Total pot 1250 | Rake 69 
Board [8h Ac 3d Qh]
Seat 1: dddocky (big blind) folded on the Turn
Seat 2: FragileMemory folded on the Turn
Seat 3: Duke Croix collected (1181)
Seat 4: yairpinto folded before Flop (didn't bet)
Seat 6: color_singleton folded before Flop (didn't bet)
Seat 8: JeBoyDirk (button) folded before Flop (didn't bet)
Seat 9: MnnM150 (small blind) folded before Flop



PokerStars Home Game Hand #218088866914: {Club #3225207}  Hold'em No Limit (50/100) - 2020/09/03 17:21:44 ET
Table 'fun gamez' 9-max (Play Money) Seat #9 is the button
Seat 1: dddocky (3076 in chips) 
Seat 2: FragileMemory (5574 in chips) 
Seat 3: Duke Croix (33973 in chips) 
Seat 4: yairpinto (2506 in chips) 
Seat 6: color_singleton (15885 in chips) 
Seat 8: JeBoyDirk (28621 in chips) 
Seat 9: MnnM150 (5702 in chips) 
dddocky: posts small blind 50
FragileMemory: posts big blind 100
*** HOLE CARDS ***
Dealt to Duke Croix [4d Tc]
Duke Croix: folds 
yairpinto: folds 
color_singleton: raises 200 to 300
JeBoyDirk: folds 
MnnM150: calls 300
dddocky: folds 
FragileMemory: calls 200
*** FLOP *** [Qd 8c 8d]
FragileMemory: checks 
color_singleton: bets 449
MnnM150: folds 
FragileMemory: folds 
Uncalled bet (449) returned to color_singleton
color_singleton collected 898 from pot
color_singleton: doesn't show hand 
*** SUMMARY ***
Total pot 950 | Rake 52 
Board [Qd 8c 8d]
Seat 1: dddocky (small blind) folded before Flop
Seat 2: FragileMemory (big blind) folded on the Flop
Seat 3: Duke Croix folded before Flop (didn't bet)
Seat 4: yairpinto folded before Flop (didn't bet)
Seat 6: color_singleton collected (898)
Seat 8: JeBoyDirk folded before Flop (didn't bet)
Seat 9: MnnM150 (button) folded on the Flop



PokerStars Home Game Hand #218088882936: {Club #3225207}  Hold'em No Limit (50/100) - 2020/09/03 17:22:11 ET
Table 'fun gamez' 9-max (Play Money) Seat #1 is the button
Seat 1: dddocky (3026 in chips) 
Seat 2: FragileMemory (5274 in chips) 
Seat 3: Duke Croix (33973 in chips) 
Seat 4: yairpinto (2506 in chips) 
Seat 6: color_singleton (16483 in chips) 
Seat 8: JeBoyDirk (28621 in chips) 
Seat 9: MnnM150 (5402 in chips) 
FragileMemory: posts small blind 50
Duke Croix: posts big blind 100
*** HOLE CARDS ***
Dealt to Duke Croix [9c 4c]
yairpinto: folds 
color_singleton: calls 100
JeBoyDirk: folds 
MnnM150: calls 100
dddocky: calls 100
FragileMemory: folds 
Duke Croix: checks 
*** FLOP *** [Jd Jc 5h]
Duke Croix: checks 
color_singleton: checks 
MnnM150: checks 
dddocky: checks 
*** TURN *** [Jd Jc 5h] [Js]
Duke Croix: checks 
color_singleton: bets 100
MnnM150: folds 
dddocky: calls 100
Duke Croix: folds 
*** RIVER *** [Jd Jc 5h Js] [3h]
color_singleton: bets 614
dddocky: folds 
Uncalled bet (614) returned to color_singleton
color_singleton collected 614 from pot
color_singleton: doesn't show hand 
*** SUMMARY ***
Total pot 650 | Rake 36 
Board [Jd Jc 5h Js 3h]
Seat 1: dddocky (button) folded on the River
Seat 2: FragileMemory (small blind) folded before Flop
Seat 3: Duke Croix (big blind) folded on the Turn
Seat 4: yairpinto folded before Flop (didn't bet)
Seat 6: color_singleton collected (614)
Seat 8: JeBoyDirk folded before Flop (didn't bet)
Seat 9: MnnM150 folded on the Turn



PokerStars Home Game Hand #218088907664: {Club #3225207}  Hold'em No Limit (50/100) - 2020/09/03 17:22:53 ET
Table 'fun gamez' 9-max (Play Money) Seat #2 is the button
Seat 1: dddocky (2826 in chips) 
Seat 2: FragileMemory (5224 in chips) 
Seat 3: Duke Croix (33873 in chips) 
Seat 4: yairpinto (2506 in chips) 
Seat 6: color_singleton (16897 in chips) 
Seat 8: JeBoyDirk (28621 in chips) 
Seat 9: MnnM150 (5302 in chips) 
Duke Croix: posts small blind 50
yairpinto: posts big blind 100
*** HOLE CARDS ***
Dealt to Duke Croix [Qc 7d]
color_singleton: folds 
JeBoyDirk: folds 
MnnM150: calls 100
dddocky: calls 100
FragileMemory: folds 
Duke Croix: calls 50
yairpinto: checks 
*** FLOP *** [Kh Qs Ks]
Duke Croix: bets 200
yairpinto: calls 200
MnnM150: folds 
dddocky: folds 
*** TURN *** [Kh Qs Ks] [3c]
Duke Croix: bets 400
yairpinto: calls 400
*** RIVER *** [Kh Qs Ks 3c] [3s]
Duke Croix: checks 
yairpinto: bets 1512
Duke Croix: folds 
Uncalled bet (1512) returned to yairpinto
yairpinto collected 1512 from pot
yairpinto: doesn't show hand 
*** SUMMARY ***
Total pot 1600 | Rake 88 
Board [Kh Qs Ks 3c 3s]
Seat 1: dddocky folded on the Flop
Seat 2: FragileMemory (button) folded before Flop (didn't bet)
Seat 3: Duke Croix (small blind) folded on the River
Seat 4: yairpinto (big blind) collected (1512)
Seat 6: color_singleton folded before Flop (didn't bet)
Seat 8: JeBoyDirk folded before Flop (didn't bet)
Seat 9: MnnM150 folded on the Flop



PokerStars Home Game Hand #218088939645: {Club #3225207}  Hold'em No Limit (50/100) - 2020/09/03 17:23:48 ET
Table 'fun gamez' 9-max (Play Money) Seat #3 is the button
Seat 1: dddocky (2726 in chips) 
Seat 2: FragileMemory (5224 in chips) 
Seat 3: Duke Croix (33173 in chips) 
Seat 4: yairpinto (3318 in chips) 
Seat 6: color_singleton (16897 in chips) 
Seat 8: JeBoyDirk (28621 in chips) 
Seat 9: MnnM150 (5202 in chips) 
yairpinto: posts small blind 50
color_singleton: posts big blind 100
*** HOLE CARDS ***
Dealt to Duke Croix [4s 6h]
JeBoyDirk: raises 100 to 200
MnnM150: folds 
dddocky: folds 
FragileMemory: folds 
Duke Croix: folds 
yairpinto: folds 
color_singleton: calls 100
*** FLOP *** [Tc Ah 3c]
color_singleton: checks 
JeBoyDirk: bets 100
color_singleton: calls 100
*** TURN *** [Tc Ah 3c] [Js]
color_singleton: checks 
JeBoyDirk: bets 300
color_singleton: folds 
Uncalled bet (300) returned to JeBoyDirk
JeBoyDirk collected 614 from pot
*** SUMMARY ***
Total pot 650 | Rake 36 
Board [Tc Ah 3c Js]
Seat 1: dddocky folded before Flop (didn't bet)
Seat 2: FragileMemory folded before Flop (didn't bet)
Seat 3: Duke Croix (button) folded before Flop (didn't bet)
Seat 4: yairpinto (small blind) folded before Flop
Seat 6: color_singleton (big blind) folded on the Turn
Seat 8: JeBoyDirk collected (614)
Seat 9: MnnM150 folded before Flop (didn't bet)



PokerStars Home Game Hand #218088967585: {Club #3225207}  Hold'em No Limit (50/100) - 2020/09/03 17:24:35 ET
Table 'fun gamez' 9-max (Play Money) Seat #4 is the button
Seat 1: dddocky (2726 in chips) 
Seat 2: FragileMemory (5224 in chips) 
Seat 3: Duke Croix (33173 in chips) 
Seat 4: yairpinto (3268 in chips) 
Seat 6: color_singleton (16597 in chips) 
Seat 8: JeBoyDirk (28935 in chips) 
Seat 9: MnnM150 (5202 in chips) 
color_singleton: posts small blind 50
JeBoyDirk: posts big blind 100
*** HOLE CARDS ***
Dealt to Duke Croix [Jh 8d]
MnnM150: folds 
dddocky: calls 100
FragileMemory: calls 100
Duke Croix: folds 
yairpinto: raises 450 to 550
color_singleton: calls 500
JeBoyDirk: folds 
dddocky: folds 
FragileMemory: folds 
*** FLOP *** [As 7h Ad]
color_singleton: checks 
yairpinto: bets 661
color_singleton: raises 661 to 1322
yairpinto: folds 
Uncalled bet (661) returned to color_singleton
color_singleton collected 2572 from pot
color_singleton: doesn't show hand 
*** SUMMARY ***
Total pot 2722 | Rake 150 
Board [As 7h Ad]
Seat 1: dddocky folded before Flop
Seat 2: FragileMemory folded before Flop
Seat 3: Duke Croix folded before Flop (didn't bet)
Seat 4: yairpinto (button) folded on the Flop
Seat 6: color_singleton (small blind) collected (2572)
Seat 8: JeBoyDirk (big blind) folded before Flop
Seat 9: MnnM150 folded before Flop (didn't bet)



PokerStars Home Game Hand #218088998304: {Club #3225207}  Hold'em No Limit (50/100) - 2020/09/03 17:25:27 ET
Table 'fun gamez' 9-max (Play Money) Seat #6 is the button
Seat 1: dddocky (2626 in chips) 
Seat 2: FragileMemory (5124 in chips) 
Seat 3: Duke Croix (33173 in chips) 
Seat 4: yairpinto (2057 in chips) 
Seat 6: color_singleton (17958 in chips) 
Seat 8: JeBoyDirk (28835 in chips) 
Seat 9: MnnM150 (5202 in chips) 
JeBoyDirk: posts small blind 50
MnnM150: posts big blind 100
*** HOLE CARDS ***
Dealt to Duke Croix [3c Jd]
dddocky: folds 
FragileMemory: calls 100
Duke Croix: folds 
yairpinto: folds 
color_singleton: folds 
JeBoyDirk: calls 50
MnnM150: checks 
*** FLOP *** [8h 8d Kd]
JeBoyDirk: bets 100
MnnM150: folds 
FragileMemory: folds 
Uncalled bet (100) returned to JeBoyDirk
JeBoyDirk collected 283 from pot
*** SUMMARY ***
Total pot 300 | Rake 17 
Board [8h 8d Kd]
Seat 1: dddocky folded before Flop (didn't bet)
Seat 2: FragileMemory folded on the Flop
Seat 3: Duke Croix folded before Flop (didn't bet)
Seat 4: yairpinto folded before Flop (didn't bet)
Seat 6: color_singleton (button) folded before Flop (didn't bet)
Seat 8: JeBoyDirk (small blind) collected (283)
Seat 9: MnnM150 (big blind) folded on the Flop



PokerStars Home Game Hand #218089020135: {Club #3225207}  Hold'em No Limit (50/100) - 2020/09/03 17:26:05 ET
Table 'fun gamez' 9-max (Play Money) Seat #8 is the button
Seat 1: dddocky (2626 in chips) 
Seat 2: FragileMemory (5024 in chips) 
Seat 3: Duke Croix (33173 in chips) 
Seat 4: yairpinto (2057 in chips) 
Seat 6: color_singleton (17958 in chips) 
Seat 8: JeBoyDirk (29018 in chips) 
Seat 9: MnnM150 (5102 in chips) 
MnnM150: posts small blind 50
dddocky: posts big blind 100
*** HOLE CARDS ***
Dealt to Duke Croix [3s 6d]
FragileMemory: folds 
Duke Croix: folds 
yairpinto: folds 
color_singleton: folds 
JeBoyDirk: raises 200 to 300
MnnM150: folds 
dddocky: folds 
Uncalled bet (200) returned to JeBoyDirk
JeBoyDirk collected 250 from pot
*** SUMMARY ***
Total pot 250 | Rake 0 
Seat 1: dddocky (big blind) folded before Flop
Seat 2: FragileMemory folded before Flop (didn't bet)
Seat 3: Duke Croix folded before Flop (didn't bet)
Seat 4: yairpinto folded before Flop (didn't bet)
Seat 6: color_singleton folded before Flop (didn't bet)
Seat 8: JeBoyDirk (button) collected (250)
Seat 9: MnnM150 (small blind) folded before Flop



PokerStars Home Game Hand #218089030624: {Club #3225207}  Hold'em No Limit (50/100) - 2020/09/03 17:26:22 ET
Table 'fun gamez' 9-max (Play Money) Seat #9 is the button
Seat 1: dddocky (2526 in chips) 
Seat 2: FragileMemory (5024 in chips) 
Seat 3: Duke Croix (33173 in chips) 
Seat 4: yairpinto (2057 in chips) 
Seat 6: color_singleton (17958 in chips) 
Seat 8: JeBoyDirk (29168 in chips) 
Seat 9: MnnM150 (5052 in chips) 
dddocky: posts small blind 50
FragileMemory: posts big blind 100
*** HOLE CARDS ***
Dealt to Duke Croix [3d 8h]
Duke Croix: folds 
yairpinto: folds 
color_singleton: calls 100
JeBoyDirk: folds 
MnnM150: calls 100
dddocky: folds 
FragileMemory: checks 
*** FLOP *** [9h 7s 6s]
FragileMemory: checks 
color_singleton: checks 
MnnM150: checks 
*** TURN *** [9h 7s 6s] [Qh]
FragileMemory: checks 
color_singleton: bets 165
MnnM150: folds 
FragileMemory: calls 165
*** RIVER *** [9h 7s 6s Qh] [Td]
FragileMemory: checks 
color_singleton: checks 
*** SHOW DOWN ***
FragileMemory: shows [Qd 8d] (a straight, Six to Ten)
color_singleton: mucks hand 
FragileMemory collected 643 from pot
*** SUMMARY ***
Total pot 680 | Rake 37 
Board [9h 7s 6s Qh Td]
Seat 1: dddocky (small blind) folded before Flop
Seat 2: FragileMemory (big blind) showed [Qd 8d] and won (643) with a straight, Six to Ten
Seat 3: Duke Croix folded before Flop (didn't bet)
Seat 4: yairpinto folded before Flop (didn't bet)
Seat 6: color_singleton mucked [Jh 5h]
Seat 8: JeBoyDirk folded before Flop (didn't bet)
Seat 9: MnnM150 (button) folded on the Turn



PokerStars Home Game Hand #218089060896: {Club #3225207}  Hold'em No Limit (50/100) - 2020/09/03 17:27:14 ET
Table 'fun gamez' 9-max (Play Money) Seat #1 is the button
Seat 1: dddocky (2476 in chips) 
Seat 2: FragileMemory (5402 in chips) 
Seat 3: Duke Croix (33173 in chips) 
Seat 4: yairpinto (2057 in chips) 
Seat 6: color_singleton (17693 in chips) 
Seat 8: JeBoyDirk (29168 in chips) 
Seat 9: MnnM150 (4952 in chips) 
FragileMemory: posts small blind 50
Duke Croix: posts big blind 100
*** HOLE CARDS ***
Dealt to Duke Croix [4c 6s]
yairpinto: folds 
color_singleton: folds 
JeBoyDirk: folds 
MnnM150: calls 100
dddocky: calls 100
FragileMemory: calls 50
Duke Croix: checks 
*** FLOP *** [4s 6h 2s]
FragileMemory: checks 
Duke Croix: bets 200
MnnM150: folds 
dddocky: calls 200
FragileMemory: folds 
*** TURN *** [4s 6h 2s] [Tc]
Duke Croix: bets 400
dddocky: folds 
Uncalled bet (400) returned to Duke Croix
Duke Croix collected 756 from pot
*** SUMMARY ***
Total pot 800 | Rake 44 
Board [4s 6h 2s Tc]
Seat 1: dddocky (button) folded on the Turn
Seat 2: FragileMemory (small blind) folded on the Flop
Seat 3: Duke Croix (big blind) collected (756)
Seat 4: yairpinto folded before Flop (didn't bet)
Seat 6: color_singleton folded before Flop (didn't bet)
Seat 8: JeBoyDirk folded before Flop (didn't bet)
Seat 9: MnnM150 folded on the Flop



PokerStars Home Game Hand #218089082903: {Club #3225207}  Hold'em No Limit (50/100) - 2020/09/03 17:27:52 ET
Table 'fun gamez' 9-max (Play Money) Seat #2 is the button
Seat 1: dddocky (2176 in chips) 
Seat 2: FragileMemory (5302 in chips) 
Seat 3: Duke Croix (33629 in chips) 
Seat 4: yairpinto (2057 in chips) 
Seat 6: color_singleton (17693 in chips) 
Seat 8: JeBoyDirk (29168 in chips) 
Seat 9: MnnM150 (4852 in chips) 
Duke Croix: posts small blind 50
yairpinto: posts big blind 100
*** HOLE CARDS ***
Dealt to Duke Croix [3c Ts]
color_singleton: folds 
JeBoyDirk: folds 
MnnM150: calls 100
dddocky: folds 
FragileMemory: folds 
Duke Croix: folds 
yairpinto: checks 
*** FLOP *** [Jd Ac Jc]
yairpinto: bets 118
MnnM150: calls 118
*** TURN *** [Jd Ac Jc] [8c]
yairpinto: bets 229
MnnM150: folds 
Uncalled bet (229) returned to yairpinto
yairpinto collected 459 from pot
yairpinto: doesn't show hand 
*** SUMMARY ***
Total pot 486 | Rake 27 
Board [Jd Ac Jc 8c]
Seat 1: dddocky folded before Flop (didn't bet)
Seat 2: FragileMemory (button) folded before Flop (didn't bet)
Seat 3: Duke Croix (small blind) folded before Flop
Seat 4: yairpinto (big blind) collected (459)
Seat 6: color_singleton folded before Flop (didn't bet)
Seat 8: JeBoyDirk folded before Flop (didn't bet)
Seat 9: MnnM150 folded on the Turn



PokerStars Home Game Hand #218089102458: {Club #3225207}  Hold'em No Limit (50/100) - 2020/09/03 17:28:26 ET
Table 'fun gamez' 9-max (Play Money) Seat #3 is the button
Seat 1: dddocky (2176 in chips) 
Seat 2: FragileMemory (5302 in chips) 
Seat 3: Duke Croix (33579 in chips) 
Seat 4: yairpinto (2298 in chips) 
Seat 6: color_singleton (17693 in chips) 
Seat 8: JeBoyDirk (29168 in chips) 
Seat 9: MnnM150 (4634 in chips) 
yairpinto: posts small blind 50
color_singleton: posts big blind 100
*** HOLE CARDS ***
Dealt to Duke Croix [As Td]
JeBoyDirk: calls 100
MnnM150: folds 
dddocky: calls 100
FragileMemory: folds 
Duke Croix: raises 400 to 500
yairpinto: folds 
color_singleton: calls 400
JeBoyDirk: calls 400
dddocky: calls 400
*** FLOP *** [5h 3c 6h]
color_singleton: checks 
JeBoyDirk: checks 
dddocky: checks 
Duke Croix: bets 1000
color_singleton: folds 
JeBoyDirk: folds 
dddocky: folds 
Uncalled bet (1000) returned to Duke Croix
Duke Croix collected 1937 from pot
*** SUMMARY ***
Total pot 2050 | Rake 113 
Board [5h 3c 6h]
Seat 1: dddocky folded on the Flop
Seat 2: FragileMemory folded before Flop (didn't bet)
Seat 3: Duke Croix (button) collected (1937)
Seat 4: yairpinto (small blind) folded before Flop
Seat 6: color_singleton (big blind) folded on the Flop
Seat 8: JeBoyDirk folded on the Flop
Seat 9: MnnM150 folded before Flop (didn't bet)



PokerStars Home Game Hand #218089122688: {Club #3225207}  Hold'em No Limit (50/100) - 2020/09/03 17:29:00 ET
Table 'fun gamez' 9-max (Play Money) Seat #4 is the button
Seat 1: dddocky (1676 in chips) 
Seat 2: FragileMemory (5302 in chips) 
Seat 3: Duke Croix (35016 in chips) 
Seat 4: yairpinto (2248 in chips) 
Seat 6: color_singleton (17193 in chips) 
Seat 8: JeBoyDirk (28668 in chips) 
Seat 9: MnnM150 (4634 in chips) 
color_singleton: posts small blind 50
JeBoyDirk: posts big blind 100
*** HOLE CARDS ***
Dealt to Duke Croix [8d 6c]
MnnM150: calls 100
dddocky: folds 
FragileMemory: calls 100
Duke Croix: folds 
yairpinto: folds 
color_singleton: raises 200 to 300
JeBoyDirk: calls 200
MnnM150: calls 200
FragileMemory: folds 
*** FLOP *** [4s 8s Jd]
color_singleton: checks 
JeBoyDirk: bets 600
MnnM150: folds 
color_singleton: calls 600
*** TURN *** [4s 8s Jd] [2d]
color_singleton: checks 
JeBoyDirk: bets 1700
color_singleton: raises 1700 to 3400
JeBoyDirk: folds 
Uncalled bet (1700) returned to color_singleton
color_singleton collected 5292 from pot
color_singleton: doesn't show hand 
*** SUMMARY ***
Total pot 5600 | Rake 308 
Board [4s 8s Jd 2d]
Seat 1: dddocky folded before Flop (didn't bet)
Seat 2: FragileMemory folded before Flop
Seat 3: Duke Croix folded before Flop (didn't bet)
Seat 4: yairpinto (button) folded before Flop (didn't bet)
Seat 6: color_singleton (small blind) collected (5292)
Seat 8: JeBoyDirk (big blind) folded on the Turn
Seat 9: MnnM150 folded on the Flop



PokerStars Home Game Hand #218089155925: {Club #3225207}  Hold'em No Limit (50/100) - 2020/09/03 17:29:57 ET
Table 'fun gamez' 9-max (Play Money) Seat #6 is the button
Seat 1: dddocky (1676 in chips) 
Seat 2: FragileMemory (5202 in chips) 
Seat 3: Duke Croix (35016 in chips) 
Seat 4: yairpinto (2248 in chips) 
Seat 6: color_singleton (19885 in chips) 
Seat 8: JeBoyDirk (26068 in chips) 
Seat 9: MnnM150 (4334 in chips) 
JeBoyDirk: posts small blind 50
MnnM150: posts big blind 100
*** HOLE CARDS ***
Dealt to Duke Croix [Jc Kd]
dddocky: folds 
FragileMemory: calls 100
Duke Croix: raises 400 to 500
yairpinto: folds 
color_singleton: folds 
JeBoyDirk: calls 450
MnnM150: calls 400
FragileMemory: folds 
*** FLOP *** [Ts 5s 2d]
JeBoyDirk: checks 
MnnM150: checks 
Duke Croix: checks 
*** TURN *** [Ts 5s 2d] [9d]
JeBoyDirk: checks 
MnnM150: checks 
Duke Croix: bets 800
JeBoyDirk: folds 
MnnM150: folds 
Uncalled bet (800) returned to Duke Croix
Duke Croix collected 1512 from pot
*** SUMMARY ***
Total pot 1600 | Rake 88 
Board [Ts 5s 2d 9d]
Seat 1: dddocky folded before Flop (didn't bet)
Seat 2: FragileMemory folded before Flop
Seat 3: Duke Croix collected (1512)
Seat 4: yairpinto folded before Flop (didn't bet)
Seat 6: color_singleton (button) folded before Flop (didn't bet)
Seat 8: JeBoyDirk (small blind) folded on the Turn
Seat 9: MnnM150 (big blind) folded on the Turn



PokerStars Home Game Hand #218089177454: {Club #3225207}  Hold'em No Limit (50/100) - 2020/09/03 17:30:34 ET
Table 'fun gamez' 9-max (Play Money) Seat #8 is the button
Seat 1: dddocky (1676 in chips) 
Seat 2: FragileMemory (5102 in chips) 
Seat 3: Duke Croix (36028 in chips) 
Seat 4: yairpinto (2248 in chips) 
Seat 6: color_singleton (19885 in chips) 
Seat 8: JeBoyDirk (25568 in chips) 
Seat 9: MnnM150 (3834 in chips) 
MnnM150: posts small blind 50
dddocky: posts big blind 100
*** HOLE CARDS ***
Dealt to Duke Croix [Ah 8c]
FragileMemory: folds 
Duke Croix: raises 200 to 300
yairpinto: folds 
color_singleton: folds 
JeBoyDirk: folds 
MnnM150: calls 250
dddocky: folds 
*** FLOP *** [8d Qc Th]
MnnM150: bets 661
Duke Croix: folds 
Uncalled bet (661) returned to MnnM150
MnnM150 collected 661 from pot
*** SUMMARY ***
Total pot 700 | Rake 39 
Board [8d Qc Th]
Seat 1: dddocky (big blind) folded before Flop
Seat 2: FragileMemory folded before Flop (didn't bet)
Seat 3: Duke Croix folded on the Flop
Seat 4: yairpinto folded before Flop (didn't bet)
Seat 6: color_singleton folded before Flop (didn't bet)
Seat 8: JeBoyDirk (button) folded before Flop (didn't bet)
Seat 9: MnnM150 (small blind) collected (661)



PokerStars Home Game Hand #218089196463: {Club #3225207}  Hold'em No Limit (50/100) - 2020/09/03 17:31:07 ET
Table 'fun gamez' 9-max (Play Money) Seat #9 is the button
Seat 1: dddocky (1576 in chips) 
Seat 2: FragileMemory (5102 in chips) 
Seat 3: Duke Croix (35728 in chips) 
Seat 4: yairpinto (2248 in chips) 
Seat 6: color_singleton (19885 in chips) 
Seat 8: JeBoyDirk (25568 in chips) 
Seat 9: MnnM150 (4195 in chips) 
dddocky: posts small blind 50
FragileMemory: posts big blind 100
*** HOLE CARDS ***
Dealt to Duke Croix [9h 5h]
Duke Croix: folds 
yairpinto: folds 
color_singleton: folds 
JeBoyDirk: folds 
MnnM150: calls 100
dddocky: calls 50
FragileMemory: checks 
*** FLOP *** [7c 2c 7d]
dddocky: checks 
FragileMemory: bets 100
MnnM150: calls 100
dddocky: folds 
*** TURN *** [7c 2c 7d] [9s]
FragileMemory: bets 236
MnnM150: folds 
Uncalled bet (236) returned to FragileMemory
FragileMemory collected 472 from pot
FragileMemory: doesn't show hand 
*** SUMMARY ***
Total pot 500 | Rake 28 
Board [7c 2c 7d 9s]
Seat 1: dddocky (small blind) folded on the Flop
Seat 2: FragileMemory (big blind) collected (472)
Seat 3: Duke Croix folded before Flop (didn't bet)
Seat 4: yairpinto folded before Flop (didn't bet)
Seat 6: color_singleton folded before Flop (didn't bet)
Seat 8: JeBoyDirk folded before Flop (didn't bet)
Seat 9: MnnM150 (button) folded on the Turn



PokerStars Home Game Hand #218089220242: {Club #3225207}  Hold'em No Limit (50/100) - 2020/09/03 17:31:48 ET
Table 'fun gamez' 9-max (Play Money) Seat #1 is the button
Seat 1: dddocky (1476 in chips) 
Seat 2: FragileMemory (5374 in chips) 
Seat 3: Duke Croix (35728 in chips) 
Seat 4: yairpinto (2248 in chips) 
Seat 6: color_singleton (19885 in chips) 
Seat 8: JeBoyDirk (25568 in chips) 
Seat 9: MnnM150 (3995 in chips) 
FragileMemory: posts small blind 50
Duke Croix: posts big blind 100
*** HOLE CARDS ***
Dealt to Duke Croix [Jc Qc]
yairpinto: folds 
color_singleton: raises 100 to 200
JeBoyDirk: calls 200
MnnM150: calls 200
dddocky: folds 
FragileMemory: folds 
Duke Croix: calls 100
*** FLOP *** [5c 4d 4s]
Duke Croix: checks 
color_singleton: bets 401
JeBoyDirk: calls 401
MnnM150: folds 
Duke Croix: folds 
*** TURN *** [5c 4d 4s] [Qh]
color_singleton: checks 
JeBoyDirk: checks 
*** RIVER *** [5c 4d 4s Qh] [Kh]
color_singleton: bets 780
JeBoyDirk: raises 1020 to 1800
color_singleton: calls 1020
*** SHOW DOWN ***
JeBoyDirk: shows [5s 5d] (a full house, Fives full of Fours)
color_singleton: mucks hand 
JeBoyDirk collected 4963 from pot
*** SUMMARY ***
Total pot 5252 | Rake 289 
Board [5c 4d 4s Qh Kh]
Seat 1: dddocky (button) folded before Flop (didn't bet)
Seat 2: FragileMemory (small blind) folded before Flop
Seat 3: Duke Croix (big blind) folded on the Flop
Seat 4: yairpinto folded before Flop (didn't bet)
Seat 6: color_singleton mucked [Ks Ts]
Seat 8: JeBoyDirk showed [5s 5d] and won (4963) with a full house, Fives full of Fours
Seat 9: MnnM150 folded on the Flop



PokerStars Home Game Hand #218089253449: {Club #3225207}  Hold'em No Limit (50/100) - 2020/09/03 17:32:46 ET
Table 'fun gamez' 9-max (Play Money) Seat #2 is the button
Seat 1: dddocky (1476 in chips) 
Seat 2: FragileMemory (5324 in chips) 
Seat 3: Duke Croix (35528 in chips) 
Seat 4: yairpinto (2248 in chips) 
Seat 6: color_singleton (17484 in chips) 
Seat 8: JeBoyDirk (28130 in chips) 
Seat 9: MnnM150 (3795 in chips) 
Duke Croix: posts small blind 50
yairpinto: posts big blind 100
*** HOLE CARDS ***
Dealt to Duke Croix [2c 5d]
color_singleton: raises 100 to 200
JeBoyDirk: calls 200
MnnM150: folds 
dddocky: calls 200
FragileMemory: calls 200
Duke Croix: folds 
yairpinto: raises 1050 to 1250
color_singleton: folds 
JeBoyDirk: raises 1050 to 2300
dddocky: folds 
FragileMemory: raises 3024 to 5324 and is all-in
yairpinto: calls 998 and is all-in
JeBoyDirk: calls 3024
*** FLOP *** [8h Jd 3s]
*** TURN *** [8h Jd 3s] [Kh]
*** RIVER *** [8h Jd 3s Kh] [Ad]
*** SHOW DOWN ***
JeBoyDirk: shows [7h 7c] (a pair of Sevens)
FragileMemory: shows [2s Ac] (a pair of Aces)
FragileMemory collected 5814 from side pot
yairpinto: shows [Tc Td] (a pair of Tens)
FragileMemory collected 6798 from main pot
*** SUMMARY ***
Total pot 13346 Main pot 6798. Side pot 5814. | Rake 734 
Board [8h Jd 3s Kh Ad]
Seat 1: dddocky folded before Flop
Seat 2: FragileMemory (button) showed [2s Ac] and won (12612) with a pair of Aces
Seat 3: Duke Croix (small blind) folded before Flop
Seat 4: yairpinto (big blind) showed [Tc Td] and lost with a pair of Tens
Seat 6: color_singleton folded before Flop
Seat 8: JeBoyDirk showed [7h 7c] and lost with a pair of Sevens
Seat 9: MnnM150 folded before Flop (didn't bet)



PokerStars Home Game Hand #218089278532: {Club #3225207}  Hold'em No Limit (50/100) - 2020/09/03 17:33:29 ET
Table 'fun gamez' 9-max (Play Money) Seat #3 is the button
Seat 1: dddocky (1276 in chips) 
Seat 2: FragileMemory (12612 in chips) 
Seat 3: Duke Croix (35478 in chips) 
Seat 6: color_singleton (17284 in chips) 
Seat 8: JeBoyDirk (22806 in chips) 
Seat 9: MnnM150 (3795 in chips) 
color_singleton: posts small blind 50
JeBoyDirk: posts big blind 100
*** HOLE CARDS ***
Dealt to Duke Croix [9c 6h]
MnnM150: calls 100
dddocky: folds 
FragileMemory: folds 
Duke Croix: folds 
color_singleton: folds 
JeBoyDirk: checks 
*** FLOP *** [2s 9h 5h]
JeBoyDirk: checks 
MnnM150: checks 
*** TURN *** [2s 9h 5h] [6d]
JeBoyDirk: checks 
MnnM150: checks 
*** RIVER *** [2s 9h 5h 6d] [8h]
JeBoyDirk: checks 
MnnM150: bets 236
JeBoyDirk: folds 
Uncalled bet (236) returned to MnnM150
MnnM150 collected 236 from pot
*** SUMMARY ***
Total pot 250 | Rake 14 
Board [2s 9h 5h 6d 8h]
Seat 1: dddocky folded before Flop (didn't bet)
Seat 2: FragileMemory folded before Flop (didn't bet)
Seat 3: Duke Croix (button) folded before Flop (didn't bet)
Seat 6: color_singleton (small blind) folded before Flop
Seat 8: JeBoyDirk (big blind) folded on the River
Seat 9: MnnM150 collected (236)



PokerStars Home Game Hand #218089304523: {Club #3225207}  Hold'em No Limit (50/100) - 2020/09/03 17:34:13 ET
Table 'fun gamez' 9-max (Play Money) Seat #6 is the button
Seat 1: dddocky (1276 in chips) 
Seat 2: FragileMemory (12612 in chips) 
Seat 3: Duke Croix (35478 in chips) 
Seat 6: color_singleton (17234 in chips) 
Seat 8: JeBoyDirk (22706 in chips) 
Seat 9: MnnM150 (3931 in chips) 
JeBoyDirk: posts small blind 50
MnnM150: posts big blind 100
*** HOLE CARDS ***
Dealt to Duke Croix [Ah Qs]
dddocky: calls 100
FragileMemory: folds 
Duke Croix: raises 300 to 400
color_singleton: folds 
JeBoyDirk: folds 
MnnM150: calls 300
dddocky: calls 300
*** FLOP *** [Tc 4c Ks]
MnnM150: checks 
dddocky: bets 876 and is all-in
Duke Croix: folds 
MnnM150: folds 
Uncalled bet (876) returned to dddocky
dddocky collected 1181 from pot
dddocky: doesn't show hand 
*** SUMMARY ***
Total pot 1250 | Rake 69 
Board [Tc 4c Ks]
Seat 1: dddocky collected (1181)
Seat 2: FragileMemory folded before Flop (didn't bet)
Seat 3: Duke Croix folded on the Flop
Seat 6: color_singleton (button) folded before Flop (didn't bet)
Seat 8: JeBoyDirk (small blind) folded before Flop
Seat 9: MnnM150 (big blind) folded on the Flop



PokerStars Home Game Hand #218089329757: {Club #3225207}  Hold'em No Limit (50/100) - 2020/09/03 17:34:56 ET
Table 'fun gamez' 9-max (Play Money) Seat #8 is the button
Seat 1: dddocky (2057 in chips) 
Seat 2: FragileMemory (12612 in chips) 
Seat 3: Duke Croix (35078 in chips) 
Seat 6: color_singleton (17234 in chips) 
Seat 8: JeBoyDirk (22656 in chips) 
Seat 9: MnnM150 (3531 in chips) 
MnnM150: posts small blind 50
dddocky: posts big blind 100
*** HOLE CARDS ***
Dealt to Duke Croix [4d 3h]
FragileMemory: folds 
Duke Croix: folds 
color_singleton: folds 
JeBoyDirk: folds 
MnnM150: calls 50
dddocky: checks 
*** FLOP *** [3c 3d 4h]
yairpinto leaves the table
MnnM150: checks 
dddocky: bets 1957 and is all-in
MnnM150: folds 
Uncalled bet (1957) returned to dddocky
dddocky collected 189 from pot
dddocky: doesn't show hand 
*** SUMMARY ***
Total pot 200 | Rake 11 
Board [3c 3d 4h]
Seat 1: dddocky (big blind) collected (189)
Seat 2: FragileMemory folded before Flop (didn't bet)
Seat 3: Duke Croix folded before Flop (didn't bet)
Seat 6: color_singleton folded before Flop (didn't bet)
Seat 8: JeBoyDirk (button) folded before Flop (didn't bet)
Seat 9: MnnM150 (small blind) folded on the Flop



PokerStars Home Game Hand #218089344319: {Club #3225207}  Hold'em No Limit (50/100) - 2020/09/03 17:35:22 ET
Table 'fun gamez' 9-max (Play Money) Seat #9 is the button
Seat 1: dddocky (2146 in chips) 
Seat 2: FragileMemory (12612 in chips) 
Seat 3: Duke Croix (35078 in chips) 
Seat 6: color_singleton (17234 in chips) 
Seat 8: JeBoyDirk (22656 in chips) 
Seat 9: MnnM150 (3431 in chips) 
dddocky: posts small blind 50
FragileMemory: posts big blind 100
*** HOLE CARDS ***
Dealt to Duke Croix [2h Jd]
Duke Croix: folds 
color_singleton: folds 
JeBoyDirk: raises 100 to 200
MnnM150: calls 200
dddocky: folds 
FragileMemory: folds 
*** FLOP *** [Ad 4s 8h]
JeBoyDirk: bets 300
MnnM150: folds 
Uncalled bet (300) returned to JeBoyDirk
JeBoyDirk collected 520 from pot
*** SUMMARY ***
Total pot 550 | Rake 30 
Board [Ad 4s 8h]
Seat 1: dddocky (small blind) folded before Flop
Seat 2: FragileMemory (big blind) folded before Flop
Seat 3: Duke Croix folded before Flop (didn't bet)
Seat 6: color_singleton folded before Flop (didn't bet)
Seat 8: JeBoyDirk collected (520)
Seat 9: MnnM150 (button) folded on the Flop



PokerStars Home Game Hand #218089369220: {Club #3225207}  Hold'em No Limit (50/100) - 2020/09/03 17:36:05 ET
Table 'fun gamez' 9-max (Play Money) Seat #1 is the button
Seat 1: dddocky (2096 in chips) 
Seat 2: FragileMemory (12512 in chips) 
Seat 3: Duke Croix (35078 in chips) 
Seat 6: color_singleton (17234 in chips) 
Seat 8: JeBoyDirk (22976 in chips) 
Seat 9: MnnM150 (3231 in chips) 
FragileMemory: posts small blind 50
Duke Croix: posts big blind 100
*** HOLE CARDS ***
Dealt to Duke Croix [Ac 8s]
color_singleton: folds 
JeBoyDirk: calls 100
MnnM150: folds 
dddocky: calls 100
FragileMemory: calls 50
Duke Croix: raises 400 to 500
JeBoyDirk: calls 400
dddocky: folds 
FragileMemory: folds 
*** FLOP *** [Th 9c 7d]
Duke Croix: bets 600
JeBoyDirk: calls 600
*** TURN *** [Th 9c 7d] [4h]
Duke Croix: bets 1200
JeBoyDirk: calls 1200
*** RIVER *** [Th 9c 7d 4h] [Js]
Duke Croix: bets 2400
JeBoyDirk: raises 3100 to 5500
Duke Croix: calls 3100
*** SHOW DOWN ***
JeBoyDirk: shows [Kh 8h] (a straight, Seven to Jack)
Duke Croix: shows [Ac 8s] (a straight, Seven to Jack)
Duke Croix collected 7466 from pot
JeBoyDirk collected 7465 from pot
*** SUMMARY ***
Total pot 15800 | Rake 869 
Board [Th 9c 7d 4h Js]
Seat 1: dddocky (button) folded before Flop
Seat 2: FragileMemory (small blind) folded before Flop
Seat 3: Duke Croix (big blind) showed [Ac 8s] and won (7466) with a straight, Seven to Jack
Seat 6: color_singleton folded before Flop (didn't bet)
Seat 8: JeBoyDirk showed [Kh 8h] and won (7465) with a straight, Seven to Jack
Seat 9: MnnM150 folded before Flop (didn't bet)



PokerStars Home Game Hand #218089403728: {Club #3225207}  Hold'em No Limit (50/100) - 2020/09/03 17:37:05 ET
Table 'fun gamez' 9-max (Play Money) Seat #2 is the button
Seat 1: dddocky (1996 in chips) 
Seat 2: FragileMemory (12412 in chips) 
Seat 3: Duke Croix (34744 in chips) 
Seat 6: color_singleton (17234 in chips) 
Seat 8: JeBoyDirk (22641 in chips) 
Seat 9: MnnM150 (3231 in chips) 
Duke Croix: posts small blind 50
color_singleton: posts big blind 100
*** HOLE CARDS ***
Dealt to Duke Croix [6s 8h]
JeBoyDirk: raises 100 to 200
MnnM150: folds 
dddocky: calls 200
FragileMemory: folds 
Duke Croix: folds 
color_singleton: calls 100
*** FLOP *** [Tc Qs 4d]
color_singleton: checks 
JeBoyDirk: bets 200
dddocky: calls 200
color_singleton: calls 200
*** TURN *** [Tc Qs 4d] [2c]
color_singleton: bets 600
JeBoyDirk: folds 
dddocky: calls 600
*** RIVER *** [Tc Qs 4d 2c] [7h]
color_singleton: bets 1157
dddocky: calls 996 and is all-in
Uncalled bet (161) returned to color_singleton
*** SHOW DOWN ***
color_singleton: shows [9h Qd] (a pair of Queens)
dddocky: shows [Kc Kd] (a pair of Kings)
dddocky collected 4198 from pot
*** SUMMARY ***
Total pot 4442 | Rake 244 
Board [Tc Qs 4d 2c 7h]
Seat 1: dddocky showed [Kc Kd] and won (4198) with a pair of Kings
Seat 2: FragileMemory (button) folded before Flop (didn't bet)
Seat 3: Duke Croix (small blind) folded before Flop
Seat 6: color_singleton (big blind) showed [9h Qd] and lost with a pair of Queens
Seat 8: JeBoyDirk folded on the Turn
Seat 9: MnnM150 folded before Flop (didn't bet)



PokerStars Home Game Hand #218089430614: {Club #3225207}  Hold'em No Limit (50/100) - 2020/09/03 17:37:52 ET
Table 'fun gamez' 9-max (Play Money) Seat #3 is the button
Seat 1: dddocky (4198 in chips) 
Seat 2: FragileMemory (12412 in chips) 
Seat 3: Duke Croix (34694 in chips) 
Seat 6: color_singleton (15238 in chips) 
Seat 8: JeBoyDirk (22241 in chips) 
Seat 9: MnnM150 (3231 in chips) 
color_singleton: posts small blind 50
JeBoyDirk: posts big blind 100
*** HOLE CARDS ***
Dealt to Duke Croix [Qh Js]
MnnM150: calls 100
dddocky: calls 100
FragileMemory: folds 
Duke Croix: raises 300 to 400
color_singleton: folds 
JeBoyDirk: folds 
MnnM150: calls 300
dddocky: calls 300
*** FLOP *** [4h Qc 2s]
MnnM150: checks 
dddocky: bets 100
Duke Croix: raises 600 to 700
MnnM150: folds 
dddocky: calls 600
*** TURN *** [4h Qc 2s] [6d]
dddocky: bets 2599
Duke Croix: raises 3898 to 6497
dddocky: calls 499 and is all-in
Uncalled bet (3399) returned to Duke Croix
*** RIVER *** [4h Qc 2s 6d] [6h]
*** SHOW DOWN ***
dddocky: shows [2c 2h] (a full house, Deuces full of Sixes)
Duke Croix: shows [Qh Js] (two pair, Queens and Sixes)
dddocky collected 8454 from pot
*** SUMMARY ***
Total pot 8946 | Rake 492 
Board [4h Qc 2s 6d 6h]
Seat 1: dddocky showed [2c 2h] and won (8454) with a full house, Deuces full of Sixes
Seat 2: FragileMemory folded before Flop (didn't bet)
Seat 3: Duke Croix (button) showed [Qh Js] and lost with two pair, Queens and Sixes
Seat 6: color_singleton (small blind) folded before Flop
Seat 8: JeBoyDirk (big blind) folded before Flop
Seat 9: MnnM150 folded on the Flop



PokerStars Home Game Hand #218089457389: {Club #3225207}  Hold'em No Limit (50/100) - 2020/09/03 17:38:39 ET
Table 'fun gamez' 9-max (Play Money) Seat #6 is the button
Seat 1: dddocky (8454 in chips) 
Seat 2: FragileMemory (12412 in chips) 
Seat 3: Duke Croix (30496 in chips) 
Seat 6: color_singleton (15188 in chips) 
Seat 8: JeBoyDirk (22141 in chips) 
Seat 9: MnnM150 (2831 in chips) 
JeBoyDirk: posts small blind 50
MnnM150: posts big blind 100
*** HOLE CARDS ***
Dealt to Duke Croix [5s Th]
dddocky: calls 100
FragileMemory: raises 100 to 200
Duke Croix: folds 
color_singleton: folds 
JeBoyDirk: folds 
MnnM150: calls 100
dddocky: calls 100
*** FLOP *** [8c 2h Ks]
MnnM150: bets 100
dddocky: folds 
FragileMemory: calls 100
*** TURN *** [8c 2h Ks] [7c]
MnnM150: bets 401
FragileMemory: folds 
Uncalled bet (401) returned to MnnM150
MnnM150 collected 803 from pot
*** SUMMARY ***
Total pot 850 | Rake 47 
Board [8c 2h Ks 7c]
Seat 1: dddocky folded on the Flop
Seat 2: FragileMemory folded on the Turn
Seat 3: Duke Croix folded before Flop (didn't bet)
Seat 6: color_singleton (button) folded before Flop (didn't bet)
Seat 8: JeBoyDirk (small blind) folded before Flop
Seat 9: MnnM150 (big blind) collected (803)



PokerStars Home Game Hand #218089488235: {Club #3225207}  Hold'em No Limit (50/100) - 2020/09/03 17:39:16 ET
Table 'fun gamez' 9-max (Play Money) Seat #8 is the button
Seat 1: dddocky (8254 in chips) 
Seat 2: FragileMemory (12112 in chips) 
Seat 3: Duke Croix (30496 in chips) 
Seat 6: color_singleton (15188 in chips) 
Seat 8: JeBoyDirk (22091 in chips) 
Seat 9: MnnM150 (3334 in chips) 
MnnM150: posts small blind 50
dddocky: posts big blind 100
*** HOLE CARDS ***
Dealt to Duke Croix [8d 3c]
FragileMemory: calls 100
Duke Croix: folds 
color_singleton: folds 
JeBoyDirk: calls 100
MnnM150: folds 
dddocky: checks 
*** FLOP *** [Kc Ks 4s]
dddocky: checks 
FragileMemory: checks 
JeBoyDirk: checks 
*** TURN *** [Kc Ks 4s] [Jc]
dddocky: checks 
FragileMemory: checks 
JeBoyDirk: checks 
*** RIVER *** [Kc Ks 4s Jc] [3s]
dddocky: checks 
FragileMemory: checks 
JeBoyDirk: checks 
*** SHOW DOWN ***
dddocky: shows [5c Ac] (a pair of Kings)
FragileMemory: mucks hand 
JeBoyDirk: mucks hand 
dddocky collected 331 from pot
*** SUMMARY ***
Total pot 350 | Rake 19 
Board [Kc Ks 4s Jc 3s]
Seat 1: dddocky (big blind) showed [5c Ac] and won (331) with a pair of Kings
Seat 2: FragileMemory mucked [7h 9h]
Seat 3: Duke Croix folded before Flop (didn't bet)
Seat 6: color_singleton folded before Flop (didn't bet)
Seat 8: JeBoyDirk (button) mucked [2h Ah]
Seat 9: MnnM150 (small blind) folded before Flop



PokerStars Home Game Hand #218089506138: {Club #3225207}  Hold'em No Limit (50/100) - 2020/09/03 17:39:47 ET
Table 'fun gamez' 9-max (Play Money) Seat #9 is the button
Seat 1: dddocky (8485 in chips) 
Seat 2: FragileMemory (12012 in chips) 
Seat 3: Duke Croix (30496 in chips) 
Seat 6: color_singleton (15188 in chips) 
Seat 8: JeBoyDirk (21991 in chips) 
Seat 9: MnnM150 (3284 in chips) 
dddocky: posts small blind 50
FragileMemory: posts big blind 100
*** HOLE CARDS ***
Dealt to Duke Croix [Kh 2s]
Duke Croix: folds 
color_singleton: calls 100
JeBoyDirk: calls 100
MnnM150: calls 100
dddocky: calls 50
FragileMemory: checks 
*** FLOP *** [3h 9c Kd]
dddocky: bets 100
FragileMemory: folds 
color_singleton: folds 
JeBoyDirk: folds 
MnnM150: calls 100
*** TURN *** [3h 9c Kd] [Qh]
dddocky: bets 661
MnnM150: folds 
Uncalled bet (661) returned to dddocky
dddocky collected 661 from pot
dddocky: doesn't show hand 
*** SUMMARY ***
Total pot 700 | Rake 39 
Board [3h 9c Kd Qh]
Seat 1: dddocky (small blind) collected (661)
Seat 2: FragileMemory (big blind) folded on the Flop
Seat 3: Duke Croix folded before Flop (didn't bet)
Seat 6: color_singleton folded on the Flop
Seat 8: JeBoyDirk folded on the Flop
Seat 9: MnnM150 (button) folded on the Turn



PokerStars Home Game Hand #218089536823: {Club #3225207}  Hold'em No Limit (50/100) - 2020/09/03 17:40:31 ET
Table 'fun gamez' 9-max (Play Money) Seat #1 is the button
Seat 1: dddocky (8946 in chips) 
Seat 2: FragileMemory (11912 in chips) 
Seat 3: Duke Croix (30496 in chips) 
Seat 6: color_singleton (15088 in chips) 
Seat 8: JeBoyDirk (21891 in chips) 
Seat 9: MnnM150 (3084 in chips) 
FragileMemory: posts small blind 50
Duke Croix: posts big blind 100
*** HOLE CARDS ***
Dealt to Duke Croix [9h Qd]
color_singleton: folds 
JeBoyDirk: folds 
MnnM150: calls 100
dddocky: folds 
FragileMemory: folds 
Duke Croix: raises 300 to 400
MnnM150: calls 300
*** FLOP *** [3s 7h Qh]
Duke Croix: bets 500
MnnM150: folds 
Uncalled bet (500) returned to Duke Croix
Duke Croix collected 803 from pot
*** SUMMARY ***
Total pot 850 | Rake 47 
Board [3s 7h Qh]
Seat 1: dddocky (button) folded before Flop (didn't bet)
Seat 2: FragileMemory (small blind) folded before Flop
Seat 3: Duke Croix (big blind) collected (803)
Seat 6: color_singleton folded before Flop (didn't bet)
Seat 8: JeBoyDirk folded before Flop (didn't bet)
Seat 9: MnnM150 folded on the Flop



PokerStars Home Game Hand #218089552174: {Club #3225207}  Hold'em No Limit (50/100) - 2020/09/03 17:40:58 ET
Table 'fun gamez' 9-max (Play Money) Seat #2 is the button
Seat 1: dddocky (8946 in chips) 
Seat 2: FragileMemory (11862 in chips) 
Seat 3: Duke Croix (30899 in chips) 
Seat 6: color_singleton (15088 in chips) 
Seat 8: JeBoyDirk (21891 in chips) 
Seat 9: MnnM150 (2684 in chips) 
Duke Croix: posts small blind 50
color_singleton: posts big blind 100
*** HOLE CARDS ***
Dealt to Duke Croix [5c 7c]
JeBoyDirk: folds 
MnnM150: calls 100
dddocky: calls 100
FragileMemory: folds 
Duke Croix: calls 50
color_singleton: checks 
*** FLOP *** [8c Kd Td]
Duke Croix: checks 
color_singleton: checks 
MnnM150: checks 
dddocky: bets 100
Duke Croix: folds 
color_singleton: folds 
MnnM150: calls 100
*** TURN *** [8c Kd Td] [8h]
MnnM150: checks 
dddocky: bets 567
MnnM150: folds 
Uncalled bet (567) returned to dddocky
dddocky collected 567 from pot
dddocky: doesn't show hand 
*** SUMMARY ***
Total pot 600 | Rake 33 
Board [8c Kd Td 8h]
Seat 1: dddocky collected (567)
Seat 2: FragileMemory (button) folded before Flop (didn't bet)
Seat 3: Duke Croix (small blind) folded on the Flop
Seat 6: color_singleton (big blind) folded on the Flop
Seat 8: JeBoyDirk folded before Flop (didn't bet)
Seat 9: MnnM150 folded on the Turn



PokerStars Home Game Hand #218089579040: {Club #3225207}  Hold'em No Limit (50/100) - 2020/09/03 17:41:47 ET
Table 'fun gamez' 9-max (Play Money) Seat #3 is the button
Seat 1: dddocky (9313 in chips) 
Seat 2: FragileMemory (11862 in chips) 
Seat 3: Duke Croix (30799 in chips) 
Seat 6: color_singleton (14988 in chips) 
Seat 8: JeBoyDirk (21891 in chips) 
Seat 9: MnnM150 (2484 in chips) 
color_singleton: posts small blind 50
JeBoyDirk: posts big blind 100
*** HOLE CARDS ***
Dealt to Duke Croix [Kh 6s]
MnnM150: calls 100
dddocky: calls 100
FragileMemory: folds 
Duke Croix: folds 
color_singleton: calls 50
JeBoyDirk: checks 
*** FLOP *** [6c Kc 3d]
color_singleton: checks 
JeBoyDirk: checks 
MnnM150: bets 189
dddocky: calls 189
color_singleton: calls 189
JeBoyDirk: calls 189
*** TURN *** [6c Kc 3d] [Qs]
color_singleton: checks 
JeBoyDirk: checks 
MnnM150: bets 546
dddocky: folds 
color_singleton: folds 
JeBoyDirk: folds 
Uncalled bet (546) returned to MnnM150
MnnM150 collected 1092 from pot
*** SUMMARY ***
Total pot 1156 | Rake 64 
Board [6c Kc 3d Qs]
Seat 1: dddocky folded on the Turn
Seat 2: FragileMemory folded before Flop (didn't bet)
Seat 3: Duke Croix (button) folded before Flop (didn't bet)
Seat 6: color_singleton (small blind) folded on the Turn
Seat 8: JeBoyDirk (big blind) folded on the Turn
Seat 9: MnnM150 collected (1092)



PokerStars Home Game Hand #218089599122: {Club #3225207}  Hold'em No Limit (50/100) - 2020/09/03 17:42:23 ET
Table 'fun gamez' 9-max (Play Money) Seat #6 is the button
Seat 1: dddocky (9024 in chips) 
Seat 2: FragileMemory (11862 in chips) 
Seat 3: Duke Croix (30799 in chips) 
Seat 6: color_singleton (14699 in chips) 
Seat 8: JeBoyDirk (21602 in chips) 
Seat 9: MnnM150 (3287 in chips) 
JeBoyDirk: posts small blind 50
MnnM150: posts big blind 100
*** HOLE CARDS ***
Dealt to Duke Croix [9h Ts]
dddocky: folds 
FragileMemory: calls 100
Duke Croix: raises 300 to 400
color_singleton: folds 
JeBoyDirk: calls 350
MnnM150: folds 
FragileMemory: folds 
*** FLOP *** [Kd Jh 7c]
JeBoyDirk: bets 400
Duke Croix: calls 400
*** TURN *** [Kd Jh 7c] [Ac]
JeBoyDirk: checks 
Duke Croix: bets 1000
JeBoyDirk: folds 
Uncalled bet (1000) returned to Duke Croix
Duke Croix collected 1701 from pot
*** SUMMARY ***
Total pot 1800 | Rake 99 
Board [Kd Jh 7c Ac]
Seat 1: dddocky folded before Flop (didn't bet)
Seat 2: FragileMemory folded before Flop
Seat 3: Duke Croix collected (1701)
Seat 6: color_singleton (button) folded before Flop (didn't bet)
Seat 8: JeBoyDirk (small blind) folded on the Turn
Seat 9: MnnM150 (big blind) folded before Flop



PokerStars Home Game Hand #218089625589: {Club #3225207}  Hold'em No Limit (50/100) - 2020/09/03 17:43:10 ET
Table 'fun gamez' 9-max (Play Money) Seat #8 is the button
Seat 1: dddocky (9024 in chips) 
Seat 2: FragileMemory (11762 in chips) 
Seat 3: Duke Croix (31700 in chips) 
Seat 6: color_singleton (14699 in chips) 
Seat 8: JeBoyDirk (20802 in chips) 
Seat 9: MnnM150 (3187 in chips) 
MnnM150: posts small blind 50
dddocky: posts big blind 100
*** HOLE CARDS ***
Dealt to Duke Croix [6s 7d]
FragileMemory: folds 
Duke Croix: raises 200 to 300
color_singleton: calls 300
JeBoyDirk: folds 
MnnM150: calls 250
dddocky: calls 200
*** FLOP *** [Qh Qd Kh]
MnnM150: checks 
dddocky: checks 
Duke Croix: checks 
color_singleton: checks 
*** TURN *** [Qh Qd Kh] [Ah]
MnnM150: checks 
dddocky: checks 
Duke Croix: checks 
color_singleton: bets 567
MnnM150: folds 
dddocky: folds 
Duke Croix: folds 
Uncalled bet (567) returned to color_singleton
color_singleton collected 1134 from pot
color_singleton: doesn't show hand 
*** SUMMARY ***
Total pot 1200 | Rake 66 
Board [Qh Qd Kh Ah]
Seat 1: dddocky (big blind) folded on the Turn
Seat 2: FragileMemory folded before Flop (didn't bet)
Seat 3: Duke Croix folded on the Turn
Seat 6: color_singleton collected (1134)
Seat 8: JeBoyDirk (button) folded before Flop (didn't bet)
Seat 9: MnnM150 (small blind) folded on the Turn



PokerStars Home Game Hand #218089652389: {Club #3225207}  Hold'em No Limit (50/100) - 2020/09/03 17:43:59 ET
Table 'fun gamez' 9-max (Play Money) Seat #9 is the button
Seat 1: dddocky (8724 in chips) 
Seat 2: FragileMemory (11762 in chips) 
Seat 3: Duke Croix (31400 in chips) 
Seat 6: color_singleton (15533 in chips) 
Seat 8: JeBoyDirk (20802 in chips) 
Seat 9: MnnM150 (2887 in chips) 
dddocky: posts small blind 50
FragileMemory: posts big blind 100
*** HOLE CARDS ***
Dealt to Duke Croix [Ac 6c]
Duke Croix: raises 200 to 300
color_singleton: folds 
JeBoyDirk: calls 300
MnnM150: folds 
dddocky: calls 250
FragileMemory: folds 
*** FLOP *** [4s Th Kd]
dddocky: checks 
Duke Croix: checks 
JeBoyDirk: checks 
*** TURN *** [4s Th Kd] [Qd]
dddocky: bets 100
Duke Croix: folds 
JeBoyDirk: calls 100
*** RIVER *** [4s Th Kd Qd] [Kh]
dddocky: bets 567
JeBoyDirk: folds 
Uncalled bet (567) returned to dddocky
dddocky collected 1134 from pot
dddocky: doesn't show hand 
*** SUMMARY ***
Total pot 1200 | Rake 66 
Board [4s Th Kd Qd Kh]
Seat 1: dddocky (small blind) collected (1134)
Seat 2: FragileMemory (big blind) folded before Flop
Seat 3: Duke Croix folded on the Turn
Seat 6: color_singleton folded before Flop (didn't bet)
Seat 8: JeBoyDirk folded on the River
Seat 9: MnnM150 (button) folded before Flop (didn't bet)



PokerStars Home Game Hand #218089671750: {Club #3225207}  Hold'em No Limit (50/100) - 2020/09/03 17:44:33 ET
Table 'fun gamez' 9-max (Play Money) Seat #1 is the button
Seat 1: dddocky (9458 in chips) 
Seat 2: FragileMemory (11662 in chips) 
Seat 3: Duke Croix (31100 in chips) 
Seat 6: color_singleton (15533 in chips) 
Seat 8: JeBoyDirk (20402 in chips) 
Seat 9: MnnM150 (2887 in chips) 
FragileMemory: posts small blind 50
Duke Croix: posts big blind 100
*** HOLE CARDS ***
Dealt to Duke Croix [2c Td]
color_singleton: folds 
JeBoyDirk: folds 
MnnM150: calls 100
dddocky: calls 100
FragileMemory: folds 
Duke Croix: checks 
*** FLOP *** [4s Kd 9h]
Duke Croix: checks 
MnnM150: checks 
dddocky: checks 
*** TURN *** [4s Kd 9h] [3c]
Duke Croix: checks 
MnnM150: checks 
dddocky: checks 
*** RIVER *** [4s Kd 9h 3c] [3h]
Duke Croix: checks 
MnnM150: checks 
dddocky: checks 
*** SHOW DOWN ***
Duke Croix: shows [2c Td] (a pair of Threes)
MnnM150: shows [Tc Qd] (a pair of Threes - King+Queen kicker)
dddocky: mucks hand 
MnnM150 collected 331 from pot
*** SUMMARY ***
Total pot 350 | Rake 19 
Board [4s Kd 9h 3c 3h]
Seat 1: dddocky (button) mucked [Jc 2s]
Seat 2: FragileMemory (small blind) folded before Flop
Seat 3: Duke Croix (big blind) showed [2c Td] and lost with a pair of Threes
Seat 6: color_singleton folded before Flop (didn't bet)
Seat 8: JeBoyDirk folded before Flop (didn't bet)
Seat 9: MnnM150 showed [Tc Qd] and won (331) with a pair of Threes



PokerStars Home Game Hand #218089690093: {Club #3225207}  Hold'em No Limit (50/100) - 2020/09/03 17:45:06 ET
Table 'fun gamez' 9-max (Play Money) Seat #2 is the button
Seat 1: dddocky (9358 in chips) 
Seat 2: FragileMemory (11612 in chips) 
Seat 3: Duke Croix (31000 in chips) 
Seat 6: color_singleton (15533 in chips) 
Seat 8: JeBoyDirk (20402 in chips) 
Seat 9: MnnM150 (3118 in chips) 
Duke Croix: posts small blind 50
color_singleton: posts big blind 100
*** HOLE CARDS ***
Dealt to Duke Croix [As 2s]
JeBoyDirk: folds 
MnnM150: calls 100
dddocky: calls 100
FragileMemory: calls 100
Duke Croix: calls 50
color_singleton: checks 
*** FLOP *** [2c 2d Tc]
Duke Croix: checks 
color_singleton: checks 
MnnM150: checks 
dddocky: checks 
FragileMemory: checks 
*** TURN *** [2c 2d Tc] [Qc]
Duke Croix: bets 300
color_singleton: folds 
MnnM150: folds 
dddocky: folds 
FragileMemory: folds 
Uncalled bet (300) returned to Duke Croix
Duke Croix collected 472 from pot
*** SUMMARY ***
Total pot 500 | Rake 28 
Board [2c 2d Tc Qc]
Seat 1: dddocky folded on the Turn
Seat 2: FragileMemory (button) folded on the Turn
Seat 3: Duke Croix (small blind) collected (472)
Seat 6: color_singleton (big blind) folded on the Turn
Seat 8: JeBoyDirk folded before Flop (didn't bet)
Seat 9: MnnM150 folded on the Turn



PokerStars Home Game Hand #218089709947: {Club #3225207}  Hold'em No Limit (50/100) - 2020/09/03 17:45:41 ET
Table 'fun gamez' 9-max (Play Money) Seat #3 is the button
Seat 1: dddocky (9258 in chips) 
Seat 2: FragileMemory (11512 in chips) 
Seat 3: Duke Croix (31372 in chips) 
Seat 6: color_singleton (15433 in chips) 
Seat 8: JeBoyDirk (20402 in chips) 
Seat 9: MnnM150 (3018 in chips) 
color_singleton: posts small blind 50
JeBoyDirk: posts big blind 100
*** HOLE CARDS ***
Dealt to Duke Croix [7s 6h]
MnnM150: folds 
dddocky: calls 100
FragileMemory: calls 100
Duke Croix: raises 300 to 400
color_singleton: folds 
JeBoyDirk: calls 300
dddocky: calls 300
FragileMemory: calls 300
*** FLOP *** [2c 8h 4h]
JeBoyDirk: checks 
dddocky: checks 
FragileMemory: checks 
Duke Croix: checks 
*** TURN *** [2c 8h 4h] [Js]
JeBoyDirk: checks 
dddocky: checks 
FragileMemory: checks 
Duke Croix: checks 
*** RIVER *** [2c 8h 4h Js] [Ah]
JeBoyDirk: checks 
dddocky: checks 
FragileMemory: checks 
Duke Croix: checks 
*** SHOW DOWN ***
JeBoyDirk: shows [Qs 4s] (a pair of Fours)
dddocky: mucks hand 
FragileMemory: mucks hand 
Duke Croix: mucks hand 
JeBoyDirk collected 1559 from pot
*** SUMMARY ***
Total pot 1650 | Rake 91 
Board [2c 8h 4h Js Ah]
Seat 1: dddocky mucked [Ks 2s]
Seat 2: FragileMemory mucked [4d 6d]
Seat 3: Duke Croix (button) mucked [7s 6h]
Seat 6: color_singleton (small blind) folded before Flop
Seat 8: JeBoyDirk (big blind) showed [Qs 4s] and won (1559) with a pair of Fours
Seat 9: MnnM150 folded before Flop (didn't bet)



PokerStars Home Game Hand #218089734875: {Club #3225207}  Hold'em No Limit (50/100) - 2020/09/03 17:46:26 ET
Table 'fun gamez' 9-max (Play Money) Seat #6 is the button
Seat 1: dddocky (8858 in chips) 
Seat 2: FragileMemory (11112 in chips) 
Seat 3: Duke Croix (30972 in chips) 
Seat 6: color_singleton (15383 in chips) 
Seat 8: JeBoyDirk (21561 in chips) 
Seat 9: MnnM150 (3018 in chips) 
JeBoyDirk: posts small blind 50
MnnM150: posts big blind 100
*** HOLE CARDS ***
Dealt to Duke Croix [5s Qs]
dddocky: calls 100
FragileMemory: folds 
Duke Croix: folds 
color_singleton: folds 
JeBoyDirk: folds 
MnnM150: checks 
*** FLOP *** [2s 4s Th]
MnnM150: checks 
dddocky: bets 236
MnnM150: folds 
Uncalled bet (236) returned to dddocky
dddocky collected 236 from pot
dddocky: doesn't show hand 
*** SUMMARY ***
Total pot 250 | Rake 14 
Board [2s 4s Th]
Seat 1: dddocky collected (236)
Seat 2: FragileMemory folded before Flop (didn't bet)
Seat 3: Duke Croix folded before Flop (didn't bet)
Seat 6: color_singleton (button) folded before Flop (didn't bet)
Seat 8: JeBoyDirk (small blind) folded before Flop
Seat 9: MnnM150 (big blind) folded on the Flop



PokerStars Home Game Hand #218089744431: {Club #3225207}  Hold'em No Limit (50/100) - 2020/09/03 17:46:43 ET
Table 'fun gamez' 9-max (Play Money) Seat #8 is the button
Seat 1: dddocky (8994 in chips) 
Seat 2: FragileMemory (11112 in chips) 
Seat 3: Duke Croix (30972 in chips) 
Seat 6: color_singleton (15383 in chips) 
Seat 8: JeBoyDirk (21511 in chips) 
Seat 9: MnnM150 (2918 in chips) 
MnnM150: posts small blind 50
dddocky: posts big blind 100
*** HOLE CARDS ***
Dealt to Duke Croix [Ac Kh]
FragileMemory: folds 
Duke Croix: raises 300 to 400
color_singleton: calls 400
JeBoyDirk: folds 
MnnM150: folds 
dddocky: calls 300
*** FLOP *** [6h 3h 6c]
dddocky: checks 
Duke Croix: checks 
color_singleton: bets 590
dddocky: folds 
Duke Croix: folds 
Uncalled bet (590) returned to color_singleton
color_singleton collected 1181 from pot
color_singleton: doesn't show hand 
*** SUMMARY ***
Total pot 1250 | Rake 69 
Board [6h 3h 6c]
Seat 1: dddocky (big blind) folded on the Flop
Seat 2: FragileMemory folded before Flop (didn't bet)
Seat 3: Duke Croix folded on the Flop
Seat 6: color_singleton collected (1181)
Seat 8: JeBoyDirk (button) folded before Flop (didn't bet)
Seat 9: MnnM150 (small blind) folded before Flop



PokerStars Home Game Hand #218089765164: {Club #3225207}  Hold'em No Limit (50/100) - 2020/09/03 17:47:21 ET
Table 'fun gamez' 9-max (Play Money) Seat #9 is the button
Seat 1: dddocky (8594 in chips) 
Seat 2: FragileMemory (11112 in chips) 
Seat 3: Duke Croix (30572 in chips) 
Seat 6: color_singleton (16164 in chips) 
Seat 8: JeBoyDirk (21511 in chips) 
Seat 9: MnnM150 (2868 in chips) 
dddocky: posts small blind 50
FragileMemory: posts big blind 100
*** HOLE CARDS ***
Dealt to Duke Croix [Kc 5d]
Duke Croix: folds 
color_singleton: raises 100 to 200
JeBoyDirk: calls 200
MnnM150: calls 200
dddocky: folds 
FragileMemory: folds 
*** FLOP *** [Ts 3d 5c]
color_singleton: checks 
JeBoyDirk: checks 
MnnM150: checks 
*** TURN *** [Ts 3d 5c] [Jh]
color_singleton: bets 354
JeBoyDirk: folds 
MnnM150: folds 
Uncalled bet (354) returned to color_singleton
color_singleton collected 709 from pot
color_singleton: doesn't show hand 
*** SUMMARY ***
Total pot 750 | Rake 41 
Board [Ts 3d 5c Jh]
Seat 1: dddocky (small blind) folded before Flop
Seat 2: FragileMemory (big blind) folded before Flop
Seat 3: Duke Croix folded before Flop (didn't bet)
Seat 6: color_singleton collected (709)
Seat 8: JeBoyDirk folded on the Turn
Seat 9: MnnM150 (button) folded on the Turn



PokerStars Home Game Hand #218089779360: {Club #3225207}  Hold'em No Limit (50/100) - 2020/09/03 17:47:47 ET
Table 'fun gamez' 9-max (Play Money) Seat #1 is the button
Seat 1: dddocky (8544 in chips) 
Seat 2: FragileMemory (11012 in chips) 
Seat 3: Duke Croix (30572 in chips) 
Seat 6: color_singleton (16673 in chips) 
Seat 8: JeBoyDirk (21311 in chips) 
Seat 9: MnnM150 (2668 in chips) 
FragileMemory: posts small blind 50
Duke Croix: posts big blind 100
*** HOLE CARDS ***
Dealt to Duke Croix [6d Jd]
color_singleton: folds 
JeBoyDirk: folds 
MnnM150: folds 
dddocky: calls 100
FragileMemory: calls 50
Duke Croix: checks 
*** FLOP *** [2h 4s Qs]
FragileMemory: checks 
Duke Croix: checks 
dddocky: checks 
*** TURN *** [2h 4s Qs] [Ts]
FragileMemory: checks 
Duke Croix: checks 
dddocky: checks 
*** RIVER *** [2h 4s Qs Ts] [7h]
FragileMemory: checks 
Duke Croix: checks 
dddocky: checks 
*** SHOW DOWN ***
FragileMemory: shows [6c 9c] (high card Queen)
Duke Croix: shows [6d Jd] (high card Queen - Jack kicker)
dddocky: shows [5c Ks] (high card King)
dddocky collected 283 from pot
*** SUMMARY ***
Total pot 300 | Rake 17 
Board [2h 4s Qs Ts 7h]
Seat 1: dddocky (button) showed [5c Ks] and won (283) with high card King
Seat 2: FragileMemory (small blind) showed [6c 9c] and lost with high card Queen
Seat 3: Duke Croix (big blind) showed [6d Jd] and lost with high card Queen
Seat 6: color_singleton folded before Flop (didn't bet)
Seat 8: JeBoyDirk folded before Flop (didn't bet)
Seat 9: MnnM150 folded before Flop (didn't bet)



PokerStars Home Game Hand #218089791718: {Club #3225207}  Hold'em No Limit (50/100) - 2020/09/03 17:48:09 ET
Table 'fun gamez' 9-max (Play Money) Seat #2 is the button
Seat 1: dddocky (8727 in chips) 
Seat 2: FragileMemory (10912 in chips) 
Seat 3: Duke Croix (30472 in chips) 
Seat 6: color_singleton (16673 in chips) 
Seat 8: JeBoyDirk (21311 in chips) 
Seat 9: MnnM150 (2668 in chips) 
Duke Croix: posts small blind 50
color_singleton: posts big blind 100
*** HOLE CARDS ***
Dealt to Duke Croix [5h Ts]
JeBoyDirk: raises 300 to 400
MnnM150: folds 
dddocky: calls 400
FragileMemory: folds 
Duke Croix: folds 
color_singleton: calls 300
*** FLOP *** [8s Kh 3c]
color_singleton: bets 590
JeBoyDirk: raises 590 to 1180
dddocky: folds 
color_singleton: folds 
Uncalled bet (590) returned to JeBoyDirk
JeBoyDirk collected 2296 from pot
*** SUMMARY ***
Total pot 2430 | Rake 134 
Board [8s Kh 3c]
Seat 1: dddocky folded on the Flop
Seat 2: FragileMemory (button) folded before Flop (didn't bet)
Seat 3: Duke Croix (small blind) folded before Flop
Seat 6: color_singleton (big blind) folded on the Flop
Seat 8: JeBoyDirk collected (2296)
Seat 9: MnnM150 folded before Flop (didn't bet)



PokerStars Home Game Hand #218089806980: {Club #3225207}  Hold'em No Limit (50/100) - 2020/09/03 17:48:37 ET
Table 'fun gamez' 9-max (Play Money) Seat #3 is the button
Seat 1: dddocky (8327 in chips) 
Seat 2: FragileMemory (10912 in chips) 
Seat 3: Duke Croix (30422 in chips) 
Seat 6: color_singleton (15683 in chips) 
Seat 8: JeBoyDirk (22617 in chips) 
Seat 9: MnnM150 (2668 in chips) 
color_singleton: posts small blind 50
JeBoyDirk: posts big blind 100
*** HOLE CARDS ***
Dealt to Duke Croix [5s Ad]
MnnM150: calls 100
dddocky: calls 100
FragileMemory: folds 
Duke Croix: calls 100
color_singleton: folds 
JeBoyDirk: checks 
*** FLOP *** [8h 9d Td]
JeBoyDirk: checks 
MnnM150: checks 
dddocky: checks 
Duke Croix: checks 
*** TURN *** [8h 9d Td] [Qd]
JeBoyDirk: checks 
MnnM150: bets 212
dddocky: calls 212
Duke Croix: folds 
JeBoyDirk: calls 212
*** RIVER *** [8h 9d Td Qd] [5d]
JeBoyDirk: checks 
MnnM150: bets 1026
dddocky: folds 
JeBoyDirk: folds 
Uncalled bet (1026) returned to MnnM150
MnnM150 collected 1026 from pot
*** SUMMARY ***
Total pot 1086 | Rake 60 
Board [8h 9d Td Qd 5d]
Seat 1: dddocky folded on the River
Seat 2: FragileMemory folded before Flop (didn't bet)
Seat 3: Duke Croix (button) folded on the Turn
Seat 6: color_singleton (small blind) folded before Flop
Seat 8: JeBoyDirk (big blind) folded on the River
Seat 9: MnnM150 collected (1026)



PokerStars Home Game Hand #218089834196: {Club #3225207}  Hold'em No Limit (50/100) - 2020/09/03 17:49:27 ET
Table 'fun gamez' 9-max (Play Money) Seat #6 is the button
Seat 1: dddocky (8015 in chips) 
Seat 2: FragileMemory (10912 in chips) 
Seat 3: Duke Croix (30322 in chips) 
Seat 6: color_singleton (15633 in chips) 
Seat 8: JeBoyDirk (22305 in chips) 
Seat 9: MnnM150 (3382 in chips) 
JeBoyDirk: posts small blind 50
MnnM150: posts big blind 100
*** HOLE CARDS ***
Dealt to Duke Croix [Jd 3c]
dddocky: calls 100
FragileMemory: calls 100
Duke Croix: folds 
color_singleton: calls 100
JeBoyDirk: calls 50
MnnM150: checks 
*** FLOP *** [Jc 2h Ac]
JeBoyDirk: checks 
MnnM150: checks 
dddocky: checks 
FragileMemory: checks 
color_singleton: checks 
*** TURN *** [Jc 2h Ac] [Qs]
JeBoyDirk: checks 
MnnM150: checks 
dddocky: checks 
FragileMemory: checks 
color_singleton: checks 
*** RIVER *** [Jc 2h Ac Qs] [Qc]
JeBoyDirk: checks 
MnnM150: checks 
dddocky: bets 472
FragileMemory: folds 
color_singleton: folds 
JeBoyDirk: folds 
MnnM150: folds 
Uncalled bet (472) returned to dddocky
dddocky collected 472 from pot
dddocky: doesn't show hand 
*** SUMMARY ***
Total pot 500 | Rake 28 
Board [Jc 2h Ac Qs Qc]
Seat 1: dddocky collected (472)
Seat 2: FragileMemory folded on the River
Seat 3: Duke Croix folded before Flop (didn't bet)
Seat 6: color_singleton (button) folded on the River
Seat 8: JeBoyDirk (small blind) folded on the River
Seat 9: MnnM150 (big blind) folded on the River



PokerStars Home Game Hand #218089860771: {Club #3225207}  Hold'em No Limit (50/100) - 2020/09/03 17:50:16 ET
Table 'fun gamez' 9-max (Play Money) Seat #8 is the button
Seat 1: dddocky (8387 in chips) 
Seat 2: FragileMemory (10812 in chips) 
Seat 3: Duke Croix (30322 in chips) 
Seat 6: color_singleton (15533 in chips) 
Seat 8: JeBoyDirk (22205 in chips) 
Seat 9: MnnM150 (3282 in chips) 
MnnM150: posts small blind 50
dddocky: posts big blind 100
*** HOLE CARDS ***
Dealt to Duke Croix [8h Ac]
FragileMemory: folds 
Duke Croix: raises 200 to 300
color_singleton: folds 
JeBoyDirk: calls 300
MnnM150: folds 
dddocky: calls 200
*** FLOP *** [Qc 7c 4s]
dddocky: bets 100
Duke Croix: calls 100
JeBoyDirk: calls 100
*** TURN *** [Qc 7c 4s] [5h]
dddocky: bets 590
Duke Croix: folds 
JeBoyDirk: folds 
Uncalled bet (590) returned to dddocky
dddocky collected 1181 from pot
dddocky: doesn't show hand 
*** SUMMARY ***
Total pot 1250 | Rake 69 
Board [Qc 7c 4s 5h]
Seat 1: dddocky (big blind) collected (1181)
Seat 2: FragileMemory folded before Flop (didn't bet)
Seat 3: Duke Croix folded on the Turn
Seat 6: color_singleton folded before Flop (didn't bet)
Seat 8: JeBoyDirk (button) folded on the Turn
Seat 9: MnnM150 (small blind) folded before Flop



PokerStars Home Game Hand #218089880887: {Club #3225207}  Hold'em No Limit (50/100) - 2020/09/03 17:50:53 ET
Table 'fun gamez' 9-max (Play Money) Seat #9 is the button
Seat 1: dddocky (9168 in chips) 
Seat 2: FragileMemory (10812 in chips) 
Seat 3: Duke Croix (29922 in chips) 
Seat 6: color_singleton (15533 in chips) 
Seat 8: JeBoyDirk (21805 in chips) 
Seat 9: MnnM150 (3232 in chips) 
dddocky: posts small blind 50
FragileMemory: posts big blind 100
*** HOLE CARDS ***
Dealt to Duke Croix [Tc 2h]
Duke Croix: folds 
color_singleton: raises 100 to 200
JeBoyDirk: folds 
MnnM150: calls 200
dddocky: folds 
FragileMemory: calls 100
*** FLOP *** [4d Qs Ks]
FragileMemory: checks 
color_singleton: bets 400
MnnM150: calls 400
FragileMemory: folds 
*** TURN *** [4d Qs Ks] [2c]
color_singleton: bets 685
MnnM150: folds 
Uncalled bet (685) returned to color_singleton
color_singleton collected 1370 from pot
color_singleton: doesn't show hand 
*** SUMMARY ***
Total pot 1450 | Rake 80 
Board [4d Qs Ks 2c]
Seat 1: dddocky (small blind) folded before Flop
Seat 2: FragileMemory (big blind) folded on the Flop
Seat 3: Duke Croix folded before Flop (didn't bet)
Seat 6: color_singleton collected (1370)
Seat 8: JeBoyDirk folded before Flop (didn't bet)
Seat 9: MnnM150 (button) folded on the Turn



PokerStars Home Game Hand #218089896326: {Club #3225207}  Hold'em No Limit (50/100) - 2020/09/03 17:51:22 ET
Table 'fun gamez' 9-max (Play Money) Seat #1 is the button
Seat 1: dddocky (9118 in chips) 
Seat 2: FragileMemory (10612 in chips) 
Seat 3: Duke Croix (29922 in chips) 
Seat 6: color_singleton (16303 in chips) 
Seat 8: JeBoyDirk (21805 in chips) 
Seat 9: MnnM150 (2632 in chips) 
FragileMemory: posts small blind 50
Duke Croix: posts big blind 100
*** HOLE CARDS ***
Dealt to Duke Croix [7h 9h]
color_singleton: folds 
JeBoyDirk: folds 
MnnM150: folds 
dddocky: calls 100
FragileMemory: calls 50
Duke Croix: checks 
*** FLOP *** [8d 5d 6c]
FragileMemory: checks 
Duke Croix: bets 100
dddocky: folds 
FragileMemory: calls 100
*** TURN *** [8d 5d 6c] [Th]
FragileMemory: checks 
Duke Croix: bets 300
FragileMemory: calls 300
*** RIVER *** [8d 5d 6c Th] [7d]
FragileMemory: bets 519
Duke Croix: raises 581 to 1100
FragileMemory: calls 581
*** SHOW DOWN ***
Duke Croix: shows [7h 9h] (a straight, Six to Ten)
FragileMemory: shows [4d 2d] (a flush, Eight high)
FragileMemory collected 3118 from pot
*** SUMMARY ***
Total pot 3300 | Rake 182 
Board [8d 5d 6c Th 7d]
Seat 1: dddocky (button) folded on the Flop
Seat 2: FragileMemory (small blind) showed [4d 2d] and won (3118) with a flush, Eight high
Seat 3: Duke Croix (big blind) showed [7h 9h] and lost with a straight, Six to Ten
Seat 6: color_singleton folded before Flop (didn't bet)
Seat 8: JeBoyDirk folded before Flop (didn't bet)
Seat 9: MnnM150 folded before Flop (didn't bet)



PokerStars Home Game Hand #218089925586: {Club #3225207}  Hold'em No Limit (50/100) - 2020/09/03 17:52:16 ET
Table 'fun gamez' 9-max (Play Money) Seat #2 is the button
Seat 1: dddocky (9018 in chips) 
Seat 2: FragileMemory (12130 in chips) 
Seat 3: Duke Croix (28322 in chips) 
Seat 6: color_singleton (16303 in chips) 
Seat 8: JeBoyDirk (21805 in chips) 
Seat 9: MnnM150 (2632 in chips) 
Duke Croix: posts small blind 50
color_singleton: posts big blind 100
*** HOLE CARDS ***
Dealt to Duke Croix [Jc 5d]
JeBoyDirk: calls 100
MnnM150: calls 100
dddocky: folds 
FragileMemory: calls 100
Duke Croix: calls 50
color_singleton: raises 200 to 300
JeBoyDirk: calls 200
MnnM150: calls 200
FragileMemory: calls 200
Duke Croix: calls 200
*** FLOP *** [Ah Tc Ts]
Duke Croix: checks 
color_singleton: checks 
JeBoyDirk: checks 
MnnM150: checks 
FragileMemory: bets 708
Duke Croix: folds 
color_singleton: calls 708
JeBoyDirk: calls 708
MnnM150: folds 
*** TURN *** [Ah Tc Ts] [6s]
color_singleton: bets 1712
JeBoyDirk: calls 1712
FragileMemory: calls 1712
*** RIVER *** [Ah Tc Ts 6s] [Qc]
color_singleton: checks 
JeBoyDirk: bets 19085 and is all-in
FragileMemory: folds 
color_singleton: folds 
Uncalled bet (19085) returned to JeBoyDirk
JeBoyDirk collected 8278 from pot
*** SUMMARY ***
Total pot 8760 | Rake 482 
Board [Ah Tc Ts 6s Qc]
Seat 1: dddocky folded before Flop (didn't bet)
Seat 2: FragileMemory (button) folded on the River
Seat 3: Duke Croix (small blind) folded on the Flop
Seat 6: color_singleton (big blind) folded on the River
Seat 8: JeBoyDirk collected (8278)
Seat 9: MnnM150 folded on the Flop



PokerStars Home Game Hand #218089969031: {Club #3225207}  Hold'em No Limit (50/100) - 2020/09/03 17:53:37 ET
Table 'fun gamez' 9-max (Play Money) Seat #3 is the button
Seat 1: dddocky (9018 in chips) 
Seat 2: FragileMemory (9410 in chips) 
Seat 3: Duke Croix (28022 in chips) 
Seat 6: color_singleton (13583 in chips) 
Seat 8: JeBoyDirk (27363 in chips) 
Seat 9: MnnM150 (2332 in chips) 
color_singleton: posts small blind 50
JeBoyDirk: posts big blind 100
*** HOLE CARDS ***
Dealt to Duke Croix [7c 7d]
MnnM150: calls 100
dddocky: calls 100
FragileMemory: calls 100
Duke Croix: raises 400 to 500
color_singleton: calls 450
JeBoyDirk: folds 
MnnM150: calls 400
dddocky: folds 
FragileMemory: calls 400
*** FLOP *** [Qh 2d 4d]
color_singleton: checks 
MnnM150: checks 
FragileMemory: checks 
Duke Croix: bets 1000
color_singleton: calls 1000
MnnM150: folds 
FragileMemory: folds 
*** TURN *** [Qh 2d 4d] [7h]
color_singleton: checks 
Duke Croix: bets 2000
color_singleton: raises 3000 to 5000
Duke Croix: raises 21522 to 26522 and is all-in
color_singleton: calls 7083 and is all-in
Uncalled bet (14439) returned to Duke Croix
*** RIVER *** [Qh 2d 4d 7h] [4s]
*** SHOW DOWN ***
color_singleton: shows [2h 2s] (a full house, Deuces full of Fours)
Duke Croix: shows [7c 7d] (a full house, Sevens full of Fours)
Duke Croix collected 26806 from pot
*** SUMMARY ***
Total pot 28366 | Rake 1560 
Board [Qh 2d 4d 7h 4s]
Seat 1: dddocky folded before Flop
Seat 2: FragileMemory folded on the Flop
Seat 3: Duke Croix (button) showed [7c 7d] and won (26806) with a full house, Sevens full of Fours
Seat 6: color_singleton (small blind) showed [2h 2s] and lost with a full house, Deuces full of Fours
Seat 8: JeBoyDirk (big blind) folded before Flop
Seat 9: MnnM150 folded on the Flop



PokerStars Home Game Hand #218090002164: {Club #3225207}  Hold'em No Limit (50/100) - 2020/09/03 17:54:39 ET
Table 'fun gamez' 9-max (Play Money) Seat #8 is the button
Seat 1: dddocky (8918 in chips) 
Seat 2: FragileMemory (8910 in chips) 
Seat 3: Duke Croix (41245 in chips) 
Seat 8: JeBoyDirk (27263 in chips) 
Seat 9: MnnM150 (1832 in chips) 
MnnM150: posts small blind 50
dddocky: posts big blind 100
*** HOLE CARDS ***
Dealt to Duke Croix [5s 9d]
FragileMemory: calls 100
Duke Croix: folds 
JeBoyDirk: raises 100 to 200
MnnM150: calls 150
dddocky: folds 
FragileMemory: calls 100
*** FLOP *** [7s Jh 2c]
MnnM150: checks 
FragileMemory: checks 
JeBoyDirk: checks 
*** TURN *** [7s Jh 2c] [7d]
MnnM150: checks 
FragileMemory: checks 
JeBoyDirk: checks 
*** RIVER *** [7s Jh 2c 7d] [Ts]
MnnM150: checks 
FragileMemory: checks 
JeBoyDirk: checks 
*** SHOW DOWN ***
MnnM150: shows [8c 6c] (a pair of Sevens)
FragileMemory: shows [Qh 3h] (a pair of Sevens - Queen kicker)
JeBoyDirk: shows [Ad Td] (two pair, Tens and Sevens)
JeBoyDirk collected 661 from pot
*** SUMMARY ***
Total pot 700 | Rake 39 
Board [7s Jh 2c 7d Ts]
Seat 1: dddocky (big blind) folded before Flop
Seat 2: FragileMemory showed [Qh 3h] and lost with a pair of Sevens
Seat 3: Duke Croix folded before Flop (didn't bet)
Seat 8: JeBoyDirk (button) showed [Ad Td] and won (661) with two pair, Tens and Sevens
Seat 9: MnnM150 (small blind) showed [8c 6c] and lost with a pair of Sevens



PokerStars Home Game Hand #218090020976: {Club #3225207}  Hold'em No Limit (50/100) - 2020/09/03 17:55:22 ET
Table 'fun gamez' 9-max (Play Money) Seat #9 is the button
Seat 1: dddocky (8818 in chips) 
Seat 2: FragileMemory (8710 in chips) 
Seat 3: Duke Croix (41245 in chips) 
Seat 6: color_singleton (10000 in chips) 
Seat 8: JeBoyDirk (27724 in chips) 
Seat 9: MnnM150 (1632 in chips) 
dddocky: posts small blind 50
FragileMemory: posts big blind 100
*** HOLE CARDS ***
Dealt to Duke Croix [4h Js]
Duke Croix: folds 
color_singleton: raises 200 to 300
JeBoyDirk: calls 300
MnnM150: folds 
dddocky: calls 250
FragileMemory: folds 
*** FLOP *** [6s Qs 3d]
dddocky: checks 
color_singleton: bets 472
JeBoyDirk: folds 
dddocky: folds 
Uncalled bet (472) returned to color_singleton
color_singleton collected 945 from pot
color_singleton: doesn't show hand 
*** SUMMARY ***
Total pot 1000 | Rake 55 
Board [6s Qs 3d]
Seat 1: dddocky (small blind) folded on the Flop
Seat 2: FragileMemory (big blind) folded before Flop
Seat 3: Duke Croix folded before Flop (didn't bet)
Seat 6: color_singleton collected (945)
Seat 8: JeBoyDirk folded on the Flop
Seat 9: MnnM150 (button) folded before Flop (didn't bet)



PokerStars Home Game Hand #218090032626: {Club #3225207}  Hold'em No Limit (50/100) - 2020/09/03 17:55:51 ET
Table 'fun gamez' 9-max (Play Money) Seat #1 is the button
Seat 1: dddocky (8518 in chips) 
Seat 3: Duke Croix (41245 in chips) 
Seat 6: color_singleton (10645 in chips) 
Seat 8: JeBoyDirk (27424 in chips) 
Seat 9: MnnM150 (1632 in chips) 
Duke Croix: posts small blind 50
color_singleton: posts big blind 100
*** HOLE CARDS ***
Dealt to Duke Croix [5s 2c]
JeBoyDirk: folds 
MnnM150: calls 100
dddocky: calls 100
JeBoyDirk leaves the table
Duke Croix: calls 50
color_singleton: checks 
*** FLOP *** [2s 3d 9s]
Duke Croix: bets 200
color_singleton: calls 200
FragileMemory leaves the table
MnnM150: folds 
dddocky: folds 
*** TURN *** [2s 3d 9s] [Ah]
Duke Croix: checks 
color_singleton: checks 
*** RIVER *** [2s 3d 9s Ah] [4s]
Duke Croix: checks 
color_singleton: checks 
*** SHOW DOWN ***
Duke Croix: shows [5s 2c] (a straight, Ace to Five)
color_singleton: mucks hand 
Duke Croix collected 756 from pot
*** SUMMARY ***
Total pot 800 | Rake 44 
Board [2s 3d 9s Ah 4s]
Seat 1: dddocky (button) folded on the Flop
Seat 3: Duke Croix (small blind) showed [5s 2c] and won (756) with a straight, Ace to Five
Seat 6: color_singleton (big blind) mucked [6c 2h]
Seat 8: JeBoyDirk folded before Flop (didn't bet)
Seat 9: MnnM150 folded on the Flop



PokerStars Home Game Hand #218090047558: {Club #3225207}  Hold'em No Limit (50/100) - 2020/09/03 17:56:29 ET
Table 'fun gamez' 9-max (Play Money) Seat #3 is the button
Seat 1: dddocky (8418 in chips) 
Seat 3: Duke Croix (41701 in chips) 
Seat 6: color_singleton (10345 in chips) 
color_singleton: posts small blind 50
dddocky: posts big blind 100
*** HOLE CARDS ***
Dealt to Duke Croix [Kc Jh]
Duke Croix: raises 300 to 400
color_singleton: calls 350
dddocky: folds 
*** FLOP *** [5s 7c 3d]
color_singleton: bets 425
Duke Croix: folds 
Uncalled bet (425) returned to color_singleton
color_singleton collected 850 from pot
color_singleton: doesn't show hand 
*** SUMMARY ***
Total pot 900 | Rake 50 
Board [5s 7c 3d]
Seat 1: dddocky (big blind) folded before Flop
Seat 3: Duke Croix (button) folded on the Flop
Seat 6: color_singleton (small blind) collected (850)



PokerStars Home Game Hand #218090054173: {Club #3225207}  Hold'em No Limit (50/100) - 2020/09/03 17:56:45 ET
Table 'fun gamez' 9-max (Play Money) Seat #6 is the button
Seat 1: dddocky (8318 in chips) 
Seat 3: Duke Croix (41301 in chips) 
Seat 6: color_singleton (10795 in chips) 
dddocky: posts small blind 50
Duke Croix: posts big blind 100
*** HOLE CARDS ***
Dealt to Duke Croix [3d 4h]
color_singleton: folds 
dddocky: calls 50
Duke Croix: checks 
*** FLOP *** [5d 6c 9s]
dddocky: checks 
Duke Croix: bets 100
dddocky: folds 
Uncalled bet (100) returned to Duke Croix
Duke Croix collected 189 from pot
*** SUMMARY ***
Total pot 200 | Rake 11 
Board [5d 6c 9s]
Seat 1: dddocky (small blind) folded on the Flop
Seat 3: Duke Croix (big blind) collected (189)
Seat 6: color_singleton (button) folded before Flop (didn't bet)



PokerStars Home Game Hand #218090062678: {Club #3225207}  Hold'em No Limit (50/100) - 2020/09/03 17:57:06 ET
Table 'fun gamez' 9-max (Play Money) Seat #1 is the button
Seat 1: dddocky (8218 in chips) 
Seat 3: Duke Croix (41390 in chips) 
Seat 6: color_singleton (10795 in chips) 
Duke Croix: posts small blind 50
color_singleton: posts big blind 100
*** HOLE CARDS ***
Dealt to Duke Croix [4s 7h]
dddocky: folds 
Duke Croix: calls 50
color_singleton: raises 100 to 200
MnnM150 leaves the table
Duke Croix: calls 100
*** FLOP *** [Js Qh Jc]
Duke Croix: checks 
color_singleton: bets 189
Duke Croix: folds 
Uncalled bet (189) returned to color_singleton
color_singleton collected 378 from pot
color_singleton: doesn't show hand 
*** SUMMARY ***
Total pot 400 | Rake 22 
Board [Js Qh Jc]
Seat 1: dddocky (button) folded before Flop (didn't bet)
Seat 3: Duke Croix (small blind) folded on the Flop
Seat 6: color_singleton (big blind) collected (378)



PokerStars Home Game Hand #218090073634: {Club #3225207}  Hold'em No Limit (50/100) - 2020/09/03 17:57:33 ET
Table 'fun gamez' 9-max (Play Money) Seat #6 is the button
Seat 3: Duke Croix (41190 in chips) 
Seat 6: color_singleton (10973 in chips) 
color_singleton: posts small blind 50
Duke Croix: posts big blind 100
*** HOLE CARDS ***
Dealt to Duke Croix [3h Kh]
color_singleton: folds 
Uncalled bet (50) returned to Duke Croix
Duke Croix collected 100 from pot
*** SUMMARY ***
Total pot 100 | Rake 0 
Seat 3: Duke Croix (big blind) collected (100)
Seat 6: color_singleton (button) (small blind) folded before Flop



PokerStars Home Game Hand #218090075836: {Club #3225207}  Hold'em No Limit (50/100) - 2020/09/03 17:57:39 ET
Table 'fun gamez' 9-max (Play Money) Seat #3 is the button
Seat 3: Duke Croix (41240 in chips) 
Seat 6: color_singleton (10923 in chips) 
Duke Croix: posts small blind 50
color_singleton: posts big blind 100
*** HOLE CARDS ***
Dealt to Duke Croix [6c Jd]
Duke Croix: calls 50
color_singleton: checks 
*** FLOP *** [Jh 3s 2s]
color_singleton: checks 
Duke Croix: bets 200
color_singleton: folds 
Uncalled bet (200) returned to Duke Croix
Duke Croix collected 189 from pot
*** SUMMARY ***
Total pot 200 | Rake 11 
Board [Jh 3s 2s]
Seat 3: Duke Croix (button) (small blind) collected (189)
Seat 6: color_singleton (big blind) folded on the Flop



