PokerStars Home Game Hand #217629783173: {Club #3225207}  Hold'em No Limit (50/100) - 2020/08/20 14:46:08 ET
Table 'Manuel Neuer' 9-max (Play Money) Seat #2 is the button
Seat 1: JeBoyDirk (9657 in chips) 
Seat 2: dddocky (9961 in chips) 
Seat 3: RichRick1337 (9507 in chips) 
Seat 4: Duke Croix (10000 in chips) 
Seat 9: Manon541 (10731 in chips) 
RichRick1337: posts small blind 50
Duke Croix: posts big blind 100
*** HOLE CARDS ***
Dealt to Duke Croix [2s 4c]
Manon541: calls 100
JeBoyDirk: folds 
dddocky: calls 100
RichRick1337: raises 100 to 200
Duke Croix: folds 
Manon541: calls 100
dddocky: calls 100
*** FLOP *** [As Ah 5s]
RichRick1337: checks 
Manon541: checks 
dddocky: checks 
*** TURN *** [As Ah 5s] [6s]
RichRick1337: bets 800
Manon541: folds 
dddocky: folds 
Uncalled bet (800) returned to RichRick1337
RichRick1337 collected 661 from pot
RichRick1337: doesn't show hand 
*** SUMMARY ***
Total pot 700 | Rake 39 
Board [As Ah 5s 6s]
Seat 1: JeBoyDirk folded before Flop (didn't bet)
Seat 2: dddocky (button) folded on the Turn
Seat 3: RichRick1337 (small blind) collected (661)
Seat 4: Duke Croix (big blind) folded before Flop
Seat 9: Manon541 folded on the Turn



PokerStars Home Game Hand #217629804314: {Club #3225207}  Hold'em No Limit (50/100) - 2020/08/20 14:46:48 ET
Table 'Manuel Neuer' 9-max (Play Money) Seat #3 is the button
Seat 1: JeBoyDirk (9657 in chips) 
Seat 2: dddocky (9761 in chips) 
Seat 3: RichRick1337 (9968 in chips) 
Seat 4: Duke Croix (9900 in chips) 
Seat 9: Manon541 (10531 in chips) 
Duke Croix: posts small blind 50
Manon541: posts big blind 100
*** HOLE CARDS ***
Dealt to Duke Croix [7h 2c]
JeBoyDirk: raises 200 to 300
dddocky: folds 
RichRick1337: folds 
Duke Croix: folds 
Manon541: calls 200
*** FLOP *** [Jc Ac 3s]
Manon541: checks 
JeBoyDirk: checks 
*** TURN *** [Jc Ac 3s] [As]
Manon541: bets 307
JeBoyDirk: calls 307
*** RIVER *** [Jc Ac 3s As] [6h]
Manon541: bets 1194
JeBoyDirk: folds 
Uncalled bet (1194) returned to Manon541
Manon541 collected 1194 from pot
*** SUMMARY ***
Total pot 1264 | Rake 70 
Board [Jc Ac 3s As 6h]
Seat 1: JeBoyDirk folded on the River
Seat 2: dddocky folded before Flop (didn't bet)
Seat 3: RichRick1337 (button) folded before Flop (didn't bet)
Seat 4: Duke Croix (small blind) folded before Flop
Seat 9: Manon541 (big blind) collected (1194)



PokerStars Home Game Hand #217629826811: {Club #3225207}  Hold'em No Limit (50/100) - 2020/08/20 14:47:30 ET
Table 'Manuel Neuer' 9-max (Play Money) Seat #4 is the button
Seat 1: JeBoyDirk (9050 in chips) 
Seat 2: dddocky (9761 in chips) 
Seat 3: RichRick1337 (9968 in chips) 
Seat 4: Duke Croix (9850 in chips) 
Seat 9: Manon541 (11118 in chips) 
Manon541: posts small blind 50
JeBoyDirk: posts big blind 100
*** HOLE CARDS ***
Dealt to Duke Croix [6s Ah]
dddocky: raises 100 to 200
RichRick1337: folds 
color_singleton joins the table at seat #6 
Duke Croix: calls 200
Manon541: folds 
JeBoyDirk: folds 
*** FLOP *** [6d Th 4s]
dddocky: bets 520
Duke Croix: folds 
Uncalled bet (520) returned to dddocky
dddocky collected 520 from pot
dddocky: doesn't show hand 
*** SUMMARY ***
Total pot 550 | Rake 30 
Board [6d Th 4s]
Seat 1: JeBoyDirk (big blind) folded before Flop
Seat 2: dddocky collected (520)
Seat 3: RichRick1337 folded before Flop (didn't bet)
Seat 4: Duke Croix (button) folded on the Flop
Seat 9: Manon541 (small blind) folded before Flop



PokerStars Home Game Hand #217629849650: {Club #3225207}  Hold'em No Limit (50/100) - 2020/08/20 14:48:12 ET
Table 'Manuel Neuer' 9-max (Play Money) Seat #9 is the button
Seat 1: JeBoyDirk (8950 in chips) 
Seat 2: dddocky (10081 in chips) 
Seat 3: RichRick1337 (9968 in chips) 
Seat 4: Duke Croix (9650 in chips) 
Seat 6: color_singleton (10000 in chips) 
Seat 9: Manon541 (11068 in chips) 
JeBoyDirk: posts small blind 50
dddocky: posts big blind 100
color_singleton: posts big blind 100
*** HOLE CARDS ***
Dealt to Duke Croix [Jh 2d]
RichRick1337: calls 100
Duke Croix: folds 
color_singleton: checks 
Manon541: folds 
JeBoyDirk: calls 50
dddocky: checks 
*** FLOP *** [2c 3c Qs]
JeBoyDirk: checks 
dddocky: checks 
RichRick1337: bets 100
color_singleton: calls 100
JeBoyDirk: folds 
dddocky: folds 
*** TURN *** [2c 3c Qs] [Ad]
RichRick1337: checks 
color_singleton: checks 
*** RIVER *** [2c 3c Qs Ad] [5c]
RichRick1337: checks 
color_singleton: checks 
*** SHOW DOWN ***
RichRick1337: shows [9s 2h] (a pair of Deuces)
color_singleton: shows [6c 5d] (a pair of Fives)
color_singleton collected 567 from pot
*** SUMMARY ***
Total pot 600 | Rake 33 
Board [2c 3c Qs Ad 5c]
Seat 1: JeBoyDirk (small blind) folded on the Flop
Seat 2: dddocky (big blind) folded on the Flop
Seat 3: RichRick1337 showed [9s 2h] and lost with a pair of Deuces
Seat 4: Duke Croix folded before Flop (didn't bet)
Seat 6: color_singleton showed [6c 5d] and won (567) with a pair of Fives
Seat 9: Manon541 (button) folded before Flop (didn't bet)



PokerStars Home Game Hand #217629871171: {Club #3225207}  Hold'em No Limit (50/100) - 2020/08/20 14:48:51 ET
Table 'Manuel Neuer' 9-max (Play Money) Seat #1 is the button
Seat 1: JeBoyDirk (8850 in chips) 
Seat 2: dddocky (9981 in chips) 
Seat 3: RichRick1337 (9768 in chips) 
Seat 4: Duke Croix (9650 in chips) 
Seat 6: color_singleton (10367 in chips) 
Seat 9: Manon541 (11068 in chips) 
dddocky: posts small blind 50
RichRick1337: posts big blind 100
*** HOLE CARDS ***
Dealt to Duke Croix [Ts 4c]
Duke Croix: folds 
color_singleton: calls 100
Manon541: calls 100
JeBoyDirk: folds 
dddocky: calls 50
RichRick1337: checks 
*** FLOP *** [7d Tc Qc]
dddocky: bets 100
RichRick1337: folds 
color_singleton: calls 100
Manon541: calls 100
*** TURN *** [7d Tc Qc] [4s]
dddocky: bets 100
color_singleton: raises 300 to 400
Manon541: calls 400
dddocky: folds 
*** RIVER *** [7d Tc Qc 4s] [6c]
color_singleton: checks 
Manon541: bets 756
color_singleton: calls 756
*** SHOW DOWN ***
Manon541: shows [5h Qs] (a pair of Queens)
color_singleton: shows [8h Qh] (a pair of Queens - Ten+Eight kicker)
color_singleton collected 2941 from pot
*** SUMMARY ***
Total pot 3112 | Rake 171 
Board [7d Tc Qc 4s 6c]
Seat 1: JeBoyDirk (button) folded before Flop (didn't bet)
Seat 2: dddocky (small blind) folded on the Turn
Seat 3: RichRick1337 (big blind) folded on the Flop
Seat 4: Duke Croix folded before Flop (didn't bet)
Seat 6: color_singleton showed [8h Qh] and won (2941) with a pair of Queens
Seat 9: Manon541 showed [5h Qs] and lost with a pair of Queens



PokerStars Home Game Hand #217629901462: {Club #3225207}  Hold'em No Limit (50/100) - 2020/08/20 14:49:47 ET
Table 'Manuel Neuer' 9-max (Play Money) Seat #2 is the button
Seat 1: JeBoyDirk (8850 in chips) 
Seat 2: dddocky (9681 in chips) 
Seat 3: RichRick1337 (9668 in chips) 
Seat 4: Duke Croix (9650 in chips) 
Seat 6: color_singleton (11952 in chips) 
Seat 9: Manon541 (9712 in chips) 
RichRick1337: posts small blind 50
Duke Croix: posts big blind 100
*** HOLE CARDS ***
Dealt to Duke Croix [Ah 9c]
color_singleton: folds 
Manon541: calls 100
JeBoyDirk: folds 
dddocky: calls 100
RichRick1337: raises 100 to 200
Duke Croix: calls 100
Manon541: calls 100
dddocky: calls 100
*** FLOP *** [Qd 4s Kc]
RichRick1337: checks 
Duke Croix: checks 
Manon541: checks 
dddocky: checks 
*** TURN *** [Qd 4s Kc] [Tc]
RichRick1337: bets 100
Duke Croix: folds 
Manon541: calls 100
dddocky: raises 100 to 200
RichRick1337: calls 100
Manon541: calls 100
*** RIVER *** [Qd 4s Kc Tc] [7h]
RichRick1337: checks 
Manon541: checks 
dddocky: bets 1323
RichRick1337: folds 
Manon541: folds 
Uncalled bet (1323) returned to dddocky
dddocky collected 1323 from pot
dddocky: doesn't show hand 
*** SUMMARY ***
Total pot 1400 | Rake 77 
Board [Qd 4s Kc Tc 7h]
Seat 1: JeBoyDirk folded before Flop (didn't bet)
Seat 2: dddocky (button) collected (1323)
Seat 3: RichRick1337 (small blind) folded on the River
Seat 4: Duke Croix (big blind) folded on the Turn
Seat 6: color_singleton folded before Flop (didn't bet)
Seat 9: Manon541 folded on the River



PokerStars Home Game Hand #217629938176: {Club #3225207}  Hold'em No Limit (50/100) - 2020/08/20 14:50:55 ET
Table 'Manuel Neuer' 9-max (Play Money) Seat #3 is the button
Seat 1: JeBoyDirk (8850 in chips) 
Seat 2: dddocky (10604 in chips) 
Seat 3: RichRick1337 (9268 in chips) 
Seat 4: Duke Croix (9450 in chips) 
Seat 6: color_singleton (11952 in chips) 
Seat 9: Manon541 (9312 in chips) 
Duke Croix: posts small blind 50
color_singleton: posts big blind 100
*** HOLE CARDS ***
Dealt to Duke Croix [7s Jd]
Manon541: calls 100
JeBoyDirk: calls 100
dddocky: calls 100
RichRick1337: calls 100
Duke Croix: calls 50
color_singleton: checks 
*** FLOP *** [Ah 4d Ac]
Duke Croix: checks 
color_singleton: checks 
Manon541: checks 
JeBoyDirk: checks 
dddocky: checks 
RichRick1337: bets 400
Duke Croix has timed out
Duke Croix: folds 
color_singleton: folds 
Manon541: folds 
JeBoyDirk: folds 
dddocky: folds 
Uncalled bet (400) returned to RichRick1337
RichRick1337 collected 567 from pot
RichRick1337: doesn't show hand 
*** SUMMARY ***
Total pot 600 | Rake 33 
Board [Ah 4d Ac]
Seat 1: JeBoyDirk folded on the Flop
Seat 2: dddocky folded on the Flop
Seat 3: RichRick1337 (button) collected (567)
Seat 4: Duke Croix (small blind) folded on the Flop
Seat 6: color_singleton (big blind) folded on the Flop
Seat 9: Manon541 folded on the Flop



PokerStars Home Game Hand #217629964012: {Club #3225207}  Hold'em No Limit (50/100) - 2020/08/20 14:51:43 ET
Table 'Manuel Neuer' 9-max (Play Money) Seat #4 is the button
Seat 1: JeBoyDirk (8750 in chips) 
Seat 2: dddocky (10504 in chips) 
Seat 3: RichRick1337 (9735 in chips) 
Seat 4: Duke Croix (9350 in chips) 
Seat 6: color_singleton (11852 in chips) 
Seat 9: Manon541 (9212 in chips) 
color_singleton: posts small blind 50
Manon541: posts big blind 100
*** HOLE CARDS ***
Dealt to Duke Croix [4d Js]
JeBoyDirk: folds 
dddocky: folds 
RichRick1337: calls 100
Duke Croix: folds 
color_singleton: calls 50
Manon541: checks 
*** FLOP *** [7c Kc Jc]
color_singleton: checks 
Manon541: checks 
RichRick1337: checks 
*** TURN *** [7c Kc Jc] [Ts]
color_singleton: checks 
Manon541: checks 
RichRick1337: checks 
*** RIVER *** [7c Kc Jc Ts] [Qc]
color_singleton: checks 
Manon541: checks 
RichRick1337: checks 
*** SHOW DOWN ***
color_singleton: shows [8d Th] (a pair of Tens)
Manon541: shows [3c 7h] (a flush, King high)
RichRick1337: mucks hand 
Manon541 collected 283 from pot
*** SUMMARY ***
Total pot 300 | Rake 17 
Board [7c Kc Jc Ts Qc]
Seat 1: JeBoyDirk folded before Flop (didn't bet)
Seat 2: dddocky folded before Flop (didn't bet)
Seat 3: RichRick1337 mucked [Qs 6h]
Seat 4: Duke Croix (button) folded before Flop (didn't bet)
Seat 6: color_singleton (small blind) showed [8d Th] and lost with a pair of Tens
Seat 9: Manon541 (big blind) showed [3c 7h] and won (283) with a flush, King high



PokerStars Home Game Hand #217629990716: {Club #3225207}  Hold'em No Limit (50/100) - 2020/08/20 14:52:31 ET
Table 'Manuel Neuer' 9-max (Play Money) Seat #6 is the button
Seat 1: JeBoyDirk (8750 in chips) 
Seat 2: dddocky (10504 in chips) 
Seat 3: RichRick1337 (9635 in chips) 
Seat 4: Duke Croix (9350 in chips) 
Seat 6: color_singleton (11752 in chips) 
Seat 9: Manon541 (9395 in chips) 
Manon541: posts small blind 50
JeBoyDirk: posts big blind 100
*** HOLE CARDS ***
Dealt to Duke Croix [2h Qh]
dddocky: folds 
RichRick1337: folds 
Duke Croix: calls 100
color_singleton: folds 
Manon541: calls 50
JeBoyDirk: checks 
*** FLOP *** [2s Qs 7h]
Manon541: checks 
JeBoyDirk: bets 300
Duke Croix: calls 300
Manon541: folds 
*** TURN *** [2s Qs 7h] [Kc]
JeBoyDirk: checks 
Duke Croix: bets 600
JeBoyDirk: folds 
Uncalled bet (600) returned to Duke Croix
Duke Croix collected 850 from pot
*** SUMMARY ***
Total pot 900 | Rake 50 
Board [2s Qs 7h Kc]
Seat 1: JeBoyDirk (big blind) folded on the Turn
Seat 2: dddocky folded before Flop (didn't bet)
Seat 3: RichRick1337 folded before Flop (didn't bet)
Seat 4: Duke Croix collected (850)
Seat 6: color_singleton (button) folded before Flop (didn't bet)
Seat 9: Manon541 (small blind) folded on the Flop



PokerStars Home Game Hand #217630030324: {Club #3225207}  Hold'em No Limit (50/100) - 2020/08/20 14:53:29 ET
Table 'Manuel Neuer' 9-max (Play Money) Seat #9 is the button
Seat 1: JeBoyDirk (8350 in chips) 
Seat 2: dddocky (10504 in chips) 
Seat 3: RichRick1337 (9635 in chips) 
Seat 4: Duke Croix (9800 in chips) 
Seat 6: color_singleton (11752 in chips) 
Seat 9: Manon541 (9295 in chips) 
JeBoyDirk: posts small blind 50
dddocky: posts big blind 100
*** HOLE CARDS ***
Dealt to Duke Croix [5s Ad]
RichRick1337: folds 
Duke Croix: calls 100
color_singleton: folds 
Manon541: calls 100
JeBoyDirk: calls 50
dddocky: checks 
*** FLOP *** [4s 8d Jh]
JeBoyDirk has timed out
JeBoyDirk: checks 
dddocky: checks 
Duke Croix: checks 
Manon541: checks 
*** TURN *** [4s 8d Jh] [As]
JeBoyDirk: checks 
dddocky: checks 
Duke Croix: bets 200
Manon541: raises 200 to 400
JeBoyDirk: folds 
dddocky: calls 400
Duke Croix: calls 200
*** RIVER *** [4s 8d Jh As] [Ac]
dddocky: checks 
Duke Croix: checks 
Manon541: bets 1512
dddocky: folds 
Duke Croix: calls 1512
*** SHOW DOWN ***
Manon541: shows [7s Ah] (three of a kind, Aces)
Duke Croix: shows [5s Ad] (three of a kind, Aces)
Duke Croix collected 2185 from pot
Manon541 collected 2185 from pot
*** SUMMARY ***
Total pot 4624 | Rake 254 
Board [4s 8d Jh As Ac]
Seat 1: JeBoyDirk (small blind) folded on the Turn
Seat 2: dddocky (big blind) folded on the River
Seat 3: RichRick1337 folded before Flop (didn't bet)
Seat 4: Duke Croix showed [5s Ad] and won (2185) with three of a kind, Aces
Seat 6: color_singleton folded before Flop (didn't bet)
Seat 9: Manon541 (button) showed [7s Ah] and won (2185) with three of a kind, Aces



PokerStars Home Game Hand #217630073995: {Club #3225207}  Hold'em No Limit (50/100) - 2020/08/20 14:54:49 ET
Table 'Manuel Neuer' 9-max (Play Money) Seat #1 is the button
Seat 1: JeBoyDirk (8250 in chips) 
Seat 2: dddocky (10004 in chips) 
Seat 3: RichRick1337 (9635 in chips) 
Seat 4: Duke Croix (9973 in chips) 
Seat 6: color_singleton (11752 in chips) 
Seat 9: Manon541 (9468 in chips) 
dddocky: posts small blind 50
RichRick1337: posts big blind 100
*** HOLE CARDS ***
Dealt to Duke Croix [9d Jd]
Duke Croix: calls 100
color_singleton: calls 100
Manon541: folds 
JeBoyDirk: folds 
dddocky: calls 50
RichRick1337: raises 100 to 200
Duke Croix: calls 100
color_singleton: calls 100
dddocky: calls 100
*** FLOP *** [3s As 5h]
dddocky: checks 
RichRick1337: bets 300
Duke Croix: folds 
color_singleton: folds 
dddocky: folds 
Uncalled bet (300) returned to RichRick1337
RichRick1337 collected 756 from pot
RichRick1337: doesn't show hand 
*** SUMMARY ***
Total pot 800 | Rake 44 
Board [3s As 5h]
Seat 1: JeBoyDirk (button) folded before Flop (didn't bet)
Seat 2: dddocky (small blind) folded on the Flop
Seat 3: RichRick1337 (big blind) collected (756)
Seat 4: Duke Croix folded on the Flop
Seat 6: color_singleton folded on the Flop
Seat 9: Manon541 folded before Flop (didn't bet)



PokerStars Home Game Hand #217630089414: {Club #3225207}  Hold'em No Limit (50/100) - 2020/08/20 14:55:22 ET
Table 'Manuel Neuer' 9-max (Play Money) Seat #2 is the button
Seat 1: JeBoyDirk (8250 in chips) 
Seat 2: dddocky (9804 in chips) 
Seat 3: RichRick1337 (10191 in chips) 
Seat 4: Duke Croix (9773 in chips) 
Seat 6: color_singleton (11552 in chips) 
Seat 9: Manon541 (9468 in chips) 
RichRick1337: posts small blind 50
Duke Croix: posts big blind 100
*** HOLE CARDS ***
Dealt to Duke Croix [5s 9h]
color_singleton: folds 
Manon541: folds 
JeBoyDirk: folds 
dddocky: calls 100
RichRick1337: calls 50
Duke Croix: checks 
*** FLOP *** [7c 6c Kh]
RichRick1337: checks 
Duke Croix: checks 
dddocky: checks 
*** TURN *** [7c 6c Kh] [Th]
RichRick1337: bets 700
Duke Croix: folds 
dddocky: folds 
Uncalled bet (700) returned to RichRick1337
RichRick1337 collected 283 from pot
RichRick1337: doesn't show hand 
*** SUMMARY ***
Total pot 300 | Rake 17 
Board [7c 6c Kh Th]
Seat 1: JeBoyDirk folded before Flop (didn't bet)
Seat 2: dddocky (button) folded on the Turn
Seat 3: RichRick1337 (small blind) collected (283)
Seat 4: Duke Croix (big blind) folded on the Turn
Seat 6: color_singleton folded before Flop (didn't bet)
Seat 9: Manon541 folded before Flop (didn't bet)



PokerStars Home Game Hand #217630106377: {Club #3225207}  Hold'em No Limit (50/100) - 2020/08/20 14:56:03 ET
Table 'Manuel Neuer' 9-max (Play Money) Seat #3 is the button
Seat 1: JeBoyDirk (8250 in chips) 
Seat 2: dddocky (9704 in chips) 
Seat 3: RichRick1337 (10374 in chips) 
Seat 4: Duke Croix (9673 in chips) 
Seat 6: color_singleton (11552 in chips) 
Seat 9: Manon541 (9468 in chips) 
Duke Croix: posts small blind 50
color_singleton: posts big blind 100
*** HOLE CARDS ***
Dealt to Duke Croix [As Kd]
Manon541 has timed out
Manon541: folds 
JeBoyDirk: folds 
dddocky: folds 
RichRick1337: calls 100
Duke Croix: raises 300 to 400
color_singleton: calls 300
RichRick1337: calls 300
*** FLOP *** [4h Jd 9s]
Duke Croix: checks 
color_singleton: checks 
RichRick1337: bets 100
Duke Croix: calls 100
color_singleton: calls 100
*** TURN *** [4h Jd 9s] [Ts]
Duke Croix: checks 
color_singleton: checks 
RichRick1337: checks 
*** RIVER *** [4h Jd 9s Ts] [4c]
Duke Croix: checks 
color_singleton: checks 
RichRick1337: bets 400
Duke Croix: folds 
color_singleton: folds 
Uncalled bet (400) returned to RichRick1337
RichRick1337 collected 1417 from pot
RichRick1337: doesn't show hand 
*** SUMMARY ***
Total pot 1500 | Rake 83 
Board [4h Jd 9s Ts 4c]
Seat 1: JeBoyDirk folded before Flop (didn't bet)
Seat 2: dddocky folded before Flop (didn't bet)
Seat 3: RichRick1337 (button) collected (1417)
Seat 4: Duke Croix (small blind) folded on the River
Seat 6: color_singleton (big blind) folded on the River
Seat 9: Manon541 folded before Flop (didn't bet)



PokerStars Home Game Hand #217630134878: {Club #3225207}  Hold'em No Limit (50/100) - 2020/08/20 14:57:11 ET
Table 'Manuel Neuer' 9-max (Play Money) Seat #4 is the button
Seat 1: JeBoyDirk (8250 in chips) 
Seat 2: dddocky (9704 in chips) 
Seat 3: RichRick1337 (11291 in chips) 
Seat 4: Duke Croix (9173 in chips) 
Seat 6: color_singleton (11052 in chips) 
Seat 9: Manon541 (9468 in chips) 
color_singleton: posts small blind 50
Manon541: posts big blind 100
*** HOLE CARDS ***
Dealt to Duke Croix [Js Ac]
JeBoyDirk: calls 100
dddocky: folds 
RichRick1337: calls 100
Duke Croix: raises 400 to 500
color_singleton: folds 
Manon541: folds 
JeBoyDirk: folds 
RichRick1337: calls 400
*** FLOP *** [5c Qh 3h]
RichRick1337: checks 
Duke Croix: checks 
*** TURN *** [5c Qh 3h] [4c]
RichRick1337: checks 
Duke Croix: bets 600
RichRick1337: folds 
Uncalled bet (600) returned to Duke Croix
Duke Croix collected 1181 from pot
*** SUMMARY ***
Total pot 1250 | Rake 69 
Board [5c Qh 3h 4c]
Seat 1: JeBoyDirk folded before Flop
Seat 2: dddocky folded before Flop (didn't bet)
Seat 3: RichRick1337 folded on the Turn
Seat 4: Duke Croix (button) collected (1181)
Seat 6: color_singleton (small blind) folded before Flop
Seat 9: Manon541 (big blind) folded before Flop



PokerStars Home Game Hand #217630155470: {Club #3225207}  Hold'em No Limit (50/100) - 2020/08/20 14:58:00 ET
Table 'Manuel Neuer' 9-max (Play Money) Seat #6 is the button
Seat 1: JeBoyDirk (8150 in chips) 
Seat 2: dddocky (9704 in chips) 
Seat 3: RichRick1337 (10791 in chips) 
Seat 4: Duke Croix (9854 in chips) 
Seat 6: color_singleton (11002 in chips) 
Seat 9: Manon541 (9368 in chips) 
Manon541: posts small blind 50
JeBoyDirk: posts big blind 100
*** HOLE CARDS ***
Dealt to Duke Croix [Ad Js]
dddocky: calls 100
RichRick1337: folds 
Duke Croix: raises 300 to 400
color_singleton: folds 
Manon541: folds 
JeBoyDirk: folds 
dddocky: calls 300
*** FLOP *** [4c 7d Td]
dddocky: bets 898
Duke Croix: folds 
Uncalled bet (898) returned to dddocky
dddocky collected 898 from pot
dddocky: doesn't show hand 
*** SUMMARY ***
Total pot 950 | Rake 52 
Board [4c 7d Td]
Seat 1: JeBoyDirk (big blind) folded before Flop
Seat 2: dddocky collected (898)
Seat 3: RichRick1337 folded before Flop (didn't bet)
Seat 4: Duke Croix folded on the Flop
Seat 6: color_singleton (button) folded before Flop (didn't bet)
Seat 9: Manon541 (small blind) folded before Flop



PokerStars Home Game Hand #217630171176: {Club #3225207}  Hold'em No Limit (50/100) - 2020/08/20 14:58:38 ET
Table 'Manuel Neuer' 9-max (Play Money) Seat #9 is the button
Seat 1: JeBoyDirk (8050 in chips) 
Seat 2: dddocky (10202 in chips) 
Seat 3: RichRick1337 (10791 in chips) 
Seat 4: Duke Croix (9454 in chips) 
Seat 6: color_singleton (11002 in chips) 
Seat 9: Manon541 (9318 in chips) 
JeBoyDirk: posts small blind 50
dddocky: posts big blind 100
*** HOLE CARDS ***
Dealt to Duke Croix [5s Qs]
RichRick1337: calls 100
Duke Croix: folds 
color_singleton: folds 
Manon541: calls 100
JeBoyDirk: calls 50
dddocky: checks 
*** FLOP *** [2d Jh Kh]
JeBoyDirk: checks 
dddocky: checks 
RichRick1337: checks 
Manon541: checks 
*** TURN *** [2d Jh Kh] [2c]
JeBoyDirk: checks 
dddocky: checks 
RichRick1337: checks 
Manon541: bets 189
JeBoyDirk: folds 
dddocky: calls 189
RichRick1337: calls 189
*** RIVER *** [2d Jh Kh 2c] [2h]
dddocky: checks 
RichRick1337: checks 
Manon541: bets 914
dddocky: folds 
RichRick1337: calls 914
*** SHOW DOWN ***
Manon541: shows [Jc 7c] (a full house, Deuces full of Jacks)
RichRick1337: mucks hand 
Manon541 collected 2641 from pot
*** SUMMARY ***
Total pot 2795 | Rake 154 
Board [2d Jh Kh 2c 2h]
Seat 1: JeBoyDirk (small blind) folded on the Turn
Seat 2: dddocky (big blind) folded on the River
Seat 3: RichRick1337 mucked [Tc As]
Seat 4: Duke Croix folded before Flop (didn't bet)
Seat 6: color_singleton folded before Flop (didn't bet)
Seat 9: Manon541 (button) showed [Jc 7c] and won (2641) with a full house, Deuces full of Jacks



PokerStars Home Game Hand #217630188788: {Club #3225207}  Hold'em No Limit (50/100) - 2020/08/20 14:59:19 ET
Table 'Manuel Neuer' 9-max (Play Money) Seat #1 is the button
Seat 1: JeBoyDirk (7950 in chips) 
Seat 2: dddocky (9913 in chips) 
Seat 3: RichRick1337 (9588 in chips) 
Seat 4: Duke Croix (9454 in chips) 
Seat 6: color_singleton (11002 in chips) 
Seat 9: Manon541 (10756 in chips) 
dddocky: posts small blind 50
RichRick1337: posts big blind 100
*** HOLE CARDS ***
Dealt to Duke Croix [8h 6d]
Duke Croix: folds 
color_singleton: calls 100
Manon541: calls 100
JeBoyDirk: folds 
dddocky: calls 50
RichRick1337: raises 100 to 200
color_singleton: calls 100
Manon541: calls 100
dddocky: calls 100
*** FLOP *** [Jc 3s Qc]
dddocky: bets 100
RichRick1337: calls 100
color_singleton: calls 100
Manon541: calls 100
*** TURN *** [Jc 3s Qc] [Kd]
dddocky: checks 
RichRick1337: checks 
color_singleton: checks 
Manon541: bets 567
dddocky: calls 567
RichRick1337: folds 
color_singleton: folds 
*** RIVER *** [Jc 3s Qc Kd] [7s]
dddocky: checks 
Manon541: bets 2206
dddocky: folds 
Uncalled bet (2206) returned to Manon541
Manon541 collected 2206 from pot
*** SUMMARY ***
Total pot 2334 | Rake 128 
Board [Jc 3s Qc Kd 7s]
Seat 1: JeBoyDirk (button) folded before Flop (didn't bet)
Seat 2: dddocky (small blind) folded on the River
Seat 3: RichRick1337 (big blind) folded on the Turn
Seat 4: Duke Croix folded before Flop (didn't bet)
Seat 6: color_singleton folded on the Turn
Seat 9: Manon541 collected (2206)



PokerStars Home Game Hand #217630220914: {Club #3225207}  Hold'em No Limit (50/100) - 2020/08/20 15:00:32 ET
Table 'Manuel Neuer' 9-max (Play Money) Seat #2 is the button
Seat 1: JeBoyDirk (7950 in chips) 
Seat 2: dddocky (9046 in chips) 
Seat 3: RichRick1337 (9288 in chips) 
Seat 4: Duke Croix (9454 in chips) 
Seat 6: color_singleton (10702 in chips) 
Seat 9: Manon541 (12095 in chips) 
RichRick1337: posts small blind 50
Duke Croix: posts big blind 100
*** HOLE CARDS ***
Dealt to Duke Croix [9d 6d]
color_singleton: raises 100 to 200
Manon541: calls 200
JeBoyDirk: calls 200
dddocky: calls 200
RichRick1337: folds 
Duke Croix: calls 100
*** FLOP *** [Td Kh 9s]
Duke Croix: checks 
color_singleton: checks 
Manon541: checks 
JeBoyDirk: checks 
dddocky: checks 
*** TURN *** [Td Kh 9s] [Jc]
Duke Croix: checks 
color_singleton: bets 496
Manon541: calls 496
JeBoyDirk: folds 
dddocky: folds 
Duke Croix: folds 
*** RIVER *** [Td Kh 9s Jc] [4s]
color_singleton: checks 
Manon541: checks 
*** SHOW DOWN ***
color_singleton: shows [Ac Kd] (a pair of Kings)
Manon541: mucks hand 
color_singleton collected 1930 from pot
*** SUMMARY ***
Total pot 2042 | Rake 112 
Board [Td Kh 9s Jc 4s]
Seat 1: JeBoyDirk folded on the Turn
Seat 2: dddocky (button) folded on the Turn
Seat 3: RichRick1337 (small blind) folded before Flop
Seat 4: Duke Croix (big blind) folded on the Turn
Seat 6: color_singleton showed [Ac Kd] and won (1930) with a pair of Kings
Seat 9: Manon541 mucked [3s As]



PokerStars Home Game Hand #217630254492: {Club #3225207}  Hold'em No Limit (50/100) - 2020/08/20 15:01:40 ET
Table 'Manuel Neuer' 9-max (Play Money) Seat #3 is the button
Seat 1: JeBoyDirk (7750 in chips) 
Seat 2: dddocky (8846 in chips) 
Seat 3: RichRick1337 (9238 in chips) 
Seat 4: Duke Croix (9254 in chips) 
Seat 6: color_singleton (11936 in chips) 
Seat 9: Manon541 (11399 in chips) 
Duke Croix: posts small blind 50
color_singleton: posts big blind 100
*** HOLE CARDS ***
Dealt to Duke Croix [5c 9d]
Manon541: folds 
JeBoyDirk: calls 100
dddocky: folds 
RichRick1337: calls 100
Duke Croix: calls 50
color_singleton: checks 
*** FLOP *** [Qh 4d 6s]
Duke Croix: checks 
color_singleton: checks 
JeBoyDirk: checks 
RichRick1337: bets 100
Duke Croix: folds 
color_singleton: folds 
JeBoyDirk: folds 
Uncalled bet (100) returned to RichRick1337
RichRick1337 collected 378 from pot
RichRick1337: doesn't show hand 
*** SUMMARY ***
Total pot 400 | Rake 22 
Board [Qh 4d 6s]
Seat 1: JeBoyDirk folded on the Flop
Seat 2: dddocky folded before Flop (didn't bet)
Seat 3: RichRick1337 (button) collected (378)
Seat 4: Duke Croix (small blind) folded on the Flop
Seat 6: color_singleton (big blind) folded on the Flop
Seat 9: Manon541 folded before Flop (didn't bet)



PokerStars Home Game Hand #217630282735: {Club #3225207}  Hold'em No Limit (50/100) - 2020/08/20 15:02:31 ET
Table 'Manuel Neuer' 9-max (Play Money) Seat #4 is the button
Seat 1: JeBoyDirk (7650 in chips) 
Seat 2: dddocky (8846 in chips) 
Seat 3: RichRick1337 (9516 in chips) 
Seat 4: Duke Croix (9154 in chips) 
Seat 6: color_singleton (11836 in chips) 
Seat 9: Manon541 (11399 in chips) 
color_singleton: posts small blind 50
Manon541: posts big blind 100
*** HOLE CARDS ***
Dealt to Duke Croix [Qd Js]
JeBoyDirk: folds 
dddocky: calls 100
RichRick1337: calls 100
Duke Croix: raises 200 to 300
color_singleton: calls 250
Manon541: folds 
dddocky: calls 200
RichRick1337: calls 200
*** FLOP *** [2c 4s 7h]
color_singleton: checks 
dddocky: checks 
RichRick1337: checks 
Duke Croix: bets 700
color_singleton: folds 
dddocky: folds 
RichRick1337: folds 
Uncalled bet (700) returned to Duke Croix
Duke Croix collected 1228 from pot
*** SUMMARY ***
Total pot 1300 | Rake 72 
Board [2c 4s 7h]
Seat 1: JeBoyDirk folded before Flop (didn't bet)
Seat 2: dddocky folded on the Flop
Seat 3: RichRick1337 folded on the Flop
Seat 4: Duke Croix (button) collected (1228)
Seat 6: color_singleton (small blind) folded on the Flop
Seat 9: Manon541 (big blind) folded before Flop



PokerStars Home Game Hand #217630302307: {Club #3225207}  Hold'em No Limit (50/100) - 2020/08/20 15:03:06 ET
Table 'Manuel Neuer' 9-max (Play Money) Seat #6 is the button
Seat 1: JeBoyDirk (7650 in chips) 
Seat 2: dddocky (8546 in chips) 
Seat 3: RichRick1337 (9216 in chips) 
Seat 4: Duke Croix (10082 in chips) 
Seat 6: color_singleton (11536 in chips) 
Seat 9: Manon541 (11299 in chips) 
Manon541: posts small blind 50
JeBoyDirk: posts big blind 100
*** HOLE CARDS ***
Dealt to Duke Croix [2d 8h]
dddocky: calls 100
RichRick1337: calls 100
Duke Croix: folds 
color_singleton: calls 100
Manon541: folds 
JeBoyDirk: checks 
*** FLOP *** [5c 8d Ac]
JeBoyDirk: checks 
dddocky: checks 
RichRick1337: bets 100
color_singleton: folds 
JeBoyDirk: folds 
dddocky: calls 100
*** TURN *** [5c 8d Ac] [5s]
dddocky: checks 
RichRick1337: bets 700
dddocky: calls 700
*** RIVER *** [5c 8d Ac 5s] [Kc]
dddocky: bets 1200
RichRick1337: calls 1200
*** SHOW DOWN ***
dddocky: shows [2c Tc] (a flush, Ace high)
RichRick1337: mucks hand 
dddocky collected 4205 from pot
*** SUMMARY ***
Total pot 4450 | Rake 245 
Board [5c 8d Ac 5s Kc]
Seat 1: JeBoyDirk (big blind) folded on the Flop
Seat 2: dddocky showed [2c Tc] and won (4205) with a flush, Ace high
Seat 3: RichRick1337 mucked [5d Qc]
Seat 4: Duke Croix folded before Flop (didn't bet)
Seat 6: color_singleton (button) folded on the Flop
Seat 9: Manon541 (small blind) folded before Flop



PokerStars Home Game Hand #217630327895: {Club #3225207}  Hold'em No Limit (50/100) - 2020/08/20 15:03:52 ET
Table 'Manuel Neuer' 9-max (Play Money) Seat #9 is the button
Seat 1: JeBoyDirk (7550 in chips) 
Seat 2: dddocky (10651 in chips) 
Seat 3: RichRick1337 (7116 in chips) 
Seat 4: Duke Croix (10082 in chips) 
Seat 6: color_singleton (11436 in chips) 
Seat 9: Manon541 (11249 in chips) 
JeBoyDirk: posts small blind 50
dddocky: posts big blind 100
*** HOLE CARDS ***
Dealt to Duke Croix [Ts 2h]
RichRick1337: calls 100
Duke Croix: folds 
color_singleton: folds 
Manon541: calls 100
JeBoyDirk: calls 50
dddocky: checks 
*** FLOP *** [Jh 4h 3h]
JeBoyDirk: checks 
dddocky: bets 100
RichRick1337: raises 100 to 200
Manon541: calls 200
JeBoyDirk: raises 300 to 500
dddocky: calls 400
RichRick1337: calls 300
Manon541: calls 300
*** TURN *** [Jh 4h 3h] [2d]
JeBoyDirk: checks 
dddocky: checks 
RichRick1337: bets 100
Manon541: calls 100
JeBoyDirk: raises 600 to 700
dddocky: folds 
RichRick1337: calls 600
Manon541: folds 
*** RIVER *** [Jh 4h 3h 2d] [Th]
JeBoyDirk: checks 
RichRick1337: bets 300
JeBoyDirk: calls 300
*** SHOW DOWN ***
RichRick1337: shows [Jd 6h] (a flush, Jack high)
JeBoyDirk: shows [7h 8h] (a flush, Jack high - Eight higher)
JeBoyDirk collected 4252 from pot
*** SUMMARY ***
Total pot 4500 | Rake 248 
Board [Jh 4h 3h 2d Th]
Seat 1: JeBoyDirk (small blind) showed [7h 8h] and won (4252) with a flush, Jack high
Seat 2: dddocky (big blind) folded on the Turn
Seat 3: RichRick1337 showed [Jd 6h] and lost with a flush, Jack high
Seat 4: Duke Croix folded before Flop (didn't bet)
Seat 6: color_singleton folded before Flop (didn't bet)
Seat 9: Manon541 (button) folded on the Turn



PokerStars Home Game Hand #217630374144: {Club #3225207}  Hold'em No Limit (50/100) - 2020/08/20 15:05:13 ET
Table 'Manuel Neuer' 9-max (Play Money) Seat #1 is the button
Seat 1: JeBoyDirk (10202 in chips) 
Seat 2: dddocky (10051 in chips) 
Seat 3: RichRick1337 (5516 in chips) 
Seat 4: Duke Croix (10082 in chips) 
Seat 6: color_singleton (11436 in chips) 
Seat 9: Manon541 (10549 in chips) 
dddocky: posts small blind 50
RichRick1337: posts big blind 100
*** HOLE CARDS ***
Dealt to Duke Croix [As 2c]
Duke Croix: calls 100
color_singleton: raises 100 to 200
Manon541: calls 200
JeBoyDirk: calls 200
dddocky: folds 
RichRick1337: calls 100
Duke Croix: calls 100
*** FLOP *** [Ks 4c Jd]
RichRick1337: checks 
Duke Croix: checks 
color_singleton: bets 496
Manon541: folds 
JeBoyDirk: calls 496
RichRick1337: calls 496
Duke Croix: folds 
*** TURN *** [Ks 4c Jd] [3d]
RichRick1337: checks 
color_singleton: checks 
JeBoyDirk: bets 1000
RichRick1337: calls 1000
color_singleton: folds 
*** RIVER *** [Ks 4c Jd 3d] [Js]
RichRick1337: checks 
JeBoyDirk: checks 
*** SHOW DOWN ***
RichRick1337: shows [4d 5d] (two pair, Jacks and Fours)
JeBoyDirk: shows [Kh Ah] (two pair, Kings and Jacks)
JeBoyDirk collected 4288 from pot
*** SUMMARY ***
Total pot 4538 | Rake 250 
Board [Ks 4c Jd 3d Js]
Seat 1: JeBoyDirk (button) showed [Kh Ah] and won (4288) with two pair, Kings and Jacks
Seat 2: dddocky (small blind) folded before Flop
Seat 3: RichRick1337 (big blind) showed [4d 5d] and lost with two pair, Jacks and Fours
Seat 4: Duke Croix folded on the Flop
Seat 6: color_singleton folded on the Turn
Seat 9: Manon541 folded on the Flop



PokerStars Home Game Hand #217630412391: {Club #3225207}  Hold'em No Limit (50/100) - 2020/08/20 15:06:17 ET
Table 'Manuel Neuer' 9-max (Play Money) Seat #3 is the button
Seat 1: JeBoyDirk (12794 in chips) 
Seat 3: RichRick1337 (3820 in chips) 
Seat 4: Duke Croix (9882 in chips) 
Seat 6: color_singleton (10740 in chips) 
Seat 9: Manon541 (10349 in chips) 
Duke Croix: posts small blind 50
color_singleton: posts big blind 100
*** HOLE CARDS ***
Dealt to Duke Croix [9c 2s]
Manon541: folds 
JeBoyDirk: calls 100
RichRick1337: calls 100
Duke Croix: calls 50
color_singleton: checks 
*** FLOP *** [3c Tc Jh]
Duke Croix: checks 
color_singleton: checks 
JeBoyDirk: checks 
RichRick1337: checks 
*** TURN *** [3c Tc Jh] [8d]
Duke Croix: checks 
color_singleton: checks 
JeBoyDirk: checks 
RichRick1337: checks 
*** RIVER *** [3c Tc Jh 8d] [9s]
Duke Croix: checks 
color_singleton: bets 378
JeBoyDirk: raises 378 to 756
RichRick1337: calls 756
Duke Croix: folds 
color_singleton: calls 378
*** SHOW DOWN ***
JeBoyDirk: shows [Kd Qh] (a straight, Nine to King)
RichRick1337: mucks hand 
color_singleton: mucks hand 
JeBoyDirk collected 2521 from pot
*** SUMMARY ***
Total pot 2668 | Rake 147 
Board [3c Tc Jh 8d 9s]
Seat 1: JeBoyDirk showed [Kd Qh] and won (2521) with a straight, Nine to King
Seat 3: RichRick1337 (button) mucked [Qd 3s]
Seat 4: Duke Croix (small blind) folded on the River
Seat 6: color_singleton (big blind) mucked [Qc 2h]
Seat 9: Manon541 folded before Flop (didn't bet)



PokerStars Home Game Hand #217630444048: {Club #3225207}  Hold'em No Limit (50/100) - 2020/08/20 15:07:10 ET
Table 'Manuel Neuer' 9-max (Play Money) Seat #4 is the button
Seat 1: JeBoyDirk (14459 in chips) 
Seat 2: dddocky (10001 in chips) 
Seat 3: RichRick1337 (2964 in chips) 
Seat 4: Duke Croix (9782 in chips) 
Seat 6: color_singleton (9884 in chips) 
Seat 9: Manon541 (10349 in chips) 
color_singleton: posts small blind 50
Manon541: posts big blind 100
*** HOLE CARDS ***
Dealt to Duke Croix [Qd 6d]
JeBoyDirk: folds 
dddocky: calls 100
RichRick1337 has timed out
RichRick1337: folds 
Duke Croix: calls 100
color_singleton: calls 50
Manon541: checks 
*** FLOP *** [Ts 4c Jc]
color_singleton: checks 
Manon541: bets 100
dddocky: raises 100 to 200
Duke Croix: folds 
color_singleton: calls 200
Manon541: calls 100
*** TURN *** [Ts 4c Jc] [Kd]
color_singleton: checks 
Manon541: checks 
dddocky: bets 100
color_singleton: calls 100
Manon541: calls 100
*** RIVER *** [Ts 4c Jc Kd] [5d]
color_singleton: checks 
Manon541: checks 
dddocky: checks 
*** SHOW DOWN ***
color_singleton: shows [Ac 7s] (high card Ace)
Manon541: mucks hand 
dddocky: shows [5h Jd] (two pair, Jacks and Fives)
dddocky collected 1228 from pot
*** SUMMARY ***
Total pot 1300 | Rake 72 
Board [Ts 4c Jc Kd 5d]
Seat 1: JeBoyDirk folded before Flop (didn't bet)
Seat 2: dddocky showed [5h Jd] and won (1228) with two pair, Jacks and Fives
Seat 3: RichRick1337 folded before Flop (didn't bet)
Seat 4: Duke Croix (button) folded on the Flop
Seat 6: color_singleton (small blind) showed [Ac 7s] and lost with high card Ace
Seat 9: Manon541 (big blind) mucked [7c 9c]



PokerStars Home Game Hand #217630482618: {Club #3225207}  Hold'em No Limit (50/100) - 2020/08/20 15:08:15 ET
Table 'Manuel Neuer' 9-max (Play Money) Seat #6 is the button
Seat 1: JeBoyDirk (14459 in chips) 
Seat 2: dddocky (10829 in chips) 
Seat 3: RichRick1337 (2964 in chips) 
Seat 4: Duke Croix (9682 in chips) 
Seat 6: color_singleton (9484 in chips) 
Seat 9: Manon541 (9949 in chips) 
Manon541: posts small blind 50
JeBoyDirk: posts big blind 100
*** HOLE CARDS ***
Dealt to Duke Croix [Tc 7c]
dddocky: folds 
RichRick1337: calls 100
Duke Croix: calls 100
color_singleton: calls 100
Manon541: calls 50
JeBoyDirk: checks 
*** FLOP *** [4s 5d Td]
Manon541: checks 
JeBoyDirk: checks 
RichRick1337: checks 
Duke Croix: bets 300
color_singleton: folds 
Manon541: folds 
JeBoyDirk: calls 300
RichRick1337: folds 
*** TURN *** [4s 5d Td] [Kc]
JeBoyDirk: checks 
Duke Croix: checks 
*** RIVER *** [4s 5d Td Kc] [Th]
JeBoyDirk: checks 
Duke Croix: bets 1000
JeBoyDirk: calls 1000
*** SHOW DOWN ***
Duke Croix: shows [Tc 7c] (three of a kind, Tens)
JeBoyDirk: mucks hand 
Duke Croix collected 2929 from pot
*** SUMMARY ***
Total pot 3100 | Rake 171 
Board [4s 5d Td Kc Th]
Seat 1: JeBoyDirk (big blind) mucked [Jd Ks]
Seat 2: dddocky folded before Flop (didn't bet)
Seat 3: RichRick1337 folded on the Flop
Seat 4: Duke Croix showed [Tc 7c] and won (2929) with three of a kind, Tens
Seat 6: color_singleton (button) folded on the Flop
Seat 9: Manon541 (small blind) folded on the Flop



PokerStars Home Game Hand #217630513147: {Club #3225207}  Hold'em No Limit (50/100) - 2020/08/20 15:09:07 ET
Table 'Manuel Neuer' 9-max (Play Money) Seat #9 is the button
Seat 1: JeBoyDirk (13059 in chips) 
Seat 2: dddocky (10829 in chips) 
Seat 3: RichRick1337 (2864 in chips) 
Seat 4: Duke Croix (11211 in chips) 
Seat 6: color_singleton (9384 in chips) 
Seat 9: Manon541 (9849 in chips) 
JeBoyDirk: posts small blind 50
dddocky: posts big blind 100
*** HOLE CARDS ***
Dealt to Duke Croix [2s 5h]
RichRick1337: calls 100
Duke Croix: folds 
color_singleton: raises 200 to 300
Manon541: calls 300
JeBoyDirk: folds 
dddocky: calls 200
RichRick1337: folds 
*** FLOP *** [Qd Qc 3c]
dddocky: checks 
color_singleton: checks 
Manon541: checks 
*** TURN *** [Qd Qc 3c] [6h]
dddocky: checks 
color_singleton: checks 
Manon541: checks 
*** RIVER *** [Qd Qc 3c 6h] [Kh]
dddocky: bets 100
color_singleton: raises 200 to 300
Manon541: folds 
dddocky: calls 200
*** SHOW DOWN ***
color_singleton: shows [Ks Jh] (two pair, Kings and Queens)
dddocky: mucks hand 
color_singleton collected 1559 from pot
*** SUMMARY ***
Total pot 1650 | Rake 91 
Board [Qd Qc 3c 6h Kh]
Seat 1: JeBoyDirk (small blind) folded before Flop
Seat 2: dddocky (big blind) mucked [3s Ad]
Seat 3: RichRick1337 folded before Flop
Seat 4: Duke Croix folded before Flop (didn't bet)
Seat 6: color_singleton showed [Ks Jh] and won (1559) with two pair, Kings and Queens
Seat 9: Manon541 (button) folded on the River



PokerStars Home Game Hand #217630538310: {Club #3225207}  Hold'em No Limit (50/100) - 2020/08/20 15:09:50 ET
Table 'Manuel Neuer' 9-max (Play Money) Seat #1 is the button
Seat 1: JeBoyDirk (13009 in chips) 
Seat 2: dddocky (10229 in chips) 
Seat 3: RichRick1337 (2764 in chips) 
Seat 4: Duke Croix (11211 in chips) 
Seat 6: color_singleton (10343 in chips) 
Seat 9: Manon541 (9549 in chips) 
dddocky: posts small blind 50
RichRick1337: posts big blind 100
*** HOLE CARDS ***
Dealt to Duke Croix [Ah 5h]
Duke Croix: raises 200 to 300
color_singleton: folds 
Manon541: calls 300
JeBoyDirk: folds 
dddocky: calls 250
RichRick1337: calls 200
*** FLOP *** [5d Ts Ks]
dddocky: checks 
RichRick1337: checks 
Duke Croix: checks 
Manon541: checks 
*** TURN *** [5d Ts Ks] [Th]
dddocky: checks 
RichRick1337: checks 
Duke Croix: bets 700
Manon541: calls 700
dddocky: folds 
RichRick1337: folds 
*** RIVER *** [5d Ts Ks Th] [Qc]
Duke Croix: checks 
Manon541: checks 
*** SHOW DOWN ***
Duke Croix: shows [Ah 5h] (two pair, Tens and Fives)
Manon541: mucks hand 
Duke Croix collected 2457 from pot
*** SUMMARY ***
Total pot 2600 | Rake 143 
Board [5d Ts Ks Th Qc]
Seat 1: JeBoyDirk (button) folded before Flop (didn't bet)
Seat 2: dddocky (small blind) folded on the Turn
Seat 3: RichRick1337 (big blind) folded on the Turn
Seat 4: Duke Croix showed [Ah 5h] and won (2457) with two pair, Tens and Fives
Seat 6: color_singleton folded before Flop (didn't bet)
Seat 9: Manon541 mucked [2c 2h]



PokerStars Home Game Hand #217630569715: {Club #3225207}  Hold'em No Limit (50/100) - 2020/08/20 15:10:43 ET
Table 'Manuel Neuer' 9-max (Play Money) Seat #2 is the button
Seat 1: JeBoyDirk (13009 in chips) 
Seat 2: dddocky (9929 in chips) 
Seat 3: RichRick1337 (2464 in chips) 
Seat 4: Duke Croix (12668 in chips) 
Seat 6: color_singleton (10343 in chips) 
Seat 9: Manon541 (8549 in chips) 
RichRick1337: posts small blind 50
Duke Croix: posts big blind 100
*** HOLE CARDS ***
Dealt to Duke Croix [9s Ts]
color_singleton: raises 200 to 300
Manon541: calls 300
JeBoyDirk: folds 
dddocky: calls 300
RichRick1337: calls 250
Duke Croix: calls 200
*** FLOP *** [Th 9h Qd]
RichRick1337: checks 
Duke Croix: bets 1000
color_singleton: calls 1000
Manon541: folds 
dddocky: folds 
RichRick1337: folds 
*** TURN *** [Th 9h Qd] [Ah]
Duke Croix: checks 
color_singleton: bets 1653
Duke Croix: folds 
Uncalled bet (1653) returned to color_singleton
color_singleton collected 3307 from pot
color_singleton: doesn't show hand 
*** SUMMARY ***
Total pot 3500 | Rake 193 
Board [Th 9h Qd Ah]
Seat 1: JeBoyDirk folded before Flop (didn't bet)
Seat 2: dddocky (button) folded on the Flop
Seat 3: RichRick1337 (small blind) folded on the Flop
Seat 4: Duke Croix (big blind) folded on the Turn
Seat 6: color_singleton collected (3307)
Seat 9: Manon541 folded on the Flop



PokerStars Home Game Hand #217630610608: {Club #3225207}  Hold'em No Limit (50/100) - 2020/08/20 15:11:52 ET
Table 'Manuel Neuer' 9-max (Play Money) Seat #3 is the button
Seat 1: JeBoyDirk (13009 in chips) 
Seat 2: dddocky (9629 in chips) 
Seat 3: RichRick1337 (2164 in chips) 
Seat 4: Duke Croix (11368 in chips) 
Seat 6: color_singleton (12350 in chips) 
Seat 9: Manon541 (8249 in chips) 
Duke Croix: posts small blind 50
color_singleton: posts big blind 100
*** HOLE CARDS ***
Dealt to Duke Croix [Kh 4c]
Manon541: calls 100
JeBoyDirk: folds 
dddocky: calls 100
RichRick1337: calls 100
Duke Croix: calls 50
color_singleton: checks 
*** FLOP *** [5s Ah 6s]
Duke Croix: checks 
color_singleton: checks 
Manon541: checks 
dddocky: checks 
RichRick1337: checks 
*** TURN *** [5s Ah 6s] [Kc]
Duke Croix: bets 400
color_singleton: folds 
Manon541: folds 
dddocky: calls 400
RichRick1337: calls 400
*** RIVER *** [5s Ah 6s Kc] [9c]
Duke Croix: bets 900
dddocky: calls 900
RichRick1337: calls 900
*** SHOW DOWN ***
Duke Croix: shows [Kh 4c] (a pair of Kings)
dddocky: shows [Ks 7s] (a pair of Kings - Ace+Nine+Seven kicker)
RichRick1337: shows [8s As] (a pair of Aces)
RichRick1337 collected 4158 from pot
*** SUMMARY ***
Total pot 4400 | Rake 242 
Board [5s Ah 6s Kc 9c]
Seat 1: JeBoyDirk folded before Flop (didn't bet)
Seat 2: dddocky showed [Ks 7s] and lost with a pair of Kings
Seat 3: RichRick1337 (button) showed [8s As] and won (4158) with a pair of Aces
Seat 4: Duke Croix (small blind) showed [Kh 4c] and lost with a pair of Kings
Seat 6: color_singleton (big blind) folded on the Turn
Seat 9: Manon541 folded on the Turn



PokerStars Home Game Hand #217630638007: {Club #3225207}  Hold'em No Limit (50/100) - 2020/08/20 15:12:39 ET
Table 'Manuel Neuer' 9-max (Play Money) Seat #4 is the button
Seat 1: JeBoyDirk (13009 in chips) 
Seat 2: dddocky (8229 in chips) 
Seat 3: RichRick1337 (4922 in chips) 
Seat 4: Duke Croix (9968 in chips) 
Seat 6: color_singleton (12250 in chips) 
Seat 9: Manon541 (8149 in chips) 
color_singleton: posts small blind 50
Manon541: posts big blind 100
*** HOLE CARDS ***
Dealt to Duke Croix [Ad 7c]
JeBoyDirk: folds 
dddocky: calls 100
RichRick1337: calls 100
Duke Croix: calls 100
color_singleton: calls 50
Manon541: checks 
*** FLOP *** [9d 4c 9s]
color_singleton: checks 
Manon541: checks 
dddocky: checks 
RichRick1337: checks 
Duke Croix: checks 
*** TURN *** [9d 4c 9s] [Kc]
color_singleton: bets 236
Manon541: folds 
dddocky: calls 236
RichRick1337: raises 236 to 472
Duke Croix: folds 
color_singleton: calls 236
dddocky: folds 
*** RIVER *** [9d 4c 9s Kc] [3h]
color_singleton: checks 
RichRick1337: checks 
*** SHOW DOWN ***
color_singleton: shows [4h 8h] (two pair, Nines and Fours)
RichRick1337: shows [Ks 7h] (two pair, Kings and Nines)
RichRick1337 collected 1588 from pot
*** SUMMARY ***
Total pot 1680 | Rake 92 
Board [9d 4c 9s Kc 3h]
Seat 1: JeBoyDirk folded before Flop (didn't bet)
Seat 2: dddocky folded on the Turn
Seat 3: RichRick1337 showed [Ks 7h] and won (1588) with two pair, Kings and Nines
Seat 4: Duke Croix (button) folded on the Turn
Seat 6: color_singleton (small blind) showed [4h 8h] and lost with two pair, Nines and Fours
Seat 9: Manon541 (big blind) folded on the Turn



PokerStars Home Game Hand #217630668396: {Club #3225207}  Hold'em No Limit (50/100) - 2020/08/20 15:13:30 ET
Table 'Manuel Neuer' 9-max (Play Money) Seat #6 is the button
Seat 1: JeBoyDirk (13009 in chips) 
Seat 2: dddocky (7893 in chips) 
Seat 3: RichRick1337 (5938 in chips) 
Seat 4: Duke Croix (9868 in chips) 
Seat 6: color_singleton (11678 in chips) 
Seat 9: Manon541 (8049 in chips) 
Manon541: posts small blind 50
JeBoyDirk: posts big blind 100
*** HOLE CARDS ***
Dealt to Duke Croix [4c 2c]
dddocky: calls 100
RichRick1337: raises 100 to 200
Duke Croix: folds 
color_singleton: calls 200
Manon541: calls 150
JeBoyDirk: calls 100
dddocky: calls 100
*** FLOP *** [Kd 9c Qh]
Manon541: checks 
JeBoyDirk: checks 
dddocky: checks 
RichRick1337: bets 100
color_singleton: raises 200 to 300
Manon541: calls 300
JeBoyDirk: folds 
dddocky: calls 300
RichRick1337: calls 200
*** TURN *** [Kd 9c Qh] [2h]
Manon541: checks 
dddocky: checks 
RichRick1337: checks 
color_singleton: bets 1100
Manon541: folds 
dddocky: folds 
RichRick1337: folds 
Uncalled bet (1100) returned to color_singleton
color_singleton collected 2079 from pot
color_singleton: doesn't show hand 
*** SUMMARY ***
Total pot 2200 | Rake 121 
Board [Kd 9c Qh 2h]
Seat 1: JeBoyDirk (big blind) folded on the Flop
Seat 2: dddocky folded on the Turn
Seat 3: RichRick1337 folded on the Turn
Seat 4: Duke Croix folded before Flop (didn't bet)
Seat 6: color_singleton (button) collected (2079)
Seat 9: Manon541 (small blind) folded on the Turn



PokerStars Home Game Hand #217630695489: {Club #3225207}  Hold'em No Limit (50/100) - 2020/08/20 15:14:16 ET
Table 'Manuel Neuer' 9-max (Play Money) Seat #1 is the button
Seat 1: JeBoyDirk (12809 in chips) 
Seat 2: dddocky (7393 in chips) 
Seat 3: RichRick1337 (5438 in chips) 
Seat 4: Duke Croix (9868 in chips) 
Seat 6: color_singleton (13257 in chips) 
dddocky: posts small blind 50
RichRick1337: posts big blind 100
*** HOLE CARDS ***
Dealt to Duke Croix [8s Ah]
Duke Croix has timed out
Duke Croix: folds 
color_singleton: folds 
JeBoyDirk: folds 
dddocky: calls 50
RichRick1337: checks 
*** FLOP *** [2h 9c Kd]
dddocky: bets 189
RichRick1337: calls 189
*** TURN *** [2h 9c Kd] [Jd]
dddocky: bets 546
RichRick1337: folds 
Uncalled bet (546) returned to dddocky
dddocky collected 546 from pot
dddocky: doesn't show hand 
*** SUMMARY ***
Total pot 578 | Rake 32 
Board [2h 9c Kd Jd]
Seat 1: JeBoyDirk (button) folded before Flop (didn't bet)
Seat 2: dddocky (small blind) collected (546)
Seat 3: RichRick1337 (big blind) folded on the Turn
Seat 4: Duke Croix folded before Flop (didn't bet)
Seat 6: color_singleton folded before Flop (didn't bet)



PokerStars Home Game Hand #217630789168: {Club #3225207}  Hold'em No Limit (50/100) - 2020/08/20 15:16:53 ET
Table 'Manuel Neuer' 9-max (Play Money) Seat #2 is the button
Seat 1: JeBoyDirk (12659 in chips) 
Seat 2: dddocky (7500 in chips) 
Seat 3: RichRick1337 (5057 in chips) 
Seat 4: Duke Croix (9868 in chips) 
Seat 6: color_singleton (13555 in chips) 
RichRick1337: posts small blind 50
Duke Croix: posts big blind 100
*** HOLE CARDS ***
Dealt to Duke Croix [3h Qd]
color_singleton: raises 200 to 300
JeBoyDirk: folds 
dddocky: calls 300
RichRick1337: calls 250
Duke Croix: folds 
*** FLOP *** [8c 2s Qh]
RichRick1337: checks 
color_singleton: checks 
dddocky: checks 
*** TURN *** [8c 2s Qh] [Kh]
RichRick1337: checks 
color_singleton: checks 
dddocky: checks 
*** RIVER *** [8c 2s Qh Kh] [3d]
RichRick1337: checks 
color_singleton: checks 
dddocky: checks 
*** SHOW DOWN ***
RichRick1337: shows [2h Js] (a pair of Deuces)
color_singleton: mucks hand 
dddocky: mucks hand 
RichRick1337 collected 945 from pot
*** SUMMARY ***
Total pot 1000 | Rake 55 
Board [8c 2s Qh Kh 3d]
Seat 1: JeBoyDirk folded before Flop (didn't bet)
Seat 2: dddocky (button) mucked [Ad 9c]
Seat 3: RichRick1337 (small blind) showed [2h Js] and won (945) with a pair of Deuces
Seat 4: Duke Croix (big blind) folded before Flop
Seat 6: color_singleton mucked [Tc As]



PokerStars Home Game Hand #217630812108: {Club #3225207}  Hold'em No Limit (50/100) - 2020/08/20 15:17:32 ET
Table 'Manuel Neuer' 9-max (Play Money) Seat #3 is the button
Seat 1: JeBoyDirk (12659 in chips) 
Seat 2: dddocky (7200 in chips) 
Seat 3: RichRick1337 (5702 in chips) 
Seat 4: Duke Croix (9768 in chips) 
Seat 6: color_singleton (13255 in chips) 
Duke Croix: posts small blind 50
color_singleton: posts big blind 100
*** HOLE CARDS ***
Dealt to Duke Croix [As 3d]
JeBoyDirk: folds 
dddocky: folds 
RichRick1337: calls 100
Duke Croix: calls 50
color_singleton: checks 
*** FLOP *** [5s 7h Qh]
Duke Croix: checks 
color_singleton: checks 
RichRick1337: checks 
*** TURN *** [5s 7h Qh] [Jc]
Duke Croix: checks 
color_singleton: checks 
RichRick1337: bets 100
Duke Croix: folds 
color_singleton: calls 100
*** RIVER *** [5s 7h Qh Jc] [Jh]
color_singleton: checks 
RichRick1337: bets 500
color_singleton: folds 
Uncalled bet (500) returned to RichRick1337
RichRick1337 collected 472 from pot
RichRick1337: doesn't show hand 
*** SUMMARY ***
Total pot 500 | Rake 28 
Board [5s 7h Qh Jc Jh]
Seat 1: JeBoyDirk folded before Flop (didn't bet)
Seat 2: dddocky folded before Flop (didn't bet)
Seat 3: RichRick1337 (button) collected (472)
Seat 4: Duke Croix (small blind) folded on the Turn
Seat 6: color_singleton (big blind) folded on the River



PokerStars Home Game Hand #217630833244: {Club #3225207}  Hold'em No Limit (50/100) - 2020/08/20 15:18:07 ET
Table 'Manuel Neuer' 9-max (Play Money) Seat #4 is the button
Seat 1: JeBoyDirk (12659 in chips) 
Seat 2: dddocky (7200 in chips) 
Seat 3: RichRick1337 (5974 in chips) 
Seat 4: Duke Croix (9668 in chips) 
Seat 6: color_singleton (13055 in chips) 
Seat 9: Manon541 (7549 in chips) 
color_singleton: posts small blind 50
Manon541: posts big blind 100
*** HOLE CARDS ***
Dealt to Duke Croix [Qd Kh]
JeBoyDirk: folds 
dddocky: calls 100
RichRick1337: calls 100
Duke Croix: raises 300 to 400
color_singleton: folds 
Manon541: folds 
dddocky: calls 300
RichRick1337: calls 300
*** FLOP *** [7s 5c 2d]
dddocky: checks 
RichRick1337: checks 
Duke Croix: bets 700
dddocky: folds 
RichRick1337: folds 
Uncalled bet (700) returned to Duke Croix
Duke Croix collected 1276 from pot
*** SUMMARY ***
Total pot 1350 | Rake 74 
Board [7s 5c 2d]
Seat 1: JeBoyDirk folded before Flop (didn't bet)
Seat 2: dddocky folded on the Flop
Seat 3: RichRick1337 folded on the Flop
Seat 4: Duke Croix (button) collected (1276)
Seat 6: color_singleton (small blind) folded before Flop
Seat 9: Manon541 (big blind) folded before Flop



PokerStars Home Game Hand #217630856257: {Club #3225207}  Hold'em No Limit (50/100) - 2020/08/20 15:18:46 ET
Table 'Manuel Neuer' 9-max (Play Money) Seat #6 is the button
Seat 1: JeBoyDirk (12659 in chips) 
Seat 2: dddocky (6800 in chips) 
Seat 3: RichRick1337 (5574 in chips) 
Seat 4: Duke Croix (10544 in chips) 
Seat 6: color_singleton (13005 in chips) 
Seat 9: Manon541 (7449 in chips) 
Manon541: posts small blind 50
JeBoyDirk: posts big blind 100
*** HOLE CARDS ***
Dealt to Duke Croix [6d 3c]
dddocky: folds 
RichRick1337: calls 100
Duke Croix: folds 
color_singleton: calls 100
Manon541: calls 50
JeBoyDirk: checks 
*** FLOP *** [Jh Qd 6s]
Manon541: checks 
JeBoyDirk: checks 
RichRick1337: checks 
color_singleton: checks 
*** TURN *** [Jh Qd 6s] [6c]
Manon541: bets 189
JeBoyDirk: folds 
RichRick1337: folds 
color_singleton: folds 
Uncalled bet (189) returned to Manon541
Manon541 collected 378 from pot
*** SUMMARY ***
Total pot 400 | Rake 22 
Board [Jh Qd 6s 6c]
Seat 1: JeBoyDirk (big blind) folded on the Turn
Seat 2: dddocky folded before Flop (didn't bet)
Seat 3: RichRick1337 folded on the Turn
Seat 4: Duke Croix folded before Flop (didn't bet)
Seat 6: color_singleton (button) folded on the Turn
Seat 9: Manon541 (small blind) collected (378)



PokerStars Home Game Hand #217630878593: {Club #3225207}  Hold'em No Limit (50/100) - 2020/08/20 15:19:23 ET
Table 'Manuel Neuer' 9-max (Play Money) Seat #9 is the button
Seat 1: JeBoyDirk (12559 in chips) 
Seat 2: dddocky (6800 in chips) 
Seat 3: RichRick1337 (5474 in chips) 
Seat 4: Duke Croix (10544 in chips) 
Seat 6: color_singleton (12905 in chips) 
Seat 9: Manon541 (7727 in chips) 
JeBoyDirk: posts small blind 50
dddocky: posts big blind 100
*** HOLE CARDS ***
Dealt to Duke Croix [8h Qs]
RichRick1337: calls 100
Duke Croix: calls 100
color_singleton: calls 100
Manon541: calls 100
JeBoyDirk: calls 50
dddocky: checks 
*** FLOP *** [Qd Ks 3h]
JeBoyDirk: checks 
dddocky: bets 100
RichRick1337: calls 100
Duke Croix: calls 100
color_singleton: calls 100
Manon541: calls 100
JeBoyDirk: folds 
*** TURN *** [Qd Ks 3h] [4h]
dddocky: bets 100
RichRick1337: calls 100
Duke Croix: calls 100
color_singleton: calls 100
Manon541: calls 100
*** RIVER *** [Qd Ks 3h 4h] [2h]
dddocky: checks 
RichRick1337: checks 
Duke Croix: checks 
color_singleton: bets 800
Manon541: folds 
dddocky: folds 
RichRick1337: folds 
Duke Croix: folds 
Uncalled bet (800) returned to color_singleton
color_singleton collected 1512 from pot
color_singleton: doesn't show hand 
*** SUMMARY ***
Total pot 1600 | Rake 88 
Board [Qd Ks 3h 4h 2h]
Seat 1: JeBoyDirk (small blind) folded on the Flop
Seat 2: dddocky (big blind) folded on the River
Seat 3: RichRick1337 folded on the River
Seat 4: Duke Croix folded on the River
Seat 6: color_singleton collected (1512)
Seat 9: Manon541 (button) folded on the River



PokerStars Home Game Hand #217630922665: {Club #3225207}  Hold'em No Limit (50/100) - 2020/08/20 15:20:37 ET
Table 'Manuel Neuer' 9-max (Play Money) Seat #1 is the button
Seat 1: JeBoyDirk (12459 in chips) 
Seat 2: dddocky (6500 in chips) 
Seat 3: RichRick1337 (5174 in chips) 
Seat 4: Duke Croix (10244 in chips) 
Seat 6: color_singleton (14117 in chips) 
Seat 9: Manon541 (7427 in chips) 
dddocky: posts small blind 50
RichRick1337: posts big blind 100
*** HOLE CARDS ***
Dealt to Duke Croix [4d 6s]
Duke Croix: folds 
color_singleton: folds 
Manon541: folds 
JeBoyDirk: folds 
dddocky: calls 50
RichRick1337: checks 
*** FLOP *** [Ad Ah 5c]
dddocky: checks 
RichRick1337: bets 100
dddocky: folds 
Uncalled bet (100) returned to RichRick1337
RichRick1337 collected 189 from pot
RichRick1337: doesn't show hand 
*** SUMMARY ***
Total pot 200 | Rake 11 
Board [Ad Ah 5c]
Seat 1: JeBoyDirk (button) folded before Flop (didn't bet)
Seat 2: dddocky (small blind) folded on the Flop
Seat 3: RichRick1337 (big blind) collected (189)
Seat 4: Duke Croix folded before Flop (didn't bet)
Seat 6: color_singleton folded before Flop (didn't bet)
Seat 9: Manon541 folded before Flop (didn't bet)



PokerStars Home Game Hand #217630935064: {Club #3225207}  Hold'em No Limit (50/100) - 2020/08/20 15:20:58 ET
Table 'Manuel Neuer' 9-max (Play Money) Seat #2 is the button
Seat 1: JeBoyDirk (12459 in chips) 
Seat 2: dddocky (6400 in chips) 
Seat 3: RichRick1337 (5263 in chips) 
Seat 4: Duke Croix (10244 in chips) 
Seat 6: color_singleton (14117 in chips) 
Seat 9: Manon541 (7427 in chips) 
RichRick1337: posts small blind 50
Duke Croix: posts big blind 100
*** HOLE CARDS ***
Dealt to Duke Croix [9h 4s]
color_singleton: folds 
Manon541: calls 100
JeBoyDirk: folds 
dddocky: calls 100
RichRick1337: calls 50
Duke Croix: checks 
*** FLOP *** [6h Jh 9c]
RichRick1337: checks 
Duke Croix: bets 200
Manon541: calls 200
dddocky: calls 200
RichRick1337: folds 
*** TURN *** [6h Jh 9c] [6c]
Duke Croix: bets 400
Manon541: folds 
dddocky: calls 400
*** RIVER *** [6h Jh 9c 6c] [2c]
Duke Croix: checks 
dddocky: bets 2100
Duke Croix: folds 
Uncalled bet (2100) returned to dddocky
dddocky collected 1701 from pot
dddocky: doesn't show hand 
*** SUMMARY ***
Total pot 1800 | Rake 99 
Board [6h Jh 9c 6c 2c]
Seat 1: JeBoyDirk folded before Flop (didn't bet)
Seat 2: dddocky (button) collected (1701)
Seat 3: RichRick1337 (small blind) folded on the Flop
Seat 4: Duke Croix (big blind) folded on the River
Seat 6: color_singleton folded before Flop (didn't bet)
Seat 9: Manon541 folded on the Turn



PokerStars Home Game Hand #217630975150: {Club #3225207}  Hold'em No Limit (50/100) - 2020/08/20 15:21:56 ET
Table 'Manuel Neuer' 9-max (Play Money) Seat #3 is the button
Seat 1: JeBoyDirk (12459 in chips) 
Seat 2: dddocky (7401 in chips) 
Seat 3: RichRick1337 (5163 in chips) 
Seat 4: Duke Croix (9544 in chips) 
Seat 6: color_singleton (14117 in chips) 
Seat 9: Manon541 (7127 in chips) 
Duke Croix: posts small blind 50
color_singleton: posts big blind 100
*** HOLE CARDS ***
Dealt to Duke Croix [2h 7s]
Manon541: folds 
JeBoyDirk: folds 
dddocky: calls 100
RichRick1337: folds 
Duke Croix: calls 50
color_singleton: checks 
*** FLOP *** [3c 5h Jd]
Duke Croix: checks 
color_singleton: bets 141
dddocky: calls 141
Duke Croix: folds 
*** TURN *** [3c 5h Jd] [6h]
color_singleton: bets 275
dddocky: calls 275
*** RIVER *** [3c 5h Jd 6h] [2d]
color_singleton: checks 
dddocky: checks 
*** SHOW DOWN ***
color_singleton: shows [7h 3s] (a pair of Threes)
dddocky: shows [9d Jh] (a pair of Jacks)
dddocky collected 1070 from pot
*** SUMMARY ***
Total pot 1132 | Rake 62 
Board [3c 5h Jd 6h 2d]
Seat 1: JeBoyDirk folded before Flop (didn't bet)
Seat 2: dddocky showed [9d Jh] and won (1070) with a pair of Jacks
Seat 3: RichRick1337 (button) folded before Flop (didn't bet)
Seat 4: Duke Croix (small blind) folded on the Flop
Seat 6: color_singleton (big blind) showed [7h 3s] and lost with a pair of Threes
Seat 9: Manon541 folded before Flop (didn't bet)



PokerStars Home Game Hand #217630995760: {Club #3225207}  Hold'em No Limit (50/100) - 2020/08/20 15:22:31 ET
Table 'Manuel Neuer' 9-max (Play Money) Seat #4 is the button
Seat 1: JeBoyDirk (12459 in chips) 
Seat 2: dddocky (7955 in chips) 
Seat 3: RichRick1337 (5163 in chips) 
Seat 4: Duke Croix (9444 in chips) 
Seat 6: color_singleton (13601 in chips) 
Seat 9: Manon541 (7127 in chips) 
color_singleton: posts small blind 50
Manon541: posts big blind 100
*** HOLE CARDS ***
Dealt to Duke Croix [5h 3h]
JeBoyDirk: folds 
dddocky: calls 100
RichRick1337: calls 100
Duke Croix: calls 100
color_singleton: raises 200 to 300
Manon541: folds 
dddocky: calls 200
RichRick1337: calls 200
Duke Croix: calls 200
*** FLOP *** [Qd 4h 8c]
color_singleton: bets 614
dddocky: folds 
RichRick1337: folds 
Duke Croix: folds 
Uncalled bet (614) returned to color_singleton
color_singleton collected 1228 from pot
color_singleton: doesn't show hand 
*** SUMMARY ***
Total pot 1300 | Rake 72 
Board [Qd 4h 8c]
Seat 1: JeBoyDirk folded before Flop (didn't bet)
Seat 2: dddocky folded on the Flop
Seat 3: RichRick1337 folded on the Flop
Seat 4: Duke Croix (button) folded on the Flop
Seat 6: color_singleton (small blind) collected (1228)
Seat 9: Manon541 (big blind) folded before Flop



PokerStars Home Game Hand #217631019803: {Club #3225207}  Hold'em No Limit (50/100) - 2020/08/20 15:23:11 ET
Table 'Manuel Neuer' 9-max (Play Money) Seat #6 is the button
Seat 1: JeBoyDirk (12459 in chips) 
Seat 2: dddocky (7655 in chips) 
Seat 3: RichRick1337 (4863 in chips) 
Seat 4: Duke Croix (9144 in chips) 
Seat 6: color_singleton (14529 in chips) 
Seat 9: Manon541 (7027 in chips) 
Manon541: posts small blind 50
JeBoyDirk: posts big blind 100
*** HOLE CARDS ***
Dealt to Duke Croix [Ac 5s]
dddocky: folds 
RichRick1337: folds 
Duke Croix: calls 100
color_singleton: folds 
Manon541: calls 50
JeBoyDirk: checks 
*** FLOP *** [Ks Ts Jd]
Manon541: bets 100
JeBoyDirk: folds 
Duke Croix: folds 
Uncalled bet (100) returned to Manon541
Manon541 collected 283 from pot
*** SUMMARY ***
Total pot 300 | Rake 17 
Board [Ks Ts Jd]
Seat 1: JeBoyDirk (big blind) folded on the Flop
Seat 2: dddocky folded before Flop (didn't bet)
Seat 3: RichRick1337 folded before Flop (didn't bet)
Seat 4: Duke Croix folded on the Flop
Seat 6: color_singleton (button) folded before Flop (didn't bet)
Seat 9: Manon541 (small blind) collected (283)



PokerStars Home Game Hand #217631043863: {Club #3225207}  Hold'em No Limit (50/100) - 2020/08/20 15:23:52 ET
Table 'Manuel Neuer' 9-max (Play Money) Seat #9 is the button
Seat 1: JeBoyDirk (12359 in chips) 
Seat 2: dddocky (7655 in chips) 
Seat 3: RichRick1337 (4863 in chips) 
Seat 4: Duke Croix (9044 in chips) 
Seat 6: color_singleton (14529 in chips) 
Seat 9: Manon541 (7210 in chips) 
JeBoyDirk: posts small blind 50
dddocky: posts big blind 100
*** HOLE CARDS ***
Dealt to Duke Croix [5c 8h]
RichRick1337: calls 100
Duke Croix: folds 
color_singleton: folds 
Manon541: calls 100
JeBoyDirk: calls 50
dddocky: checks 
*** FLOP *** [8c Qh 9s]
JeBoyDirk: checks 
dddocky: checks 
RichRick1337: bets 100
Manon541: folds 
JeBoyDirk: calls 100
dddocky: calls 100
*** TURN *** [8c Qh 9s] [4d]
JeBoyDirk: checks 
dddocky: checks 
RichRick1337: checks 
*** RIVER *** [8c Qh 9s 4d] [5s]
JeBoyDirk: bets 300
dddocky: folds 
RichRick1337: calls 300
*** SHOW DOWN ***
JeBoyDirk: shows [5h 9c] (two pair, Nines and Fives)
RichRick1337: mucks hand 
JeBoyDirk collected 1228 from pot
*** SUMMARY ***
Total pot 1300 | Rake 72 
Board [8c Qh 9s 4d 5s]
Seat 1: JeBoyDirk (small blind) showed [5h 9c] and won (1228) with two pair, Nines and Fives
Seat 2: dddocky (big blind) folded on the River
Seat 3: RichRick1337 mucked [3s 3h]
Seat 4: Duke Croix folded before Flop (didn't bet)
Seat 6: color_singleton folded before Flop (didn't bet)
Seat 9: Manon541 (button) folded on the Flop



PokerStars Home Game Hand #217631075099: {Club #3225207}  Hold'em No Limit (50/100) - 2020/08/20 15:24:45 ET
Table 'Manuel Neuer' 9-max (Play Money) Seat #1 is the button
Seat 1: JeBoyDirk (13087 in chips) 
Seat 2: dddocky (7455 in chips) 
Seat 3: RichRick1337 (4363 in chips) 
Seat 4: Duke Croix (9044 in chips) 
Seat 6: color_singleton (14529 in chips) 
Seat 9: Manon541 (7110 in chips) 
dddocky: posts small blind 50
RichRick1337: posts big blind 100
*** HOLE CARDS ***
Dealt to Duke Croix [3s 6c]
Duke Croix: folds 
color_singleton: raises 100 to 200
Manon541: folds 
JeBoyDirk: folds 
dddocky: calls 150
RichRick1337: calls 100
*** FLOP *** [9d 2h 9c]
dddocky: checks 
RichRick1337: checks 
color_singleton: checks 
*** TURN *** [9d 2h 9c] [Kc]
dddocky: checks 
RichRick1337: checks 
color_singleton: bets 283
dddocky: folds 
RichRick1337: calls 283
*** RIVER *** [9d 2h 9c Kc] [8s]
RichRick1337: checks 
color_singleton: bets 551
RichRick1337: folds 
Uncalled bet (551) returned to color_singleton
color_singleton collected 1102 from pot
color_singleton: doesn't show hand 
*** SUMMARY ***
Total pot 1166 | Rake 64 
Board [9d 2h 9c Kc 8s]
Seat 1: JeBoyDirk (button) folded before Flop (didn't bet)
Seat 2: dddocky (small blind) folded on the Turn
Seat 3: RichRick1337 (big blind) folded on the River
Seat 4: Duke Croix folded before Flop (didn't bet)
Seat 6: color_singleton collected (1102)
Seat 9: Manon541 folded before Flop (didn't bet)



PokerStars Home Game Hand #217631108425: {Club #3225207}  Hold'em No Limit (50/100) - 2020/08/20 15:25:41 ET
Table 'Manuel Neuer' 9-max (Play Money) Seat #2 is the button
Seat 1: JeBoyDirk (13087 in chips) 
Seat 2: dddocky (7255 in chips) 
Seat 3: RichRick1337 (3880 in chips) 
Seat 4: Duke Croix (9044 in chips) 
Seat 6: color_singleton (15148 in chips) 
Seat 9: Manon541 (7110 in chips) 
RichRick1337: posts small blind 50
Duke Croix: posts big blind 100
*** HOLE CARDS ***
Dealt to Duke Croix [5c Tc]
color_singleton: folds 
Manon541: calls 100
JeBoyDirk: folds 
dddocky: calls 100
RichRick1337: folds 
Duke Croix: checks 
*** FLOP *** [Jc 8s Kh]
Duke Croix: checks 
Manon541: bets 165
dddocky: raises 165 to 330
Duke Croix: folds 
Manon541: calls 165
*** TURN *** [Jc 8s Kh] [2d]
Manon541: checks 
dddocky: checks 
*** RIVER *** [Jc 8s Kh 2d] [Qd]
Manon541: bets 954
dddocky: folds 
Uncalled bet (954) returned to Manon541
Manon541 collected 954 from pot
*** SUMMARY ***
Total pot 1010 | Rake 56 
Board [Jc 8s Kh 2d Qd]
Seat 1: JeBoyDirk folded before Flop (didn't bet)
Seat 2: dddocky (button) folded on the River
Seat 3: RichRick1337 (small blind) folded before Flop
Seat 4: Duke Croix (big blind) folded on the Flop
Seat 6: color_singleton folded before Flop (didn't bet)
Seat 9: Manon541 collected (954)



PokerStars Home Game Hand #217631142477: {Club #3225207}  Hold'em No Limit (50/100) - 2020/08/20 15:26:39 ET
Table 'Manuel Neuer' 9-max (Play Money) Seat #3 is the button
Seat 1: JeBoyDirk (13087 in chips) 
Seat 2: dddocky (6825 in chips) 
Seat 3: RichRick1337 (3830 in chips) 
Seat 4: Duke Croix (8944 in chips) 
Seat 6: color_singleton (15148 in chips) 
Seat 9: Manon541 (7634 in chips) 
Duke Croix: posts small blind 50
color_singleton: posts big blind 100
*** HOLE CARDS ***
Dealt to Duke Croix [Kc 3c]
Manon541: calls 100
JeBoyDirk: folds 
dddocky: calls 100
RichRick1337: calls 100
Duke Croix: calls 50
color_singleton: checks 
*** FLOP *** [Ks 5d 2d]
Duke Croix: bets 300
color_singleton: folds 
Manon541: calls 300
dddocky: raises 300 to 600
RichRick1337: folds 
Duke Croix: calls 300
Manon541: calls 300
*** TURN *** [Ks 5d 2d] [Jc]
Duke Croix: checks 
Manon541: checks 
dddocky: bets 2173
Duke Croix: folds 
Manon541: folds 
Uncalled bet (2173) returned to dddocky
dddocky collected 2173 from pot
dddocky: doesn't show hand 
*** SUMMARY ***
Total pot 2300 | Rake 127 
Board [Ks 5d 2d Jc]
Seat 1: JeBoyDirk folded before Flop (didn't bet)
Seat 2: dddocky collected (2173)
Seat 3: RichRick1337 (button) folded on the Flop
Seat 4: Duke Croix (small blind) folded on the Turn
Seat 6: color_singleton (big blind) folded on the Flop
Seat 9: Manon541 folded on the Turn



PokerStars Home Game Hand #217631168917: {Club #3225207}  Hold'em No Limit (50/100) - 2020/08/20 15:27:24 ET
Table 'Manuel Neuer' 9-max (Play Money) Seat #4 is the button
Seat 1: JeBoyDirk (13087 in chips) 
Seat 2: dddocky (8298 in chips) 
Seat 3: RichRick1337 (3730 in chips) 
Seat 4: Duke Croix (8244 in chips) 
Seat 6: color_singleton (15048 in chips) 
Seat 9: Manon541 (6934 in chips) 
color_singleton: posts small blind 50
Manon541: posts big blind 100
*** HOLE CARDS ***
Dealt to Duke Croix [7h Jd]
JeBoyDirk: raises 100 to 200
dddocky: calls 200
RichRick1337: calls 200
Duke Croix: folds 
color_singleton: raises 300 to 500
Manon541: folds 
JeBoyDirk: calls 300
dddocky: folds 
RichRick1337: calls 300
*** FLOP *** [Kh 3c Jh]
color_singleton: bets 850
JeBoyDirk: folds 
RichRick1337: calls 850
*** TURN *** [Kh 3c Jh] [9d]
color_singleton: checks 
RichRick1337: checks 
*** RIVER *** [Kh 3c Jh 9d] [6c]
color_singleton: checks 
RichRick1337: checks 
*** SHOW DOWN ***
color_singleton: shows [Qc Qd] (a pair of Queens)
RichRick1337: shows [As Kc] (a pair of Kings)
RichRick1337 collected 3307 from pot
*** SUMMARY ***
Total pot 3500 | Rake 193 
Board [Kh 3c Jh 9d 6c]
Seat 1: JeBoyDirk folded on the Flop
Seat 2: dddocky folded before Flop
Seat 3: RichRick1337 showed [As Kc] and won (3307) with a pair of Kings
Seat 4: Duke Croix (button) folded before Flop (didn't bet)
Seat 6: color_singleton (small blind) showed [Qc Qd] and lost with a pair of Queens
Seat 9: Manon541 (big blind) folded before Flop



PokerStars Home Game Hand #217631196113: {Club #3225207}  Hold'em No Limit (50/100) - 2020/08/20 15:28:10 ET
Table 'Manuel Neuer' 9-max (Play Money) Seat #6 is the button
Seat 1: JeBoyDirk (12587 in chips) 
Seat 2: dddocky (8098 in chips) 
Seat 3: RichRick1337 (5687 in chips) 
Seat 4: Duke Croix (8244 in chips) 
Seat 6: color_singleton (13698 in chips) 
Seat 9: Manon541 (6834 in chips) 
Manon541: posts small blind 50
JeBoyDirk: posts big blind 100
*** HOLE CARDS ***
Dealt to Duke Croix [6s Qd]
dddocky: calls 100
RichRick1337: calls 100
Duke Croix: folds 
color_singleton: calls 100
Manon541: calls 50
JeBoyDirk: checks 
*** FLOP *** [9h Kc 3s]
Manon541: checks 
JeBoyDirk: checks 
dddocky: bets 100
RichRick1337: raises 100 to 200
color_singleton: folds 
Manon541: folds 
JeBoyDirk: folds 
dddocky: calls 100
*** TURN *** [9h Kc 3s] [2h]
dddocky: checks 
RichRick1337: bets 425
dddocky: folds 
Uncalled bet (425) returned to RichRick1337
RichRick1337 collected 850 from pot
RichRick1337: doesn't show hand 
*** SUMMARY ***
Total pot 900 | Rake 50 
Board [9h Kc 3s 2h]
Seat 1: JeBoyDirk (big blind) folded on the Flop
Seat 2: dddocky folded on the Turn
Seat 3: RichRick1337 collected (850)
Seat 4: Duke Croix folded before Flop (didn't bet)
Seat 6: color_singleton (button) folded on the Flop
Seat 9: Manon541 (small blind) folded on the Flop



PokerStars Home Game Hand #217631220812: {Club #3225207}  Hold'em No Limit (50/100) - 2020/08/20 15:28:52 ET
Table 'Manuel Neuer' 9-max (Play Money) Seat #9 is the button
Seat 1: JeBoyDirk (12487 in chips) 
Seat 2: dddocky (7798 in chips) 
Seat 3: RichRick1337 (6237 in chips) 
Seat 4: Duke Croix (8244 in chips) 
Seat 6: color_singleton (13598 in chips) 
Seat 9: Manon541 (6734 in chips) 
JeBoyDirk: posts small blind 50
dddocky: posts big blind 100
*** HOLE CARDS ***
Dealt to Duke Croix [9c Ad]
RichRick1337: calls 100
Duke Croix: raises 300 to 400
color_singleton: folds 
Manon541: calls 400
JeBoyDirk: folds 
dddocky: folds 
RichRick1337: calls 300
*** FLOP *** [3d 8c 2s]
RichRick1337: checks 
Duke Croix: checks 
Manon541: checks 
*** TURN *** [3d 8c 2s] [4c]
RichRick1337: checks 
Duke Croix: bets 700
Manon541: folds 
RichRick1337: folds 
Uncalled bet (700) returned to Duke Croix
Duke Croix collected 1276 from pot
*** SUMMARY ***
Total pot 1350 | Rake 74 
Board [3d 8c 2s 4c]
Seat 1: JeBoyDirk (small blind) folded before Flop
Seat 2: dddocky (big blind) folded before Flop
Seat 3: RichRick1337 folded on the Turn
Seat 4: Duke Croix collected (1276)
Seat 6: color_singleton folded before Flop (didn't bet)
Seat 9: Manon541 (button) folded on the Turn



PokerStars Home Game Hand #217631240869: {Club #3225207}  Hold'em No Limit (50/100) - 2020/08/20 15:29:27 ET
Table 'Manuel Neuer' 9-max (Play Money) Seat #1 is the button
Seat 1: JeBoyDirk (12437 in chips) 
Seat 2: dddocky (7698 in chips) 
Seat 3: RichRick1337 (5837 in chips) 
Seat 4: Duke Croix (9120 in chips) 
Seat 6: color_singleton (13598 in chips) 
Seat 9: Manon541 (6334 in chips) 
dddocky: posts small blind 50
RichRick1337: posts big blind 100
*** HOLE CARDS ***
Dealt to Duke Croix [7c 7s]
Duke Croix: raises 300 to 400
color_singleton: folds 
Manon541: folds 
JeBoyDirk: calls 400
dddocky: folds 
RichRick1337: folds 
*** FLOP *** [4d Jh 4s]
Duke Croix: bets 500
JeBoyDirk: calls 500
*** TURN *** [4d Jh 4s] [5c]
Duke Croix: bets 1000
JeBoyDirk: calls 1000
*** RIVER *** [4d Jh 4s 5c] [2h]
Duke Croix: bets 1600
JeBoyDirk: calls 1600
*** SHOW DOWN ***
Duke Croix: shows [7c 7s] (two pair, Sevens and Fours)
JeBoyDirk: shows [Jc Ad] (two pair, Jacks and Fours)
JeBoyDirk collected 6757 from pot
*** SUMMARY ***
Total pot 7150 | Rake 393 
Board [4d Jh 4s 5c 2h]
Seat 1: JeBoyDirk (button) showed [Jc Ad] and won (6757) with two pair, Jacks and Fours
Seat 2: dddocky (small blind) folded before Flop
Seat 3: RichRick1337 (big blind) folded before Flop
Seat 4: Duke Croix showed [7c 7s] and lost with two pair, Sevens and Fours
Seat 6: color_singleton folded before Flop (didn't bet)
Seat 9: Manon541 folded before Flop (didn't bet)



PokerStars Home Game Hand #217631268126: {Club #3225207}  Hold'em No Limit (50/100) - 2020/08/20 15:30:13 ET
Table 'Manuel Neuer' 9-max (Play Money) Seat #2 is the button
Seat 1: JeBoyDirk (15694 in chips) 
Seat 2: dddocky (7648 in chips) 
Seat 3: RichRick1337 (5737 in chips) 
Seat 4: Duke Croix (5620 in chips) 
Seat 6: color_singleton (13598 in chips) 
Seat 9: Manon541 (6334 in chips) 
RichRick1337: posts small blind 50
Duke Croix: posts big blind 100
*** HOLE CARDS ***
Dealt to Duke Croix [Kd 6s]
color_singleton: folds 
Manon541: folds 
JeBoyDirk: folds 
dddocky: calls 100
RichRick1337: raises 100 to 200
Duke Croix: calls 100
dddocky: calls 100
*** FLOP *** [9d 5d 4d]
RichRick1337: checks 
Duke Croix: bets 400
dddocky: folds 
RichRick1337: calls 400
*** TURN *** [9d 5d 4d] [Jc]
RichRick1337: checks 
Duke Croix: bets 700
RichRick1337: calls 700
*** RIVER *** [9d 5d 4d Jc] [6d]
RichRick1337: checks 
Duke Croix: bets 2000
RichRick1337: folds 
Uncalled bet (2000) returned to Duke Croix
Duke Croix collected 2646 from pot
*** SUMMARY ***
Total pot 2800 | Rake 154 
Board [9d 5d 4d Jc 6d]
Seat 1: JeBoyDirk folded before Flop (didn't bet)
Seat 2: dddocky (button) folded on the Flop
Seat 3: RichRick1337 (small blind) folded on the River
Seat 4: Duke Croix (big blind) collected (2646)
Seat 6: color_singleton folded before Flop (didn't bet)
Seat 9: Manon541 folded before Flop (didn't bet)



PokerStars Home Game Hand #217631300072: {Club #3225207}  Hold'em No Limit (50/100) - 2020/08/20 15:31:07 ET
Table 'Manuel Neuer' 9-max (Play Money) Seat #3 is the button
Seat 1: JeBoyDirk (15694 in chips) 
Seat 2: dddocky (7448 in chips) 
Seat 3: RichRick1337 (4437 in chips) 
Seat 4: Duke Croix (6966 in chips) 
Seat 6: color_singleton (13598 in chips) 
Seat 9: Manon541 (6334 in chips) 
Duke Croix: posts small blind 50
color_singleton: posts big blind 100
*** HOLE CARDS ***
Dealt to Duke Croix [8h 9h]
Manon541: folds 
JeBoyDirk: calls 100
dddocky: calls 100
RichRick1337: folds 
Duke Croix: calls 50
color_singleton: checks 
*** FLOP *** [Kd 3h 2h]
Duke Croix: bets 200
color_singleton: folds 
JeBoyDirk: calls 200
dddocky: calls 200
*** TURN *** [Kd 3h 2h] [9c]
Duke Croix: bets 500
JeBoyDirk: calls 500
dddocky: folds 
*** RIVER *** [Kd 3h 2h 9c] [As]
Duke Croix: checks 
JeBoyDirk: checks 
*** SHOW DOWN ***
Duke Croix: shows [8h 9h] (a pair of Nines)
JeBoyDirk: mucks hand 
Duke Croix collected 1890 from pot
*** SUMMARY ***
Total pot 2000 | Rake 110 
Board [Kd 3h 2h 9c As]
Seat 1: JeBoyDirk mucked [6h 4h]
Seat 2: dddocky folded on the Turn
Seat 3: RichRick1337 (button) folded before Flop (didn't bet)
Seat 4: Duke Croix (small blind) showed [8h 9h] and won (1890) with a pair of Nines
Seat 6: color_singleton (big blind) folded on the Flop
Seat 9: Manon541 folded before Flop (didn't bet)



PokerStars Home Game Hand #217631325258: {Club #3225207}  Hold'em No Limit (50/100) - 2020/08/20 15:31:49 ET
Table 'Manuel Neuer' 9-max (Play Money) Seat #4 is the button
Seat 1: JeBoyDirk (14894 in chips) 
Seat 2: dddocky (7148 in chips) 
Seat 3: RichRick1337 (4437 in chips) 
Seat 4: Duke Croix (8056 in chips) 
Seat 6: color_singleton (13498 in chips) 
Seat 9: Manon541 (6334 in chips) 
color_singleton: posts small blind 50
Manon541: posts big blind 100
*** HOLE CARDS ***
Dealt to Duke Croix [Js 8c]
JeBoyDirk: folds 
dddocky: calls 100
RichRick1337: raises 100 to 200
Duke Croix: calls 200
color_singleton: folds 
Manon541: calls 100
dddocky: calls 100
*** FLOP *** [Ad 2d 8s]
Manon541: checks 
dddocky: checks 
RichRick1337: checks 
Duke Croix: checks 
*** TURN *** [Ad 2d 8s] [7c]
Manon541: checks 
dddocky: checks 
RichRick1337: checks 
Duke Croix: bets 400
Manon541: folds 
dddocky: folds 
RichRick1337: folds 
Uncalled bet (400) returned to Duke Croix
Duke Croix collected 803 from pot
*** SUMMARY ***
Total pot 850 | Rake 47 
Board [Ad 2d 8s 7c]
Seat 1: JeBoyDirk folded before Flop (didn't bet)
Seat 2: dddocky folded on the Turn
Seat 3: RichRick1337 folded on the Turn
Seat 4: Duke Croix (button) collected (803)
Seat 6: color_singleton (small blind) folded before Flop
Seat 9: Manon541 (big blind) folded on the Turn



PokerStars Home Game Hand #217631347919: {Club #3225207}  Hold'em No Limit (50/100) - 2020/08/20 15:32:28 ET
Table 'Manuel Neuer' 9-max (Play Money) Seat #6 is the button
Seat 1: JeBoyDirk (14894 in chips) 
Seat 2: dddocky (6948 in chips) 
Seat 3: RichRick1337 (4237 in chips) 
Seat 4: Duke Croix (8659 in chips) 
Seat 6: color_singleton (13448 in chips) 
Seat 9: Manon541 (6134 in chips) 
Manon541: posts small blind 50
JeBoyDirk: posts big blind 100
*** HOLE CARDS ***
Dealt to Duke Croix [4h 2h]
dddocky: folds 
RichRick1337: calls 100
Duke Croix: calls 100
color_singleton has timed out
color_singleton: folds 
Manon541: calls 50
JeBoyDirk: checks 
*** FLOP *** [Ah 2d 3d]
Manon541: bets 189
JeBoyDirk: calls 189
RichRick1337: calls 189
Duke Croix: calls 189
*** TURN *** [Ah 2d 3d] [6d]
Manon541: bets 546
JeBoyDirk: folds 
RichRick1337: folds 
Duke Croix: folds 
Uncalled bet (546) returned to Manon541
Manon541 collected 1092 from pot
*** SUMMARY ***
Total pot 1156 | Rake 64 
Board [Ah 2d 3d 6d]
Seat 1: JeBoyDirk (big blind) folded on the Turn
Seat 2: dddocky folded before Flop (didn't bet)
Seat 3: RichRick1337 folded on the Turn
Seat 4: Duke Croix folded on the Turn
Seat 6: color_singleton (button) folded before Flop (didn't bet)
Seat 9: Manon541 (small blind) collected (1092)



PokerStars Home Game Hand #217631378299: {Club #3225207}  Hold'em No Limit (50/100) - 2020/08/20 15:33:19 ET
Table 'Manuel Neuer' 9-max (Play Money) Seat #9 is the button
Seat 1: JeBoyDirk (14605 in chips) 
Seat 2: dddocky (6948 in chips) 
Seat 3: RichRick1337 (3948 in chips) 
Seat 4: Duke Croix (8370 in chips) 
Seat 9: Manon541 (6937 in chips) 
JeBoyDirk: posts small blind 50
dddocky: posts big blind 100
*** HOLE CARDS ***
Dealt to Duke Croix [9d Kd]
RichRick1337: folds 
Duke Croix: raises 200 to 300
Manon541: folds 
JeBoyDirk: calls 250
dddocky: folds 
*** FLOP *** [8d 2h Ah]
JeBoyDirk: checks 
Duke Croix: checks 
*** TURN *** [8d 2h Ah] [Ad]
JeBoyDirk: checks 
Duke Croix: bets 400
JeBoyDirk: folds 
Uncalled bet (400) returned to Duke Croix
Duke Croix collected 661 from pot
*** SUMMARY ***
Total pot 700 | Rake 39 
Board [8d 2h Ah Ad]
Seat 1: JeBoyDirk (small blind) folded on the Turn
Seat 2: dddocky (big blind) folded before Flop
Seat 3: RichRick1337 folded before Flop (didn't bet)
Seat 4: Duke Croix collected (661)
Seat 9: Manon541 (button) folded before Flop (didn't bet)



PokerStars Home Game Hand #217631398665: {Club #3225207}  Hold'em No Limit (50/100) - 2020/08/20 15:33:54 ET
Table 'Manuel Neuer' 9-max (Play Money) Seat #1 is the button
Seat 1: JeBoyDirk (14305 in chips) 
Seat 2: dddocky (6848 in chips) 
Seat 3: RichRick1337 (3948 in chips) 
Seat 4: Duke Croix (8731 in chips) 
Seat 9: Manon541 (6937 in chips) 
dddocky: posts small blind 50
RichRick1337: posts big blind 100
*** HOLE CARDS ***
Dealt to Duke Croix [2s Ks]
Duke Croix: folds 
Manon541: calls 100
JeBoyDirk: folds 
dddocky: calls 50
RichRick1337: checks 
*** FLOP *** [3s 3d 6d]
dddocky: checks 
RichRick1337: checks 
Manon541: checks 
*** TURN *** [3s 3d 6d] [5h]
dddocky: checks 
RichRick1337: bets 700
Manon541: folds 
dddocky: folds 
Uncalled bet (700) returned to RichRick1337
RichRick1337 collected 283 from pot
RichRick1337: doesn't show hand 
*** SUMMARY ***
Total pot 300 | Rake 17 
Board [3s 3d 6d 5h]
Seat 1: JeBoyDirk (button) folded before Flop (didn't bet)
Seat 2: dddocky (small blind) folded on the Turn
Seat 3: RichRick1337 (big blind) collected (283)
Seat 4: Duke Croix folded before Flop (didn't bet)
Seat 9: Manon541 folded on the Turn



PokerStars Home Game Hand #217631419521: {Club #3225207}  Hold'em No Limit (50/100) - 2020/08/20 15:34:30 ET
Table 'Manuel Neuer' 9-max (Play Money) Seat #2 is the button
Seat 1: JeBoyDirk (14305 in chips) 
Seat 2: dddocky (6748 in chips) 
Seat 3: RichRick1337 (4131 in chips) 
Seat 4: Duke Croix (8731 in chips) 
Seat 9: Manon541 (6837 in chips) 
RichRick1337: posts small blind 50
Duke Croix: posts big blind 100
*** HOLE CARDS ***
Dealt to Duke Croix [Kd Ac]
Manon541: calls 100
JeBoyDirk: folds 
dddocky: calls 100
RichRick1337: calls 50
Duke Croix: raises 500 to 600
Manon541: calls 500
dddocky: folds 
RichRick1337: calls 500
*** FLOP *** [Qs 5h 2d]
RichRick1337: checks 
Duke Croix: checks 
Manon541: checks 
*** TURN *** [Qs 5h 2d] [9c]
RichRick1337: checks 
Duke Croix: bets 900
Manon541: calls 900
RichRick1337: folds 
*** RIVER *** [Qs 5h 2d 9c] [7h]
Duke Croix: bets 2000
Manon541: folds 
Uncalled bet (2000) returned to Duke Croix
Duke Croix collected 3496 from pot
*** SUMMARY ***
Total pot 3700 | Rake 204 
Board [Qs 5h 2d 9c 7h]
Seat 1: JeBoyDirk folded before Flop (didn't bet)
Seat 2: dddocky (button) folded before Flop
Seat 3: RichRick1337 (small blind) folded on the Turn
Seat 4: Duke Croix (big blind) collected (3496)
Seat 9: Manon541 folded on the River



PokerStars Home Game Hand #217631453684: {Club #3225207}  Hold'em No Limit (50/100) - 2020/08/20 15:35:28 ET
Table 'Manuel Neuer' 9-max (Play Money) Seat #3 is the button
Seat 1: JeBoyDirk (14305 in chips) 
Seat 2: dddocky (6648 in chips) 
Seat 3: RichRick1337 (3531 in chips) 
Seat 4: Duke Croix (10727 in chips) 
Seat 6: color_singleton (13448 in chips) 
Seat 9: Manon541 (5337 in chips) 
Duke Croix: posts small blind 50
color_singleton: posts big blind 100
*** HOLE CARDS ***
Dealt to Duke Croix [3c Th]
Manon541: folds 
JeBoyDirk: folds 
dddocky: calls 100
RichRick1337: folds 
Duke Croix: calls 50
color_singleton: checks 
*** FLOP *** [Jc As 2s]
Duke Croix: checks 
color_singleton: checks 
dddocky: checks 
*** TURN *** [Jc As 2s] [Kd]
Duke Croix: checks 
color_singleton: checks 
dddocky: bets 100
Duke Croix: folds 
color_singleton: raises 200 to 300
dddocky: calls 200
*** RIVER *** [Jc As 2s Kd] [Qd]
color_singleton: checks 
dddocky: checks 
*** SHOW DOWN ***
color_singleton: shows [Ks 5c] (a pair of Kings)
dddocky: shows [Kc Qh] (two pair, Kings and Queens)
dddocky collected 850 from pot
*** SUMMARY ***
Total pot 900 | Rake 50 
Board [Jc As 2s Kd Qd]
Seat 1: JeBoyDirk folded before Flop (didn't bet)
Seat 2: dddocky showed [Kc Qh] and won (850) with two pair, Kings and Queens
Seat 3: RichRick1337 (button) folded before Flop (didn't bet)
Seat 4: Duke Croix (small blind) folded on the Turn
Seat 6: color_singleton (big blind) showed [Ks 5c] and lost with a pair of Kings
Seat 9: Manon541 folded before Flop (didn't bet)



PokerStars Home Game Hand #217631487898: {Club #3225207}  Hold'em No Limit (50/100) - 2020/08/20 15:36:25 ET
Table 'Manuel Neuer' 9-max (Play Money) Seat #4 is the button
Seat 1: JeBoyDirk (14305 in chips) 
Seat 2: dddocky (7098 in chips) 
Seat 3: RichRick1337 (3531 in chips) 
Seat 4: Duke Croix (10627 in chips) 
Seat 6: color_singleton (13048 in chips) 
Seat 9: Manon541 (5337 in chips) 
color_singleton: posts small blind 50
Manon541: posts big blind 100
*** HOLE CARDS ***
Dealt to Duke Croix [7s 8c]
JeBoyDirk: calls 100
dddocky: calls 100
RichRick1337: calls 100
Duke Croix: calls 100
color_singleton: calls 50
Manon541: checks 
*** FLOP *** [5h 6s 2d]
color_singleton: checks 
Manon541: checks 
JeBoyDirk: checks 
dddocky: checks 
RichRick1337: checks 
Duke Croix: bets 400
color_singleton: folds 
Manon541: folds 
JeBoyDirk: calls 400
dddocky: folds 
RichRick1337: folds 
*** TURN *** [5h 6s 2d] [5s]
JeBoyDirk: checks 
Duke Croix: bets 800
JeBoyDirk: calls 800
*** RIVER *** [5h 6s 2d 5s] [3s]
JeBoyDirk: checks 
Duke Croix: checks 
*** SHOW DOWN ***
JeBoyDirk: shows [7h 7d] (two pair, Sevens and Fives)
Duke Croix: mucks hand 
JeBoyDirk collected 2835 from pot
*** SUMMARY ***
Total pot 3000 | Rake 165 
Board [5h 6s 2d 5s 3s]
Seat 1: JeBoyDirk showed [7h 7d] and won (2835) with two pair, Sevens and Fives
Seat 2: dddocky folded on the Flop
Seat 3: RichRick1337 folded on the Flop
Seat 4: Duke Croix (button) mucked [7s 8c]
Seat 6: color_singleton (small blind) folded on the Flop
Seat 9: Manon541 (big blind) folded on the Flop



PokerStars Home Game Hand #217631520860: {Club #3225207}  Hold'em No Limit (50/100) - 2020/08/20 15:37:22 ET
Table 'Manuel Neuer' 9-max (Play Money) Seat #6 is the button
Seat 1: JeBoyDirk (15840 in chips) 
Seat 2: dddocky (6998 in chips) 
Seat 3: RichRick1337 (3431 in chips) 
Seat 4: Duke Croix (9327 in chips) 
Seat 6: color_singleton (12948 in chips) 
Seat 9: Manon541 (5237 in chips) 
Manon541: posts small blind 50
JeBoyDirk: posts big blind 100
*** HOLE CARDS ***
Dealt to Duke Croix [5s 2h]
dddocky: calls 100
RichRick1337: folds 
Duke Croix: folds 
color_singleton: folds 
Manon541: calls 50
JeBoyDirk: checks 
*** FLOP *** [Ad Qc 2c]
Manon541: bets 141
JeBoyDirk: folds 
dddocky: calls 141
*** TURN *** [Ad Qc 2c] [8s]
Manon541: bets 275
dddocky: calls 275
*** RIVER *** [Ad Qc 2c 8s] [Jh]
Manon541: bets 1070
dddocky: calls 1070
*** SHOW DOWN ***
Manon541: shows [Qd 5d] (a pair of Queens)
dddocky: shows [Ah 7c] (a pair of Aces)
dddocky collected 3092 from pot
*** SUMMARY ***
Total pot 3272 | Rake 180 
Board [Ad Qc 2c 8s Jh]
Seat 1: JeBoyDirk (big blind) folded on the Flop
Seat 2: dddocky showed [Ah 7c] and won (3092) with a pair of Aces
Seat 3: RichRick1337 folded before Flop (didn't bet)
Seat 4: Duke Croix folded before Flop (didn't bet)
Seat 6: color_singleton (button) folded before Flop (didn't bet)
Seat 9: Manon541 (small blind) showed [Qd 5d] and lost with a pair of Queens



PokerStars Home Game Hand #217631545340: {Club #3225207}  Hold'em No Limit (50/100) - 2020/08/20 15:38:03 ET
Table 'Manuel Neuer' 9-max (Play Money) Seat #9 is the button
Seat 1: JeBoyDirk (15740 in chips) 
Seat 2: dddocky (8504 in chips) 
Seat 3: RichRick1337 (3431 in chips) 
Seat 4: Duke Croix (9327 in chips) 
Seat 6: color_singleton (12948 in chips) 
Seat 9: Manon541 (3651 in chips) 
JeBoyDirk: posts small blind 50
dddocky: posts big blind 100
*** HOLE CARDS ***
Dealt to Duke Croix [Ad Qh]
RichRick1337: folds 
Duke Croix: raises 300 to 400
color_singleton: calls 400
Manon541: folds 
JeBoyDirk: folds 
dddocky: folds 
*** FLOP *** [5h Qd Th]
Duke Croix: bets 400
color_singleton: calls 400
*** TURN *** [5h Qd Th] [7d]
Duke Croix: bets 1000
color_singleton: folds 
Uncalled bet (1000) returned to Duke Croix
Duke Croix collected 1654 from pot
*** SUMMARY ***
Total pot 1750 | Rake 96 
Board [5h Qd Th 7d]
Seat 1: JeBoyDirk (small blind) folded before Flop
Seat 2: dddocky (big blind) folded before Flop
Seat 3: RichRick1337 folded before Flop (didn't bet)
Seat 4: Duke Croix collected (1654)
Seat 6: color_singleton folded on the Turn
Seat 9: Manon541 (button) folded before Flop (didn't bet)



PokerStars Home Game Hand #217631566532: {Club #3225207}  Hold'em No Limit (50/100) - 2020/08/20 15:38:39 ET
Table 'Manuel Neuer' 9-max (Play Money) Seat #1 is the button
Seat 1: JeBoyDirk (15690 in chips) 
Seat 2: dddocky (8404 in chips) 
Seat 3: RichRick1337 (3431 in chips) 
Seat 4: Duke Croix (10181 in chips) 
Seat 6: color_singleton (12148 in chips) 
Seat 9: Manon541 (3651 in chips) 
dddocky: posts small blind 50
RichRick1337: posts big blind 100
*** HOLE CARDS ***
Dealt to Duke Croix [9s Ad]
Duke Croix: raises 300 to 400
color_singleton: folds 
Manon541: folds 
JeBoyDirk: folds 
dddocky: calls 350
RichRick1337: folds 
*** FLOP *** [4d 6h As]
dddocky: bets 100
Duke Croix: raises 400 to 500
dddocky: raises 400 to 900
Duke Croix: calls 400
*** TURN *** [4d 6h As] [4h]
dddocky: bets 100
Duke Croix: raises 900 to 1000
dddocky: calls 900
*** RIVER *** [4d 6h As 4h] [5h]
dddocky: checks 
Duke Croix: checks 
*** SHOW DOWN ***
dddocky: shows [Ac Qd] (two pair, Aces and Fours)
Duke Croix: mucks hand 
dddocky collected 4441 from pot
*** SUMMARY ***
Total pot 4700 | Rake 259 
Board [4d 6h As 4h 5h]
Seat 1: JeBoyDirk (button) folded before Flop (didn't bet)
Seat 2: dddocky (small blind) showed [Ac Qd] and won (4441) with two pair, Aces and Fours
Seat 3: RichRick1337 (big blind) folded before Flop
Seat 4: Duke Croix mucked [9s Ad]
Seat 6: color_singleton folded before Flop (didn't bet)
Seat 9: Manon541 folded before Flop (didn't bet)



PokerStars Home Game Hand #217631595512: {Club #3225207}  Hold'em No Limit (50/100) - 2020/08/20 15:39:29 ET
Table 'Manuel Neuer' 9-max (Play Money) Seat #2 is the button
Seat 1: JeBoyDirk (15690 in chips) 
Seat 2: dddocky (10545 in chips) 
Seat 3: RichRick1337 (3331 in chips) 
Seat 4: Duke Croix (7881 in chips) 
Seat 6: color_singleton (12148 in chips) 
Seat 9: Manon541 (3651 in chips) 
RichRick1337: posts small blind 50
Duke Croix: posts big blind 100
*** HOLE CARDS ***
Dealt to Duke Croix [9d 6c]
color_singleton: folds 
Manon541: folds 
JeBoyDirk: folds 
dddocky: calls 100
RichRick1337: calls 50
Duke Croix: checks 
*** FLOP *** [Ah Kd Jc]
RichRick1337: checks 
Duke Croix: checks 
dddocky: checks 
*** TURN *** [Ah Kd Jc] [Qs]
RichRick1337: bets 100
Duke Croix: folds 
dddocky: folds 
Uncalled bet (100) returned to RichRick1337
RichRick1337 collected 283 from pot
RichRick1337: doesn't show hand 
*** SUMMARY ***
Total pot 300 | Rake 17 
Board [Ah Kd Jc Qs]
Seat 1: JeBoyDirk folded before Flop (didn't bet)
Seat 2: dddocky (button) folded on the Turn
Seat 3: RichRick1337 (small blind) collected (283)
Seat 4: Duke Croix (big blind) folded on the Turn
Seat 6: color_singleton folded before Flop (didn't bet)
Seat 9: Manon541 folded before Flop (didn't bet)



PokerStars Home Game Hand #217631609636: {Club #3225207}  Hold'em No Limit (50/100) - 2020/08/20 15:39:53 ET
Table 'Manuel Neuer' 9-max (Play Money) Seat #3 is the button
Seat 1: JeBoyDirk (15690 in chips) 
Seat 2: dddocky (10445 in chips) 
Seat 3: RichRick1337 (3514 in chips) 
Seat 4: Duke Croix (7781 in chips) 
Seat 6: color_singleton (12148 in chips) 
Seat 9: Manon541 (3651 in chips) 
Duke Croix: posts small blind 50
color_singleton: posts big blind 100
*** HOLE CARDS ***
Dealt to Duke Croix [Kc Td]
Manon541: folds 
JeBoyDirk: calls 100
dddocky: calls 100
RichRick1337: calls 100
Duke Croix: calls 50
color_singleton: raises 200 to 300
JeBoyDirk: calls 200
dddocky: calls 200
RichRick1337: folds 
Duke Croix: calls 200
*** FLOP *** [As 6d 4c]
Duke Croix: checks 
color_singleton: bets 614
JeBoyDirk: folds 
dddocky: folds 
Duke Croix: folds 
Uncalled bet (614) returned to color_singleton
color_singleton collected 1228 from pot
color_singleton: doesn't show hand 
*** SUMMARY ***
Total pot 1300 | Rake 72 
Board [As 6d 4c]
Seat 1: JeBoyDirk folded on the Flop
Seat 2: dddocky folded on the Flop
Seat 3: RichRick1337 (button) folded before Flop
Seat 4: Duke Croix (small blind) folded on the Flop
Seat 6: color_singleton (big blind) collected (1228)
Seat 9: Manon541 folded before Flop (didn't bet)



PokerStars Home Game Hand #217631633039: {Club #3225207}  Hold'em No Limit (50/100) - 2020/08/20 15:40:32 ET
Table 'Manuel Neuer' 9-max (Play Money) Seat #4 is the button
Seat 1: JeBoyDirk (15390 in chips) 
Seat 2: dddocky (10145 in chips) 
Seat 3: RichRick1337 (3414 in chips) 
Seat 4: Duke Croix (7481 in chips) 
Seat 6: color_singleton (13076 in chips) 
Seat 9: Manon541 (3651 in chips) 
color_singleton: posts small blind 50
Manon541: posts big blind 100
*** HOLE CARDS ***
Dealt to Duke Croix [7d 7s]
JeBoyDirk: folds 
dddocky: folds 
RichRick1337: folds 
Duke Croix: raises 300 to 400
color_singleton: calls 350
Manon541: folds 
*** FLOP *** [8c Ah Ks]
color_singleton: checks 
Duke Croix: bets 500
color_singleton: raises 500 to 1000
Duke Croix: folds 
Uncalled bet (500) returned to color_singleton
color_singleton collected 1795 from pot
color_singleton: doesn't show hand 
*** SUMMARY ***
Total pot 1900 | Rake 105 
Board [8c Ah Ks]
Seat 1: JeBoyDirk folded before Flop (didn't bet)
Seat 2: dddocky folded before Flop (didn't bet)
Seat 3: RichRick1337 folded before Flop (didn't bet)
Seat 4: Duke Croix (button) folded on the Flop
Seat 6: color_singleton (small blind) collected (1795)
Seat 9: Manon541 (big blind) folded before Flop



PokerStars Home Game Hand #217631645660: {Club #3225207}  Hold'em No Limit (50/100) - 2020/08/20 15:40:54 ET
Table 'Manuel Neuer' 9-max (Play Money) Seat #6 is the button
Seat 1: JeBoyDirk (15390 in chips) 
Seat 2: dddocky (10145 in chips) 
Seat 3: RichRick1337 (3414 in chips) 
Seat 4: Duke Croix (6581 in chips) 
Seat 6: color_singleton (13971 in chips) 
Seat 9: Manon541 (3551 in chips) 
Manon541: posts small blind 50
JeBoyDirk: posts big blind 100
*** HOLE CARDS ***
Dealt to Duke Croix [8s Tc]
dddocky: calls 100
RichRick1337: calls 100
Duke Croix: folds 
color_singleton: folds 
Manon541: calls 50
JeBoyDirk: checks 
*** FLOP *** [Th 5s 7d]
Manon541: checks 
JeBoyDirk: checks 
dddocky: checks 
RichRick1337: bets 100
Manon541: calls 100
JeBoyDirk: folds 
dddocky: calls 100
*** TURN *** [Th 5s 7d] [7h]
Manon541: checks 
dddocky: checks 
RichRick1337: bets 330
Manon541: folds 
dddocky: folds 
Uncalled bet (330) returned to RichRick1337
RichRick1337 collected 661 from pot
RichRick1337: doesn't show hand 
*** SUMMARY ***
Total pot 700 | Rake 39 
Board [Th 5s 7d 7h]
Seat 1: JeBoyDirk (big blind) folded on the Flop
Seat 2: dddocky folded on the Turn
Seat 3: RichRick1337 collected (661)
Seat 4: Duke Croix folded before Flop (didn't bet)
Seat 6: color_singleton (button) folded before Flop (didn't bet)
Seat 9: Manon541 (small blind) folded on the Turn



PokerStars Home Game Hand #217631668672: {Club #3225207}  Hold'em No Limit (50/100) - 2020/08/20 15:41:33 ET
Table 'Manuel Neuer' 9-max (Play Money) Seat #9 is the button
Seat 1: JeBoyDirk (15290 in chips) 
Seat 2: dddocky (9945 in chips) 
Seat 3: RichRick1337 (3875 in chips) 
Seat 4: Duke Croix (6581 in chips) 
Seat 6: color_singleton (13971 in chips) 
Seat 9: Manon541 (3351 in chips) 
JeBoyDirk: posts small blind 50
dddocky: posts big blind 100
*** HOLE CARDS ***
Dealt to Duke Croix [3c Td]
RichRick1337: calls 100
Duke Croix: folds 
color_singleton: folds 
Manon541: calls 100
JeBoyDirk: raises 200 to 300
dddocky: calls 200
RichRick1337: calls 200
Manon541: calls 200
*** FLOP *** [Jd 9c Ah]
JeBoyDirk: checks 
dddocky: checks 
RichRick1337: checks 
Manon541: checks 
*** TURN *** [Jd 9c Ah] [8s]
JeBoyDirk: bets 500
dddocky: folds 
RichRick1337: raises 500 to 1000
Manon541: folds 
JeBoyDirk: calls 500
*** RIVER *** [Jd 9c Ah 8s] [Qs]
JeBoyDirk: checks 
RichRick1337: checks 
*** SHOW DOWN ***
JeBoyDirk: shows [Ks Ac] (a pair of Aces)
RichRick1337: shows [8c 8h] (three of a kind, Eights)
RichRick1337 collected 3024 from pot
*** SUMMARY ***
Total pot 3200 | Rake 176 
Board [Jd 9c Ah 8s Qs]
Seat 1: JeBoyDirk (small blind) showed [Ks Ac] and lost with a pair of Aces
Seat 2: dddocky (big blind) folded on the Turn
Seat 3: RichRick1337 showed [8c 8h] and won (3024) with three of a kind, Eights
Seat 4: Duke Croix folded before Flop (didn't bet)
Seat 6: color_singleton folded before Flop (didn't bet)
Seat 9: Manon541 (button) folded on the Turn



PokerStars Home Game Hand #217631692043: {Club #3225207}  Hold'em No Limit (50/100) - 2020/08/20 15:42:11 ET
Table 'Manuel Neuer' 9-max (Play Money) Seat #1 is the button
Seat 1: JeBoyDirk (13990 in chips) 
Seat 2: dddocky (9645 in chips) 
Seat 3: RichRick1337 (5599 in chips) 
Seat 4: Duke Croix (6581 in chips) 
Seat 6: color_singleton (13971 in chips) 
Seat 9: Manon541 (3051 in chips) 
dddocky: posts small blind 50
RichRick1337: posts big blind 100
*** HOLE CARDS ***
Dealt to Duke Croix [Th 8c]
Duke Croix: folds 
color_singleton: raises 200 to 300
Manon541: calls 300
JeBoyDirk: folds 
dddocky: calls 250
RichRick1337: calls 200
*** FLOP *** [Qh 9c 2c]
dddocky: checks 
RichRick1337: checks 
color_singleton: checks 
Manon541: checks 
*** TURN *** [Qh 9c 2c] [2h]
dddocky: checks 
RichRick1337: checks 
color_singleton: checks 
Manon541: checks 
*** RIVER *** [Qh 9c 2c 2h] [2s]
dddocky: checks 
RichRick1337: checks 
color_singleton: checks 
Manon541: checks 
*** SHOW DOWN ***
dddocky: shows [Kd 3d] (three of a kind, Deuces)
RichRick1337: mucks hand 
color_singleton: shows [6d Ad] (three of a kind, Deuces - Ace kicker)
Manon541: shows [As Td] (three of a kind, Deuces)
color_singleton collected 567 from pot
Manon541 collected 567 from pot
*** SUMMARY ***
Total pot 1200 | Rake 66 
Board [Qh 9c 2c 2h 2s]
Seat 1: JeBoyDirk (button) folded before Flop (didn't bet)
Seat 2: dddocky (small blind) showed [Kd 3d] and lost with three of a kind, Deuces
Seat 3: RichRick1337 (big blind) mucked [5h Jc]
Seat 4: Duke Croix folded before Flop (didn't bet)
Seat 6: color_singleton showed [6d Ad] and won (567) with three of a kind, Deuces
Seat 9: Manon541 showed [As Td] and won (567) with three of a kind, Deuces



PokerStars Home Game Hand #217631719863: {Club #3225207}  Hold'em No Limit (50/100) - 2020/08/20 15:42:58 ET
Table 'Manuel Neuer' 9-max (Play Money) Seat #2 is the button
Seat 1: JeBoyDirk (13990 in chips) 
Seat 2: dddocky (9345 in chips) 
Seat 3: RichRick1337 (5299 in chips) 
Seat 4: Duke Croix (6581 in chips) 
Seat 6: color_singleton (14238 in chips) 
Seat 9: Manon541 (3318 in chips) 
RichRick1337: posts small blind 50
Duke Croix: posts big blind 100
*** HOLE CARDS ***
Dealt to Duke Croix [Th 9s]
color_singleton: raises 200 to 300
Manon541: calls 300
JeBoyDirk: folds 
dddocky: folds 
RichRick1337: calls 250
Duke Croix: calls 200
*** FLOP *** [8s 5h Qh]
RichRick1337: checks 
Duke Croix: checks 
color_singleton: checks 
Manon541: checks 
*** TURN *** [8s 5h Qh] [Ad]
RichRick1337: bets 1134
Duke Croix: folds 
color_singleton: folds 
Manon541: folds 
Uncalled bet (1134) returned to RichRick1337
RichRick1337 collected 1134 from pot
RichRick1337: doesn't show hand 
*** SUMMARY ***
Total pot 1200 | Rake 66 
Board [8s 5h Qh Ad]
Seat 1: JeBoyDirk folded before Flop (didn't bet)
Seat 2: dddocky (button) folded before Flop (didn't bet)
Seat 3: RichRick1337 (small blind) collected (1134)
Seat 4: Duke Croix (big blind) folded on the Turn
Seat 6: color_singleton folded on the Turn
Seat 9: Manon541 folded on the Turn



PokerStars Home Game Hand #217631737180: {Club #3225207}  Hold'em No Limit (50/100) - 2020/08/20 15:43:27 ET
Table 'Manuel Neuer' 9-max (Play Money) Seat #3 is the button
Seat 1: JeBoyDirk (13990 in chips) 
Seat 2: dddocky (9345 in chips) 
Seat 3: RichRick1337 (6133 in chips) 
Seat 4: Duke Croix (6281 in chips) 
Seat 6: color_singleton (13938 in chips) 
Seat 9: Manon541 (3018 in chips) 
Duke Croix: posts small blind 50
color_singleton: posts big blind 100
*** HOLE CARDS ***
Dealt to Duke Croix [8s Ac]
Manon541: folds 
JeBoyDirk: folds 
dddocky: calls 100
RichRick1337: calls 100
Duke Croix: calls 50
color_singleton: checks 
*** FLOP *** [9s 5s 4c]
Duke Croix: checks 
color_singleton: checks 
dddocky: bets 378
RichRick1337: calls 378
Duke Croix: folds 
color_singleton: calls 378
*** TURN *** [9s 5s 4c] [Ks]
color_singleton: checks 
dddocky: bets 725
RichRick1337: folds 
color_singleton: folds 
Uncalled bet (725) returned to dddocky
dddocky collected 1450 from pot
dddocky: doesn't show hand 
*** SUMMARY ***
Total pot 1534 | Rake 84 
Board [9s 5s 4c Ks]
Seat 1: JeBoyDirk folded before Flop (didn't bet)
Seat 2: dddocky collected (1450)
Seat 3: RichRick1337 (button) folded on the Turn
Seat 4: Duke Croix (small blind) folded on the Flop
Seat 6: color_singleton (big blind) folded on the Turn
Seat 9: Manon541 folded before Flop (didn't bet)



PokerStars Home Game Hand #217631766607: {Club #3225207}  Hold'em No Limit (50/100) - 2020/08/20 15:44:18 ET
Table 'Manuel Neuer' 9-max (Play Money) Seat #4 is the button
Seat 1: JeBoyDirk (13990 in chips) 
Seat 2: dddocky (10317 in chips) 
Seat 3: RichRick1337 (5655 in chips) 
Seat 4: Duke Croix (6181 in chips) 
Seat 6: color_singleton (13460 in chips) 
Seat 9: Manon541 (3018 in chips) 
color_singleton: posts small blind 50
Manon541: posts big blind 100
*** HOLE CARDS ***
Dealt to Duke Croix [2s Kc]
JeBoyDirk: folds 
dddocky: calls 100
RichRick1337: calls 100
Duke Croix: folds 
color_singleton: raises 100 to 200
Manon541: calls 100
dddocky: calls 100
RichRick1337: calls 100
*** FLOP *** [Qh 8h 3h]
color_singleton: checks 
Manon541: checks 
dddocky: checks 
RichRick1337: checks 
*** TURN *** [Qh 8h 3h] [Jh]
color_singleton: bets 200
Manon541: raises 200 to 400
dddocky: folds 
RichRick1337: raises 200 to 600
color_singleton: calls 400
Manon541: calls 200
*** RIVER *** [Qh 8h 3h Jh] [Qd]
color_singleton: bets 2457
Manon541: calls 2218 and is all-in
RichRick1337: calls 2457
*** SHOW DOWN ***
color_singleton: shows [Ah 7d] (a flush, Ace high)
RichRick1337: mucks hand 
color_singleton collected 452 from side pot
Manon541: mucks hand 
color_singleton collected 8745 from main pot
*** SUMMARY ***
Total pot 9732 Main pot 8745. Side pot 452. | Rake 535 
Board [Qh 8h 3h Jh Qd]
Seat 1: JeBoyDirk folded before Flop (didn't bet)
Seat 2: dddocky folded on the Turn
Seat 3: RichRick1337 mucked [Th 4d]
Seat 4: Duke Croix (button) folded before Flop (didn't bet)
Seat 6: color_singleton (small blind) showed [Ah 7d] and won (9197) with a flush, Ace high
Seat 9: Manon541 (big blind) mucked [Ts 9h]



PokerStars Home Game Hand #217631805363: {Club #3225207}  Hold'em No Limit (50/100) - 2020/08/20 15:45:24 ET
Table 'Manuel Neuer' 9-max (Play Money) Seat #6 is the button
Seat 1: JeBoyDirk (13990 in chips) 
Seat 2: dddocky (10117 in chips) 
Seat 3: RichRick1337 (2398 in chips) 
Seat 4: Duke Croix (6181 in chips) 
Seat 6: color_singleton (19400 in chips) 
JeBoyDirk: posts small blind 50
dddocky: posts big blind 100
*** HOLE CARDS ***
Dealt to Duke Croix [2h Ah]
RichRick1337: calls 100
Duke Croix: raises 300 to 400
color_singleton: folds 
JeBoyDirk: folds 
dddocky: folds 
RichRick1337: folds 
Uncalled bet (300) returned to Duke Croix
Duke Croix collected 350 from pot
*** SUMMARY ***
Total pot 350 | Rake 0 
Seat 1: JeBoyDirk (small blind) folded before Flop
Seat 2: dddocky (big blind) folded before Flop
Seat 3: RichRick1337 folded before Flop
Seat 4: Duke Croix collected (350)
Seat 6: color_singleton (button) folded before Flop (didn't bet)



PokerStars Home Game Hand #217631815487: {Club #3225207}  Hold'em No Limit (50/100) - 2020/08/20 15:45:41 ET
Table 'Manuel Neuer' 9-max (Play Money) Seat #1 is the button
Seat 1: JeBoyDirk (13940 in chips) 
Seat 2: dddocky (10017 in chips) 
Seat 3: RichRick1337 (2298 in chips) 
Seat 4: Duke Croix (6431 in chips) 
Seat 6: color_singleton (19400 in chips) 
Seat 9: Manon541 (10000 in chips) 
dddocky: posts small blind 50
RichRick1337: posts big blind 100
Manon541: posts small blind 50
*** HOLE CARDS ***
Dealt to Duke Croix [Qh 5c]
Duke Croix: folds 
color_singleton: folds 
Manon541: folds 
JeBoyDirk: calls 100
dddocky: calls 50
RichRick1337: checks 
*** FLOP *** [8d 2s Jd]
dddocky: checks 
RichRick1337: checks 
JeBoyDirk: checks 
*** TURN *** [8d 2s Jd] [6d]
dddocky: bets 331
RichRick1337: folds 
JeBoyDirk: folds 
Uncalled bet (331) returned to dddocky
dddocky collected 331 from pot
dddocky: doesn't show hand 
*** SUMMARY ***
Total pot 350 | Rake 19 
Board [8d 2s Jd 6d]
Seat 1: JeBoyDirk (button) folded on the Turn
Seat 2: dddocky (small blind) collected (331)
Seat 3: RichRick1337 (big blind) folded on the Turn
Seat 4: Duke Croix folded before Flop (didn't bet)
Seat 6: color_singleton folded before Flop (didn't bet)
Seat 9: Manon541 folded before Flop (didn't bet)



PokerStars Home Game Hand #217631832114: {Club #3225207}  Hold'em No Limit (50/100) - 2020/08/20 15:46:10 ET
Table 'Manuel Neuer' 9-max (Play Money) Seat #2 is the button
Seat 1: JeBoyDirk (13840 in chips) 
Seat 2: dddocky (10248 in chips) 
Seat 3: RichRick1337 (2198 in chips) 
Seat 4: Duke Croix (6431 in chips) 
Seat 6: color_singleton (19400 in chips) 
Seat 9: Manon541 (9950 in chips) 
RichRick1337: posts small blind 50
Duke Croix: posts big blind 100
*** HOLE CARDS ***
Dealt to Duke Croix [Qc Jd]
color_singleton: raises 200 to 300
Manon541: calls 300
JeBoyDirk: calls 300
dddocky: calls 300
RichRick1337: folds 
Duke Croix: calls 200
*** FLOP *** [Qd Ts 8c]
Duke Croix: bets 600
color_singleton: calls 600
Manon541: folds 
JeBoyDirk: folds 
dddocky: calls 600
*** TURN *** [Qd Ts 8c] [7h]
Duke Croix: bets 1300
color_singleton: calls 1300
dddocky: folds 
*** RIVER *** [Qd Ts 8c 7h] [3s]
Duke Croix: bets 4231 and is all-in
color_singleton: folds 
Uncalled bet (4231) returned to Duke Croix
Duke Croix collected 5623 from pot
*** SUMMARY ***
Total pot 5950 | Rake 327 
Board [Qd Ts 8c 7h 3s]
Seat 1: JeBoyDirk folded on the Flop
Seat 2: dddocky (button) folded on the Turn
Seat 3: RichRick1337 (small blind) folded before Flop
Seat 4: Duke Croix (big blind) collected (5623)
Seat 6: color_singleton folded on the River
Seat 9: Manon541 folded on the Flop



PokerStars Home Game Hand #217631863840: {Club #3225207}  Hold'em No Limit (50/100) - 2020/08/20 15:47:04 ET
Table 'Manuel Neuer' 9-max (Play Money) Seat #3 is the button
Seat 1: JeBoyDirk (13540 in chips) 
Seat 2: dddocky (9348 in chips) 
Seat 3: RichRick1337 (2148 in chips) 
Seat 4: Duke Croix (9854 in chips) 
Seat 6: color_singleton (17200 in chips) 
Seat 9: Manon541 (9650 in chips) 
Duke Croix: posts small blind 50
color_singleton: posts big blind 100
*** HOLE CARDS ***
Dealt to Duke Croix [7h 8c]
Manon541: calls 100
JeBoyDirk: folds 
dddocky: calls 100
RichRick1337: raises 100 to 200
Duke Croix: calls 150
color_singleton: folds 
Manon541: calls 100
dddocky: calls 100
*** FLOP *** [6c 7c Kd]
Duke Croix: checks 
Manon541: bets 100
dddocky: folds 
RichRick1337: calls 100
Duke Croix: calls 100
*** TURN *** [6c 7c Kd] [Ah]
Duke Croix: checks 
Manon541: checks 
RichRick1337: checks 
*** RIVER *** [6c 7c Kd Ah] [2h]
Duke Croix: checks 
Manon541: bets 567
RichRick1337: folds 
Duke Croix: folds 
Uncalled bet (567) returned to Manon541
Manon541 collected 1134 from pot
*** SUMMARY ***
Total pot 1200 | Rake 66 
Board [6c 7c Kd Ah 2h]
Seat 1: JeBoyDirk folded before Flop (didn't bet)
Seat 2: dddocky folded on the Flop
Seat 3: RichRick1337 (button) folded on the River
Seat 4: Duke Croix (small blind) folded on the River
Seat 6: color_singleton (big blind) folded before Flop
Seat 9: Manon541 collected (1134)



PokerStars Home Game Hand #217631896507: {Club #3225207}  Hold'em No Limit (50/100) - 2020/08/20 15:47:48 ET
Table 'Manuel Neuer' 9-max (Play Money) Seat #4 is the button
Seat 1: JeBoyDirk (13540 in chips) 
Seat 2: dddocky (9148 in chips) 
Seat 3: RichRick1337 (1848 in chips) 
Seat 4: Duke Croix (9554 in chips) 
Seat 6: color_singleton (17100 in chips) 
Seat 9: Manon541 (10484 in chips) 
color_singleton: posts small blind 50
Manon541: posts big blind 100
*** HOLE CARDS ***
Dealt to Duke Croix [Qc 6c]
JeBoyDirk: folds 
dddocky: calls 100
RichRick1337: folds 
Duke Croix: raises 300 to 400
color_singleton: folds 
Manon541: calls 300
dddocky: calls 300
*** FLOP *** [9h Kh 4c]
Manon541: checks 
dddocky: checks 
Duke Croix: checks 
*** TURN *** [9h Kh 4c] [8c]
Manon541: checks 
dddocky: bets 100
Duke Croix: raises 700 to 800
Manon541: folds 
dddocky: folds 
Uncalled bet (700) returned to Duke Croix
Duke Croix collected 1370 from pot
*** SUMMARY ***
Total pot 1450 | Rake 80 
Board [9h Kh 4c 8c]
Seat 1: JeBoyDirk folded before Flop (didn't bet)
Seat 2: dddocky folded on the Turn
Seat 3: RichRick1337 folded before Flop (didn't bet)
Seat 4: Duke Croix (button) collected (1370)
Seat 6: color_singleton (small blind) folded before Flop
Seat 9: Manon541 (big blind) folded on the Turn



PokerStars Home Game Hand #217631926113: {Club #3225207}  Hold'em No Limit (50/100) - 2020/08/20 15:48:38 ET
Table 'Manuel Neuer' 9-max (Play Money) Seat #6 is the button
Seat 1: JeBoyDirk (13540 in chips) 
Seat 2: dddocky (8648 in chips) 
Seat 3: RichRick1337 (1848 in chips) 
Seat 4: Duke Croix (10424 in chips) 
Seat 6: color_singleton (17050 in chips) 
Seat 9: Manon541 (10084 in chips) 
Manon541: posts small blind 50
JeBoyDirk: posts big blind 100
*** HOLE CARDS ***
Dealt to Duke Croix [Ah 7c]
dddocky: calls 100
RichRick1337: folds 
Duke Croix: raises 300 to 400
color_singleton: folds 
Manon541: calls 350
JeBoyDirk: folds 
dddocky: calls 300
*** FLOP *** [Kh 3d 8s]
Manon541: checks 
dddocky: checks 
Duke Croix: checks 
*** TURN *** [Kh 3d 8s] [4s]
Manon541: checks 
dddocky: checks 
Duke Croix: checks 
*** RIVER *** [Kh 3d 8s 4s] [4c]
Manon541: checks 
dddocky: checks 
Duke Croix: checks 
*** SHOW DOWN ***
Manon541: shows [Qd 4d] (three of a kind, Fours)
dddocky: mucks hand 
Duke Croix: mucks hand 
Manon541 collected 1228 from pot
*** SUMMARY ***
Total pot 1300 | Rake 72 
Board [Kh 3d 8s 4s 4c]
Seat 1: JeBoyDirk (big blind) folded before Flop
Seat 2: dddocky mucked [Qc Js]
Seat 3: RichRick1337 folded before Flop (didn't bet)
Seat 4: Duke Croix mucked [Ah 7c]
Seat 6: color_singleton (button) folded before Flop (didn't bet)
Seat 9: Manon541 (small blind) showed [Qd 4d] and won (1228) with three of a kind, Fours



PokerStars Home Game Hand #217631947286: {Club #3225207}  Hold'em No Limit (50/100) - 2020/08/20 15:49:14 ET
Table 'Manuel Neuer' 9-max (Play Money) Seat #9 is the button
Seat 1: JeBoyDirk (13440 in chips) 
Seat 2: dddocky (8248 in chips) 
Seat 3: RichRick1337 (1848 in chips) 
Seat 4: Duke Croix (10024 in chips) 
Seat 6: color_singleton (17050 in chips) 
Seat 9: Manon541 (10912 in chips) 
JeBoyDirk: posts small blind 50
dddocky: posts big blind 100
*** HOLE CARDS ***
Dealt to Duke Croix [8d 5s]
RichRick1337: calls 100
Duke Croix: folds 
color_singleton: raises 100 to 200
Manon541: calls 200
JeBoyDirk: calls 150
dddocky: calls 100
RichRick1337: raises 100 to 300
color_singleton: calls 100
Manon541: calls 100
JeBoyDirk: calls 100
dddocky: calls 100
*** FLOP *** [7s Kc Ad]
JeBoyDirk: checks 
dddocky: checks 
RichRick1337: bets 100
color_singleton: calls 100
Manon541: folds 
JeBoyDirk: calls 100
dddocky: folds 
*** TURN *** [7s Kc Ad] [3s]
JeBoyDirk: checks 
RichRick1337: checks 
color_singleton: checks 
*** RIVER *** [7s Kc Ad 3s] [Ts]
JeBoyDirk: checks 
RichRick1337: checks 
color_singleton: checks 
*** SHOW DOWN ***
JeBoyDirk: shows [Jd Kd] (a pair of Kings)
RichRick1337: mucks hand 
color_singleton: mucks hand 
JeBoyDirk collected 1701 from pot
*** SUMMARY ***
Total pot 1800 | Rake 99 
Board [7s Kc Ad 3s Ts]
Seat 1: JeBoyDirk (small blind) showed [Jd Kd] and won (1701) with a pair of Kings
Seat 2: dddocky (big blind) folded on the Flop
Seat 3: RichRick1337 mucked [4h 4d]
Seat 4: Duke Croix folded before Flop (didn't bet)
Seat 6: color_singleton mucked [Qc Tc]
Seat 9: Manon541 (button) folded on the Flop



PokerStars Home Game Hand #217631978052: {Club #3225207}  Hold'em No Limit (50/100) - 2020/08/20 15:50:07 ET
Table 'Manuel Neuer' 9-max (Play Money) Seat #1 is the button
Seat 1: JeBoyDirk (14741 in chips) 
Seat 3: RichRick1337 (1448 in chips) 
Seat 4: Duke Croix (10024 in chips) 
Seat 6: color_singleton (16650 in chips) 
Seat 9: Manon541 (10612 in chips) 
RichRick1337: posts small blind 50
Duke Croix: posts big blind 100
*** HOLE CARDS ***
Dealt to Duke Croix [9h 7s]
color_singleton: folds 
Manon541: folds 
JeBoyDirk: raises 200 to 300
RichRick1337: calls 250
Duke Croix: calls 200
*** FLOP *** [5c 7c Ks]
RichRick1337: checks 
Duke Croix: checks 
JeBoyDirk: checks 
*** TURN *** [5c 7c Ks] [8d]
RichRick1337: checks 
Duke Croix: bets 500
JeBoyDirk: calls 500
RichRick1337: folds 
*** RIVER *** [5c 7c Ks 8d] [2c]
Duke Croix: checks 
JeBoyDirk: checks 
*** SHOW DOWN ***
Duke Croix: shows [9h 7s] (a pair of Sevens)
JeBoyDirk: shows [Kh Kd] (three of a kind, Kings)
JeBoyDirk collected 1795 from pot
*** SUMMARY ***
Total pot 1900 | Rake 105 
Board [5c 7c Ks 8d 2c]
Seat 1: JeBoyDirk (button) showed [Kh Kd] and won (1795) with three of a kind, Kings
Seat 3: RichRick1337 (small blind) folded on the Turn
Seat 4: Duke Croix (big blind) showed [9h 7s] and lost with a pair of Sevens
Seat 6: color_singleton folded before Flop (didn't bet)
Seat 9: Manon541 folded before Flop (didn't bet)



PokerStars Home Game Hand #217632004026: {Club #3225207}  Hold'em No Limit (50/100) - 2020/08/20 15:50:51 ET
Table 'Manuel Neuer' 9-max (Play Money) Seat #3 is the button
Seat 1: JeBoyDirk (15736 in chips) 
Seat 3: RichRick1337 (1148 in chips) 
Seat 4: Duke Croix (9224 in chips) 
Seat 6: color_singleton (16650 in chips) 
Seat 9: Manon541 (10612 in chips) 
Duke Croix: posts small blind 50
color_singleton: posts big blind 100
*** HOLE CARDS ***
Dealt to Duke Croix [9h 3c]
Manon541: calls 100
JeBoyDirk: folds 
RichRick1337: calls 100
Duke Croix: calls 50
color_singleton: checks 
*** FLOP *** [Ks 7h Jd]
Duke Croix: checks 
color_singleton: checks 
Manon541: checks 
RichRick1337: checks 
*** TURN *** [Ks 7h Jd] [Jc]
Duke Croix: checks 
color_singleton: bets 189
Manon541: calls 189
RichRick1337: folds 
Duke Croix: folds 
*** RIVER *** [Ks 7h Jd Jc] [Th]
color_singleton: checks 
Manon541: bets 367
color_singleton: calls 367
*** SHOW DOWN ***
Manon541: shows [6c 6s] (two pair, Jacks and Sixes)
color_singleton: shows [6d 7c] (two pair, Jacks and Sevens)
color_singleton collected 1429 from pot
*** SUMMARY ***
Total pot 1512 | Rake 83 
Board [Ks 7h Jd Jc Th]
Seat 1: JeBoyDirk folded before Flop (didn't bet)
Seat 3: RichRick1337 (button) folded on the Turn
Seat 4: Duke Croix (small blind) folded on the Turn
Seat 6: color_singleton (big blind) showed [6d 7c] and won (1429) with two pair, Jacks and Sevens
Seat 9: Manon541 showed [6c 6s] and lost with two pair, Jacks and Sixes



PokerStars Home Game Hand #217632027993: {Club #3225207}  Hold'em No Limit (50/100) - 2020/08/20 15:51:32 ET
Table 'Manuel Neuer' 9-max (Play Money) Seat #4 is the button
Seat 1: JeBoyDirk (15736 in chips) 
Seat 3: RichRick1337 (1048 in chips) 
Seat 4: Duke Croix (9124 in chips) 
Seat 6: color_singleton (17423 in chips) 
Seat 9: Manon541 (9956 in chips) 
color_singleton: posts small blind 50
Manon541: posts big blind 100
*** HOLE CARDS ***
Dealt to Duke Croix [Kc 4h]
JeBoyDirk: folds 
RichRick1337: raises 100 to 200
Duke Croix: folds 
color_singleton: calls 150
Manon541: calls 100
*** FLOP *** [6s 3d Tc]
color_singleton: checks 
Manon541: checks 
RichRick1337: checks 
*** TURN *** [6s 3d Tc] [2d]
color_singleton: bets 283
Manon541: folds 
RichRick1337: folds 
Uncalled bet (283) returned to color_singleton
color_singleton collected 567 from pot
color_singleton: doesn't show hand 
*** SUMMARY ***
Total pot 600 | Rake 33 
Board [6s 3d Tc 2d]
Seat 1: JeBoyDirk folded before Flop (didn't bet)
Seat 3: RichRick1337 folded on the Turn
Seat 4: Duke Croix (button) folded before Flop (didn't bet)
Seat 6: color_singleton (small blind) collected (567)
Seat 9: Manon541 (big blind) folded on the Turn



PokerStars Home Game Hand #217632041201: {Club #3225207}  Hold'em No Limit (50/100) - 2020/08/20 15:51:55 ET
Table 'Manuel Neuer' 9-max (Play Money) Seat #6 is the button
Seat 1: JeBoyDirk (15736 in chips) 
Seat 3: RichRick1337 (848 in chips) 
Seat 4: Duke Croix (9124 in chips) 
Seat 6: color_singleton (17790 in chips) 
Seat 9: Manon541 (9756 in chips) 
Manon541: posts small blind 50
JeBoyDirk: posts big blind 100
*** HOLE CARDS ***
Dealt to Duke Croix [5c 6c]
RichRick1337: folds 
Duke Croix: raises 300 to 400
color_singleton: calls 400
Manon541: calls 350
JeBoyDirk: folds 
*** FLOP *** [8d 6h Jh]
Manon541: checks 
Duke Croix: checks 
color_singleton: checks 
*** TURN *** [8d 6h Jh] [Td]
Manon541: checks 
Duke Croix: checks 
color_singleton: checks 
*** RIVER *** [8d 6h Jh Td] [3c]
Manon541: checks 
Duke Croix: bets 600
color_singleton: folds 
Manon541: folds 
Uncalled bet (600) returned to Duke Croix
Duke Croix collected 1228 from pot
*** SUMMARY ***
Total pot 1300 | Rake 72 
Board [8d 6h Jh Td 3c]
Seat 1: JeBoyDirk (big blind) folded before Flop
Seat 3: RichRick1337 folded before Flop (didn't bet)
Seat 4: Duke Croix collected (1228)
Seat 6: color_singleton (button) folded on the River
Seat 9: Manon541 (small blind) folded on the River



PokerStars Home Game Hand #217632064117: {Club #3225207}  Hold'em No Limit (50/100) - 2020/08/20 15:52:34 ET
Table 'Manuel Neuer' 9-max (Play Money) Seat #9 is the button
Seat 1: JeBoyDirk (15636 in chips) 
Seat 3: RichRick1337 (848 in chips) 
Seat 4: Duke Croix (9952 in chips) 
Seat 6: color_singleton (17390 in chips) 
Seat 9: Manon541 (9356 in chips) 
JeBoyDirk: posts small blind 50
RichRick1337: posts big blind 100
*** HOLE CARDS ***
Dealt to Duke Croix [7c Tc]
Duke Croix: calls 100
color_singleton: folds 
Manon541: calls 100
JeBoyDirk: calls 50
RichRick1337: checks 
*** FLOP *** [7h 3d Ac]
JeBoyDirk: checks 
RichRick1337: checks 
Duke Croix: checks 
Manon541: checks 
*** TURN *** [7h 3d Ac] [7s]
JeBoyDirk: checks 
RichRick1337: checks 
Duke Croix: bets 378
Manon541: folds 
JeBoyDirk: folds 
RichRick1337: folds 
Uncalled bet (378) returned to Duke Croix
Duke Croix collected 378 from pot
*** SUMMARY ***
Total pot 400 | Rake 22 
Board [7h 3d Ac 7s]
Seat 1: JeBoyDirk (small blind) folded on the Turn
Seat 3: RichRick1337 (big blind) folded on the Turn
Seat 4: Duke Croix collected (378)
Seat 6: color_singleton folded before Flop (didn't bet)
Seat 9: Manon541 (button) folded on the Turn



PokerStars Home Game Hand #217632090173: {Club #3225207}  Hold'em No Limit (50/100) - 2020/08/20 15:53:19 ET
Table 'Manuel Neuer' 9-max (Play Money) Seat #1 is the button
Seat 1: JeBoyDirk (15536 in chips) 
Seat 3: RichRick1337 (748 in chips) 
Seat 4: Duke Croix (10230 in chips) 
Seat 6: color_singleton (17390 in chips) 
Seat 9: Manon541 (9256 in chips) 
RichRick1337: posts small blind 50
Duke Croix: posts big blind 100
*** HOLE CARDS ***
Dealt to Duke Croix [8h 4c]
color_singleton: folds 
Manon541: calls 100
JeBoyDirk: raises 100 to 200
RichRick1337: calls 150
Duke Croix: folds 
Manon541: calls 100
*** FLOP *** [9d 7h 8d]
RichRick1337: checks 
Manon541: checks 
JeBoyDirk: checks 
*** TURN *** [9d 7h 8d] [4s]
RichRick1337: checks 
Manon541: checks 
JeBoyDirk: checks 
*** RIVER *** [9d 7h 8d 4s] [Kh]
RichRick1337: checks 
Manon541: checks 
JeBoyDirk: checks 
*** SHOW DOWN ***
RichRick1337: shows [Kc 4h] (two pair, Kings and Fours)
Manon541: mucks hand 
JeBoyDirk: mucks hand 
RichRick1337 collected 661 from pot
*** SUMMARY ***
Total pot 700 | Rake 39 
Board [9d 7h 8d 4s Kh]
Seat 1: JeBoyDirk (button) mucked [Ah Qh]
Seat 3: RichRick1337 (small blind) showed [Kc 4h] and won (661) with two pair, Kings and Fours
Seat 4: Duke Croix (big blind) folded before Flop
Seat 6: color_singleton folded before Flop (didn't bet)
Seat 9: Manon541 mucked [5c Ac]



PokerStars Home Game Hand #217632113037: {Club #3225207}  Hold'em No Limit (50/100) - 2020/08/20 15:53:58 ET
Table 'Manuel Neuer' 9-max (Play Money) Seat #3 is the button
Seat 1: JeBoyDirk (15336 in chips) 
Seat 2: dddocky (7948 in chips) 
Seat 3: RichRick1337 (1209 in chips) 
Seat 4: Duke Croix (10130 in chips) 
Seat 6: color_singleton (17390 in chips) 
Seat 9: Manon541 (9056 in chips) 
Duke Croix: posts small blind 50
color_singleton: posts big blind 100
dddocky: posts small & big blinds 150
*** HOLE CARDS ***
Dealt to Duke Croix [Qh Th]
Manon541: calls 100
JeBoyDirk: folds 
dddocky: checks 
RichRick1337: calls 100
Duke Croix: calls 50
color_singleton: checks 
*** FLOP *** [Jc Jh 4s]
Duke Croix: checks 
color_singleton: checks 
Manon541: checks 
dddocky: checks 
RichRick1337: checks 
*** TURN *** [Jc Jh 4s] [7h]
Duke Croix: bets 400
color_singleton: folds 
Manon541: folds 
dddocky: raises 400 to 800
RichRick1337: folds 
Duke Croix: calls 400
*** RIVER *** [Jc Jh 4s 7h] [9c]
Duke Croix: bets 1100
dddocky: calls 1100
*** SHOW DOWN ***
Duke Croix: shows [Qh Th] (a pair of Jacks)
dddocky: shows [As Jd] (three of a kind, Jacks)
dddocky collected 4111 from pot
*** SUMMARY ***
Total pot 4350 | Rake 239 
Board [Jc Jh 4s 7h 9c]
Seat 1: JeBoyDirk folded before Flop (didn't bet)
Seat 2: dddocky showed [As Jd] and won (4111) with three of a kind, Jacks
Seat 3: RichRick1337 (button) folded on the Turn
Seat 4: Duke Croix (small blind) showed [Qh Th] and lost with a pair of Jacks
Seat 6: color_singleton (big blind) folded on the Turn
Seat 9: Manon541 folded on the Turn



PokerStars Home Game Hand #217632150449: {Club #3225207}  Hold'em No Limit (50/100) - 2020/08/20 15:55:02 ET
Table 'Manuel Neuer' 9-max (Play Money) Seat #4 is the button
Seat 1: JeBoyDirk (15336 in chips) 
Seat 2: dddocky (10009 in chips) 
Seat 3: RichRick1337 (1109 in chips) 
Seat 4: Duke Croix (8130 in chips) 
Seat 6: color_singleton (17290 in chips) 
Seat 9: Manon541 (8956 in chips) 
color_singleton: posts small blind 50
Manon541: posts big blind 100
*** HOLE CARDS ***
Dealt to Duke Croix [Ac 7s]
JeBoyDirk: folds 
dddocky: calls 100
RichRick1337: calls 100
Duke Croix: raises 400 to 500
color_singleton: folds 
Manon541: calls 400
dddocky: calls 400
RichRick1337: folds 
*** FLOP *** [8s 9s 9c]
Manon541: checks 
dddocky: checks 
Duke Croix: checks 
*** TURN *** [8s 9s 9c] [6c]
Manon541: checks 
dddocky: checks 
Duke Croix: checks 
*** RIVER *** [8s 9s 9c 6c] [Ah]
Manon541: checks 
dddocky: checks 
Duke Croix: bets 1000
Manon541: folds 
dddocky: folds 
Uncalled bet (1000) returned to Duke Croix
Duke Croix collected 1559 from pot
*** SUMMARY ***
Total pot 1650 | Rake 91 
Board [8s 9s 9c 6c Ah]
Seat 1: JeBoyDirk folded before Flop (didn't bet)
Seat 2: dddocky folded on the River
Seat 3: RichRick1337 folded before Flop
Seat 4: Duke Croix (button) collected (1559)
Seat 6: color_singleton (small blind) folded before Flop
Seat 9: Manon541 (big blind) folded on the River



PokerStars Home Game Hand #217632178152: {Club #3225207}  Hold'em No Limit (50/100) - 2020/08/20 15:56:05 ET
Table 'Manuel Neuer' 9-max (Play Money) Seat #6 is the button
Seat 1: JeBoyDirk (15336 in chips) 
Seat 2: dddocky (9509 in chips) 
Seat 3: RichRick1337 (1009 in chips) 
Seat 4: Duke Croix (9189 in chips) 
Seat 6: color_singleton (17240 in chips) 
Seat 9: Manon541 (8456 in chips) 
Manon541: posts small blind 50
JeBoyDirk: posts big blind 100
*** HOLE CARDS ***
Dealt to Duke Croix [3s 6c]
dddocky: calls 100
RichRick1337: folds 
Duke Croix: folds 
color_singleton: raises 200 to 300
Manon541: folds 
JeBoyDirk: calls 200
dddocky: calls 200
*** FLOP *** [5s 7d Qs]
JeBoyDirk: checks 
dddocky: checks 
color_singleton: checks 
*** TURN *** [5s 7d Qs] [Qc]
JeBoyDirk: checks 
dddocky: checks 
color_singleton: checks 
*** RIVER *** [5s 7d Qs Qc] [8h]
JeBoyDirk: checks 
dddocky: checks 
color_singleton: checks 
*** SHOW DOWN ***
JeBoyDirk: shows [8s 9s] (two pair, Queens and Eights)
dddocky: mucks hand 
color_singleton: mucks hand 
JeBoyDirk collected 898 from pot
*** SUMMARY ***
Total pot 950 | Rake 52 
Board [5s 7d Qs Qc 8h]
Seat 1: JeBoyDirk (big blind) showed [8s 9s] and won (898) with two pair, Queens and Eights
Seat 2: dddocky mucked [4h Jc]
Seat 3: RichRick1337 folded before Flop (didn't bet)
Seat 4: Duke Croix folded before Flop (didn't bet)
Seat 6: color_singleton (button) mucked [6h Kh]
Seat 9: Manon541 (small blind) folded before Flop



PokerStars Home Game Hand #217632196729: {Club #3225207}  Hold'em No Limit (50/100) - 2020/08/20 15:56:47 ET
Table 'Manuel Neuer' 9-max (Play Money) Seat #9 is the button
Seat 1: JeBoyDirk (15934 in chips) 
Seat 2: dddocky (9209 in chips) 
Seat 3: RichRick1337 (1009 in chips) 
Seat 4: Duke Croix (9189 in chips) 
Seat 6: color_singleton (16940 in chips) 
Seat 9: Manon541 (8406 in chips) 
JeBoyDirk: posts small blind 50
dddocky: posts big blind 100
*** HOLE CARDS ***
Dealt to Duke Croix [Qs 5s]
RichRick1337: calls 100
Duke Croix: folds 
color_singleton: raises 100 to 200
Manon541: calls 200
JeBoyDirk: folds 
dddocky: calls 100
RichRick1337: calls 100
*** FLOP *** [9h 7d 8d]
dddocky: checks 
RichRick1337: checks 
color_singleton: bets 401
Manon541: calls 401
dddocky: folds 
RichRick1337: folds 
*** TURN *** [9h 7d 8d] [Qh]
color_singleton: bets 780
Manon541: calls 780
*** RIVER *** [9h 7d 8d Qh] [Kd]
color_singleton: checks 
Manon541: bets 3035
color_singleton: folds 
Uncalled bet (3035) returned to Manon541
Manon541 collected 3035 from pot
*** SUMMARY ***
Total pot 3212 | Rake 177 
Board [9h 7d 8d Qh Kd]
Seat 1: JeBoyDirk (small blind) folded before Flop
Seat 2: dddocky (big blind) folded on the Flop
Seat 3: RichRick1337 folded on the Flop
Seat 4: Duke Croix folded before Flop (didn't bet)
Seat 6: color_singleton folded on the River
Seat 9: Manon541 (button) collected (3035)



PokerStars Home Game Hand #217632222949: {Club #3225207}  Hold'em No Limit (50/100) - 2020/08/20 15:57:46 ET
Table 'Manuel Neuer' 9-max (Play Money) Seat #1 is the button
Seat 1: JeBoyDirk (15884 in chips) 
Seat 2: dddocky (9009 in chips) 
Seat 3: RichRick1337 (809 in chips) 
Seat 4: Duke Croix (9189 in chips) 
Seat 6: color_singleton (15559 in chips) 
Seat 9: Manon541 (10060 in chips) 
dddocky: posts small blind 50
RichRick1337: posts big blind 100
*** HOLE CARDS ***
Dealt to Duke Croix [Jh 9s]
Duke Croix: calls 100
color_singleton: folds 
Manon541: calls 100
JeBoyDirk: folds 
dddocky: calls 50
RichRick1337: checks 
*** FLOP *** [2s 2h Ts]
dddocky: bets 378
RichRick1337: calls 378
Duke Croix: folds 
Manon541: folds 
*** TURN *** [2s 2h Ts] [8c]
dddocky: checks 
RichRick1337: bets 100
dddocky: calls 100
*** RIVER *** [2s 2h Ts 8c] [2d]
dddocky: checks 
RichRick1337: bets 231 and is all-in
dddocky: calls 231
*** SHOW DOWN ***
RichRick1337: shows [9d Tc] (a full house, Deuces full of Tens)
dddocky: shows [Th 3h] (a full house, Deuces full of Tens)
dddocky collected 859 from pot
RichRick1337 collected 859 from pot
*** SUMMARY ***
Total pot 1818 | Rake 100 
Board [2s 2h Ts 8c 2d]
Seat 1: JeBoyDirk (button) folded before Flop (didn't bet)
Seat 2: dddocky (small blind) showed [Th 3h] and won (859) with a full house, Deuces full of Tens
Seat 3: RichRick1337 (big blind) showed [9d Tc] and won (859) with a full house, Deuces full of Tens
Seat 4: Duke Croix folded on the Flop
Seat 6: color_singleton folded before Flop (didn't bet)
Seat 9: Manon541 folded on the Flop



PokerStars Home Game Hand #217632250915: {Club #3225207}  Hold'em No Limit (50/100) - 2020/08/20 15:58:43 ET
Table 'Manuel Neuer' 9-max (Play Money) Seat #2 is the button
Seat 1: JeBoyDirk (15884 in chips) 
Seat 2: dddocky (9059 in chips) 
Seat 3: RichRick1337 (859 in chips) 
Seat 4: Duke Croix (9089 in chips) 
Seat 6: color_singleton (15559 in chips) 
Seat 9: Manon541 (9960 in chips) 
RichRick1337: posts small blind 50
Duke Croix: posts big blind 100
*** HOLE CARDS ***
Dealt to Duke Croix [5d 5c]
color_singleton: folds 
Manon541: calls 100
JeBoyDirk: raises 200 to 300
dddocky: calls 300
RichRick1337: folds 
Duke Croix: calls 200
Manon541: folds 
*** FLOP *** [Qd As Tc]
Duke Croix: checks 
JeBoyDirk: checks 
dddocky: checks 
*** TURN *** [Qd As Tc] [2d]
Duke Croix: bets 400
JeBoyDirk: folds 
dddocky: folds 
Uncalled bet (400) returned to Duke Croix
Duke Croix collected 992 from pot
*** SUMMARY ***
Total pot 1050 | Rake 58 
Board [Qd As Tc 2d]
Seat 1: JeBoyDirk folded on the Turn
Seat 2: dddocky (button) folded on the Turn
Seat 3: RichRick1337 (small blind) folded before Flop
Seat 4: Duke Croix (big blind) collected (992)
Seat 6: color_singleton folded before Flop (didn't bet)
Seat 9: Manon541 folded before Flop



PokerStars Home Game Hand #217632263496: {Club #3225207}  Hold'em No Limit (50/100) - 2020/08/20 15:59:11 ET
Table 'Manuel Neuer' 9-max (Play Money) Seat #3 is the button
Seat 1: JeBoyDirk (15584 in chips) 
Seat 2: dddocky (8759 in chips) 
Seat 3: RichRick1337 (809 in chips) 
Seat 4: Duke Croix (9781 in chips) 
Seat 6: color_singleton (15559 in chips) 
Seat 9: Manon541 (9860 in chips) 
Duke Croix: posts small blind 50
color_singleton: posts big blind 100
*** HOLE CARDS ***
Dealt to Duke Croix [Jh 8d]
Manon541 has timed out
Manon541: folds 
JeBoyDirk: folds 
dddocky: folds 
RichRick1337: calls 100
Duke Croix: calls 50
color_singleton: checks 
*** FLOP *** [8c Td Ts]
Duke Croix: bets 200
color_singleton: calls 200
RichRick1337: folds 
*** TURN *** [8c Td Ts] [Ac]
Duke Croix: bets 400
color_singleton: calls 400
*** RIVER *** [8c Td Ts Ac] [3c]
Duke Croix: checks 
color_singleton: checks 
*** SHOW DOWN ***
Duke Croix: shows [Jh 8d] (two pair, Tens and Eights)
color_singleton: mucks hand 
Duke Croix collected 1417 from pot
*** SUMMARY ***
Total pot 1500 | Rake 83 
Board [8c Td Ts Ac 3c]
Seat 1: JeBoyDirk folded before Flop (didn't bet)
Seat 2: dddocky folded before Flop (didn't bet)
Seat 3: RichRick1337 (button) folded on the Flop
Seat 4: Duke Croix (small blind) showed [Jh 8d] and won (1417) with two pair, Tens and Eights
Seat 6: color_singleton (big blind) mucked [9d 7s]
Seat 9: Manon541 folded before Flop (didn't bet)



PokerStars Home Game Hand #217632282045: {Club #3225207}  Hold'em No Limit (50/100) - 2020/08/20 15:59:53 ET
Table 'Manuel Neuer' 9-max (Play Money) Seat #4 is the button
Seat 1: JeBoyDirk (15584 in chips) 
Seat 2: dddocky (8759 in chips) 
Seat 3: RichRick1337 (709 in chips) 
Seat 4: Duke Croix (10498 in chips) 
Seat 6: color_singleton (14859 in chips) 
Seat 9: Manon541 (9860 in chips) 
color_singleton: posts small blind 50
Manon541: posts big blind 100
*** HOLE CARDS ***
Dealt to Duke Croix [Ts Kh]
JeBoyDirk: calls 100
dddocky: calls 100
RichRick1337: folds 
Duke Croix: raises 400 to 500
color_singleton: folds 
Manon541: folds 
JeBoyDirk: calls 400
dddocky: calls 400
*** FLOP *** [5d Tc Js]
JeBoyDirk: checks 
dddocky: checks 
Duke Croix: checks 
*** TURN *** [5d Tc Js] [2d]
JeBoyDirk: checks 
dddocky: checks 
Duke Croix: bets 850
JeBoyDirk: folds 
dddocky: folds 
Uncalled bet (850) returned to Duke Croix
Duke Croix collected 1559 from pot
*** SUMMARY ***
Total pot 1650 | Rake 91 
Board [5d Tc Js 2d]
Seat 1: JeBoyDirk folded on the Turn
Seat 2: dddocky folded on the Turn
Seat 3: RichRick1337 folded before Flop (didn't bet)
Seat 4: Duke Croix (button) collected (1559)
Seat 6: color_singleton (small blind) folded before Flop
Seat 9: Manon541 (big blind) folded before Flop



PokerStars Home Game Hand #217632297740: {Club #3225207}  Hold'em No Limit (50/100) - 2020/08/20 16:00:27 ET
Table 'Manuel Neuer' 9-max (Play Money) Seat #6 is the button
Seat 1: JeBoyDirk (15084 in chips) 
Seat 2: dddocky (8259 in chips) 
Seat 3: RichRick1337 (709 in chips) 
Seat 4: Duke Croix (11557 in chips) 
Seat 6: color_singleton (14809 in chips) 
Seat 9: Manon541 (9760 in chips) 
Manon541: posts small blind 50
JeBoyDirk: posts big blind 100
*** HOLE CARDS ***
Dealt to Duke Croix [Qh Jd]
dddocky: calls 100
RichRick1337: folds 
Duke Croix: raises 300 to 400
color_singleton: calls 400
Manon541: calls 350
JeBoyDirk: calls 300
dddocky: calls 300
*** FLOP *** [8s 6d Jh]
Manon541: checks 
JeBoyDirk: checks 
dddocky: checks 
Duke Croix: bets 700
color_singleton: raises 700 to 1400
Manon541: folds 
JeBoyDirk: folds 
dddocky: folds 
Duke Croix: calls 700
*** TURN *** [8s 6d Jh] [Qs]
Duke Croix: checks 
color_singleton: bets 2268
Duke Croix: raises 2732 to 5000
color_singleton: calls 2732
*** RIVER *** [8s 6d Jh Qs] [Th]
Duke Croix: checks 
color_singleton: checks 
*** SHOW DOWN ***
Duke Croix: shows [Qh Jd] (two pair, Queens and Jacks)
color_singleton: mucks hand 
Duke Croix collected 13986 from pot
*** SUMMARY ***
Total pot 14800 | Rake 814 
Board [8s 6d Jh Qs Th]
Seat 1: JeBoyDirk (big blind) folded on the Flop
Seat 2: dddocky folded on the Flop
Seat 3: RichRick1337 folded before Flop (didn't bet)
Seat 4: Duke Croix showed [Qh Jd] and won (13986) with two pair, Queens and Jacks
Seat 6: color_singleton (button) mucked [Js Ah]
Seat 9: Manon541 (small blind) folded on the Flop



PokerStars Home Game Hand #217632328416: {Club #3225207}  Hold'em No Limit (50/100) - 2020/08/20 16:01:27 ET
Table 'Manuel Neuer' 9-max (Play Money) Seat #9 is the button
Seat 1: JeBoyDirk (14684 in chips) 
Seat 2: dddocky (7859 in chips) 
Seat 3: RichRick1337 (709 in chips) 
Seat 4: Duke Croix (18743 in chips) 
Seat 6: color_singleton (8009 in chips) 
Seat 9: Manon541 (9360 in chips) 
JeBoyDirk: posts small blind 50
dddocky: posts big blind 100
*** HOLE CARDS ***
Dealt to Duke Croix [Ah 8d]
RichRick1337: folds 
Duke Croix: raises 300 to 400
color_singleton: folds 
Manon541: calls 400
JeBoyDirk: folds 
dddocky: calls 300
*** FLOP *** [2s 8s Jh]
dddocky: bets 1100
Duke Croix: folds 
Manon541: folds 
Uncalled bet (1100) returned to dddocky
dddocky collected 1181 from pot
dddocky: doesn't show hand 
*** SUMMARY ***
Total pot 1250 | Rake 69 
Board [2s 8s Jh]
Seat 1: JeBoyDirk (small blind) folded before Flop
Seat 2: dddocky (big blind) collected (1181)
Seat 3: RichRick1337 folded before Flop (didn't bet)
Seat 4: Duke Croix folded on the Flop
Seat 6: color_singleton folded before Flop (didn't bet)
Seat 9: Manon541 (button) folded on the Flop



PokerStars Home Game Hand #217632342156: {Club #3225207}  Hold'em No Limit (50/100) - 2020/08/20 16:01:52 ET
Table 'Manuel Neuer' 9-max (Play Money) Seat #1 is the button
Seat 1: JeBoyDirk (14634 in chips) 
Seat 2: dddocky (8640 in chips) 
Seat 3: RichRick1337 (709 in chips) 
Seat 4: Duke Croix (18343 in chips) 
Seat 6: color_singleton (8009 in chips) 
Seat 9: Manon541 (8960 in chips) 
dddocky: posts small blind 50
RichRick1337: posts big blind 100
*** HOLE CARDS ***
Dealt to Duke Croix [9s Jh]
Duke Croix: folds 
color_singleton: folds 
Manon541: folds 
JeBoyDirk: raises 300 to 400
dddocky: folds 
RichRick1337: calls 300
*** FLOP *** [9d 5s 7c]
RichRick1337: checks 
JeBoyDirk: bets 400
RichRick1337: calls 309 and is all-in
Uncalled bet (91) returned to JeBoyDirk
*** TURN *** [9d 5s 7c] [As]
*** RIVER *** [9d 5s 7c As] [8s]
*** SHOW DOWN ***
RichRick1337: shows [Qh 2h] (high card Ace)
JeBoyDirk: shows [Qc Ad] (a pair of Aces)
JeBoyDirk collected 1387 from pot
*** SUMMARY ***
Total pot 1468 | Rake 81 
Board [9d 5s 7c As 8s]
Seat 1: JeBoyDirk (button) showed [Qc Ad] and won (1387) with a pair of Aces
Seat 2: dddocky (small blind) folded before Flop
Seat 3: RichRick1337 (big blind) showed [Qh 2h] and lost with high card Ace
Seat 4: Duke Croix folded before Flop (didn't bet)
Seat 6: color_singleton folded before Flop (didn't bet)
Seat 9: Manon541 folded before Flop (didn't bet)



PokerStars Home Game Hand #217632357740: {Club #3225207}  Hold'em No Limit (50/100) - 2020/08/20 16:02:20 ET
Table 'Manuel Neuer' 9-max (Play Money) Seat #2 is the button
Seat 1: JeBoyDirk (15312 in chips) 
Seat 2: dddocky (8590 in chips) 
Seat 4: Duke Croix (18343 in chips) 
Seat 6: color_singleton (8009 in chips) 
Seat 9: Manon541 (8960 in chips) 
Duke Croix: posts small blind 50
color_singleton: posts big blind 100
*** HOLE CARDS ***
Dealt to Duke Croix [5s Js]
Manon541: calls 100
JeBoyDirk: folds 
dddocky: calls 100
Duke Croix: calls 50
color_singleton: checks 
*** FLOP *** [9s 2h 3h]
Duke Croix: checks 
color_singleton: checks 
Manon541: checks 
dddocky: checks 
*** TURN *** [9s 2h 3h] [Qd]
Duke Croix: checks 
color_singleton: checks 
Manon541: checks 
dddocky: checks 
*** RIVER *** [9s 2h 3h Qd] [7s]
Duke Croix: checks 
color_singleton: checks 
Manon541: checks 
dddocky: checks 
*** SHOW DOWN ***
Duke Croix: shows [5s Js] (high card Queen)
color_singleton: mucks hand 
Manon541: shows [7c Tc] (a pair of Sevens)
dddocky: mucks hand 
Manon541 collected 378 from pot
*** SUMMARY ***
Total pot 400 | Rake 22 
Board [9s 2h 3h Qd 7s]
Seat 1: JeBoyDirk folded before Flop (didn't bet)
Seat 2: dddocky (button) mucked [6d Td]
Seat 4: Duke Croix (small blind) showed [5s Js] and lost with high card Queen
Seat 6: color_singleton (big blind) mucked [5d 6s]
Seat 9: Manon541 showed [7c Tc] and won (378) with a pair of Sevens



PokerStars Home Game Hand #217632378740: {Club #3225207}  Hold'em No Limit (50/100) - 2020/08/20 16:02:56 ET
Table 'Manuel Neuer' 9-max (Play Money) Seat #4 is the button
Seat 1: JeBoyDirk (15312 in chips) 
Seat 2: dddocky (8490 in chips) 
Seat 4: Duke Croix (18243 in chips) 
Seat 6: color_singleton (7909 in chips) 
Seat 9: Manon541 (9238 in chips) 
color_singleton: posts small blind 50
Manon541: posts big blind 100
*** HOLE CARDS ***
Dealt to Duke Croix [3s 2s]
JeBoyDirk: folds 
dddocky: folds 
Duke Croix: calls 100
color_singleton: folds 
Manon541: checks 
*** FLOP *** [As 6d Th]
Manon541: checks 
Duke Croix: checks 
*** TURN *** [As 6d Th] [Qd]
Manon541: bets 118
Duke Croix: folds 
Uncalled bet (118) returned to Manon541
Manon541 collected 236 from pot
*** SUMMARY ***
Total pot 250 | Rake 14 
Board [As 6d Th Qd]
Seat 1: JeBoyDirk folded before Flop (didn't bet)
Seat 2: dddocky folded before Flop (didn't bet)
Seat 4: Duke Croix (button) folded on the Turn
Seat 6: color_singleton (small blind) folded before Flop
Seat 9: Manon541 (big blind) collected (236)



PokerStars Home Game Hand #217632392185: {Club #3225207}  Hold'em No Limit (50/100) - 2020/08/20 16:03:20 ET
Table 'Manuel Neuer' 9-max (Play Money) Seat #6 is the button
Seat 1: JeBoyDirk (15312 in chips) 
Seat 2: dddocky (8490 in chips) 
Seat 4: Duke Croix (18143 in chips) 
Seat 6: color_singleton (7859 in chips) 
Seat 9: Manon541 (9374 in chips) 
Manon541: posts small blind 50
JeBoyDirk: posts big blind 100
*** HOLE CARDS ***
Dealt to Duke Croix [As Jc]
dddocky: folds 
Duke Croix: raises 300 to 400
color_singleton: folds 
Manon541: folds 
JeBoyDirk: folds 
Uncalled bet (300) returned to Duke Croix
Duke Croix collected 250 from pot
*** SUMMARY ***
Total pot 250 | Rake 0 
Seat 1: JeBoyDirk (big blind) folded before Flop
Seat 2: dddocky folded before Flop (didn't bet)
Seat 4: Duke Croix collected (250)
Seat 6: color_singleton (button) folded before Flop (didn't bet)
Seat 9: Manon541 (small blind) folded before Flop



PokerStars Home Game Hand #217632402704: {Club #3225207}  Hold'em No Limit (50/100) - 2020/08/20 16:03:38 ET
Table 'Manuel Neuer' 9-max (Play Money) Seat #9 is the button
Seat 1: JeBoyDirk (15212 in chips) 
Seat 2: dddocky (8490 in chips) 
Seat 3: RichRick1337 (6655 in chips) 
Seat 4: Duke Croix (18293 in chips) 
Seat 6: color_singleton (7859 in chips) 
Seat 9: Manon541 (9324 in chips) 
JeBoyDirk: posts small blind 50
dddocky: posts big blind 100
RichRick1337: posts small blind 50
*** HOLE CARDS ***
Dealt to Duke Croix [8h 4c]
RichRick1337: folds 
Duke Croix: folds 
color_singleton: raises 200 to 300
Manon541: calls 300
JeBoyDirk: folds 
dddocky: folds 
*** FLOP *** [3c Jd 5h]
color_singleton: bets 378
Manon541: folds 
Uncalled bet (378) returned to color_singleton
color_singleton collected 756 from pot
color_singleton: doesn't show hand 
*** SUMMARY ***
Total pot 800 | Rake 44 
Board [3c Jd 5h]
Seat 1: JeBoyDirk (small blind) folded before Flop
Seat 2: dddocky (big blind) folded before Flop
Seat 3: RichRick1337 folded before Flop (didn't bet)
Seat 4: Duke Croix folded before Flop (didn't bet)
Seat 6: color_singleton collected (756)
Seat 9: Manon541 (button) folded on the Flop



PokerStars Home Game Hand #217632414944: {Club #3225207}  Hold'em No Limit (50/100) - 2020/08/20 16:04:00 ET
Table 'Manuel Neuer' 9-max (Play Money) Seat #1 is the button
Seat 1: JeBoyDirk (15162 in chips) 
Seat 2: dddocky (8390 in chips) 
Seat 3: RichRick1337 (6605 in chips) 
Seat 4: Duke Croix (18293 in chips) 
Seat 6: color_singleton (8315 in chips) 
Seat 9: Manon541 (9024 in chips) 
dddocky: posts small blind 50
RichRick1337: posts big blind 100
*** HOLE CARDS ***
Dealt to Duke Croix [5h 7s]
Duke Croix has timed out
Duke Croix: folds 
color_singleton: folds 
Manon541: calls 100
JeBoyDirk: folds 
dddocky: calls 50
RichRick1337: checks 
*** FLOP *** [4s 8d 4d]
dddocky: bets 283
RichRick1337: raises 283 to 566
Manon541: calls 566
dddocky: calls 283
*** TURN *** [4s 8d 4d] [6s]
dddocky: bets 100
RichRick1337: raises 2088 to 2188
Manon541: folds 
dddocky: folds 
Uncalled bet (2088) returned to RichRick1337
RichRick1337 collected 2077 from pot
RichRick1337: doesn't show hand 
*** SUMMARY ***
Total pot 2198 | Rake 121 
Board [4s 8d 4d 6s]
Seat 1: JeBoyDirk (button) folded before Flop (didn't bet)
Seat 2: dddocky (small blind) folded on the Turn
Seat 3: RichRick1337 (big blind) collected (2077)
Seat 4: Duke Croix folded before Flop (didn't bet)
Seat 6: color_singleton folded before Flop (didn't bet)
Seat 9: Manon541 folded on the Turn



PokerStars Home Game Hand #217632564394: {Club #3225207}  Hold'em No Limit (50/100) - 2020/08/20 16:08:18 ET
Table 'Manuel Neuer' 9-max (Play Money) Seat #6 is the button
Seat 1: JeBoyDirk (14862 in chips) 
Seat 2: dddocky (6663 in chips) 
Seat 3: RichRick1337 (5136 in chips) 
Seat 4: Duke Croix (18293 in chips) 
Seat 6: color_singleton (8115 in chips) 
Seat 9: Manon541 (12200 in chips) 
Manon541: posts small blind 50
JeBoyDirk: posts big blind 100
Duke Croix: posts small & big blinds 150
*** HOLE CARDS ***
Dealt to Duke Croix [9h 2s]
dddocky: calls 100
RichRick1337: calls 100
Duke Croix: checks 
color_singleton: raises 200 to 300
Manon541: calls 250
JeBoyDirk: calls 200
dddocky: calls 200
RichRick1337: calls 200
Duke Croix: calls 200
*** FLOP *** [3s Ts Js]
Manon541: checks 
JeBoyDirk: bets 500
dddocky: folds 
RichRick1337: folds 
Duke Croix: folds 
color_singleton: calls 500
Manon541: folds 
*** TURN *** [3s Ts Js] [5h]
JeBoyDirk: bets 1000
color_singleton: folds 
Uncalled bet (1000) returned to JeBoyDirk
JeBoyDirk collected 2693 from pot
*** SUMMARY ***
Total pot 2850 | Rake 157 
Board [3s Ts Js 5h]
Seat 1: JeBoyDirk (big blind) collected (2693)
Seat 2: dddocky folded on the Flop
Seat 3: RichRick1337 folded on the Flop
Seat 4: Duke Croix folded on the Flop
Seat 6: color_singleton (button) folded on the Turn
Seat 9: Manon541 (small blind) folded on the Flop



PokerStars Home Game Hand #217632603329: {Club #3225207}  Hold'em No Limit (50/100) - 2020/08/20 16:09:24 ET
Table 'Manuel Neuer' 9-max (Play Money) Seat #9 is the button
Seat 1: JeBoyDirk (16755 in chips) 
Seat 2: dddocky (6363 in chips) 
Seat 3: RichRick1337 (4836 in chips) 
Seat 4: Duke Croix (17943 in chips) 
Seat 6: color_singleton (7315 in chips) 
Seat 9: Manon541 (11900 in chips) 
JeBoyDirk: posts small blind 50
dddocky: posts big blind 100
*** HOLE CARDS ***
Dealt to Duke Croix [5s 8s]
RichRick1337: calls 100
Duke Croix: folds 
color_singleton: folds 
Manon541: calls 100
JeBoyDirk: calls 50
dddocky: checks 
*** FLOP *** [4s 6c 9h]
JeBoyDirk: checks 
dddocky: checks 
RichRick1337: checks 
Manon541: checks 
*** TURN *** [4s 6c 9h] [Ks]
JeBoyDirk: checks 
dddocky: checks 
RichRick1337: checks 
Manon541: bets 378
JeBoyDirk: folds 
dddocky: folds 
RichRick1337: folds 
Uncalled bet (378) returned to Manon541
Manon541 collected 378 from pot
*** SUMMARY ***
Total pot 400 | Rake 22 
Board [4s 6c 9h Ks]
Seat 1: JeBoyDirk (small blind) folded on the Turn
Seat 2: dddocky (big blind) folded on the Turn
Seat 3: RichRick1337 folded on the Turn
Seat 4: Duke Croix folded before Flop (didn't bet)
Seat 6: color_singleton folded before Flop (didn't bet)
Seat 9: Manon541 (button) collected (378)



PokerStars Home Game Hand #217632629608: {Club #3225207}  Hold'em No Limit (50/100) - 2020/08/20 16:10:09 ET
Table 'Manuel Neuer' 9-max (Play Money) Seat #1 is the button
Seat 1: JeBoyDirk (16655 in chips) 
Seat 2: dddocky (6263 in chips) 
Seat 3: RichRick1337 (4736 in chips) 
Seat 4: Duke Croix (17943 in chips) 
Seat 6: color_singleton (7315 in chips) 
Seat 9: Manon541 (12178 in chips) 
dddocky: posts small blind 50
RichRick1337: posts big blind 100
*** HOLE CARDS ***
Dealt to Duke Croix [Ad As]
Duke Croix: raises 300 to 400
color_singleton: calls 400
Manon541: calls 400
JeBoyDirk: folds 
dddocky: folds 
RichRick1337: folds 
*** FLOP *** [3d Tc 9c]
Duke Croix: bets 900
color_singleton: raises 900 to 1800
Manon541: folds 
Duke Croix: raises 1200 to 3000
color_singleton: calls 1200
*** TURN *** [3d Tc 9c] [Qc]
Duke Croix: checks 
color_singleton: checks 
*** RIVER *** [3d Tc 9c Qc] [Jh]
Duke Croix: checks 
color_singleton: bets 3473
Duke Croix: folds 
Uncalled bet (3473) returned to color_singleton
color_singleton collected 6946 from pot
color_singleton: doesn't show hand 
*** SUMMARY ***
Total pot 7350 | Rake 404 
Board [3d Tc 9c Qc Jh]
Seat 1: JeBoyDirk (button) folded before Flop (didn't bet)
Seat 2: dddocky (small blind) folded before Flop
Seat 3: RichRick1337 (big blind) folded before Flop
Seat 4: Duke Croix folded on the River
Seat 6: color_singleton collected (6946)
Seat 9: Manon541 folded on the Flop



PokerStars Home Game Hand #217632673563: {Club #3225207}  Hold'em No Limit (50/100) - 2020/08/20 16:11:26 ET
Table 'Manuel Neuer' 9-max (Play Money) Seat #2 is the button
Seat 1: JeBoyDirk (16655 in chips) 
Seat 2: dddocky (6213 in chips) 
Seat 3: RichRick1337 (4636 in chips) 
Seat 4: Duke Croix (14543 in chips) 
Seat 6: color_singleton (10861 in chips) 
Seat 9: Manon541 (11778 in chips) 
RichRick1337: posts small blind 50
Duke Croix: posts big blind 100
*** HOLE CARDS ***
Dealt to Duke Croix [Ah 7c]
color_singleton: folds 
Manon541: calls 100
JeBoyDirk: folds 
dddocky: folds 
RichRick1337: folds 
Duke Croix: checks 
*** FLOP *** [Qc Qs Kc]
Duke Croix: checks 
Manon541: bets 118
Duke Croix: folds 
Uncalled bet (118) returned to Manon541
Manon541 collected 236 from pot
*** SUMMARY ***
Total pot 250 | Rake 14 
Board [Qc Qs Kc]
Seat 1: JeBoyDirk folded before Flop (didn't bet)
Seat 2: dddocky (button) folded before Flop (didn't bet)
Seat 3: RichRick1337 (small blind) folded before Flop
Seat 4: Duke Croix (big blind) folded on the Flop
Seat 6: color_singleton folded before Flop (didn't bet)
Seat 9: Manon541 collected (236)



PokerStars Home Game Hand #217632690055: {Club #3225207}  Hold'em No Limit (50/100) - 2020/08/20 16:11:54 ET
Table 'Manuel Neuer' 9-max (Play Money) Seat #3 is the button
Seat 1: JeBoyDirk (16655 in chips) 
Seat 2: dddocky (6213 in chips) 
Seat 3: RichRick1337 (4586 in chips) 
Seat 4: Duke Croix (14443 in chips) 
Seat 6: color_singleton (10861 in chips) 
Seat 9: Manon541 (11914 in chips) 
Duke Croix: posts small blind 50
color_singleton: posts big blind 100
*** HOLE CARDS ***
Dealt to Duke Croix [5c 6d]
Manon541: folds 
JeBoyDirk: calls 100
dddocky: calls 100
RichRick1337: calls 100
Duke Croix: calls 50
color_singleton: checks 
*** FLOP *** [Ah 5h Ts]
Duke Croix: checks 
color_singleton: checks 
JeBoyDirk: checks 
dddocky: checks 
RichRick1337: checks 
*** TURN *** [Ah 5h Ts] [7h]
Duke Croix: checks 
color_singleton: checks 
JeBoyDirk: checks 
dddocky: checks 
RichRick1337: checks 
*** RIVER *** [Ah 5h Ts 7h] [2s]
Duke Croix: checks 
color_singleton: checks 
JeBoyDirk: checks 
dddocky: checks 
RichRick1337: checks 
*** SHOW DOWN ***
Duke Croix: shows [5c 6d] (a pair of Fives)
color_singleton: mucks hand 
JeBoyDirk: shows [6c 6h] (a pair of Sixes)
dddocky: mucks hand 
RichRick1337: mucks hand 
JeBoyDirk collected 472 from pot
*** SUMMARY ***
Total pot 500 | Rake 28 
Board [Ah 5h Ts 7h 2s]
Seat 1: JeBoyDirk showed [6c 6h] and won (472) with a pair of Sixes
Seat 2: dddocky mucked [2d Qh]
Seat 3: RichRick1337 (button) mucked [9c Qd]
Seat 4: Duke Croix (small blind) showed [5c 6d] and lost with a pair of Fives
Seat 6: color_singleton (big blind) mucked [6s Ks]
Seat 9: Manon541 folded before Flop (didn't bet)



PokerStars Home Game Hand #217632724477: {Club #3225207}  Hold'em No Limit (50/100) - 2020/08/20 16:12:54 ET
Table 'Manuel Neuer' 9-max (Play Money) Seat #4 is the button
Seat 1: JeBoyDirk (17027 in chips) 
Seat 2: dddocky (6113 in chips) 
Seat 3: RichRick1337 (4486 in chips) 
Seat 4: Duke Croix (14343 in chips) 
Seat 6: color_singleton (10761 in chips) 
Seat 9: Manon541 (11914 in chips) 
color_singleton: posts small blind 50
Manon541: posts big blind 100
*** HOLE CARDS ***
Dealt to Duke Croix [8s 7d]
JeBoyDirk: calls 100
dddocky: calls 100
RichRick1337: folds 
Duke Croix: calls 100
color_singleton: calls 50
Manon541: checks 
*** FLOP *** [7c 3d Qd]
color_singleton: checks 
Manon541: checks 
JeBoyDirk: checks 
dddocky: checks 
Duke Croix: checks 
*** TURN *** [7c 3d Qd] [9d]
color_singleton: checks 
Manon541: checks 
JeBoyDirk: checks 
dddocky: checks 
Duke Croix: bets 300
color_singleton: folds 
Manon541: folds 
JeBoyDirk: folds 
dddocky: folds 
Uncalled bet (300) returned to Duke Croix
Duke Croix collected 472 from pot
*** SUMMARY ***
Total pot 500 | Rake 28 
Board [7c 3d Qd 9d]
Seat 1: JeBoyDirk folded on the Turn
Seat 2: dddocky folded on the Turn
Seat 3: RichRick1337 folded before Flop (didn't bet)
Seat 4: Duke Croix (button) collected (472)
Seat 6: color_singleton (small blind) folded on the Turn
Seat 9: Manon541 (big blind) folded on the Turn



PokerStars Home Game Hand #217632768265: {Club #3225207}  Hold'em No Limit (50/100) - 2020/08/20 16:14:10 ET
Table 'Manuel Neuer' 9-max (Play Money) Seat #6 is the button
Seat 1: JeBoyDirk (16927 in chips) 
Seat 2: dddocky (6013 in chips) 
Seat 3: RichRick1337 (4486 in chips) 
Seat 4: Duke Croix (14715 in chips) 
Seat 6: color_singleton (10661 in chips) 
Seat 9: Manon541 (11814 in chips) 
Manon541: posts small blind 50
JeBoyDirk: posts big blind 100
*** HOLE CARDS ***
Dealt to Duke Croix [6c Js]
dddocky: folds 
RichRick1337: calls 100
Duke Croix: folds 
color_singleton: calls 100
Manon541: calls 50
JeBoyDirk: checks 
*** FLOP *** [7h Ah 5d]
Manon541: checks 
JeBoyDirk: checks 
RichRick1337: checks 
color_singleton: checks 
*** TURN *** [7h Ah 5d] [Ac]
Manon541: bets 189
JeBoyDirk: folds 
RichRick1337: folds 
color_singleton: folds 
Uncalled bet (189) returned to Manon541
Manon541 collected 378 from pot
*** SUMMARY ***
Total pot 400 | Rake 22 
Board [7h Ah 5d Ac]
Seat 1: JeBoyDirk (big blind) folded on the Turn
Seat 2: dddocky folded before Flop (didn't bet)
Seat 3: RichRick1337 folded on the Turn
Seat 4: Duke Croix folded before Flop (didn't bet)
Seat 6: color_singleton (button) folded on the Turn
Seat 9: Manon541 (small blind) collected (378)



PokerStars Home Game Hand #217632796144: {Club #3225207}  Hold'em No Limit (50/100) - 2020/08/20 16:14:52 ET
Table 'Manuel Neuer' 9-max (Play Money) Seat #9 is the button
Seat 1: JeBoyDirk (16827 in chips) 
Seat 2: dddocky (6013 in chips) 
Seat 3: RichRick1337 (4386 in chips) 
Seat 4: Duke Croix (14715 in chips) 
Seat 6: color_singleton (10561 in chips) 
Seat 9: Manon541 (12092 in chips) 
JeBoyDirk: posts small blind 50
dddocky: posts big blind 100
*** HOLE CARDS ***
Dealt to Duke Croix [3d 6h]
RichRick1337: calls 100
Duke Croix: folds 
color_singleton: raises 100 to 200
Manon541: calls 200
JeBoyDirk: folds 
dddocky: folds 
RichRick1337: folds 
*** FLOP *** [Js 8s Kd]
color_singleton: bets 307
Manon541: calls 307
*** TURN *** [Js 8s Kd] [8h]
color_singleton: bets 597
Manon541: folds 
Uncalled bet (597) returned to color_singleton
color_singleton collected 1194 from pot
color_singleton: doesn't show hand 
*** SUMMARY ***
Total pot 1264 | Rake 70 
Board [Js 8s Kd 8h]
Seat 1: JeBoyDirk (small blind) folded before Flop
Seat 2: dddocky (big blind) folded before Flop
Seat 3: RichRick1337 folded before Flop
Seat 4: Duke Croix folded before Flop (didn't bet)
Seat 6: color_singleton collected (1194)
Seat 9: Manon541 (button) folded on the Turn



PokerStars Home Game Hand #217632819045: {Club #3225207}  Hold'em No Limit (50/100) - 2020/08/20 16:15:31 ET
Table 'Manuel Neuer' 9-max (Play Money) Seat #1 is the button
Seat 1: JeBoyDirk (16777 in chips) 
Seat 2: dddocky (5913 in chips) 
Seat 3: RichRick1337 (4286 in chips) 
Seat 4: Duke Croix (14715 in chips) 
Seat 6: color_singleton (11248 in chips) 
Seat 9: Manon541 (11585 in chips) 
dddocky: posts small blind 50
RichRick1337: posts big blind 100
*** HOLE CARDS ***
Dealt to Duke Croix [Qd 8c]
Duke Croix: folds 
color_singleton: raises 200 to 300
Manon541: folds 
JeBoyDirk: folds 
dddocky: folds 
RichRick1337: folds 
Uncalled bet (200) returned to color_singleton
color_singleton collected 250 from pot
color_singleton: doesn't show hand 
*** SUMMARY ***
Total pot 250 | Rake 0 
Seat 1: JeBoyDirk (button) folded before Flop (didn't bet)
Seat 2: dddocky (small blind) folded before Flop
Seat 3: RichRick1337 (big blind) folded before Flop
Seat 4: Duke Croix folded before Flop (didn't bet)
Seat 6: color_singleton collected (250)
Seat 9: Manon541 folded before Flop (didn't bet)



PokerStars Home Game Hand #217632838323: {Club #3225207}  Hold'em No Limit (50/100) - 2020/08/20 16:16:04 ET
Table 'Manuel Neuer' 9-max (Play Money) Seat #2 is the button
Seat 1: JeBoyDirk (16777 in chips) 
Seat 2: dddocky (5863 in chips) 
Seat 3: RichRick1337 (4186 in chips) 
Seat 4: Duke Croix (14715 in chips) 
Seat 6: color_singleton (11398 in chips) 
Seat 9: Manon541 (11585 in chips) 
RichRick1337: posts small blind 50
Duke Croix: posts big blind 100
*** HOLE CARDS ***
Dealt to Duke Croix [Jd Kd]
color_singleton: folds 
Manon541: folds 
JeBoyDirk: folds 
dddocky: folds 
RichRick1337: calls 50
Duke Croix: raises 400 to 500
RichRick1337: folds 
Uncalled bet (400) returned to Duke Croix
Duke Croix collected 200 from pot
*** SUMMARY ***
Total pot 200 | Rake 0 
Seat 1: JeBoyDirk folded before Flop (didn't bet)
Seat 2: dddocky (button) folded before Flop (didn't bet)
Seat 3: RichRick1337 (small blind) folded before Flop
Seat 4: Duke Croix (big blind) collected (200)
Seat 6: color_singleton folded before Flop (didn't bet)
Seat 9: Manon541 folded before Flop (didn't bet)



PokerStars Home Game Hand #217632855238: {Club #3225207}  Hold'em No Limit (50/100) - 2020/08/20 16:16:32 ET
Table 'Manuel Neuer' 9-max (Play Money) Seat #3 is the button
Seat 1: JeBoyDirk (16777 in chips) 
Seat 2: dddocky (5863 in chips) 
Seat 3: RichRick1337 (4086 in chips) 
Seat 4: Duke Croix (14815 in chips) 
Seat 6: color_singleton (11398 in chips) 
Seat 9: Manon541 (11585 in chips) 
Duke Croix: posts small blind 50
color_singleton: posts big blind 100
*** HOLE CARDS ***
Dealt to Duke Croix [7h Jd]
Manon541: calls 100
JeBoyDirk: folds 
dddocky: calls 100
RichRick1337: calls 100
Duke Croix: calls 50
color_singleton: raises 100 to 200
Manon541: calls 100
dddocky: calls 100
RichRick1337: calls 100
Duke Croix: calls 100
*** FLOP *** [Jc 6d 3h]
Duke Croix: bets 400
color_singleton: calls 400
Manon541: folds 
dddocky: folds 
RichRick1337: folds 
*** TURN *** [Jc 6d 3h] [8h]
Duke Croix: bets 900
color_singleton: folds 
Uncalled bet (900) returned to Duke Croix
Duke Croix collected 1701 from pot
*** SUMMARY ***
Total pot 1800 | Rake 99 
Board [Jc 6d 3h 8h]
Seat 1: JeBoyDirk folded before Flop (didn't bet)
Seat 2: dddocky folded on the Flop
Seat 3: RichRick1337 (button) folded on the Flop
Seat 4: Duke Croix (small blind) collected (1701)
Seat 6: color_singleton (big blind) folded on the Turn
Seat 9: Manon541 folded on the Flop



PokerStars Home Game Hand #217632882896: {Club #3225207}  Hold'em No Limit (50/100) - 2020/08/20 16:17:19 ET
Table 'Manuel Neuer' 9-max (Play Money) Seat #4 is the button
Seat 1: JeBoyDirk (16777 in chips) 
Seat 2: dddocky (5663 in chips) 
Seat 3: RichRick1337 (3886 in chips) 
Seat 4: Duke Croix (15916 in chips) 
Seat 6: color_singleton (10798 in chips) 
Seat 9: Manon541 (11385 in chips) 
color_singleton: posts small blind 50
Manon541: posts big blind 100
*** HOLE CARDS ***
Dealt to Duke Croix [Qc Kd]
JeBoyDirk: raises 200 to 300
dddocky: folds 
RichRick1337: folds 
Duke Croix: calls 300
color_singleton: folds 
Manon541: folds 
*** FLOP *** [7h 5h 9d]
JeBoyDirk: bets 600
Duke Croix: folds 
Uncalled bet (600) returned to JeBoyDirk
JeBoyDirk collected 709 from pot
*** SUMMARY ***
Total pot 750 | Rake 41 
Board [7h 5h 9d]
Seat 1: JeBoyDirk collected (709)
Seat 2: dddocky folded before Flop (didn't bet)
Seat 3: RichRick1337 folded before Flop (didn't bet)
Seat 4: Duke Croix (button) folded on the Flop
Seat 6: color_singleton (small blind) folded before Flop
Seat 9: Manon541 (big blind) folded before Flop



PokerStars Home Game Hand #217632903031: {Club #3225207}  Hold'em No Limit (50/100) - 2020/08/20 16:17:53 ET
Table 'Manuel Neuer' 9-max (Play Money) Seat #6 is the button
Seat 1: JeBoyDirk (17186 in chips) 
Seat 2: dddocky (5663 in chips) 
Seat 3: RichRick1337 (3886 in chips) 
Seat 4: Duke Croix (15616 in chips) 
Seat 6: color_singleton (10748 in chips) 
Seat 9: Manon541 (11285 in chips) 
Manon541: posts small blind 50
JeBoyDirk: posts big blind 100
*** HOLE CARDS ***
Dealt to Duke Croix [Tc 9h]
dddocky: calls 100
RichRick1337: calls 100
Duke Croix: calls 100
color_singleton: raises 100 to 200
Manon541: calls 150
JeBoyDirk: calls 100
dddocky: calls 100
RichRick1337: calls 100
Duke Croix: calls 100
*** FLOP *** [5s Ts Qs]
Manon541: bets 567
JeBoyDirk: calls 567
dddocky: folds 
RichRick1337: calls 567
Duke Croix: folds 
color_singleton: folds 
*** TURN *** [5s Ts Qs] [Js]
Manon541: checks 
JeBoyDirk: checks 
RichRick1337: checks 
*** RIVER *** [5s Ts Qs Js] [8d]
Manon541: bets 2741
JeBoyDirk: raises 13341 to 16082
RichRick1337: folds 
Manon541: folds 
Uncalled bet (13341) returned to JeBoyDirk
JeBoyDirk collected 7922 from pot
*** SUMMARY ***
Total pot 8383 | Rake 461 
Board [5s Ts Qs Js 8d]
Seat 1: JeBoyDirk (big blind) collected (7922)
Seat 2: dddocky folded on the Flop
Seat 3: RichRick1337 folded on the River
Seat 4: Duke Croix folded on the Flop
Seat 6: color_singleton (button) folded on the Flop
Seat 9: Manon541 (small blind) folded on the River



PokerStars Home Game Hand #217632973423: {Club #3225207}  Hold'em No Limit (50/100) - 2020/08/20 16:19:50 ET
Table 'Manuel Neuer' 9-max (Play Money) Seat #9 is the button
Seat 1: JeBoyDirk (21600 in chips) 
Seat 2: dddocky (5463 in chips) 
Seat 3: RichRick1337 (3119 in chips) 
Seat 4: Duke Croix (15416 in chips) 
Seat 6: color_singleton (10548 in chips) 
Seat 9: Manon541 (7777 in chips) 
JeBoyDirk: posts small blind 50
dddocky: posts big blind 100
*** HOLE CARDS ***
Dealt to Duke Croix [Tc Ts]
RichRick1337: calls 100
Duke Croix: raises 300 to 400
color_singleton: calls 400
Manon541: folds 
JeBoyDirk: folds 
dddocky: folds 
RichRick1337: calls 300
*** FLOP *** [Qs 7s 2c]
RichRick1337: checks 
Duke Croix: checks 
color_singleton: checks 
*** TURN *** [Qs 7s 2c] [2h]
RichRick1337: bets 638
Duke Croix: folds 
color_singleton: folds 
Uncalled bet (638) returned to RichRick1337
RichRick1337 collected 1276 from pot
RichRick1337: doesn't show hand 
*** SUMMARY ***
Total pot 1350 | Rake 74 
Board [Qs 7s 2c 2h]
Seat 1: JeBoyDirk (small blind) folded before Flop
Seat 2: dddocky (big blind) folded before Flop
Seat 3: RichRick1337 collected (1276)
Seat 4: Duke Croix folded on the Turn
Seat 6: color_singleton folded on the Turn
Seat 9: Manon541 (button) folded before Flop (didn't bet)



PokerStars Home Game Hand #217633002491: {Club #3225207}  Hold'em No Limit (50/100) - 2020/08/20 16:20:39 ET
Table 'Manuel Neuer' 9-max (Play Money) Seat #1 is the button
Seat 1: JeBoyDirk (21550 in chips) 
Seat 2: dddocky (5363 in chips) 
Seat 3: RichRick1337 (3995 in chips) 
Seat 4: Duke Croix (15016 in chips) 
Seat 6: color_singleton (10148 in chips) 
Seat 9: Manon541 (7777 in chips) 
dddocky: posts small blind 50
RichRick1337: posts big blind 100
*** HOLE CARDS ***
Dealt to Duke Croix [3d Kh]
Duke Croix: folds 
color_singleton: raises 200 to 300
Manon541: folds 
JeBoyDirk: folds 
dddocky: calls 250
RichRick1337: calls 200
*** FLOP *** [8c 5h Qd]
dddocky: checks 
RichRick1337: checks 
color_singleton: bets 425
dddocky: folds 
RichRick1337: calls 425
*** TURN *** [8c 5h Qd] [Kd]
RichRick1337: checks 
color_singleton: checks 
*** RIVER *** [8c 5h Qd Kd] [5d]
RichRick1337: checks 
color_singleton: checks 
*** SHOW DOWN ***
RichRick1337: shows [Ac 2c] (a pair of Fives)
color_singleton: shows [Jc Jd] (two pair, Jacks and Fives)
color_singleton collected 1654 from pot
*** SUMMARY ***
Total pot 1750 | Rake 96 
Board [8c 5h Qd Kd 5d]
Seat 1: JeBoyDirk (button) folded before Flop (didn't bet)
Seat 2: dddocky (small blind) folded on the Flop
Seat 3: RichRick1337 (big blind) showed [Ac 2c] and lost with a pair of Fives
Seat 4: Duke Croix folded before Flop (didn't bet)
Seat 6: color_singleton showed [Jc Jd] and won (1654) with two pair, Jacks and Fives
Seat 9: Manon541 folded before Flop (didn't bet)



PokerStars Home Game Hand #217633033872: {Club #3225207}  Hold'em No Limit (50/100) - 2020/08/20 16:21:19 ET
Table 'Manuel Neuer' 9-max (Play Money) Seat #2 is the button
Seat 1: JeBoyDirk (21550 in chips) 
Seat 2: dddocky (5063 in chips) 
Seat 3: RichRick1337 (3270 in chips) 
Seat 4: Duke Croix (15016 in chips) 
Seat 6: color_singleton (11077 in chips) 
Seat 9: Manon541 (7777 in chips) 
RichRick1337: posts small blind 50
Duke Croix: posts big blind 100
*** HOLE CARDS ***
Dealt to Duke Croix [Jh 3s]
color_singleton: raises 200 to 300
Manon541: calls 300
JeBoyDirk: calls 300
dddocky: folds 
RichRick1337: calls 250
Duke Croix: folds 
*** FLOP *** [9c 2c Jd]
RichRick1337: bets 100
color_singleton: calls 100
Manon541: calls 100
JeBoyDirk: calls 100
*** TURN *** [9c 2c Jd] [7c]
RichRick1337: bets 100
color_singleton: calls 100
Manon541: folds 
JeBoyDirk: calls 100
*** RIVER *** [9c 2c Jd 7c] [Kh]
RichRick1337: bets 100
color_singleton: raises 1045 to 1145
JeBoyDirk: calls 1145
RichRick1337: folds 
*** SHOW DOWN ***
color_singleton: shows [Qd Kd] (a pair of Kings)
JeBoyDirk: shows [Ks Ac] (a pair of Kings - Ace kicker)
JeBoyDirk collected 4149 from pot
*** SUMMARY ***
Total pot 4390 | Rake 241 
Board [9c 2c Jd 7c Kh]
Seat 1: JeBoyDirk showed [Ks Ac] and won (4149) with a pair of Kings
Seat 2: dddocky (button) folded before Flop (didn't bet)
Seat 3: RichRick1337 (small blind) folded on the River
Seat 4: Duke Croix (big blind) folded before Flop
Seat 6: color_singleton showed [Qd Kd] and lost with a pair of Kings
Seat 9: Manon541 folded on the Turn



PokerStars Home Game Hand #217633069101: {Club #3225207}  Hold'em No Limit (50/100) - 2020/08/20 16:22:18 ET
Table 'Manuel Neuer' 9-max (Play Money) Seat #3 is the button
Seat 1: JeBoyDirk (24054 in chips) 
Seat 2: dddocky (5063 in chips) 
Seat 3: RichRick1337 (2670 in chips) 
Seat 4: Duke Croix (14916 in chips) 
Seat 6: color_singleton (9432 in chips) 
Seat 9: Manon541 (7377 in chips) 
Duke Croix: posts small blind 50
color_singleton: posts big blind 100
*** HOLE CARDS ***
Dealt to Duke Croix [8c 9h]
Manon541: folds 
JeBoyDirk: calls 100
dddocky: calls 100
RichRick1337: calls 100
Duke Croix: calls 50
color_singleton: checks 
*** FLOP *** [4c 3c Jh]
Duke Croix: checks 
color_singleton: bets 236
JeBoyDirk: folds 
dddocky: calls 236
RichRick1337: folds 
Duke Croix: folds 
*** TURN *** [4c 3c Jh] [Qs]
color_singleton: checks 
dddocky: checks 
*** RIVER *** [4c 3c Jh Qs] [5h]
color_singleton: bets 459
dddocky: folds 
Uncalled bet (459) returned to color_singleton
color_singleton collected 919 from pot
color_singleton: doesn't show hand 
*** SUMMARY ***
Total pot 972 | Rake 53 
Board [4c 3c Jh Qs 5h]
Seat 1: JeBoyDirk folded on the Flop
Seat 2: dddocky folded on the River
Seat 3: RichRick1337 (button) folded on the Flop
Seat 4: Duke Croix (small blind) folded on the Flop
Seat 6: color_singleton (big blind) collected (919)
Seat 9: Manon541 folded before Flop (didn't bet)



PokerStars Home Game Hand #217633097212: {Club #3225207}  Hold'em No Limit (50/100) - 2020/08/20 16:23:05 ET
Table 'Manuel Neuer' 9-max (Play Money) Seat #4 is the button
Seat 1: JeBoyDirk (23954 in chips) 
Seat 2: dddocky (4727 in chips) 
Seat 3: RichRick1337 (2570 in chips) 
Seat 4: Duke Croix (14816 in chips) 
Seat 6: color_singleton (10015 in chips) 
Seat 9: Manon541 (7377 in chips) 
color_singleton: posts small blind 50
Manon541: posts big blind 100
*** HOLE CARDS ***
Dealt to Duke Croix [Ac Ts]
JeBoyDirk: calls 100
dddocky: calls 100
RichRick1337: raises 100 to 200
Duke Croix: raises 300 to 500
color_singleton: folds 
Manon541: folds 
JeBoyDirk: calls 400
dddocky: folds 
RichRick1337: calls 300
*** FLOP *** [Qc 2s Td]
JeBoyDirk: checks 
RichRick1337: checks 
Duke Croix: bets 1000
JeBoyDirk: folds 
RichRick1337: calls 1000
*** TURN *** [Qc 2s Td] [4c]
RichRick1337: bets 100
Duke Croix: raises 1872 to 1972
RichRick1337: calls 970 and is all-in
Uncalled bet (902) returned to Duke Croix
*** RIVER *** [Qc 2s Td 4c] [8c]
*** SHOW DOWN ***
RichRick1337: shows [Jh Jc] (a pair of Jacks)
Duke Croix: shows [Ac Ts] (a pair of Tens)
RichRick1337 collected 5566 from pot
*** SUMMARY ***
Total pot 5890 | Rake 324 
Board [Qc 2s Td 4c 8c]
Seat 1: JeBoyDirk folded on the Flop
Seat 2: dddocky folded before Flop
Seat 3: RichRick1337 showed [Jh Jc] and won (5566) with a pair of Jacks
Seat 4: Duke Croix (button) showed [Ac Ts] and lost with a pair of Tens
Seat 6: color_singleton (small blind) folded before Flop
Seat 9: Manon541 (big blind) folded before Flop



PokerStars Home Game Hand #217633129581: {Club #3225207}  Hold'em No Limit (50/100) - 2020/08/20 16:24:00 ET
Table 'Manuel Neuer' 9-max (Play Money) Seat #6 is the button
Seat 1: JeBoyDirk (23454 in chips) 
Seat 2: dddocky (4627 in chips) 
Seat 3: RichRick1337 (5566 in chips) 
Seat 4: Duke Croix (12246 in chips) 
Seat 6: color_singleton (9965 in chips) 
Seat 9: Manon541 (7277 in chips) 
Manon541: posts small blind 50
JeBoyDirk: posts big blind 100
*** HOLE CARDS ***
Dealt to Duke Croix [Th 8d]
dddocky: folds 
RichRick1337: calls 100
Duke Croix: folds 
color_singleton: folds 
Manon541: calls 50
JeBoyDirk: checks 
*** FLOP *** [8c 3c Kh]
Manon541: checks 
JeBoyDirk: checks 
RichRick1337: checks 
*** TURN *** [8c 3c Kh] [5d]
Manon541: checks 
JeBoyDirk: checks 
RichRick1337: checks 
*** RIVER *** [8c 3c Kh 5d] [2h]
Manon541: checks 
JeBoyDirk: checks 
RichRick1337: checks 
*** SHOW DOWN ***
Manon541: shows [3d 6d] (a pair of Threes)
JeBoyDirk: mucks hand 
RichRick1337: mucks hand 
Manon541 collected 283 from pot
*** SUMMARY ***
Total pot 300 | Rake 17 
Board [8c 3c Kh 5d 2h]
Seat 1: JeBoyDirk (big blind) mucked [Qs 7c]
Seat 2: dddocky folded before Flop (didn't bet)
Seat 3: RichRick1337 mucked [Tc 6h]
Seat 4: Duke Croix folded before Flop (didn't bet)
Seat 6: color_singleton (button) folded before Flop (didn't bet)
Seat 9: Manon541 (small blind) showed [3d 6d] and won (283) with a pair of Threes



PokerStars Home Game Hand #217633154938: {Club #3225207}  Hold'em No Limit (50/100) - 2020/08/20 16:24:42 ET
Table 'Manuel Neuer' 9-max (Play Money) Seat #9 is the button
Seat 1: JeBoyDirk (23354 in chips) 
Seat 2: dddocky (4627 in chips) 
Seat 3: RichRick1337 (5466 in chips) 
Seat 4: Duke Croix (12246 in chips) 
Seat 6: color_singleton (9965 in chips) 
Seat 9: Manon541 (7460 in chips) 
JeBoyDirk: posts small blind 50
dddocky: posts big blind 100
*** HOLE CARDS ***
Dealt to Duke Croix [Jh Tc]
RichRick1337: calls 100
Duke Croix: raises 300 to 400
color_singleton: calls 400
Manon541: folds 
JeBoyDirk: folds 
dddocky: calls 300
RichRick1337: calls 300
*** FLOP *** [6c 5h Qd]
dddocky: checks 
RichRick1337: checks 
Duke Croix: checks 
color_singleton: checks 
*** TURN *** [6c 5h Qd] [Kh]
dddocky: bets 100
RichRick1337: calls 100
Duke Croix: calls 100
color_singleton: raises 700 to 800
dddocky: calls 700
RichRick1337: folds 
Duke Croix: calls 700
*** RIVER *** [6c 5h Qd Kh] [3h]
dddocky: checks 
Duke Croix: checks 
color_singleton: bets 1961
dddocky: folds 
Duke Croix: folds 
Uncalled bet (1961) returned to color_singleton
color_singleton collected 3922 from pot
color_singleton: doesn't show hand 
*** SUMMARY ***
Total pot 4150 | Rake 228 
Board [6c 5h Qd Kh 3h]
Seat 1: JeBoyDirk (small blind) folded before Flop
Seat 2: dddocky (big blind) folded on the River
Seat 3: RichRick1337 folded on the Turn
Seat 4: Duke Croix folded on the River
Seat 6: color_singleton collected (3922)
Seat 9: Manon541 (button) folded before Flop (didn't bet)



PokerStars Home Game Hand #217633193760: {Club #3225207}  Hold'em No Limit (50/100) - 2020/08/20 16:25:47 ET
Table 'Manuel Neuer' 9-max (Play Money) Seat #1 is the button
Seat 1: JeBoyDirk (23304 in chips) 
Seat 2: dddocky (3427 in chips) 
Seat 3: RichRick1337 (4966 in chips) 
Seat 4: Duke Croix (11046 in chips) 
Seat 6: color_singleton (12687 in chips) 
Seat 9: Manon541 (7460 in chips) 
dddocky: posts small blind 50
RichRick1337: posts big blind 100
*** HOLE CARDS ***
Dealt to Duke Croix [7s Qd]
Duke Croix: calls 100
color_singleton: folds 
Manon541: calls 100
JeBoyDirk: calls 100
dddocky: raises 100 to 200
RichRick1337: calls 100
Duke Croix: calls 100
Manon541: calls 100
JeBoyDirk: calls 100
*** FLOP *** [Kh 7c Qh]
dddocky: checks 
RichRick1337: bets 100
Duke Croix: raises 400 to 500
Manon541: folds 
JeBoyDirk: calls 500
dddocky: folds 
RichRick1337: calls 400
*** TURN *** [Kh 7c Qh] [Jc]
RichRick1337: bets 100
Duke Croix: calls 100
JeBoyDirk: calls 100
*** RIVER *** [Kh 7c Qh Jc] [5c]
RichRick1337: bets 100
Duke Croix: raises 900 to 1000
JeBoyDirk: folds 
RichRick1337: calls 900
*** SHOW DOWN ***
Duke Croix: shows [7s Qd] (two pair, Queens and Sevens)
RichRick1337: mucks hand 
Duke Croix collected 4536 from pot
*** SUMMARY ***
Total pot 4800 | Rake 264 
Board [Kh 7c Qh Jc 5c]
Seat 1: JeBoyDirk (button) folded on the River
Seat 2: dddocky (small blind) folded on the Flop
Seat 3: RichRick1337 (big blind) mucked [6s Kd]
Seat 4: Duke Croix showed [7s Qd] and won (4536) with two pair, Queens and Sevens
Seat 6: color_singleton folded before Flop (didn't bet)
Seat 9: Manon541 folded on the Flop



PokerStars Home Game Hand #217633222400: {Club #3225207}  Hold'em No Limit (50/100) - 2020/08/20 16:26:36 ET
Table 'Manuel Neuer' 9-max (Play Money) Seat #2 is the button
Seat 1: JeBoyDirk (22504 in chips) 
Seat 2: dddocky (3227 in chips) 
Seat 3: RichRick1337 (3166 in chips) 
Seat 4: Duke Croix (13782 in chips) 
Seat 6: color_singleton (12687 in chips) 
Seat 9: Manon541 (7260 in chips) 
RichRick1337: posts small blind 50
Duke Croix: posts big blind 100
*** HOLE CARDS ***
Dealt to Duke Croix [6c 3h]
color_singleton: folds 
Manon541: calls 100
JeBoyDirk: folds 
dddocky: folds 
RichRick1337: calls 50
Duke Croix: checks 
*** FLOP *** [5d Kh 9h]
RichRick1337: checks 
Duke Croix: checks 
Manon541: checks 
*** TURN *** [5d Kh 9h] [Kc]
RichRick1337: checks 
Duke Croix: checks 
Manon541: checks 
*** RIVER *** [5d Kh 9h Kc] [Ks]
RichRick1337: checks 
Duke Croix: checks 
Manon541: checks 
*** SHOW DOWN ***
RichRick1337: shows [8d 6d] (three of a kind, Kings)
Duke Croix: mucks hand 
Manon541: shows [Qs 7d] (three of a kind, Kings - Queen kicker)
Manon541 collected 283 from pot
*** SUMMARY ***
Total pot 300 | Rake 17 
Board [5d Kh 9h Kc Ks]
Seat 1: JeBoyDirk folded before Flop (didn't bet)
Seat 2: dddocky (button) folded before Flop (didn't bet)
Seat 3: RichRick1337 (small blind) showed [8d 6d] and lost with three of a kind, Kings
Seat 4: Duke Croix (big blind) mucked [6c 3h]
Seat 6: color_singleton folded before Flop (didn't bet)
Seat 9: Manon541 showed [Qs 7d] and won (283) with three of a kind, Kings



PokerStars Home Game Hand #217633244740: {Club #3225207}  Hold'em No Limit (50/100) - 2020/08/20 16:27:11 ET
Table 'Manuel Neuer' 9-max (Play Money) Seat #3 is the button
Seat 1: JeBoyDirk (22504 in chips) 
Seat 2: dddocky (3227 in chips) 
Seat 3: RichRick1337 (3066 in chips) 
Seat 4: Duke Croix (13682 in chips) 
Seat 6: color_singleton (12687 in chips) 
Seat 9: Manon541 (7443 in chips) 
Duke Croix: posts small blind 50
color_singleton: posts big blind 100
*** HOLE CARDS ***
Dealt to Duke Croix [4d 7s]
Manon541: calls 100
JeBoyDirk: raises 100 to 200
dddocky: calls 200
RichRick1337: calls 200
Duke Croix: folds 
color_singleton: calls 100
Manon541 has timed out
Manon541: folds 
*** FLOP *** [8s 2d 6s]
color_singleton: bets 449
JeBoyDirk: folds 
dddocky: calls 449
RichRick1337: folds 
*** TURN *** [8s 2d 6s] [As]
color_singleton: bets 1746
dddocky: calls 1746
*** RIVER *** [8s 2d 6s As] [2h]
color_singleton: bets 5046
dddocky: calls 832 and is all-in
Uncalled bet (4214) returned to color_singleton
*** SHOW DOWN ***
color_singleton: shows [4s Js] (a flush, Ace high)
dddocky: shows [6d 6h] (a full house, Sixes full of Deuces)
dddocky collected 6619 from pot
*** SUMMARY ***
Total pot 7004 | Rake 385 
Board [8s 2d 6s As 2h]
Seat 1: JeBoyDirk folded on the Flop
Seat 2: dddocky showed [6d 6h] and won (6619) with a full house, Sixes full of Deuces
Seat 3: RichRick1337 (button) folded on the Flop
Seat 4: Duke Croix (small blind) folded before Flop
Seat 6: color_singleton (big blind) showed [4s Js] and lost with a flush, Ace high
Seat 9: Manon541 folded before Flop



PokerStars Home Game Hand #217633288356: {Club #3225207}  Hold'em No Limit (50/100) - 2020/08/20 16:28:24 ET
Table 'Manuel Neuer' 9-max (Play Money) Seat #4 is the button
Seat 1: JeBoyDirk (22304 in chips) 
Seat 2: dddocky (6619 in chips) 
Seat 3: RichRick1337 (2866 in chips) 
Seat 4: Duke Croix (13632 in chips) 
Seat 6: color_singleton (9460 in chips) 
Seat 9: Manon541 (7343 in chips) 
color_singleton: posts small blind 50
Manon541: posts big blind 100
*** HOLE CARDS ***
Dealt to Duke Croix [Td 6h]
JeBoyDirk: calls 100
dddocky: folds 
RichRick1337: calls 100
Duke Croix: folds 
color_singleton: calls 50
Manon541: checks 
*** FLOP *** [8d 7c 3c]
color_singleton: checks 
Manon541: checks 
JeBoyDirk: checks 
RichRick1337: checks 
*** TURN *** [8d 7c 3c] [Tc]
color_singleton: bets 189
Manon541: folds 
JeBoyDirk: folds 
RichRick1337: calls 189
*** RIVER *** [8d 7c 3c Tc] [3h]
color_singleton: bets 500
RichRick1337: folds 
Uncalled bet (500) returned to color_singleton
color_singleton collected 735 from pot
color_singleton: doesn't show hand 
*** SUMMARY ***
Total pot 778 | Rake 43 
Board [8d 7c 3c Tc 3h]
Seat 1: JeBoyDirk folded on the Turn
Seat 2: dddocky folded before Flop (didn't bet)
Seat 3: RichRick1337 folded on the River
Seat 4: Duke Croix (button) folded before Flop (didn't bet)
Seat 6: color_singleton (small blind) collected (735)
Seat 9: Manon541 (big blind) folded on the Turn



PokerStars Home Game Hand #217633322245: {Club #3225207}  Hold'em No Limit (50/100) - 2020/08/20 16:29:22 ET
Table 'Manuel Neuer' 9-max (Play Money) Seat #6 is the button
Seat 1: JeBoyDirk (22204 in chips) 
Seat 2: dddocky (6619 in chips) 
Seat 3: RichRick1337 (2577 in chips) 
Seat 4: Duke Croix (13632 in chips) 
Seat 6: color_singleton (9906 in chips) 
Seat 9: Manon541 (7243 in chips) 
Manon541: posts small blind 50
JeBoyDirk: posts big blind 100
*** HOLE CARDS ***
Dealt to Duke Croix [7c 4c]
dddocky: calls 100
RichRick1337: calls 100
Duke Croix: folds 
color_singleton: raises 200 to 300
Manon541: folds 
JeBoyDirk has timed out
JeBoyDirk: folds 
dddocky: calls 200
RichRick1337: folds 
*** FLOP *** [Kc 8s Jh]
dddocky: checks 
color_singleton: checks 
*** TURN *** [Kc 8s Jh] [6s]
dddocky: checks 
color_singleton: checks 
*** RIVER *** [Kc 8s Jh 6s] [3d]
dddocky: checks 
color_singleton: checks 
*** SHOW DOWN ***
dddocky: shows [2c 9c] (high card King)
color_singleton: shows [Ah 5s] (high card Ace)
color_singleton collected 803 from pot
*** SUMMARY ***
Total pot 850 | Rake 47 
Board [Kc 8s Jh 6s 3d]
Seat 1: JeBoyDirk (big blind) folded before Flop
Seat 2: dddocky showed [2c 9c] and lost with high card King
Seat 3: RichRick1337 folded before Flop
Seat 4: Duke Croix folded before Flop (didn't bet)
Seat 6: color_singleton (button) showed [Ah 5s] and won (803) with high card Ace
Seat 9: Manon541 (small blind) folded before Flop



PokerStars Home Game Hand #217633348120: {Club #3225207}  Hold'em No Limit (50/100) - 2020/08/20 16:30:06 ET
Table 'Manuel Neuer' 9-max (Play Money) Seat #2 is the button
Seat 2: dddocky (6319 in chips) 
Seat 3: RichRick1337 (2477 in chips) 
Seat 4: Duke Croix (13632 in chips) 
Seat 6: color_singleton (10409 in chips) 
RichRick1337: posts small blind 50
Duke Croix: posts big blind 100
*** HOLE CARDS ***
Dealt to Duke Croix [4d 2h]
color_singleton: raises 200 to 300
dddocky: folds 
RichRick1337: calls 250
Duke Croix: folds 
*** FLOP *** [Qs 2d Td]
Duke Croix said, "(violin)"
RichRick1337: bets 100
color_singleton: calls 100
*** TURN *** [Qs 2d Td] [Kd]
RichRick1337: bets 100
color_singleton: raises 300 to 400
RichRick1337: calls 300
*** RIVER *** [Qs 2d Td Kd] [8h]
RichRick1337: bets 100
color_singleton: calls 100
*** SHOW DOWN ***
RichRick1337: shows [Ah Qh] (a pair of Queens)
color_singleton: shows [9h Ks] (a pair of Kings)
color_singleton collected 1795 from pot
*** SUMMARY ***
Total pot 1900 | Rake 105 
Board [Qs 2d Td Kd 8h]
Seat 2: dddocky (button) folded before Flop (didn't bet)
Seat 3: RichRick1337 (small blind) showed [Ah Qh] and lost with a pair of Queens
Seat 4: Duke Croix (big blind) folded before Flop
Seat 6: color_singleton showed [9h Ks] and won (1795) with a pair of Kings



PokerStars Home Game Hand #217633363699: {Club #3225207}  Hold'em No Limit (50/100) - 2020/08/20 16:30:32 ET
Table 'Manuel Neuer' 9-max (Play Money) Seat #3 is the button
Seat 2: dddocky (6319 in chips) 
Seat 3: RichRick1337 (1577 in chips) 
Seat 4: Duke Croix (13532 in chips) 
Seat 6: color_singleton (11304 in chips) 
Duke Croix: posts small blind 50
color_singleton: posts big blind 100
*** HOLE CARDS ***
Dealt to Duke Croix [Ad Jd]
dddocky: folds 
RichRick1337: calls 100
Duke Croix: raises 400 to 500
color_singleton: calls 400
RichRick1337: folds 
*** FLOP *** [Kc 3d Jh]
Duke Croix: checks 
color_singleton: checks 
*** TURN *** [Kc 3d Jh] [Qh]
Duke Croix: checks 
color_singleton: checks 
*** RIVER *** [Kc 3d Jh Qh] [4c]
Duke Croix: checks 
color_singleton: checks 
*** SHOW DOWN ***
Duke Croix: shows [Ad Jd] (a pair of Jacks)
color_singleton: mucks hand 
Duke Croix collected 1039 from pot
*** SUMMARY ***
Total pot 1100 | Rake 61 
Board [Kc 3d Jh Qh 4c]
Seat 2: dddocky folded before Flop (didn't bet)
Seat 3: RichRick1337 (button) folded before Flop
Seat 4: Duke Croix (small blind) showed [Ad Jd] and won (1039) with a pair of Jacks
Seat 6: color_singleton (big blind) mucked [6s 6h]



PokerStars Home Game Hand #217633379019: {Club #3225207}  Hold'em No Limit (50/100) - 2020/08/20 16:30:58 ET
Table 'Manuel Neuer' 9-max (Play Money) Seat #4 is the button
Seat 2: dddocky (6319 in chips) 
Seat 3: RichRick1337 (1477 in chips) 
Seat 4: Duke Croix (14071 in chips) 
Seat 6: color_singleton (10804 in chips) 
color_singleton: posts small blind 50
dddocky: posts big blind 100
*** HOLE CARDS ***
Dealt to Duke Croix [8d Js]
RichRick1337: calls 100
Duke Croix: folds 
color_singleton: raises 200 to 300
dddocky: folds 
RichRick1337: calls 200
*** FLOP *** [Ac 4d Qd]
color_singleton: checks 
RichRick1337: bets 100
color_singleton: calls 100
*** TURN *** [Ac 4d Qd] [2d]
color_singleton: checks 
RichRick1337: bets 100
color_singleton: raises 525 to 625
RichRick1337: calls 525
*** RIVER *** [Ac 4d Qd 2d] [5d]
color_singleton: checks 
RichRick1337: checks 
*** SHOW DOWN ***
color_singleton: shows [Kc As] (a pair of Aces)
RichRick1337: mucks hand 
color_singleton collected 2032 from pot
*** SUMMARY ***
Total pot 2150 | Rake 118 
Board [Ac 4d Qd 2d 5d]
Seat 2: dddocky (big blind) folded before Flop
Seat 3: RichRick1337 mucked [4h Jc]
Seat 4: Duke Croix (button) folded before Flop (didn't bet)
Seat 6: color_singleton (small blind) showed [Kc As] and won (2032) with a pair of Aces



PokerStars Home Game Hand #217633402009: {Club #3225207}  Hold'em No Limit (50/100) - 2020/08/20 16:31:38 ET
Table 'Manuel Neuer' 9-max (Play Money) Seat #6 is the button
Seat 3: RichRick1337 (452 in chips) 
Seat 4: Duke Croix (14071 in chips) 
Seat 6: color_singleton (11811 in chips) 
RichRick1337: posts small blind 50
Duke Croix: posts big blind 100
*** HOLE CARDS ***
Dealt to Duke Croix [Jh 4c]
color_singleton: folds 
RichRick1337: calls 50
Duke Croix: checks 
*** FLOP *** [Ts 9c 4d]
RichRick1337: checks 
Duke Croix: checks 
*** TURN *** [Ts 9c 4d] [8d]
RichRick1337: bets 100
Duke Croix: calls 100
*** RIVER *** [Ts 9c 4d 8d] [Qs]
RichRick1337: bets 100
Duke Croix: calls 100
*** SHOW DOWN ***
RichRick1337: shows [5c 8h] (a pair of Eights)
Duke Croix: shows [Jh 4c] (a straight, Eight to Queen)
Duke Croix collected 567 from pot
*** SUMMARY ***
Total pot 600 | Rake 33 
Board [Ts 9c 4d 8d Qs]
Seat 3: RichRick1337 (small blind) showed [5c 8h] and lost with a pair of Eights
Seat 4: Duke Croix (big blind) showed [Jh 4c] and won (567) with a straight, Eight to Queen
Seat 6: color_singleton (button) folded before Flop (didn't bet)



PokerStars Home Game Hand #217633413374: {Club #3225207}  Hold'em No Limit (50/100) - 2020/08/20 16:31:57 ET
Table 'Manuel Neuer' 9-max (Play Money) Seat #3 is the button
Seat 3: RichRick1337 (152 in chips) 
Seat 4: Duke Croix (14338 in chips) 
Seat 6: color_singleton (11811 in chips) 
Seat 9: Manon541 (7193 in chips) 
Duke Croix: posts small blind 50
color_singleton: posts big blind 100
Manon541: posts small & big blinds 150
*** HOLE CARDS ***
Dealt to Duke Croix [6h Th]
Manon541: checks 
RichRick1337: calls 100
Duke Croix: calls 50
color_singleton: raises 200 to 300
Manon541: calls 200
RichRick1337: calls 52 and is all-in
Duke Croix: calls 200
*** FLOP *** [Tc 7c Ah]
Duke Croix: checks 
color_singleton: checks 
Manon541: checks 
*** TURN *** [Tc 7c Ah] [Jd]
Duke Croix: checks 
color_singleton: bets 520
Manon541: folds 
Duke Croix: calls 520
*** RIVER *** [Tc 7c Ah Jd] [2d]
Duke Croix: checks 
color_singleton: checks 
*** SHOW DOWN ***
Duke Croix: shows [6h Th] (a pair of Tens)
color_singleton: shows [8d Ac] (a pair of Aces)
color_singleton collected 1402 from side pot
RichRick1337: mucks hand 
color_singleton collected 622 from main pot
*** SUMMARY ***
Total pot 2142 Main pot 622. Side pot 1402. | Rake 118 
Board [Tc 7c Ah Jd 2d]
Seat 3: RichRick1337 (button) mucked [3d Qs]
Seat 4: Duke Croix (small blind) showed [6h Th] and lost with a pair of Tens
Seat 6: color_singleton (big blind) showed [8d Ac] and won (2024) with a pair of Aces
Seat 9: Manon541 folded on the Turn



PokerStars Home Game Hand #217633442174: {Club #3225207}  Hold'em No Limit (50/100) - 2020/08/20 16:32:46 ET
Table 'Manuel Neuer' 9-max (Play Money) Seat #4 is the button
Seat 4: Duke Croix (13518 in chips) 
Seat 6: color_singleton (13015 in chips) 
Seat 9: Manon541 (6843 in chips) 
color_singleton: posts small blind 50
Manon541: posts big blind 100
*** HOLE CARDS ***
Dealt to Duke Croix [5c Kh]
Duke Croix: folds 
color_singleton: folds 
Uncalled bet (50) returned to Manon541
Manon541 collected 100 from pot
*** SUMMARY ***
Total pot 100 | Rake 0 
Seat 4: Duke Croix (button) folded before Flop (didn't bet)
Seat 6: color_singleton (small blind) folded before Flop
Seat 9: Manon541 (big blind) collected (100)



PokerStars Home Game Hand #217633445822: {Club #3225207}  Hold'em No Limit (50/100) - 2020/08/20 16:32:52 ET
Table 'Manuel Neuer' 9-max (Play Money) Seat #6 is the button
Seat 4: Duke Croix (13518 in chips) 
Seat 6: color_singleton (12965 in chips) 
Seat 9: Manon541 (6893 in chips) 
Manon541: posts small blind 50
Duke Croix: posts big blind 100
*** HOLE CARDS ***
Dealt to Duke Croix [8c Js]
color_singleton: raises 100 to 200
Manon541: folds 
Duke Croix: calls 100
*** FLOP *** [Ad Tc 7h]
Duke Croix: checks 
color_singleton: checks 
*** TURN *** [Ad Tc 7h] [3h]
Duke Croix: checks 
color_singleton: bets 212
Duke Croix: folds 
Uncalled bet (212) returned to color_singleton
color_singleton collected 425 from pot
color_singleton: doesn't show hand 
*** SUMMARY ***
Total pot 450 | Rake 25 
Board [Ad Tc 7h 3h]
Seat 4: Duke Croix (big blind) folded on the Turn
Seat 6: color_singleton (button) collected (425)
Seat 9: Manon541 (small blind) folded before Flop



PokerStars Home Game Hand #217633466053: {Club #3225207}  Hold'em No Limit (50/100) - 2020/08/20 16:33:17 ET
Table 'Manuel Neuer' 9-max (Play Money) Seat #9 is the button
Seat 4: Duke Croix (13318 in chips) 
Seat 6: color_singleton (13190 in chips) 
Seat 9: Manon541 (6843 in chips) 
Duke Croix: posts small blind 50
color_singleton: posts big blind 100
*** HOLE CARDS ***
Dealt to Duke Croix [8h 7h]
Manon541: calls 100
Duke Croix: raises 300 to 400
color_singleton: calls 300
Manon541: calls 300
*** FLOP *** [8c 6s 2c]
Duke Croix: bets 700
color_singleton: folds 
Manon541: calls 700
*** TURN *** [8c 6s 2c] [Td]
Duke Croix: checks 
Manon541: checks 
*** RIVER *** [8c 6s 2c Td] [6c]
Duke Croix: bets 1000
Manon541: raises 4457 to 5457
Duke Croix: folds 
Uncalled bet (4457) returned to Manon541
Manon541 collected 4347 from pot
*** SUMMARY ***
Total pot 4600 | Rake 253 
Board [8c 6s 2c Td 6c]
Seat 4: Duke Croix (small blind) folded on the River
Seat 6: color_singleton (big blind) folded on the Flop
Seat 9: Manon541 (button) collected (4347)



PokerStars Home Game Hand #217633487882: {Club #3225207}  Hold'em No Limit (50/100) - 2020/08/20 16:33:55 ET
Table 'Manuel Neuer' 9-max (Play Money) Seat #4 is the button
Seat 1: JeBoyDirk (22104 in chips) 
Seat 2: dddocky (6219 in chips) 
Seat 4: Duke Croix (11218 in chips) 
Seat 6: color_singleton (12790 in chips) 
Seat 9: Manon541 (9090 in chips) 
color_singleton: posts small blind 50
Manon541: posts big blind 100
JeBoyDirk: posts small & big blinds 150
dddocky: posts small & big blinds 150
*** HOLE CARDS ***
Dealt to Duke Croix [Tc Kc]
JeBoyDirk: checks 
dddocky: checks 
Duke Croix: raises 400 to 500
color_singleton: folds 
Manon541: folds 
JeBoyDirk: folds 
dddocky: calls 400
*** FLOP *** [6s Jh Qh]
dddocky: bets 100
Duke Croix: raises 700 to 800
dddocky: calls 700
*** TURN *** [6s Jh Qh] [3s]
dddocky: checks 
Duke Croix: bets 1800
dddocky: calls 1800
*** RIVER *** [6s Jh Qh 3s] [Ts]
dddocky: checks 
Duke Croix: checks 
*** SHOW DOWN ***
dddocky: shows [Kd Jd] (a pair of Jacks)
Duke Croix: mucks hand 
dddocky collected 6190 from pot
*** SUMMARY ***
Total pot 6550 | Rake 360 
Board [6s Jh Qh 3s Ts]
Seat 1: JeBoyDirk folded before Flop (didn't bet)
Seat 2: dddocky showed [Kd Jd] and won (6190) with a pair of Jacks
Seat 4: Duke Croix (button) mucked [Tc Kc]
Seat 6: color_singleton (small blind) folded before Flop
Seat 9: Manon541 (big blind) folded before Flop



PokerStars Home Game Hand #217633513333: {Club #3225207}  Hold'em No Limit (50/100) - 2020/08/20 16:34:38 ET
Table 'Manuel Neuer' 9-max (Play Money) Seat #6 is the button
Seat 1: JeBoyDirk (21954 in chips) 
Seat 2: dddocky (9259 in chips) 
Seat 4: Duke Croix (8118 in chips) 
Seat 6: color_singleton (12740 in chips) 
Seat 9: Manon541 (8990 in chips) 
Manon541: posts small blind 50
JeBoyDirk: posts big blind 100
*** HOLE CARDS ***
Dealt to Duke Croix [Tc Qs]
dddocky: folds 
Duke Croix: raises 200 to 300
color_singleton: folds 
Manon541: folds 
JeBoyDirk: folds 
Uncalled bet (200) returned to Duke Croix
Duke Croix collected 250 from pot
*** SUMMARY ***
Total pot 250 | Rake 0 
Seat 1: JeBoyDirk (big blind) folded before Flop
Seat 2: dddocky folded before Flop (didn't bet)
Seat 4: Duke Croix collected (250)
Seat 6: color_singleton (button) folded before Flop (didn't bet)
Seat 9: Manon541 (small blind) folded before Flop



PokerStars Home Game Hand #217633519161: {Club #3225207}  Hold'em No Limit (50/100) - 2020/08/20 16:34:48 ET
Table 'Manuel Neuer' 9-max (Play Money) Seat #9 is the button
Seat 1: JeBoyDirk (21854 in chips) 
Seat 2: dddocky (9259 in chips) 
Seat 4: Duke Croix (8268 in chips) 
Seat 6: color_singleton (12740 in chips) 
Seat 9: Manon541 (8940 in chips) 
JeBoyDirk: posts small blind 50
dddocky: posts big blind 100
*** HOLE CARDS ***
Dealt to Duke Croix [3d 7s]
Duke Croix: folds 
color_singleton: folds 
Manon541: folds 
JeBoyDirk: calls 50
dddocky: checks 
*** FLOP *** [4c 2c 6d]
JeBoyDirk: checks 
dddocky: bets 189
JeBoyDirk: folds 
Uncalled bet (189) returned to dddocky
dddocky collected 189 from pot
dddocky: doesn't show hand 
*** SUMMARY ***
Total pot 200 | Rake 11 
Board [4c 2c 6d]
Seat 1: JeBoyDirk (small blind) folded on the Flop
Seat 2: dddocky (big blind) collected (189)
Seat 4: Duke Croix folded before Flop (didn't bet)
Seat 6: color_singleton folded before Flop (didn't bet)
Seat 9: Manon541 (button) folded before Flop (didn't bet)



PokerStars Home Game Hand #217633529503: {Club #3225207}  Hold'em No Limit (50/100) - 2020/08/20 16:35:06 ET
Table 'Manuel Neuer' 9-max (Play Money) Seat #1 is the button
Seat 1: JeBoyDirk (21754 in chips) 
Seat 2: dddocky (9348 in chips) 
Seat 4: Duke Croix (8268 in chips) 
Seat 6: color_singleton (12740 in chips) 
Seat 9: Manon541 (8940 in chips) 
dddocky: posts small blind 50
Duke Croix: posts big blind 100
*** HOLE CARDS ***
Dealt to Duke Croix [As 5h]
color_singleton: raises 100 to 200
Manon541: folds 
JeBoyDirk: folds 
dddocky: folds 
Duke Croix: calls 100
*** FLOP *** [4h 5d Th]
Duke Croix: bets 300
RichRick1337 leaves the table
color_singleton: raises 300 to 600
Duke Croix: calls 300
*** TURN *** [4h 5d Th] [Js]
Duke Croix: checks 
color_singleton: bets 779
Duke Croix: folds 
Uncalled bet (779) returned to color_singleton
color_singleton collected 1559 from pot
color_singleton: doesn't show hand 
*** SUMMARY ***
Total pot 1650 | Rake 91 
Board [4h 5d Th Js]
Seat 1: JeBoyDirk (button) folded before Flop (didn't bet)
Seat 2: dddocky (small blind) folded before Flop
Seat 4: Duke Croix (big blind) folded on the Turn
Seat 6: color_singleton collected (1559)
Seat 9: Manon541 folded before Flop (didn't bet)



PokerStars Home Game Hand #217633548635: {Club #3225207}  Hold'em No Limit (50/100) - 2020/08/20 16:35:39 ET
Table 'Manuel Neuer' 9-max (Play Money) Seat #2 is the button
Seat 1: JeBoyDirk (21754 in chips) 
Seat 2: dddocky (9298 in chips) 
Seat 4: Duke Croix (7468 in chips) 
Seat 6: color_singleton (13499 in chips) 
Seat 9: Manon541 (8940 in chips) 
Duke Croix: posts small blind 50
color_singleton: posts big blind 100
*** HOLE CARDS ***
Dealt to Duke Croix [Jh Ah]
Manon541: calls 100
JeBoyDirk: calls 100
dddocky: calls 100
Duke Croix: raises 400 to 500
color_singleton: folds 
Manon541: folds 
JeBoyDirk: calls 400
dddocky: calls 400
*** FLOP *** [2h 4s 8c]
Duke Croix: checks 
JeBoyDirk: checks 
dddocky: checks 
*** TURN *** [2h 4s 8c] [Tc]
Duke Croix: checks 
JeBoyDirk: bets 500
dddocky: calls 500
Duke Croix: folds 
*** RIVER *** [2h 4s 8c Tc] [4c]
JeBoyDirk: bets 800
dddocky: raises 800 to 1600
JeBoyDirk: folds 
Uncalled bet (800) returned to dddocky
dddocky collected 4063 from pot
dddocky: doesn't show hand 
*** SUMMARY ***
Total pot 4300 | Rake 237 
Board [2h 4s 8c Tc 4c]
Seat 1: JeBoyDirk folded on the River
Seat 2: dddocky (button) collected (4063)
Seat 4: Duke Croix (small blind) folded on the Turn
Seat 6: color_singleton (big blind) folded before Flop
Seat 9: Manon541 folded before Flop



PokerStars Home Game Hand #217633593529: {Club #3225207}  Hold'em No Limit (50/100) - 2020/08/20 16:36:56 ET
Table 'Manuel Neuer' 9-max (Play Money) Seat #4 is the button
Seat 1: JeBoyDirk (19954 in chips) 
Seat 2: dddocky (11561 in chips) 
Seat 4: Duke Croix (6968 in chips) 
Seat 6: color_singleton (13399 in chips) 
Seat 9: Manon541 (8840 in chips) 
color_singleton: posts small blind 50
Manon541: posts big blind 100
*** HOLE CARDS ***
Dealt to Duke Croix [3c 4s]
JeBoyDirk: calls 100
dddocky: calls 100
Duke Croix: folds 
color_singleton has timed out
color_singleton: folds 
Manon541: checks 
*** FLOP *** [8c 4d 8d]
Manon541: checks 
JeBoyDirk: checks 
dddocky: checks 
*** TURN *** [8c 4d 8d] [5c]
Manon541: checks 
JeBoyDirk: checks 
dddocky: checks 
*** RIVER *** [8c 4d 8d 5c] [Js]
Manon541: checks 
JeBoyDirk: checks 
dddocky: checks 
*** SHOW DOWN ***
Manon541: shows [Qd 9d] (a pair of Eights)
JeBoyDirk: shows [Ac Qs] (a pair of Eights - Ace kicker)
dddocky: mucks hand 
JeBoyDirk collected 331 from pot
*** SUMMARY ***
Total pot 350 | Rake 19 
Board [8c 4d 8d 5c Js]
Seat 1: JeBoyDirk showed [Ac Qs] and won (331) with a pair of Eights
Seat 2: dddocky mucked [7c Qh]
Seat 4: Duke Croix (button) folded before Flop (didn't bet)
Seat 6: color_singleton (small blind) folded before Flop
Seat 9: Manon541 (big blind) showed [Qd 9d] and lost with a pair of Eights



PokerStars Home Game Hand #217633622999: {Club #3225207}  Hold'em No Limit (50/100) - 2020/08/20 16:37:47 ET
Table 'Manuel Neuer' 9-max (Play Money) Seat #9 is the button
Seat 1: JeBoyDirk (20185 in chips) 
Seat 2: dddocky (11461 in chips) 
Seat 4: Duke Croix (6968 in chips) 
Seat 9: Manon541 (8740 in chips) 
JeBoyDirk: posts small blind 50
dddocky: posts big blind 100
*** HOLE CARDS ***
Dealt to Duke Croix [Ks Td]
Duke Croix: raises 300 to 400
Manon541: calls 400
JeBoyDirk: folds 
dddocky: folds 
*** FLOP *** [Tc 7c 6h]
Duke Croix: bets 500
Manon541: folds 
Uncalled bet (500) returned to Duke Croix
Duke Croix collected 898 from pot
*** SUMMARY ***
Total pot 950 | Rake 52 
Board [Tc 7c 6h]
Seat 1: JeBoyDirk (small blind) folded before Flop
Seat 2: dddocky (big blind) folded before Flop
Seat 4: Duke Croix collected (898)
Seat 9: Manon541 (button) folded on the Flop



PokerStars Home Game Hand #217633637592: {Club #3225207}  Hold'em No Limit (50/100) - 2020/08/20 16:38:12 ET
Table 'Manuel Neuer' 9-max (Play Money) Seat #1 is the button
Seat 1: JeBoyDirk (20135 in chips) 
Seat 2: dddocky (11361 in chips) 
Seat 4: Duke Croix (7466 in chips) 
Seat 9: Manon541 (8340 in chips) 
dddocky: posts small blind 50
Duke Croix: posts big blind 100
*** HOLE CARDS ***
Dealt to Duke Croix [8h 9h]
Manon541: calls 100
JeBoyDirk: folds 
dddocky: calls 50
Duke Croix: raises 400 to 500
Manon541: folds 
dddocky: folds 
Uncalled bet (400) returned to Duke Croix
Duke Croix collected 300 from pot
*** SUMMARY ***
Total pot 300 | Rake 0 
Seat 1: JeBoyDirk (button) folded before Flop (didn't bet)
Seat 2: dddocky (small blind) folded before Flop
Seat 4: Duke Croix (big blind) collected (300)
Seat 9: Manon541 folded before Flop



PokerStars Home Game Hand #217633651862: {Club #3225207}  Hold'em No Limit (50/100) - 2020/08/20 16:38:36 ET
Table 'Manuel Neuer' 9-max (Play Money) Seat #2 is the button
Seat 1: JeBoyDirk (20135 in chips) 
Seat 2: dddocky (11261 in chips) 
Seat 4: Duke Croix (7666 in chips) 
Seat 9: Manon541 (8240 in chips) 
Duke Croix: posts small blind 50
Manon541: posts big blind 100
*** HOLE CARDS ***
Dealt to Duke Croix [7s 7c]
JeBoyDirk: folds 
dddocky: folds 
Duke Croix: raises 300 to 400
Manon541: folds 
Uncalled bet (300) returned to Duke Croix
Duke Croix collected 200 from pot
*** SUMMARY ***
Total pot 200 | Rake 0 
Seat 1: JeBoyDirk folded before Flop (didn't bet)
Seat 2: dddocky (button) folded before Flop (didn't bet)
Seat 4: Duke Croix (small blind) collected (200)
Seat 9: Manon541 (big blind) folded before Flop



PokerStars Home Game Hand #217633663914: {Club #3225207}  Hold'em No Limit (50/100) - 2020/08/20 16:38:57 ET
Table 'Manuel Neuer' 9-max (Play Money) Seat #4 is the button
Seat 1: JeBoyDirk (20135 in chips) 
Seat 2: dddocky (11261 in chips) 
Seat 4: Duke Croix (7766 in chips) 
Seat 9: Manon541 (8140 in chips) 
Manon541: posts small blind 50
JeBoyDirk: posts big blind 100
*** HOLE CARDS ***
Dealt to Duke Croix [8d Qh]
dddocky: calls 100
Duke Croix: raises 400 to 500
Manon541: folds 
JeBoyDirk: folds 
dddocky: folds 
Uncalled bet (400) returned to Duke Croix
Duke Croix collected 350 from pot
*** SUMMARY ***
Total pot 350 | Rake 0 
Seat 1: JeBoyDirk (big blind) folded before Flop
Seat 2: dddocky folded before Flop
Seat 4: Duke Croix (button) collected (350)
Seat 9: Manon541 (small blind) folded before Flop



PokerStars Home Game Hand #217633679351: {Club #3225207}  Hold'em No Limit (50/100) - 2020/08/20 16:39:24 ET
Table 'Manuel Neuer' 9-max (Play Money) Seat #9 is the button
Seat 1: JeBoyDirk (20035 in chips) 
Seat 2: dddocky (11161 in chips) 
Seat 4: Duke Croix (8016 in chips) 
Seat 6: color_singleton (13349 in chips) 
Seat 9: Manon541 (8090 in chips) 
JeBoyDirk: posts small blind 50
dddocky: posts big blind 100
color_singleton: posts small & big blinds 150
*** HOLE CARDS ***
Dealt to Duke Croix [Jc Jd]
Duke Croix: raises 400 to 500
color_singleton: folds 
Manon541: folds 
JeBoyDirk: folds 
dddocky: folds 
Uncalled bet (400) returned to Duke Croix
Duke Croix collected 400 from pot
*** SUMMARY ***
Total pot 400 | Rake 0 
Seat 1: JeBoyDirk (small blind) folded before Flop
Seat 2: dddocky (big blind) folded before Flop
Seat 4: Duke Croix collected (400)
Seat 6: color_singleton folded before Flop (didn't bet)
Seat 9: Manon541 (button) folded before Flop (didn't bet)



PokerStars Home Game Hand #217633689101: {Club #3225207}  Hold'em No Limit (50/100) - 2020/08/20 16:39:41 ET
Table 'Manuel Neuer' 9-max (Play Money) Seat #1 is the button
Seat 1: JeBoyDirk (19985 in chips) 
Seat 2: dddocky (11061 in chips) 
Seat 4: Duke Croix (8316 in chips) 
Seat 6: color_singleton (13199 in chips) 
Seat 9: Manon541 (8090 in chips) 
dddocky: posts small blind 50
Duke Croix: posts big blind 100
*** HOLE CARDS ***
Dealt to Duke Croix [8h Qh]
color_singleton: calls 100
Manon541: folds 
JeBoyDirk: folds 
dddocky: calls 50
Duke Croix: checks 
*** FLOP *** [Kd 8d 2c]
dddocky: checks 
Duke Croix: checks 
color_singleton: checks 
*** TURN *** [Kd 8d 2c] [Jh]
dddocky: bets 141
Duke Croix: folds 
color_singleton: calls 141
*** RIVER *** [Kd 8d 2c Jh] [Tc]
dddocky: bets 550
color_singleton: calls 550
*** SHOW DOWN ***
dddocky: shows [Kh 3d] (a pair of Kings)
color_singleton: shows [3h Kc] (a pair of Kings)
dddocky collected 795 from pot
color_singleton collected 794 from pot
*** SUMMARY ***
Total pot 1682 | Rake 93 
Board [Kd 8d 2c Jh Tc]
Seat 1: JeBoyDirk (button) folded before Flop (didn't bet)
Seat 2: dddocky (small blind) showed [Kh 3d] and won (795) with a pair of Kings
Seat 4: Duke Croix (big blind) folded on the Turn
Seat 6: color_singleton showed [3h Kc] and won (794) with a pair of Kings
Seat 9: Manon541 folded before Flop (didn't bet)



PokerStars Home Game Hand #217633717832: {Club #3225207}  Hold'em No Limit (50/100) - 2020/08/20 16:40:31 ET
Table 'Manuel Neuer' 9-max (Play Money) Seat #2 is the button
Seat 1: JeBoyDirk (19985 in chips) 
Seat 2: dddocky (11065 in chips) 
Seat 4: Duke Croix (8216 in chips) 
Seat 6: color_singleton (13202 in chips) 
Seat 9: Manon541 (8090 in chips) 
Duke Croix: posts small blind 50
color_singleton: posts big blind 100
*** HOLE CARDS ***
Dealt to Duke Croix [5c Kc]
Manon541: calls 100
JeBoyDirk: folds 
dddocky: folds 
Duke Croix: calls 50
color_singleton: raises 200 to 300
Manon541: calls 200
Duke Croix: folds 
*** FLOP *** [Jh 9s 8c]
color_singleton: checks 
Manon541: checks 
*** TURN *** [Jh 9s 8c] [3h]
color_singleton: checks 
Manon541: checks 
*** RIVER *** [Jh 9s 8c 3h] [7d]
color_singleton: bets 661
Manon541: folds 
Uncalled bet (661) returned to color_singleton
color_singleton collected 661 from pot
color_singleton: doesn't show hand 
*** SUMMARY ***
Total pot 700 | Rake 39 
Board [Jh 9s 8c 3h 7d]
Seat 1: JeBoyDirk folded before Flop (didn't bet)
Seat 2: dddocky (button) folded before Flop (didn't bet)
Seat 4: Duke Croix (small blind) folded before Flop
Seat 6: color_singleton (big blind) collected (661)
Seat 9: Manon541 folded on the River



PokerStars Home Game Hand #217633743096: {Club #3225207}  Hold'em No Limit (50/100) - 2020/08/20 16:41:15 ET
Table 'Manuel Neuer' 9-max (Play Money) Seat #4 is the button
Seat 1: JeBoyDirk (19985 in chips) 
Seat 2: dddocky (11065 in chips) 
Seat 4: Duke Croix (8116 in chips) 
Seat 6: color_singleton (13563 in chips) 
Seat 9: Manon541 (7790 in chips) 
color_singleton: posts small blind 50
Manon541: posts big blind 100
*** HOLE CARDS ***
Dealt to Duke Croix [Kh Qc]
JeBoyDirk: folds 
dddocky: folds 
Duke Croix: raises 300 to 400
color_singleton: calls 350
Manon541: calls 300
*** FLOP *** [Kc 4s 9s]
color_singleton: checks 
Manon541: checks 
Duke Croix: bets 800
color_singleton: folds 
Manon541: folds 
Uncalled bet (800) returned to Duke Croix
Duke Croix collected 1134 from pot
*** SUMMARY ***
Total pot 1200 | Rake 66 
Board [Kc 4s 9s]
Seat 1: JeBoyDirk folded before Flop (didn't bet)
Seat 2: dddocky folded before Flop (didn't bet)
Seat 4: Duke Croix (button) collected (1134)
Seat 6: color_singleton (small blind) folded on the Flop
Seat 9: Manon541 (big blind) folded on the Flop



PokerStars Home Game Hand #217633770748: {Club #3225207}  Hold'em No Limit (50/100) - 2020/08/20 16:42:03 ET
Table 'Manuel Neuer' 9-max (Play Money) Seat #6 is the button
Seat 1: JeBoyDirk (19985 in chips) 
Seat 2: dddocky (11065 in chips) 
Seat 4: Duke Croix (8850 in chips) 
Seat 6: color_singleton (13163 in chips) 
Seat 9: Manon541 (7390 in chips) 
Manon541: posts small blind 50
JeBoyDirk: posts big blind 100
*** HOLE CARDS ***
Dealt to Duke Croix [4s 5d]
dddocky: calls 100
Duke Croix: folds 
color_singleton: calls 100
Manon541: calls 50
JeBoyDirk: checks 
*** FLOP *** [7s 7d 6h]
Manon541: checks 
JeBoyDirk: checks 
dddocky: checks 
color_singleton: bets 189
Manon541: calls 189
JeBoyDirk: calls 189
dddocky: calls 189
*** TURN *** [7s 7d 6h] [Jd]
Manon541: checks 
JeBoyDirk: checks 
dddocky: checks 
color_singleton: checks 
*** RIVER *** [7s 7d 6h Jd] [3s]
Manon541: bets 546
JeBoyDirk: folds 
dddocky: folds 
color_singleton: folds 
Uncalled bet (546) returned to Manon541
Manon541 collected 1092 from pot
*** SUMMARY ***
Total pot 1156 | Rake 64 
Board [7s 7d 6h Jd 3s]
Seat 1: JeBoyDirk (big blind) folded on the River
Seat 2: dddocky folded on the River
Seat 4: Duke Croix folded before Flop (didn't bet)
Seat 6: color_singleton (button) folded on the River
Seat 9: Manon541 (small blind) collected (1092)



PokerStars Home Game Hand #217633806550: {Club #3225207}  Hold'em No Limit (50/100) - 2020/08/20 16:43:05 ET
Table 'Manuel Neuer' 9-max (Play Money) Seat #9 is the button
Seat 1: JeBoyDirk (19696 in chips) 
Seat 2: dddocky (10776 in chips) 
Seat 4: Duke Croix (8850 in chips) 
Seat 6: color_singleton (12874 in chips) 
Seat 9: Manon541 (8193 in chips) 
JeBoyDirk: posts small blind 50
dddocky: posts big blind 100
*** HOLE CARDS ***
Dealt to Duke Croix [Js 4c]
Duke Croix: folds 
color_singleton: folds 
Manon541: calls 100
JeBoyDirk: folds 
dddocky: checks 
*** FLOP *** [Ts Tc 3c]
dddocky: checks 
Manon541: checks 
*** TURN *** [Ts Tc 3c] [6c]
dddocky: checks 
Manon541: checks 
*** RIVER *** [Ts Tc 3c 6c] [3d]
dddocky: checks 
Manon541: checks 
*** SHOW DOWN ***
dddocky: shows [8c 9d] (two pair, Tens and Threes)
Manon541: shows [Jh 2h] (two pair, Tens and Threes - Jack kicker)
Manon541 collected 236 from pot
*** SUMMARY ***
Total pot 250 | Rake 14 
Board [Ts Tc 3c 6c 3d]
Seat 1: JeBoyDirk (small blind) folded before Flop
Seat 2: dddocky (big blind) showed [8c 9d] and lost with two pair, Tens and Threes
Seat 4: Duke Croix folded before Flop (didn't bet)
Seat 6: color_singleton folded before Flop (didn't bet)
Seat 9: Manon541 (button) showed [Jh 2h] and won (236) with two pair, Tens and Threes



PokerStars Home Game Hand #217633837317: {Club #3225207}  Hold'em No Limit (50/100) - 2020/08/20 16:43:58 ET
Table 'Manuel Neuer' 9-max (Play Money) Seat #1 is the button
Seat 1: JeBoyDirk (19646 in chips) 
Seat 2: dddocky (10676 in chips) 
Seat 4: Duke Croix (8850 in chips) 
Seat 6: color_singleton (12874 in chips) 
Seat 9: Manon541 (8329 in chips) 
dddocky: posts small blind 50
Duke Croix: posts big blind 100
*** HOLE CARDS ***
Dealt to Duke Croix [9d Qc]
color_singleton: calls 100
Manon541: calls 100
JeBoyDirk: folds 
dddocky: folds 
Duke Croix: checks 
*** FLOP *** [Ts 2c 8s]
Duke Croix: checks 
color_singleton: checks 
Manon541: checks 
*** TURN *** [Ts 2c 8s] [5h]
Duke Croix: checks 
color_singleton: checks 
Manon541: bets 165
Duke Croix: folds 
color_singleton: calls 165
*** RIVER *** [Ts 2c 8s 5h] [6s]
color_singleton: checks 
Manon541: bets 321
color_singleton: folds 
Uncalled bet (321) returned to Manon541
Manon541 collected 643 from pot
*** SUMMARY ***
Total pot 680 | Rake 37 
Board [Ts 2c 8s 5h 6s]
Seat 1: JeBoyDirk (button) folded before Flop (didn't bet)
Seat 2: dddocky (small blind) folded before Flop
Seat 4: Duke Croix (big blind) folded on the Turn
Seat 6: color_singleton folded on the River
Seat 9: Manon541 collected (643)



PokerStars Home Game Hand #217633881948: {Club #3225207}  Hold'em No Limit (50/100) - 2020/08/20 16:45:16 ET
Table 'Manuel Neuer' 9-max (Play Money) Seat #2 is the button
Seat 1: JeBoyDirk (19646 in chips) 
Seat 2: dddocky (10626 in chips) 
Seat 4: Duke Croix (8750 in chips) 
Seat 6: color_singleton (12609 in chips) 
Seat 9: Manon541 (8707 in chips) 
Duke Croix: posts small blind 50
color_singleton: posts big blind 100
*** HOLE CARDS ***
Dealt to Duke Croix [5d 9c]
Manon541: folds 
JeBoyDirk: raises 100 to 200
dddocky: calls 200
Duke Croix: folds 
color_singleton: calls 100
*** FLOP *** [7s Qs 3s]
color_singleton: checks 
JeBoyDirk: bets 200
dddocky: raises 200 to 400
color_singleton: folds 
JeBoyDirk: calls 200
*** TURN *** [7s Qs 3s] [Ks]
JeBoyDirk: checks 
dddocky: checks 
*** RIVER *** [7s Qs 3s Ks] [Ts]
JeBoyDirk: bets 1400
dddocky: calls 1400
*** SHOW DOWN ***
JeBoyDirk: shows [2c As] (a flush, Ace high)
dddocky: mucks hand 
JeBoyDirk collected 4016 from pot
*** SUMMARY ***
Total pot 4250 | Rake 234 
Board [7s Qs 3s Ks Ts]
Seat 1: JeBoyDirk showed [2c As] and won (4016) with a flush, Ace high
Seat 2: dddocky (button) mucked [Qc 9s]
Seat 4: Duke Croix (small blind) folded before Flop
Seat 6: color_singleton (big blind) folded on the Flop
Seat 9: Manon541 folded before Flop (didn't bet)



PokerStars Home Game Hand #217633912368: {Club #3225207}  Hold'em No Limit (50/100) - 2020/08/20 16:46:09 ET
Table 'Manuel Neuer' 9-max (Play Money) Seat #4 is the button
Seat 1: JeBoyDirk (21662 in chips) 
Seat 2: dddocky (8626 in chips) 
Seat 4: Duke Croix (8700 in chips) 
Seat 6: color_singleton (12409 in chips) 
Seat 9: Manon541 (8707 in chips) 
color_singleton: posts small blind 50
Manon541: posts big blind 100
*** HOLE CARDS ***
Dealt to Duke Croix [9d Jc]
JeBoyDirk: folds 
dddocky: calls 100
Duke Croix: calls 100
color_singleton: calls 50
Manon541: raises 100 to 200
dddocky: calls 100
Duke Croix: calls 100
color_singleton: calls 100
*** FLOP *** [7h Kd As]
color_singleton: checks 
Manon541: bets 378
dddocky: folds 
Duke Croix: folds 
color_singleton: folds 
Uncalled bet (378) returned to Manon541
Manon541 collected 756 from pot
*** SUMMARY ***
Total pot 800 | Rake 44 
Board [7h Kd As]
Seat 1: JeBoyDirk folded before Flop (didn't bet)
Seat 2: dddocky folded on the Flop
Seat 4: Duke Croix (button) folded on the Flop
Seat 6: color_singleton (small blind) folded on the Flop
Seat 9: Manon541 (big blind) collected (756)



PokerStars Home Game Hand #217633933491: {Club #3225207}  Hold'em No Limit (50/100) - 2020/08/20 16:46:46 ET
Table 'Manuel Neuer' 9-max (Play Money) Seat #6 is the button
Seat 1: JeBoyDirk (21662 in chips) 
Seat 2: dddocky (8426 in chips) 
Seat 4: Duke Croix (8500 in chips) 
Seat 6: color_singleton (12209 in chips) 
Seat 9: Manon541 (9263 in chips) 
Manon541: posts small blind 50
JeBoyDirk: posts big blind 100
*** HOLE CARDS ***
Dealt to Duke Croix [As 3s]
dddocky: calls 100
Duke Croix: calls 100
color_singleton: raises 300 to 400
Manon541: folds 
JeBoyDirk: folds 
dddocky: folds 
Duke Croix: calls 300
*** FLOP *** [7s Ts Qs]
Duke Croix: checks 
color_singleton: bets 992
Duke Croix: calls 992
*** TURN *** [7s Ts Qs] [8d]
Duke Croix: checks 
color_singleton: checks 
*** RIVER *** [7s Ts Qs 8d] [Qh]
Duke Croix: checks 
color_singleton: checks 
*** SHOW DOWN ***
Duke Croix: shows [As 3s] (a flush, Ace high)
color_singleton: mucks hand 
Duke Croix collected 2867 from pot
*** SUMMARY ***
Total pot 3034 | Rake 167 
Board [7s Ts Qs 8d Qh]
Seat 1: JeBoyDirk (big blind) folded before Flop
Seat 2: dddocky folded before Flop
Seat 4: Duke Croix showed [As 3s] and won (2867) with a flush, Ace high
Seat 6: color_singleton (button) mucked [Ac Qc]
Seat 9: Manon541 (small blind) folded before Flop



PokerStars Home Game Hand #217633956650: {Club #3225207}  Hold'em No Limit (50/100) - 2020/08/20 16:47:25 ET
Table 'Manuel Neuer' 9-max (Play Money) Seat #9 is the button
Seat 1: JeBoyDirk (21562 in chips) 
Seat 2: dddocky (8326 in chips) 
Seat 4: Duke Croix (9975 in chips) 
Seat 6: color_singleton (10817 in chips) 
Seat 9: Manon541 (9213 in chips) 
JeBoyDirk: posts small blind 50
dddocky: posts big blind 100
*** HOLE CARDS ***
Dealt to Duke Croix [As 5s]
Duke Croix: raises 300 to 400
color_singleton: folds 
Manon541: folds 
JeBoyDirk: folds 
dddocky: calls 300
*** FLOP *** [Jd 9h 3s]
dddocky: bets 100
Duke Croix: calls 100
*** TURN *** [Jd 9h 3s] [Qh]
dddocky: bets 100
Duke Croix: folds 
Uncalled bet (100) returned to dddocky
dddocky collected 992 from pot
*** SUMMARY ***
Total pot 1050 | Rake 58 
Board [Jd 9h 3s Qh]
Seat 1: JeBoyDirk (small blind) folded before Flop
Seat 2: dddocky (big blind) collected (992)
Seat 4: Duke Croix folded on the Turn
Seat 6: color_singleton folded before Flop (didn't bet)
Seat 9: Manon541 (button) folded before Flop (didn't bet)



PokerStars Home Game Hand #217633978861: {Club #3225207}  Hold'em No Limit (50/100) - 2020/08/20 16:48:04 ET
Table 'Manuel Neuer' 9-max (Play Money) Seat #1 is the button
Seat 1: JeBoyDirk (21512 in chips) 
Seat 4: Duke Croix (9475 in chips) 
Seat 6: color_singleton (10817 in chips) 
Seat 9: Manon541 (9213 in chips) 
dddocky has timed out
dddocky: is sitting out 
Duke Croix: posts small blind 50
color_singleton: posts big blind 100
*** HOLE CARDS ***
Dealt to Duke Croix [Jd 2h]
Manon541: folds 
JeBoyDirk: calls 100
Duke Croix: calls 50
color_singleton: checks 
*** FLOP *** [2c Qs Ts]
Duke Croix: checks 
color_singleton: checks 
JeBoyDirk: checks 
*** TURN *** [2c Qs Ts] [8h]
Duke Croix: checks 
color_singleton: bets 141
JeBoyDirk: folds 
Duke Croix: calls 141
*** RIVER *** [2c Qs Ts 8h] [Jh]
Duke Croix: checks 
color_singleton: bets 275
Duke Croix: raises 275 to 550
color_singleton: calls 275
*** SHOW DOWN ***
Duke Croix: shows [Jd 2h] (two pair, Jacks and Deuces)
color_singleton: shows [2d Jc] (two pair, Jacks and Deuces)
Duke Croix collected 795 from pot
color_singleton collected 794 from pot
*** SUMMARY ***
Total pot 1682 | Rake 93 
Board [2c Qs Ts 8h Jh]
Seat 1: JeBoyDirk (button) folded on the Turn
Seat 4: Duke Croix (small blind) showed [Jd 2h] and won (795) with two pair, Jacks and Deuces
Seat 6: color_singleton (big blind) showed [2d Jc] and won (794) with two pair, Jacks and Deuces
Seat 9: Manon541 folded before Flop (didn't bet)



PokerStars Home Game Hand #217634009712: {Club #3225207}  Hold'em No Limit (50/100) - 2020/08/20 16:48:56 ET
Table 'Manuel Neuer' 9-max (Play Money) Seat #4 is the button
Seat 1: JeBoyDirk (21412 in chips) 
Seat 4: Duke Croix (9479 in chips) 
Seat 6: color_singleton (10820 in chips) 
Seat 9: Manon541 (9213 in chips) 
color_singleton: posts small blind 50
Manon541: posts big blind 100
*** HOLE CARDS ***
Dealt to Duke Croix [Qh Kd]
JeBoyDirk: folds 
Duke Croix: raises 400 to 500
color_singleton: folds 
Manon541: calls 400
*** FLOP *** [4c 3h 6h]
Manon541: checks 
Duke Croix: checks 
*** TURN *** [4c 3h 6h] [Kc]
Manon541: checks 
Duke Croix: bets 500
Manon541: calls 500
*** RIVER *** [4c 3h 6h Kc] [7d]
Manon541: checks 
Duke Croix: bets 1000
Manon541: folds 
Uncalled bet (1000) returned to Duke Croix
Duke Croix collected 1937 from pot
*** SUMMARY ***
Total pot 2050 | Rake 113 
Board [4c 3h 6h Kc 7d]
Seat 1: JeBoyDirk folded before Flop (didn't bet)
Seat 4: Duke Croix (button) collected (1937)
Seat 6: color_singleton (small blind) folded before Flop
Seat 9: Manon541 (big blind) folded on the River



PokerStars Home Game Hand #217634027007: {Club #3225207}  Hold'em No Limit (50/100) - 2020/08/20 16:49:26 ET
Table 'Manuel Neuer' 9-max (Play Money) Seat #6 is the button
Seat 1: JeBoyDirk (21412 in chips) 
Seat 4: Duke Croix (10416 in chips) 
Seat 6: color_singleton (10770 in chips) 
Seat 9: Manon541 (8213 in chips) 
Manon541: posts small blind 50
JeBoyDirk: posts big blind 100
*** HOLE CARDS ***
Dealt to Duke Croix [Jd 7h]
Duke Croix: folds 
color_singleton: folds 
Manon541: calls 50
JeBoyDirk: checks 
*** FLOP *** [9c 5c 7d]
Manon541: checks 
JeBoyDirk: checks 
*** TURN *** [9c 5c 7d] [3h]
Manon541: checks 
JeBoyDirk: checks 
*** RIVER *** [9c 5c 7d 3h] [4h]
Manon541: bets 189
JeBoyDirk: folds 
Uncalled bet (189) returned to Manon541
Manon541 collected 189 from pot
*** SUMMARY ***
Total pot 200 | Rake 11 
Board [9c 5c 7d 3h 4h]
Seat 1: JeBoyDirk (big blind) folded on the River
Seat 4: Duke Croix folded before Flop (didn't bet)
Seat 6: color_singleton (button) folded before Flop (didn't bet)
Seat 9: Manon541 (small blind) collected (189)



PokerStars Home Game Hand #217634044020: {Club #3225207}  Hold'em No Limit (50/100) - 2020/08/20 16:49:55 ET
Table 'Manuel Neuer' 9-max (Play Money) Seat #9 is the button
Seat 1: JeBoyDirk (21312 in chips) 
Seat 4: Duke Croix (10416 in chips) 
Seat 6: color_singleton (10770 in chips) 
Seat 9: Manon541 (8302 in chips) 
JeBoyDirk: posts small blind 50
Duke Croix: posts big blind 100
*** HOLE CARDS ***
Dealt to Duke Croix [9c Tc]
color_singleton: folds 
Manon541: calls 100
JeBoyDirk: folds 
Duke Croix: raises 300 to 400
Manon541: folds 
Uncalled bet (300) returned to Duke Croix
Duke Croix collected 250 from pot
*** SUMMARY ***
Total pot 250 | Rake 0 
Seat 1: JeBoyDirk (small blind) folded before Flop
Seat 4: Duke Croix (big blind) collected (250)
Seat 6: color_singleton folded before Flop (didn't bet)
Seat 9: Manon541 (button) folded before Flop



PokerStars Home Game Hand #217634056556: {Club #3225207}  Hold'em No Limit (50/100) - 2020/08/20 16:50:16 ET
Table 'Manuel Neuer' 9-max (Play Money) Seat #1 is the button
Seat 1: JeBoyDirk (21262 in chips) 
Seat 4: Duke Croix (10566 in chips) 
Seat 6: color_singleton (10770 in chips) 
Seat 9: Manon541 (8202 in chips) 
Duke Croix: posts small blind 50
color_singleton: posts big blind 100
*** HOLE CARDS ***
Dealt to Duke Croix [As 6c]
Manon541: calls 100
JeBoyDirk: folds 
Duke Croix: calls 50
color_singleton: checks 
*** FLOP *** [3h Th 2c]
Duke Croix: checks 
color_singleton: checks 
Manon541: checks 
*** TURN *** [3h Th 2c] [8h]
Duke Croix: checks 
color_singleton: checks 
Manon541: checks 
*** RIVER *** [3h Th 2c 8h] [Ah]
Duke Croix: checks 
color_singleton: bets 283
Manon541: calls 283
Duke Croix: folds 
*** SHOW DOWN ***
color_singleton: shows [Qh 4s] (a flush, Ace high)
Manon541: mucks hand 
color_singleton collected 818 from pot
*** SUMMARY ***
Total pot 866 | Rake 48 
Board [3h Th 2c 8h Ah]
Seat 1: JeBoyDirk (button) folded before Flop (didn't bet)
Seat 4: Duke Croix (small blind) folded on the River
Seat 6: color_singleton (big blind) showed [Qh 4s] and won (818) with a flush, Ace high
Seat 9: Manon541 mucked [Js 2h]



PokerStars Home Game Hand #217634081001: {Club #3225207}  Hold'em No Limit (50/100) - 2020/08/20 16:50:58 ET
Table 'Manuel Neuer' 9-max (Play Money) Seat #4 is the button
Seat 1: JeBoyDirk (21262 in chips) 
Seat 4: Duke Croix (10466 in chips) 
Seat 6: color_singleton (11205 in chips) 
Seat 9: Manon541 (7819 in chips) 
color_singleton: posts small blind 50
Manon541: posts big blind 100
*** HOLE CARDS ***
Dealt to Duke Croix [Qh Ks]
JeBoyDirk: calls 100
Duke Croix: raises 300 to 400
color_singleton: folds 
Manon541: folds 
JeBoyDirk: folds 
Uncalled bet (300) returned to Duke Croix
Duke Croix collected 350 from pot
*** SUMMARY ***
Total pot 350 | Rake 0 
Seat 1: JeBoyDirk folded before Flop
Seat 4: Duke Croix (button) collected (350)
Seat 6: color_singleton (small blind) folded before Flop
Seat 9: Manon541 (big blind) folded before Flop



PokerStars Home Game Hand #217634093572: {Club #3225207}  Hold'em No Limit (50/100) - 2020/08/20 16:51:19 ET
Table 'Manuel Neuer' 9-max (Play Money) Seat #6 is the button
Seat 1: JeBoyDirk (21162 in chips) 
Seat 4: Duke Croix (10716 in chips) 
Seat 6: color_singleton (11155 in chips) 
Seat 9: Manon541 (7719 in chips) 
Manon541: posts small blind 50
JeBoyDirk: posts big blind 100
*** HOLE CARDS ***
Dealt to Duke Croix [Ks 5s]
Duke Croix: calls 100
color_singleton: raises 200 to 300
Manon541: calls 250
JeBoyDirk: folds 
Duke Croix: calls 200
*** FLOP *** [8s 3h 2h]
Manon541: checks 
Duke Croix: checks 
color_singleton: checks 
*** TURN *** [8s 3h 2h] [4c]
Manon541: checks 
Duke Croix: checks 
color_singleton: checks 
*** RIVER *** [8s 3h 2h 4c] [2c]
Manon541: bets 472
Duke Croix: folds 
color_singleton: folds 
Uncalled bet (472) returned to Manon541
Manon541 collected 945 from pot
*** SUMMARY ***
Total pot 1000 | Rake 55 
Board [8s 3h 2h 4c 2c]
Seat 1: JeBoyDirk (big blind) folded before Flop
Seat 4: Duke Croix folded on the River
Seat 6: color_singleton (button) folded on the River
Seat 9: Manon541 (small blind) collected (945)



PokerStars Home Game Hand #217634130088: {Club #3225207}  Hold'em No Limit (50/100) - 2020/08/20 16:52:07 ET
Table 'Manuel Neuer' 9-max (Play Money) Seat #9 is the button
Seat 1: JeBoyDirk (21062 in chips) 
Seat 2: dddocky (8818 in chips) 
Seat 4: Duke Croix (10416 in chips) 
Seat 6: color_singleton (10855 in chips) 
Seat 9: Manon541 (8364 in chips) 
JeBoyDirk: posts small blind 50
dddocky: posts big blind 100
*** HOLE CARDS ***
Dealt to Duke Croix [Jd Kd]
Duke Croix: raises 300 to 400
color_singleton: folds 
Manon541: folds 
JeBoyDirk: calls 350
dddocky: folds 
*** FLOP *** [8c 4c Ts]
JeBoyDirk: checks 
Duke Croix: checks 
*** TURN *** [8c 4c Ts] [2h]
JeBoyDirk: checks 
Duke Croix: checks 
*** RIVER *** [8c 4c Ts 2h] [As]
JeBoyDirk: checks 
Duke Croix: checks 
*** SHOW DOWN ***
JeBoyDirk: shows [Qc Ac] (a pair of Aces)
Duke Croix: mucks hand 
JeBoyDirk collected 850 from pot
*** SUMMARY ***
Total pot 900 | Rake 50 
Board [8c 4c Ts 2h As]
Seat 1: JeBoyDirk (small blind) showed [Qc Ac] and won (850) with a pair of Aces
Seat 2: dddocky (big blind) folded before Flop
Seat 4: Duke Croix mucked [Jd Kd]
Seat 6: color_singleton folded before Flop (didn't bet)
Seat 9: Manon541 (button) folded before Flop (didn't bet)



PokerStars Home Game Hand #217634145851: {Club #3225207}  Hold'em No Limit (50/100) - 2020/08/20 16:52:34 ET
Table 'Manuel Neuer' 9-max (Play Money) Seat #1 is the button
Seat 1: JeBoyDirk (21512 in chips) 
Seat 2: dddocky (8718 in chips) 
Seat 4: Duke Croix (10016 in chips) 
Seat 6: color_singleton (10855 in chips) 
Seat 9: Manon541 (8364 in chips) 
dddocky: posts small blind 50
Duke Croix: posts big blind 100
*** HOLE CARDS ***
Dealt to Duke Croix [2h 9c]
color_singleton: raises 200 to 300
Manon541: folds 
JeBoyDirk: folds 
dddocky: calls 250
Duke Croix: folds 
*** FLOP *** [6s 5h 4c]
dddocky: bets 661
color_singleton: folds 
Uncalled bet (661) returned to dddocky
dddocky collected 661 from pot
dddocky: doesn't show hand 
*** SUMMARY ***
Total pot 700 | Rake 39 
Board [6s 5h 4c]
Seat 1: JeBoyDirk (button) folded before Flop (didn't bet)
Seat 2: dddocky (small blind) collected (661)
Seat 4: Duke Croix (big blind) folded before Flop
Seat 6: color_singleton folded on the Flop
Seat 9: Manon541 folded before Flop (didn't bet)



PokerStars Home Game Hand #217634159001: {Club #3225207}  Hold'em No Limit (50/100) - 2020/08/20 16:52:57 ET
Table 'Manuel Neuer' 9-max (Play Money) Seat #2 is the button
Seat 1: JeBoyDirk (21512 in chips) 
Seat 2: dddocky (9079 in chips) 
Seat 4: Duke Croix (9916 in chips) 
Seat 6: color_singleton (10555 in chips) 
Seat 9: Manon541 (8364 in chips) 
Duke Croix: posts small blind 50
color_singleton: posts big blind 100
*** HOLE CARDS ***
Dealt to Duke Croix [Qs Qc]
Manon541: calls 100
JeBoyDirk: folds 
dddocky: calls 100
Duke Croix: raises 400 to 500
color_singleton: folds 
Manon541: calls 400
dddocky: calls 400
*** FLOP *** [Tc 5d 7c]
Duke Croix: bets 1000
Manon541: folds 
dddocky: folds 
Uncalled bet (1000) returned to Duke Croix
Duke Croix collected 1512 from pot
*** SUMMARY ***
Total pot 1600 | Rake 88 
Board [Tc 5d 7c]
Seat 1: JeBoyDirk folded before Flop (didn't bet)
Seat 2: dddocky (button) folded on the Flop
Seat 4: Duke Croix (small blind) collected (1512)
Seat 6: color_singleton (big blind) folded before Flop
Seat 9: Manon541 folded on the Flop



PokerStars Home Game Hand #217634176892: {Club #3225207}  Hold'em No Limit (50/100) - 2020/08/20 16:53:27 ET
Table 'Manuel Neuer' 9-max (Play Money) Seat #4 is the button
Seat 1: JeBoyDirk (21512 in chips) 
Seat 2: dddocky (8579 in chips) 
Seat 4: Duke Croix (10928 in chips) 
Seat 6: color_singleton (10455 in chips) 
Seat 9: Manon541 (7864 in chips) 
color_singleton: posts small blind 50
Manon541: posts big blind 100
*** HOLE CARDS ***
Dealt to Duke Croix [6s Td]
JeBoyDirk: folds 
dddocky: folds 
Duke Croix: folds 
color_singleton: raises 200 to 300
Manon541: folds 
Uncalled bet (200) returned to color_singleton
color_singleton collected 200 from pot
color_singleton: doesn't show hand 
*** SUMMARY ***
Total pot 200 | Rake 0 
Seat 1: JeBoyDirk folded before Flop (didn't bet)
Seat 2: dddocky folded before Flop (didn't bet)
Seat 4: Duke Croix (button) folded before Flop (didn't bet)
Seat 6: color_singleton (small blind) collected (200)
Seat 9: Manon541 (big blind) folded before Flop



PokerStars Home Game Hand #217634182130: {Club #3225207}  Hold'em No Limit (50/100) - 2020/08/20 16:53:36 ET
Table 'Manuel Neuer' 9-max (Play Money) Seat #6 is the button
Seat 1: JeBoyDirk (21512 in chips) 
Seat 2: dddocky (8579 in chips) 
Seat 4: Duke Croix (10928 in chips) 
Seat 6: color_singleton (10555 in chips) 
Seat 9: Manon541 (7764 in chips) 
Manon541: posts small blind 50
JeBoyDirk: posts big blind 100
*** HOLE CARDS ***
Dealt to Duke Croix [8s 3d]
dddocky: calls 100
Duke Croix: folds 
color_singleton: raises 100 to 200
Manon541: folds 
JeBoyDirk: folds 
dddocky: calls 100
*** FLOP *** [3s Kc As]
dddocky: checks 
color_singleton: checks 
*** TURN *** [3s Kc As] [Ah]
dddocky: bets 520
color_singleton: folds 
Uncalled bet (520) returned to dddocky
dddocky collected 520 from pot
dddocky: doesn't show hand 
*** SUMMARY ***
Total pot 550 | Rake 30 
Board [3s Kc As Ah]
Seat 1: JeBoyDirk (big blind) folded before Flop
Seat 2: dddocky collected (520)
Seat 4: Duke Croix folded before Flop (didn't bet)
Seat 6: color_singleton (button) folded on the Turn
Seat 9: Manon541 (small blind) folded before Flop



PokerStars Home Game Hand #217634197315: {Club #3225207}  Hold'em No Limit (50/100) - 2020/08/20 16:54:03 ET
Table 'Manuel Neuer' 9-max (Play Money) Seat #9 is the button
Seat 1: JeBoyDirk (21412 in chips) 
Seat 2: dddocky (8899 in chips) 
Seat 4: Duke Croix (10928 in chips) 
Seat 6: color_singleton (10355 in chips) 
Seat 9: Manon541 (7714 in chips) 
JeBoyDirk: posts small blind 50
dddocky: posts big blind 100
*** HOLE CARDS ***
Dealt to Duke Croix [As Td]
Duke Croix: raises 300 to 400
color_singleton: folds 
Manon541: calls 400
JeBoyDirk: folds 
dddocky: calls 300
*** FLOP *** [Kh 5d 7s]
dddocky: bets 590
Duke Croix: folds 
Manon541: folds 
Uncalled bet (590) returned to dddocky
dddocky collected 1181 from pot
dddocky: doesn't show hand 
*** SUMMARY ***
Total pot 1250 | Rake 69 
Board [Kh 5d 7s]
Seat 1: JeBoyDirk (small blind) folded before Flop
Seat 2: dddocky (big blind) collected (1181)
Seat 4: Duke Croix folded on the Flop
Seat 6: color_singleton folded before Flop (didn't bet)
Seat 9: Manon541 (button) folded on the Flop



PokerStars Home Game Hand #217634216239: {Club #3225207}  Hold'em No Limit (50/100) - 2020/08/20 16:54:35 ET
Table 'Manuel Neuer' 9-max (Play Money) Seat #1 is the button
Seat 1: JeBoyDirk (21362 in chips) 
Seat 2: dddocky (9680 in chips) 
Seat 4: Duke Croix (10528 in chips) 
Seat 6: color_singleton (10355 in chips) 
Seat 9: Manon541 (7314 in chips) 
dddocky: posts small blind 50
Duke Croix: posts big blind 100
*** HOLE CARDS ***
Dealt to Duke Croix [Kc As]
color_singleton: folds 
Manon541: calls 100
JeBoyDirk: folds 
dddocky: calls 50
Duke Croix: raises 400 to 500
Manon541: folds 
dddocky: calls 400
*** FLOP *** [5h Qh Ad]
dddocky: bets 519
Duke Croix: calls 519
*** TURN *** [5h Qh Ad] [4h]
dddocky: bets 2020
Duke Croix: folds 
Uncalled bet (2020) returned to dddocky
dddocky collected 2020 from pot
dddocky: doesn't show hand 
*** SUMMARY ***
Total pot 2138 | Rake 118 
Board [5h Qh Ad 4h]
Seat 1: JeBoyDirk (button) folded before Flop (didn't bet)
Seat 2: dddocky (small blind) collected (2020)
Seat 4: Duke Croix (big blind) folded on the Turn
Seat 6: color_singleton folded before Flop (didn't bet)
Seat 9: Manon541 folded before Flop



PokerStars Home Game Hand #217634242406: {Club #3225207}  Hold'em No Limit (50/100) - 2020/08/20 16:55:26 ET
Table 'Manuel Neuer' 9-max (Play Money) Seat #2 is the button
Seat 1: JeBoyDirk (21362 in chips) 
Seat 2: dddocky (10681 in chips) 
Seat 4: Duke Croix (9509 in chips) 
Seat 6: color_singleton (10355 in chips) 
Seat 9: Manon541 (7214 in chips) 
Duke Croix: posts small blind 50
color_singleton: posts big blind 100
*** HOLE CARDS ***
Dealt to Duke Croix [4d Qc]
Manon541: calls 100
JeBoyDirk: calls 100
dddocky: calls 100
Duke Croix: calls 50
color_singleton: raises 200 to 300
Manon541: folds 
JeBoyDirk: calls 200
dddocky: calls 200
Duke Croix: calls 200
*** FLOP *** [Td 8d Ah]
Duke Croix: checks 
color_singleton: bets 614
JeBoyDirk: folds 
dddocky: raises 614 to 1228
Duke Croix: folds 
color_singleton: folds 
Uncalled bet (614) returned to dddocky
dddocky collected 2389 from pot
dddocky: doesn't show hand 
*** SUMMARY ***
Total pot 2528 | Rake 139 
Board [Td 8d Ah]
Seat 1: JeBoyDirk folded on the Flop
Seat 2: dddocky (button) collected (2389)
Seat 4: Duke Croix (small blind) folded on the Flop
Seat 6: color_singleton (big blind) folded on the Flop
Seat 9: Manon541 folded before Flop



PokerStars Home Game Hand #217634265007: {Club #3225207}  Hold'em No Limit (50/100) - 2020/08/20 16:56:18 ET
Table 'Manuel Neuer' 9-max (Play Money) Seat #4 is the button
Seat 1: JeBoyDirk (21062 in chips) 
Seat 2: dddocky (12156 in chips) 
Seat 4: Duke Croix (9209 in chips) 
Seat 6: color_singleton (9441 in chips) 
Seat 9: Manon541 (7114 in chips) 
color_singleton: posts small blind 50
Manon541: posts big blind 100
*** HOLE CARDS ***
Dealt to Duke Croix [Jh Jc]
JeBoyDirk: folds 
dddocky: folds 
Duke Croix: raises 300 to 400
color_singleton: folds 
Manon541: folds 
Uncalled bet (300) returned to Duke Croix
Duke Croix collected 250 from pot
*** SUMMARY ***
Total pot 250 | Rake 0 
Seat 1: JeBoyDirk folded before Flop (didn't bet)
Seat 2: dddocky folded before Flop (didn't bet)
Seat 4: Duke Croix (button) collected (250)
Seat 6: color_singleton (small blind) folded before Flop
Seat 9: Manon541 (big blind) folded before Flop



PokerStars Home Game Hand #217634270435: {Club #3225207}  Hold'em No Limit (50/100) - 2020/08/20 16:56:30 ET
Table 'Manuel Neuer' 9-max (Play Money) Seat #6 is the button
Seat 1: JeBoyDirk (21062 in chips) 
Seat 2: dddocky (12156 in chips) 
Seat 4: Duke Croix (9359 in chips) 
Seat 6: color_singleton (9391 in chips) 
Seat 9: Manon541 (7014 in chips) 
Manon541: posts small blind 50
JeBoyDirk: posts big blind 100
*** HOLE CARDS ***
Dealt to Duke Croix [As 5d]
dddocky: calls 100
Duke Croix: raises 300 to 400
color_singleton: folds 
Manon541: folds 
JeBoyDirk: calls 300
dddocky: folds 
*** FLOP *** [7c 3h Ks]
JeBoyDirk: checks 
Duke Croix: checks 
*** TURN *** [7c 3h Ks] [Ah]
JeBoyDirk: checks 
Duke Croix: bets 400
JeBoyDirk: folds 
Uncalled bet (400) returned to Duke Croix
Duke Croix collected 898 from pot
*** SUMMARY ***
Total pot 950 | Rake 52 
Board [7c 3h Ks Ah]
Seat 1: JeBoyDirk (big blind) folded on the Turn
Seat 2: dddocky folded before Flop
Seat 4: Duke Croix collected (898)
Seat 6: color_singleton (button) folded before Flop (didn't bet)
Seat 9: Manon541 (small blind) folded before Flop



PokerStars Home Game Hand #217634282802: {Club #3225207}  Hold'em No Limit (50/100) - 2020/08/20 16:56:58 ET
Table 'Manuel Neuer' 9-max (Play Money) Seat #9 is the button
Seat 1: JeBoyDirk (20662 in chips) 
Seat 2: dddocky (12056 in chips) 
Seat 4: Duke Croix (9857 in chips) 
Seat 6: color_singleton (9391 in chips) 
Seat 9: Manon541 (6964 in chips) 
JeBoyDirk: posts small blind 50
dddocky: posts big blind 100
*** HOLE CARDS ***
Dealt to Duke Croix [8s Kh]
Duke Croix: raises 200 to 300
color_singleton: folds 
Manon541: calls 300
JeBoyDirk: folds 
dddocky: folds 
*** FLOP *** [Qd 8c 4c]
Duke Croix: checks 
Manon541: checks 
*** TURN *** [Qd 8c 4c] [Qc]
Duke Croix: bets 400
Manon541: folds 
Uncalled bet (400) returned to Duke Croix
Duke Croix collected 709 from pot
*** SUMMARY ***
Total pot 750 | Rake 41 
Board [Qd 8c 4c Qc]
Seat 1: JeBoyDirk (small blind) folded before Flop
Seat 2: dddocky (big blind) folded before Flop
Seat 4: Duke Croix collected (709)
Seat 6: color_singleton folded before Flop (didn't bet)
Seat 9: Manon541 (button) folded on the Turn



PokerStars Home Game Hand #217634292146: {Club #3225207}  Hold'em No Limit (50/100) - 2020/08/20 16:57:19 ET
Table 'Manuel Neuer' 9-max (Play Money) Seat #1 is the button
Seat 1: JeBoyDirk (20612 in chips) 
Seat 2: dddocky (11956 in chips) 
Seat 4: Duke Croix (10266 in chips) 
Seat 6: color_singleton (9391 in chips) 
Seat 9: Manon541 (6664 in chips) 
dddocky: posts small blind 50
Duke Croix: posts big blind 100
*** HOLE CARDS ***
Dealt to Duke Croix [8c Ts]
color_singleton: raises 200 to 300
Manon541: folds 
JeBoyDirk: raises 200 to 500
dddocky: folds 
Duke Croix: folds 
color_singleton: calls 200
*** FLOP *** [2c Qs Qc]
color_singleton: checks 
JeBoyDirk: bets 900
color_singleton: folds 
Uncalled bet (900) returned to JeBoyDirk
JeBoyDirk collected 1087 from pot
*** SUMMARY ***
Total pot 1150 | Rake 63 
Board [2c Qs Qc]
Seat 1: JeBoyDirk (button) collected (1087)
Seat 2: dddocky (small blind) folded before Flop
Seat 4: Duke Croix (big blind) folded before Flop
Seat 6: color_singleton folded on the Flop
Seat 9: Manon541 folded before Flop (didn't bet)



PokerStars Home Game Hand #217634306238: {Club #3225207}  Hold'em No Limit (50/100) - 2020/08/20 16:57:51 ET
Table 'Manuel Neuer' 9-max (Play Money) Seat #2 is the button
Seat 1: JeBoyDirk (21199 in chips) 
Seat 2: dddocky (11906 in chips) 
Seat 4: Duke Croix (10166 in chips) 
Seat 6: color_singleton (8891 in chips) 
Seat 9: Manon541 (6664 in chips) 
Duke Croix: posts small blind 50
color_singleton: posts big blind 100
*** HOLE CARDS ***
Dealt to Duke Croix [Qd Td]
Manon541: calls 100
JeBoyDirk: folds 
dddocky: calls 100
Duke Croix: raises 300 to 400
color_singleton: folds 
Manon541: calls 300
dddocky: folds 
*** FLOP *** [Jc Qh Kc]
Duke Croix: bets 500
Manon541: calls 500
*** TURN *** [Jc Qh Kc] [7d]
Duke Croix: bets 1000
Manon541: folds 
Uncalled bet (1000) returned to Duke Croix
Duke Croix collected 1890 from pot
*** SUMMARY ***
Total pot 2000 | Rake 110 
Board [Jc Qh Kc 7d]
Seat 1: JeBoyDirk folded before Flop (didn't bet)
Seat 2: dddocky (button) folded before Flop
Seat 4: Duke Croix (small blind) collected (1890)
Seat 6: color_singleton (big blind) folded before Flop
Seat 9: Manon541 folded on the Turn



PokerStars Home Game Hand #217634321263: {Club #3225207}  Hold'em No Limit (50/100) - 2020/08/20 16:58:25 ET
Table 'Manuel Neuer' 9-max (Play Money) Seat #4 is the button
Seat 1: JeBoyDirk (21199 in chips) 
Seat 2: dddocky (11806 in chips) 
Seat 4: Duke Croix (11156 in chips) 
Seat 6: color_singleton (8791 in chips) 
Seat 9: Manon541 (5764 in chips) 
color_singleton: posts small blind 50
Manon541: posts big blind 100
*** HOLE CARDS ***
Dealt to Duke Croix [7d 4d]
JeBoyDirk: folds 
dddocky: folds 
Duke Croix: folds 
color_singleton: calls 50
Manon541: checks 
*** FLOP *** [Td 3s 6s]
color_singleton: checks 
Manon541: checks 
*** TURN *** [Td 3s 6s] [As]
color_singleton: checks 
Manon541: checks 
*** RIVER *** [Td 3s 6s As] [Jc]
color_singleton: checks 
Manon541: checks 
*** SHOW DOWN ***
color_singleton: shows [9h 2h] (high card Ace)
Manon541: shows [8s 3c] (a pair of Threes)
Manon541 collected 189 from pot
*** SUMMARY ***
Total pot 200 | Rake 11 
Board [Td 3s 6s As Jc]
Seat 1: JeBoyDirk folded before Flop (didn't bet)
Seat 2: dddocky folded before Flop (didn't bet)
Seat 4: Duke Croix (button) folded before Flop (didn't bet)
Seat 6: color_singleton (small blind) showed [9h 2h] and lost with high card Ace
Seat 9: Manon541 (big blind) showed [8s 3c] and won (189) with a pair of Threes



PokerStars Home Game Hand #217634337656: {Club #3225207}  Hold'em No Limit (50/100) - 2020/08/20 16:59:02 ET
Table 'Manuel Neuer' 9-max (Play Money) Seat #6 is the button
Seat 1: JeBoyDirk (21199 in chips) 
Seat 2: dddocky (11806 in chips) 
Seat 4: Duke Croix (11156 in chips) 
Seat 6: color_singleton (8691 in chips) 
Seat 9: Manon541 (5853 in chips) 
Manon541: posts small blind 50
JeBoyDirk: posts big blind 100
*** HOLE CARDS ***
Dealt to Duke Croix [7h 8d]
dddocky: calls 100
Duke Croix: raises 200 to 300
color_singleton: folds 
Manon541: folds 
JeBoyDirk: calls 200
dddocky: calls 200
*** FLOP *** [Qc 5h 4s]
JeBoyDirk: checks 
dddocky: checks 
Duke Croix: checks 
*** TURN *** [Qc 5h 4s] [Kc]
JeBoyDirk: bets 300
dddocky: calls 300
Duke Croix: folds 
*** RIVER *** [Qc 5h 4s Kc] [8h]
JeBoyDirk: checks 
dddocky: checks 
*** SHOW DOWN ***
JeBoyDirk: shows [Kd 7d] (a pair of Kings)
dddocky: mucks hand 
JeBoyDirk collected 1465 from pot
*** SUMMARY ***
Total pot 1550 | Rake 85 
Board [Qc 5h 4s Kc 8h]
Seat 1: JeBoyDirk (big blind) showed [Kd 7d] and won (1465) with a pair of Kings
Seat 2: dddocky mucked [Th Js]
Seat 4: Duke Croix folded on the Turn
Seat 6: color_singleton (button) folded before Flop (didn't bet)
Seat 9: Manon541 (small blind) folded before Flop



PokerStars Home Game Hand #217634356195: {Club #3225207}  Hold'em No Limit (50/100) - 2020/08/20 16:59:44 ET
Table 'Manuel Neuer' 9-max (Play Money) Seat #9 is the button
Seat 1: JeBoyDirk (22064 in chips) 
Seat 2: dddocky (11206 in chips) 
Seat 4: Duke Croix (10856 in chips) 
Seat 6: color_singleton (8691 in chips) 
Seat 9: Manon541 (5803 in chips) 
JeBoyDirk: posts small blind 50
dddocky: posts big blind 100
*** HOLE CARDS ***
Dealt to Duke Croix [Jd Kd]
Duke Croix: raises 300 to 400
color_singleton: folds 
Manon541: folds 
JeBoyDirk: folds 
dddocky: calls 300
*** FLOP *** [9h 8h As]
dddocky: bets 803
Duke Croix: folds 
Uncalled bet (803) returned to dddocky
dddocky collected 803 from pot
dddocky: doesn't show hand 
*** SUMMARY ***
Total pot 850 | Rake 47 
Board [9h 8h As]
Seat 1: JeBoyDirk (small blind) folded before Flop
Seat 2: dddocky (big blind) collected (803)
Seat 4: Duke Croix folded on the Flop
Seat 6: color_singleton folded before Flop (didn't bet)
Seat 9: Manon541 (button) folded before Flop (didn't bet)



PokerStars Home Game Hand #217634366587: {Club #3225207}  Hold'em No Limit (50/100) - 2020/08/20 17:00:07 ET
Table 'Manuel Neuer' 9-max (Play Money) Seat #1 is the button
Seat 1: JeBoyDirk (22014 in chips) 
Seat 2: dddocky (11609 in chips) 
Seat 4: Duke Croix (10456 in chips) 
Seat 6: color_singleton (8691 in chips) 
Seat 9: Manon541 (5803 in chips) 
dddocky: posts small blind 50
Duke Croix: posts big blind 100
*** HOLE CARDS ***
Dealt to Duke Croix [Kh Ks]
color_singleton: folds 
Manon541: calls 100
JeBoyDirk: folds 
dddocky: calls 50
Duke Croix: raises 400 to 500
Manon541: calls 400
dddocky: calls 400
*** FLOP *** [8s Qs 2c]
dddocky: checks 
Duke Croix: bets 1000
Manon541: folds 
dddocky: calls 1000
*** TURN *** [8s Qs 2c] [Td]
dddocky: checks 
Duke Croix: bets 1200
dddocky: folds 
Uncalled bet (1200) returned to Duke Croix
Duke Croix collected 3307 from pot
*** SUMMARY ***
Total pot 3500 | Rake 193 
Board [8s Qs 2c Td]
Seat 1: JeBoyDirk (button) folded before Flop (didn't bet)
Seat 2: dddocky (small blind) folded on the Turn
Seat 4: Duke Croix (big blind) collected (3307)
Seat 6: color_singleton folded before Flop (didn't bet)
Seat 9: Manon541 folded on the Flop



PokerStars Home Game Hand #217634387935: {Club #3225207}  Hold'em No Limit (50/100) - 2020/08/20 17:00:52 ET
Table 'Manuel Neuer' 9-max (Play Money) Seat #2 is the button
Seat 1: JeBoyDirk (22014 in chips) 
Seat 2: dddocky (10109 in chips) 
Seat 4: Duke Croix (12263 in chips) 
Seat 6: color_singleton (8691 in chips) 
Seat 9: Manon541 (5303 in chips) 
Duke Croix: posts small blind 50
color_singleton: posts big blind 100
*** HOLE CARDS ***
Dealt to Duke Croix [Js 3h]
Manon541: calls 100
JeBoyDirk: calls 100
dddocky: calls 100
Duke Croix: calls 50
color_singleton: checks 
*** FLOP *** [Ah Ks Jd]
Duke Croix: checks 
color_singleton: checks 
Manon541: bets 236
JeBoyDirk: folds 
dddocky: calls 236
Duke Croix: folds 
color_singleton: folds 
*** TURN *** [Ah Ks Jd] [2c]
Manon541: bets 459
dddocky: folds 
Uncalled bet (459) returned to Manon541
Manon541 collected 919 from pot
*** SUMMARY ***
Total pot 972 | Rake 53 
Board [Ah Ks Jd 2c]
Seat 1: JeBoyDirk folded on the Flop
Seat 2: dddocky (button) folded on the Turn
Seat 4: Duke Croix (small blind) folded on the Flop
Seat 6: color_singleton (big blind) folded on the Flop
Seat 9: Manon541 collected (919)



PokerStars Home Game Hand #217634412579: {Club #3225207}  Hold'em No Limit (50/100) - 2020/08/20 17:01:38 ET
Table 'Manuel Neuer' 9-max (Play Money) Seat #4 is the button
Seat 1: JeBoyDirk (21914 in chips) 
Seat 2: dddocky (9773 in chips) 
Seat 4: Duke Croix (12163 in chips) 
Seat 6: color_singleton (8591 in chips) 
Seat 9: Manon541 (5886 in chips) 
color_singleton: posts small blind 50
Manon541: posts big blind 100
*** HOLE CARDS ***
Dealt to Duke Croix [2s Qh]
JeBoyDirk: folds 
dddocky: calls 100
Duke Croix: folds 
color_singleton: calls 50
Manon541: checks 
*** FLOP *** [8h 9c Ac]
color_singleton: bets 141
Manon541: folds 
dddocky: calls 141
*** TURN *** [8h 9c Ac] [9s]
color_singleton: bets 275
dddocky: calls 275
*** RIVER *** [8h 9c Ac 9s] [Jc]
color_singleton: checks 
dddocky: checks 
*** SHOW DOWN ***
color_singleton: shows [7h 6s] (a pair of Nines)
dddocky: shows [3d Ad] (two pair, Aces and Nines)
dddocky collected 1070 from pot
*** SUMMARY ***
Total pot 1132 | Rake 62 
Board [8h 9c Ac 9s Jc]
Seat 1: JeBoyDirk folded before Flop (didn't bet)
Seat 2: dddocky showed [3d Ad] and won (1070) with two pair, Aces and Nines
Seat 4: Duke Croix (button) folded before Flop (didn't bet)
Seat 6: color_singleton (small blind) showed [7h 6s] and lost with a pair of Nines
Seat 9: Manon541 (big blind) folded on the Flop



PokerStars Home Game Hand #217634431863: {Club #3225207}  Hold'em No Limit (50/100) - 2020/08/20 17:02:12 ET
Table 'Manuel Neuer' 9-max (Play Money) Seat #6 is the button
Seat 1: JeBoyDirk (21914 in chips) 
Seat 2: dddocky (10327 in chips) 
Seat 4: Duke Croix (12163 in chips) 
Seat 6: color_singleton (8075 in chips) 
Seat 9: Manon541 (5786 in chips) 
Manon541: posts small blind 50
JeBoyDirk: posts big blind 100
*** HOLE CARDS ***
Dealt to Duke Croix [Qc As]
dddocky: calls 100
Duke Croix: raises 300 to 400
color_singleton: calls 400
Manon541: folds 
JeBoyDirk: calls 300
dddocky: calls 300
*** FLOP *** [6c 8h Kc]
JeBoyDirk: checks 
dddocky: checks 
Duke Croix: checks 
color_singleton: checks 
*** TURN *** [6c 8h Kc] [8c]
JeBoyDirk: bets 500
dddocky: folds 
Duke Croix: calls 500
color_singleton: folds 
*** RIVER *** [6c 8h Kc 8c] [9h]
JeBoyDirk: bets 1000
Duke Croix: folds 
Uncalled bet (1000) returned to JeBoyDirk
JeBoyDirk collected 2504 from pot
*** SUMMARY ***
Total pot 2650 | Rake 146 
Board [6c 8h Kc 8c 9h]
Seat 1: JeBoyDirk (big blind) collected (2504)
Seat 2: dddocky folded on the Turn
Seat 4: Duke Croix folded on the River
Seat 6: color_singleton (button) folded on the Turn
Seat 9: Manon541 (small blind) folded before Flop



PokerStars Home Game Hand #217634461060: {Club #3225207}  Hold'em No Limit (50/100) - 2020/08/20 17:03:04 ET
Table 'Manuel Neuer' 9-max (Play Money) Seat #9 is the button
Seat 1: JeBoyDirk (23518 in chips) 
Seat 2: dddocky (9927 in chips) 
Seat 4: Duke Croix (11263 in chips) 
Seat 6: color_singleton (7675 in chips) 
Seat 9: Manon541 (5736 in chips) 
JeBoyDirk: posts small blind 50
dddocky: posts big blind 100
*** HOLE CARDS ***
Dealt to Duke Croix [3s 5s]
Duke Croix: folds 
color_singleton: folds 
Manon541: folds 
JeBoyDirk: folds 
Uncalled bet (50) returned to dddocky
dddocky collected 100 from pot
*** SUMMARY ***
Total pot 100 | Rake 0 
Seat 1: JeBoyDirk (small blind) folded before Flop
Seat 2: dddocky (big blind) collected (100)
Seat 4: Duke Croix folded before Flop (didn't bet)
Seat 6: color_singleton folded before Flop (didn't bet)
Seat 9: Manon541 (button) folded before Flop (didn't bet)



PokerStars Home Game Hand #217634467636: {Club #3225207}  Hold'em No Limit (50/100) - 2020/08/20 17:03:15 ET
Table 'Manuel Neuer' 9-max (Play Money) Seat #1 is the button
Seat 1: JeBoyDirk (23468 in chips) 
Seat 2: dddocky (9977 in chips) 
Seat 4: Duke Croix (11263 in chips) 
Seat 6: color_singleton (7675 in chips) 
Seat 9: Manon541 (5736 in chips) 
dddocky: posts small blind 50
Duke Croix: posts big blind 100
*** HOLE CARDS ***
Dealt to Duke Croix [Ad 6h]
color_singleton: folds 
Manon541: calls 100
JeBoyDirk: folds 
dddocky: folds 
Duke Croix: checks 
*** FLOP *** [5h 3d 7s]
Duke Croix: checks 
Manon541: checks 
*** TURN *** [5h 3d 7s] [4d]
Duke Croix: bets 200
Manon541: calls 200
*** RIVER *** [5h 3d 7s 4d] [9s]
Duke Croix: bets 400
Manon541: folds 
Uncalled bet (400) returned to Duke Croix
Duke Croix collected 614 from pot
*** SUMMARY ***
Total pot 650 | Rake 36 
Board [5h 3d 7s 4d 9s]
Seat 1: JeBoyDirk (button) folded before Flop (didn't bet)
Seat 2: dddocky (small blind) folded before Flop
Seat 4: Duke Croix (big blind) collected (614)
Seat 6: color_singleton folded before Flop (didn't bet)
Seat 9: Manon541 folded on the River



PokerStars Home Game Hand #217634490773: {Club #3225207}  Hold'em No Limit (50/100) - 2020/08/20 17:03:55 ET
Table 'Manuel Neuer' 9-max (Play Money) Seat #2 is the button
Seat 1: JeBoyDirk (23468 in chips) 
Seat 2: dddocky (9927 in chips) 
Seat 4: Duke Croix (11577 in chips) 
Seat 6: color_singleton (7675 in chips) 
Seat 9: Manon541 (5436 in chips) 
Duke Croix: posts small blind 50
color_singleton: posts big blind 100
*** HOLE CARDS ***
Dealt to Duke Croix [3c 8h]
Manon541: folds 
JeBoyDirk: folds 
dddocky: folds 
Duke Croix: calls 50
color_singleton: checks 
*** FLOP *** [Kd 2d Jh]
Duke Croix: checks 
color_singleton: bets 100
Duke Croix: folds 
Uncalled bet (100) returned to color_singleton
color_singleton collected 189 from pot
color_singleton: doesn't show hand 
*** SUMMARY ***
Total pot 200 | Rake 11 
Board [Kd 2d Jh]
Seat 1: JeBoyDirk folded before Flop (didn't bet)
Seat 2: dddocky (button) folded before Flop (didn't bet)
Seat 4: Duke Croix (small blind) folded on the Flop
Seat 6: color_singleton (big blind) collected (189)
Seat 9: Manon541 folded before Flop (didn't bet)



PokerStars Home Game Hand #217634510131: {Club #3225207}  Hold'em No Limit (50/100) - 2020/08/20 17:04:29 ET
Table 'Manuel Neuer' 9-max (Play Money) Seat #4 is the button
Seat 1: JeBoyDirk (23468 in chips) 
Seat 2: dddocky (9927 in chips) 
Seat 4: Duke Croix (11477 in chips) 
Seat 6: color_singleton (7764 in chips) 
Seat 9: Manon541 (5436 in chips) 
color_singleton: posts small blind 50
Manon541: posts big blind 100
*** HOLE CARDS ***
Dealt to Duke Croix [7d As]
JeBoyDirk: calls 100
dddocky: calls 100
Duke Croix: raises 400 to 500
color_singleton: folds 
Manon541: calls 400
JeBoyDirk: calls 400
dddocky: folds 
*** FLOP *** [Js 2d Qc]
Manon541: checks 
JeBoyDirk: checks 
Duke Croix: checks 
*** TURN *** [Js 2d Qc] [3d]
Manon541: checks 
JeBoyDirk: checks 
Duke Croix: checks 
*** RIVER *** [Js 2d Qc 3d] [Ks]
Manon541: checks 
JeBoyDirk: checks 
Duke Croix: checks 
*** SHOW DOWN ***
Manon541: shows [Ad 3h] (a pair of Threes)
JeBoyDirk: mucks hand 
Duke Croix: mucks hand 
Manon541 collected 1559 from pot
*** SUMMARY ***
Total pot 1650 | Rake 91 
Board [Js 2d Qc 3d Ks]
Seat 1: JeBoyDirk mucked [6h 7h]
Seat 2: dddocky folded before Flop
Seat 4: Duke Croix (button) mucked [7d As]
Seat 6: color_singleton (small blind) folded before Flop
Seat 9: Manon541 (big blind) showed [Ad 3h] and won (1559) with a pair of Threes



PokerStars Home Game Hand #217634534964: {Club #3225207}  Hold'em No Limit (50/100) - 2020/08/20 17:05:12 ET
Table 'Manuel Neuer' 9-max (Play Money) Seat #6 is the button
Seat 1: JeBoyDirk (22968 in chips) 
Seat 2: dddocky (9827 in chips) 
Seat 4: Duke Croix (10977 in chips) 
Seat 6: color_singleton (7714 in chips) 
Seat 9: Manon541 (6495 in chips) 
Manon541: posts small blind 50
JeBoyDirk: posts big blind 100
*** HOLE CARDS ***
Dealt to Duke Croix [Kc 8d]
dddocky: calls 100
Duke Croix: calls 100
color_singleton: folds 
Manon541: calls 50
JeBoyDirk: checks 
*** FLOP *** [Ks 5h Jh]
Manon541: checks 
JeBoyDirk: checks 
dddocky: checks 
Duke Croix: bets 200
Manon541: calls 200
JeBoyDirk: folds 
dddocky: folds 
*** TURN *** [Ks 5h Jh] [Td]
Manon541: checks 
Duke Croix: bets 400
Manon541: calls 400
*** RIVER *** [Ks 5h Jh Td] [Js]
Manon541: bets 1512
Duke Croix: folds 
Uncalled bet (1512) returned to Manon541
Manon541 collected 1512 from pot
*** SUMMARY ***
Total pot 1600 | Rake 88 
Board [Ks 5h Jh Td Js]
Seat 1: JeBoyDirk (big blind) folded on the Flop
Seat 2: dddocky folded on the Flop
Seat 4: Duke Croix folded on the River
Seat 6: color_singleton (button) folded before Flop (didn't bet)
Seat 9: Manon541 (small blind) collected (1512)



PokerStars Home Game Hand #217634572119: {Club #3225207}  Hold'em No Limit (50/100) - 2020/08/20 17:06:17 ET
Table 'Manuel Neuer' 9-max (Play Money) Seat #9 is the button
Seat 1: JeBoyDirk (22868 in chips) 
Seat 2: dddocky (9727 in chips) 
Seat 4: Duke Croix (10277 in chips) 
Seat 6: color_singleton (7714 in chips) 
Seat 9: Manon541 (7307 in chips) 
JeBoyDirk: posts small blind 50
dddocky: posts big blind 100
*** HOLE CARDS ***
Dealt to Duke Croix [7h 7d]
Duke Croix: raises 200 to 300
color_singleton: calls 300
Manon541: calls 300
JeBoyDirk: calls 250
dddocky: folds 
*** FLOP *** [Qh Ah Jh]
JeBoyDirk: checks 
Duke Croix: checks 
color_singleton: checks 
Manon541: bets 614
JeBoyDirk: folds 
Duke Croix: folds 
color_singleton: folds 
Uncalled bet (614) returned to Manon541
Manon541 collected 1228 from pot
*** SUMMARY ***
Total pot 1300 | Rake 72 
Board [Qh Ah Jh]
Seat 1: JeBoyDirk (small blind) folded on the Flop
Seat 2: dddocky (big blind) folded before Flop
Seat 4: Duke Croix folded on the Flop
Seat 6: color_singleton folded on the Flop
Seat 9: Manon541 (button) collected (1228)



PokerStars Home Game Hand #217634596254: {Club #3225207}  Hold'em No Limit (50/100) - 2020/08/20 17:06:59 ET
Table 'Manuel Neuer' 9-max (Play Money) Seat #1 is the button
Seat 1: JeBoyDirk (22568 in chips) 
Seat 2: dddocky (9627 in chips) 
Seat 4: Duke Croix (9977 in chips) 
Seat 6: color_singleton (7414 in chips) 
Seat 9: Manon541 (8235 in chips) 
dddocky: posts small blind 50
Duke Croix: posts big blind 100
*** HOLE CARDS ***
Dealt to Duke Croix [5s 2c]
color_singleton: raises 100 to 200
Manon541: folds 
JeBoyDirk: folds 
dddocky: calls 150
Duke Croix: calls 100
*** FLOP *** [3h Td Qs]
dddocky: bets 100
Duke Croix: folds 
color_singleton: calls 100
*** TURN *** [3h Td Qs] [Jh]
dddocky: bets 100
color_singleton: calls 100
*** RIVER *** [3h Td Qs Jh] [2d]
dddocky: checks 
color_singleton: checks 
*** SHOW DOWN ***
dddocky: shows [4h Qh] (a pair of Queens)
color_singleton: mucks hand 
dddocky collected 945 from pot
*** SUMMARY ***
Total pot 1000 | Rake 55 
Board [3h Td Qs Jh 2d]
Seat 1: JeBoyDirk (button) folded before Flop (didn't bet)
Seat 2: dddocky (small blind) showed [4h Qh] and won (945) with a pair of Queens
Seat 4: Duke Croix (big blind) folded on the Flop
Seat 6: color_singleton mucked [7d Kc]
Seat 9: Manon541 folded before Flop (didn't bet)



PokerStars Home Game Hand #217634608512: {Club #3225207}  Hold'em No Limit (50/100) - 2020/08/20 17:07:20 ET
Table 'Manuel Neuer' 9-max (Play Money) Seat #2 is the button
Seat 1: JeBoyDirk (22568 in chips) 
Seat 2: dddocky (10172 in chips) 
Seat 4: Duke Croix (9777 in chips) 
Seat 6: color_singleton (7014 in chips) 
Seat 9: Manon541 (8235 in chips) 
Duke Croix: posts small blind 50
color_singleton: posts big blind 100
*** HOLE CARDS ***
Dealt to Duke Croix [6d Kd]
Manon541: calls 100
JeBoyDirk: folds 
dddocky: folds 
Duke Croix: calls 50
color_singleton: raises 200 to 300
Manon541: calls 200
Duke Croix: calls 200
*** FLOP *** [3s 8c 8s]
Duke Croix: checks 
color_singleton: bets 425
Manon541: calls 425
Duke Croix: folds 
*** TURN *** [3s 8c 8s] [Td]
color_singleton: checks 
Manon541: checks 
*** RIVER *** [3s 8c 8s Td] [9h]
color_singleton: checks 
Manon541: checks 
*** SHOW DOWN ***
color_singleton: shows [Jh Ad] (a pair of Eights)
Manon541: mucks hand 
color_singleton collected 1654 from pot
*** SUMMARY ***
Total pot 1750 | Rake 96 
Board [3s 8c 8s Td 9h]
Seat 1: JeBoyDirk folded before Flop (didn't bet)
Seat 2: dddocky (button) folded before Flop (didn't bet)
Seat 4: Duke Croix (small blind) folded on the Flop
Seat 6: color_singleton (big blind) showed [Jh Ad] and won (1654) with a pair of Eights
Seat 9: Manon541 mucked [6s 4s]



PokerStars Home Game Hand #217634638397: {Club #3225207}  Hold'em No Limit (50/100) - 2020/08/20 17:08:13 ET
Table 'Manuel Neuer' 9-max (Play Money) Seat #4 is the button
Seat 1: JeBoyDirk (22568 in chips) 
Seat 2: dddocky (10172 in chips) 
Seat 4: Duke Croix (9477 in chips) 
Seat 6: color_singleton (7943 in chips) 
Seat 9: Manon541 (7510 in chips) 
color_singleton: posts small blind 50
Manon541: posts big blind 100
*** HOLE CARDS ***
Dealt to Duke Croix [Jc 6d]
JeBoyDirk: folds 
dddocky: calls 100
Duke Croix: folds 
color_singleton: calls 50
Manon541: raises 100 to 200
dddocky: calls 100
color_singleton: calls 100
*** FLOP *** [9s Qd Qs]
color_singleton: checks 
Manon541: checks 
dddocky: checks 
*** TURN *** [9s Qd Qs] [2h]
color_singleton: checks 
Manon541: bets 283
dddocky: calls 283
color_singleton: folds 
*** RIVER *** [9s Qd Qs 2h] [9d]
Manon541: checks 
dddocky: checks 
*** SHOW DOWN ***
Manon541: shows [6s 6h] (two pair, Queens and Nines)
dddocky: shows [4d Ad] (two pair, Queens and Nines - Ace kicker)
dddocky collected 1102 from pot
*** SUMMARY ***
Total pot 1166 | Rake 64 
Board [9s Qd Qs 2h 9d]
Seat 1: JeBoyDirk folded before Flop (didn't bet)
Seat 2: dddocky showed [4d Ad] and won (1102) with two pair, Queens and Nines
Seat 4: Duke Croix (button) folded before Flop (didn't bet)
Seat 6: color_singleton (small blind) folded on the Turn
Seat 9: Manon541 (big blind) showed [6s 6h] and lost with two pair, Queens and Nines



PokerStars Home Game Hand #217634674016: {Club #3225207}  Hold'em No Limit (50/100) - 2020/08/20 17:09:15 ET
Table 'Manuel Neuer' 9-max (Play Money) Seat #6 is the button
Seat 1: JeBoyDirk (22568 in chips) 
Seat 2: dddocky (10791 in chips) 
Seat 4: Duke Croix (9477 in chips) 
Seat 6: color_singleton (7743 in chips) 
Seat 9: Manon541 (7027 in chips) 
Manon541: posts small blind 50
JeBoyDirk: posts big blind 100
*** HOLE CARDS ***
Dealt to Duke Croix [9d 5c]
dddocky: calls 100
Duke Croix: folds 
color_singleton: folds 
Manon541: calls 50
JeBoyDirk: checks 
*** FLOP *** [Qd 5d 9c]
Manon541: checks 
JeBoyDirk: checks 
dddocky: checks 
*** TURN *** [Qd 5d 9c] [3h]
Manon541: checks 
JeBoyDirk: checks 
dddocky: checks 
*** RIVER *** [Qd 5d 9c 3h] [4d]
Manon541: checks 
JeBoyDirk: checks 
dddocky: checks 
*** SHOW DOWN ***
Manon541: shows [6d Jc] (high card Queen)
JeBoyDirk: shows [4h 6c] (a pair of Fours)
dddocky: mucks hand 
JeBoyDirk collected 283 from pot
*** SUMMARY ***
Total pot 300 | Rake 17 
Board [Qd 5d 9c 3h 4d]
Seat 1: JeBoyDirk (big blind) showed [4h 6c] and won (283) with a pair of Fours
Seat 2: dddocky mucked [Js 8d]
Seat 4: Duke Croix folded before Flop (didn't bet)
Seat 6: color_singleton (button) folded before Flop (didn't bet)
Seat 9: Manon541 (small blind) showed [6d Jc] and lost with high card Queen



PokerStars Home Game Hand #217634699369: {Club #3225207}  Hold'em No Limit (50/100) - 2020/08/20 17:09:59 ET
Table 'Manuel Neuer' 9-max (Play Money) Seat #9 is the button
Seat 1: JeBoyDirk (22751 in chips) 
Seat 2: dddocky (10691 in chips) 
Seat 4: Duke Croix (9477 in chips) 
Seat 6: color_singleton (7743 in chips) 
Seat 9: Manon541 (6927 in chips) 
JeBoyDirk: posts small blind 50
dddocky: posts big blind 100
*** HOLE CARDS ***
Dealt to Duke Croix [6h 7s]
Duke Croix: calls 100
color_singleton: folds 
Manon541: calls 100
JeBoyDirk: calls 50
dddocky: checks 
*** FLOP *** [Jh Qd Js]
JeBoyDirk: checks 
dddocky: bets 378
Duke Croix: folds 
Manon541: folds 
JeBoyDirk: calls 378
*** TURN *** [Jh Qd Js] [2h]
JeBoyDirk: checks 
dddocky: checks 
*** RIVER *** [Jh Qd Js 2h] [Ac]
JeBoyDirk: bets 700
dddocky: folds 
Uncalled bet (700) returned to JeBoyDirk
JeBoyDirk collected 1092 from pot
*** SUMMARY ***
Total pot 1156 | Rake 64 
Board [Jh Qd Js 2h Ac]
Seat 1: JeBoyDirk (small blind) collected (1092)
Seat 2: dddocky (big blind) folded on the River
Seat 4: Duke Croix folded on the Flop
Seat 6: color_singleton folded before Flop (didn't bet)
Seat 9: Manon541 (button) folded on the Flop



PokerStars Home Game Hand #217634727519: {Club #3225207}  Hold'em No Limit (50/100) - 2020/08/20 17:10:48 ET
Table 'Manuel Neuer' 9-max (Play Money) Seat #1 is the button
Seat 1: JeBoyDirk (23365 in chips) 
Seat 2: dddocky (10213 in chips) 
Seat 4: Duke Croix (9377 in chips) 
Seat 6: color_singleton (7743 in chips) 
Seat 9: Manon541 (6827 in chips) 
dddocky: posts small blind 50
Duke Croix: posts big blind 100
*** HOLE CARDS ***
Dealt to Duke Croix [Ts 5c]
color_singleton: folds 
Manon541: calls 100
JeBoyDirk: folds 
dddocky: folds 
Duke Croix: checks 
*** FLOP *** [Qd 9d Ac]
Duke Croix: checks 
Manon541: checks 
*** TURN *** [Qd 9d Ac] [Qh]
Duke Croix: checks 
Manon541: checks 
*** RIVER *** [Qd 9d Ac Qh] [4s]
Duke Croix: checks 
Manon541: checks 
*** SHOW DOWN ***
Duke Croix: shows [Ts 5c] (a pair of Queens)
Manon541: shows [3h Th] (a pair of Queens)
Duke Croix collected 118 from pot
Manon541 collected 118 from pot
*** SUMMARY ***
Total pot 250 | Rake 14 
Board [Qd 9d Ac Qh 4s]
Seat 1: JeBoyDirk (button) folded before Flop (didn't bet)
Seat 2: dddocky (small blind) folded before Flop
Seat 4: Duke Croix (big blind) showed [Ts 5c] and won (118) with a pair of Queens
Seat 6: color_singleton folded before Flop (didn't bet)
Seat 9: Manon541 showed [3h Th] and won (118) with a pair of Queens



PokerStars Home Game Hand #217634747979: {Club #3225207}  Hold'em No Limit (50/100) - 2020/08/20 17:11:24 ET
Table 'Manuel Neuer' 9-max (Play Money) Seat #2 is the button
Seat 1: JeBoyDirk (23365 in chips) 
Seat 2: dddocky (10163 in chips) 
Seat 4: Duke Croix (9395 in chips) 
Seat 6: color_singleton (7743 in chips) 
Seat 9: Manon541 (6845 in chips) 
Duke Croix: posts small blind 50
color_singleton: posts big blind 100
*** HOLE CARDS ***
Dealt to Duke Croix [As 9d]
Manon541: folds 
JeBoyDirk: folds 
dddocky: folds 
Duke Croix: raises 300 to 400
color_singleton: folds 
Uncalled bet (300) returned to Duke Croix
Duke Croix collected 200 from pot
*** SUMMARY ***
Total pot 200 | Rake 0 
Seat 1: JeBoyDirk folded before Flop (didn't bet)
Seat 2: dddocky (button) folded before Flop (didn't bet)
Seat 4: Duke Croix (small blind) collected (200)
Seat 6: color_singleton (big blind) folded before Flop
Seat 9: Manon541 folded before Flop (didn't bet)



PokerStars Home Game Hand #217634757530: {Club #3225207}  Hold'em No Limit (50/100) - 2020/08/20 17:11:41 ET
Table 'Manuel Neuer' 9-max (Play Money) Seat #4 is the button
Seat 1: JeBoyDirk (23365 in chips) 
Seat 2: dddocky (10163 in chips) 
Seat 4: Duke Croix (9495 in chips) 
Seat 6: color_singleton (7643 in chips) 
Seat 9: Manon541 (6845 in chips) 
color_singleton: posts small blind 50
Manon541: posts big blind 100
*** HOLE CARDS ***
Dealt to Duke Croix [6h 7d]
JeBoyDirk: raises 300 to 400
dddocky: folds 
Duke Croix: folds 
color_singleton: folds 
Manon541: calls 300
*** FLOP *** [7h 4d 3h]
Manon541: checks 
JeBoyDirk: bets 400
Manon541: folds 
Uncalled bet (400) returned to JeBoyDirk
JeBoyDirk collected 803 from pot
*** SUMMARY ***
Total pot 850 | Rake 47 
Board [7h 4d 3h]
Seat 1: JeBoyDirk collected (803)
Seat 2: dddocky folded before Flop (didn't bet)
Seat 4: Duke Croix (button) folded before Flop (didn't bet)
Seat 6: color_singleton (small blind) folded before Flop
Seat 9: Manon541 (big blind) folded on the Flop



PokerStars Home Game Hand #217634784908: {Club #3225207}  Hold'em No Limit (50/100) - 2020/08/20 17:12:29 ET
Table 'Manuel Neuer' 9-max (Play Money) Seat #6 is the button
Seat 1: JeBoyDirk (23768 in chips) 
Seat 2: dddocky (10163 in chips) 
Seat 4: Duke Croix (9495 in chips) 
Seat 6: color_singleton (7593 in chips) 
Seat 9: Manon541 (6445 in chips) 
Manon541: posts small blind 50
JeBoyDirk: posts big blind 100
*** HOLE CARDS ***
Dealt to Duke Croix [Th 8h]
dddocky: folds 
Duke Croix: raises 300 to 400
color_singleton: folds 
Manon541: calls 350
JeBoyDirk: folds 
*** FLOP *** [Jd As 8d]
Manon541: checks 
Duke Croix: checks 
*** TURN *** [Jd As 8d] [6h]
Manon541: checks 
Duke Croix: checks 
*** RIVER *** [Jd As 8d 6h] [5h]
Manon541: checks 
Duke Croix: checks 
*** SHOW DOWN ***
Manon541: shows [4h 2h] (high card Ace)
Duke Croix: shows [Th 8h] (a pair of Eights)
Duke Croix collected 850 from pot
*** SUMMARY ***
Total pot 900 | Rake 50 
Board [Jd As 8d 6h 5h]
Seat 1: JeBoyDirk (big blind) folded before Flop
Seat 2: dddocky folded before Flop (didn't bet)
Seat 4: Duke Croix showed [Th 8h] and won (850) with a pair of Eights
Seat 6: color_singleton (button) folded before Flop (didn't bet)
Seat 9: Manon541 (small blind) showed [4h 2h] and lost with high card Ace



PokerStars Home Game Hand #217634800753: {Club #3225207}  Hold'em No Limit (50/100) - 2020/08/20 17:12:56 ET
Table 'Manuel Neuer' 9-max (Play Money) Seat #9 is the button
Seat 1: JeBoyDirk (23668 in chips) 
Seat 2: dddocky (10163 in chips) 
Seat 4: Duke Croix (9945 in chips) 
Seat 6: color_singleton (7593 in chips) 
Seat 9: Manon541 (6045 in chips) 
JeBoyDirk: posts small blind 50
dddocky: posts big blind 100
*** HOLE CARDS ***
Dealt to Duke Croix [8h As]
Duke Croix: raises 200 to 300
color_singleton: folds 
Manon541: folds 
JeBoyDirk has timed out
JeBoyDirk: folds 
dddocky: folds 
Uncalled bet (200) returned to Duke Croix
Duke Croix collected 250 from pot
*** SUMMARY ***
Total pot 250 | Rake 0 
Seat 1: JeBoyDirk (small blind) folded before Flop
Seat 2: dddocky (big blind) folded before Flop
Seat 4: Duke Croix collected (250)
Seat 6: color_singleton folded before Flop (didn't bet)
Seat 9: Manon541 (button) folded before Flop (didn't bet)



PokerStars Home Game Hand #217634817332: {Club #3225207}  Hold'em No Limit (50/100) - 2020/08/20 17:13:26 ET
Table 'Manuel Neuer' 9-max (Play Money) Seat #2 is the button
Seat 2: dddocky (10063 in chips) 
Seat 4: Duke Croix (10095 in chips) 
Seat 6: color_singleton (7593 in chips) 
Seat 9: Manon541 (6045 in chips) 
Duke Croix: posts small blind 50
color_singleton: posts big blind 100
*** HOLE CARDS ***
Dealt to Duke Croix [Kd 3d]
Manon541: calls 100
dddocky: calls 100
Duke Croix: calls 50
color_singleton: checks 
*** FLOP *** [Qc 6d 8s]
Duke Croix: checks 
color_singleton: bets 189
Manon541: calls 189
dddocky: calls 189
Duke Croix: folds 
*** TURN *** [Qc 6d 8s] [7s]
color_singleton: bets 457
Manon541: folds 
dddocky: folds 
Uncalled bet (457) returned to color_singleton
color_singleton collected 914 from pot
color_singleton: doesn't show hand 
*** SUMMARY ***
Total pot 967 | Rake 53 
Board [Qc 6d 8s 7s]
Seat 2: dddocky (button) folded on the Turn
Seat 4: Duke Croix (small blind) folded on the Flop
Seat 6: color_singleton (big blind) collected (914)
Seat 9: Manon541 folded on the Turn



PokerStars Home Game Hand #217634840800: {Club #3225207}  Hold'em No Limit (50/100) - 2020/08/20 17:14:06 ET
Table 'Manuel Neuer' 9-max (Play Money) Seat #4 is the button
Seat 2: dddocky (9774 in chips) 
Seat 4: Duke Croix (9995 in chips) 
Seat 6: color_singleton (8218 in chips) 
Seat 9: Manon541 (5756 in chips) 
color_singleton: posts small blind 50
Manon541: posts big blind 100
*** HOLE CARDS ***
Dealt to Duke Croix [9s Th]
dddocky: folds 
Duke Croix: raises 300 to 400
color_singleton: calls 350
Manon541: calls 300
*** FLOP *** [8c 4h Ad]
color_singleton: bets 200
Manon541: calls 200
Duke Croix: calls 200
*** TURN *** [8c 4h Ad] [9h]
color_singleton: checks 
Manon541: bets 850
Duke Croix: folds 
color_singleton: folds 
Uncalled bet (850) returned to Manon541
Manon541 collected 1701 from pot
*** SUMMARY ***
Total pot 1800 | Rake 99 
Board [8c 4h Ad 9h]
Seat 2: dddocky folded before Flop (didn't bet)
Seat 4: Duke Croix (button) folded on the Turn
Seat 6: color_singleton (small blind) folded on the Turn
Seat 9: Manon541 (big blind) collected (1701)



PokerStars Home Game Hand #217634859901: {Club #3225207}  Hold'em No Limit (50/100) - 2020/08/20 17:14:40 ET
Table 'Manuel Neuer' 9-max (Play Money) Seat #6 is the button
Seat 1: JeBoyDirk (23618 in chips) 
Seat 2: dddocky (9774 in chips) 
Seat 4: Duke Croix (9395 in chips) 
Seat 6: color_singleton (7618 in chips) 
Seat 9: Manon541 (6857 in chips) 
Manon541: posts small blind 50
JeBoyDirk: posts big blind 100
*** HOLE CARDS ***
Dealt to Duke Croix [9d 4c]
dddocky: raises 100 to 200
Duke Croix: folds 
color_singleton: folds 
Manon541: calls 150
JeBoyDirk: calls 100
*** FLOP *** [6s 8s 3s]
Manon541: checks 
JeBoyDirk: bets 300
dddocky: calls 300
Manon541: folds 
*** TURN *** [6s 8s 3s] [Qh]
JeBoyDirk: bets 600
dddocky: folds 
Uncalled bet (600) returned to JeBoyDirk
JeBoyDirk collected 1134 from pot
*** SUMMARY ***
Total pot 1200 | Rake 66 
Board [6s 8s 3s Qh]
Seat 1: JeBoyDirk (big blind) collected (1134)
Seat 2: dddocky folded on the Turn
Seat 4: Duke Croix folded before Flop (didn't bet)
Seat 6: color_singleton (button) folded before Flop (didn't bet)
Seat 9: Manon541 (small blind) folded on the Flop



PokerStars Home Game Hand #217634879368: {Club #3225207}  Hold'em No Limit (50/100) - 2020/08/20 17:15:14 ET
Table 'Manuel Neuer' 9-max (Play Money) Seat #9 is the button
Seat 1: JeBoyDirk (24252 in chips) 
Seat 2: dddocky (9274 in chips) 
Seat 4: Duke Croix (9395 in chips) 
Seat 6: color_singleton (7618 in chips) 
Seat 9: Manon541 (6657 in chips) 
JeBoyDirk: posts small blind 50
dddocky: posts big blind 100
*** HOLE CARDS ***
Dealt to Duke Croix [9h Tc]
Duke Croix: raises 300 to 400
color_singleton: calls 400
Manon541: folds 
JeBoyDirk: calls 350
dddocky: folds 
*** FLOP *** [7d Kd 9d]
JeBoyDirk: checks 
Duke Croix: checks 
color_singleton: checks 
*** TURN *** [7d Kd 9d] [9c]
JeBoyDirk: checks 
Duke Croix: bets 700
color_singleton: folds 
JeBoyDirk: folds 
Uncalled bet (700) returned to Duke Croix
Duke Croix collected 1228 from pot
*** SUMMARY ***
Total pot 1300 | Rake 72 
Board [7d Kd 9d 9c]
Seat 1: JeBoyDirk (small blind) folded on the Turn
Seat 2: dddocky (big blind) folded before Flop
Seat 4: Duke Croix collected (1228)
Seat 6: color_singleton folded on the Turn
Seat 9: Manon541 (button) folded before Flop (didn't bet)



PokerStars Home Game Hand #217634900614: {Club #3225207}  Hold'em No Limit (50/100) - 2020/08/20 17:15:51 ET
Table 'Manuel Neuer' 9-max (Play Money) Seat #1 is the button
Seat 1: JeBoyDirk (23852 in chips) 
Seat 2: dddocky (9174 in chips) 
Seat 4: Duke Croix (10223 in chips) 
Seat 6: color_singleton (7218 in chips) 
Seat 9: Manon541 (6657 in chips) 
dddocky: posts small blind 50
Duke Croix: posts big blind 100
*** HOLE CARDS ***
Dealt to Duke Croix [Th Kh]
color_singleton: raises 100 to 200
Manon541: folds 
JeBoyDirk: folds 
dddocky: calls 150
Duke Croix: raises 400 to 600
color_singleton: calls 400
dddocky: calls 400
*** FLOP *** [Ah 7d 4c]
dddocky: checks 
Duke Croix: checks 
color_singleton: checks 
*** TURN *** [Ah 7d 4c] [Qd]
dddocky: checks 
Duke Croix: checks 
color_singleton: checks 
*** RIVER *** [Ah 7d 4c Qd] [As]
dddocky: checks 
Duke Croix: checks 
color_singleton: checks 
*** SHOW DOWN ***
dddocky: shows [Qc 8s] (two pair, Aces and Queens)
Duke Croix: mucks hand 
color_singleton: mucks hand 
dddocky collected 1701 from pot
*** SUMMARY ***
Total pot 1800 | Rake 99 
Board [Ah 7d 4c Qd As]
Seat 1: JeBoyDirk (button) folded before Flop (didn't bet)
Seat 2: dddocky (small blind) showed [Qc 8s] and won (1701) with two pair, Aces and Queens
Seat 4: Duke Croix (big blind) mucked [Th Kh]
Seat 6: color_singleton mucked [3h 3d]
Seat 9: Manon541 folded before Flop (didn't bet)



PokerStars Home Game Hand #217634926802: {Club #3225207}  Hold'em No Limit (50/100) - 2020/08/20 17:16:37 ET
Table 'Manuel Neuer' 9-max (Play Money) Seat #2 is the button
Seat 1: JeBoyDirk (23852 in chips) 
Seat 2: dddocky (10275 in chips) 
Seat 4: Duke Croix (9623 in chips) 
Seat 6: color_singleton (6618 in chips) 
Seat 9: Manon541 (6657 in chips) 
Duke Croix: posts small blind 50
color_singleton: posts big blind 100
*** HOLE CARDS ***
Dealt to Duke Croix [3h 5s]
Manon541: calls 100
JeBoyDirk: calls 100
dddocky: folds 
Duke Croix: folds 
color_singleton: checks 
*** FLOP *** [6d 8s 7d]
color_singleton: bets 165
Manon541: calls 165
JeBoyDirk: calls 165
*** TURN *** [6d 8s 7d] [3d]
color_singleton: checks 
Manon541: checks 
JeBoyDirk: checks 
*** RIVER *** [6d 8s 7d 3d] [8d]
color_singleton: checks 
Manon541: bets 799
JeBoyDirk: folds 
color_singleton: folds 
Uncalled bet (799) returned to Manon541
Manon541 collected 799 from pot
*** SUMMARY ***
Total pot 845 | Rake 46 
Board [6d 8s 7d 3d 8d]
Seat 1: JeBoyDirk folded on the River
Seat 2: dddocky (button) folded before Flop (didn't bet)
Seat 4: Duke Croix (small blind) folded before Flop
Seat 6: color_singleton (big blind) folded on the River
Seat 9: Manon541 collected (799)



PokerStars Home Game Hand #217634950369: {Club #3225207}  Hold'em No Limit (50/100) - 2020/08/20 17:17:19 ET
Table 'Manuel Neuer' 9-max (Play Money) Seat #4 is the button
Seat 1: JeBoyDirk (23587 in chips) 
Seat 2: dddocky (10275 in chips) 
Seat 4: Duke Croix (9573 in chips) 
Seat 6: color_singleton (6353 in chips) 
Seat 9: Manon541 (7191 in chips) 
color_singleton: posts small blind 50
Manon541: posts big blind 100
*** HOLE CARDS ***
Dealt to Duke Croix [9c Ks]
JeBoyDirk: folds 
dddocky: calls 100
Duke Croix: raises 300 to 400
color_singleton: folds 
Manon541: folds 
dddocky: folds 
Uncalled bet (300) returned to Duke Croix
Duke Croix collected 350 from pot
*** SUMMARY ***
Total pot 350 | Rake 0 
Seat 1: JeBoyDirk folded before Flop (didn't bet)
Seat 2: dddocky folded before Flop
Seat 4: Duke Croix (button) collected (350)
Seat 6: color_singleton (small blind) folded before Flop
Seat 9: Manon541 (big blind) folded before Flop



PokerStars Home Game Hand #217634958414: {Club #3225207}  Hold'em No Limit (50/100) - 2020/08/20 17:17:33 ET
Table 'Manuel Neuer' 9-max (Play Money) Seat #6 is the button
Seat 1: JeBoyDirk (23587 in chips) 
Seat 2: dddocky (10175 in chips) 
Seat 4: Duke Croix (9823 in chips) 
Seat 6: color_singleton (6303 in chips) 
Seat 9: Manon541 (7091 in chips) 
Manon541: posts small blind 50
JeBoyDirk: posts big blind 100
*** HOLE CARDS ***
Dealt to Duke Croix [As 6c]
dddocky: folds 
Duke Croix: raises 200 to 300
color_singleton: folds 
Manon541: calls 250
JeBoyDirk: folds 
*** FLOP *** [Ts Qs 8d]
Manon541: checks 
Duke Croix: checks 
*** TURN *** [Ts Qs 8d] [3h]
Manon541: checks 
Duke Croix: checks 
*** RIVER *** [Ts Qs 8d 3h] [Jh]
Manon541: checks 
Duke Croix: checks 
*** SHOW DOWN ***
Manon541: shows [4d Ks] (high card King)
Duke Croix: shows [As 6c] (high card Ace)
Duke Croix collected 661 from pot
*** SUMMARY ***
Total pot 700 | Rake 39 
Board [Ts Qs 8d 3h Jh]
Seat 1: JeBoyDirk (big blind) folded before Flop
Seat 2: dddocky folded before Flop (didn't bet)
Seat 4: Duke Croix showed [As 6c] and won (661) with high card Ace
Seat 6: color_singleton (button) folded before Flop (didn't bet)
Seat 9: Manon541 (small blind) showed [4d Ks] and lost with high card King



PokerStars Home Game Hand #217634978651: {Club #3225207}  Hold'em No Limit (50/100) - 2020/08/20 17:18:04 ET
Table 'Manuel Neuer' 9-max (Play Money) Seat #9 is the button
Seat 1: JeBoyDirk (23487 in chips) 
Seat 2: dddocky (10175 in chips) 
Seat 4: Duke Croix (10184 in chips) 
Seat 6: color_singleton (6303 in chips) 
Seat 9: Manon541 (6791 in chips) 
JeBoyDirk: posts small blind 50
dddocky: posts big blind 100
*** HOLE CARDS ***
Dealt to Duke Croix [8d 3c]
Duke Croix: folds 
color_singleton: folds 
Manon541: calls 100
JeBoyDirk: calls 50
dddocky: checks 
*** FLOP *** [Ts Qs 9s]
JeBoyDirk: checks 
dddocky: checks 
Manon541: checks 
*** TURN *** [Ts Qs 9s] [2h]
JeBoyDirk: bets 300
dddocky: folds 
Manon541: folds 
Uncalled bet (300) returned to JeBoyDirk
JeBoyDirk collected 283 from pot
*** SUMMARY ***
Total pot 300 | Rake 17 
Board [Ts Qs 9s 2h]
Seat 1: JeBoyDirk (small blind) collected (283)
Seat 2: dddocky (big blind) folded on the Turn
Seat 4: Duke Croix folded before Flop (didn't bet)
Seat 6: color_singleton folded before Flop (didn't bet)
Seat 9: Manon541 (button) folded on the Turn



PokerStars Home Game Hand #217634993478: {Club #3225207}  Hold'em No Limit (50/100) - 2020/08/20 17:18:30 ET
Table 'Manuel Neuer' 9-max (Play Money) Seat #1 is the button
Seat 1: JeBoyDirk (23670 in chips) 
Seat 2: dddocky (10075 in chips) 
Seat 4: Duke Croix (10184 in chips) 
Seat 6: color_singleton (6303 in chips) 
Seat 9: Manon541 (6691 in chips) 
dddocky: posts small blind 50
Duke Croix: posts big blind 100
*** HOLE CARDS ***
Dealt to Duke Croix [8h Kh]
color_singleton: raises 200 to 300
Manon541: folds 
JeBoyDirk: folds 
dddocky: folds 
Duke Croix: calls 200
*** FLOP *** [6d As 2d]
Duke Croix: checks 
color_singleton: bets 307
Duke Croix: folds 
Uncalled bet (307) returned to color_singleton
color_singleton collected 614 from pot
color_singleton: doesn't show hand 
*** SUMMARY ***
Total pot 650 | Rake 36 
Board [6d As 2d]
Seat 1: JeBoyDirk (button) folded before Flop (didn't bet)
Seat 2: dddocky (small blind) folded before Flop
Seat 4: Duke Croix (big blind) folded on the Flop
Seat 6: color_singleton collected (614)
Seat 9: Manon541 folded before Flop (didn't bet)



PokerStars Home Game Hand #217635003578: {Club #3225207}  Hold'em No Limit (50/100) - 2020/08/20 17:18:48 ET
Table 'Manuel Neuer' 9-max (Play Money) Seat #2 is the button
Seat 1: JeBoyDirk (23670 in chips) 
Seat 2: dddocky (10025 in chips) 
Seat 4: Duke Croix (9884 in chips) 
Seat 6: color_singleton (6617 in chips) 
Seat 9: Manon541 (6691 in chips) 
Duke Croix: posts small blind 50
color_singleton: posts big blind 100
*** HOLE CARDS ***
Dealt to Duke Croix [5h 2c]
Manon541: calls 100
JeBoyDirk: folds 
dddocky: calls 100
Duke Croix: calls 50
color_singleton: raises 200 to 300
Manon541: calls 200
dddocky: calls 200
Duke Croix: folds 
*** FLOP *** [3h Jd 8h]
color_singleton: bets 472
Manon541: folds 
dddocky: calls 472
*** TURN *** [3h Jd 8h] [9h]
color_singleton: bets 1837
dddocky: folds 
Uncalled bet (1837) returned to color_singleton
color_singleton collected 1837 from pot
color_singleton: doesn't show hand 
*** SUMMARY ***
Total pot 1944 | Rake 107 
Board [3h Jd 8h 9h]
Seat 1: JeBoyDirk folded before Flop (didn't bet)
Seat 2: dddocky (button) folded on the Turn
Seat 4: Duke Croix (small blind) folded before Flop
Seat 6: color_singleton (big blind) collected (1837)
Seat 9: Manon541 folded on the Flop



PokerStars Home Game Hand #217635031484: {Club #3225207}  Hold'em No Limit (50/100) - 2020/08/20 17:19:37 ET
Table 'Manuel Neuer' 9-max (Play Money) Seat #4 is the button
Seat 1: JeBoyDirk (23670 in chips) 
Seat 2: dddocky (9253 in chips) 
Seat 4: Duke Croix (9784 in chips) 
Seat 6: color_singleton (7682 in chips) 
Seat 9: Manon541 (6391 in chips) 
color_singleton: posts small blind 50
Manon541: posts big blind 100
*** HOLE CARDS ***
Dealt to Duke Croix [Jh Ts]
JeBoyDirk: folds 
dddocky: calls 100
Duke Croix: raises 300 to 400
color_singleton: folds 
Manon541: folds 
dddocky: folds 
Uncalled bet (300) returned to Duke Croix
Duke Croix collected 350 from pot
*** SUMMARY ***
Total pot 350 | Rake 0 
Seat 1: JeBoyDirk folded before Flop (didn't bet)
Seat 2: dddocky folded before Flop
Seat 4: Duke Croix (button) collected (350)
Seat 6: color_singleton (small blind) folded before Flop
Seat 9: Manon541 (big blind) folded before Flop



PokerStars Home Game Hand #217635040142: {Club #3225207}  Hold'em No Limit (50/100) - 2020/08/20 17:19:52 ET
Table 'Manuel Neuer' 9-max (Play Money) Seat #6 is the button
Seat 1: JeBoyDirk (23670 in chips) 
Seat 2: dddocky (9153 in chips) 
Seat 4: Duke Croix (10034 in chips) 
Seat 6: color_singleton (7632 in chips) 
Seat 9: Manon541 (6291 in chips) 
Manon541: posts small blind 50
JeBoyDirk: posts big blind 100
*** HOLE CARDS ***
Dealt to Duke Croix [7s Jd]
dddocky: calls 100
Duke Croix: calls 100
color_singleton has timed out
color_singleton: folds 
Manon541: calls 50
JeBoyDirk: checks 
*** FLOP *** [5h 4d 2h]
Manon541: checks 
JeBoyDirk: checks 
dddocky: bets 100
Duke Croix: folds 
Manon541: folds 
JeBoyDirk: folds 
Uncalled bet (100) returned to dddocky
dddocky collected 378 from pot
dddocky: doesn't show hand 
*** SUMMARY ***
Total pot 400 | Rake 22 
Board [5h 4d 2h]
Seat 1: JeBoyDirk (big blind) folded on the Flop
Seat 2: dddocky collected (378)
Seat 4: Duke Croix folded on the Flop
Seat 6: color_singleton (button) folded before Flop (didn't bet)
Seat 9: Manon541 (small blind) folded on the Flop



PokerStars Home Game Hand #217635073877: {Club #3225207}  Hold'em No Limit (50/100) - 2020/08/20 17:20:51 ET
Table 'Manuel Neuer' 9-max (Play Money) Seat #9 is the button
Seat 1: JeBoyDirk (23570 in chips) 
Seat 2: dddocky (9431 in chips) 
Seat 4: Duke Croix (9934 in chips) 
Seat 9: Manon541 (6191 in chips) 
JeBoyDirk: posts small blind 50
dddocky: posts big blind 100
*** HOLE CARDS ***
Dealt to Duke Croix [8d 5c]
Duke Croix: folds 
Manon541: calls 100
JeBoyDirk: calls 50
dddocky: checks 
*** FLOP *** [Jc Kc 9d]
JeBoyDirk: checks 
dddocky: checks 
Manon541: checks 
*** TURN *** [Jc Kc 9d] [4c]
JeBoyDirk: bets 300
dddocky: folds 
Manon541: folds 
Uncalled bet (300) returned to JeBoyDirk
JeBoyDirk collected 283 from pot
*** SUMMARY ***
Total pot 300 | Rake 17 
Board [Jc Kc 9d 4c]
Seat 1: JeBoyDirk (small blind) collected (283)
Seat 2: dddocky (big blind) folded on the Turn
Seat 4: Duke Croix folded before Flop (didn't bet)
Seat 9: Manon541 (button) folded on the Turn



PokerStars Home Game Hand #217635092132: {Club #3225207}  Hold'em No Limit (50/100) - 2020/08/20 17:21:23 ET
Table 'Manuel Neuer' 9-max (Play Money) Seat #1 is the button
Seat 1: JeBoyDirk (23753 in chips) 
Seat 2: dddocky (9331 in chips) 
Seat 4: Duke Croix (9934 in chips) 
Seat 6: color_singleton (7632 in chips) 
Seat 9: Manon541 (6091 in chips) 
dddocky: posts small blind 50
Duke Croix: posts big blind 100
*** HOLE CARDS ***
Dealt to Duke Croix [8d Jd]
color_singleton: raises 100 to 200
Manon541: folds 
JeBoyDirk: calls 200
dddocky: calls 150
Duke Croix: calls 100
*** FLOP *** [3h 8h 9c]
dddocky: checks 
Duke Croix: checks 
color_singleton: bets 378
JeBoyDirk: folds 
dddocky: calls 378
Duke Croix: folds 
*** TURN *** [3h 8h 9c] [4c]
dddocky: checks 
color_singleton: bets 735
dddocky: calls 735
*** RIVER *** [3h 8h 9c 4c] [Ks]
dddocky: checks 
color_singleton: checks 
*** SHOW DOWN ***
dddocky: shows [Th 6h] (high card King)
color_singleton: shows [8s Js] (a pair of Eights)
color_singleton collected 2860 from pot
*** SUMMARY ***
Total pot 3026 | Rake 166 
Board [3h 8h 9c 4c Ks]
Seat 1: JeBoyDirk (button) folded on the Flop
Seat 2: dddocky (small blind) showed [Th 6h] and lost with high card King
Seat 4: Duke Croix (big blind) folded on the Flop
Seat 6: color_singleton showed [8s Js] and won (2860) with a pair of Eights
Seat 9: Manon541 folded before Flop (didn't bet)



PokerStars Home Game Hand #217635121149: {Club #3225207}  Hold'em No Limit (50/100) - 2020/08/20 17:22:14 ET
Table 'Manuel Neuer' 9-max (Play Money) Seat #2 is the button
Seat 1: JeBoyDirk (23553 in chips) 
Seat 2: dddocky (8018 in chips) 
Seat 4: Duke Croix (9734 in chips) 
Seat 6: color_singleton (9179 in chips) 
Duke Croix: posts small blind 50
color_singleton: posts big blind 100
*** HOLE CARDS ***
Dealt to Duke Croix [Ad 6c]
JeBoyDirk: folds 
dddocky: calls 100
Duke Croix: calls 50
color_singleton: checks 
*** FLOP *** [4s 6s Jh]
Duke Croix: checks 
color_singleton: checks 
dddocky: checks 
*** TURN *** [4s 6s Jh] [Jd]
Duke Croix: bets 300
color_singleton: folds 
dddocky: folds 
Uncalled bet (300) returned to Duke Croix
Duke Croix collected 283 from pot
*** SUMMARY ***
Total pot 300 | Rake 17 
Board [4s 6s Jh Jd]
Seat 1: JeBoyDirk folded before Flop (didn't bet)
Seat 2: dddocky (button) folded on the Turn
Seat 4: Duke Croix (small blind) collected (283)
Seat 6: color_singleton (big blind) folded on the Turn



PokerStars Home Game Hand #217635134565: {Club #3225207}  Hold'em No Limit (50/100) - 2020/08/20 17:22:39 ET
Table 'Manuel Neuer' 9-max (Play Money) Seat #4 is the button
Seat 1: JeBoyDirk (23553 in chips) 
Seat 2: dddocky (7918 in chips) 
Seat 4: Duke Croix (9917 in chips) 
Seat 6: color_singleton (9079 in chips) 
color_singleton: posts small blind 50
JeBoyDirk: posts big blind 100
*** HOLE CARDS ***
Dealt to Duke Croix [9s 2d]
dddocky: folds 
Duke Croix: folds 
color_singleton: calls 50
JeBoyDirk: checks 
*** FLOP *** [5d 7s 8c]
color_singleton: bets 189
JeBoyDirk: folds 
Uncalled bet (189) returned to color_singleton
color_singleton collected 189 from pot
color_singleton: doesn't show hand 
*** SUMMARY ***
Total pot 200 | Rake 11 
Board [5d 7s 8c]
Seat 1: JeBoyDirk (big blind) folded on the Flop
Seat 2: dddocky folded before Flop (didn't bet)
Seat 4: Duke Croix (button) folded before Flop (didn't bet)
Seat 6: color_singleton (small blind) collected (189)



PokerStars Home Game Hand #217635149706: {Club #3225207}  Hold'em No Limit (50/100) - 2020/08/20 17:23:05 ET
Table 'Manuel Neuer' 9-max (Play Money) Seat #6 is the button
Seat 1: JeBoyDirk (23453 in chips) 
Seat 2: dddocky (7918 in chips) 
Seat 4: Duke Croix (9917 in chips) 
Seat 6: color_singleton (9168 in chips) 
JeBoyDirk: posts small blind 50
dddocky: posts big blind 100
*** HOLE CARDS ***
Dealt to Duke Croix [6c 3s]
Duke Croix: folds 
color_singleton: raises 100 to 200
JeBoyDirk: folds 
dddocky: calls 100
*** FLOP *** [5c 3h Kc]
dddocky: checks 
color_singleton: checks 
*** TURN *** [5c 3h Kc] [4h]
dddocky: checks 
color_singleton: checks 
*** RIVER *** [5c 3h Kc 4h] [Js]
dddocky: checks 
color_singleton: checks 
*** SHOW DOWN ***
dddocky: shows [Qs 5s] (a pair of Fives)
color_singleton: mucks hand 
dddocky collected 425 from pot
*** SUMMARY ***
Total pot 450 | Rake 25 
Board [5c 3h Kc 4h Js]
Seat 1: JeBoyDirk (small blind) folded before Flop
Seat 2: dddocky (big blind) showed [Qs 5s] and won (425) with a pair of Fives
Seat 4: Duke Croix folded before Flop (didn't bet)
Seat 6: color_singleton (button) mucked [Td Qd]



PokerStars Home Game Hand #217635162785: {Club #3225207}  Hold'em No Limit (50/100) - 2020/08/20 17:23:29 ET
Table 'Manuel Neuer' 9-max (Play Money) Seat #1 is the button
Seat 1: JeBoyDirk (23403 in chips) 
Seat 2: dddocky (8143 in chips) 
Seat 4: Duke Croix (9917 in chips) 
Seat 6: color_singleton (8968 in chips) 
dddocky: posts small blind 50
Duke Croix: posts big blind 100
*** HOLE CARDS ***
Dealt to Duke Croix [Ah 6c]
color_singleton: folds 
JeBoyDirk: raises 100 to 200
dddocky: folds 
Duke Croix: calls 100
*** FLOP *** [9s 9d 2d]
Duke Croix: checks 
JeBoyDirk: checks 
*** TURN *** [9s 9d 2d] [Jh]
Duke Croix: checks 
JeBoyDirk: checks 
*** RIVER *** [9s 9d 2d Jh] [8h]
Duke Croix: checks 
JeBoyDirk: checks 
*** SHOW DOWN ***
Duke Croix: shows [Ah 6c] (a pair of Nines)
JeBoyDirk: mucks hand 
Duke Croix collected 425 from pot
*** SUMMARY ***
Total pot 450 | Rake 25 
Board [9s 9d 2d Jh 8h]
Seat 1: JeBoyDirk (button) mucked [Ts Kh]
Seat 2: dddocky (small blind) folded before Flop
Seat 4: Duke Croix (big blind) showed [Ah 6c] and won (425) with a pair of Nines
Seat 6: color_singleton folded before Flop (didn't bet)



PokerStars Home Game Hand #217635182825: {Club #3225207}  Hold'em No Limit (50/100) - 2020/08/20 17:24:04 ET
Table 'Manuel Neuer' 9-max (Play Money) Seat #2 is the button
Seat 1: JeBoyDirk (23203 in chips) 
Seat 2: dddocky (8093 in chips) 
Seat 4: Duke Croix (10142 in chips) 
Seat 6: color_singleton (8968 in chips) 
Duke Croix: posts small blind 50
color_singleton: posts big blind 100
*** HOLE CARDS ***
Dealt to Duke Croix [4s 4c]
JeBoyDirk: raises 100 to 200
dddocky: calls 200
Duke Croix: calls 150
color_singleton: calls 100
*** FLOP *** [7s 8s 5h]
Duke Croix: bets 400
color_singleton: calls 400
JeBoyDirk: folds 
dddocky: folds 
*** TURN *** [7s 8s 5h] [5d]
Duke Croix: bets 800
color_singleton: calls 800
*** RIVER *** [7s 8s 5h 5d] [5c]
Duke Croix: bets 1800
color_singleton: folds 
Uncalled bet (1800) returned to Duke Croix
Duke Croix collected 3024 from pot
*** SUMMARY ***
Total pot 3200 | Rake 176 
Board [7s 8s 5h 5d 5c]
Seat 1: JeBoyDirk folded on the Flop
Seat 2: dddocky (button) folded on the Flop
Seat 4: Duke Croix (small blind) collected (3024)
Seat 6: color_singleton (big blind) folded on the River



PokerStars Home Game Hand #217635217883: {Club #3225207}  Hold'em No Limit (50/100) - 2020/08/20 17:24:59 ET
Table 'Manuel Neuer' 9-max (Play Money) Seat #4 is the button
Seat 1: JeBoyDirk (23003 in chips) 
Seat 2: dddocky (7893 in chips) 
Seat 4: Duke Croix (11766 in chips) 
Seat 6: color_singleton (7568 in chips) 
Seat 9: Manon541 (6091 in chips) 
color_singleton: posts small blind 50
Manon541: posts big blind 100
*** HOLE CARDS ***
Dealt to Duke Croix [9h Qs]
JeBoyDirk: folds 
dddocky: calls 100
Duke Croix: raises 300 to 400
color_singleton: calls 350
Manon541: calls 300
dddocky: calls 300
*** FLOP *** [7s Qc Kc]
color_singleton: bets 756
Manon541: folds 
dddocky: folds 
Duke Croix: folds 
Uncalled bet (756) returned to color_singleton
color_singleton collected 1512 from pot
color_singleton: doesn't show hand 
*** SUMMARY ***
Total pot 1600 | Rake 88 
Board [7s Qc Kc]
Seat 1: JeBoyDirk folded before Flop (didn't bet)
Seat 2: dddocky folded on the Flop
Seat 4: Duke Croix (button) folded on the Flop
Seat 6: color_singleton (small blind) collected (1512)
Seat 9: Manon541 (big blind) folded on the Flop



PokerStars Home Game Hand #217635230502: {Club #3225207}  Hold'em No Limit (50/100) - 2020/08/20 17:25:21 ET
Table 'Manuel Neuer' 9-max (Play Money) Seat #6 is the button
Seat 1: JeBoyDirk (23003 in chips) 
Seat 2: dddocky (7493 in chips) 
Seat 4: Duke Croix (11366 in chips) 
Seat 6: color_singleton (8680 in chips) 
Seat 9: Manon541 (5691 in chips) 
Manon541: posts small blind 50
JeBoyDirk: posts big blind 100
*** HOLE CARDS ***
Dealt to Duke Croix [2d 8c]
dddocky: folds 
Duke Croix: folds 
color_singleton: folds 
Manon541: calls 50
JeBoyDirk: checks 
*** FLOP *** [Ks 8d Kc]
Manon541: checks 
JeBoyDirk: checks 
*** TURN *** [Ks 8d Kc] [Qs]
Manon541: bets 100
JeBoyDirk: folds 
Uncalled bet (100) returned to Manon541
Manon541 collected 189 from pot
*** SUMMARY ***
Total pot 200 | Rake 11 
Board [Ks 8d Kc Qs]
Seat 1: JeBoyDirk (big blind) folded on the Turn
Seat 2: dddocky folded before Flop (didn't bet)
Seat 4: Duke Croix folded before Flop (didn't bet)
Seat 6: color_singleton (button) folded before Flop (didn't bet)
Seat 9: Manon541 (small blind) collected (189)



PokerStars Home Game Hand #217635246524: {Club #3225207}  Hold'em No Limit (50/100) - 2020/08/20 17:25:50 ET
Table 'Manuel Neuer' 9-max (Play Money) Seat #9 is the button
Seat 1: JeBoyDirk (22903 in chips) 
Seat 2: dddocky (7493 in chips) 
Seat 4: Duke Croix (11366 in chips) 
Seat 6: color_singleton (8680 in chips) 
Seat 9: Manon541 (5780 in chips) 
JeBoyDirk: posts small blind 50
dddocky: posts big blind 100
*** HOLE CARDS ***
Dealt to Duke Croix [8d Qc]
Duke Croix: raises 200 to 300
color_singleton: folds 
Manon541: folds 
JeBoyDirk: calls 250
dddocky: calls 200
*** FLOP *** [Js As Ts]
JeBoyDirk: checks 
dddocky: checks 
Duke Croix: bets 500
JeBoyDirk: folds 
dddocky: folds 
Uncalled bet (500) returned to Duke Croix
Duke Croix collected 850 from pot
*** SUMMARY ***
Total pot 900 | Rake 50 
Board [Js As Ts]
Seat 1: JeBoyDirk (small blind) folded on the Flop
Seat 2: dddocky (big blind) folded on the Flop
Seat 4: Duke Croix collected (850)
Seat 6: color_singleton folded before Flop (didn't bet)
Seat 9: Manon541 (button) folded before Flop (didn't bet)



PokerStars Home Game Hand #217635265616: {Club #3225207}  Hold'em No Limit (50/100) - 2020/08/20 17:26:25 ET
Table 'Manuel Neuer' 9-max (Play Money) Seat #1 is the button
Seat 1: JeBoyDirk (22603 in chips) 
Seat 2: dddocky (7193 in chips) 
Seat 4: Duke Croix (11916 in chips) 
Seat 6: color_singleton (8680 in chips) 
Seat 9: Manon541 (5780 in chips) 
dddocky: posts small blind 50
Duke Croix: posts big blind 100
*** HOLE CARDS ***
Dealt to Duke Croix [8s Jd]
color_singleton: raises 100 to 200
Manon541: calls 200
JeBoyDirk: folds 
dddocky: calls 150
Duke Croix: calls 100
*** FLOP *** [Js 6h 6d]
dddocky: checks 
Duke Croix: bets 500
color_singleton: calls 500
Manon541: folds 
dddocky: folds 
*** TURN *** [Js 6h 6d] [Ks]
Duke Croix: checks 
color_singleton: checks 
*** RIVER *** [Js 6h 6d Ks] [4s]
Duke Croix: checks 
color_singleton: bets 850
Duke Croix: calls 850
*** SHOW DOWN ***
color_singleton: shows [Ac Ah] (two pair, Aces and Sixes)
Duke Croix: mucks hand 
color_singleton collected 3307 from pot
*** SUMMARY ***
Total pot 3500 | Rake 193 
Board [Js 6h 6d Ks 4s]
Seat 1: JeBoyDirk (button) folded before Flop (didn't bet)
Seat 2: dddocky (small blind) folded on the Flop
Seat 4: Duke Croix (big blind) mucked [8s Jd]
Seat 6: color_singleton showed [Ac Ah] and won (3307) with two pair, Aces and Sixes
Seat 9: Manon541 folded on the Flop



PokerStars Home Game Hand #217635298823: {Club #3225207}  Hold'em No Limit (50/100) - 2020/08/20 17:27:25 ET
Table 'Manuel Neuer' 9-max (Play Money) Seat #2 is the button
Seat 1: JeBoyDirk (22603 in chips) 
Seat 2: dddocky (6993 in chips) 
Seat 4: Duke Croix (10366 in chips) 
Seat 6: color_singleton (10437 in chips) 
Seat 9: Manon541 (5580 in chips) 
Duke Croix: posts small blind 50
color_singleton: posts big blind 100
*** HOLE CARDS ***
Dealt to Duke Croix [4s 6h]
Manon541: calls 100
JeBoyDirk: folds 
dddocky: folds 
Duke Croix: calls 50
color_singleton: raises 200 to 300
Manon541: folds 
Duke Croix: folds 
Uncalled bet (200) returned to color_singleton
color_singleton collected 300 from pot
color_singleton: doesn't show hand 
*** SUMMARY ***
Total pot 300 | Rake 0 
Seat 1: JeBoyDirk folded before Flop (didn't bet)
Seat 2: dddocky (button) folded before Flop (didn't bet)
Seat 4: Duke Croix (small blind) folded before Flop
Seat 6: color_singleton (big blind) collected (300)
Seat 9: Manon541 folded before Flop



PokerStars Home Game Hand #217635312198: {Club #3225207}  Hold'em No Limit (50/100) - 2020/08/20 17:27:49 ET
Table 'Manuel Neuer' 9-max (Play Money) Seat #4 is the button
Seat 1: JeBoyDirk (22603 in chips) 
Seat 2: dddocky (6993 in chips) 
Seat 4: Duke Croix (10266 in chips) 
Seat 6: color_singleton (10637 in chips) 
Seat 9: Manon541 (5480 in chips) 
color_singleton: posts small blind 50
Manon541: posts big blind 100
*** HOLE CARDS ***
Dealt to Duke Croix [Jc Tc]
JeBoyDirk: folds 
dddocky: calls 100
Duke Croix: raises 300 to 400
color_singleton: folds 
Manon541: calls 300
dddocky: calls 300
*** FLOP *** [2d 6s Qs]
Manon541: checks 
dddocky: checks 
Duke Croix: checks 
*** TURN *** [2d 6s Qs] [Ad]
Manon541: checks 
dddocky: checks 
Duke Croix: bets 700
Manon541: folds 
dddocky: folds 
Uncalled bet (700) returned to Duke Croix
Duke Croix collected 1181 from pot
*** SUMMARY ***
Total pot 1250 | Rake 69 
Board [2d 6s Qs Ad]
Seat 1: JeBoyDirk folded before Flop (didn't bet)
Seat 2: dddocky folded on the Turn
Seat 4: Duke Croix (button) collected (1181)
Seat 6: color_singleton (small blind) folded before Flop
Seat 9: Manon541 (big blind) folded on the Turn



PokerStars Home Game Hand #217635334416: {Club #3225207}  Hold'em No Limit (50/100) - 2020/08/20 17:28:30 ET
Table 'Manuel Neuer' 9-max (Play Money) Seat #6 is the button
Seat 1: JeBoyDirk (22603 in chips) 
Seat 2: dddocky (6593 in chips) 
Seat 4: Duke Croix (11047 in chips) 
Seat 6: color_singleton (10587 in chips) 
Seat 9: Manon541 (5080 in chips) 
Manon541: posts small blind 50
JeBoyDirk: posts big blind 100
*** HOLE CARDS ***
Dealt to Duke Croix [6c Qc]
dddocky: calls 100
Duke Croix: calls 100
color_singleton: calls 100
Manon541: calls 50
JeBoyDirk: checks 
*** FLOP *** [8s 3c 7d]
Manon541: checks 
JeBoyDirk: checks 
dddocky: checks 
Duke Croix: checks 
color_singleton: checks 
*** TURN *** [8s 3c 7d] [9h]
Manon541: bets 236
JeBoyDirk: folds 
dddocky: calls 236
Duke Croix: calls 236
color_singleton: calls 236
*** RIVER *** [8s 3c 7d 9h] [2c]
Manon541: bets 682
dddocky: folds 
Duke Croix: folds 
color_singleton: folds 
Uncalled bet (682) returned to Manon541
Manon541 collected 1365 from pot
*** SUMMARY ***
Total pot 1444 | Rake 79 
Board [8s 3c 7d 9h 2c]
Seat 1: JeBoyDirk (big blind) folded on the Turn
Seat 2: dddocky folded on the River
Seat 4: Duke Croix folded on the River
Seat 6: color_singleton (button) folded on the River
Seat 9: Manon541 (small blind) collected (1365)



PokerStars Home Game Hand #217635355911: {Club #3225207}  Hold'em No Limit (50/100) - 2020/08/20 17:29:09 ET
Table 'Manuel Neuer' 9-max (Play Money) Seat #9 is the button
Seat 1: JeBoyDirk (22503 in chips) 
Seat 2: dddocky (6257 in chips) 
Seat 4: Duke Croix (10711 in chips) 
Seat 6: color_singleton (10251 in chips) 
Seat 9: Manon541 (6109 in chips) 
JeBoyDirk: posts small blind 50
dddocky: posts big blind 100
*** HOLE CARDS ***
Dealt to Duke Croix [9h 9s]
Duke Croix: raises 300 to 400
color_singleton: folds 
Manon541: calls 400
JeBoyDirk: folds 
dddocky: folds 
*** FLOP *** [3d 2h 4c]
Duke Croix: bets 500
Manon541: folds 
Uncalled bet (500) returned to Duke Croix
Duke Croix collected 898 from pot
*** SUMMARY ***
Total pot 950 | Rake 52 
Board [3d 2h 4c]
Seat 1: JeBoyDirk (small blind) folded before Flop
Seat 2: dddocky (big blind) folded before Flop
Seat 4: Duke Croix collected (898)
Seat 6: color_singleton folded before Flop (didn't bet)
Seat 9: Manon541 (button) folded on the Flop



PokerStars Home Game Hand #217635369648: {Club #3225207}  Hold'em No Limit (50/100) - 2020/08/20 17:29:34 ET
Table 'Manuel Neuer' 9-max (Play Money) Seat #1 is the button
Seat 1: JeBoyDirk (22453 in chips) 
Seat 2: dddocky (6157 in chips) 
Seat 4: Duke Croix (11209 in chips) 
Seat 6: color_singleton (10251 in chips) 
Seat 9: Manon541 (5709 in chips) 
dddocky: posts small blind 50
Duke Croix: posts big blind 100
*** HOLE CARDS ***
Dealt to Duke Croix [7h As]
color_singleton: raises 100 to 200
Manon541: calls 200
JeBoyDirk: calls 200
dddocky: calls 150
Duke Croix: calls 100
*** FLOP *** [5h 7c 9d]
dddocky: checks 
Duke Croix: bets 500
color_singleton: folds 
Manon541: folds 
JeBoyDirk: folds 
dddocky: folds 
Uncalled bet (500) returned to Duke Croix
Duke Croix collected 945 from pot
*** SUMMARY ***
Total pot 1000 | Rake 55 
Board [5h 7c 9d]
Seat 1: JeBoyDirk (button) folded on the Flop
Seat 2: dddocky (small blind) folded on the Flop
Seat 4: Duke Croix (big blind) collected (945)
Seat 6: color_singleton folded on the Flop
Seat 9: Manon541 folded on the Flop



PokerStars Home Game Hand #217635384753: {Club #3225207}  Hold'em No Limit (50/100) - 2020/08/20 17:30:02 ET
Table 'Manuel Neuer' 9-max (Play Money) Seat #2 is the button
Seat 1: JeBoyDirk (22253 in chips) 
Seat 2: dddocky (5957 in chips) 
Seat 4: Duke Croix (11954 in chips) 
Seat 6: color_singleton (10051 in chips) 
Seat 9: Manon541 (5509 in chips) 
Duke Croix: posts small blind 50
color_singleton: posts big blind 100
*** HOLE CARDS ***
Dealt to Duke Croix [3c 2c]
Manon541: folds 
JeBoyDirk: calls 100
dddocky: calls 100
Duke Croix: calls 50
color_singleton: raises 200 to 300
JeBoyDirk: calls 200
dddocky: calls 200
Duke Croix: calls 200
*** FLOP *** [Kc 6s Qs]
Duke Croix: checks 
color_singleton: checks 
JeBoyDirk: checks 
dddocky: checks 
*** TURN *** [Kc 6s Qs] [9s]
Duke Croix: checks 
color_singleton: checks 
JeBoyDirk: bets 600
dddocky: folds 
Duke Croix: folds 
color_singleton: folds 
Uncalled bet (600) returned to JeBoyDirk
JeBoyDirk collected 1134 from pot
*** SUMMARY ***
Total pot 1200 | Rake 66 
Board [Kc 6s Qs 9s]
Seat 1: JeBoyDirk collected (1134)
Seat 2: dddocky (button) folded on the Turn
Seat 4: Duke Croix (small blind) folded on the Turn
Seat 6: color_singleton (big blind) folded on the Turn
Seat 9: Manon541 folded before Flop (didn't bet)



PokerStars Home Game Hand #217635412826: {Club #3225207}  Hold'em No Limit (50/100) - 2020/08/20 17:30:53 ET
Table 'Manuel Neuer' 9-max (Play Money) Seat #4 is the button
Seat 1: JeBoyDirk (23087 in chips) 
Seat 2: dddocky (5657 in chips) 
Seat 4: Duke Croix (11654 in chips) 
Seat 6: color_singleton (9751 in chips) 
Seat 9: Manon541 (5509 in chips) 
color_singleton: posts small blind 50
Manon541: posts big blind 100
*** HOLE CARDS ***
Dealt to Duke Croix [Ac 2s]
JeBoyDirk: calls 100
dddocky: folds 
Duke Croix: calls 100
color_singleton: calls 50
Manon541: checks 
*** FLOP *** [9c Ts 7c]
color_singleton: checks 
Manon541: checks 
JeBoyDirk: bets 200
Duke Croix: folds 
color_singleton: folds 
Manon541: raises 200 to 400
JeBoyDirk: calls 200
*** TURN *** [9c Ts 7c] [6s]
Manon541: bets 1134
JeBoyDirk: folds 
Uncalled bet (1134) returned to Manon541
Manon541 collected 1134 from pot
*** SUMMARY ***
Total pot 1200 | Rake 66 
Board [9c Ts 7c 6s]
Seat 1: JeBoyDirk folded on the Turn
Seat 2: dddocky folded before Flop (didn't bet)
Seat 4: Duke Croix (button) folded on the Flop
Seat 6: color_singleton (small blind) folded on the Flop
Seat 9: Manon541 (big blind) collected (1134)



PokerStars Home Game Hand #217635448107: {Club #3225207}  Hold'em No Limit (50/100) - 2020/08/20 17:31:58 ET
Table 'Manuel Neuer' 9-max (Play Money) Seat #6 is the button
Seat 1: JeBoyDirk (22587 in chips) 
Seat 2: dddocky (5657 in chips) 
Seat 4: Duke Croix (11554 in chips) 
Seat 6: color_singleton (9651 in chips) 
Seat 9: Manon541 (6143 in chips) 
Manon541: posts small blind 50
JeBoyDirk: posts big blind 100
*** HOLE CARDS ***
Dealt to Duke Croix [Kc 6s]
dddocky: folds 
Duke Croix: raises 200 to 300
color_singleton: calls 300
Manon541: calls 250
JeBoyDirk: folds 
*** FLOP *** [5s Kh 8s]
Manon541: checks 
Duke Croix: bets 500
color_singleton: folds 
Manon541: folds 
Uncalled bet (500) returned to Duke Croix
Duke Croix collected 945 from pot
*** SUMMARY ***
Total pot 1000 | Rake 55 
Board [5s Kh 8s]
Seat 1: JeBoyDirk (big blind) folded before Flop
Seat 2: dddocky folded before Flop (didn't bet)
Seat 4: Duke Croix collected (945)
Seat 6: color_singleton (button) folded on the Flop
Seat 9: Manon541 (small blind) folded on the Flop



PokerStars Home Game Hand #217635470462: {Club #3225207}  Hold'em No Limit (50/100) - 2020/08/20 17:32:39 ET
Table 'Manuel Neuer' 9-max (Play Money) Seat #9 is the button
Seat 1: JeBoyDirk (22487 in chips) 
Seat 2: dddocky (5657 in chips) 
Seat 4: Duke Croix (12199 in chips) 
Seat 6: color_singleton (9351 in chips) 
Seat 9: Manon541 (5843 in chips) 
JeBoyDirk: posts small blind 50
dddocky: posts big blind 100
*** HOLE CARDS ***
Dealt to Duke Croix [9h 6c]
Duke Croix: folds 
color_singleton: raises 100 to 200
Manon541: folds 
JeBoyDirk: calls 150
dddocky: calls 100
*** FLOP *** [Tc Td 2h]
JeBoyDirk: checks 
dddocky: checks 
color_singleton: checks 
*** TURN *** [Tc Td 2h] [Kh]
JeBoyDirk: checks 
dddocky: bets 100
color_singleton: folds 
JeBoyDirk: folds 
Uncalled bet (100) returned to dddocky
dddocky collected 567 from pot
dddocky: doesn't show hand 
*** SUMMARY ***
Total pot 600 | Rake 33 
Board [Tc Td 2h Kh]
Seat 1: JeBoyDirk (small blind) folded on the Turn
Seat 2: dddocky (big blind) collected (567)
Seat 4: Duke Croix folded before Flop (didn't bet)
Seat 6: color_singleton folded on the Turn
Seat 9: Manon541 (button) folded before Flop (didn't bet)



PokerStars Home Game Hand #217635483005: {Club #3225207}  Hold'em No Limit (50/100) - 2020/08/20 17:33:02 ET
Table 'Manuel Neuer' 9-max (Play Money) Seat #1 is the button
Seat 1: JeBoyDirk (22287 in chips) 
Seat 2: dddocky (6024 in chips) 
Seat 4: Duke Croix (12199 in chips) 
Seat 6: color_singleton (9151 in chips) 
Seat 9: Manon541 (5843 in chips) 
dddocky: posts small blind 50
Duke Croix: posts big blind 100
*** HOLE CARDS ***
Dealt to Duke Croix [4d 8s]
color_singleton: folds 
Manon541: folds 
JeBoyDirk: folds 
dddocky: calls 50
Duke Croix: checks 
*** FLOP *** [Ad 6s 8h]
dddocky: checks 
Duke Croix: bets 100
dddocky: calls 100
*** TURN *** [Ad 6s 8h] [Js]
dddocky: checks 
Duke Croix: bets 200
dddocky: calls 200
*** RIVER *** [Ad 6s 8h Js] [Qh]
dddocky: checks 
Duke Croix: checks 
*** SHOW DOWN ***
dddocky: shows [Jd Tc] (a pair of Jacks)
Duke Croix: mucks hand 
dddocky collected 756 from pot
*** SUMMARY ***
Total pot 800 | Rake 44 
Board [Ad 6s 8h Js Qh]
Seat 1: JeBoyDirk (button) folded before Flop (didn't bet)
Seat 2: dddocky (small blind) showed [Jd Tc] and won (756) with a pair of Jacks
Seat 4: Duke Croix (big blind) mucked [4d 8s]
Seat 6: color_singleton folded before Flop (didn't bet)
Seat 9: Manon541 folded before Flop (didn't bet)



PokerStars Home Game Hand #217635500457: {Club #3225207}  Hold'em No Limit (50/100) - 2020/08/20 17:33:34 ET
Table 'Manuel Neuer' 9-max (Play Money) Seat #2 is the button
Seat 1: JeBoyDirk (22287 in chips) 
Seat 2: dddocky (6380 in chips) 
Seat 4: Duke Croix (11799 in chips) 
Seat 6: color_singleton (9151 in chips) 
Seat 9: Manon541 (5843 in chips) 
Duke Croix: posts small blind 50
color_singleton: posts big blind 100
*** HOLE CARDS ***
Dealt to Duke Croix [3c Jd]
Manon541: calls 100
JeBoyDirk: calls 100
dddocky: calls 100
Duke Croix: calls 50
color_singleton: checks 
*** FLOP *** [7h 5s 2d]
Duke Croix: checks 
color_singleton: bets 300
Manon541: calls 300
JeBoyDirk: folds 
dddocky: folds 
Duke Croix: folds 
*** TURN *** [7h 5s 2d] [5d]
color_singleton: bets 519
Manon541: raises 519 to 1038
color_singleton: folds 
Uncalled bet (519) returned to Manon541
Manon541 collected 2020 from pot
*** SUMMARY ***
Total pot 2138 | Rake 118 
Board [7h 5s 2d 5d]
Seat 1: JeBoyDirk folded on the Flop
Seat 2: dddocky (button) folded on the Flop
Seat 4: Duke Croix (small blind) folded on the Flop
Seat 6: color_singleton (big blind) folded on the Turn
Seat 9: Manon541 collected (2020)



PokerStars Home Game Hand #217635525441: {Club #3225207}  Hold'em No Limit (50/100) - 2020/08/20 17:34:20 ET
Table 'Manuel Neuer' 9-max (Play Money) Seat #4 is the button
Seat 1: JeBoyDirk (22187 in chips) 
Seat 2: dddocky (6280 in chips) 
Seat 4: Duke Croix (11699 in chips) 
Seat 6: color_singleton (8232 in chips) 
Seat 9: Manon541 (6944 in chips) 
color_singleton: posts small blind 50
Manon541: posts big blind 100
*** HOLE CARDS ***
Dealt to Duke Croix [2s Ts]
JeBoyDirk: folds 
dddocky: calls 100
Duke Croix: folds 
color_singleton: calls 50
Manon541: checks 
*** FLOP *** [8s 2h 5s]
color_singleton: bets 283
Manon541: folds 
dddocky: folds 
Uncalled bet (283) returned to color_singleton
color_singleton collected 283 from pot
color_singleton: doesn't show hand 
*** SUMMARY ***
Total pot 300 | Rake 17 
Board [8s 2h 5s]
Seat 1: JeBoyDirk folded before Flop (didn't bet)
Seat 2: dddocky folded on the Flop
Seat 4: Duke Croix (button) folded before Flop (didn't bet)
Seat 6: color_singleton (small blind) collected (283)
Seat 9: Manon541 (big blind) folded on the Flop



PokerStars Home Game Hand #217635540826: {Club #3225207}  Hold'em No Limit (50/100) - 2020/08/20 17:34:48 ET
Table 'Manuel Neuer' 9-max (Play Money) Seat #6 is the button
Seat 1: JeBoyDirk (22187 in chips) 
Seat 2: dddocky (6180 in chips) 
Seat 4: Duke Croix (11699 in chips) 
Seat 6: color_singleton (8415 in chips) 
Seat 9: Manon541 (6844 in chips) 
Manon541: posts small blind 50
JeBoyDirk: posts big blind 100
*** HOLE CARDS ***
Dealt to Duke Croix [5c 2s]
dddocky: folds 
Duke Croix: folds 
color_singleton: raises 100 to 200
Manon541: calls 150
JeBoyDirk: calls 100
*** FLOP *** [8s 8c 9d]
Manon541: checks 
JeBoyDirk: checks 
color_singleton: checks 
*** TURN *** [8s 8c 9d] [Kc]
Manon541: bets 283
JeBoyDirk: calls 283
color_singleton: calls 283
*** RIVER *** [8s 8c 9d Kc] [Ts]
Manon541: bets 1369
JeBoyDirk: raises 1431 to 2800
color_singleton: folds 
Manon541: calls 1431
*** SHOW DOWN ***
JeBoyDirk: shows [Jd Qc] (a straight, Nine to King)
Manon541: mucks hand 
JeBoyDirk collected 6661 from pot
*** SUMMARY ***
Total pot 7049 | Rake 388 
Board [8s 8c 9d Kc Ts]
Seat 1: JeBoyDirk (big blind) showed [Jd Qc] and won (6661) with a straight, Nine to King
Seat 2: dddocky folded before Flop (didn't bet)
Seat 4: Duke Croix folded before Flop (didn't bet)
Seat 6: color_singleton (button) folded on the River
Seat 9: Manon541 (small blind) mucked [Tc Ks]



PokerStars Home Game Hand #217635573384: {Club #3225207}  Hold'em No Limit (50/100) - 2020/08/20 17:35:48 ET
Table 'Manuel Neuer' 9-max (Play Money) Seat #9 is the button
Seat 1: JeBoyDirk (25565 in chips) 
Seat 4: Duke Croix (11699 in chips) 
Seat 6: color_singleton (7932 in chips) 
Seat 9: Manon541 (3561 in chips) 
JeBoyDirk: posts small blind 50
dddocky has timed out
dddocky: is sitting out 
Duke Croix: posts big blind 100
*** HOLE CARDS ***
Dealt to Duke Croix [9d 3c]
color_singleton: raises 200 to 300
Manon541: calls 300
JeBoyDirk: calls 250
Duke Croix: folds 
*** FLOP *** [Qc 9c Ts]
JeBoyDirk: checks 
color_singleton: checks 
Manon541: checks 
*** TURN *** [Qc 9c Ts] [8h]
JeBoyDirk: checks 
color_singleton: checks 
Manon541: checks 
*** RIVER *** [Qc 9c Ts 8h] [4s]
JeBoyDirk: checks 
color_singleton: checks 
Manon541: checks 
*** SHOW DOWN ***
JeBoyDirk: shows [8s 7s] (a pair of Eights)
color_singleton: mucks hand 
Manon541: shows [Qd Ad] (a pair of Queens)
Manon541 collected 945 from pot
*** SUMMARY ***
Total pot 1000 | Rake 55 
Board [Qc 9c Ts 8h 4s]
Seat 1: JeBoyDirk (small blind) showed [8s 7s] and lost with a pair of Eights
Seat 4: Duke Croix (big blind) folded before Flop
Seat 6: color_singleton mucked [6h Ah]
Seat 9: Manon541 (button) showed [Qd Ad] and won (945) with a pair of Queens



PokerStars Home Game Hand #217635604223: {Club #3225207}  Hold'em No Limit (50/100) - 2020/08/20 17:36:45 ET
Table 'Manuel Neuer' 9-max (Play Money) Seat #1 is the button
Seat 1: JeBoyDirk (25265 in chips) 
Seat 4: Duke Croix (11599 in chips) 
Seat 6: color_singleton (7632 in chips) 
Seat 9: Manon541 (4206 in chips) 
Duke Croix: posts small blind 50
color_singleton: posts big blind 100
*** HOLE CARDS ***
Dealt to Duke Croix [7h 8c]
Manon541: calls 100
JeBoyDirk: calls 100
Duke Croix: calls 50
color_singleton: checks 
*** FLOP *** [Jh 6d Jc]
Duke Croix: checks 
color_singleton: checks 
Manon541: checks 
JeBoyDirk: checks 
*** TURN *** [Jh 6d Jc] [7c]
Duke Croix: checks 
color_singleton: checks 
Manon541: checks 
JeBoyDirk: checks 
*** RIVER *** [Jh 6d Jc 7c] [Qs]
Duke Croix: checks 
color_singleton: bets 189
Manon541: calls 189
JeBoyDirk: folds 
Duke Croix: folds 
*** SHOW DOWN ***
color_singleton: shows [Qc 2s] (two pair, Queens and Jacks)
Manon541: mucks hand 
color_singleton collected 735 from pot
*** SUMMARY ***
Total pot 778 | Rake 43 
Board [Jh 6d Jc 7c Qs]
Seat 1: JeBoyDirk (button) folded on the River
Seat 4: Duke Croix (small blind) folded on the River
Seat 6: color_singleton (big blind) showed [Qc 2s] and won (735) with two pair, Queens and Jacks
Seat 9: Manon541 mucked [Tc As]



PokerStars Home Game Hand #217635632433: {Club #3225207}  Hold'em No Limit (50/100) - 2020/08/20 17:37:38 ET
Table 'Manuel Neuer' 9-max (Play Money) Seat #4 is the button
Seat 1: JeBoyDirk (25165 in chips) 
Seat 2: dddocky (6180 in chips) 
Seat 4: Duke Croix (11499 in chips) 
Seat 6: color_singleton (8078 in chips) 
Seat 9: Manon541 (3917 in chips) 
color_singleton: posts small blind 50
Manon541: posts big blind 100
dddocky: posts small & big blinds 150
*** HOLE CARDS ***
Dealt to Duke Croix [2c 3h]
JeBoyDirk: folds 
dddocky: checks 
Duke Croix: folds 
color_singleton: calls 50
Manon541: checks 
*** FLOP *** [3c 5h Td]
color_singleton: checks 
Manon541: checks 
dddocky: checks 
*** TURN *** [3c 5h Td] [Qs]
color_singleton: bets 165
Manon541: folds 
dddocky: calls 165
*** RIVER *** [3c 5h Td Qs] [Kh]
color_singleton: bets 321
dddocky: calls 321
*** SHOW DOWN ***
color_singleton: shows [5c Qc] (two pair, Queens and Fives)
dddocky: mucks hand 
color_singleton collected 1249 from pot
*** SUMMARY ***
Total pot 1322 | Rake 73 
Board [3c 5h Td Qs Kh]
Seat 1: JeBoyDirk folded before Flop (didn't bet)
Seat 2: dddocky mucked [Qh 7c]
Seat 4: Duke Croix (button) folded before Flop (didn't bet)
Seat 6: color_singleton (small blind) showed [5c Qc] and won (1249) with two pair, Queens and Fives
Seat 9: Manon541 (big blind) folded on the Turn



PokerStars Home Game Hand #217635655631: {Club #3225207}  Hold'em No Limit (50/100) - 2020/08/20 17:38:21 ET
Table 'Manuel Neuer' 9-max (Play Money) Seat #6 is the button
Seat 1: JeBoyDirk (25165 in chips) 
Seat 2: dddocky (5544 in chips) 
Seat 4: Duke Croix (11499 in chips) 
Seat 6: color_singleton (8741 in chips) 
Seat 9: Manon541 (3817 in chips) 
Manon541: posts small blind 50
JeBoyDirk: posts big blind 100
*** HOLE CARDS ***
Dealt to Duke Croix [Ah 5s]
dddocky: calls 100
Duke Croix: raises 200 to 300
color_singleton: calls 300
Manon541: calls 250
JeBoyDirk: folds 
dddocky: calls 200
*** FLOP *** [8d Ts Td]
Manon541: checks 
dddocky: checks 
Duke Croix: checks 
color_singleton: checks 
*** TURN *** [8d Ts Td] [Qd]
Manon541: checks 
dddocky: checks 
Duke Croix: checks 
color_singleton: checks 
*** RIVER *** [8d Ts Td Qd] [5d]
Manon541: bets 614
dddocky: folds 
Duke Croix: folds 
color_singleton: folds 
Uncalled bet (614) returned to Manon541
Manon541 collected 1228 from pot
*** SUMMARY ***
Total pot 1300 | Rake 72 
Board [8d Ts Td Qd 5d]
Seat 1: JeBoyDirk (big blind) folded before Flop
Seat 2: dddocky folded on the River
Seat 4: Duke Croix folded on the River
Seat 6: color_singleton (button) folded on the River
Seat 9: Manon541 (small blind) collected (1228)



PokerStars Home Game Hand #217635681795: {Club #3225207}  Hold'em No Limit (50/100) - 2020/08/20 17:39:02 ET
Table 'Manuel Neuer' 9-max (Play Money) Seat #9 is the button
Seat 1: JeBoyDirk (25065 in chips) 
Seat 2: dddocky (5244 in chips) 
Seat 4: Duke Croix (11199 in chips) 
Seat 6: color_singleton (8441 in chips) 
Seat 9: Manon541 (4745 in chips) 
JeBoyDirk: posts small blind 50
dddocky: posts big blind 100
*** HOLE CARDS ***
Dealt to Duke Croix [Td 9h]
Duke Croix: calls 100
color_singleton: raises 200 to 300
Manon541: folds 
JeBoyDirk: calls 250
dddocky: folds 
Duke Croix: calls 200
*** FLOP *** [9s 5h Ah]
JeBoyDirk: checks 
Duke Croix: checks 
color_singleton: checks 
*** TURN *** [9s 5h Ah] [6d]
JeBoyDirk: checks 
Duke Croix: checks 
color_singleton: bets 472
JeBoyDirk: folds 
Duke Croix: calls 472
*** RIVER *** [9s 5h Ah 6d] [Kd]
Duke Croix: checks 
color_singleton: checks 
*** SHOW DOWN ***
Duke Croix: shows [Td 9h] (a pair of Nines)
color_singleton: shows [Ac Ts] (a pair of Aces)
color_singleton collected 1837 from pot
*** SUMMARY ***
Total pot 1944 | Rake 107 
Board [9s 5h Ah 6d Kd]
Seat 1: JeBoyDirk (small blind) folded on the Turn
Seat 2: dddocky (big blind) folded before Flop
Seat 4: Duke Croix showed [Td 9h] and lost with a pair of Nines
Seat 6: color_singleton showed [Ac Ts] and won (1837) with a pair of Aces
Seat 9: Manon541 (button) folded before Flop (didn't bet)



PokerStars Home Game Hand #217635697494: {Club #3225207}  Hold'em No Limit (50/100) - 2020/08/20 17:39:31 ET
Table 'Manuel Neuer' 9-max (Play Money) Seat #1 is the button
Seat 1: JeBoyDirk (24765 in chips) 
Seat 2: dddocky (5144 in chips) 
Seat 4: Duke Croix (10427 in chips) 
Seat 6: color_singleton (9506 in chips) 
Seat 9: Manon541 (4745 in chips) 
dddocky: posts small blind 50
Duke Croix: posts big blind 100
*** HOLE CARDS ***
Dealt to Duke Croix [2c 6c]
color_singleton: folds 
Manon541: folds 
JeBoyDirk: raises 300 to 400
dddocky: folds 
Duke Croix: folds 
Uncalled bet (300) returned to JeBoyDirk
JeBoyDirk collected 250 from pot
*** SUMMARY ***
Total pot 250 | Rake 0 
Seat 1: JeBoyDirk (button) collected (250)
Seat 2: dddocky (small blind) folded before Flop
Seat 4: Duke Croix (big blind) folded before Flop
Seat 6: color_singleton folded before Flop (didn't bet)
Seat 9: Manon541 folded before Flop (didn't bet)



PokerStars Home Game Hand #217635705899: {Club #3225207}  Hold'em No Limit (50/100) - 2020/08/20 17:39:47 ET
Table 'Manuel Neuer' 9-max (Play Money) Seat #2 is the button
Seat 1: JeBoyDirk (24915 in chips) 
Seat 2: dddocky (5094 in chips) 
Seat 4: Duke Croix (10327 in chips) 
Seat 6: color_singleton (9506 in chips) 
Seat 9: Manon541 (4745 in chips) 
Duke Croix: posts small blind 50
color_singleton: posts big blind 100
*** HOLE CARDS ***
Dealt to Duke Croix [Jh Ah]
Manon541: folds 
JeBoyDirk: folds 
dddocky: folds 
Duke Croix: raises 400 to 500
color_singleton: folds 
Uncalled bet (400) returned to Duke Croix
Duke Croix collected 200 from pot
*** SUMMARY ***
Total pot 200 | Rake 0 
Seat 1: JeBoyDirk folded before Flop (didn't bet)
Seat 2: dddocky (button) folded before Flop (didn't bet)
Seat 4: Duke Croix (small blind) collected (200)
Seat 6: color_singleton (big blind) folded before Flop
Seat 9: Manon541 folded before Flop (didn't bet)



PokerStars Home Game Hand #217635714944: {Club #3225207}  Hold'em No Limit (50/100) - 2020/08/20 17:40:04 ET
Table 'Manuel Neuer' 9-max (Play Money) Seat #4 is the button
Seat 1: JeBoyDirk (24915 in chips) 
Seat 2: dddocky (5094 in chips) 
Seat 4: Duke Croix (10427 in chips) 
Seat 6: color_singleton (9406 in chips) 
Seat 9: Manon541 (4745 in chips) 
color_singleton: posts small blind 50
Manon541: posts big blind 100
*** HOLE CARDS ***
Dealt to Duke Croix [Qs 6s]
JeBoyDirk: folds 
dddocky: calls 100
Duke Croix: calls 100
color_singleton: raises 200 to 300
Manon541: calls 200
dddocky: calls 200
Duke Croix: calls 200
*** FLOP *** [5h 3h 5s]
color_singleton: checks 
Manon541: checks 
dddocky: checks 
Duke Croix: checks 
*** TURN *** [5h 3h 5s] [Qd]
color_singleton: checks 
Manon541: checks 
dddocky: checks 
Duke Croix: bets 600
color_singleton: calls 600
Manon541: folds 
dddocky: folds 
*** RIVER *** [5h 3h 5s Qd] [6d]
color_singleton: checks 
Duke Croix: bets 1500
color_singleton: folds 
Uncalled bet (1500) returned to Duke Croix
Duke Croix collected 2268 from pot
*** SUMMARY ***
Total pot 2400 | Rake 132 
Board [5h 3h 5s Qd 6d]
Seat 1: JeBoyDirk folded before Flop (didn't bet)
Seat 2: dddocky folded on the Turn
Seat 4: Duke Croix (button) collected (2268)
Seat 6: color_singleton (small blind) folded on the River
Seat 9: Manon541 (big blind) folded on the Turn



PokerStars Home Game Hand #217635759927: {Club #3225207}  Hold'em No Limit (50/100) - 2020/08/20 17:41:15 ET
Table 'Manuel Neuer' 9-max (Play Money) Seat #6 is the button
Seat 1: JeBoyDirk (24915 in chips) 
Seat 2: dddocky (4794 in chips) 
Seat 4: Duke Croix (11795 in chips) 
Seat 6: color_singleton (8506 in chips) 
Seat 9: Manon541 (4445 in chips) 
Manon541: posts small blind 50
JeBoyDirk: posts big blind 100
*** HOLE CARDS ***
Dealt to Duke Croix [Ah Td]
dddocky: folds 
Duke Croix: raises 300 to 400
color_singleton: folds 
Manon541: folds 
JeBoyDirk: folds 
Uncalled bet (300) returned to Duke Croix
Duke Croix collected 250 from pot
*** SUMMARY ***
Total pot 250 | Rake 0 
Seat 1: JeBoyDirk (big blind) folded before Flop
Seat 2: dddocky folded before Flop (didn't bet)
Seat 4: Duke Croix collected (250)
Seat 6: color_singleton (button) folded before Flop (didn't bet)
Seat 9: Manon541 (small blind) folded before Flop



PokerStars Home Game Hand #217635774972: {Club #3225207}  Hold'em No Limit (50/100) - 2020/08/20 17:41:43 ET
Table 'Manuel Neuer' 9-max (Play Money) Seat #9 is the button
Seat 1: JeBoyDirk (24815 in chips) 
Seat 2: dddocky (4794 in chips) 
Seat 4: Duke Croix (11945 in chips) 
Seat 6: color_singleton (8506 in chips) 
Seat 9: Manon541 (4395 in chips) 
JeBoyDirk: posts small blind 50
dddocky: posts big blind 100
*** HOLE CARDS ***
Dealt to Duke Croix [2c 4h]
Duke Croix: folds 
color_singleton: folds 
Manon541: calls 100
JeBoyDirk: folds 
dddocky: checks 
*** FLOP *** [9c 4c Td]
dddocky: checks 
Manon541: checks 
*** TURN *** [9c 4c Td] [5h]
dddocky: checks 
Manon541: checks 
*** RIVER *** [9c 4c Td 5h] [5d]
dddocky: checks 
Manon541: checks 
*** SHOW DOWN ***
dddocky: shows [3d 7c] (a pair of Fives)
Manon541: shows [Ks 7d] (a pair of Fives - King kicker)
Manon541 collected 236 from pot
*** SUMMARY ***
Total pot 250 | Rake 14 
Board [9c 4c Td 5h 5d]
Seat 1: JeBoyDirk (small blind) folded before Flop
Seat 2: dddocky (big blind) showed [3d 7c] and lost with a pair of Fives
Seat 4: Duke Croix folded before Flop (didn't bet)
Seat 6: color_singleton folded before Flop (didn't bet)
Seat 9: Manon541 (button) showed [Ks 7d] and won (236) with a pair of Fives



PokerStars Home Game Hand #217635790555: {Club #3225207}  Hold'em No Limit (50/100) - 2020/08/20 17:42:13 ET
Table 'Manuel Neuer' 9-max (Play Money) Seat #1 is the button
Seat 1: JeBoyDirk (24765 in chips) 
Seat 2: dddocky (4694 in chips) 
Seat 4: Duke Croix (11945 in chips) 
Seat 6: color_singleton (8506 in chips) 
Seat 9: Manon541 (4531 in chips) 
dddocky: posts small blind 50
Duke Croix: posts big blind 100
*** HOLE CARDS ***
Dealt to Duke Croix [9s 8s]
color_singleton: folds 
Manon541: calls 100
JeBoyDirk: folds 
dddocky: calls 50
Duke Croix: raises 300 to 400
Manon541: folds 
dddocky: calls 300
*** FLOP *** [3s Kc 5c]
dddocky: checks 
Duke Croix: bets 400
dddocky: folds 
Uncalled bet (400) returned to Duke Croix
Duke Croix collected 850 from pot
*** SUMMARY ***
Total pot 900 | Rake 50 
Board [3s Kc 5c]
Seat 1: JeBoyDirk (button) folded before Flop (didn't bet)
Seat 2: dddocky (small blind) folded on the Flop
Seat 4: Duke Croix (big blind) collected (850)
Seat 6: color_singleton folded before Flop (didn't bet)
Seat 9: Manon541 folded before Flop



PokerStars Home Game Hand #217635803318: {Club #3225207}  Hold'em No Limit (50/100) - 2020/08/20 17:42:37 ET
Table 'Manuel Neuer' 9-max (Play Money) Seat #2 is the button
Seat 1: JeBoyDirk (24765 in chips) 
Seat 2: dddocky (4294 in chips) 
Seat 4: Duke Croix (12395 in chips) 
Seat 6: color_singleton (8506 in chips) 
Seat 9: Manon541 (4431 in chips) 
Duke Croix: posts small blind 50
color_singleton: posts big blind 100
*** HOLE CARDS ***
Dealt to Duke Croix [5c 7s]
Manon541: folds 
JeBoyDirk: folds 
dddocky: calls 100
Duke Croix: calls 50
color_singleton: raises 100 to 200
dddocky: calls 100
Duke Croix: calls 100
*** FLOP *** [2c Jd 6s]
Duke Croix: checks 
color_singleton: checks 
dddocky: bets 100
Duke Croix: folds 
color_singleton: calls 100
*** TURN *** [2c Jd 6s] [8c]
color_singleton: checks 
dddocky: bets 100
color_singleton: calls 100
*** RIVER *** [2c Jd 6s 8c] [Ts]
color_singleton: checks 
dddocky: checks 
*** SHOW DOWN ***
color_singleton: shows [3c Kc] (high card King)
dddocky: shows [Ac Jh] (a pair of Jacks)
dddocky collected 945 from pot
*** SUMMARY ***
Total pot 1000 | Rake 55 
Board [2c Jd 6s 8c Ts]
Seat 1: JeBoyDirk folded before Flop (didn't bet)
Seat 2: dddocky (button) showed [Ac Jh] and won (945) with a pair of Jacks
Seat 4: Duke Croix (small blind) folded on the Flop
Seat 6: color_singleton (big blind) showed [3c Kc] and lost with high card King
Seat 9: Manon541 folded before Flop (didn't bet)



PokerStars Home Game Hand #217635833927: {Club #3225207}  Hold'em No Limit (50/100) - 2020/08/20 17:43:35 ET
Table 'Manuel Neuer' 9-max (Play Money) Seat #4 is the button
Seat 1: JeBoyDirk (24765 in chips) 
Seat 2: dddocky (4839 in chips) 
Seat 4: Duke Croix (12195 in chips) 
Seat 6: color_singleton (8106 in chips) 
Seat 9: Manon541 (4431 in chips) 
color_singleton: posts small blind 50
Manon541: posts big blind 100
*** HOLE CARDS ***
Dealt to Duke Croix [4c 5h]
JeBoyDirk: folds 
dddocky: calls 100
Duke Croix: folds 
color_singleton: folds 
Manon541: checks 
*** FLOP *** [9d Jh Qh]
Manon541: checks 
dddocky: bets 100
Manon541: folds 
Uncalled bet (100) returned to dddocky
dddocky collected 236 from pot
dddocky: doesn't show hand 
*** SUMMARY ***
Total pot 250 | Rake 14 
Board [9d Jh Qh]
Seat 1: JeBoyDirk folded before Flop (didn't bet)
Seat 2: dddocky collected (236)
Seat 4: Duke Croix (button) folded before Flop (didn't bet)
Seat 6: color_singleton (small blind) folded before Flop
Seat 9: Manon541 (big blind) folded on the Flop



PokerStars Home Game Hand #217635846448: {Club #3225207}  Hold'em No Limit (50/100) - 2020/08/20 17:43:58 ET
Table 'Manuel Neuer' 9-max (Play Money) Seat #6 is the button
Seat 1: JeBoyDirk (24765 in chips) 
Seat 2: dddocky (4975 in chips) 
Seat 4: Duke Croix (12195 in chips) 
Seat 6: color_singleton (8056 in chips) 
Seat 9: Manon541 (4331 in chips) 
Manon541: posts small blind 50
JeBoyDirk: posts big blind 100
*** HOLE CARDS ***
Dealt to Duke Croix [Ah 3s]
dddocky: folds 
Duke Croix: raises 300 to 400
color_singleton: calls 400
Manon541: folds 
JeBoyDirk: calls 300
*** FLOP *** [3d Th 4h]
JeBoyDirk: checks 
Duke Croix: checks 
color_singleton: checks 
*** TURN *** [3d Th 4h] [4c]
JeBoyDirk: checks 
Duke Croix: checks 
color_singleton: checks 
*** RIVER *** [3d Th 4h 4c] [5d]
JeBoyDirk: checks 
Duke Croix: bets 500
color_singleton: calls 500
JeBoyDirk: folds 
*** SHOW DOWN ***
Duke Croix: shows [Ah 3s] (two pair, Fours and Threes)
color_singleton: mucks hand 
Duke Croix collected 2126 from pot
*** SUMMARY ***
Total pot 2250 | Rake 124 
Board [3d Th 4h 4c 5d]
Seat 1: JeBoyDirk (big blind) folded on the River
Seat 2: dddocky folded before Flop (didn't bet)
Seat 4: Duke Croix showed [Ah 3s] and won (2126) with two pair, Fours and Threes
Seat 6: color_singleton (button) mucked [8s As]
Seat 9: Manon541 (small blind) folded before Flop



PokerStars Home Game Hand #217635875225: {Club #3225207}  Hold'em No Limit (50/100) - 2020/08/20 17:44:52 ET
Table 'Manuel Neuer' 9-max (Play Money) Seat #9 is the button
Seat 1: JeBoyDirk (24365 in chips) 
Seat 2: dddocky (4975 in chips) 
Seat 4: Duke Croix (13421 in chips) 
Seat 6: color_singleton (7156 in chips) 
Seat 9: Manon541 (4281 in chips) 
JeBoyDirk: posts small blind 50
dddocky: posts big blind 100
*** HOLE CARDS ***
Dealt to Duke Croix [Jd Qs]
Duke Croix: raises 300 to 400
color_singleton: calls 400
Manon541: calls 400
JeBoyDirk: folds 
dddocky: folds 
*** FLOP *** [3h 8h Th]
Duke Croix: checks 
color_singleton: bets 1276
Manon541: folds 
Duke Croix: folds 
Uncalled bet (1276) returned to color_singleton
color_singleton collected 1276 from pot
color_singleton: doesn't show hand 
*** SUMMARY ***
Total pot 1350 | Rake 74 
Board [3h 8h Th]
Seat 1: JeBoyDirk (small blind) folded before Flop
Seat 2: dddocky (big blind) folded before Flop
Seat 4: Duke Croix folded on the Flop
Seat 6: color_singleton collected (1276)
Seat 9: Manon541 (button) folded on the Flop



PokerStars Home Game Hand #217635889198: {Club #3225207}  Hold'em No Limit (50/100) - 2020/08/20 17:45:19 ET
Table 'Manuel Neuer' 9-max (Play Money) Seat #1 is the button
Seat 1: JeBoyDirk (24315 in chips) 
Seat 4: Duke Croix (13021 in chips) 
Seat 6: color_singleton (8032 in chips) 
Seat 9: Manon541 (3881 in chips) 
Duke Croix: posts small blind 50
color_singleton: posts big blind 100
*** HOLE CARDS ***
Dealt to Duke Croix [3h 7c]
Manon541: folds 
JeBoyDirk: folds 
Duke Croix: calls 50
color_singleton: raises 100 to 200
Duke Croix: calls 100
*** FLOP *** [Kh As 3d]
Duke Croix: bets 200
color_singleton: calls 200
*** TURN *** [Kh As 3d] [4h]
Duke Croix: checks 
color_singleton: checks 
*** RIVER *** [Kh As 3d 4h] [Td]
Duke Croix: bets 400
color_singleton: calls 400
*** SHOW DOWN ***
Duke Croix: shows [3h 7c] (a pair of Threes)
color_singleton: shows [5d Kd] (a pair of Kings)
color_singleton collected 1512 from pot
*** SUMMARY ***
Total pot 1600 | Rake 88 
Board [Kh As 3d 4h Td]
Seat 1: JeBoyDirk (button) folded before Flop (didn't bet)
Seat 4: Duke Croix (small blind) showed [3h 7c] and lost with a pair of Threes
Seat 6: color_singleton (big blind) showed [5d Kd] and won (1512) with a pair of Kings
Seat 9: Manon541 folded before Flop (didn't bet)



PokerStars Home Game Hand #217635908645: {Club #3225207}  Hold'em No Limit (50/100) - 2020/08/20 17:45:56 ET
Table 'Manuel Neuer' 9-max (Play Money) Seat #4 is the button
Seat 1: JeBoyDirk (24315 in chips) 
Seat 4: Duke Croix (12221 in chips) 
Seat 6: color_singleton (8744 in chips) 
Seat 9: Manon541 (3881 in chips) 
color_singleton: posts small blind 50
Manon541: posts big blind 100
*** HOLE CARDS ***
Dealt to Duke Croix [Jc 5c]
JeBoyDirk: calls 100
Duke Croix: calls 100
color_singleton: calls 50
Manon541: checks 
*** FLOP *** [Kd Jh 7c]
color_singleton: checks 
Manon541: checks 
JeBoyDirk: bets 100
Duke Croix: calls 100
color_singleton: folds 
Manon541: folds 
*** TURN *** [Kd Jh 7c] [Ah]
JeBoyDirk: bets 300
Duke Croix: folds 
Uncalled bet (300) returned to JeBoyDirk
JeBoyDirk collected 567 from pot
*** SUMMARY ***
Total pot 600 | Rake 33 
Board [Kd Jh 7c Ah]
Seat 1: JeBoyDirk collected (567)
Seat 4: Duke Croix (button) folded on the Turn
Seat 6: color_singleton (small blind) folded on the Flop
Seat 9: Manon541 (big blind) folded on the Flop



PokerStars Home Game Hand #217635927118: {Club #3225207}  Hold'em No Limit (50/100) - 2020/08/20 17:46:31 ET
Table 'Manuel Neuer' 9-max (Play Money) Seat #6 is the button
Seat 1: JeBoyDirk (24682 in chips) 
Seat 4: Duke Croix (12021 in chips) 
Seat 6: color_singleton (8644 in chips) 
Seat 9: Manon541 (3781 in chips) 
Manon541: posts small blind 50
JeBoyDirk: posts big blind 100
*** HOLE CARDS ***
Dealt to Duke Croix [Ks Ad]
Duke Croix: raises 300 to 400
color_singleton: calls 400
Manon541: calls 350
JeBoyDirk: calls 300
*** FLOP *** [Kc 3h Th]
Manon541: checks 
JeBoyDirk: checks 
Duke Croix: bets 800
color_singleton: calls 800
Manon541: calls 800
JeBoyDirk: folds 
*** TURN *** [Kc 3h Th] [2s]
Manon541: checks 
Duke Croix: bets 1900
color_singleton: calls 1900
Manon541: folds 
*** RIVER *** [Kc 3h Th 2s] [3c]
Duke Croix: bets 2000
color_singleton: calls 2000
*** SHOW DOWN ***
Duke Croix: shows [Ks Ad] (two pair, Kings and Threes)
color_singleton: mucks hand 
Duke Croix collected 11151 from pot
*** SUMMARY ***
Total pot 11800 | Rake 649 
Board [Kc 3h Th 2s 3c]
Seat 1: JeBoyDirk (big blind) folded on the Flop
Seat 4: Duke Croix showed [Ks Ad] and won (11151) with two pair, Kings and Threes
Seat 6: color_singleton (button) mucked [Kh 2h]
Seat 9: Manon541 (small blind) folded on the Turn



PokerStars Home Game Hand #217635955433: {Club #3225207}  Hold'em No Limit (50/100) - 2020/08/20 17:47:25 ET
Table 'Manuel Neuer' 9-max (Play Money) Seat #9 is the button
Seat 1: JeBoyDirk (24282 in chips) 
Seat 2: dddocky (4875 in chips) 
Seat 4: Duke Croix (18072 in chips) 
Seat 6: color_singleton (3544 in chips) 
Seat 9: Manon541 (2581 in chips) 
JeBoyDirk: posts small blind 50
dddocky: posts big blind 100
*** HOLE CARDS ***
Dealt to Duke Croix [9h Jd]
Duke Croix: folds 
color_singleton: calls 100
Manon541: calls 100
JeBoyDirk: calls 50
dddocky: checks 
*** FLOP *** [3s 2c 2d]
JeBoyDirk: checks 
dddocky: checks 
color_singleton: checks 
Manon541: checks 
*** TURN *** [3s 2c 2d] [7s]
JeBoyDirk: checks 
dddocky: checks 
color_singleton: bets 189
Manon541: calls 189
JeBoyDirk: folds 
dddocky: calls 189
*** RIVER *** [3s 2c 2d 7s] [5h]
dddocky: bets 457
color_singleton: folds 
Manon541: folds 
Uncalled bet (457) returned to dddocky
dddocky collected 914 from pot
dddocky: doesn't show hand 
*** SUMMARY ***
Total pot 967 | Rake 53 
Board [3s 2c 2d 7s 5h]
Seat 1: JeBoyDirk (small blind) folded on the Turn
Seat 2: dddocky (big blind) collected (914)
Seat 4: Duke Croix folded before Flop (didn't bet)
Seat 6: color_singleton folded on the River
Seat 9: Manon541 (button) folded on the River



PokerStars Home Game Hand #217635983114: {Club #3225207}  Hold'em No Limit (50/100) - 2020/08/20 17:48:18 ET
Table 'Manuel Neuer' 9-max (Play Money) Seat #1 is the button
Seat 1: JeBoyDirk (24182 in chips) 
Seat 2: dddocky (5500 in chips) 
Seat 4: Duke Croix (18072 in chips) 
Seat 6: color_singleton (3255 in chips) 
Seat 9: Manon541 (2292 in chips) 
dddocky: posts small blind 50
Duke Croix: posts big blind 100
*** HOLE CARDS ***
Dealt to Duke Croix [Qd 3h]
color_singleton: raises 200 to 300
Manon541: folds 
JeBoyDirk: calls 300
dddocky: folds 
Duke Croix: folds 
*** FLOP *** [6s 8h 4d]
color_singleton: checks 
JeBoyDirk: checks 
*** TURN *** [6s 8h 4d] [2s]
color_singleton: checks 
JeBoyDirk: checks 
*** RIVER *** [6s 8h 4d 2s] [Ah]
color_singleton: bets 354
JeBoyDirk: folds 
Uncalled bet (354) returned to color_singleton
color_singleton collected 709 from pot
color_singleton: doesn't show hand 
*** SUMMARY ***
Total pot 750 | Rake 41 
Board [6s 8h 4d 2s Ah]
Seat 1: JeBoyDirk (button) folded on the River
Seat 2: dddocky (small blind) folded before Flop
Seat 4: Duke Croix (big blind) folded before Flop
Seat 6: color_singleton collected (709)
Seat 9: Manon541 folded before Flop (didn't bet)



PokerStars Home Game Hand #217635997062: {Club #3225207}  Hold'em No Limit (50/100) - 2020/08/20 17:48:45 ET
Table 'Manuel Neuer' 9-max (Play Money) Seat #2 is the button
Seat 1: JeBoyDirk (23882 in chips) 
Seat 2: dddocky (5450 in chips) 
Seat 4: Duke Croix (17972 in chips) 
Seat 6: color_singleton (3664 in chips) 
Seat 9: Manon541 (2292 in chips) 
Duke Croix: posts small blind 50
color_singleton: posts big blind 100
*** HOLE CARDS ***
Dealt to Duke Croix [Kc 7s]
Manon541: calls 100
JeBoyDirk: folds 
dddocky: calls 100
Duke Croix: calls 50
color_singleton: raises 200 to 300
Manon541: calls 200
dddocky: calls 200
Duke Croix: calls 200
*** FLOP *** [Ah 7d 4h]
Duke Croix: checks 
color_singleton: bets 567
Manon541: folds 
dddocky: folds 
Duke Croix: folds 
Uncalled bet (567) returned to color_singleton
color_singleton collected 1134 from pot
color_singleton: doesn't show hand 
*** SUMMARY ***
Total pot 1200 | Rake 66 
Board [Ah 7d 4h]
Seat 1: JeBoyDirk folded before Flop (didn't bet)
Seat 2: dddocky (button) folded on the Flop
Seat 4: Duke Croix (small blind) folded on the Flop
Seat 6: color_singleton (big blind) collected (1134)
Seat 9: Manon541 folded on the Flop



PokerStars Home Game Hand #217636012780: {Club #3225207}  Hold'em No Limit (50/100) - 2020/08/20 17:49:16 ET
Table 'Manuel Neuer' 9-max (Play Money) Seat #4 is the button
Seat 1: JeBoyDirk (23882 in chips) 
Seat 2: dddocky (5150 in chips) 
Seat 4: Duke Croix (17672 in chips) 
Seat 6: color_singleton (4498 in chips) 
Seat 9: Manon541 (1992 in chips) 
color_singleton: posts small blind 50
Manon541: posts big blind 100
*** HOLE CARDS ***
Dealt to Duke Croix [9d Kh]
JeBoyDirk: calls 100
dddocky: calls 100
Duke Croix has timed out
Duke Croix: folds 
color_singleton: raises 200 to 300
Manon541: calls 200
JeBoyDirk: calls 200
dddocky: folds 
*** FLOP *** [Qs 3c Qh]
color_singleton: checks 
Manon541: checks 
JeBoyDirk: checks 
*** TURN *** [Qs 3c Qh] [Th]
color_singleton: bets 472
Manon541: folds 
JeBoyDirk: folds 
Uncalled bet (472) returned to color_singleton
color_singleton collected 945 from pot
color_singleton: doesn't show hand 
*** SUMMARY ***
Total pot 1000 | Rake 55 
Board [Qs 3c Qh Th]
Seat 1: JeBoyDirk folded on the Turn
Seat 2: dddocky folded before Flop
Seat 4: Duke Croix (button) folded before Flop (didn't bet)
Seat 6: color_singleton (small blind) collected (945)
Seat 9: Manon541 (big blind) folded on the Turn



PokerStars Home Game Hand #217636042486: {Club #3225207}  Hold'em No Limit (50/100) - 2020/08/20 17:50:13 ET
Table 'Manuel Neuer' 9-max (Play Money) Seat #6 is the button
Seat 1: JeBoyDirk (23582 in chips) 
Seat 2: dddocky (5050 in chips) 
Seat 4: Duke Croix (17672 in chips) 
Seat 6: color_singleton (5143 in chips) 
Seat 9: Manon541 (1692 in chips) 
Manon541: posts small blind 50
JeBoyDirk: posts big blind 100
*** HOLE CARDS ***
Dealt to Duke Croix [Qc 2s]
dddocky: calls 100
Duke Croix: folds 
color_singleton: folds 
Manon541: calls 50
JeBoyDirk: checks 
*** FLOP *** [4h Kc As]
Manon541: bets 141
JeBoyDirk: calls 141
dddocky: folds 
*** TURN *** [4h Kc As] [5c]
Manon541: bets 275
JeBoyDirk: calls 275
*** RIVER *** [4h Kc As 5c] [3h]
Manon541: bets 535
JeBoyDirk: calls 535
*** SHOW DOWN ***
Manon541: shows [Qh Ah] (a pair of Aces)
JeBoyDirk: mucks hand 
Manon541 collected 2081 from pot
*** SUMMARY ***
Total pot 2202 | Rake 121 
Board [4h Kc As 5c 3h]
Seat 1: JeBoyDirk (big blind) mucked [Ad 8h]
Seat 2: dddocky folded on the Flop
Seat 4: Duke Croix folded before Flop (didn't bet)
Seat 6: color_singleton (button) folded before Flop (didn't bet)
Seat 9: Manon541 (small blind) showed [Qh Ah] and won (2081) with a pair of Aces



PokerStars Home Game Hand #217636061116: {Club #3225207}  Hold'em No Limit (50/100) - 2020/08/20 17:50:49 ET
Table 'Manuel Neuer' 9-max (Play Money) Seat #9 is the button
Seat 1: JeBoyDirk (22531 in chips) 
Seat 2: dddocky (4950 in chips) 
Seat 4: Duke Croix (17672 in chips) 
Seat 6: color_singleton (5143 in chips) 
Seat 9: Manon541 (2722 in chips) 
JeBoyDirk: posts small blind 50
dddocky: posts big blind 100
*** HOLE CARDS ***
Dealt to Duke Croix [3s Kd]
Duke Croix has timed out
Duke Croix: folds 
color_singleton: raises 200 to 300
Manon541: folds 
JeBoyDirk: calls 250
dddocky: calls 200
*** FLOP *** [As Qs 7c]
JeBoyDirk: checks 
dddocky: checks 
color_singleton: checks 
*** TURN *** [As Qs 7c] [Kc]
JeBoyDirk: bets 400
dddocky: folds 
color_singleton: calls 400
*** RIVER *** [As Qs 7c Kc] [7d]
JeBoyDirk: checks 
color_singleton: checks 
*** SHOW DOWN ***
JeBoyDirk: shows [5h 5c] (two pair, Sevens and Fives)
color_singleton: shows [8h Kh] (two pair, Kings and Sevens)
color_singleton collected 1606 from pot
*** SUMMARY ***
Total pot 1700 | Rake 94 
Board [As Qs 7c Kc 7d]
Seat 1: JeBoyDirk (small blind) showed [5h 5c] and lost with two pair, Sevens and Fives
Seat 2: dddocky (big blind) folded on the Turn
Seat 4: Duke Croix folded before Flop (didn't bet)
Seat 6: color_singleton showed [8h Kh] and won (1606) with two pair, Kings and Sevens
Seat 9: Manon541 (button) folded before Flop (didn't bet)



PokerStars Home Game Hand #217636254237: {Club #3225207}  Hold'em No Limit (50/100) - 2020/08/20 17:57:42 ET
Table 'Manuel Neuer' 9-max (Play Money) Seat #1 is the button
Seat 1: JeBoyDirk (25551 in chips) 
Seat 2: dddocky (4003 in chips) 
Seat 4: Duke Croix (17672 in chips) 
Seat 6: color_singleton (5252 in chips) 
Seat 9: Manon541 (9226 in chips) 
dddocky: posts small blind 50
Duke Croix: posts big blind 100
*** HOLE CARDS ***
Dealt to Duke Croix [Jh 9s]
color_singleton: calls 100
Manon541: folds 
JeBoyDirk: folds 
dddocky: calls 50
Duke Croix: checks 
*** FLOP *** [5d 5s 7h]
dddocky: checks 
Duke Croix: checks 
color_singleton: bets 141
dddocky: folds 
Duke Croix: folds 
Uncalled bet (141) returned to color_singleton
color_singleton collected 283 from pot
color_singleton: doesn't show hand 
*** SUMMARY ***
Total pot 300 | Rake 17 
Board [5d 5s 7h]
Seat 1: JeBoyDirk (button) folded before Flop (didn't bet)
Seat 2: dddocky (small blind) folded on the Flop
Seat 4: Duke Croix (big blind) folded on the Flop
Seat 6: color_singleton collected (283)
Seat 9: Manon541 folded before Flop (didn't bet)



PokerStars Home Game Hand #217636268593: {Club #3225207}  Hold'em No Limit (50/100) - 2020/08/20 17:58:18 ET
Table 'Manuel Neuer' 9-max (Play Money) Seat #2 is the button
Seat 1: JeBoyDirk (25551 in chips) 
Seat 2: dddocky (3903 in chips) 
Seat 4: Duke Croix (17572 in chips) 
Seat 6: color_singleton (5435 in chips) 
Seat 9: Manon541 (9226 in chips) 
Duke Croix: posts small blind 50
color_singleton: posts big blind 100
*** HOLE CARDS ***
Dealt to Duke Croix [6h Ac]
Manon541: calls 100
JeBoyDirk: folds 
dddocky: calls 100
Duke Croix: calls 50
color_singleton: checks 
*** FLOP *** [5d 9d 8c]
Duke Croix: checks 
color_singleton: checks 
Manon541: checks 
dddocky: checks 
*** TURN *** [5d 9d 8c] [4c]
Duke Croix: checks 
color_singleton: checks 
Manon541: checks 
dddocky: checks 
*** RIVER *** [5d 9d 8c 4c] [2s]
Duke Croix: checks 
color_singleton: checks 
Manon541: checks 
dddocky: checks 
*** SHOW DOWN ***
Duke Croix: shows [6h Ac] (high card Ace)
color_singleton: mucks hand 
Manon541: mucks hand 
dddocky: mucks hand 
Duke Croix collected 378 from pot
*** SUMMARY ***
Total pot 400 | Rake 22 
Board [5d 9d 8c 4c 2s]
Seat 1: JeBoyDirk folded before Flop (didn't bet)
Seat 2: dddocky (button) mucked [Ts Jc]
Seat 4: Duke Croix (small blind) showed [6h Ac] and won (378) with high card Ace
Seat 6: color_singleton (big blind) mucked [Td 3c]
Seat 9: Manon541 mucked [Th Qc]



PokerStars Home Game Hand #217636280959: {Club #3225207}  Hold'em No Limit (50/100) - 2020/08/20 17:58:49 ET
Table 'Manuel Neuer' 9-max (Play Money) Seat #4 is the button
Seat 1: JeBoyDirk (25551 in chips) 
Seat 2: dddocky (3803 in chips) 
Seat 4: Duke Croix (17850 in chips) 
Seat 6: color_singleton (5335 in chips) 
Seat 9: Manon541 (9126 in chips) 
color_singleton: posts small blind 50
Manon541: posts big blind 100
*** HOLE CARDS ***
Dealt to Duke Croix [7c 8d]
JeBoyDirk: folds 
dddocky: calls 100
Duke Croix: calls 100
color_singleton: folds 
Manon541: checks 
*** FLOP *** [7d Kd 6s]
Manon541: bets 165
dddocky: calls 165
Duke Croix: calls 165
*** TURN *** [7d Kd 6s] [Qc]
Manon541: bets 399
dddocky: calls 399
Duke Croix: folds 
*** RIVER *** [7d Kd 6s Qc] [Js]
Manon541: bets 776
dddocky: calls 776
*** SHOW DOWN ***
Manon541: shows [Ac Ks] (a pair of Kings)
dddocky: shows [Qs 7s] (two pair, Queens and Sevens)
dddocky collected 3019 from pot
*** SUMMARY ***
Total pot 3195 | Rake 176 
Board [7d Kd 6s Qc Js]
Seat 1: JeBoyDirk folded before Flop (didn't bet)
Seat 2: dddocky showed [Qs 7s] and won (3019) with two pair, Queens and Sevens
Seat 4: Duke Croix (button) folded on the Turn
Seat 6: color_singleton (small blind) folded before Flop
Seat 9: Manon541 (big blind) showed [Ac Ks] and lost with a pair of Kings



PokerStars Home Game Hand #217636294042: {Club #3225207}  Hold'em No Limit (50/100) - 2020/08/20 17:59:22 ET
Table 'Manuel Neuer' 9-max (Play Money) Seat #6 is the button
Seat 1: JeBoyDirk (25551 in chips) 
Seat 2: dddocky (5382 in chips) 
Seat 4: Duke Croix (17585 in chips) 
Seat 6: color_singleton (5285 in chips) 
Seat 9: Manon541 (7686 in chips) 
Manon541: posts small blind 50
JeBoyDirk: posts big blind 100
*** HOLE CARDS ***
Dealt to Duke Croix [8s Ad]
dddocky: calls 100
Duke Croix: raises 300 to 400
color_singleton: calls 400
Manon541: calls 350
JeBoyDirk: folds 
dddocky: calls 300
*** FLOP *** [Ac 6c Ah]
Manon541: bets 803
dddocky: calls 803
Duke Croix: calls 803
color_singleton: calls 803
*** TURN *** [Ac 6c Ah] [6s]
Manon541: bets 2321
dddocky: folds 
Duke Croix: raises 9284 to 11605
color_singleton: folds 
Manon541: calls 4162 and is all-in
Uncalled bet (5122) returned to Duke Croix
*** RIVER *** [Ac 6c Ah 6s] [2d]
*** SHOW DOWN ***
Manon541: shows [As 9c] (a full house, Aces full of Sixes)
Duke Croix: shows [8s Ad] (a full house, Aces full of Sixes)
Manon541 collected 8448 from pot
Duke Croix collected 8447 from pot
*** SUMMARY ***
Total pot 17878 | Rake 983 
Board [Ac 6c Ah 6s 2d]
Seat 1: JeBoyDirk (big blind) folded before Flop
Seat 2: dddocky folded on the Turn
Seat 4: Duke Croix showed [8s Ad] and won (8447) with a full house, Aces full of Sixes
Seat 6: color_singleton (button) folded on the Turn
Seat 9: Manon541 (small blind) showed [As 9c] and won (8448) with a full house, Aces full of Sixes



PokerStars Home Game Hand #217636315397: {Club #3225207}  Hold'em No Limit (50/100) - 2020/08/20 18:00:15 ET
Table 'Manuel Neuer' 9-max (Play Money) Seat #9 is the button
Seat 1: JeBoyDirk (25451 in chips) 
Seat 2: dddocky (4179 in chips) 
Seat 4: Duke Croix (18346 in chips) 
Seat 6: color_singleton (4082 in chips) 
Seat 9: Manon541 (8448 in chips) 
JeBoyDirk: posts small blind 50
dddocky: posts big blind 100
*** HOLE CARDS ***
Dealt to Duke Croix [Qc 7d]
Duke Croix: calls 100
color_singleton: folds 
Manon541: calls 100
JeBoyDirk: calls 50
dddocky: checks 
*** FLOP *** [6c Js 4d]
JeBoyDirk: checks 
dddocky: bets 100
Duke Croix: folds 
Manon541: calls 100
JeBoyDirk: folds 
*** TURN *** [6c Js 4d] [Kc]
dddocky: bets 100
Manon541: calls 100
*** RIVER *** [6c Js 4d Kc] [7s]
dddocky: bets 100
Manon541: calls 100
*** SHOW DOWN ***
dddocky: shows [Jd Td] (a pair of Jacks)
Manon541: mucks hand 
dddocky collected 945 from pot
*** SUMMARY ***
Total pot 1000 | Rake 55 
Board [6c Js 4d Kc 7s]
Seat 1: JeBoyDirk (small blind) folded on the Flop
Seat 2: dddocky (big blind) showed [Jd Td] and won (945) with a pair of Jacks
Seat 4: Duke Croix folded on the Flop
Seat 6: color_singleton folded before Flop (didn't bet)
Seat 9: Manon541 (button) mucked [Ac 9h]



PokerStars Home Game Hand #217636332914: {Club #3225207}  Hold'em No Limit (50/100) - 2020/08/20 18:00:57 ET
Table 'Manuel Neuer' 9-max (Play Money) Seat #1 is the button
Seat 1: JeBoyDirk (25351 in chips) 
Seat 2: dddocky (4724 in chips) 
Seat 4: Duke Croix (18246 in chips) 
Seat 6: color_singleton (4082 in chips) 
Seat 9: Manon541 (8048 in chips) 
dddocky: posts small blind 50
Duke Croix: posts big blind 100
*** HOLE CARDS ***
Dealt to Duke Croix [Kd 8d]
color_singleton: raises 200 to 300
Manon541: folds 
JeBoyDirk: folds 
dddocky: calls 250
Duke Croix: calls 200
*** FLOP *** [Jc 8h Ts]
dddocky: bets 425
Duke Croix: folds 
color_singleton: calls 425
*** TURN *** [Jc 8h Ts] [2c]
dddocky: checks 
color_singleton: checks 
*** RIVER *** [Jc 8h Ts 2c] [5s]
dddocky: checks 
color_singleton: checks 
*** SHOW DOWN ***
dddocky: shows [Qh Jd] (a pair of Jacks)
color_singleton: mucks hand 
dddocky collected 1654 from pot
*** SUMMARY ***
Total pot 1750 | Rake 96 
Board [Jc 8h Ts 2c 5s]
Seat 1: JeBoyDirk (button) folded before Flop (didn't bet)
Seat 2: dddocky (small blind) showed [Qh Jd] and won (1654) with a pair of Jacks
Seat 4: Duke Croix (big blind) folded on the Flop
Seat 6: color_singleton mucked [8s 7s]
Seat 9: Manon541 folded before Flop (didn't bet)



PokerStars Home Game Hand #217636345407: {Club #3225207}  Hold'em No Limit (50/100) - 2020/08/20 18:01:23 ET
Table 'Manuel Neuer' 9-max (Play Money) Seat #2 is the button
Seat 1: JeBoyDirk (25351 in chips) 
Seat 2: dddocky (5653 in chips) 
Seat 4: Duke Croix (17946 in chips) 
Seat 6: color_singleton (3357 in chips) 
Seat 9: Manon541 (8048 in chips) 
Duke Croix: posts small blind 50
color_singleton: posts big blind 100
*** HOLE CARDS ***
Dealt to Duke Croix [6h 6s]
Manon541: calls 100
JeBoyDirk: folds 
dddocky: calls 100
Duke Croix: calls 50
color_singleton: checks 
*** FLOP *** [Qh Ad 8s]
Duke Croix: checks 
color_singleton: checks 
Manon541: checks 
dddocky: bets 100
Duke Croix: folds 
color_singleton: folds 
Manon541: calls 100
*** TURN *** [Qh Ad 8s] [Ah]
Manon541: checks 
dddocky: bets 100
Manon541: calls 100
*** RIVER *** [Qh Ad 8s Ah] [Jh]
Manon541: bets 756
dddocky: calls 756
*** SHOW DOWN ***
Manon541: shows [Th Kc] (a straight, Ten to Ace)
dddocky: mucks hand 
Manon541 collected 2185 from pot
*** SUMMARY ***
Total pot 2312 | Rake 127 
Board [Qh Ad 8s Ah Jh]
Seat 1: JeBoyDirk folded before Flop (didn't bet)
Seat 2: dddocky (button) mucked [Ks Kh]
Seat 4: Duke Croix (small blind) folded on the Flop
Seat 6: color_singleton (big blind) folded on the Flop
Seat 9: Manon541 showed [Th Kc] and won (2185) with a straight, Ten to Ace



PokerStars Home Game Hand #217636367882: {Club #3225207}  Hold'em No Limit (50/100) - 2020/08/20 18:02:10 ET
Table 'Manuel Neuer' 9-max (Play Money) Seat #4 is the button
Seat 1: JeBoyDirk (25351 in chips) 
Seat 2: dddocky (4597 in chips) 
Seat 4: Duke Croix (17846 in chips) 
Seat 6: color_singleton (3257 in chips) 
Seat 9: Manon541 (9177 in chips) 
color_singleton: posts small blind 50
Manon541: posts big blind 100
*** HOLE CARDS ***
Dealt to Duke Croix [6s 3s]
JeBoyDirk: folds 
dddocky: folds 
Duke Croix: calls 100
color_singleton: folds 
Manon541: checks 
*** FLOP *** [4h Ah 4c]
Manon541: checks 
Duke Croix: checks 
*** TURN *** [4h Ah 4c] [4d]
Manon541: checks 
Duke Croix: checks 
*** RIVER *** [4h Ah 4c 4d] [Qc]
Manon541: checks 
Duke Croix: checks 
*** SHOW DOWN ***
Manon541: shows [7s 5s] (three of a kind, Fours)
Duke Croix: shows [6s 3s] (three of a kind, Fours)
Manon541 collected 118 from pot
Duke Croix collected 118 from pot
*** SUMMARY ***
Total pot 250 | Rake 14 
Board [4h Ah 4c 4d Qc]
Seat 1: JeBoyDirk folded before Flop (didn't bet)
Seat 2: dddocky folded before Flop (didn't bet)
Seat 4: Duke Croix (button) showed [6s 3s] and won (118) with three of a kind, Fours
Seat 6: color_singleton (small blind) folded before Flop
Seat 9: Manon541 (big blind) showed [7s 5s] and won (118) with three of a kind, Fours



PokerStars Home Game Hand #217636381506: {Club #3225207}  Hold'em No Limit (50/100) - 2020/08/20 18:02:38 ET
Table 'Manuel Neuer' 9-max (Play Money) Seat #6 is the button
Seat 1: JeBoyDirk (25351 in chips) 
Seat 2: dddocky (4597 in chips) 
Seat 4: Duke Croix (17864 in chips) 
Seat 6: color_singleton (3207 in chips) 
Seat 9: Manon541 (9195 in chips) 
Manon541: posts small blind 50
JeBoyDirk: posts big blind 100
*** HOLE CARDS ***
Dealt to Duke Croix [Jc 5h]
dddocky: calls 100
Duke Croix: folds 
color_singleton: calls 100
Manon541: folds 
JeBoyDirk: checks 
*** FLOP *** [Jd 8s Tc]
JeBoyDirk: checks 
dddocky: bets 100
color_singleton: raises 265 to 365
JeBoyDirk: folds 
dddocky: calls 265
*** TURN *** [Jd 8s Tc] [2c]
dddocky: checks 
color_singleton: bets 510
dddocky: calls 510
*** RIVER *** [Jd 8s Tc 2c] [Ac]
dddocky: checks 
color_singleton: checks 
*** SHOW DOWN ***
dddocky: shows [Qc Qh] (a pair of Queens)
color_singleton: mucks hand 
dddocky collected 1984 from pot
*** SUMMARY ***
Total pot 2100 | Rake 116 
Board [Jd 8s Tc 2c Ac]
Seat 1: JeBoyDirk (big blind) folded on the Flop
Seat 2: dddocky showed [Qc Qh] and won (1984) with a pair of Queens
Seat 4: Duke Croix folded before Flop (didn't bet)
Seat 6: color_singleton (button) mucked [Jh 7c]
Seat 9: Manon541 (small blind) folded before Flop



PokerStars Home Game Hand #217636396131: {Club #3225207}  Hold'em No Limit (50/100) - 2020/08/20 18:03:08 ET
Table 'Manuel Neuer' 9-max (Play Money) Seat #9 is the button
Seat 1: JeBoyDirk (25251 in chips) 
Seat 2: dddocky (5606 in chips) 
Seat 4: Duke Croix (17864 in chips) 
Seat 6: color_singleton (2232 in chips) 
Seat 9: Manon541 (9145 in chips) 
JeBoyDirk: posts small blind 50
dddocky: posts big blind 100
*** HOLE CARDS ***
Dealt to Duke Croix [Kc 2c]
Duke Croix: calls 100
color_singleton: folds 
Manon541: folds 
JeBoyDirk: folds 
dddocky: checks 
*** FLOP *** [Qd 5s Jd]
dddocky: checks 
Duke Croix: checks 
*** TURN *** [Qd 5s Jd] [7c]
dddocky: checks 
JeBoyDirk leaves the table
Duke Croix: checks 
*** RIVER *** [Qd 5s Jd 7c] [3h]
dddocky: checks 
Duke Croix: checks 
*** SHOW DOWN ***
dddocky: shows [7s 4c] (a pair of Sevens)
Duke Croix: mucks hand 
dddocky collected 236 from pot
*** SUMMARY ***
Total pot 250 | Rake 14 
Board [Qd 5s Jd 7c 3h]
Seat 1: JeBoyDirk (small blind) folded before Flop
Seat 2: dddocky (big blind) showed [7s 4c] and won (236) with a pair of Sevens
Seat 4: Duke Croix mucked [Kc 2c]
Seat 6: color_singleton folded before Flop (didn't bet)
Seat 9: Manon541 (button) folded before Flop (didn't bet)



PokerStars Home Game Hand #217636409163: {Club #3225207}  Hold'em No Limit (50/100) - 2020/08/20 18:03:35 ET
Table 'Manuel Neuer' 9-max (Play Money) Seat #2 is the button
Seat 2: dddocky (5742 in chips) 
Seat 4: Duke Croix (17764 in chips) 
Seat 6: color_singleton (2232 in chips) 
Seat 9: Manon541 (9145 in chips) 
Duke Croix: posts small blind 50
color_singleton: posts big blind 100
*** HOLE CARDS ***
Dealt to Duke Croix [5d 8h]
Manon541: calls 100
dddocky: folds 
Duke Croix: calls 50
color_singleton: raises 200 to 300
Manon541: calls 200
Duke Croix: calls 200
*** FLOP *** [7h Ks Qc]
Duke Croix: checks 
color_singleton: bets 425
Manon541: calls 425
Duke Croix: folds 
*** TURN *** [7h Ks Qc] [Jd]
color_singleton: checks 
Manon541: checks 
*** RIVER *** [7h Ks Qc Jd] [7s]
color_singleton: checks 
Manon541: checks 
*** SHOW DOWN ***
color_singleton: shows [Ad 4c] (a pair of Sevens)
Manon541: shows [Kh 3d] (two pair, Kings and Sevens)
Manon541 collected 1654 from pot
*** SUMMARY ***
Total pot 1750 | Rake 96 
Board [7h Ks Qc Jd 7s]
Seat 2: dddocky (button) folded before Flop (didn't bet)
Seat 4: Duke Croix (small blind) folded on the Flop
Seat 6: color_singleton (big blind) showed [Ad 4c] and lost with a pair of Sevens
Seat 9: Manon541 showed [Kh 3d] and won (1654) with two pair, Kings and Sevens



PokerStars Home Game Hand #217636423507: {Club #3225207}  Hold'em No Limit (50/100) - 2020/08/20 18:04:04 ET
Table 'Manuel Neuer' 9-max (Play Money) Seat #4 is the button
Seat 2: dddocky (5742 in chips) 
Seat 4: Duke Croix (17464 in chips) 
Seat 6: color_singleton (1507 in chips) 
Seat 9: Manon541 (10074 in chips) 
color_singleton: posts small blind 50
Manon541: posts big blind 100
*** HOLE CARDS ***
Dealt to Duke Croix [4h 7s]
dddocky: folds 
Duke Croix: folds 
color_singleton: calls 50
Manon541: checks 
*** FLOP *** [8s Qd 4d]
color_singleton: bets 100
Manon541: calls 100
*** TURN *** [8s Qd 4d] [3d]
color_singleton: checks 
Manon541: checks 
*** RIVER *** [8s Qd 4d 3d] [9h]
color_singleton: checks 
Manon541: bets 189
color_singleton: folds 
Uncalled bet (189) returned to Manon541
Manon541 collected 378 from pot
*** SUMMARY ***
Total pot 400 | Rake 22 
Board [8s Qd 4d 3d 9h]
Seat 2: dddocky folded before Flop (didn't bet)
Seat 4: Duke Croix (button) folded before Flop (didn't bet)
Seat 6: color_singleton (small blind) folded on the River
Seat 9: Manon541 (big blind) collected (378)



PokerStars Home Game Hand #217636437819: {Club #3225207}  Hold'em No Limit (50/100) - 2020/08/20 18:04:34 ET
Table 'Manuel Neuer' 9-max (Play Money) Seat #6 is the button
Seat 2: dddocky (5742 in chips) 
Seat 4: Duke Croix (17464 in chips) 
Seat 6: color_singleton (1307 in chips) 
Seat 9: Manon541 (10252 in chips) 
Manon541: posts small blind 50
dddocky: posts big blind 100
*** HOLE CARDS ***
Dealt to Duke Croix [9c 2h]
Duke Croix: folds 
color_singleton: raises 250 to 350
Manon541: folds 
dddocky: calls 250
*** FLOP *** [2s 4h 7h]
dddocky: checks 
color_singleton: bets 957 and is all-in
dddocky: folds 
Uncalled bet (957) returned to color_singleton
color_singleton collected 709 from pot
color_singleton: doesn't show hand 
*** SUMMARY ***
Total pot 750 | Rake 41 
Board [2s 4h 7h]
Seat 2: dddocky (big blind) folded on the Flop
Seat 4: Duke Croix folded before Flop (didn't bet)
Seat 6: color_singleton (button) collected (709)
Seat 9: Manon541 (small blind) folded before Flop



PokerStars Home Game Hand #217636445394: {Club #3225207}  Hold'em No Limit (50/100) - 2020/08/20 18:04:50 ET
Table 'Manuel Neuer' 9-max (Play Money) Seat #9 is the button
Seat 2: dddocky (5392 in chips) 
Seat 4: Duke Croix (17464 in chips) 
Seat 6: color_singleton (1666 in chips) 
Seat 9: Manon541 (10202 in chips) 
dddocky: posts small blind 50
Duke Croix: posts big blind 100
*** HOLE CARDS ***
Dealt to Duke Croix [6s 2h]
color_singleton: raises 200 to 300
Manon541: calls 300
dddocky: folds 
Duke Croix: folds 
*** FLOP *** [Qs 5s 3d]
color_singleton: bets 354
Manon541: calls 354
*** TURN *** [Qs 5s 3d] [9d]
color_singleton: bets 689
Manon541: folds 
Uncalled bet (689) returned to color_singleton
color_singleton collected 1378 from pot
color_singleton: doesn't show hand 
*** SUMMARY ***
Total pot 1458 | Rake 80 
Board [Qs 5s 3d 9d]
Seat 2: dddocky (small blind) folded before Flop
Seat 4: Duke Croix (big blind) folded before Flop
Seat 6: color_singleton collected (1378)
Seat 9: Manon541 (button) folded on the Turn



PokerStars Home Game Hand #217636456769: {Club #3225207}  Hold'em No Limit (50/100) - 2020/08/20 18:05:13 ET
Table 'Manuel Neuer' 9-max (Play Money) Seat #2 is the button
Seat 2: dddocky (5342 in chips) 
Seat 4: Duke Croix (17364 in chips) 
Seat 6: color_singleton (2390 in chips) 
Seat 9: Manon541 (9548 in chips) 
Duke Croix: posts small blind 50
color_singleton: posts big blind 100
*** HOLE CARDS ***
Dealt to Duke Croix [4s 4h]
Manon541: calls 100
dddocky: calls 100
Duke Croix: raises 300 to 400
color_singleton: folds 
Manon541: calls 300
dddocky: calls 300
*** FLOP *** [5c 2s Kh]
Duke Croix: bets 700
Manon541: folds 
dddocky: folds 
Uncalled bet (700) returned to Duke Croix
Duke Croix collected 1228 from pot
*** SUMMARY ***
Total pot 1300 | Rake 72 
Board [5c 2s Kh]
Seat 2: dddocky (button) folded on the Flop
Seat 4: Duke Croix (small blind) collected (1228)
Seat 6: color_singleton (big blind) folded before Flop
Seat 9: Manon541 folded on the Flop



PokerStars Home Game Hand #217636465197: {Club #3225207}  Hold'em No Limit (50/100) - 2020/08/20 18:05:30 ET
Table 'Manuel Neuer' 9-max (Play Money) Seat #4 is the button
Seat 2: dddocky (4942 in chips) 
Seat 4: Duke Croix (18192 in chips) 
Seat 6: color_singleton (2290 in chips) 
Seat 9: Manon541 (9148 in chips) 
color_singleton: posts small blind 50
Manon541: posts big blind 100
*** HOLE CARDS ***
Dealt to Duke Croix [3h 6s]
dddocky: calls 100
Duke Croix: folds 
color_singleton has timed out
color_singleton: folds 
Manon541: checks 
*** FLOP *** [2h Jd 5c]
Manon541: checks 
dddocky: checks 
*** TURN *** [2h Jd 5c] [Js]
Manon541: checks 
dddocky: checks 
*** RIVER *** [2h Jd 5c Js] [6d]
Manon541: bets 118
dddocky: folds 
Uncalled bet (118) returned to Manon541
Manon541 collected 236 from pot
*** SUMMARY ***
Total pot 250 | Rake 14 
Board [2h Jd 5c Js 6d]
Seat 2: dddocky folded on the River
Seat 4: Duke Croix (button) folded before Flop (didn't bet)
Seat 6: color_singleton (small blind) folded before Flop
Seat 9: Manon541 (big blind) collected (236)



PokerStars Home Game Hand #217636486872: {Club #3225207}  Hold'em No Limit (50/100) - 2020/08/20 18:06:15 ET
Table 'Manuel Neuer' 9-max (Play Money) Seat #9 is the button
Seat 2: dddocky (4842 in chips) 
Seat 4: Duke Croix (18192 in chips) 
Seat 9: Manon541 (9284 in chips) 
dddocky: posts small blind 50
Duke Croix: posts big blind 100
*** HOLE CARDS ***
Dealt to Duke Croix [7d Tc]
Manon541: calls 100
dddocky: calls 50
Duke Croix: checks 
*** FLOP *** [2d Jd Jc]
dddocky: bets 100
Duke Croix: folds 
Manon541: folds 
Uncalled bet (100) returned to dddocky
dddocky collected 283 from pot
dddocky: doesn't show hand 
*** SUMMARY ***
Total pot 300 | Rake 17 
Board [2d Jd Jc]
Seat 2: dddocky (small blind) collected (283)
Seat 4: Duke Croix (big blind) folded on the Flop
Seat 9: Manon541 (button) folded on the Flop



PokerStars Home Game Hand #217636496964: {Club #3225207}  Hold'em No Limit (50/100) - 2020/08/20 18:06:36 ET
Table 'Manuel Neuer' 9-max (Play Money) Seat #2 is the button
Seat 2: dddocky (5025 in chips) 
Seat 4: Duke Croix (18092 in chips) 
Seat 9: Manon541 (9184 in chips) 
Duke Croix: posts small blind 50
Manon541: posts big blind 100
*** HOLE CARDS ***
Dealt to Duke Croix [Js 5c]
dddocky: folds 
Duke Croix: calls 50
Manon541: checks 
*** FLOP *** [5d Kh 6h]
Duke Croix: bets 100
Manon541: calls 100
*** TURN *** [5d Kh 6h] [6c]
Duke Croix: bets 300
Manon541: calls 300
*** RIVER *** [5d Kh 6h 6c] [Kd]
Duke Croix: checks 
Manon541: checks 
*** SHOW DOWN ***
Duke Croix: shows [Js 5c] (two pair, Kings and Sixes)
Manon541: shows [Td As] (two pair, Kings and Sixes - Ace kicker)
Manon541 collected 945 from pot
*** SUMMARY ***
Total pot 1000 | Rake 55 
Board [5d Kh 6h 6c Kd]
Seat 2: dddocky (button) folded before Flop (didn't bet)
Seat 4: Duke Croix (small blind) showed [Js 5c] and lost with two pair, Kings and Sixes
Seat 9: Manon541 (big blind) showed [Td As] and won (945) with two pair, Kings and Sixes



PokerStars Home Game Hand #217636512634: {Club #3225207}  Hold'em No Limit (50/100) - 2020/08/20 18:07:08 ET
Table 'Manuel Neuer' 9-max (Play Money) Seat #4 is the button
Seat 2: dddocky (5025 in chips) 
Seat 4: Duke Croix (17592 in chips) 
Seat 9: Manon541 (9629 in chips) 
Manon541: posts small blind 50
dddocky: posts big blind 100
*** HOLE CARDS ***
Dealt to Duke Croix [8h 5c]
Duke Croix: folds 
Manon541: calls 50
dddocky: checks 
*** FLOP *** [Qc 8d 2s]
Manon541: checks 
dddocky: bets 189
Manon541: folds 
Uncalled bet (189) returned to dddocky
dddocky collected 189 from pot
dddocky: doesn't show hand 
*** SUMMARY ***
Total pot 200 | Rake 11 
Board [Qc 8d 2s]
Seat 2: dddocky (big blind) collected (189)
Seat 4: Duke Croix (button) folded before Flop (didn't bet)
Seat 9: Manon541 (small blind) folded on the Flop



PokerStars Home Game Hand #217636521731: {Club #3225207}  Hold'em No Limit (50/100) - 2020/08/20 18:07:27 ET
Table 'Manuel Neuer' 9-max (Play Money) Seat #9 is the button
Seat 2: dddocky (5114 in chips) 
Seat 4: Duke Croix (17592 in chips) 
Seat 6: color_singleton (2240 in chips) 
Seat 9: Manon541 (9529 in chips) 
dddocky: posts small blind 50
Duke Croix: posts big blind 100
color_singleton: posts small & big blinds 150
*** HOLE CARDS ***
Dealt to Duke Croix [8c Ac]
color_singleton: raises 200 to 300
Manon541: calls 300
dddocky: calls 250
Duke Croix: calls 200
*** FLOP *** [Qc 3s Js]
dddocky: bets 100
Duke Croix: calls 100
color_singleton: calls 100
Manon541: calls 100
*** TURN *** [Qc 3s Js] [9h]
dddocky: bets 1559
Duke Croix: folds 
color_singleton: folds 
Manon541: calls 1559
*** RIVER *** [Qc 3s Js 9h] [4d]
dddocky: checks 
Manon541: checks 
*** SHOW DOWN ***
dddocky: shows [Qd 2s] (a pair of Queens)
Manon541: shows [Qs 2d] (a pair of Queens)
dddocky collected 2253 from pot
Manon541 collected 2253 from pot
*** SUMMARY ***
Total pot 4768 | Rake 262 
Board [Qc 3s Js 9h 4d]
Seat 2: dddocky (small blind) showed [Qd 2s] and won (2253) with a pair of Queens
Seat 4: Duke Croix (big blind) folded on the Turn
Seat 6: color_singleton folded on the Turn
Seat 9: Manon541 (button) showed [Qs 2d] and won (2253) with a pair of Queens



PokerStars Home Game Hand #217636541404: {Club #3225207}  Hold'em No Limit (50/100) - 2020/08/20 18:08:08 ET
Table 'Manuel Neuer' 9-max (Play Money) Seat #2 is the button
Seat 2: dddocky (5408 in chips) 
Seat 4: Duke Croix (17192 in chips) 
Seat 6: color_singleton (1790 in chips) 
Seat 9: Manon541 (9823 in chips) 
Duke Croix: posts small blind 50
color_singleton: posts big blind 100
*** HOLE CARDS ***
Dealt to Duke Croix [4c Qd]
Manon541: calls 100
dddocky: calls 100
Duke Croix: calls 50
color_singleton: checks 
*** FLOP *** [Kc 3h 9s]
Duke Croix: checks 
color_singleton: checks 
Manon541: bets 189
dddocky: calls 189
Duke Croix: folds 
color_singleton: folds 
*** TURN *** [Kc 3h 9s] [5h]
Manon541: bets 735
dddocky: calls 735
*** RIVER *** [Kc 3h 9s 5h] [Qh]
Manon541: checks 
dddocky: checks 
*** SHOW DOWN ***
Manon541: shows [Ks 7d] (a pair of Kings)
dddocky: mucks hand 
Manon541 collected 2124 from pot
*** SUMMARY ***
Total pot 2248 | Rake 124 
Board [Kc 3h 9s 5h Qh]
Seat 2: dddocky (button) mucked [As 3d]
Seat 4: Duke Croix (small blind) folded on the Flop
Seat 6: color_singleton (big blind) folded on the Flop
Seat 9: Manon541 showed [Ks 7d] and won (2124) with a pair of Kings



PokerStars Home Game Hand #217636560221: {Club #3225207}  Hold'em No Limit (50/100) - 2020/08/20 18:08:37 ET
Table 'Manuel Neuer' 9-max (Play Money) Seat #4 is the button
Seat 2: dddocky (4384 in chips) 
Seat 4: Duke Croix (17092 in chips) 
Seat 6: color_singleton (1690 in chips) 
Seat 9: Manon541 (10923 in chips) 
color_singleton: posts small blind 50
Manon541: posts big blind 100
*** HOLE CARDS ***
Dealt to Duke Croix [Js Ad]
dddocky: calls 100
Duke Croix: raises 400 to 500
color_singleton: folds 
Manon541: folds 
dddocky: calls 400
*** FLOP *** [Ac 2s Kc]
dddocky: checks 
Duke Croix: bets 550
dddocky: folds 
Uncalled bet (550) returned to Duke Croix
Duke Croix collected 1087 from pot
*** SUMMARY ***
Total pot 1150 | Rake 63 
Board [Ac 2s Kc]
Seat 2: dddocky folded on the Flop
Seat 4: Duke Croix (button) collected (1087)
Seat 6: color_singleton (small blind) folded before Flop
Seat 9: Manon541 (big blind) folded before Flop



PokerStars Home Game Hand #217636570493: {Club #3225207}  Hold'em No Limit (50/100) - 2020/08/20 18:08:58 ET
Table 'Manuel Neuer' 9-max (Play Money) Seat #6 is the button
Seat 2: dddocky (3884 in chips) 
Seat 4: Duke Croix (17679 in chips) 
Seat 6: color_singleton (1640 in chips) 
Seat 9: Manon541 (10823 in chips) 
Manon541: posts small blind 50
dddocky: posts big blind 100
*** HOLE CARDS ***
Dealt to Duke Croix [Jd 7h]
Duke Croix: folds 
color_singleton: raises 200 to 300
Manon541: calls 250
dddocky: calls 200
*** FLOP *** [Tc 7c 3h]
Manon541: checks 
dddocky: checks 
color_singleton: bets 850
Manon541: folds 
dddocky: folds 
Uncalled bet (850) returned to color_singleton
color_singleton collected 850 from pot
color_singleton: doesn't show hand 
*** SUMMARY ***
Total pot 900 | Rake 50 
Board [Tc 7c 3h]
Seat 2: dddocky (big blind) folded on the Flop
Seat 4: Duke Croix folded before Flop (didn't bet)
Seat 6: color_singleton (button) collected (850)
Seat 9: Manon541 (small blind) folded on the Flop



PokerStars Home Game Hand #217636580348: {Club #3225207}  Hold'em No Limit (50/100) - 2020/08/20 18:09:19 ET
Table 'Manuel Neuer' 9-max (Play Money) Seat #9 is the button
Seat 2: dddocky (3584 in chips) 
Seat 4: Duke Croix (17679 in chips) 
Seat 6: color_singleton (2190 in chips) 
Seat 9: Manon541 (10523 in chips) 
dddocky: posts small blind 50
Duke Croix: posts big blind 100
*** HOLE CARDS ***
Dealt to Duke Croix [2d 9c]
color_singleton: raises 200 to 300
Manon541: folds 
dddocky: folds 
Duke Croix: folds 
Uncalled bet (200) returned to color_singleton
color_singleton collected 250 from pot
color_singleton: doesn't show hand 
*** SUMMARY ***
Total pot 250 | Rake 0 
Seat 2: dddocky (small blind) folded before Flop
Seat 4: Duke Croix (big blind) folded before Flop
Seat 6: color_singleton collected (250)
Seat 9: Manon541 (button) folded before Flop (didn't bet)



PokerStars Home Game Hand #217636584762: {Club #3225207}  Hold'em No Limit (50/100) - 2020/08/20 18:09:28 ET
Table 'Manuel Neuer' 9-max (Play Money) Seat #2 is the button
Seat 2: dddocky (3534 in chips) 
Seat 4: Duke Croix (17579 in chips) 
Seat 6: color_singleton (2340 in chips) 
Seat 9: Manon541 (10523 in chips) 
Duke Croix: posts small blind 50
color_singleton: posts big blind 100
*** HOLE CARDS ***
Dealt to Duke Croix [5h 7c]
Manon541: calls 100
dddocky: folds 
Duke Croix: calls 50
color_singleton: checks 
*** FLOP *** [3s 2h 5c]
Duke Croix: bets 200
color_singleton: calls 200
Manon541: calls 200
*** TURN *** [3s 2h 5c] [Jh]
Duke Croix: bets 400
color_singleton: folds 
Manon541: folds 
Uncalled bet (400) returned to Duke Croix
Duke Croix collected 850 from pot
*** SUMMARY ***
Total pot 900 | Rake 50 
Board [3s 2h 5c Jh]
Seat 2: dddocky (button) folded before Flop (didn't bet)
Seat 4: Duke Croix (small blind) collected (850)
Seat 6: color_singleton (big blind) folded on the Turn
Seat 9: Manon541 folded on the Turn



PokerStars Home Game Hand #217636595535: {Club #3225207}  Hold'em No Limit (50/100) - 2020/08/20 18:09:50 ET
Table 'Manuel Neuer' 9-max (Play Money) Seat #4 is the button
Seat 2: dddocky (3534 in chips) 
Seat 4: Duke Croix (18129 in chips) 
Seat 6: color_singleton (2040 in chips) 
Seat 9: Manon541 (10223 in chips) 
color_singleton: posts small blind 50
Manon541: posts big blind 100
*** HOLE CARDS ***
Dealt to Duke Croix [Qd Tc]
dddocky: calls 100
Duke Croix: raises 400 to 500
color_singleton: folds 
Manon541: folds 
dddocky: calls 400
*** FLOP *** [8h Kc 6c]
dddocky: bets 100
Duke Croix: calls 100
*** TURN *** [8h Kc 6c] [9d]
dddocky: bets 100
Duke Croix: raises 600 to 700
dddocky: raises 600 to 1300
Duke Croix: calls 600
*** RIVER *** [8h Kc 6c 9d] [6s]
dddocky: bets 1634 and is all-in
Duke Croix: folds 
Uncalled bet (1634) returned to dddocky
dddocky collected 3733 from pot
dddocky: doesn't show hand 
*** SUMMARY ***
Total pot 3950 | Rake 217 
Board [8h Kc 6c 9d 6s]
Seat 2: dddocky collected (3733)
Seat 4: Duke Croix (button) folded on the River
Seat 6: color_singleton (small blind) folded before Flop
Seat 9: Manon541 (big blind) folded before Flop



PokerStars Home Game Hand #217636615720: {Club #3225207}  Hold'em No Limit (50/100) - 2020/08/20 18:10:31 ET
Table 'Manuel Neuer' 9-max (Play Money) Seat #6 is the button
Seat 2: dddocky (5367 in chips) 
Seat 4: Duke Croix (16229 in chips) 
Seat 6: color_singleton (1990 in chips) 
Seat 9: Manon541 (10123 in chips) 
Manon541: posts small blind 50
dddocky: posts big blind 100
*** HOLE CARDS ***
Dealt to Duke Croix [Ts Qh]
Duke Croix: raises 200 to 300
color_singleton: raises 700 to 1000
Manon541: calls 950
dddocky: folds 
Duke Croix: calls 700
*** FLOP *** [6h 2h 6c]
Manon541: checks 
Duke Croix: checks 
color_singleton: bets 990 and is all-in
Manon541: folds 
Duke Croix: calls 990
*** TURN *** [6h 2h 6c] [Tc]
*** RIVER *** [6h 2h 6c Tc] [Jc]
*** SHOW DOWN ***
Duke Croix: shows [Ts Qh] (two pair, Tens and Sixes)
color_singleton: shows [9h 9c] (two pair, Nines and Sixes)
Duke Croix collected 4801 from pot
*** SUMMARY ***
Total pot 5080 | Rake 279 
Board [6h 2h 6c Tc Jc]
Seat 2: dddocky (big blind) folded before Flop
Seat 4: Duke Croix showed [Ts Qh] and won (4801) with two pair, Tens and Sixes
Seat 6: color_singleton (button) showed [9h 9c] and lost with two pair, Nines and Sixes
Seat 9: Manon541 (small blind) folded on the Flop



PokerStars Home Game Hand #217636631951: {Club #3225207}  Hold'em No Limit (50/100) - 2020/08/20 18:11:05 ET
Table 'Manuel Neuer' 9-max (Play Money) Seat #9 is the button
Seat 2: dddocky (5267 in chips) 
Seat 4: Duke Croix (19040 in chips) 
Seat 9: Manon541 (9123 in chips) 
dddocky: posts small blind 50
Duke Croix: posts big blind 100
*** HOLE CARDS ***
Dealt to Duke Croix [Kc 6d]
Manon541: calls 100
dddocky: calls 50
Duke Croix: checks 
*** FLOP *** [6c 7c 7d]
dddocky: checks 
Duke Croix: bets 200
Manon541: raises 200 to 400
dddocky: folds 
Duke Croix: calls 200
*** TURN *** [6c 7c 7d] [9s]
Duke Croix: checks 
Manon541: bets 519
Duke Croix: folds 
Uncalled bet (519) returned to Manon541
Manon541 collected 1039 from pot
*** SUMMARY ***
Total pot 1100 | Rake 61 
Board [6c 7c 7d 9s]
Seat 2: dddocky (small blind) folded on the Flop
Seat 4: Duke Croix (big blind) folded on the Turn
Seat 9: Manon541 (button) collected (1039)



PokerStars Home Game Hand #217636649547: {Club #3225207}  Hold'em No Limit (50/100) - 2020/08/20 18:11:41 ET
Table 'Manuel Neuer' 9-max (Play Money) Seat #2 is the button
Seat 2: dddocky (5167 in chips) 
Seat 4: Duke Croix (18540 in chips) 
Seat 6: color_singleton (10000 in chips) 
Seat 9: Manon541 (9662 in chips) 
Duke Croix: posts small blind 50
color_singleton: posts big blind 100
*** HOLE CARDS ***
Dealt to Duke Croix [4h 2d]
Manon541: calls 100
dddocky: calls 100
Duke Croix: calls 50
color_singleton: checks 
*** FLOP *** [4d Qd 8s]
Duke Croix: checks 
color_singleton: bets 189
Manon541: folds 
dddocky: calls 189
Duke Croix: calls 189
*** TURN *** [4d Qd 8s] [Qc]
Duke Croix: bets 300
color_singleton: calls 300
dddocky: folds 
*** RIVER *** [4d Qd 8s Qc] [Ac]
Duke Croix: checks 
color_singleton: bets 740
Duke Croix: folds 
Uncalled bet (740) returned to color_singleton
color_singleton collected 1481 from pot
color_singleton: doesn't show hand 
*** SUMMARY ***
Total pot 1567 | Rake 86 
Board [4d Qd 8s Qc Ac]
Seat 2: dddocky (button) folded on the Turn
Seat 4: Duke Croix (small blind) folded on the River
Seat 6: color_singleton (big blind) collected (1481)
Seat 9: Manon541 folded on the Flop



PokerStars Home Game Hand #217636665497: {Club #3225207}  Hold'em No Limit (50/100) - 2020/08/20 18:12:14 ET
Table 'Manuel Neuer' 9-max (Play Money) Seat #4 is the button
Seat 2: dddocky (4878 in chips) 
Seat 4: Duke Croix (17951 in chips) 
Seat 6: color_singleton (10892 in chips) 
Seat 9: Manon541 (9562 in chips) 
color_singleton: posts small blind 50
Manon541: posts big blind 100
*** HOLE CARDS ***
Dealt to Duke Croix [7d 5c]
dddocky: calls 100
Duke Croix: folds 
color_singleton: folds 
Manon541: checks 
*** FLOP *** [2c 3h 5d]
Manon541: bets 118
dddocky: folds 
Uncalled bet (118) returned to Manon541
Manon541 collected 236 from pot
*** SUMMARY ***
Total pot 250 | Rake 14 
Board [2c 3h 5d]
Seat 2: dddocky folded on the Flop
Seat 4: Duke Croix (button) folded before Flop (didn't bet)
Seat 6: color_singleton (small blind) folded before Flop
Seat 9: Manon541 (big blind) collected (236)



PokerStars Home Game Hand #217636673495: {Club #3225207}  Hold'em No Limit (50/100) - 2020/08/20 18:12:31 ET
Table 'Manuel Neuer' 9-max (Play Money) Seat #6 is the button
Seat 2: dddocky (4778 in chips) 
Seat 4: Duke Croix (17951 in chips) 
Seat 6: color_singleton (10842 in chips) 
Seat 9: Manon541 (9698 in chips) 
Manon541: posts small blind 50
dddocky: posts big blind 100
*** HOLE CARDS ***
Dealt to Duke Croix [6s Ah]
Duke Croix: raises 300 to 400
color_singleton: folds 
Manon541: folds 
dddocky: calls 300
*** FLOP *** [5h 5d 3h]
dddocky: checks 
Duke Croix: checks 
*** TURN *** [5h 5d 3h] [6c]
dddocky: checks 
Duke Croix: bets 401
dddocky: folds 
Uncalled bet (401) returned to Duke Croix
Duke Croix collected 803 from pot
*** SUMMARY ***
Total pot 850 | Rake 47 
Board [5h 5d 3h 6c]
Seat 2: dddocky (big blind) folded on the Turn
Seat 4: Duke Croix collected (803)
Seat 6: color_singleton (button) folded before Flop (didn't bet)
Seat 9: Manon541 (small blind) folded before Flop



PokerStars Home Game Hand #217636684394: {Club #3225207}  Hold'em No Limit (50/100) - 2020/08/20 18:12:53 ET
Table 'Manuel Neuer' 9-max (Play Money) Seat #9 is the button
Seat 2: dddocky (4378 in chips) 
Seat 4: Duke Croix (18354 in chips) 
Seat 6: color_singleton (10842 in chips) 
Seat 9: Manon541 (9648 in chips) 
dddocky: posts small blind 50
Duke Croix: posts big blind 100
*** HOLE CARDS ***
Dealt to Duke Croix [Ad 2h]
color_singleton: folds 
Manon541: calls 100
dddocky: folds 
Duke Croix: raises 300 to 400
Manon541: folds 
Uncalled bet (300) returned to Duke Croix
Duke Croix collected 250 from pot
*** SUMMARY ***
Total pot 250 | Rake 0 
Seat 2: dddocky (small blind) folded before Flop
Seat 4: Duke Croix (big blind) collected (250)
Seat 6: color_singleton folded before Flop (didn't bet)
Seat 9: Manon541 (button) folded before Flop



PokerStars Home Game Hand #217636690993: {Club #3225207}  Hold'em No Limit (50/100) - 2020/08/20 18:13:07 ET
Table 'Manuel Neuer' 9-max (Play Money) Seat #2 is the button
Seat 2: dddocky (4328 in chips) 
Seat 4: Duke Croix (18504 in chips) 
Seat 6: color_singleton (10842 in chips) 
Seat 9: Manon541 (9548 in chips) 
Duke Croix: posts small blind 50
color_singleton: posts big blind 100
*** HOLE CARDS ***
Dealt to Duke Croix [Js 5c]
Manon541: calls 100
dddocky: calls 100
Duke Croix: calls 50
color_singleton: checks 
*** FLOP *** [6s 6c Kc]
Duke Croix: checks 
color_singleton: bets 189
Manon541: calls 189
dddocky: calls 189
Duke Croix: folds 
*** TURN *** [6s 6c Kc] [4h]
color_singleton: bets 457
Manon541: folds 
dddocky: calls 457
*** RIVER *** [6s 6c Kc 4h] [5h]
color_singleton: bets 889
dddocky: calls 889
*** SHOW DOWN ***
color_singleton: shows [Kd 8d] (two pair, Kings and Sixes)
dddocky: shows [As 6h] (three of a kind, Sixes)
dddocky collected 3458 from pot
*** SUMMARY ***
Total pot 3659 | Rake 201 
Board [6s 6c Kc 4h 5h]
Seat 2: dddocky (button) showed [As 6h] and won (3458) with three of a kind, Sixes
Seat 4: Duke Croix (small blind) folded on the Flop
Seat 6: color_singleton (big blind) showed [Kd 8d] and lost with two pair, Kings and Sixes
Seat 9: Manon541 folded on the Turn



PokerStars Home Game Hand #217636705671: {Club #3225207}  Hold'em No Limit (50/100) - 2020/08/20 18:13:37 ET
Table 'Manuel Neuer' 9-max (Play Money) Seat #4 is the button
Seat 2: dddocky (6151 in chips) 
Seat 4: Duke Croix (18404 in chips) 
Seat 6: color_singleton (9207 in chips) 
Seat 9: Manon541 (9259 in chips) 
color_singleton: posts small blind 50
Manon541: posts big blind 100
*** HOLE CARDS ***
Dealt to Duke Croix [4h 6c]
dddocky: folds 
Duke Croix: folds 
color_singleton: raises 200 to 300
Manon541: calls 200
*** FLOP *** [Ah As 7s]
color_singleton: bets 283
Manon541: folds 
Uncalled bet (283) returned to color_singleton
color_singleton collected 567 from pot
color_singleton: doesn't show hand 
*** SUMMARY ***
Total pot 600 | Rake 33 
Board [Ah As 7s]
Seat 2: dddocky folded before Flop (didn't bet)
Seat 4: Duke Croix (button) folded before Flop (didn't bet)
Seat 6: color_singleton (small blind) collected (567)
Seat 9: Manon541 (big blind) folded on the Flop



PokerStars Home Game Hand #217636715388: {Club #3225207}  Hold'em No Limit (50/100) - 2020/08/20 18:13:57 ET
Table 'Manuel Neuer' 9-max (Play Money) Seat #6 is the button
Seat 2: dddocky (6151 in chips) 
Seat 4: Duke Croix (18404 in chips) 
Seat 6: color_singleton (9474 in chips) 
Seat 9: Manon541 (8959 in chips) 
Manon541: posts small blind 50
dddocky: posts big blind 100
*** HOLE CARDS ***
Dealt to Duke Croix [6s Ks]
Duke Croix: calls 100
color_singleton: raises 200 to 300
Manon541: calls 250
dddocky: folds 
Duke Croix: calls 200
*** FLOP *** [3h Jh 6h]
Manon541: checks 
Duke Croix: checks 
color_singleton: bets 472
Manon541: folds 
Duke Croix: folds 
Uncalled bet (472) returned to color_singleton
color_singleton collected 945 from pot
color_singleton: doesn't show hand 
*** SUMMARY ***
Total pot 1000 | Rake 55 
Board [3h Jh 6h]
Seat 2: dddocky (big blind) folded before Flop
Seat 4: Duke Croix folded on the Flop
Seat 6: color_singleton (button) collected (945)
Seat 9: Manon541 (small blind) folded on the Flop



PokerStars Home Game Hand #217636731820: {Club #3225207}  Hold'em No Limit (50/100) - 2020/08/20 18:14:32 ET
Table 'Manuel Neuer' 9-max (Play Money) Seat #9 is the button
Seat 2: dddocky (6051 in chips) 
Seat 4: Duke Croix (18104 in chips) 
Seat 6: color_singleton (10119 in chips) 
Seat 9: Manon541 (8659 in chips) 
dddocky: posts small blind 50
Duke Croix: posts big blind 100
*** HOLE CARDS ***
Dealt to Duke Croix [3h Qh]
color_singleton: folds 
Manon541: calls 100
dddocky: calls 50
Duke Croix: checks 
*** FLOP *** [6c 8s 7c]
dddocky: checks 
Duke Croix: checks 
Manon541: checks 
*** TURN *** [6c 8s 7c] [Jh]
dddocky: checks 
Duke Croix: checks 
Manon541: checks 
*** RIVER *** [6c 8s 7c Jh] [As]
dddocky: bets 283
Duke Croix: folds 
Manon541: calls 283
*** SHOW DOWN ***
dddocky: shows [Ah 5s] (a pair of Aces)
Manon541: mucks hand 
dddocky collected 818 from pot
*** SUMMARY ***
Total pot 866 | Rake 48 
Board [6c 8s 7c Jh As]
Seat 2: dddocky (small blind) showed [Ah 5s] and won (818) with a pair of Aces
Seat 4: Duke Croix (big blind) folded on the River
Seat 6: color_singleton folded before Flop (didn't bet)
Seat 9: Manon541 (button) mucked [Jd Ks]



PokerStars Home Game Hand #217636750755: {Club #3225207}  Hold'em No Limit (50/100) - 2020/08/20 18:15:11 ET
Table 'Manuel Neuer' 9-max (Play Money) Seat #2 is the button
Seat 2: dddocky (6486 in chips) 
Seat 4: Duke Croix (18004 in chips) 
Seat 6: color_singleton (10119 in chips) 
Seat 9: Manon541 (8276 in chips) 
Duke Croix: posts small blind 50
color_singleton: posts big blind 100
*** HOLE CARDS ***
Dealt to Duke Croix [Th 5s]
Manon541: calls 100
dddocky: folds 
Duke Croix: calls 50
color_singleton: checks 
*** FLOP *** [7d 9c 5c]
Duke Croix: checks 
color_singleton: checks 
Manon541: checks 
*** TURN *** [7d 9c 5c] [Td]
Duke Croix: bets 200
color_singleton: folds 
Manon541: calls 200
*** RIVER *** [7d 9c 5c Td] [Ad]
Duke Croix: checks 
Manon541: bets 330
Duke Croix: calls 330
*** SHOW DOWN ***
Manon541: shows [7h Kc] (a pair of Sevens)
Duke Croix: shows [Th 5s] (two pair, Tens and Fives)
Duke Croix collected 1285 from pot
*** SUMMARY ***
Total pot 1360 | Rake 75 
Board [7d 9c 5c Td Ad]
Seat 2: dddocky (button) folded before Flop (didn't bet)
Seat 4: Duke Croix (small blind) showed [Th 5s] and won (1285) with two pair, Tens and Fives
Seat 6: color_singleton (big blind) folded on the Turn
Seat 9: Manon541 showed [7h Kc] and lost with a pair of Sevens



PokerStars Home Game Hand #217636789622: {Club #3225207}  Hold'em No Limit (50/100) - 2020/08/20 18:16:14 ET
Table 'Manuel Neuer' 9-max (Play Money) Seat #4 is the button
Seat 2: dddocky (6486 in chips) 
Seat 4: Duke Croix (18659 in chips) 
Seat 6: color_singleton (10019 in chips) 
Seat 9: Manon541 (7646 in chips) 
color_singleton: posts small blind 50
Manon541: posts big blind 100
*** HOLE CARDS ***
Dealt to Duke Croix [Qd 6c]
dddocky: folds 
Duke Croix: folds 
color_singleton: raises 200 to 300
Manon541: calls 200
*** FLOP *** [5c 2s Qh]
color_singleton: bets 283
Manon541: folds 
Uncalled bet (283) returned to color_singleton
color_singleton collected 567 from pot
color_singleton: doesn't show hand 
*** SUMMARY ***
Total pot 600 | Rake 33 
Board [5c 2s Qh]
Seat 2: dddocky folded before Flop (didn't bet)
Seat 4: Duke Croix (button) folded before Flop (didn't bet)
Seat 6: color_singleton (small blind) collected (567)
Seat 9: Manon541 (big blind) folded on the Flop



PokerStars Home Game Hand #217636797421: {Club #3225207}  Hold'em No Limit (50/100) - 2020/08/20 18:16:30 ET
Table 'Manuel Neuer' 9-max (Play Money) Seat #6 is the button
Seat 2: dddocky (6486 in chips) 
Seat 4: Duke Croix (18659 in chips) 
Seat 6: color_singleton (10286 in chips) 
Seat 9: Manon541 (7346 in chips) 
Manon541: posts small blind 50
dddocky: posts big blind 100
*** HOLE CARDS ***
Dealt to Duke Croix [Js Ah]
Duke Croix: raises 200 to 300
color_singleton: calls 300
Manon541: folds 
dddocky: folds 
*** FLOP *** [2h 5c Jd]
Duke Croix: bets 400
color_singleton: calls 400
*** TURN *** [2h 5c Jd] [Qh]
Duke Croix: bets 800
color_singleton: folds 
Uncalled bet (800) returned to Duke Croix
Duke Croix collected 1465 from pot
*** SUMMARY ***
Total pot 1550 | Rake 85 
Board [2h 5c Jd Qh]
Seat 2: dddocky (big blind) folded before Flop
Seat 4: Duke Croix collected (1465)
Seat 6: color_singleton (button) folded on the Turn
Seat 9: Manon541 (small blind) folded before Flop



PokerStars Home Game Hand #217636809511: {Club #3225207}  Hold'em No Limit (50/100) - 2020/08/20 18:16:56 ET
Table 'Manuel Neuer' 9-max (Play Money) Seat #9 is the button
Seat 2: dddocky (6386 in chips) 
Seat 4: Duke Croix (19424 in chips) 
Seat 6: color_singleton (9586 in chips) 
Seat 9: Manon541 (7296 in chips) 
dddocky: posts small blind 50
Duke Croix: posts big blind 100
*** HOLE CARDS ***
Dealt to Duke Croix [Qd 3s]
color_singleton: raises 100 to 200
Manon541: folds 
dddocky: calls 150
Duke Croix: calls 100
*** FLOP *** [4h 9c Ts]
dddocky: bets 100
Duke Croix: folds 
color_singleton: calls 100
*** TURN *** [4h 9c Ts] [Kh]
dddocky: checks 
color_singleton: bets 378
dddocky: folds 
Uncalled bet (378) returned to color_singleton
color_singleton collected 756 from pot
color_singleton: doesn't show hand 
*** SUMMARY ***
Total pot 800 | Rake 44 
Board [4h 9c Ts Kh]
Seat 2: dddocky (small blind) folded on the Turn
Seat 4: Duke Croix (big blind) folded on the Flop
Seat 6: color_singleton collected (756)
Seat 9: Manon541 (button) folded before Flop (didn't bet)



PokerStars Home Game Hand #217636821949: {Club #3225207}  Hold'em No Limit (50/100) - 2020/08/20 18:17:22 ET
Table 'Manuel Neuer' 9-max (Play Money) Seat #2 is the button
Seat 2: dddocky (6086 in chips) 
Seat 4: Duke Croix (19224 in chips) 
Seat 6: color_singleton (10042 in chips) 
Seat 9: Manon541 (7296 in chips) 
Duke Croix: posts small blind 50
color_singleton: posts big blind 100
*** HOLE CARDS ***
Dealt to Duke Croix [Ts Js]
Manon541: calls 100
dddocky: calls 100
Duke Croix: calls 50
color_singleton: checks 
*** FLOP *** [Jh 3d Ad]
Duke Croix: checks 
color_singleton: checks 
Manon541: checks 
dddocky: checks 
*** TURN *** [Jh 3d Ad] [4s]
Duke Croix: checks 
color_singleton: checks 
Manon541: checks 
dddocky: checks 
*** RIVER *** [Jh 3d Ad 4s] [8h]
Duke Croix: checks 
color_singleton: checks 
Manon541: checks 
dddocky: checks 
*** SHOW DOWN ***
Duke Croix: shows [Ts Js] (a pair of Jacks)
color_singleton: mucks hand 
Manon541: mucks hand 
dddocky: mucks hand 
Duke Croix collected 378 from pot
*** SUMMARY ***
Total pot 400 | Rake 22 
Board [Jh 3d Ad 4s 8h]
Seat 2: dddocky (button) mucked [7d Qc]
Seat 4: Duke Croix (small blind) showed [Ts Js] and won (378) with a pair of Jacks
Seat 6: color_singleton (big blind) mucked [6s 9h]
Seat 9: Manon541 mucked [2d Tc]



PokerStars Home Game Hand #217636843019: {Club #3225207}  Hold'em No Limit (50/100) - 2020/08/20 18:18:07 ET
Table 'Manuel Neuer' 9-max (Play Money) Seat #4 is the button
Seat 2: dddocky (5986 in chips) 
Seat 4: Duke Croix (19502 in chips) 
Seat 6: color_singleton (9942 in chips) 
Seat 9: Manon541 (7196 in chips) 
color_singleton: posts small blind 50
Manon541: posts big blind 100
*** HOLE CARDS ***
Dealt to Duke Croix [Ts 8c]
dddocky: calls 100
Duke Croix: calls 100
color_singleton: raises 100 to 200
Manon541: folds 
dddocky: calls 100
Duke Croix: calls 100
*** FLOP *** [9s 2d 6s]
color_singleton: checks 
dddocky: checks 
Duke Croix: checks 
*** TURN *** [9s 2d 6s] [4d]
color_singleton: checks 
dddocky: checks 
Duke Croix: checks 
*** RIVER *** [9s 2d 6s 4d] [Jd]
color_singleton: checks 
dddocky: checks 
Duke Croix: checks 
*** SHOW DOWN ***
color_singleton: shows [7d Kh] (high card King)
dddocky: shows [Ac 7c] (high card Ace)
Duke Croix: mucks hand 
dddocky collected 661 from pot
*** SUMMARY ***
Total pot 700 | Rake 39 
Board [9s 2d 6s 4d Jd]
Seat 2: dddocky showed [Ac 7c] and won (661) with high card Ace
Seat 4: Duke Croix (button) mucked [Ts 8c]
Seat 6: color_singleton (small blind) showed [7d Kh] and lost with high card King
Seat 9: Manon541 (big blind) folded before Flop



PokerStars Home Game Hand #217636862104: {Club #3225207}  Hold'em No Limit (50/100) - 2020/08/20 18:18:48 ET
Table 'Manuel Neuer' 9-max (Play Money) Seat #6 is the button
Seat 2: dddocky (6447 in chips) 
Seat 4: Duke Croix (19302 in chips) 
Seat 6: color_singleton (9742 in chips) 
Seat 9: Manon541 (7096 in chips) 
Manon541: posts small blind 50
dddocky: posts big blind 100
*** HOLE CARDS ***
Dealt to Duke Croix [5d 4d]
Duke Croix: calls 100
color_singleton: raises 100 to 200
Manon541: calls 150
dddocky: folds 
Duke Croix: calls 100
*** FLOP *** [8c Jc 7s]
Manon541: bets 330
Duke Croix: folds 
color_singleton: calls 330
*** TURN *** [8c Jc 7s] [Ac]
Manon541: bets 642
color_singleton: calls 642
*** RIVER *** [8c Jc 7s Ac] [6c]
Manon541: bets 2499
color_singleton: calls 2499
*** SHOW DOWN ***
Manon541: shows [Kh Kc] (a flush, Ace high)
color_singleton: mucks hand 
Manon541 collected 7222 from pot
*** SUMMARY ***
Total pot 7642 | Rake 420 
Board [8c Jc 7s Ac 6c]
Seat 2: dddocky (big blind) folded before Flop
Seat 4: Duke Croix folded on the Flop
Seat 6: color_singleton (button) mucked [Tc 9h]
Seat 9: Manon541 (small blind) showed [Kh Kc] and won (7222) with a flush, Ace high



PokerStars Home Game Hand #217636882420: {Club #3225207}  Hold'em No Limit (50/100) - 2020/08/20 18:19:31 ET
Table 'Manuel Neuer' 9-max (Play Money) Seat #9 is the button
Seat 2: dddocky (6347 in chips) 
Seat 4: Duke Croix (19102 in chips) 
Seat 6: color_singleton (6071 in chips) 
Seat 9: Manon541 (10647 in chips) 
dddocky: posts small blind 50
Duke Croix: posts big blind 100
*** HOLE CARDS ***
Dealt to Duke Croix [Th 8h]
color_singleton: calls 100
Manon541: calls 100
dddocky: calls 50
Duke Croix: checks 
*** FLOP *** [Kc 9s 7s]
dddocky: checks 
Duke Croix: bets 300
color_singleton: raises 300 to 600
Manon541: calls 600
dddocky: calls 600
Duke Croix: calls 300
*** TURN *** [Kc 9s 7s] [8s]
dddocky: bets 100
Duke Croix: calls 100
color_singleton: calls 100
Manon541: raises 1523 to 1623
dddocky: calls 1523
Duke Croix: folds 
color_singleton: calls 1523
*** RIVER *** [Kc 9s 7s 8s] [Qs]
dddocky: bets 3671
color_singleton: folds 
Manon541: folds 
Uncalled bet (3671) returned to dddocky
dddocky collected 7342 from pot
dddocky: doesn't show hand 
*** SUMMARY ***
Total pot 7769 | Rake 427 
Board [Kc 9s 7s 8s Qs]
Seat 2: dddocky (small blind) collected (7342)
Seat 4: Duke Croix (big blind) folded on the Turn
Seat 6: color_singleton folded on the River
Seat 9: Manon541 (button) folded on the River



PokerStars Home Game Hand #217636908553: {Club #3225207}  Hold'em No Limit (50/100) - 2020/08/20 18:20:27 ET
Table 'Manuel Neuer' 9-max (Play Money) Seat #2 is the button
Seat 2: dddocky (11366 in chips) 
Seat 4: Duke Croix (18302 in chips) 
Seat 6: color_singleton (3748 in chips) 
Seat 9: Manon541 (8324 in chips) 
Duke Croix: posts small blind 50
color_singleton: posts big blind 100
*** HOLE CARDS ***
Dealt to Duke Croix [4c 7d]
Manon541: calls 100
dddocky: calls 100
Duke Croix: calls 50
color_singleton: checks 
*** FLOP *** [Tc 3s Jd]
Duke Croix: checks 
color_singleton: bets 378
Manon541: folds 
dddocky: folds 
Duke Croix: folds 
Uncalled bet (378) returned to color_singleton
color_singleton collected 378 from pot
color_singleton: doesn't show hand 
*** SUMMARY ***
Total pot 400 | Rake 22 
Board [Tc 3s Jd]
Seat 2: dddocky (button) folded on the Flop
Seat 4: Duke Croix (small blind) folded on the Flop
Seat 6: color_singleton (big blind) collected (378)
Seat 9: Manon541 folded on the Flop



PokerStars Home Game Hand #217636917096: {Club #3225207}  Hold'em No Limit (50/100) - 2020/08/20 18:20:45 ET
Table 'Manuel Neuer' 9-max (Play Money) Seat #4 is the button
Seat 2: dddocky (11266 in chips) 
Seat 4: Duke Croix (18202 in chips) 
Seat 6: color_singleton (4026 in chips) 
Seat 9: Manon541 (8224 in chips) 
color_singleton: posts small blind 50
Manon541: posts big blind 100
*** HOLE CARDS ***
Dealt to Duke Croix [5c Js]
dddocky: calls 100
Duke Croix: calls 100
color_singleton: raises 100 to 200
Manon541: calls 100
dddocky: calls 100
Duke Croix: calls 100
*** FLOP *** [5s Qd 8d]
color_singleton: bets 756
Manon541: folds 
dddocky: folds 
Duke Croix: folds 
Uncalled bet (756) returned to color_singleton
color_singleton collected 756 from pot
color_singleton: doesn't show hand 
*** SUMMARY ***
Total pot 800 | Rake 44 
Board [5s Qd 8d]
Seat 2: dddocky folded on the Flop
Seat 4: Duke Croix (button) folded on the Flop
Seat 6: color_singleton (small blind) collected (756)
Seat 9: Manon541 (big blind) folded on the Flop



PokerStars Home Game Hand #217636926036: {Club #3225207}  Hold'em No Limit (50/100) - 2020/08/20 18:21:05 ET
Table 'Manuel Neuer' 9-max (Play Money) Seat #6 is the button
Seat 2: dddocky (11066 in chips) 
Seat 4: Duke Croix (18002 in chips) 
Seat 6: color_singleton (4582 in chips) 
Seat 9: Manon541 (8024 in chips) 
Manon541: posts small blind 50
dddocky: posts big blind 100
*** HOLE CARDS ***
Dealt to Duke Croix [2d 6h]
Duke Croix: folds 
color_singleton: raises 100 to 200
Manon541: calls 150
dddocky: calls 100
*** FLOP *** [Jd 5h 5s]
Manon541: bets 283
dddocky: calls 283
color_singleton: calls 283
*** TURN *** [Jd 5h 5s] [Ah]
Manon541: bets 684
dddocky: raises 684 to 1368
color_singleton: calls 1368
Manon541: calls 684
*** RIVER *** [Jd 5h 5s Ah] [4s]
Manon541: checks 
dddocky: checks 
color_singleton: checks 
*** SHOW DOWN ***
Manon541: shows [Kd 5d] (three of a kind, Fives)
dddocky: mucks hand 
color_singleton: mucks hand 
Manon541 collected 5248 from pot
*** SUMMARY ***
Total pot 5553 | Rake 305 
Board [Jd 5h 5s Ah 4s]
Seat 2: dddocky (big blind) mucked [Ad 4h]
Seat 4: Duke Croix folded before Flop (didn't bet)
Seat 6: color_singleton (button) mucked [Th Kh]
Seat 9: Manon541 (small blind) showed [Kd 5d] and won (5248) with three of a kind, Fives



PokerStars Home Game Hand #217636946089: {Club #3225207}  Hold'em No Limit (50/100) - 2020/08/20 18:21:47 ET
Table 'Manuel Neuer' 9-max (Play Money) Seat #9 is the button
Seat 2: dddocky (9215 in chips) 
Seat 4: Duke Croix (18002 in chips) 
Seat 6: color_singleton (2731 in chips) 
Seat 9: Manon541 (11421 in chips) 
dddocky: posts small blind 50
Duke Croix: posts big blind 100
*** HOLE CARDS ***
Dealt to Duke Croix [2d 2c]
color_singleton: raises 100 to 200
Manon541: folds 
dddocky: calls 150
Duke Croix: calls 100
*** FLOP *** [3c 3d 5h]
dddocky: checks 
Duke Croix: bets 300
color_singleton: folds 
dddocky: folds 
Uncalled bet (300) returned to Duke Croix
Duke Croix collected 567 from pot
*** SUMMARY ***
Total pot 600 | Rake 33 
Board [3c 3d 5h]
Seat 2: dddocky (small blind) folded on the Flop
Seat 4: Duke Croix (big blind) collected (567)
Seat 6: color_singleton folded on the Flop
Seat 9: Manon541 (button) folded before Flop (didn't bet)



PokerStars Home Game Hand #217636956895: {Club #3225207}  Hold'em No Limit (50/100) - 2020/08/20 18:22:10 ET
Table 'Manuel Neuer' 9-max (Play Money) Seat #2 is the button
Seat 2: dddocky (9015 in chips) 
Seat 4: Duke Croix (18369 in chips) 
Seat 6: color_singleton (2531 in chips) 
Seat 9: Manon541 (11421 in chips) 
Duke Croix: posts small blind 50
color_singleton: posts big blind 100
*** HOLE CARDS ***
Dealt to Duke Croix [6s 7s]
Manon541: calls 100
dddocky: calls 100
Duke Croix: calls 50
color_singleton: raises 200 to 300
Manon541: calls 200
dddocky: calls 200
Duke Croix: calls 200
*** FLOP *** [2h 8d Qh]
Duke Croix: checks 
color_singleton: checks 
Manon541: checks 
dddocky: checks 
*** TURN *** [2h 8d Qh] [3c]
Duke Croix: checks 
color_singleton: checks 
Manon541: checks 
dddocky: checks 
*** RIVER *** [2h 8d Qh 3c] [Js]
Duke Croix: checks 
color_singleton: checks 
Manon541: bets 1134
dddocky: folds 
Duke Croix: folds 
color_singleton: folds 
Uncalled bet (1134) returned to Manon541
Manon541 collected 1134 from pot
*** SUMMARY ***
Total pot 1200 | Rake 66 
Board [2h 8d Qh 3c Js]
Seat 2: dddocky (button) folded on the River
Seat 4: Duke Croix (small blind) folded on the River
Seat 6: color_singleton (big blind) folded on the River
Seat 9: Manon541 collected (1134)



PokerStars Home Game Hand #217636971658: {Club #3225207}  Hold'em No Limit (50/100) - 2020/08/20 18:22:42 ET
Table 'Manuel Neuer' 9-max (Play Money) Seat #4 is the button
Seat 2: dddocky (8715 in chips) 
Seat 4: Duke Croix (18069 in chips) 
Seat 6: color_singleton (2231 in chips) 
Seat 9: Manon541 (12255 in chips) 
color_singleton: posts small blind 50
Manon541: posts big blind 100
*** HOLE CARDS ***
Dealt to Duke Croix [Td 9h]
dddocky: calls 100
Duke Croix: calls 100
color_singleton: calls 50
Manon541: checks 
*** FLOP *** [4d Ks 8c]
color_singleton: checks 
Manon541: checks 
dddocky: bets 100
Duke Croix: folds 
color_singleton: folds 
Manon541: folds 
Uncalled bet (100) returned to dddocky
dddocky collected 378 from pot
dddocky: doesn't show hand 
*** SUMMARY ***
Total pot 400 | Rake 22 
Board [4d Ks 8c]
Seat 2: dddocky collected (378)
Seat 4: Duke Croix (button) folded on the Flop
Seat 6: color_singleton (small blind) folded on the Flop
Seat 9: Manon541 (big blind) folded on the Flop



PokerStars Home Game Hand #217636984079: {Club #3225207}  Hold'em No Limit (50/100) - 2020/08/20 18:23:08 ET
Table 'Manuel Neuer' 9-max (Play Money) Seat #6 is the button
Seat 2: dddocky (8993 in chips) 
Seat 4: Duke Croix (17969 in chips) 
Seat 6: color_singleton (2131 in chips) 
Seat 9: Manon541 (12155 in chips) 
Manon541: posts small blind 50
dddocky: posts big blind 100
*** HOLE CARDS ***
Dealt to Duke Croix [4h Kc]
Duke Croix: folds 
color_singleton: raises 100 to 200
Manon541: raises 100 to 300
dddocky: calls 200
color_singleton: calls 100
*** FLOP *** [Qs 3c Kd]
Manon541: bets 425
dddocky: calls 425
color_singleton: folds 
*** TURN *** [Qs 3c Kd] [Ac]
Manon541: bets 827
dddocky: calls 827
*** RIVER *** [Qs 3c Kd Ac] [6c]
Manon541: bets 3217
dddocky: calls 3217
*** SHOW DOWN ***
Manon541: shows [Ad Ah] (three of a kind, Aces)
dddocky: shows [9c Qc] (a flush, Ace high)
dddocky collected 9297 from pot
*** SUMMARY ***
Total pot 9838 | Rake 541 
Board [Qs 3c Kd Ac 6c]
Seat 2: dddocky (big blind) showed [9c Qc] and won (9297) with a flush, Ace high
Seat 4: Duke Croix folded before Flop (didn't bet)
Seat 6: color_singleton (button) folded on the Flop
Seat 9: Manon541 (small blind) showed [Ad Ah] and lost with three of a kind, Aces



PokerStars Home Game Hand #217636997865: {Club #3225207}  Hold'em No Limit (50/100) - 2020/08/20 18:23:38 ET
Table 'Manuel Neuer' 9-max (Play Money) Seat #9 is the button
Seat 2: dddocky (13521 in chips) 
Seat 4: Duke Croix (17969 in chips) 
Seat 6: color_singleton (1831 in chips) 
Seat 9: Manon541 (7386 in chips) 
dddocky: posts small blind 50
Duke Croix: posts big blind 100
*** HOLE CARDS ***
Dealt to Duke Croix [8s 6c]
color_singleton: raises 100 to 200
Manon541: calls 200
dddocky: calls 150
Duke Croix: calls 100
*** FLOP *** [5c 6d 4s]
dddocky: checks 
Duke Croix: bets 400
color_singleton: calls 400
Manon541: folds 
dddocky: calls 400
*** TURN *** [5c 6d 4s] [3c]
dddocky: checks 
Duke Croix: checks 
color_singleton: bets 945
dddocky: calls 945
Duke Croix: folds 
*** RIVER *** [5c 6d 4s 3c] [4c]
dddocky: checks 
color_singleton: bets 286 and is all-in
dddocky: folds 
Uncalled bet (286) returned to color_singleton
color_singleton collected 3676 from pot
color_singleton: doesn't show hand 
*** SUMMARY ***
Total pot 3890 | Rake 214 
Board [5c 6d 4s 3c 4c]
Seat 2: dddocky (small blind) folded on the River
Seat 4: Duke Croix (big blind) folded on the Turn
Seat 6: color_singleton collected (3676)
Seat 9: Manon541 (button) folded on the Flop



PokerStars Home Game Hand #217637029533: {Club #3225207}  Hold'em No Limit (50/100) - 2020/08/20 18:24:46 ET
Table 'Manuel Neuer' 9-max (Play Money) Seat #2 is the button
Seat 2: dddocky (11976 in chips) 
Seat 4: Duke Croix (17369 in chips) 
Seat 6: color_singleton (3962 in chips) 
Seat 9: Manon541 (7186 in chips) 
Duke Croix: posts small blind 50
color_singleton: posts big blind 100
*** HOLE CARDS ***
Dealt to Duke Croix [9d 7c]
Manon541: calls 100
dddocky: calls 100
Duke Croix: calls 50
color_singleton: checks 
*** FLOP *** [8d Ts Kc]
Duke Croix: bets 300
color_singleton: folds 
Manon541: folds 
dddocky: calls 300
*** TURN *** [8d Ts Kc] [6d]
Duke Croix: bets 500
dddocky: calls 500
*** RIVER *** [8d Ts Kc 6d] [Ad]
Duke Croix: bets 1300
dddocky: calls 1300
*** SHOW DOWN ***
Duke Croix: shows [9d 7c] (a straight, Six to Ten)
dddocky: mucks hand 
Duke Croix collected 4347 from pot
*** SUMMARY ***
Total pot 4600 | Rake 253 
Board [8d Ts Kc 6d Ad]
Seat 2: dddocky (button) mucked [Kh Tc]
Seat 4: Duke Croix (small blind) showed [9d 7c] and won (4347) with a straight, Six to Ten
Seat 6: color_singleton (big blind) folded on the Flop
Seat 9: Manon541 folded on the Flop



PokerStars Home Game Hand #217637044404: {Club #3225207}  Hold'em No Limit (50/100) - 2020/08/20 18:25:18 ET
Table 'Manuel Neuer' 9-max (Play Money) Seat #4 is the button
Seat 2: dddocky (9776 in chips) 
Seat 4: Duke Croix (19516 in chips) 
Seat 6: color_singleton (3862 in chips) 
Seat 9: Manon541 (7086 in chips) 
color_singleton: posts small blind 50
Manon541: posts big blind 100
*** HOLE CARDS ***
Dealt to Duke Croix [9s 9c]
dddocky: folds 
Duke Croix: raises 300 to 400
color_singleton: folds 
Manon541: folds 
Uncalled bet (300) returned to Duke Croix
Duke Croix collected 250 from pot
*** SUMMARY ***
Total pot 250 | Rake 0 
Seat 2: dddocky folded before Flop (didn't bet)
Seat 4: Duke Croix (button) collected (250)
Seat 6: color_singleton (small blind) folded before Flop
Seat 9: Manon541 (big blind) folded before Flop



PokerStars Home Game Hand #217637049747: {Club #3225207}  Hold'em No Limit (50/100) - 2020/08/20 18:25:29 ET
Table 'Manuel Neuer' 9-max (Play Money) Seat #6 is the button
Seat 2: dddocky (9776 in chips) 
Seat 4: Duke Croix (19666 in chips) 
Seat 6: color_singleton (3812 in chips) 
Seat 9: Manon541 (6986 in chips) 
Manon541: posts small blind 50
dddocky: posts big blind 100
*** HOLE CARDS ***
Dealt to Duke Croix [5s 3d]
Duke Croix: folds 
color_singleton: raises 300 to 400
Manon541: folds 
dddocky: folds 
Uncalled bet (300) returned to color_singleton
color_singleton collected 250 from pot
color_singleton: doesn't show hand 
*** SUMMARY ***
Total pot 250 | Rake 0 
Seat 2: dddocky (big blind) folded before Flop
Seat 4: Duke Croix folded before Flop (didn't bet)
Seat 6: color_singleton (button) collected (250)
Seat 9: Manon541 (small blind) folded before Flop



PokerStars Home Game Hand #217637061891: {Club #3225207}  Hold'em No Limit (50/100) - 2020/08/20 18:25:46 ET
Table 'Manuel Neuer' 9-max (Play Money) Seat #9 is the button
Seat 2: dddocky (9676 in chips) 
Seat 4: Duke Croix (19666 in chips) 
Seat 6: color_singleton (3962 in chips) 
Seat 9: Manon541 (6936 in chips) 
dddocky: posts small blind 50
Duke Croix: posts big blind 100
*** HOLE CARDS ***
Dealt to Duke Croix [6s 8d]
color_singleton: raises 200 to 300
Manon541: folds 
dddocky: calls 250
Duke Croix: calls 200
*** FLOP *** [9h 2h 3h]
dddocky: checks 
Duke Croix: checks 
color_singleton: bets 425
dddocky: calls 425
Duke Croix: folds 
*** TURN *** [9h 2h 3h] [Ts]
dddocky: checks 
color_singleton: checks 
*** RIVER *** [9h 2h 3h Ts] [Jc]
dddocky: checks 
color_singleton: checks 
*** SHOW DOWN ***
dddocky: shows [Ks Qd] (a straight, Nine to King)
color_singleton: mucks hand 
dddocky collected 1654 from pot
*** SUMMARY ***
Total pot 1750 | Rake 96 
Board [9h 2h 3h Ts Jc]
Seat 2: dddocky (small blind) showed [Ks Qd] and won (1654) with a straight, Nine to King
Seat 4: Duke Croix (big blind) folded on the Flop
Seat 6: color_singleton mucked [Kh 8s]
Seat 9: Manon541 (button) folded before Flop (didn't bet)



PokerStars Home Game Hand #217637073744: {Club #3225207}  Hold'em No Limit (50/100) - 2020/08/20 18:26:12 ET
Table 'Manuel Neuer' 9-max (Play Money) Seat #2 is the button
Seat 2: dddocky (10605 in chips) 
Seat 4: Duke Croix (19366 in chips) 
Seat 6: color_singleton (3237 in chips) 
Seat 9: Manon541 (6936 in chips) 
Duke Croix: posts small blind 50
color_singleton: posts big blind 100
*** HOLE CARDS ***
Dealt to Duke Croix [Kd 4h]
Manon541: calls 100
dddocky: calls 100
Duke Croix: calls 50
color_singleton: checks 
*** FLOP *** [3s Qs 7d]
Duke Croix: checks 
color_singleton: checks 
Manon541: checks 
dddocky: checks 
*** TURN *** [3s Qs 7d] [4d]
Duke Croix: checks 
color_singleton: checks 
Manon541: checks 
dddocky: checks 
*** RIVER *** [3s Qs 7d 4d] [3h]
Duke Croix: bets 100
color_singleton: folds 
Manon541: folds 
dddocky: calls 100
*** SHOW DOWN ***
Duke Croix: shows [Kd 4h] (two pair, Fours and Threes)
dddocky: mucks hand 
Duke Croix collected 567 from pot
*** SUMMARY ***
Total pot 600 | Rake 33 
Board [3s Qs 7d 4d 3h]
Seat 2: dddocky (button) mucked [Jc 4s]
Seat 4: Duke Croix (small blind) showed [Kd 4h] and won (567) with two pair, Fours and Threes
Seat 6: color_singleton (big blind) folded on the River
Seat 9: Manon541 folded on the River



PokerStars Home Game Hand #217637090531: {Club #3225207}  Hold'em No Limit (50/100) - 2020/08/20 18:26:48 ET
Table 'Manuel Neuer' 9-max (Play Money) Seat #4 is the button
Seat 2: dddocky (10405 in chips) 
Seat 4: Duke Croix (19733 in chips) 
Seat 6: color_singleton (3137 in chips) 
Seat 9: Manon541 (6836 in chips) 
color_singleton: posts small blind 50
Manon541: posts big blind 100
*** HOLE CARDS ***
Dealt to Duke Croix [7h 5h]
dddocky: calls 100
Duke Croix: calls 100
color_singleton: folds 
Manon541: checks 
*** FLOP *** [Jh 5d Ad]
Manon541: checks 
dddocky: checks 
Duke Croix: checks 
*** TURN *** [Jh 5d Ad] [Js]
Manon541: checks 
dddocky: checks 
Duke Croix: bets 200
Manon541: folds 
dddocky: calls 200
*** RIVER *** [Jh 5d Ad Js] [8c]
dddocky: checks 
Duke Croix: bets 400
dddocky: folds 
Uncalled bet (400) returned to Duke Croix
Duke Croix collected 709 from pot
*** SUMMARY ***
Total pot 750 | Rake 41 
Board [Jh 5d Ad Js 8c]
Seat 2: dddocky folded on the River
Seat 4: Duke Croix (button) collected (709)
Seat 6: color_singleton (small blind) folded before Flop
Seat 9: Manon541 (big blind) folded on the Turn



PokerStars Home Game Hand #217637101848: {Club #3225207}  Hold'em No Limit (50/100) - 2020/08/20 18:27:13 ET
Table 'Manuel Neuer' 9-max (Play Money) Seat #6 is the button
Seat 2: dddocky (10105 in chips) 
Seat 4: Duke Croix (20142 in chips) 
Seat 6: color_singleton (3087 in chips) 
Seat 9: Manon541 (6736 in chips) 
Manon541: posts small blind 50
dddocky: posts big blind 100
*** HOLE CARDS ***
Dealt to Duke Croix [8h Kd]
Duke Croix: raises 300 to 400
color_singleton: folds 
Manon541: folds 
dddocky: calls 300
*** FLOP *** [8s 3c Tc]
dddocky: checks 
Duke Croix: bets 500
dddocky: folds 
Uncalled bet (500) returned to Duke Croix
Duke Croix collected 803 from pot
*** SUMMARY ***
Total pot 850 | Rake 47 
Board [8s 3c Tc]
Seat 2: dddocky (big blind) folded on the Flop
Seat 4: Duke Croix collected (803)
Seat 6: color_singleton (button) folded before Flop (didn't bet)
Seat 9: Manon541 (small blind) folded before Flop



PokerStars Home Game Hand #217637110459: {Club #3225207}  Hold'em No Limit (50/100) - 2020/08/20 18:27:31 ET
Table 'Manuel Neuer' 9-max (Play Money) Seat #9 is the button
Seat 2: dddocky (9705 in chips) 
Seat 4: Duke Croix (20545 in chips) 
Seat 6: color_singleton (3087 in chips) 
Seat 9: Manon541 (6686 in chips) 
dddocky: posts small blind 50
Duke Croix: posts big blind 100
*** HOLE CARDS ***
Dealt to Duke Croix [6d Qc]
color_singleton: folds 
Manon541: calls 100
dddocky: calls 50
Duke Croix: checks 
*** FLOP *** [4d Jc 9s]
dddocky: checks 
Duke Croix: checks 
Manon541: checks 
*** TURN *** [4d Jc 9s] [Tc]
dddocky: checks 
Duke Croix: bets 200
Manon541: calls 200
dddocky: folds 
*** RIVER *** [4d Jc 9s Tc] [3c]
Duke Croix: checks 
Manon541: checks 
*** SHOW DOWN ***
Duke Croix: shows [6d Qc] (high card Queen)
Manon541: shows [Ah 2h] (high card Ace)
Manon541 collected 661 from pot
*** SUMMARY ***
Total pot 700 | Rake 39 
Board [4d Jc 9s Tc 3c]
Seat 2: dddocky (small blind) folded on the Turn
Seat 4: Duke Croix (big blind) showed [6d Qc] and lost with high card Queen
Seat 6: color_singleton folded before Flop (didn't bet)
Seat 9: Manon541 (button) showed [Ah 2h] and won (661) with high card Ace



PokerStars Home Game Hand #217637122574: {Club #3225207}  Hold'em No Limit (50/100) - 2020/08/20 18:27:58 ET
Table 'Manuel Neuer' 9-max (Play Money) Seat #2 is the button
Seat 2: dddocky (9605 in chips) 
Seat 4: Duke Croix (20245 in chips) 
Seat 6: color_singleton (3087 in chips) 
Seat 9: Manon541 (7047 in chips) 
Duke Croix: posts small blind 50
color_singleton: posts big blind 100
*** HOLE CARDS ***
Dealt to Duke Croix [7d 8s]
Manon541: folds 
dddocky: folds 
Duke Croix: calls 50
color_singleton: raises 100 to 200
Duke Croix: calls 100
*** FLOP *** [Td 8c Qs]
Duke Croix: checks 
color_singleton: checks 
*** TURN *** [Td 8c Qs] [8d]
Duke Croix: checks 
color_singleton: bets 189
Duke Croix: raises 311 to 500
color_singleton: calls 311
*** RIVER *** [Td 8c Qs 8d] [As]
Duke Croix: checks 
color_singleton: checks 
*** SHOW DOWN ***
Duke Croix: shows [7d 8s] (three of a kind, Eights)
color_singleton: mucks hand 
Duke Croix collected 1323 from pot
*** SUMMARY ***
Total pot 1400 | Rake 77 
Board [Td 8c Qs 8d As]
Seat 2: dddocky (button) folded before Flop (didn't bet)
Seat 4: Duke Croix (small blind) showed [7d 8s] and won (1323) with three of a kind, Eights
Seat 6: color_singleton (big blind) mucked [Qc 6s]
Seat 9: Manon541 folded before Flop (didn't bet)



PokerStars Home Game Hand #217637138632: {Club #3225207}  Hold'em No Limit (50/100) - 2020/08/20 18:28:33 ET
Table 'Manuel Neuer' 9-max (Play Money) Seat #4 is the button
Seat 2: dddocky (9605 in chips) 
Seat 4: Duke Croix (20868 in chips) 
Seat 6: color_singleton (2387 in chips) 
Seat 9: Manon541 (7047 in chips) 
color_singleton: posts small blind 50
Manon541: posts big blind 100
*** HOLE CARDS ***
Dealt to Duke Croix [Kc Ks]
dddocky: calls 100
Duke Croix: raises 400 to 500
color_singleton: calls 450
Manon541: folds 
dddocky: calls 400
*** FLOP *** [8c 8h 8d]
color_singleton: checks 
dddocky: checks 
Duke Croix: checks 
*** TURN *** [8c 8h 8d] [8s]
color_singleton: checks 
dddocky: checks 
Duke Croix: bets 756
color_singleton: folds 
dddocky: folds 
Uncalled bet (756) returned to Duke Croix
Duke Croix collected 1512 from pot
*** SUMMARY ***
Total pot 1600 | Rake 88 
Board [8c 8h 8d 8s]
Seat 2: dddocky folded on the Turn
Seat 4: Duke Croix (button) collected (1512)
Seat 6: color_singleton (small blind) folded on the Turn
Seat 9: Manon541 (big blind) folded before Flop



PokerStars Home Game Hand #217637155539: {Club #3225207}  Hold'em No Limit (50/100) - 2020/08/20 18:29:10 ET
Table 'Manuel Neuer' 9-max (Play Money) Seat #6 is the button
Seat 2: dddocky (9105 in chips) 
Seat 4: Duke Croix (21880 in chips) 
Seat 6: color_singleton (1887 in chips) 
Seat 9: Manon541 (6947 in chips) 
Manon541: posts small blind 50
dddocky: posts big blind 100
*** HOLE CARDS ***
Dealt to Duke Croix [Jd Ts]
Duke Croix: raises 200 to 300
color_singleton: folds 
Manon541: calls 250
dddocky: folds 
*** FLOP *** [Kh Ac 7h]
Manon541: checks 
Duke Croix: bets 300
Manon541: folds 
Uncalled bet (300) returned to Duke Croix
Duke Croix collected 661 from pot
*** SUMMARY ***
Total pot 700 | Rake 39 
Board [Kh Ac 7h]
Seat 2: dddocky (big blind) folded before Flop
Seat 4: Duke Croix collected (661)
Seat 6: color_singleton (button) folded before Flop (didn't bet)
Seat 9: Manon541 (small blind) folded on the Flop



PokerStars Home Game Hand #217637169776: {Club #3225207}  Hold'em No Limit (50/100) - 2020/08/20 18:29:42 ET
Table 'Manuel Neuer' 9-max (Play Money) Seat #9 is the button
Seat 2: dddocky (9005 in chips) 
Seat 4: Duke Croix (22241 in chips) 
Seat 6: color_singleton (1887 in chips) 
Seat 9: Manon541 (6647 in chips) 
dddocky: posts small blind 50
Duke Croix: posts big blind 100
*** HOLE CARDS ***
Dealt to Duke Croix [Jc Ts]
color_singleton: raises 200 to 300
Manon541: folds 
dddocky: folds 
Duke Croix: calls 200
*** FLOP *** [Kh 6s Tc]
Duke Croix: checks 
color_singleton: checks 
*** TURN *** [Kh 6s Tc] [Jd]
Duke Croix: bets 400
color_singleton: calls 400
*** RIVER *** [Kh 6s Tc Jd] [3c]
Duke Croix: bets 1187
color_singleton: folds 
Uncalled bet (1187) returned to Duke Croix
Duke Croix collected 1370 from pot
*** SUMMARY ***
Total pot 1450 | Rake 80 
Board [Kh 6s Tc Jd 3c]
Seat 2: dddocky (small blind) folded before Flop
Seat 4: Duke Croix (big blind) collected (1370)
Seat 6: color_singleton folded on the River
Seat 9: Manon541 (button) folded before Flop (didn't bet)



PokerStars Home Game Hand #217637183062: {Club #3225207}  Hold'em No Limit (50/100) - 2020/08/20 18:30:11 ET
Table 'Manuel Neuer' 9-max (Play Money) Seat #2 is the button
Seat 2: dddocky (8955 in chips) 
Seat 4: Duke Croix (22911 in chips) 
Seat 6: color_singleton (1187 in chips) 
Seat 9: Manon541 (6647 in chips) 
Duke Croix: posts small blind 50
color_singleton: posts big blind 100
*** HOLE CARDS ***
Dealt to Duke Croix [5h 6d]
Manon541: calls 100
dddocky: calls 100
Duke Croix: calls 50
color_singleton: checks 
*** FLOP *** [Ah Kc 8h]
Duke Croix: checks 
color_singleton: checks 
Manon541: bets 189
dddocky: calls 189
Duke Croix: folds 
color_singleton: folds 
*** TURN *** [Ah Kc 8h] [Ac]
Manon541: bets 367
dddocky: calls 367
*** RIVER *** [Ah Kc 8h Ac] [2s]
Manon541: bets 714
dddocky: raises 714 to 1428
Manon541: calls 714
*** SHOW DOWN ***
dddocky: shows [As Th] (three of a kind, Aces)
Manon541: mucks hand 
dddocky collected 4128 from pot
*** SUMMARY ***
Total pot 4368 | Rake 240 
Board [Ah Kc 8h Ac 2s]
Seat 2: dddocky (button) showed [As Th] and won (4128) with three of a kind, Aces
Seat 4: Duke Croix (small blind) folded on the Flop
Seat 6: color_singleton (big blind) folded on the Flop
Seat 9: Manon541 mucked [Kd 5d]



PokerStars Home Game Hand #217637197118: {Club #3225207}  Hold'em No Limit (50/100) - 2020/08/20 18:30:42 ET
Table 'Manuel Neuer' 9-max (Play Money) Seat #4 is the button
Seat 2: dddocky (10999 in chips) 
Seat 4: Duke Croix (22811 in chips) 
Seat 6: color_singleton (1087 in chips) 
Seat 9: Manon541 (4563 in chips) 
color_singleton: posts small blind 50
Manon541: posts big blind 100
*** HOLE CARDS ***
Dealt to Duke Croix [5c Qh]
dddocky: calls 100
Duke Croix: folds 
color_singleton: calls 50
Manon541: checks 
*** FLOP *** [3d 8d 2c]
color_singleton: checks 
Manon541: checks 
dddocky: checks 
*** TURN *** [3d 8d 2c] [8c]
color_singleton: bets 141
Manon541: folds 
dddocky: folds 
Uncalled bet (141) returned to color_singleton
color_singleton collected 283 from pot
color_singleton: doesn't show hand 
*** SUMMARY ***
Total pot 300 | Rake 17 
Board [3d 8d 2c 8c]
Seat 2: dddocky folded on the Turn
Seat 4: Duke Croix (button) folded before Flop (didn't bet)
Seat 6: color_singleton (small blind) collected (283)
Seat 9: Manon541 (big blind) folded on the Turn



PokerStars Home Game Hand #217637205069: {Club #3225207}  Hold'em No Limit (50/100) - 2020/08/20 18:30:59 ET
Table 'Manuel Neuer' 9-max (Play Money) Seat #6 is the button
Seat 2: dddocky (10899 in chips) 
Seat 4: Duke Croix (22811 in chips) 
Seat 6: color_singleton (1270 in chips) 
Seat 9: Manon541 (4463 in chips) 
Manon541: posts small blind 50
dddocky: posts big blind 100
*** HOLE CARDS ***
Dealt to Duke Croix [Ah 5d]
Duke Croix: raises 300 to 400
color_singleton: folds 
Manon541: calls 350
dddocky: calls 300
*** FLOP *** [5c Js As]
Manon541: bets 567
dddocky: calls 567
Duke Croix: raises 1433 to 2000
Manon541: folds 
dddocky: folds 
Uncalled bet (1433) returned to Duke Croix
Duke Croix collected 2741 from pot
*** SUMMARY ***
Total pot 2901 | Rake 160 
Board [5c Js As]
Seat 2: dddocky (big blind) folded on the Flop
Seat 4: Duke Croix collected (2741)
Seat 6: color_singleton (button) folded before Flop (didn't bet)
Seat 9: Manon541 (small blind) folded on the Flop



PokerStars Home Game Hand #217637221114: {Club #3225207}  Hold'em No Limit (50/100) - 2020/08/20 18:31:34 ET
Table 'Manuel Neuer' 9-max (Play Money) Seat #9 is the button
Seat 2: dddocky (9932 in chips) 
Seat 4: Duke Croix (24585 in chips) 
Seat 6: color_singleton (1270 in chips) 
Seat 9: Manon541 (3496 in chips) 
dddocky: posts small blind 50
Duke Croix: posts big blind 100
*** HOLE CARDS ***
Dealt to Duke Croix [6s Kd]
color_singleton: raises 200 to 300
Manon541: folds 
dddocky: calls 250
Duke Croix: folds 
*** FLOP *** [3s Td Qc]
dddocky: checks 
color_singleton: checks 
*** TURN *** [3s Td Qc] [Tc]
dddocky: checks 
color_singleton: bets 330
dddocky: folds 
Uncalled bet (330) returned to color_singleton
color_singleton collected 661 from pot
color_singleton: doesn't show hand 
*** SUMMARY ***
Total pot 700 | Rake 39 
Board [3s Td Qc Tc]
Seat 2: dddocky (small blind) folded on the Turn
Seat 4: Duke Croix (big blind) folded before Flop
Seat 6: color_singleton collected (661)
Seat 9: Manon541 (button) folded before Flop (didn't bet)



PokerStars Home Game Hand #217637231977: {Club #3225207}  Hold'em No Limit (50/100) - 2020/08/20 18:31:58 ET
Table 'Manuel Neuer' 9-max (Play Money) Seat #2 is the button
Seat 2: dddocky (9632 in chips) 
Seat 4: Duke Croix (24485 in chips) 
Seat 6: color_singleton (1631 in chips) 
Seat 9: Manon541 (3496 in chips) 
Duke Croix: posts small blind 50
color_singleton: posts big blind 100
*** HOLE CARDS ***
Dealt to Duke Croix [8s 2c]
Manon541: calls 100
dddocky: calls 100
Duke Croix: calls 50
color_singleton: checks 
*** FLOP *** [Ac 4s 5h]
Duke Croix: checks 
color_singleton: bets 189
Manon541: calls 189
dddocky: folds 
Duke Croix: folds 
*** TURN *** [Ac 4s 5h] [Jc]
color_singleton: checks 
Manon541: bets 367
color_singleton: calls 367
*** RIVER *** [Ac 4s 5h Jc] [Qh]
color_singleton: bets 975 and is all-in
Manon541: calls 975
*** SHOW DOWN ***
color_singleton: shows [Qs 4h] (two pair, Queens and Fours)
Manon541: shows [Td Ah] (a pair of Aces)
color_singleton collected 3272 from pot
*** SUMMARY ***
Total pot 3462 | Rake 190 
Board [Ac 4s 5h Jc Qh]
Seat 2: dddocky (button) folded on the Flop
Seat 4: Duke Croix (small blind) folded on the Flop
Seat 6: color_singleton (big blind) showed [Qs 4h] and won (3272) with two pair, Queens and Fours
Seat 9: Manon541 showed [Td Ah] and lost with a pair of Aces



PokerStars Home Game Hand #217637250519: {Club #3225207}  Hold'em No Limit (50/100) - 2020/08/20 18:32:38 ET
Table 'Manuel Neuer' 9-max (Play Money) Seat #4 is the button
Seat 2: dddocky (9532 in chips) 
Seat 4: Duke Croix (24385 in chips) 
Seat 6: color_singleton (3272 in chips) 
Seat 9: Manon541 (1865 in chips) 
color_singleton: posts small blind 50
Manon541: posts big blind 100
*** HOLE CARDS ***
Dealt to Duke Croix [3d 9s]
dddocky: calls 100
Duke Croix: folds 
color_singleton: raises 100 to 200
Manon541: folds 
dddocky: calls 100
*** FLOP *** [5s Td 8d]
color_singleton: bets 472
dddocky: calls 472
*** TURN *** [5s Td 8d] [Ks]
color_singleton: checks 
dddocky: checks 
*** RIVER *** [5s Td 8d Ks] [Qs]
color_singleton: checks 
dddocky: bets 1365
color_singleton: folds 
Uncalled bet (1365) returned to dddocky
dddocky collected 1365 from pot
dddocky: doesn't show hand 
*** SUMMARY ***
Total pot 1444 | Rake 79 
Board [5s Td 8d Ks Qs]
Seat 2: dddocky collected (1365)
Seat 4: Duke Croix (button) folded before Flop (didn't bet)
Seat 6: color_singleton (small blind) folded on the River
Seat 9: Manon541 (big blind) folded before Flop



PokerStars Home Game Hand #217637265907: {Club #3225207}  Hold'em No Limit (50/100) - 2020/08/20 18:33:12 ET
Table 'Manuel Neuer' 9-max (Play Money) Seat #6 is the button
Seat 4: Duke Croix (24385 in chips) 
Seat 6: color_singleton (2600 in chips) 
Seat 9: Manon541 (1765 in chips) 
Manon541: posts small blind 50
Duke Croix: posts big blind 100
*** HOLE CARDS ***
Dealt to Duke Croix [8h 5c]
color_singleton: raises 200 to 300
Manon541: folds 
Duke Croix: folds 
Uncalled bet (200) returned to color_singleton
color_singleton collected 250 from pot
color_singleton: doesn't show hand 
*** SUMMARY ***
Total pot 250 | Rake 0 
Seat 4: Duke Croix (big blind) folded before Flop
Seat 6: color_singleton (button) collected (250)
Seat 9: Manon541 (small blind) folded before Flop



PokerStars Home Game Hand #217637270759: {Club #3225207}  Hold'em No Limit (50/100) - 2020/08/20 18:33:23 ET
Table 'Manuel Neuer' 9-max (Play Money) Seat #9 is the button
Seat 4: Duke Croix (24285 in chips) 
Seat 6: color_singleton (2750 in chips) 
Seat 9: Manon541 (1715 in chips) 
Duke Croix: posts small blind 50
color_singleton: posts big blind 100
*** HOLE CARDS ***
Dealt to Duke Croix [6h Td]
Manon541: calls 100
Duke Croix: calls 50
color_singleton: raises 200 to 300
Manon541: calls 200
Duke Croix: calls 200
*** FLOP *** [Th 7d Jh]
Duke Croix: bets 400
color_singleton: calls 400
dddocky leaves the table
Manon541: calls 400
*** TURN *** [Th 7d Jh] [3c]
Duke Croix: checks 
color_singleton: bets 2050 and is all-in
Manon541: calls 1015 and is all-in
Duke Croix: folds 
Uncalled bet (1035) returned to color_singleton
*** RIVER *** [Th 7d Jh 3c] [6d]
*** SHOW DOWN ***
color_singleton: shows [7h Jc] (two pair, Jacks and Sevens)
Manon541: shows [Jd 3s] (two pair, Jacks and Threes)
color_singleton collected 3903 from pot
*** SUMMARY ***
Total pot 4130 | Rake 227 
Board [Th 7d Jh 3c 6d]
Seat 4: Duke Croix (small blind) folded on the Turn
Seat 6: color_singleton (big blind) showed [7h Jc] and won (3903) with two pair, Jacks and Sevens
Seat 9: Manon541 (button) showed [Jd 3s] and lost with two pair, Jacks and Threes



PokerStars Home Game Hand #217637290797: {Club #3225207}  Hold'em No Limit (50/100) - 2020/08/20 18:34:07 ET
Table 'Manuel Neuer' 9-max (Play Money) Seat #6 is the button
Seat 4: Duke Croix (23585 in chips) 
Seat 6: color_singleton (4938 in chips) 
color_singleton: posts small blind 50
Duke Croix: posts big blind 100
*** HOLE CARDS ***
Dealt to Duke Croix [3s Ac]
color_singleton: folds 
Uncalled bet (50) returned to Duke Croix
Duke Croix collected 100 from pot
*** SUMMARY ***
Total pot 100 | Rake 0 
Seat 4: Duke Croix (big blind) collected (100)
Seat 6: color_singleton (button) (small blind) folded before Flop



PokerStars Home Game Hand #217637293903: {Club #3225207}  Hold'em No Limit (50/100) - 2020/08/20 18:34:13 ET
Table 'Manuel Neuer' 9-max (Play Money) Seat #4 is the button
Seat 4: Duke Croix (23635 in chips) 
Seat 6: color_singleton (4888 in chips) 
Duke Croix: posts small blind 50
color_singleton: posts big blind 100
*** HOLE CARDS ***
Dealt to Duke Croix [3h Tc]
Duke Croix: calls 50
color_singleton: raises 400 to 500
Duke Croix: folds 
Uncalled bet (400) returned to color_singleton
color_singleton collected 200 from pot
color_singleton: doesn't show hand 
*** SUMMARY ***
Total pot 200 | Rake 0 
Seat 4: Duke Croix (button) (small blind) folded before Flop
Seat 6: color_singleton (big blind) collected (200)



PokerStars Home Game Hand #217637298516: {Club #3225207}  Hold'em No Limit (50/100) - 2020/08/20 18:34:23 ET
Table 'Manuel Neuer' 9-max (Play Money) Seat #6 is the button
Seat 4: Duke Croix (23535 in chips) 
Seat 6: color_singleton (4988 in chips) 
color_singleton: posts small blind 50
Duke Croix: posts big blind 100
*** HOLE CARDS ***
Dealt to Duke Croix [Qd 7c]
color_singleton: calls 50
Duke Croix: checks 
*** FLOP *** [5c Qs 2h]
Duke Croix: bets 200
color_singleton: folds 
Uncalled bet (200) returned to Duke Croix
Duke Croix collected 189 from pot
*** SUMMARY ***
Total pot 200 | Rake 11 
Board [5c Qs 2h]
Seat 4: Duke Croix (big blind) collected (189)
Seat 6: color_singleton (button) (small blind) folded on the Flop



PokerStars Home Game Hand #217637303541: {Club #3225207}  Hold'em No Limit (50/100) - 2020/08/20 18:34:34 ET
Table 'Manuel Neuer' 9-max (Play Money) Seat #4 is the button
Seat 4: Duke Croix (23624 in chips) 
Seat 6: color_singleton (4888 in chips) 
Duke Croix: posts small blind 50
color_singleton: posts big blind 100
*** HOLE CARDS ***
Dealt to Duke Croix [9h 3h]
Duke Croix: calls 50
color_singleton: raises 200 to 300
Duke Croix: folds 
Uncalled bet (200) returned to color_singleton
color_singleton collected 200 from pot
color_singleton: doesn't show hand 
*** SUMMARY ***
Total pot 200 | Rake 0 
Seat 4: Duke Croix (button) (small blind) folded before Flop
Seat 6: color_singleton (big blind) collected (200)



PokerStars Home Game Hand #217637309081: {Club #3225207}  Hold'em No Limit (50/100) - 2020/08/20 18:34:47 ET
Table 'Manuel Neuer' 9-max (Play Money) Seat #6 is the button
Seat 4: Duke Croix (23524 in chips) 
Seat 6: color_singleton (4988 in chips) 
color_singleton: posts small blind 50
Duke Croix: posts big blind 100
*** HOLE CARDS ***
Dealt to Duke Croix [5s 4d]
color_singleton: raises 200 to 300
Duke Croix: calls 200
*** FLOP *** [2d Kd 7s]
Duke Croix: checks 
color_singleton: checks 
*** TURN *** [2d Kd 7s] [5h]
Duke Croix: bets 300
color_singleton: folds 
Uncalled bet (300) returned to Duke Croix
Duke Croix collected 567 from pot
*** SUMMARY ***
Total pot 600 | Rake 33 
Board [2d Kd 7s 5h]
Seat 4: Duke Croix (big blind) collected (567)
Seat 6: color_singleton (button) (small blind) folded on the Turn



PokerStars Home Game Hand #217637320844: {Club #3225207}  Hold'em No Limit (50/100) - 2020/08/20 18:35:12 ET
Table 'Manuel Neuer' 9-max (Play Money) Seat #4 is the button
Seat 4: Duke Croix (23791 in chips) 
Seat 6: color_singleton (4688 in chips) 
Duke Croix: posts small blind 50
color_singleton: posts big blind 100
*** HOLE CARDS ***
Dealt to Duke Croix [Kd 9d]
Duke Croix: raises 300 to 400
color_singleton: folds 
Uncalled bet (300) returned to Duke Croix
Duke Croix collected 200 from pot
*** SUMMARY ***
Total pot 200 | Rake 0 
Seat 4: Duke Croix (button) (small blind) collected (200)
Seat 6: color_singleton (big blind) folded before Flop



PokerStars Home Game Hand #217637324211: {Club #3225207}  Hold'em No Limit (50/100) - 2020/08/20 18:35:20 ET
Table 'Manuel Neuer' 9-max (Play Money) Seat #4 is the button
Seat 4: Duke Croix (23891 in chips) 
Seat 6: color_singleton (4588 in chips) 
Seat 9: Manon541 (8300 in chips) 
color_singleton: posts small blind 50
Manon541: posts big blind 100
*** HOLE CARDS ***
Dealt to Duke Croix [4c 6d]
Duke Croix: folds 
color_singleton: raises 200 to 300
Manon541: calls 200
*** FLOP *** [8h Qs Ks]
color_singleton: checks 
Manon541: checks 
*** TURN *** [8h Qs Ks] [Ac]
color_singleton: checks 
Manon541: checks 
*** RIVER *** [8h Qs Ks Ac] [Jc]
color_singleton: checks 
Manon541: checks 
*** SHOW DOWN ***
color_singleton: shows [5c 5d] (a pair of Fives)
Manon541: mucks hand 
color_singleton collected 567 from pot
*** SUMMARY ***
Total pot 600 | Rake 33 
Board [8h Qs Ks Ac Jc]
Seat 4: Duke Croix (button) folded before Flop (didn't bet)
Seat 6: color_singleton (small blind) showed [5c 5d] and won (567) with a pair of Fives
Seat 9: Manon541 (big blind) mucked [2h 5h]



PokerStars Home Game Hand #217637335676: {Club #3225207}  Hold'em No Limit (50/100) - 2020/08/20 18:35:44 ET
Table 'Manuel Neuer' 9-max (Play Money) Seat #6 is the button
Seat 4: Duke Croix (23891 in chips) 
Seat 6: color_singleton (4855 in chips) 
Seat 9: Manon541 (8000 in chips) 
Manon541: posts small blind 50
Duke Croix: posts big blind 100
*** HOLE CARDS ***
Dealt to Duke Croix [9h 3s]
color_singleton: calls 100
Manon541: calls 50
Duke Croix: checks 
*** FLOP *** [Jh Ks 6s]
Manon541: bets 141
Duke Croix: folds 
color_singleton: calls 141
*** TURN *** [Jh Ks 6s] [2h]
Manon541: checks 
color_singleton: checks 
*** RIVER *** [Jh Ks 6s 2h] [Tc]
Manon541: checks 
color_singleton: bets 275
Manon541: calls 275
*** SHOW DOWN ***
color_singleton: shows [Kd 6d] (two pair, Kings and Sixes)
Manon541: mucks hand 
color_singleton collected 1070 from pot
*** SUMMARY ***
Total pot 1132 | Rake 62 
Board [Jh Ks 6s 2h Tc]
Seat 4: Duke Croix (big blind) folded on the Flop
Seat 6: color_singleton (button) showed [Kd 6d] and won (1070) with two pair, Kings and Sixes
Seat 9: Manon541 (small blind) mucked [Qc Kh]



PokerStars Home Game Hand #217637357923: {Club #3225207}  Hold'em No Limit (50/100) - 2020/08/20 18:36:33 ET
Table 'Manuel Neuer' 9-max (Play Money) Seat #9 is the button
Seat 4: Duke Croix (23791 in chips) 
Seat 6: color_singleton (5409 in chips) 
Seat 9: Manon541 (7484 in chips) 
Duke Croix: posts small blind 50
color_singleton: posts big blind 100
*** HOLE CARDS ***
Dealt to Duke Croix [Ks 2d]
Manon541: calls 100
Duke Croix: calls 50
color_singleton: checks 
*** FLOP *** [5d 4c Jh]
Duke Croix: checks 
color_singleton: checks 
Manon541: checks 
*** TURN *** [5d 4c Jh] [Ad]
Duke Croix: checks 
color_singleton: checks 
Manon541: bets 141
Duke Croix: folds 
color_singleton: calls 141
*** RIVER *** [5d 4c Jh Ad] [Th]
color_singleton: checks 
Manon541: checks 
*** SHOW DOWN ***
color_singleton: shows [Jc 4s] (two pair, Jacks and Fours)
Manon541: mucks hand 
color_singleton collected 550 from pot
*** SUMMARY ***
Total pot 582 | Rake 32 
Board [5d 4c Jh Ad Th]
Seat 4: Duke Croix (small blind) folded on the Turn
Seat 6: color_singleton (big blind) showed [Jc 4s] and won (550) with two pair, Jacks and Fours
Seat 9: Manon541 (button) mucked [Jd Kh]



PokerStars Home Game Hand #217637370022: {Club #3225207}  Hold'em No Limit (50/100) - 2020/08/20 18:36:59 ET
Table 'Manuel Neuer' 9-max (Play Money) Seat #4 is the button
Seat 4: Duke Croix (23691 in chips) 
Seat 6: color_singleton (5718 in chips) 
Seat 9: Manon541 (7243 in chips) 
color_singleton: posts small blind 50
Manon541: posts big blind 100
*** HOLE CARDS ***
Dealt to Duke Croix [9c 2c]
Duke Croix: folds 
color_singleton: raises 200 to 300
Manon541: calls 200
*** FLOP *** [7h Jd 5c]
color_singleton: bets 283
Manon541: folds 
Uncalled bet (283) returned to color_singleton
color_singleton collected 567 from pot
color_singleton: doesn't show hand 
*** SUMMARY ***
Total pot 600 | Rake 33 
Board [7h Jd 5c]
Seat 4: Duke Croix (button) folded before Flop (didn't bet)
Seat 6: color_singleton (small blind) collected (567)
Seat 9: Manon541 (big blind) folded on the Flop



PokerStars Home Game Hand #217637376818: {Club #3225207}  Hold'em No Limit (50/100) - 2020/08/20 18:37:14 ET
Table 'Manuel Neuer' 9-max (Play Money) Seat #6 is the button
Seat 4: Duke Croix (23691 in chips) 
Seat 6: color_singleton (5985 in chips) 
Seat 9: Manon541 (6943 in chips) 
Manon541: posts small blind 50
Duke Croix: posts big blind 100
*** HOLE CARDS ***
Dealt to Duke Croix [7h 6h]
color_singleton: folds 
Manon541: calls 50
Duke Croix: raises 200 to 300
Manon541: folds 
Uncalled bet (200) returned to Duke Croix
Duke Croix collected 200 from pot
*** SUMMARY ***
Total pot 200 | Rake 0 
Seat 4: Duke Croix (big blind) collected (200)
Seat 6: color_singleton (button) folded before Flop (didn't bet)
Seat 9: Manon541 (small blind) folded before Flop



PokerStars Home Game Hand #217637384170: {Club #3225207}  Hold'em No Limit (50/100) - 2020/08/20 18:37:30 ET
Table 'Manuel Neuer' 9-max (Play Money) Seat #9 is the button
Seat 4: Duke Croix (23791 in chips) 
Seat 6: color_singleton (5985 in chips) 
Seat 9: Manon541 (6843 in chips) 
Duke Croix: posts small blind 50
color_singleton: posts big blind 100
*** HOLE CARDS ***
Dealt to Duke Croix [Jh 7h]
Manon541: calls 100
Duke Croix: calls 50
color_singleton: checks 
*** FLOP *** [Kd 9d 5h]
Duke Croix: checks 
color_singleton: checks 
Manon541: checks 
*** TURN *** [Kd 9d 5h] [9c]
Duke Croix: checks 
color_singleton: checks 
Manon541: checks 
*** RIVER *** [Kd 9d 5h 9c] [3s]
Duke Croix: checks 
color_singleton: checks 
Manon541: checks 
*** SHOW DOWN ***
Duke Croix: shows [Jh 7h] (a pair of Nines)
color_singleton: shows [4d Qh] (a pair of Nines - King+Queen kicker)
Manon541: shows [Ks 8h] (two pair, Kings and Nines)
Manon541 collected 283 from pot
*** SUMMARY ***
Total pot 300 | Rake 17 
Board [Kd 9d 5h 9c 3s]
Seat 4: Duke Croix (small blind) showed [Jh 7h] and lost with a pair of Nines
Seat 6: color_singleton (big blind) showed [4d Qh] and lost with a pair of Nines
Seat 9: Manon541 (button) showed [Ks 8h] and won (283) with two pair, Kings and Nines



PokerStars Home Game Hand #217637395522: {Club #3225207}  Hold'em No Limit (50/100) - 2020/08/20 18:37:55 ET
Table 'Manuel Neuer' 9-max (Play Money) Seat #4 is the button
Seat 4: Duke Croix (23691 in chips) 
Seat 6: color_singleton (5885 in chips) 
Seat 9: Manon541 (7026 in chips) 
color_singleton: posts small blind 50
Manon541: posts big blind 100
*** HOLE CARDS ***
Dealt to Duke Croix [Jd Td]
Duke Croix: raises 300 to 400
color_singleton: folds 
Manon541: calls 300
*** FLOP *** [4c 3h Ah]
Manon541: checks 
Duke Croix: checks 
*** TURN *** [4c 3h Ah] [Qs]
Manon541: checks 
Duke Croix: bets 400
Manon541: folds 
Uncalled bet (400) returned to Duke Croix
Duke Croix collected 803 from pot
*** SUMMARY ***
Total pot 850 | Rake 47 
Board [4c 3h Ah Qs]
Seat 4: Duke Croix (button) collected (803)
Seat 6: color_singleton (small blind) folded before Flop
Seat 9: Manon541 (big blind) folded on the Turn



PokerStars Home Game Hand #217637405724: {Club #3225207}  Hold'em No Limit (50/100) - 2020/08/20 18:38:17 ET
Table 'Manuel Neuer' 9-max (Play Money) Seat #6 is the button
Seat 4: Duke Croix (24094 in chips) 
Seat 6: color_singleton (5835 in chips) 
Seat 9: Manon541 (6626 in chips) 
Manon541: posts small blind 50
Duke Croix: posts big blind 100
*** HOLE CARDS ***
Dealt to Duke Croix [7h 6c]
color_singleton has timed out
color_singleton: folds 
Manon541: calls 50
Duke Croix: raises 200 to 300
Manon541: calls 200
*** FLOP *** [4h 7c 5s]
Manon541: checks 
Duke Croix: bets 400
Manon541: folds 
Uncalled bet (400) returned to Duke Croix
Duke Croix collected 567 from pot
*** SUMMARY ***
Total pot 600 | Rake 33 
Board [4h 7c 5s]
Seat 4: Duke Croix (big blind) collected (567)
Seat 6: color_singleton (button) folded before Flop (didn't bet)
Seat 9: Manon541 (small blind) folded on the Flop



PokerStars Home Game Hand #217637422780: {Club #3225207}  Hold'em No Limit (50/100) - 2020/08/20 18:38:54 ET
Table 'Manuel Neuer' 9-max (Play Money) Seat #9 is the button
Seat 4: Duke Croix (24361 in chips) 
Seat 6: color_singleton (5835 in chips) 
Seat 9: Manon541 (6326 in chips) 
Duke Croix: posts small blind 50
color_singleton: posts big blind 100
*** HOLE CARDS ***
Dealt to Duke Croix [4c 5s]
Manon541: calls 100
Duke Croix: calls 50
color_singleton: checks 
*** FLOP *** [Jc Qs Kd]
Duke Croix: checks 
color_singleton: checks 
Manon541: bets 141
Duke Croix: folds 
color_singleton: folds 
Uncalled bet (141) returned to Manon541
Manon541 collected 283 from pot
*** SUMMARY ***
Total pot 300 | Rake 17 
Board [Jc Qs Kd]
Seat 4: Duke Croix (small blind) folded on the Flop
Seat 6: color_singleton (big blind) folded on the Flop
Seat 9: Manon541 (button) collected (283)



PokerStars Home Game Hand #217637431504: {Club #3225207}  Hold'em No Limit (50/100) - 2020/08/20 18:39:13 ET
Table 'Manuel Neuer' 9-max (Play Money) Seat #4 is the button
Seat 4: Duke Croix (24261 in chips) 
Seat 6: color_singleton (5735 in chips) 
Seat 9: Manon541 (6509 in chips) 
color_singleton: posts small blind 50
Manon541: posts big blind 100
*** HOLE CARDS ***
Dealt to Duke Croix [6c Ad]
Duke Croix: raises 300 to 400
color_singleton: folds 
Manon541: calls 300
*** FLOP *** [2c Jh 5s]
Manon541: checks 
Duke Croix: checks 
*** TURN *** [2c Jh 5s] [Tc]
Manon541: checks 
Duke Croix: bets 400
Manon541: folds 
Uncalled bet (400) returned to Duke Croix
Duke Croix collected 803 from pot
*** SUMMARY ***
Total pot 850 | Rake 47 
Board [2c Jh 5s Tc]
Seat 4: Duke Croix (button) collected (803)
Seat 6: color_singleton (small blind) folded before Flop
Seat 9: Manon541 (big blind) folded on the Turn



PokerStars Home Game Hand #217637440936: {Club #3225207}  Hold'em No Limit (50/100) - 2020/08/20 18:39:34 ET
Table 'Manuel Neuer' 9-max (Play Money) Seat #6 is the button
Seat 4: Duke Croix (24664 in chips) 
Seat 6: color_singleton (5685 in chips) 
Seat 9: Manon541 (6109 in chips) 
Manon541: posts small blind 50
Duke Croix: posts big blind 100
*** HOLE CARDS ***
Dealt to Duke Croix [6c 9h]
color_singleton: raises 200 to 300
Manon541: folds 
Duke Croix: calls 200
*** FLOP *** [Qs 7s Qc]
Duke Croix: checks 
color_singleton: bets 307
Duke Croix: folds 
Uncalled bet (307) returned to color_singleton
color_singleton collected 614 from pot
color_singleton: doesn't show hand 
*** SUMMARY ***
Total pot 650 | Rake 36 
Board [Qs 7s Qc]
Seat 4: Duke Croix (big blind) folded on the Flop
Seat 6: color_singleton (button) collected (614)
Seat 9: Manon541 (small blind) folded before Flop



PokerStars Home Game Hand #217637453361: {Club #3225207}  Hold'em No Limit (50/100) - 2020/08/20 18:39:55 ET
Table 'Manuel Neuer' 9-max (Play Money) Seat #9 is the button
Seat 4: Duke Croix (24364 in chips) 
Seat 6: color_singleton (5999 in chips) 
Seat 9: Manon541 (6059 in chips) 
Duke Croix: posts small blind 50
color_singleton: posts big blind 100
*** HOLE CARDS ***
Dealt to Duke Croix [6s 5d]
Manon541: calls 100
Duke Croix: calls 50
color_singleton: checks 
*** FLOP *** [Ah Qh 4h]
Duke Croix: checks 
color_singleton: checks 
Manon541: bets 141
Duke Croix: folds 
color_singleton: folds 
Uncalled bet (141) returned to Manon541
Manon541 collected 283 from pot
*** SUMMARY ***
Total pot 300 | Rake 17 
Board [Ah Qh 4h]
Seat 4: Duke Croix (small blind) folded on the Flop
Seat 6: color_singleton (big blind) folded on the Flop
Seat 9: Manon541 (button) collected (283)



PokerStars Home Game Hand #217637462599: {Club #3225207}  Hold'em No Limit (50/100) - 2020/08/20 18:40:16 ET
Table 'Manuel Neuer' 9-max (Play Money) Seat #4 is the button
Seat 4: Duke Croix (24264 in chips) 
Seat 6: color_singleton (5899 in chips) 
Seat 9: Manon541 (6242 in chips) 
color_singleton: posts small blind 50
Manon541: posts big blind 100
*** HOLE CARDS ***
Dealt to Duke Croix [9s Kh]
Duke Croix: raises 300 to 400
color_singleton: folds 
Manon541: calls 300
*** FLOP *** [Th 7d 5d]
Manon541: checks 
Duke Croix: bets 400
Manon541: folds 
Uncalled bet (400) returned to Duke Croix
Duke Croix collected 803 from pot
*** SUMMARY ***
Total pot 850 | Rake 47 
Board [Th 7d 5d]
Seat 4: Duke Croix (button) collected (803)
Seat 6: color_singleton (small blind) folded before Flop
Seat 9: Manon541 (big blind) folded on the Flop



PokerStars Home Game Hand #217637472027: {Club #3225207}  Hold'em No Limit (50/100) - 2020/08/20 18:40:36 ET
Table 'Manuel Neuer' 9-max (Play Money) Seat #6 is the button
Seat 4: Duke Croix (24667 in chips) 
Seat 6: color_singleton (5849 in chips) 
Seat 9: Manon541 (5842 in chips) 
Manon541: posts small blind 50
Duke Croix: posts big blind 100
*** HOLE CARDS ***
Dealt to Duke Croix [7s 2d]
color_singleton: raises 200 to 300
Manon541: folds 
Duke Croix: folds 
Uncalled bet (200) returned to color_singleton
color_singleton collected 250 from pot
color_singleton: doesn't show hand 
*** SUMMARY ***
Total pot 250 | Rake 0 
Seat 4: Duke Croix (big blind) folded before Flop
Seat 6: color_singleton (button) collected (250)
Seat 9: Manon541 (small blind) folded before Flop



PokerStars Home Game Hand #217637475852: {Club #3225207}  Hold'em No Limit (50/100) - 2020/08/20 18:40:45 ET
Table 'Manuel Neuer' 9-max (Play Money) Seat #9 is the button
Seat 4: Duke Croix (24567 in chips) 
Seat 6: color_singleton (5999 in chips) 
Seat 9: Manon541 (5792 in chips) 
Duke Croix: posts small blind 50
color_singleton: posts big blind 100
*** HOLE CARDS ***
Dealt to Duke Croix [Qd Ts]
Manon541: calls 100
Duke Croix: raises 300 to 400
color_singleton: folds 
Manon541: calls 300
*** FLOP *** [4d 8s 7c]
Duke Croix: bets 400
Manon541: folds 
Uncalled bet (400) returned to Duke Croix
Duke Croix collected 850 from pot
*** SUMMARY ***
Total pot 900 | Rake 50 
Board [4d 8s 7c]
Seat 4: Duke Croix (small blind) collected (850)
Seat 6: color_singleton (big blind) folded before Flop
Seat 9: Manon541 (button) folded on the Flop



PokerStars Home Game Hand #217637482970: {Club #3225207}  Hold'em No Limit (50/100) - 2020/08/20 18:41:00 ET
Table 'Manuel Neuer' 9-max (Play Money) Seat #4 is the button
Seat 4: Duke Croix (25017 in chips) 
Seat 6: color_singleton (5899 in chips) 
Seat 9: Manon541 (5392 in chips) 
color_singleton: posts small blind 50
Manon541: posts big blind 100
*** HOLE CARDS ***
Dealt to Duke Croix [2h 4c]
Duke Croix: folds 
color_singleton: raises 100 to 200
Manon541: folds 
Uncalled bet (100) returned to color_singleton
color_singleton collected 200 from pot
color_singleton: doesn't show hand 
*** SUMMARY ***
Total pot 200 | Rake 0 
Seat 4: Duke Croix (button) folded before Flop (didn't bet)
Seat 6: color_singleton (small blind) collected (200)
Seat 9: Manon541 (big blind) folded before Flop



PokerStars Home Game Hand #217637486796: {Club #3225207}  Hold'em No Limit (50/100) - 2020/08/20 18:41:09 ET
Table 'Manuel Neuer' 9-max (Play Money) Seat #6 is the button
Seat 4: Duke Croix (25017 in chips) 
Seat 6: color_singleton (5999 in chips) 
Seat 9: Manon541 (5292 in chips) 
Manon541: posts small blind 50
Duke Croix: posts big blind 100
*** HOLE CARDS ***
Dealt to Duke Croix [6c Kd]
color_singleton: raises 200 to 300
Manon541: folds 
Duke Croix: calls 200
*** FLOP *** [Qc 6h 2s]
Duke Croix: bets 400
color_singleton: calls 400
*** TURN *** [Qc 6h 2s] [Jc]
Duke Croix: checks 
color_singleton: checks 
*** RIVER *** [Qc 6h 2s Jc] [Ks]
Duke Croix: bets 1000
color_singleton: folds 
Uncalled bet (1000) returned to Duke Croix
Duke Croix collected 1370 from pot
*** SUMMARY ***
Total pot 1450 | Rake 80 
Board [Qc 6h 2s Jc Ks]
Seat 4: Duke Croix (big blind) collected (1370)
Seat 6: color_singleton (button) folded on the River
Seat 9: Manon541 (small blind) folded before Flop



PokerStars Home Game Hand #217637500940: {Club #3225207}  Hold'em No Limit (50/100) - 2020/08/20 18:41:41 ET
Table 'Manuel Neuer' 9-max (Play Money) Seat #9 is the button
Seat 4: Duke Croix (25687 in chips) 
Seat 6: color_singleton (5299 in chips) 
Seat 9: Manon541 (5242 in chips) 
Duke Croix: posts small blind 50
color_singleton: posts big blind 100
*** HOLE CARDS ***
Dealt to Duke Croix [Tc 4h]
Manon541: calls 100
Duke Croix: calls 50
color_singleton: checks 
*** FLOP *** [5s Kc 9s]
Duke Croix: checks 
color_singleton: checks 
Manon541: checks 
*** TURN *** [5s Kc 9s] [8d]
Duke Croix: checks 
color_singleton: bets 141
Manon541: folds 
Duke Croix: folds 
Uncalled bet (141) returned to color_singleton
color_singleton collected 283 from pot
color_singleton: doesn't show hand 
*** SUMMARY ***
Total pot 300 | Rake 17 
Board [5s Kc 9s 8d]
Seat 4: Duke Croix (small blind) folded on the Turn
Seat 6: color_singleton (big blind) collected (283)
Seat 9: Manon541 (button) folded on the Turn



PokerStars Home Game Hand #217637510796: {Club #3225207}  Hold'em No Limit (50/100) - 2020/08/20 18:42:03 ET
Table 'Manuel Neuer' 9-max (Play Money) Seat #4 is the button
Seat 4: Duke Croix (25587 in chips) 
Seat 6: color_singleton (5482 in chips) 
Seat 9: Manon541 (5142 in chips) 
color_singleton: posts small blind 50
Manon541: posts big blind 100
*** HOLE CARDS ***
Dealt to Duke Croix [2d 4h]
Duke Croix: folds 
color_singleton: raises 100 to 200
Manon541: folds 
Uncalled bet (100) returned to color_singleton
color_singleton collected 200 from pot
color_singleton: doesn't show hand 
*** SUMMARY ***
Total pot 200 | Rake 0 
Seat 4: Duke Croix (button) folded before Flop (didn't bet)
Seat 6: color_singleton (small blind) collected (200)
Seat 9: Manon541 (big blind) folded before Flop



PokerStars Home Game Hand #217637514225: {Club #3225207}  Hold'em No Limit (50/100) - 2020/08/20 18:42:11 ET
Table 'Manuel Neuer' 9-max (Play Money) Seat #6 is the button
Seat 4: Duke Croix (25587 in chips) 
Seat 6: color_singleton (5582 in chips) 
Seat 9: Manon541 (5042 in chips) 
Manon541: posts small blind 50
Duke Croix: posts big blind 100
*** HOLE CARDS ***
Dealt to Duke Croix [Td 8c]
color_singleton: calls 100
Manon541: calls 50
Duke Croix: checks 
*** FLOP *** [2d 3h 9c]
Manon541: checks 
Duke Croix: checks 
color_singleton: checks 
*** TURN *** [2d 3h 9c] [7s]
Manon541: bets 141
Duke Croix: calls 141
color_singleton: raises 141 to 282
Manon541: calls 141
Duke Croix: calls 141
*** RIVER *** [2d 3h 9c 7s] [Jd]
Manon541: checks 
Duke Croix: bets 700
color_singleton: calls 700
Manon541: folds 
*** SHOW DOWN ***
Duke Croix: shows [Td 8c] (a straight, Seven to Jack)
color_singleton: mucks hand 
Duke Croix collected 2406 from pot
*** SUMMARY ***
Total pot 2546 | Rake 140 
Board [2d 3h 9c 7s Jd]
Seat 4: Duke Croix (big blind) showed [Td 8c] and won (2406) with a straight, Seven to Jack
Seat 6: color_singleton (button) mucked [As Ah]
Seat 9: Manon541 (small blind) folded on the River



PokerStars Home Game Hand #217637528036: {Club #3225207}  Hold'em No Limit (50/100) - 2020/08/20 18:42:42 ET
Table 'Manuel Neuer' 9-max (Play Money) Seat #9 is the button
Seat 4: Duke Croix (26911 in chips) 
Seat 6: color_singleton (4500 in chips) 
Seat 9: Manon541 (4660 in chips) 
Duke Croix: posts small blind 50
color_singleton: posts big blind 100
*** HOLE CARDS ***
Dealt to Duke Croix [9c 8s]
Manon541: calls 100
Duke Croix: raises 200 to 300
color_singleton: folds 
Manon541: calls 200
*** FLOP *** [5s Th Jc]
Duke Croix: bets 400
Manon541: folds 
Uncalled bet (400) returned to Duke Croix
Duke Croix collected 661 from pot
*** SUMMARY ***
Total pot 700 | Rake 39 
Board [5s Th Jc]
Seat 4: Duke Croix (small blind) collected (661)
Seat 6: color_singleton (big blind) folded before Flop
Seat 9: Manon541 (button) folded on the Flop



PokerStars Home Game Hand #217637537288: {Club #3225207}  Hold'em No Limit (50/100) - 2020/08/20 18:43:02 ET
Table 'Manuel Neuer' 9-max (Play Money) Seat #4 is the button
Seat 4: Duke Croix (27272 in chips) 
Seat 6: color_singleton (4400 in chips) 
Seat 9: Manon541 (4360 in chips) 
color_singleton: posts small blind 50
Manon541: posts big blind 100
*** HOLE CARDS ***
Dealt to Duke Croix [Qh 4h]
Duke Croix: calls 100
color_singleton: calls 50
Manon541: raises 100 to 200
Duke Croix: calls 100
color_singleton: calls 100
*** FLOP *** [3h Qd 5h]
color_singleton: bets 283
Manon541: raises 283 to 566
Duke Croix: calls 566
color_singleton: calls 283
*** TURN *** [3h Qd 5h] [5c]
color_singleton: checks 
Manon541: bets 2172
Duke Croix: raises 24334 to 26506 and is all-in
color_singleton: calls 3634 and is all-in
Manon541: calls 1422 and is all-in
Uncalled bet (22872) returned to Duke Croix
*** RIVER *** [3h Qd 5h 5c] [As]
*** SHOW DOWN ***
color_singleton: shows [7d 5s] (three of a kind, Fives)
Duke Croix: shows [Qh 4h] (two pair, Queens and Fives)
color_singleton collected 75 from side pot
Manon541: shows [Ac Ad] (a full house, Aces full of Fives)
Manon541 collected 12361 from main pot
*** SUMMARY ***
Total pot 13160 Main pot 12361. Side pot 75. | Rake 724 
Board [3h Qd 5h 5c As]
Seat 4: Duke Croix (button) showed [Qh 4h] and lost with two pair, Queens and Fives
Seat 6: color_singleton (small blind) showed [7d 5s] and won (75) with three of a kind, Fives
Seat 9: Manon541 (big blind) showed [Ac Ad] and won (12361) with a full house, Aces full of Fives



PokerStars Home Game Hand #217637558106: {Club #3225207}  Hold'em No Limit (50/100) - 2020/08/20 18:43:49 ET
Table 'Manuel Neuer' 9-max (Play Money) Seat #9 is the button
Seat 4: Duke Croix (22872 in chips) 
Seat 9: Manon541 (12361 in chips) 
Manon541: posts small blind 50
Duke Croix: posts big blind 100
*** HOLE CARDS ***
Dealt to Duke Croix [7h 4c]
Manon541: calls 50
Duke Croix: checks 
*** FLOP *** [6h Ad Kc]
Duke Croix: checks 
Manon541: checks 
*** TURN *** [6h Ad Kc] [8h]
Duke Croix: checks 
Manon541: checks 
*** RIVER *** [6h Ad Kc 8h] [3d]
Duke Croix: checks 
Manon541: checks 
*** SHOW DOWN ***
Duke Croix: shows [7h 4c] (high card Ace)
Manon541: shows [4d Tc] (high card Ace - King+Ten kicker)
Manon541 collected 189 from pot
*** SUMMARY ***
Total pot 200 | Rake 11 
Board [6h Ad Kc 8h 3d]
Seat 4: Duke Croix (big blind) showed [7h 4c] and lost with high card Ace
Seat 9: Manon541 (button) (small blind) showed [4d Tc] and won (189) with high card Ace



PokerStars Home Game Hand #217637569548: {Club #3225207}  Hold'em No Limit (50/100) - 2020/08/20 18:44:15 ET
Table 'Manuel Neuer' 9-max (Play Money) Seat #9 is the button
Seat 4: Duke Croix (22772 in chips) 
Seat 6: color_singleton (10000 in chips) 
Seat 9: Manon541 (12450 in chips) 
Duke Croix: posts small blind 50
color_singleton: posts big blind 100
*** HOLE CARDS ***
Dealt to Duke Croix [Qc Js]
Manon541: folds 
Duke Croix: raises 300 to 400
color_singleton: folds 
Uncalled bet (300) returned to Duke Croix
Duke Croix collected 200 from pot
*** SUMMARY ***
Total pot 200 | Rake 0 
Seat 4: Duke Croix (small blind) collected (200)
Seat 6: color_singleton (big blind) folded before Flop
Seat 9: Manon541 (button) folded before Flop (didn't bet)



PokerStars Home Game Hand #217637574807: {Club #3225207}  Hold'em No Limit (50/100) - 2020/08/20 18:44:27 ET
Table 'Manuel Neuer' 9-max (Play Money) Seat #4 is the button
Seat 4: Duke Croix (22872 in chips) 
Seat 6: color_singleton (9900 in chips) 
Seat 9: Manon541 (12450 in chips) 
color_singleton: posts small blind 50
Manon541: posts big blind 100
*** HOLE CARDS ***
Dealt to Duke Croix [5d Ks]
Duke Croix: calls 100
color_singleton: raises 100 to 200
Manon541: folds 
Duke Croix: calls 100
*** FLOP *** [Jh 5h Th]
color_singleton: bets 236
Duke Croix: folds 
Uncalled bet (236) returned to color_singleton
color_singleton collected 472 from pot
color_singleton: doesn't show hand 
*** SUMMARY ***
Total pot 500 | Rake 28 
Board [Jh 5h Th]
Seat 4: Duke Croix (button) folded on the Flop
Seat 6: color_singleton (small blind) collected (472)
Seat 9: Manon541 (big blind) folded before Flop



PokerStars Home Game Hand #217637584005: {Club #3225207}  Hold'em No Limit (50/100) - 2020/08/20 18:44:48 ET
Table 'Manuel Neuer' 9-max (Play Money) Seat #6 is the button
Seat 4: Duke Croix (22672 in chips) 
Seat 6: color_singleton (10172 in chips) 
Seat 9: Manon541 (12350 in chips) 
Manon541: posts small blind 50
Duke Croix: posts big blind 100
*** HOLE CARDS ***
Dealt to Duke Croix [3d As]
color_singleton: raises 100 to 200
Manon541: folds 
Duke Croix: calls 100
*** FLOP *** [7h 9d 5d]
Duke Croix: checks 
color_singleton: checks 
*** TURN *** [7h 9d 5d] [5h]
Duke Croix: checks 
color_singleton: bets 212
Duke Croix: folds 
Uncalled bet (212) returned to color_singleton
color_singleton collected 425 from pot
color_singleton: doesn't show hand 
*** SUMMARY ***
Total pot 450 | Rake 25 
Board [7h 9d 5d 5h]
Seat 4: Duke Croix (big blind) folded on the Turn
Seat 6: color_singleton (button) collected (425)
Seat 9: Manon541 (small blind) folded before Flop



PokerStars Home Game Hand #217637593727: {Club #3225207}  Hold'em No Limit (50/100) - 2020/08/20 18:45:09 ET
Table 'Manuel Neuer' 9-max (Play Money) Seat #9 is the button
Seat 4: Duke Croix (22472 in chips) 
Seat 6: color_singleton (10397 in chips) 
Seat 9: Manon541 (12300 in chips) 
Duke Croix: posts small blind 50
color_singleton: posts big blind 100
*** HOLE CARDS ***
Dealt to Duke Croix [Th Td]
Manon541: calls 100
Duke Croix: raises 300 to 400
color_singleton: calls 300
Manon541: calls 300
*** FLOP *** [Kc Js 4d]
Duke Croix: bets 600
color_singleton: calls 600
Manon541: folds 
*** TURN *** [Kc Js 4d] [2h]
Duke Croix: checks 
color_singleton: bets 1134
Duke Croix: folds 
Uncalled bet (1134) returned to color_singleton
color_singleton collected 2268 from pot
color_singleton: doesn't show hand 
*** SUMMARY ***
Total pot 2400 | Rake 132 
Board [Kc Js 4d 2h]
Seat 4: Duke Croix (small blind) folded on the Turn
Seat 6: color_singleton (big blind) collected (2268)
Seat 9: Manon541 (button) folded on the Flop



PokerStars Home Game Hand #217637604644: {Club #3225207}  Hold'em No Limit (50/100) - 2020/08/20 18:45:34 ET
Table 'Manuel Neuer' 9-max (Play Money) Seat #4 is the button
Seat 4: Duke Croix (21472 in chips) 
Seat 6: color_singleton (11665 in chips) 
Seat 9: Manon541 (11900 in chips) 
color_singleton: posts small blind 50
Manon541: posts big blind 100
*** HOLE CARDS ***
Dealt to Duke Croix [4c Jd]
Duke Croix: folds 
color_singleton: raises 100 to 200
Manon541: folds 
Uncalled bet (100) returned to color_singleton
color_singleton collected 200 from pot
color_singleton: doesn't show hand 
*** SUMMARY ***
Total pot 200 | Rake 0 
Seat 4: Duke Croix (button) folded before Flop (didn't bet)
Seat 6: color_singleton (small blind) collected (200)
Seat 9: Manon541 (big blind) folded before Flop



PokerStars Home Game Hand #217637607387: {Club #3225207}  Hold'em No Limit (50/100) - 2020/08/20 18:45:40 ET
Table 'Manuel Neuer' 9-max (Play Money) Seat #6 is the button
Seat 4: Duke Croix (21472 in chips) 
Seat 6: color_singleton (11765 in chips) 
Seat 9: Manon541 (11800 in chips) 
Manon541: posts small blind 50
Duke Croix: posts big blind 100
*** HOLE CARDS ***
Dealt to Duke Croix [Js 2c]
color_singleton: raises 100 to 200
Manon541: calls 150
Duke Croix: calls 100
*** FLOP *** [6h 4c Th]
Manon541: checks 
Duke Croix: checks 
color_singleton: checks 
*** TURN *** [6h 4c Th] [8h]
Manon541: bets 283
Duke Croix: folds 
color_singleton: calls 283
*** RIVER *** [6h 4c Th 8h] [Kd]
Manon541: bets 551
color_singleton: calls 551
*** SHOW DOWN ***
Manon541: shows [Tc Ah] (a pair of Tens)
color_singleton: mucks hand 
Manon541 collected 2143 from pot
*** SUMMARY ***
Total pot 2268 | Rake 125 
Board [6h 4c Th 8h Kd]
Seat 4: Duke Croix (big blind) folded on the Turn
Seat 6: color_singleton (button) mucked [Ad 8c]
Seat 9: Manon541 (small blind) showed [Tc Ah] and won (2143) with a pair of Tens



PokerStars Home Game Hand #217637621512: {Club #3225207}  Hold'em No Limit (50/100) - 2020/08/20 18:46:12 ET
Table 'Manuel Neuer' 9-max (Play Money) Seat #9 is the button
Seat 4: Duke Croix (21272 in chips) 
Seat 6: color_singleton (10731 in chips) 
Seat 9: Manon541 (12909 in chips) 
Duke Croix: posts small blind 50
color_singleton: posts big blind 100
*** HOLE CARDS ***
Dealt to Duke Croix [Qh 6d]
Manon541: calls 100
Duke Croix: calls 50
color_singleton: checks 
*** FLOP *** [8s Ks Qs]
Duke Croix: checks 
color_singleton: checks 
Manon541: bets 100
Duke Croix: calls 100
color_singleton: folds 
*** TURN *** [8s Ks Qs] [Ac]
Duke Croix: bets 300
Manon541: raises 300 to 600
Duke Croix: folds 
Uncalled bet (300) returned to Manon541
Manon541 collected 1039 from pot
*** SUMMARY ***
Total pot 1100 | Rake 61 
Board [8s Ks Qs Ac]
Seat 4: Duke Croix (small blind) folded on the Turn
Seat 6: color_singleton (big blind) folded on the Flop
Seat 9: Manon541 (button) collected (1039)



PokerStars Home Game Hand #217637636549: {Club #3225207}  Hold'em No Limit (50/100) - 2020/08/20 18:46:46 ET
Table 'Manuel Neuer' 9-max (Play Money) Seat #4 is the button
Seat 4: Duke Croix (20772 in chips) 
Seat 6: color_singleton (10631 in chips) 
Seat 9: Manon541 (13448 in chips) 
color_singleton: posts small blind 50
Manon541: posts big blind 100
*** HOLE CARDS ***
Dealt to Duke Croix [4h 5h]
Duke Croix: raises 200 to 300
color_singleton: folds 
Manon541: calls 200
*** FLOP *** [Jh 8d 3d]
Manon541: checks 
Duke Croix: checks 
*** TURN *** [Jh 8d 3d] [7s]
Manon541: bets 307
Duke Croix: folds 
Uncalled bet (307) returned to Manon541
Manon541 collected 614 from pot
*** SUMMARY ***
Total pot 650 | Rake 36 
Board [Jh 8d 3d 7s]
Seat 4: Duke Croix (button) folded on the Turn
Seat 6: color_singleton (small blind) folded before Flop
Seat 9: Manon541 (big blind) collected (614)



PokerStars Home Game Hand #217637643412: {Club #3225207}  Hold'em No Limit (50/100) - 2020/08/20 18:47:01 ET
Table 'Manuel Neuer' 9-max (Play Money) Seat #6 is the button
Seat 4: Duke Croix (20472 in chips) 
Seat 6: color_singleton (10581 in chips) 
Seat 9: Manon541 (13762 in chips) 
Manon541: posts small blind 50
Duke Croix: posts big blind 100
*** HOLE CARDS ***
Dealt to Duke Croix [Jh 9s]
color_singleton: raises 200 to 300
Manon541: folds 
Duke Croix: calls 200
*** FLOP *** [Th Qd 4c]
Duke Croix: bets 400
color_singleton: calls 400
*** TURN *** [Th Qd 4c] [4d]
Duke Croix: bets 700
color_singleton: calls 700
*** RIVER *** [Th Qd 4c 4d] [9c]
Duke Croix: bets 1500
color_singleton: folds 
Uncalled bet (1500) returned to Duke Croix
Duke Croix collected 2693 from pot
*** SUMMARY ***
Total pot 2850 | Rake 157 
Board [Th Qd 4c 4d 9c]
Seat 4: Duke Croix (big blind) collected (2693)
Seat 6: color_singleton (button) folded on the River
Seat 9: Manon541 (small blind) folded before Flop



PokerStars Home Game Hand #217637657017: {Club #3225207}  Hold'em No Limit (50/100) - 2020/08/20 18:47:32 ET
Table 'Manuel Neuer' 9-max (Play Money) Seat #9 is the button
Seat 4: Duke Croix (21765 in chips) 
Seat 6: color_singleton (9181 in chips) 
Seat 9: Manon541 (13712 in chips) 
Duke Croix: posts small blind 50
color_singleton: posts big blind 100
*** HOLE CARDS ***
Dealt to Duke Croix [3s Qd]
Manon541: folds 
Duke Croix: calls 50
color_singleton: raises 100 to 200
Duke Croix: calls 100
*** FLOP *** [8d 5d Qs]
Duke Croix: checks 
color_singleton: bets 189
Duke Croix: calls 189
*** TURN *** [8d 5d Qs] [6d]
Duke Croix: checks 
color_singleton: checks 
*** RIVER *** [8d 5d Qs 6d] [2d]
Duke Croix: bets 600
color_singleton: calls 600
*** SHOW DOWN ***
Duke Croix: shows [3s Qd] (a flush, Queen high)
color_singleton: mucks hand 
Duke Croix collected 1869 from pot
*** SUMMARY ***
Total pot 1978 | Rake 109 
Board [8d 5d Qs 6d 2d]
Seat 4: Duke Croix (small blind) showed [3s Qd] and won (1869) with a flush, Queen high
Seat 6: color_singleton (big blind) mucked [Th Jd]
Seat 9: Manon541 (button) folded before Flop (didn't bet)



PokerStars Home Game Hand #217637669150: {Club #3225207}  Hold'em No Limit (50/100) - 2020/08/20 18:47:59 ET
Table 'Manuel Neuer' 9-max (Play Money) Seat #4 is the button
Seat 4: Duke Croix (22645 in chips) 
Seat 6: color_singleton (8192 in chips) 
Seat 9: Manon541 (13712 in chips) 
color_singleton: posts small blind 50
Manon541: posts big blind 100
*** HOLE CARDS ***
Dealt to Duke Croix [Qs 4s]
Duke Croix: calls 100
color_singleton: calls 50
Manon541: checks 
*** FLOP *** [Kc 7h 9c]
color_singleton: bets 141
Manon541: calls 141
Duke Croix: folds 
*** TURN *** [Kc 7h 9c] [6c]
color_singleton: bets 275
Manon541: folds 
Uncalled bet (275) returned to color_singleton
color_singleton collected 550 from pot
color_singleton: doesn't show hand 
*** SUMMARY ***
Total pot 582 | Rake 32 
Board [Kc 7h 9c 6c]
Seat 4: Duke Croix (button) folded on the Flop
Seat 6: color_singleton (small blind) collected (550)
Seat 9: Manon541 (big blind) folded on the Turn



PokerStars Home Game Hand #217637681007: {Club #3225207}  Hold'em No Limit (50/100) - 2020/08/20 18:48:26 ET
Table 'Manuel Neuer' 9-max (Play Money) Seat #6 is the button
Seat 4: Duke Croix (22545 in chips) 
Seat 6: color_singleton (8501 in chips) 
Seat 9: Manon541 (13471 in chips) 
Manon541: posts small blind 50
Duke Croix: posts big blind 100
*** HOLE CARDS ***
Dealt to Duke Croix [8d Th]
color_singleton: folds 
Manon541: calls 50
Duke Croix: checks 
*** FLOP *** [7c Js 3s]
Manon541: bets 100
Duke Croix: folds 
Uncalled bet (100) returned to Manon541
Manon541 collected 189 from pot
*** SUMMARY ***
Total pot 200 | Rake 11 
Board [7c Js 3s]
Seat 4: Duke Croix (big blind) folded on the Flop
Seat 6: color_singleton (button) folded before Flop (didn't bet)
Seat 9: Manon541 (small blind) collected (189)



PokerStars Home Game Hand #217637686137: {Club #3225207}  Hold'em No Limit (50/100) - 2020/08/20 18:48:38 ET
Table 'Manuel Neuer' 9-max (Play Money) Seat #9 is the button
Seat 4: Duke Croix (22445 in chips) 
Seat 6: color_singleton (8501 in chips) 
Seat 9: Manon541 (13560 in chips) 
Duke Croix: posts small blind 50
color_singleton: posts big blind 100
*** HOLE CARDS ***
Dealt to Duke Croix [Kd 3d]
Manon541: folds 
Duke Croix: calls 50
color_singleton: raises 100 to 200
Duke Croix: calls 100
*** FLOP *** [4d 2h 5h]
Duke Croix: bets 200
color_singleton: calls 200
*** TURN *** [4d 2h 5h] [Ad]
Duke Croix: bets 500
color_singleton: calls 500
*** RIVER *** [4d 2h 5h Ad] [4s]
Duke Croix: checks 
color_singleton: bets 1000
Duke Croix: folds 
Uncalled bet (1000) returned to color_singleton
color_singleton collected 1701 from pot
color_singleton: doesn't show hand 
*** SUMMARY ***
Total pot 1800 | Rake 99 
Board [4d 2h 5h Ad 4s]
Seat 4: Duke Croix (small blind) folded on the River
Seat 6: color_singleton (big blind) collected (1701)
Seat 9: Manon541 (button) folded before Flop (didn't bet)



PokerStars Home Game Hand #217637699732: {Club #3225207}  Hold'em No Limit (50/100) - 2020/08/20 18:49:09 ET
Table 'Manuel Neuer' 9-max (Play Money) Seat #4 is the button
Seat 4: Duke Croix (21545 in chips) 
Seat 6: color_singleton (9302 in chips) 
Seat 9: Manon541 (13560 in chips) 
color_singleton: posts small blind 50
Manon541: posts big blind 100
*** HOLE CARDS ***
Dealt to Duke Croix [Jc As]
Duke Croix: raises 300 to 400
color_singleton: folds 
Manon541: folds 
Uncalled bet (300) returned to Duke Croix
Duke Croix collected 250 from pot
*** SUMMARY ***
Total pot 250 | Rake 0 
Seat 4: Duke Croix (button) collected (250)
Seat 6: color_singleton (small blind) folded before Flop
Seat 9: Manon541 (big blind) folded before Flop



PokerStars Home Game Hand #217637711388: {Club #3225207}  Hold'em No Limit (50/100) - 2020/08/20 18:49:18 ET
Table 'Manuel Neuer' 9-max (Play Money) Seat #6 is the button
Seat 4: Duke Croix (21695 in chips) 
Seat 6: color_singleton (9252 in chips) 
Seat 9: Manon541 (13460 in chips) 
Manon541: posts small blind 50
Duke Croix: posts big blind 100
*** HOLE CARDS ***
Dealt to Duke Croix [As 2h]
color_singleton: raises 100 to 200
Manon541: folds 
Duke Croix: calls 100
*** FLOP *** [Ah Ac 4c]
Duke Croix: checks 
color_singleton: checks 
*** TURN *** [Ah Ac 4c] [Ks]
Duke Croix: bets 300
color_singleton: raises 300 to 600
Duke Croix: raises 300 to 900
color_singleton: calls 300
*** RIVER *** [Ah Ac 4c Ks] [Jc]
Duke Croix: checks 
color_singleton: checks 
*** SHOW DOWN ***
Duke Croix: shows [As 2h] (three of a kind, Aces)
color_singleton: mucks hand 
Duke Croix collected 2126 from pot
*** SUMMARY ***
Total pot 2250 | Rake 124 
Board [Ah Ac 4c Ks Jc]
Seat 4: Duke Croix (big blind) showed [As 2h] and won (2126) with three of a kind, Aces
Seat 6: color_singleton (button) mucked [Td Kh]
Seat 9: Manon541 (small blind) folded before Flop



PokerStars Home Game Hand #217637720851: {Club #3225207}  Hold'em No Limit (50/100) - 2020/08/20 18:49:39 ET
Table 'Manuel Neuer' 9-max (Play Money) Seat #9 is the button
Seat 4: Duke Croix (22721 in chips) 
Seat 6: color_singleton (8152 in chips) 
Seat 9: Manon541 (13410 in chips) 
Duke Croix: posts small blind 50
color_singleton: posts big blind 100
*** HOLE CARDS ***
Dealt to Duke Croix [9s 4h]
Manon541: calls 100
Duke Croix: calls 50
color_singleton: raises 100 to 200
Manon541: calls 100
Duke Croix: calls 100
*** FLOP *** [4s Qh 7s]
Duke Croix: checks 
color_singleton: bets 283
Manon541: calls 283
Duke Croix: folds 
*** TURN *** [4s Qh 7s] [4c]
color_singleton: bets 551
Manon541: calls 551
*** RIVER *** [4s Qh 7s 4c] [As]
color_singleton: bets 1071
Manon541: folds 
Uncalled bet (1071) returned to color_singleton
color_singleton collected 2143 from pot
color_singleton: doesn't show hand 
*** SUMMARY ***
Total pot 2268 | Rake 125 
Board [4s Qh 7s 4c As]
Seat 4: Duke Croix (small blind) folded on the Flop
Seat 6: color_singleton (big blind) collected (2143)
Seat 9: Manon541 (button) folded on the River



PokerStars Home Game Hand #217637740600: {Club #3225207}  Hold'em No Limit (50/100) - 2020/08/20 18:50:24 ET
Table 'Manuel Neuer' 9-max (Play Money) Seat #4 is the button
Seat 4: Duke Croix (22521 in chips) 
Seat 6: color_singleton (9261 in chips) 
Seat 9: Manon541 (12376 in chips) 
color_singleton: posts small blind 50
Manon541: posts big blind 100
*** HOLE CARDS ***
Dealt to Duke Croix [Jd 3h]
Duke Croix: folds 
color_singleton: folds 
Uncalled bet (50) returned to Manon541
Manon541 collected 100 from pot
*** SUMMARY ***
Total pot 100 | Rake 0 
Seat 4: Duke Croix (button) folded before Flop (didn't bet)
Seat 6: color_singleton (small blind) folded before Flop
Seat 9: Manon541 (big blind) collected (100)



PokerStars Home Game Hand #217637743659: {Club #3225207}  Hold'em No Limit (50/100) - 2020/08/20 18:50:31 ET
Table 'Manuel Neuer' 9-max (Play Money) Seat #6 is the button
Seat 4: Duke Croix (22521 in chips) 
Seat 6: color_singleton (9211 in chips) 
Seat 9: Manon541 (12426 in chips) 
Manon541: posts small blind 50
Duke Croix: posts big blind 100
*** HOLE CARDS ***
Dealt to Duke Croix [Qd 9d]
color_singleton: folds 
Manon541: calls 50
Duke Croix: raises 200 to 300
Manon541: folds 
Uncalled bet (200) returned to Duke Croix
Duke Croix collected 200 from pot
*** SUMMARY ***
Total pot 200 | Rake 0 
Seat 4: Duke Croix (big blind) collected (200)
Seat 6: color_singleton (button) folded before Flop (didn't bet)
Seat 9: Manon541 (small blind) folded before Flop



PokerStars Home Game Hand #217637748236: {Club #3225207}  Hold'em No Limit (50/100) - 2020/08/20 18:50:42 ET
Table 'Manuel Neuer' 9-max (Play Money) Seat #9 is the button
Seat 4: Duke Croix (22621 in chips) 
Seat 6: color_singleton (9211 in chips) 
Seat 9: Manon541 (12326 in chips) 
Duke Croix: posts small blind 50
color_singleton: posts big blind 100
*** HOLE CARDS ***
Dealt to Duke Croix [Qh 5c]
Manon541: calls 100
Duke Croix: calls 50
color_singleton: checks 
*** FLOP *** [Jc 6s 3h]
Duke Croix: checks 
color_singleton: checks 
Manon541: bets 141
Duke Croix: folds 
color_singleton: folds 
Uncalled bet (141) returned to Manon541
Manon541 collected 283 from pot
*** SUMMARY ***
Total pot 300 | Rake 17 
Board [Jc 6s 3h]
Seat 4: Duke Croix (small blind) folded on the Flop
Seat 6: color_singleton (big blind) folded on the Flop
Seat 9: Manon541 (button) collected (283)



PokerStars Home Game Hand #217637756621: {Club #3225207}  Hold'em No Limit (50/100) - 2020/08/20 18:51:01 ET
Table 'Manuel Neuer' 9-max (Play Money) Seat #4 is the button
Seat 4: Duke Croix (22521 in chips) 
Seat 6: color_singleton (9111 in chips) 
Seat 9: Manon541 (12509 in chips) 
color_singleton: posts small blind 50
Manon541: posts big blind 100
*** HOLE CARDS ***
Dealt to Duke Croix [5h 2d]
Duke Croix: folds 
color_singleton: folds 
Uncalled bet (50) returned to Manon541
Manon541 collected 100 from pot
*** SUMMARY ***
Total pot 100 | Rake 0 
Seat 4: Duke Croix (button) folded before Flop (didn't bet)
Seat 6: color_singleton (small blind) folded before Flop
Seat 9: Manon541 (big blind) collected (100)



PokerStars Home Game Hand #217637759520: {Club #3225207}  Hold'em No Limit (50/100) - 2020/08/20 18:51:08 ET
Table 'Manuel Neuer' 9-max (Play Money) Seat #6 is the button
Seat 4: Duke Croix (22521 in chips) 
Seat 6: color_singleton (9061 in chips) 
Seat 9: Manon541 (12559 in chips) 
Manon541: posts small blind 50
Duke Croix: posts big blind 100
*** HOLE CARDS ***
Dealt to Duke Croix [2h Kh]
color_singleton: folds 
Manon541: calls 50
Duke Croix: raises 200 to 300
Manon541: calls 200
*** FLOP *** [3d 6d 8h]
Manon541: checks 
Duke Croix: bets 400
Manon541: folds 
Uncalled bet (400) returned to Duke Croix
Duke Croix collected 567 from pot
*** SUMMARY ***
Total pot 600 | Rake 33 
Board [3d 6d 8h]
Seat 4: Duke Croix (big blind) collected (567)
Seat 6: color_singleton (button) folded before Flop (didn't bet)
Seat 9: Manon541 (small blind) folded on the Flop



PokerStars Home Game Hand #217637767116: {Club #3225207}  Hold'em No Limit (50/100) - 2020/08/20 18:51:26 ET
Table 'Manuel Neuer' 9-max (Play Money) Seat #9 is the button
Seat 4: Duke Croix (22788 in chips) 
Seat 6: color_singleton (9061 in chips) 
Seat 9: Manon541 (12259 in chips) 
Duke Croix: posts small blind 50
color_singleton: posts big blind 100
*** HOLE CARDS ***
Dealt to Duke Croix [Ts Qc]
Manon541: calls 100
Duke Croix: raises 400 to 500
color_singleton: folds 
Manon541: folds 
Uncalled bet (400) returned to Duke Croix
Duke Croix collected 300 from pot
*** SUMMARY ***
Total pot 300 | Rake 0 
Seat 4: Duke Croix (small blind) collected (300)
Seat 6: color_singleton (big blind) folded before Flop
Seat 9: Manon541 (button) folded before Flop



PokerStars Home Game Hand #217637772027: {Club #3225207}  Hold'em No Limit (50/100) - 2020/08/20 18:51:37 ET
Table 'Manuel Neuer' 9-max (Play Money) Seat #4 is the button
Seat 4: Duke Croix (22988 in chips) 
Seat 6: color_singleton (8961 in chips) 
Seat 9: Manon541 (12159 in chips) 
color_singleton: posts small blind 50
Manon541: posts big blind 100
*** HOLE CARDS ***
Dealt to Duke Croix [8s Qs]
Duke Croix: raises 200 to 300
color_singleton: folds 
Manon541: folds 
Uncalled bet (200) returned to Duke Croix
Duke Croix collected 250 from pot
*** SUMMARY ***
Total pot 250 | Rake 0 
Seat 4: Duke Croix (button) collected (250)
Seat 6: color_singleton (small blind) folded before Flop
Seat 9: Manon541 (big blind) folded before Flop



PokerStars Home Game Hand #217637775117: {Club #3225207}  Hold'em No Limit (50/100) - 2020/08/20 18:51:44 ET
Table 'Manuel Neuer' 9-max (Play Money) Seat #6 is the button
Seat 4: Duke Croix (23138 in chips) 
Seat 6: color_singleton (8911 in chips) 
Seat 9: Manon541 (12059 in chips) 
Manon541: posts small blind 50
Duke Croix: posts big blind 100
*** HOLE CARDS ***
Dealt to Duke Croix [Ac Tc]
color_singleton: folds 
Manon541: folds 
Uncalled bet (50) returned to Duke Croix
Duke Croix collected 100 from pot
*** SUMMARY ***
Total pot 100 | Rake 0 
Seat 4: Duke Croix (big blind) collected (100)
Seat 6: color_singleton (button) folded before Flop (didn't bet)
Seat 9: Manon541 (small blind) folded before Flop



PokerStars Home Game Hand #217637777642: {Club #3225207}  Hold'em No Limit (50/100) - 2020/08/20 18:51:50 ET
Table 'Manuel Neuer' 9-max (Play Money) Seat #9 is the button
Seat 4: Duke Croix (23188 in chips) 
Seat 6: color_singleton (8911 in chips) 
Seat 9: Manon541 (12009 in chips) 
Duke Croix: posts small blind 50
color_singleton: posts big blind 100
*** HOLE CARDS ***
Dealt to Duke Croix [5s Tc]
Manon541: calls 100
Duke Croix: calls 50
color_singleton: raises 200 to 300
Manon541: calls 200
Duke Croix: folds 
*** FLOP *** [Jh Ts 9h]
color_singleton: bets 330
Manon541: folds 
Uncalled bet (330) returned to color_singleton
color_singleton collected 661 from pot
color_singleton: doesn't show hand 
*** SUMMARY ***
Total pot 700 | Rake 39 
Board [Jh Ts 9h]
Seat 4: Duke Croix (small blind) folded before Flop
Seat 6: color_singleton (big blind) collected (661)
Seat 9: Manon541 (button) folded on the Flop



PokerStars Home Game Hand #217637787573: {Club #3225207}  Hold'em No Limit (50/100) - 2020/08/20 18:52:13 ET
Table 'Manuel Neuer' 9-max (Play Money) Seat #4 is the button
Seat 4: Duke Croix (23088 in chips) 
Seat 6: color_singleton (9272 in chips) 
Seat 9: Manon541 (11709 in chips) 
color_singleton: posts small blind 50
Manon541: posts big blind 100
*** HOLE CARDS ***
Dealt to Duke Croix [2s 8d]
Duke Croix: folds 
color_singleton: raises 100 to 200
Manon541: calls 100
*** FLOP *** [3d 4h 9c]
color_singleton: bets 189
Manon541: folds 
Uncalled bet (189) returned to color_singleton
color_singleton collected 378 from pot
color_singleton: doesn't show hand 
*** SUMMARY ***
Total pot 400 | Rake 22 
Board [3d 4h 9c]
Seat 4: Duke Croix (button) folded before Flop (didn't bet)
Seat 6: color_singleton (small blind) collected (378)
Seat 9: Manon541 (big blind) folded on the Flop



PokerStars Home Game Hand #217637794211: {Club #3225207}  Hold'em No Limit (50/100) - 2020/08/20 18:52:29 ET
Table 'Manuel Neuer' 9-max (Play Money) Seat #6 is the button
Seat 4: Duke Croix (23088 in chips) 
Seat 6: color_singleton (9450 in chips) 
Seat 9: Manon541 (11509 in chips) 
Manon541: posts small blind 50
Duke Croix: posts big blind 100
*** HOLE CARDS ***
Dealt to Duke Croix [Ah Qs]
color_singleton: raises 100 to 200
Manon541: folds 
Duke Croix: raises 400 to 600
color_singleton: calls 400
*** FLOP *** [Kc 9d Ks]
Duke Croix: checks 
color_singleton: bets 590
Duke Croix: folds 
Uncalled bet (590) returned to color_singleton
color_singleton collected 1181 from pot
color_singleton: doesn't show hand 
*** SUMMARY ***
Total pot 1250 | Rake 69 
Board [Kc 9d Ks]
Seat 4: Duke Croix (big blind) folded on the Flop
Seat 6: color_singleton (button) collected (1181)
Seat 9: Manon541 (small blind) folded before Flop



PokerStars Home Game Hand #217637803394: {Club #3225207}  Hold'em No Limit (50/100) - 2020/08/20 18:52:50 ET
Table 'Manuel Neuer' 9-max (Play Money) Seat #9 is the button
Seat 4: Duke Croix (22488 in chips) 
Seat 6: color_singleton (10031 in chips) 
Seat 9: Manon541 (11459 in chips) 
Duke Croix: posts small blind 50
color_singleton: posts big blind 100
*** HOLE CARDS ***
Dealt to Duke Croix [8s Td]
Manon541: calls 100
Duke Croix: calls 50
color_singleton: raises 200 to 300
Manon541: folds 
Duke Croix: calls 200
*** FLOP *** [7s 6d 2s]
Duke Croix: checks 
color_singleton: bets 330
Duke Croix: calls 330
*** TURN *** [7s 6d 2s] [3d]
Duke Croix: checks 
color_singleton: bets 642
Duke Croix: folds 
Uncalled bet (642) returned to color_singleton
color_singleton collected 1285 from pot
color_singleton: doesn't show hand 
*** SUMMARY ***
Total pot 1360 | Rake 75 
Board [7s 6d 2s 3d]
Seat 4: Duke Croix (small blind) folded on the Turn
Seat 6: color_singleton (big blind) collected (1285)
Seat 9: Manon541 (button) folded before Flop



PokerStars Home Game Hand #217637816143: {Club #3225207}  Hold'em No Limit (50/100) - 2020/08/20 18:53:20 ET
Table 'Manuel Neuer' 9-max (Play Money) Seat #4 is the button
Seat 4: Duke Croix (21858 in chips) 
Seat 6: color_singleton (10686 in chips) 
Seat 9: Manon541 (11359 in chips) 
color_singleton: posts small blind 50
Manon541: posts big blind 100
*** HOLE CARDS ***
Dealt to Duke Croix [3d 3s]
Duke Croix: raises 300 to 400
color_singleton: calls 350
Manon541: folds 
*** FLOP *** [4h 7s 5d]
color_singleton: checks 
Duke Croix: bets 500
color_singleton: folds 
Uncalled bet (500) returned to Duke Croix
Duke Croix collected 850 from pot
*** SUMMARY ***
Total pot 900 | Rake 50 
Board [4h 7s 5d]
Seat 4: Duke Croix (button) collected (850)
Seat 6: color_singleton (small blind) folded on the Flop
Seat 9: Manon541 (big blind) folded before Flop



PokerStars Home Game Hand #217637823853: {Club #3225207}  Hold'em No Limit (50/100) - 2020/08/20 18:53:37 ET
Table 'Manuel Neuer' 9-max (Play Money) Seat #6 is the button
Seat 4: Duke Croix (22308 in chips) 
Seat 6: color_singleton (10286 in chips) 
Seat 9: Manon541 (11259 in chips) 
Manon541: posts small blind 50
Duke Croix: posts big blind 100
*** HOLE CARDS ***
Dealt to Duke Croix [9d 6c]
color_singleton: folds 
Manon541: calls 50
Duke Croix: checks 
*** FLOP *** [Qd 6d 2d]
Manon541: checks 
Duke Croix: bets 200
Manon541: calls 200
*** TURN *** [Qd 6d 2d] [Jc]
Manon541: checks 
Duke Croix: bets 500
Manon541: calls 500
*** RIVER *** [Qd 6d 2d Jc] [6h]
Manon541: checks 
Duke Croix: bets 1200
Manon541: folds 
Uncalled bet (1200) returned to Duke Croix
Duke Croix collected 1512 from pot
*** SUMMARY ***
Total pot 1600 | Rake 88 
Board [Qd 6d 2d Jc 6h]
Seat 4: Duke Croix (big blind) collected (1512)
Seat 6: color_singleton (button) folded before Flop (didn't bet)
Seat 9: Manon541 (small blind) folded on the River



PokerStars Home Game Hand #217637837608: {Club #3225207}  Hold'em No Limit (50/100) - 2020/08/20 18:54:09 ET
Table 'Manuel Neuer' 9-max (Play Money) Seat #9 is the button
Seat 4: Duke Croix (23020 in chips) 
Seat 6: color_singleton (10286 in chips) 
Seat 9: Manon541 (10459 in chips) 
Duke Croix: posts small blind 50
color_singleton: posts big blind 100
*** HOLE CARDS ***
Dealt to Duke Croix [Js 5s]
Manon541: folds 
Duke Croix: calls 50
color_singleton: raises 300 to 400
Duke Croix: folds 
Uncalled bet (300) returned to color_singleton
color_singleton collected 200 from pot
color_singleton: doesn't show hand 
*** SUMMARY ***
Total pot 200 | Rake 0 
Seat 4: Duke Croix (small blind) folded before Flop
Seat 6: color_singleton (big blind) collected (200)
Seat 9: Manon541 (button) folded before Flop (didn't bet)



PokerStars Home Game Hand #217637841826: {Club #3225207}  Hold'em No Limit (50/100) - 2020/08/20 18:54:19 ET
Table 'Manuel Neuer' 9-max (Play Money) Seat #4 is the button
Seat 4: Duke Croix (22920 in chips) 
Seat 6: color_singleton (10386 in chips) 
Seat 9: Manon541 (10459 in chips) 
color_singleton: posts small blind 50
Manon541: posts big blind 100
*** HOLE CARDS ***
Dealt to Duke Croix [9c Ts]
Duke Croix: calls 100
color_singleton: raises 200 to 300
Manon541: calls 200
Duke Croix: calls 200
*** FLOP *** [5s Js Kh]
color_singleton: bets 425
Manon541: folds 
Duke Croix: folds 
Uncalled bet (425) returned to color_singleton
color_singleton collected 850 from pot
color_singleton: doesn't show hand 
*** SUMMARY ***
Total pot 900 | Rake 50 
Board [5s Js Kh]
Seat 4: Duke Croix (button) folded on the Flop
Seat 6: color_singleton (small blind) collected (850)
Seat 9: Manon541 (big blind) folded on the Flop



PokerStars Home Game Hand #217637850040: {Club #3225207}  Hold'em No Limit (50/100) - 2020/08/20 18:54:38 ET
Table 'Manuel Neuer' 9-max (Play Money) Seat #6 is the button
Seat 4: Duke Croix (22620 in chips) 
Seat 6: color_singleton (10936 in chips) 
Seat 9: Manon541 (10159 in chips) 
Manon541: posts small blind 50
Duke Croix: posts big blind 100
*** HOLE CARDS ***
Dealt to Duke Croix [Ks As]
color_singleton: folds 
Manon541: calls 50
Duke Croix: raises 400 to 500
Manon541: folds 
Uncalled bet (400) returned to Duke Croix
Duke Croix collected 200 from pot
*** SUMMARY ***
Total pot 200 | Rake 0 
Seat 4: Duke Croix (big blind) collected (200)
Seat 6: color_singleton (button) folded before Flop (didn't bet)
Seat 9: Manon541 (small blind) folded before Flop



PokerStars Home Game Hand #217637855427: {Club #3225207}  Hold'em No Limit (50/100) - 2020/08/20 18:54:50 ET
Table 'Manuel Neuer' 9-max (Play Money) Seat #9 is the button
Seat 4: Duke Croix (22720 in chips) 
Seat 6: color_singleton (10936 in chips) 
Seat 9: Manon541 (10059 in chips) 
Duke Croix: posts small blind 50
color_singleton: posts big blind 100
*** HOLE CARDS ***
Dealt to Duke Croix [Ts Ac]
Manon541: calls 100
Duke Croix: raises 300 to 400
color_singleton: folds 
Manon541: calls 300
*** FLOP *** [3c 4c 4s]
Duke Croix: checks 
Manon541: checks 
*** TURN *** [3c 4c 4s] [8s]
Duke Croix: checks 
Manon541: checks 
*** RIVER *** [3c 4c 4s 8s] [Kd]
Duke Croix: checks 
Manon541: bets 425
Duke Croix: folds 
Uncalled bet (425) returned to Manon541
Manon541 collected 850 from pot
*** SUMMARY ***
Total pot 900 | Rake 50 
Board [3c 4c 4s 8s Kd]
Seat 4: Duke Croix (small blind) folded on the River
Seat 6: color_singleton (big blind) folded before Flop
Seat 9: Manon541 (button) collected (850)



PokerStars Home Game Hand #217637868210: {Club #3225207}  Hold'em No Limit (50/100) - 2020/08/20 18:55:24 ET
Table 'Manuel Neuer' 9-max (Play Money) Seat #4 is the button
Seat 4: Duke Croix (22320 in chips) 
Seat 6: color_singleton (10836 in chips) 
Seat 9: Manon541 (10509 in chips) 
color_singleton: posts small blind 50
Manon541: posts big blind 100
*** HOLE CARDS ***
Dealt to Duke Croix [5h Jh]
Duke Croix: calls 100
color_singleton: calls 50
Manon541: checks 
*** FLOP *** [Ad 6c 7s]
color_singleton: checks 
Manon541: checks 
Duke Croix: checks 
*** TURN *** [Ad 6c 7s] [Js]
color_singleton: checks 
Manon541: checks 
Duke Croix: bets 200
color_singleton: folds 
Manon541: calls 200
*** RIVER *** [Ad 6c 7s Js] [Ah]
Manon541: checks 
Duke Croix: bets 500
Manon541: calls 500
*** SHOW DOWN ***
Duke Croix: shows [5h Jh] (two pair, Aces and Jacks)
Manon541: mucks hand 
Duke Croix collected 1606 from pot
*** SUMMARY ***
Total pot 1700 | Rake 94 
Board [Ad 6c 7s Js Ah]
Seat 4: Duke Croix (button) showed [5h Jh] and won (1606) with two pair, Aces and Jacks
Seat 6: color_singleton (small blind) folded on the Turn
Seat 9: Manon541 (big blind) mucked [2s 7h]



PokerStars Home Game Hand #217637881946: {Club #3225207}  Hold'em No Limit (50/100) - 2020/08/20 18:56:04 ET
Table 'Manuel Neuer' 9-max (Play Money) Seat #6 is the button
Seat 4: Duke Croix (23126 in chips) 
Seat 6: color_singleton (10736 in chips) 
Seat 9: Manon541 (9709 in chips) 
Manon541: posts small blind 50
Duke Croix: posts big blind 100
*** HOLE CARDS ***
Dealt to Duke Croix [Tc 3s]
color_singleton: folds 
Manon541: calls 50
Duke Croix: checks 
*** FLOP *** [9c Kc 7s]
Manon541: bets 100
Duke Croix: folds 
Uncalled bet (100) returned to Manon541
Manon541 collected 189 from pot
*** SUMMARY ***
Total pot 200 | Rake 11 
Board [9c Kc 7s]
Seat 4: Duke Croix (big blind) folded on the Flop
Seat 6: color_singleton (button) folded before Flop (didn't bet)
Seat 9: Manon541 (small blind) collected (189)



PokerStars Home Game Hand #217637887843: {Club #3225207}  Hold'em No Limit (50/100) - 2020/08/20 18:56:20 ET
Table 'Manuel Neuer' 9-max (Play Money) Seat #9 is the button
Seat 4: Duke Croix (23026 in chips) 
Seat 6: color_singleton (10736 in chips) 
Seat 9: Manon541 (9798 in chips) 
Duke Croix: posts small blind 50
color_singleton: posts big blind 100
*** HOLE CARDS ***
Dealt to Duke Croix [Qh 4c]
Manon541: folds 
Duke Croix: calls 50
color_singleton: checks 
*** FLOP *** [2c Td 8s]
Duke Croix: checks 
color_singleton: checks 
*** TURN *** [2c Td 8s] [Qs]
Duke Croix: bets 200
color_singleton: folds 
Uncalled bet (200) returned to Duke Croix
Duke Croix collected 189 from pot
*** SUMMARY ***
Total pot 200 | Rake 11 
Board [2c Td 8s Qs]
Seat 4: Duke Croix (small blind) collected (189)
Seat 6: color_singleton (big blind) folded on the Turn
Seat 9: Manon541 (button) folded before Flop (didn't bet)



PokerStars Home Game Hand #217637893901: {Club #3225207}  Hold'em No Limit (50/100) - 2020/08/20 18:56:38 ET
Table 'Manuel Neuer' 9-max (Play Money) Seat #4 is the button
Seat 4: Duke Croix (23115 in chips) 
Seat 6: color_singleton (10636 in chips) 
Seat 9: Manon541 (9798 in chips) 
color_singleton: posts small blind 50
Manon541: posts big blind 100
*** HOLE CARDS ***
Dealt to Duke Croix [8c 2c]
Duke Croix: folds 
color_singleton: raises 100 to 200
Manon541: calls 100
*** FLOP *** [6s Qh 6d]
color_singleton: bets 189
Manon541: calls 189
*** TURN *** [6s Qh 6d] [Ks]
color_singleton: bets 367
Manon541: folds 
Uncalled bet (367) returned to color_singleton
color_singleton collected 735 from pot
color_singleton: doesn't show hand 
*** SUMMARY ***
Total pot 778 | Rake 43 
Board [6s Qh 6d Ks]
Seat 4: Duke Croix (button) folded before Flop (didn't bet)
Seat 6: color_singleton (small blind) collected (735)
Seat 9: Manon541 (big blind) folded on the Turn



PokerStars Home Game Hand #217637902185: {Club #3225207}  Hold'em No Limit (50/100) - 2020/08/20 18:57:01 ET
Table 'Manuel Neuer' 9-max (Play Money) Seat #6 is the button
Seat 4: Duke Croix (23115 in chips) 
Seat 6: color_singleton (10982 in chips) 
Seat 9: Manon541 (9409 in chips) 
Manon541: posts small blind 50
Duke Croix: posts big blind 100
*** HOLE CARDS ***
Dealt to Duke Croix [Ah 4h]
color_singleton: folds 
Manon541: calls 50
Duke Croix: raises 300 to 400
Manon541: calls 300
*** FLOP *** [7c 9d 8h]
Manon541: checks 
Duke Croix: checks 
*** TURN *** [7c 9d 8h] [Ad]
Manon541: checks 
Duke Croix: bets 400
Manon541: folds 
Uncalled bet (400) returned to Duke Croix
Duke Croix collected 756 from pot
*** SUMMARY ***
Total pot 800 | Rake 44 
Board [7c 9d 8h Ad]
Seat 4: Duke Croix (big blind) collected (756)
Seat 6: color_singleton (button) folded before Flop (didn't bet)
Seat 9: Manon541 (small blind) folded on the Turn



PokerStars Home Game Hand #217637911728: {Club #3225207}  Hold'em No Limit (50/100) - 2020/08/20 18:57:29 ET
Table 'Manuel Neuer' 9-max (Play Money) Seat #9 is the button
Seat 4: Duke Croix (23471 in chips) 
Seat 6: color_singleton (10982 in chips) 
Seat 9: Manon541 (9009 in chips) 
Duke Croix: posts small blind 50
color_singleton: posts big blind 100
*** HOLE CARDS ***
Dealt to Duke Croix [2h 4s]
Manon541: calls 100
Duke Croix: calls 50
color_singleton: checks 
*** FLOP *** [As Kc 3c]
Duke Croix: checks 
color_singleton: bets 141
Manon541: raises 141 to 282
Duke Croix: calls 282
color_singleton: calls 141
*** TURN *** [As Kc 3c] [Kh]
Duke Croix: checks 
color_singleton: checks 
Manon541: bets 541
Duke Croix: folds 
color_singleton: folds 
Uncalled bet (541) returned to Manon541
Manon541 collected 1083 from pot
*** SUMMARY ***
Total pot 1146 | Rake 63 
Board [As Kc 3c Kh]
Seat 4: Duke Croix (small blind) folded on the Turn
Seat 6: color_singleton (big blind) folded on the Turn
Seat 9: Manon541 (button) collected (1083)



PokerStars Home Game Hand #217637924851: {Club #3225207}  Hold'em No Limit (50/100) - 2020/08/20 18:58:06 ET
Table 'Manuel Neuer' 9-max (Play Money) Seat #4 is the button
Seat 4: Duke Croix (23089 in chips) 
Seat 6: color_singleton (10600 in chips) 
Seat 9: Manon541 (9710 in chips) 
color_singleton: posts small blind 50
Manon541: posts big blind 100
*** HOLE CARDS ***
Dealt to Duke Croix [Qc 9h]
Duke Croix: folds 
color_singleton has timed out
color_singleton: folds 
Uncalled bet (50) returned to Manon541
Manon541 collected 100 from pot
*** SUMMARY ***
Total pot 100 | Rake 0 
Seat 4: Duke Croix (button) folded before Flop (didn't bet)
Seat 6: color_singleton (small blind) folded before Flop
Seat 9: Manon541 (big blind) collected (100)



PokerStars Home Game Hand #217637972566: {Club #3225207}  Hold'em No Limit (50/100) - 2020/08/20 19:00:22 ET
Table 'Manuel Neuer' 9-max (Play Money) Seat #6 is the button
Seat 4: Duke Croix (23089 in chips) 
Seat 6: color_singleton (10550 in chips) 
color_singleton: posts small blind 50
Duke Croix: posts big blind 100
*** HOLE CARDS ***
Dealt to Duke Croix [Qc 8h]
color_singleton: raises 200 to 300
Duke Croix: calls 200
*** FLOP *** [6h Kd Kc]
Duke Croix: checks 
color_singleton: checks 
*** TURN *** [6h Kd Kc] [6d]
Duke Croix: bets 300
color_singleton: folds 
Uncalled bet (300) returned to Duke Croix
Duke Croix collected 567 from pot
*** SUMMARY ***
Total pot 600 | Rake 33 
Board [6h Kd Kc 6d]
Seat 4: Duke Croix (big blind) collected (567)
Seat 6: color_singleton (button) (small blind) folded on the Turn



PokerStars Home Game Hand #217637982703: {Club #3225207}  Hold'em No Limit (50/100) - 2020/08/20 19:00:49 ET
Table 'Manuel Neuer' 9-max (Play Money) Seat #4 is the button
Seat 4: Duke Croix (23356 in chips) 
Seat 6: color_singleton (10250 in chips) 
Duke Croix: posts small blind 50
color_singleton: posts big blind 100
*** HOLE CARDS ***
Dealt to Duke Croix [5d Kd]
Duke Croix: calls 50
color_singleton: raises 100 to 200
Duke Croix: calls 100
*** FLOP *** [3d Jh 5s]
color_singleton: checks 
Duke Croix: bets 200
color_singleton: folds 
Uncalled bet (200) returned to Duke Croix
Duke Croix collected 378 from pot
*** SUMMARY ***
Total pot 400 | Rake 22 
Board [3d Jh 5s]
Seat 4: Duke Croix (button) (small blind) collected (378)
Seat 6: color_singleton (big blind) folded on the Flop



PokerStars Home Game Hand #217637990128: {Club #3225207}  Hold'em No Limit (50/100) - 2020/08/20 19:01:08 ET
Table 'Manuel Neuer' 9-max (Play Money) Seat #4 is the button
Seat 4: Duke Croix (23534 in chips) 
Seat 6: color_singleton (10050 in chips) 
Seat 9: Manon541 (9760 in chips) 
color_singleton: posts small blind 50
Manon541: posts big blind 100
*** HOLE CARDS ***
Dealt to Duke Croix [6s 3h]
Duke Croix: folds 
color_singleton: raises 200 to 300
Manon541 has timed out
Manon541: folds 
Uncalled bet (200) returned to color_singleton
color_singleton collected 200 from pot
color_singleton: doesn't show hand 
*** SUMMARY ***
Total pot 200 | Rake 0 
Seat 4: Duke Croix (button) folded before Flop (didn't bet)
Seat 6: color_singleton (small blind) collected (200)
Seat 9: Manon541 (big blind) folded before Flop



PokerStars Home Game Hand #217638001662: {Club #3225207}  Hold'em No Limit (50/100) - 2020/08/20 19:01:36 ET
Table 'Manuel Neuer' 9-max (Play Money) Seat #6 is the button
Seat 4: Duke Croix (23534 in chips) 
Seat 6: color_singleton (10150 in chips) 
color_singleton: posts small blind 50
Duke Croix: posts big blind 100
*** HOLE CARDS ***
Dealt to Duke Croix [Jd 2h]
color_singleton: folds 
Uncalled bet (50) returned to Duke Croix
Duke Croix collected 100 from pot
*** SUMMARY ***
Total pot 100 | Rake 0 
Seat 4: Duke Croix (big blind) collected (100)
Seat 6: color_singleton (button) (small blind) folded before Flop



PokerStars Home Game Hand #217638004216: {Club #3225207}  Hold'em No Limit (50/100) - 2020/08/20 19:01:41 ET
Table 'Manuel Neuer' 9-max (Play Money) Seat #4 is the button
Seat 4: Duke Croix (23584 in chips) 
Seat 6: color_singleton (10100 in chips) 
Seat 9: Manon541 (9660 in chips) 
color_singleton: posts small blind 50
Manon541: posts big blind 100
*** HOLE CARDS ***
Dealt to Duke Croix [2d Kh]
Duke Croix: folds 
color_singleton: raises 100 to 200
Manon541: calls 100
*** FLOP *** [Ks 4d 3s]
color_singleton: checks 
Manon541: checks 
*** TURN *** [Ks 4d 3s] [2c]
color_singleton: checks 
Manon541: checks 
*** RIVER *** [Ks 4d 3s 2c] [Td]
color_singleton: checks 
Manon541: checks 
*** SHOW DOWN ***
color_singleton: shows [Jd As] (high card Ace)
Manon541: mucks hand 
color_singleton collected 378 from pot
*** SUMMARY ***
Total pot 400 | Rake 22 
Board [Ks 4d 3s 2c Td]
Seat 4: Duke Croix (button) folded before Flop (didn't bet)
Seat 6: color_singleton (small blind) showed [Jd As] and won (378) with high card Ace
Seat 9: Manon541 (big blind) mucked [Jc 8s]



PokerStars Home Game Hand #217638016001: {Club #3225207}  Hold'em No Limit (50/100) - 2020/08/20 19:02:09 ET
Table 'Manuel Neuer' 9-max (Play Money) Seat #6 is the button
Seat 4: Duke Croix (23584 in chips) 
Seat 6: color_singleton (10278 in chips) 
Seat 9: Manon541 (9460 in chips) 
Manon541: posts small blind 50
Duke Croix: posts big blind 100
*** HOLE CARDS ***
Dealt to Duke Croix [9d 7h]
color_singleton: folds 
Manon541: folds 
Uncalled bet (50) returned to Duke Croix
Duke Croix collected 100 from pot
*** SUMMARY ***
Total pot 100 | Rake 0 
Seat 4: Duke Croix (big blind) collected (100)
Seat 6: color_singleton (button) folded before Flop (didn't bet)
Seat 9: Manon541 (small blind) folded before Flop



PokerStars Home Game Hand #217638020622: {Club #3225207}  Hold'em No Limit (50/100) - 2020/08/20 19:02:20 ET
Table 'Manuel Neuer' 9-max (Play Money) Seat #9 is the button
Seat 4: Duke Croix (23634 in chips) 
Seat 6: color_singleton (10278 in chips) 
Seat 9: Manon541 (9410 in chips) 
Duke Croix: posts small blind 50
color_singleton: posts big blind 100
*** HOLE CARDS ***
Dealt to Duke Croix [Qc As]
Manon541: calls 100
Duke Croix: raises 300 to 400
color_singleton: folds 
Manon541: calls 300
*** FLOP *** [2s 9s Jc]
Duke Croix: checks 
Manon541: checks 
*** TURN *** [2s 9s Jc] [5c]
Duke Croix: bets 500
Manon541: calls 500
*** RIVER *** [2s 9s Jc 5c] [7s]
Duke Croix: bets 1000
Manon541: folds 
Uncalled bet (1000) returned to Duke Croix
Duke Croix collected 1795 from pot
*** SUMMARY ***
Total pot 1900 | Rake 105 
Board [2s 9s Jc 5c 7s]
Seat 4: Duke Croix (small blind) collected (1795)
Seat 6: color_singleton (big blind) folded before Flop
Seat 9: Manon541 (button) folded on the River



PokerStars Home Game Hand #217638032993: {Club #3225207}  Hold'em No Limit (50/100) - 2020/08/20 19:02:50 ET
Table 'Manuel Neuer' 9-max (Play Money) Seat #4 is the button
Seat 4: Duke Croix (24529 in chips) 
Seat 6: color_singleton (10178 in chips) 
Seat 9: Manon541 (8510 in chips) 
color_singleton: posts small blind 50
Manon541: posts big blind 100
*** HOLE CARDS ***
Dealt to Duke Croix [Kh Qh]
Duke Croix: raises 300 to 400
color_singleton: folds 
Manon541: folds 
Uncalled bet (300) returned to Duke Croix
Duke Croix collected 250 from pot
*** SUMMARY ***
Total pot 250 | Rake 0 
Seat 4: Duke Croix (button) collected (250)
Seat 6: color_singleton (small blind) folded before Flop
Seat 9: Manon541 (big blind) folded before Flop



PokerStars Home Game Hand #217638036565: {Club #3225207}  Hold'em No Limit (50/100) - 2020/08/20 19:02:59 ET
Table 'Manuel Neuer' 9-max (Play Money) Seat #6 is the button
Seat 4: Duke Croix (24679 in chips) 
Seat 6: color_singleton (10128 in chips) 
Seat 9: Manon541 (8410 in chips) 
Manon541: posts small blind 50
Duke Croix: posts big blind 100
*** HOLE CARDS ***
Dealt to Duke Croix [Th 8h]
color_singleton: folds 
Manon541: calls 50
Duke Croix: raises 300 to 400
Manon541: calls 300
*** FLOP *** [9c 8c 7s]
Manon541: checks 
Duke Croix: bets 400
Manon541: calls 400
*** TURN *** [9c 8c 7s] [Ac]
Manon541: bets 756
Duke Croix: folds 
Uncalled bet (756) returned to Manon541
Manon541 collected 1512 from pot
*** SUMMARY ***
Total pot 1600 | Rake 88 
Board [9c 8c 7s Ac]
Seat 4: Duke Croix (big blind) folded on the Turn
Seat 6: color_singleton (button) folded before Flop (didn't bet)
Seat 9: Manon541 (small blind) collected (1512)



PokerStars Home Game Hand #217638055886: {Club #3225207}  Hold'em No Limit (50/100) - 2020/08/20 19:03:44 ET
Table 'Manuel Neuer' 9-max (Play Money) Seat #9 is the button
Seat 4: Duke Croix (23879 in chips) 
Seat 6: color_singleton (10128 in chips) 
Seat 9: Manon541 (9122 in chips) 
Duke Croix: posts small blind 50
color_singleton: posts big blind 100
*** HOLE CARDS ***
Dealt to Duke Croix [Js 2c]
Manon541: calls 100
Duke Croix: calls 50
color_singleton: checks 
*** FLOP *** [5d 3s 9s]
Duke Croix: checks 
color_singleton: checks 
Manon541: checks 
*** TURN *** [5d 3s 9s] [9c]
Duke Croix: checks 
color_singleton: checks 
Manon541: checks 
*** RIVER *** [5d 3s 9s 9c] [9d]
Duke Croix: checks 
color_singleton: checks 
Manon541: checks 
*** SHOW DOWN ***
Duke Croix: shows [Js 2c] (three of a kind, Nines)
color_singleton: shows [8d Qd] (three of a kind, Nines - Queen kicker)
Manon541: shows [4h Ad] (three of a kind, Nines - Ace kicker)
Manon541 collected 283 from pot
*** SUMMARY ***
Total pot 300 | Rake 17 
Board [5d 3s 9s 9c 9d]
Seat 4: Duke Croix (small blind) showed [Js 2c] and lost with three of a kind, Nines
Seat 6: color_singleton (big blind) showed [8d Qd] and lost with three of a kind, Nines
Seat 9: Manon541 (button) showed [4h Ad] and won (283) with three of a kind, Nines



PokerStars Home Game Hand #217638065869: {Club #3225207}  Hold'em No Limit (50/100) - 2020/08/20 19:04:08 ET
Table 'Manuel Neuer' 9-max (Play Money) Seat #4 is the button
Seat 4: Duke Croix (23779 in chips) 
Seat 6: color_singleton (10028 in chips) 
Seat 9: Manon541 (9305 in chips) 
color_singleton: posts small blind 50
Manon541: posts big blind 100
*** HOLE CARDS ***
Dealt to Duke Croix [3d 9c]
Duke Croix: folds 
color_singleton: folds 
Uncalled bet (50) returned to Manon541
Manon541 collected 100 from pot
*** SUMMARY ***
Total pot 100 | Rake 0 
Seat 4: Duke Croix (button) folded before Flop (didn't bet)
Seat 6: color_singleton (small blind) folded before Flop
Seat 9: Manon541 (big blind) collected (100)



PokerStars Home Game Hand #217638068453: {Club #3225207}  Hold'em No Limit (50/100) - 2020/08/20 19:04:14 ET
Table 'Manuel Neuer' 9-max (Play Money) Seat #6 is the button
Seat 4: Duke Croix (23779 in chips) 
Seat 6: color_singleton (9978 in chips) 
Seat 9: Manon541 (9355 in chips) 
Manon541: posts small blind 50
Duke Croix: posts big blind 100
*** HOLE CARDS ***
Dealt to Duke Croix [Jh Js]
color_singleton: folds 
Manon541: calls 50
Duke Croix: raises 300 to 400
Manon541: calls 300
*** FLOP *** [9d Tc 6c]
Manon541: checks 
Duke Croix: bets 400
Manon541: folds 
Uncalled bet (400) returned to Duke Croix
Duke Croix collected 756 from pot
*** SUMMARY ***
Total pot 800 | Rake 44 
Board [9d Tc 6c]
Seat 4: Duke Croix (big blind) collected (756)
Seat 6: color_singleton (button) folded before Flop (didn't bet)
Seat 9: Manon541 (small blind) folded on the Flop



PokerStars Home Game Hand #217638076190: {Club #3225207}  Hold'em No Limit (50/100) - 2020/08/20 19:04:33 ET
Table 'Manuel Neuer' 9-max (Play Money) Seat #9 is the button
Seat 4: Duke Croix (24135 in chips) 
Seat 6: color_singleton (9978 in chips) 
Seat 9: Manon541 (8955 in chips) 
Duke Croix: posts small blind 50
color_singleton: posts big blind 100
*** HOLE CARDS ***
Dealt to Duke Croix [7s Ts]
Manon541: calls 100
Duke Croix: calls 50
color_singleton: raises 200 to 300
Manon541: calls 200
Duke Croix: calls 200
*** FLOP *** [5c 4d 9d]
Duke Croix: checks 
color_singleton: checks 
Manon541: checks 
*** TURN *** [5c 4d 9d] [5s]
Duke Croix: checks 
color_singleton: checks 
Manon541: checks 
*** RIVER *** [5c 4d 9d 5s] [2c]
Duke Croix: checks 
color_singleton: bets 850
Manon541: calls 850
Duke Croix: folds 
*** SHOW DOWN ***
color_singleton: shows [9h 9s] (a full house, Nines full of Fives)
Manon541: mucks hand 
color_singleton collected 2457 from pot
*** SUMMARY ***
Total pot 2600 | Rake 143 
Board [5c 4d 9d 5s 2c]
Seat 4: Duke Croix (small blind) folded on the River
Seat 6: color_singleton (big blind) showed [9h 9s] and won (2457) with a full house, Nines full of Fives
Seat 9: Manon541 (button) mucked [4s Qh]



PokerStars Home Game Hand #217638088646: {Club #3225207}  Hold'em No Limit (50/100) - 2020/08/20 19:05:02 ET
Table 'Manuel Neuer' 9-max (Play Money) Seat #4 is the button
Seat 4: Duke Croix (23835 in chips) 
Seat 6: color_singleton (11285 in chips) 
Seat 9: Manon541 (7805 in chips) 
color_singleton: posts small blind 50
Manon541: posts big blind 100
*** HOLE CARDS ***
Dealt to Duke Croix [7d 4c]
Duke Croix: folds 
color_singleton: folds 
Uncalled bet (50) returned to Manon541
Manon541 collected 100 from pot
*** SUMMARY ***
Total pot 100 | Rake 0 
Seat 4: Duke Croix (button) folded before Flop (didn't bet)
Seat 6: color_singleton (small blind) folded before Flop
Seat 9: Manon541 (big blind) collected (100)



PokerStars Home Game Hand #217638091564: {Club #3225207}  Hold'em No Limit (50/100) - 2020/08/20 19:05:09 ET
Table 'Manuel Neuer' 9-max (Play Money) Seat #6 is the button
Seat 4: Duke Croix (23835 in chips) 
Seat 6: color_singleton (11235 in chips) 
Seat 9: Manon541 (7855 in chips) 
Manon541: posts small blind 50
Duke Croix: posts big blind 100
*** HOLE CARDS ***
Dealt to Duke Croix [As 4c]
color_singleton: folds 
Manon541: folds 
Uncalled bet (50) returned to Duke Croix
Duke Croix collected 100 from pot
*** SUMMARY ***
Total pot 100 | Rake 0 
Seat 4: Duke Croix (big blind) collected (100)
Seat 6: color_singleton (button) folded before Flop (didn't bet)
Seat 9: Manon541 (small blind) folded before Flop



PokerStars Home Game Hand #217638094237: {Club #3225207}  Hold'em No Limit (50/100) - 2020/08/20 19:05:15 ET
Table 'Manuel Neuer' 9-max (Play Money) Seat #9 is the button
Seat 4: Duke Croix (23885 in chips) 
Seat 6: color_singleton (11235 in chips) 
Seat 9: Manon541 (7805 in chips) 
Duke Croix: posts small blind 50
color_singleton: posts big blind 100
*** HOLE CARDS ***
Dealt to Duke Croix [4c Kd]
Manon541: calls 100
Duke Croix: calls 50
color_singleton: checks 
*** FLOP *** [3s 6s 5h]
Duke Croix: bets 200
color_singleton: calls 200
Manon541: folds 
*** TURN *** [3s 6s 5h] [Ac]
Duke Croix: checks 
color_singleton: checks 
*** RIVER *** [3s 6s 5h Ac] [6h]
Duke Croix: checks 
color_singleton: bets 330
Duke Croix: folds 
Uncalled bet (330) returned to color_singleton
color_singleton collected 661 from pot
color_singleton: doesn't show hand 
*** SUMMARY ***
Total pot 700 | Rake 39 
Board [3s 6s 5h Ac 6h]
Seat 4: Duke Croix (small blind) folded on the River
Seat 6: color_singleton (big blind) collected (661)
Seat 9: Manon541 (button) folded on the Flop



PokerStars Home Game Hand #217638107973: {Club #3225207}  Hold'em No Limit (50/100) - 2020/08/20 19:05:47 ET
Table 'Manuel Neuer' 9-max (Play Money) Seat #4 is the button
Seat 4: Duke Croix (23585 in chips) 
Seat 6: color_singleton (11596 in chips) 
Seat 9: Manon541 (7705 in chips) 
color_singleton: posts small blind 50
Manon541: posts big blind 100
*** HOLE CARDS ***
Dealt to Duke Croix [Qc 3s]
Duke Croix: folds 
color_singleton: calls 50
Manon541: checks 
*** FLOP *** [As Ts Qs]
color_singleton: checks 
Manon541: checks 
*** TURN *** [As Ts Qs] [9h]
color_singleton: checks 
Manon541: checks 
*** RIVER *** [As Ts Qs 9h] [4s]
color_singleton: checks 
Manon541: checks 
*** SHOW DOWN ***
color_singleton: shows [7s 4d] (a flush, Ace high)
Manon541: mucks hand 
color_singleton collected 189 from pot
*** SUMMARY ***
Total pot 200 | Rake 11 
Board [As Ts Qs 9h 4s]
Seat 4: Duke Croix (button) folded before Flop (didn't bet)
Seat 6: color_singleton (small blind) showed [7s 4d] and won (189) with a flush, Ace high
Seat 9: Manon541 (big blind) mucked [7h 3c]



PokerStars Home Game Hand #217638117443: {Club #3225207}  Hold'em No Limit (50/100) - 2020/08/20 19:06:10 ET
Table 'Manuel Neuer' 9-max (Play Money) Seat #6 is the button
Seat 4: Duke Croix (23585 in chips) 
Seat 6: color_singleton (11685 in chips) 
Seat 9: Manon541 (7605 in chips) 
Manon541: posts small blind 50
Duke Croix: posts big blind 100
*** HOLE CARDS ***
Dealt to Duke Croix [Th 7h]
color_singleton: folds 
Manon541: folds 
Uncalled bet (50) returned to Duke Croix
Duke Croix collected 100 from pot
*** SUMMARY ***
Total pot 100 | Rake 0 
Seat 4: Duke Croix (big blind) collected (100)
Seat 6: color_singleton (button) folded before Flop (didn't bet)
Seat 9: Manon541 (small blind) folded before Flop



PokerStars Home Game Hand #217638120498: {Club #3225207}  Hold'em No Limit (50/100) - 2020/08/20 19:06:17 ET
Table 'Manuel Neuer' 9-max (Play Money) Seat #9 is the button
Seat 4: Duke Croix (23635 in chips) 
Seat 6: color_singleton (11685 in chips) 
Seat 9: Manon541 (7555 in chips) 
Duke Croix: posts small blind 50
color_singleton: posts big blind 100
*** HOLE CARDS ***
Dealt to Duke Croix [Jh Ks]
Manon541: calls 100
Duke Croix: raises 300 to 400
color_singleton: calls 300
Manon541: calls 300
*** FLOP *** [6h Kc As]
Duke Croix: checks 
color_singleton: checks 
Manon541: checks 
*** TURN *** [6h Kc As] [5c]
Duke Croix: bets 600
color_singleton: calls 600
Manon541: calls 600
*** RIVER *** [6h Kc As 5c] [6c]
Duke Croix: checks 
color_singleton: checks 
Manon541: bets 1417
Duke Croix: folds 
color_singleton: folds 
Uncalled bet (1417) returned to Manon541
Manon541 collected 2835 from pot
*** SUMMARY ***
Total pot 3000 | Rake 165 
Board [6h Kc As 5c 6c]
Seat 4: Duke Croix (small blind) folded on the River
Seat 6: color_singleton (big blind) folded on the River
Seat 9: Manon541 (button) collected (2835)



PokerStars Home Game Hand #217638140205: {Club #3225207}  Hold'em No Limit (50/100) - 2020/08/20 19:07:04 ET
Table 'Manuel Neuer' 9-max (Play Money) Seat #4 is the button
Seat 4: Duke Croix (22635 in chips) 
Seat 6: color_singleton (10685 in chips) 
Seat 9: Manon541 (9390 in chips) 
color_singleton: posts small blind 50
Manon541: posts big blind 100
*** HOLE CARDS ***
Dealt to Duke Croix [3s 5c]
Duke Croix: folds 
color_singleton: raises 200 to 300
Manon541: calls 200
*** FLOP *** [Kh 3h 9s]
color_singleton: checks 
Manon541: checks 
*** TURN *** [Kh 3h 9s] [Qh]
color_singleton: checks 
Manon541: bets 283
color_singleton: calls 283
*** RIVER *** [Kh 3h 9s Qh] [3c]
color_singleton: checks 
Manon541: bets 551
color_singleton: folds 
Uncalled bet (551) returned to Manon541
Manon541 collected 1102 from pot
*** SUMMARY ***
Total pot 1166 | Rake 64 
Board [Kh 3h 9s Qh 3c]
Seat 4: Duke Croix (button) folded before Flop (didn't bet)
Seat 6: color_singleton (small blind) folded on the River
Seat 9: Manon541 (big blind) collected (1102)



PokerStars Home Game Hand #217638151168: {Club #3225207}  Hold'em No Limit (50/100) - 2020/08/20 19:07:31 ET
Table 'Manuel Neuer' 9-max (Play Money) Seat #6 is the button
Seat 4: Duke Croix (22635 in chips) 
Seat 6: color_singleton (10102 in chips) 
Seat 9: Manon541 (9909 in chips) 
Manon541: posts small blind 50
Duke Croix: posts big blind 100
*** HOLE CARDS ***
Dealt to Duke Croix [Qh 3h]
color_singleton: folds 
Manon541: calls 50
Duke Croix: checks 
*** FLOP *** [7s 4s 4h]
Manon541: checks 
Duke Croix: checks 
*** TURN *** [7s 4s 4h] [2h]
Manon541: checks 
Duke Croix: checks 
*** RIVER *** [7s 4s 4h 2h] [2c]
Manon541: checks 
Duke Croix: checks 
*** SHOW DOWN ***
Manon541: shows [Jd 9s] (two pair, Fours and Deuces)
Duke Croix: shows [Qh 3h] (two pair, Fours and Deuces - Queen kicker)
Duke Croix collected 189 from pot
*** SUMMARY ***
Total pot 200 | Rake 11 
Board [7s 4s 4h 2h 2c]
Seat 4: Duke Croix (big blind) showed [Qh 3h] and won (189) with two pair, Fours and Deuces
Seat 6: color_singleton (button) folded before Flop (didn't bet)
Seat 9: Manon541 (small blind) showed [Jd 9s] and lost with two pair, Fours and Deuces



PokerStars Home Game Hand #217638160981: {Club #3225207}  Hold'em No Limit (50/100) - 2020/08/20 19:07:54 ET
Table 'Manuel Neuer' 9-max (Play Money) Seat #9 is the button
Seat 4: Duke Croix (22724 in chips) 
Seat 6: color_singleton (10102 in chips) 
Seat 9: Manon541 (9809 in chips) 
Duke Croix: posts small blind 50
color_singleton: posts big blind 100
*** HOLE CARDS ***
Dealt to Duke Croix [6h 4s]
Manon541: calls 100
Duke Croix: calls 50
color_singleton: checks 
*** FLOP *** [Ks 6s 7h]
Duke Croix: checks 
color_singleton: checks 
Manon541: checks 
*** TURN *** [Ks 6s 7h] [2s]
Duke Croix: bets 141
color_singleton: calls 141
Manon541: calls 141
*** RIVER *** [Ks 6s 7h 2s] [9h]
Duke Croix: checks 
color_singleton: checks 
Manon541: checks 
*** SHOW DOWN ***
Duke Croix: shows [6h 4s] (a pair of Sixes)
color_singleton: shows [5h 7d] (a pair of Sevens)
Manon541: shows [Ts Td] (a pair of Tens)
Manon541 collected 683 from pot
*** SUMMARY ***
Total pot 723 | Rake 40 
Board [Ks 6s 7h 2s 9h]
Seat 4: Duke Croix (small blind) showed [6h 4s] and lost with a pair of Sixes
Seat 6: color_singleton (big blind) showed [5h 7d] and lost with a pair of Sevens
Seat 9: Manon541 (button) showed [Ts Td] and won (683) with a pair of Tens



PokerStars Home Game Hand #217638172097: {Club #3225207}  Hold'em No Limit (50/100) - 2020/08/20 19:08:21 ET
Table 'Manuel Neuer' 9-max (Play Money) Seat #4 is the button
Seat 4: Duke Croix (22483 in chips) 
Seat 6: color_singleton (9861 in chips) 
Seat 9: Manon541 (10251 in chips) 
color_singleton: posts small blind 50
Manon541: posts big blind 100
*** HOLE CARDS ***
Dealt to Duke Croix [Jh 9s]
Duke Croix: raises 200 to 300
color_singleton: folds 
Manon541: calls 200
*** FLOP *** [Ac 8d 4h]
Manon541: checks 
Duke Croix: checks 
*** TURN *** [Ac 8d 4h] [6h]
Manon541: checks 
Duke Croix: checks 
*** RIVER *** [Ac 8d 4h 6h] [9c]
Manon541: bets 307
Duke Croix: calls 307
*** SHOW DOWN ***
Manon541: shows [4c 5c] (a pair of Fours)
Duke Croix: shows [Jh 9s] (a pair of Nines)
Duke Croix collected 1194 from pot
*** SUMMARY ***
Total pot 1264 | Rake 70 
Board [Ac 8d 4h 6h 9c]
Seat 4: Duke Croix (button) showed [Jh 9s] and won (1194) with a pair of Nines
Seat 6: color_singleton (small blind) folded before Flop
Seat 9: Manon541 (big blind) showed [4c 5c] and lost with a pair of Fours



PokerStars Home Game Hand #217638181164: {Club #3225207}  Hold'em No Limit (50/100) - 2020/08/20 19:08:43 ET
Table 'Manuel Neuer' 9-max (Play Money) Seat #6 is the button
Seat 4: Duke Croix (23070 in chips) 
Seat 6: color_singleton (9811 in chips) 
Seat 9: Manon541 (9644 in chips) 
Manon541: posts small blind 50
Duke Croix: posts big blind 100
*** HOLE CARDS ***
Dealt to Duke Croix [7s 6d]
color_singleton: folds 
Manon541: calls 50
Duke Croix: checks 
*** FLOP *** [8s 5h 3s]
Manon541: checks 
Duke Croix: bets 200
Manon541: calls 200
*** TURN *** [8s 5h 3s] [4d]
Manon541: checks 
Duke Croix: bets 400
Manon541: folds 
Uncalled bet (400) returned to Duke Croix
Duke Croix collected 567 from pot
*** SUMMARY ***
Total pot 600 | Rake 33 
Board [8s 5h 3s 4d]
Seat 4: Duke Croix (big blind) collected (567)
Seat 6: color_singleton (button) folded before Flop (didn't bet)
Seat 9: Manon541 (small blind) folded on the Turn



PokerStars Home Game Hand #217638192913: {Club #3225207}  Hold'em No Limit (50/100) - 2020/08/20 19:09:11 ET
Table 'Manuel Neuer' 9-max (Play Money) Seat #9 is the button
Seat 4: Duke Croix (23337 in chips) 
Seat 6: color_singleton (9811 in chips) 
Seat 9: Manon541 (9344 in chips) 
Duke Croix: posts small blind 50
color_singleton: posts big blind 100
*** HOLE CARDS ***
Dealt to Duke Croix [Td Kd]
Manon541: calls 100
Duke Croix: raises 300 to 400
color_singleton: folds 
Manon541: calls 300
*** FLOP *** [Kc 4c 6s]
Duke Croix: bets 500
Manon541: folds 
Uncalled bet (500) returned to Duke Croix
Duke Croix collected 850 from pot
*** SUMMARY ***
Total pot 900 | Rake 50 
Board [Kc 4c 6s]
Seat 4: Duke Croix (small blind) collected (850)
Seat 6: color_singleton (big blind) folded before Flop
Seat 9: Manon541 (button) folded on the Flop



PokerStars Home Game Hand #217638201939: {Club #3225207}  Hold'em No Limit (50/100) - 2020/08/20 19:09:33 ET
Table 'Manuel Neuer' 9-max (Play Money) Seat #4 is the button
Seat 4: Duke Croix (23787 in chips) 
Seat 6: color_singleton (9711 in chips) 
Seat 9: Manon541 (8944 in chips) 
color_singleton: posts small blind 50
Manon541: posts big blind 100
*** HOLE CARDS ***
Dealt to Duke Croix [6h 9s]
Duke Croix: folds 
color_singleton: raises 100 to 200
Manon541: folds 
Uncalled bet (100) returned to color_singleton
color_singleton collected 200 from pot
color_singleton: doesn't show hand 
*** SUMMARY ***
Total pot 200 | Rake 0 
Seat 4: Duke Croix (button) folded before Flop (didn't bet)
Seat 6: color_singleton (small blind) collected (200)
Seat 9: Manon541 (big blind) folded before Flop



PokerStars Home Game Hand #217638204699: {Club #3225207}  Hold'em No Limit (50/100) - 2020/08/20 19:09:39 ET
Table 'Manuel Neuer' 9-max (Play Money) Seat #6 is the button
Seat 4: Duke Croix (23787 in chips) 
Seat 6: color_singleton (9811 in chips) 
Seat 9: Manon541 (8844 in chips) 
Manon541: posts small blind 50
Duke Croix: posts big blind 100
*** HOLE CARDS ***
Dealt to Duke Croix [Jd 6c]
color_singleton: folds 
Manon541: calls 50
Duke Croix: checks 
*** FLOP *** [6h Qd Qs]
Manon541: checks 
Duke Croix: bets 200
Manon541: calls 200
*** TURN *** [6h Qd Qs] [Td]
Manon541: checks 
Duke Croix: bets 400
Manon541: folds 
Uncalled bet (400) returned to Duke Croix
Duke Croix collected 567 from pot
*** SUMMARY ***
Total pot 600 | Rake 33 
Board [6h Qd Qs Td]
Seat 4: Duke Croix (big blind) collected (567)
Seat 6: color_singleton (button) folded before Flop (didn't bet)
Seat 9: Manon541 (small blind) folded on the Turn



PokerStars Home Game Hand #217638215205: {Club #3225207}  Hold'em No Limit (50/100) - 2020/08/20 19:10:04 ET
Table 'Manuel Neuer' 9-max (Play Money) Seat #9 is the button
Seat 4: Duke Croix (24054 in chips) 
Seat 6: color_singleton (9811 in chips) 
Seat 9: Manon541 (8544 in chips) 
Duke Croix: posts small blind 50
color_singleton: posts big blind 100
*** HOLE CARDS ***
Dealt to Duke Croix [6c Jh]
Manon541: calls 100
Duke Croix: calls 50
color_singleton: checks 
*** FLOP *** [2d 3d 9d]
Duke Croix: checks 
color_singleton: checks 
Manon541: bets 141
Duke Croix: folds 
color_singleton: calls 141
*** TURN *** [2d 3d 9d] [Kd]
color_singleton: checks 
Manon541: checks 
*** RIVER *** [2d 3d 9d Kd] [Ks]
color_singleton: checks 
Manon541: bets 550
color_singleton: calls 550
*** SHOW DOWN ***
Manon541: shows [9s 5s] (two pair, Kings and Nines)
color_singleton: shows [8d Qs] (a flush, King high)
color_singleton collected 1589 from pot
*** SUMMARY ***
Total pot 1682 | Rake 93 
Board [2d 3d 9d Kd Ks]
Seat 4: Duke Croix (small blind) folded on the Flop
Seat 6: color_singleton (big blind) showed [8d Qs] and won (1589) with a flush, King high
Seat 9: Manon541 (button) showed [9s 5s] and lost with two pair, Kings and Nines



PokerStars Home Game Hand #217638232968: {Club #3225207}  Hold'em No Limit (50/100) - 2020/08/20 19:10:47 ET
Table 'Manuel Neuer' 9-max (Play Money) Seat #4 is the button
Seat 4: Duke Croix (23954 in chips) 
Seat 6: color_singleton (10609 in chips) 
Seat 9: Manon541 (7753 in chips) 
color_singleton: posts small blind 50
Manon541: posts big blind 100
*** HOLE CARDS ***
Dealt to Duke Croix [Td Ks]
Duke Croix: raises 300 to 400
color_singleton: folds 
Manon541: folds 
Uncalled bet (300) returned to Duke Croix
Duke Croix collected 250 from pot
*** SUMMARY ***
Total pot 250 | Rake 0 
Seat 4: Duke Croix (button) collected (250)
Seat 6: color_singleton (small blind) folded before Flop
Seat 9: Manon541 (big blind) folded before Flop



PokerStars Home Game Hand #217638237947: {Club #3225207}  Hold'em No Limit (50/100) - 2020/08/20 19:10:59 ET
Table 'Manuel Neuer' 9-max (Play Money) Seat #6 is the button
Seat 4: Duke Croix (24104 in chips) 
Seat 6: color_singleton (10559 in chips) 
Seat 9: Manon541 (7653 in chips) 
Manon541: posts small blind 50
Duke Croix: posts big blind 100
*** HOLE CARDS ***
Dealt to Duke Croix [9h Ah]
color_singleton: raises 100 to 200
Manon541: calls 150
Duke Croix: raises 300 to 500
color_singleton: folds 
Manon541: calls 300
*** FLOP *** [5h Jh 8s]
Manon541: checks 
Duke Croix: bets 700
Manon541: folds 
Uncalled bet (700) returned to Duke Croix
Duke Croix collected 1134 from pot
*** SUMMARY ***
Total pot 1200 | Rake 66 
Board [5h Jh 8s]
Seat 4: Duke Croix (big blind) collected (1134)
Seat 6: color_singleton (button) folded before Flop
Seat 9: Manon541 (small blind) folded on the Flop



PokerStars Home Game Hand #217638249801: {Club #3225207}  Hold'em No Limit (50/100) - 2020/08/20 19:11:28 ET
Table 'Manuel Neuer' 9-max (Play Money) Seat #9 is the button
Seat 4: Duke Croix (24738 in chips) 
Seat 6: color_singleton (10359 in chips) 
Seat 9: Manon541 (7153 in chips) 
Duke Croix: posts small blind 50
color_singleton: posts big blind 100
*** HOLE CARDS ***
Dealt to Duke Croix [Kd 8c]
Manon541: calls 100
Duke Croix: calls 50
color_singleton: checks 
*** FLOP *** [Td Qh 9c]
Duke Croix: bets 200
color_singleton: calls 200
Manon541: calls 200
*** TURN *** [Td Qh 9c] [7d]
Duke Croix: bets 400
color_singleton: folds 
Manon541: folds 
Uncalled bet (400) returned to Duke Croix
Duke Croix collected 850 from pot
*** SUMMARY ***
Total pot 900 | Rake 50 
Board [Td Qh 9c 7d]
Seat 4: Duke Croix (small blind) collected (850)
Seat 6: color_singleton (big blind) folded on the Turn
Seat 9: Manon541 (button) folded on the Turn



PokerStars Home Game Hand #217638261613: {Club #3225207}  Hold'em No Limit (50/100) - 2020/08/20 19:11:57 ET
Table 'Manuel Neuer' 9-max (Play Money) Seat #4 is the button
Seat 4: Duke Croix (25288 in chips) 
Seat 6: color_singleton (10059 in chips) 
Seat 9: Manon541 (6853 in chips) 
color_singleton: posts small blind 50
Manon541: posts big blind 100
*** HOLE CARDS ***
Dealt to Duke Croix [Ts 4h]
Duke Croix: folds 
color_singleton: raises 200 to 300
Manon541: calls 200
*** FLOP *** [8s Js Jh]
color_singleton: checks 
Manon541: checks 
*** TURN *** [8s Js Jh] [7s]
color_singleton: checks 
Manon541: checks 
*** RIVER *** [8s Js Jh 7s] [7c]
color_singleton: checks 
Manon541: checks 
*** SHOW DOWN ***
color_singleton: shows [3d 3s] (two pair, Jacks and Sevens)
Manon541: shows [Ah 5c] (two pair, Jacks and Sevens - Ace kicker)
Manon541 collected 567 from pot
*** SUMMARY ***
Total pot 600 | Rake 33 
Board [8s Js Jh 7s 7c]
Seat 4: Duke Croix (button) folded before Flop (didn't bet)
Seat 6: color_singleton (small blind) showed [3d 3s] and lost with two pair, Jacks and Sevens
Seat 9: Manon541 (big blind) showed [Ah 5c] and won (567) with two pair, Jacks and Sevens



PokerStars Home Game Hand #217638270144: {Club #3225207}  Hold'em No Limit (50/100) - 2020/08/20 19:12:18 ET
Table 'Manuel Neuer' 9-max (Play Money) Seat #6 is the button
Seat 4: Duke Croix (25288 in chips) 
Seat 6: color_singleton (9759 in chips) 
Seat 9: Manon541 (7120 in chips) 
Manon541: posts small blind 50
Duke Croix: posts big blind 100
*** HOLE CARDS ***
Dealt to Duke Croix [2d 5s]
color_singleton: raises 100 to 200
Manon541: folds 
Duke Croix: folds 
Uncalled bet (100) returned to color_singleton
color_singleton collected 250 from pot
color_singleton: doesn't show hand 
*** SUMMARY ***
Total pot 250 | Rake 0 
Seat 4: Duke Croix (big blind) folded before Flop
Seat 6: color_singleton (button) collected (250)
Seat 9: Manon541 (small blind) folded before Flop



PokerStars Home Game Hand #217638274620: {Club #3225207}  Hold'em No Limit (50/100) - 2020/08/20 19:12:29 ET
Table 'Manuel Neuer' 9-max (Play Money) Seat #9 is the button
Seat 4: Duke Croix (25188 in chips) 
Seat 6: color_singleton (9909 in chips) 
Seat 9: Manon541 (7070 in chips) 
Duke Croix: posts small blind 50
color_singleton: posts big blind 100
*** HOLE CARDS ***
Dealt to Duke Croix [7c Ts]
Manon541: calls 100
Duke Croix: calls 50
color_singleton: raises 100 to 200
Manon541: calls 100
Duke Croix: calls 100
*** FLOP *** [Js 9h 6s]
Duke Croix: checks 
color_singleton: bets 283
Manon541: calls 283
Duke Croix: folds 
*** TURN *** [Js 9h 6s] [5h]
color_singleton: checks 
Manon541: checks 
*** RIVER *** [Js 9h 6s 5h] [9s]
color_singleton: bets 551
Manon541: calls 551
*** SHOW DOWN ***
color_singleton: shows [7d 8s] (a straight, Five to Nine)
Manon541: mucks hand 
color_singleton collected 2143 from pot
*** SUMMARY ***
Total pot 2268 | Rake 125 
Board [Js 9h 6s 5h 9s]
Seat 4: Duke Croix (small blind) folded on the Flop
Seat 6: color_singleton (big blind) showed [7d 8s] and won (2143) with a straight, Five to Nine
Seat 9: Manon541 (button) mucked [6c Kh]



PokerStars Home Game Hand #217638299521: {Club #3225207}  Hold'em No Limit (50/100) - 2020/08/20 19:13:31 ET
Table 'Manuel Neuer' 9-max (Play Money) Seat #4 is the button
Seat 4: Duke Croix (24988 in chips) 
Seat 6: color_singleton (11018 in chips) 
Seat 9: Manon541 (6036 in chips) 
color_singleton: posts small blind 50
Manon541: posts big blind 100
*** HOLE CARDS ***
Dealt to Duke Croix [Qh 8d]
Duke Croix: raises 200 to 300
color_singleton: raises 200 to 500
Manon541: folds 
Duke Croix: calls 200
*** FLOP *** [9c 3s Qs]
color_singleton: bets 1039
Duke Croix: calls 1039
*** TURN *** [9c 3s Qs] [Ks]
color_singleton: checks 
Duke Croix: bets 1500
color_singleton: folds 
Uncalled bet (1500) returned to Duke Croix
Duke Croix collected 3003 from pot
*** SUMMARY ***
Total pot 3178 | Rake 175 
Board [9c 3s Qs Ks]
Seat 4: Duke Croix (button) collected (3003)
Seat 6: color_singleton (small blind) folded on the Turn
Seat 9: Manon541 (big blind) folded before Flop



PokerStars Home Game Hand #217638323413: {Club #3225207}  Hold'em No Limit (50/100) - 2020/08/20 19:14:06 ET
Table 'Manuel Neuer' 9-max (Play Money) Seat #6 is the button
Seat 4: Duke Croix (26452 in chips) 
Seat 6: color_singleton (9479 in chips) 
Seat 9: Manon541 (5936 in chips) 
Manon541: posts small blind 50
Duke Croix: posts big blind 100
*** HOLE CARDS ***
Dealt to Duke Croix [9h 5c]
color_singleton: folds 
Manon541: calls 50
Duke Croix: checks 
*** FLOP *** [As 3s 9d]
Manon541: checks 
Duke Croix: bets 200
Manon541: folds 
Uncalled bet (200) returned to Duke Croix
Duke Croix collected 189 from pot
*** SUMMARY ***
Total pot 200 | Rake 11 
Board [As 3s 9d]
Seat 4: Duke Croix (big blind) collected (189)
Seat 6: color_singleton (button) folded before Flop (didn't bet)
Seat 9: Manon541 (small blind) folded on the Flop



PokerStars Home Game Hand #217638330403: {Club #3225207}  Hold'em No Limit (50/100) - 2020/08/20 19:14:24 ET
Table 'Manuel Neuer' 9-max (Play Money) Seat #9 is the button
Seat 4: Duke Croix (26541 in chips) 
Seat 6: color_singleton (9479 in chips) 
Seat 9: Manon541 (5836 in chips) 
Duke Croix: posts small blind 50
color_singleton: posts big blind 100
*** HOLE CARDS ***
Dealt to Duke Croix [2s 5s]
Manon541: calls 100
Duke Croix: calls 50
color_singleton: raises 100 to 200
Manon541: calls 100
Duke Croix: calls 100
*** FLOP *** [2h 5c 9c]
Duke Croix: bets 400
color_singleton: calls 400
Manon541: folds 
*** TURN *** [2h 5c 9c] [9h]
Duke Croix: bets 700
color_singleton: calls 700
*** RIVER *** [2h 5c 9c 9h] [Tc]
Duke Croix: checks 
color_singleton: checks 
*** SHOW DOWN ***
Duke Croix: shows [2s 5s] (two pair, Nines and Fives)
color_singleton: shows [8d 5h] (two pair, Nines and Fives)
Duke Croix collected 1323 from pot
color_singleton collected 1323 from pot
*** SUMMARY ***
Total pot 2800 | Rake 154 
Board [2h 5c 9c 9h Tc]
Seat 4: Duke Croix (small blind) showed [2s 5s] and won (1323) with two pair, Nines and Fives
Seat 6: color_singleton (big blind) showed [8d 5h] and won (1323) with two pair, Nines and Fives
Seat 9: Manon541 (button) folded on the Flop



PokerStars Home Game Hand #217638345251: {Club #3225207}  Hold'em No Limit (50/100) - 2020/08/20 19:15:00 ET
Table 'Manuel Neuer' 9-max (Play Money) Seat #4 is the button
Seat 4: Duke Croix (26564 in chips) 
Seat 6: color_singleton (9502 in chips) 
Seat 9: Manon541 (5636 in chips) 
color_singleton: posts small blind 50
Manon541: posts big blind 100
*** HOLE CARDS ***
Dealt to Duke Croix [8c 9s]
Duke Croix: raises 200 to 300
color_singleton: calls 250
Manon541: calls 200
*** FLOP *** [6h 5d 5c]
color_singleton: checks 
Manon541: checks 
Duke Croix: checks 
*** TURN *** [6h 5d 5c] [Ad]
color_singleton: checks 
Manon541: checks 
Duke Croix: checks 
*** RIVER *** [6h 5d 5c Ad] [4d]
color_singleton: bets 425
Manon541: folds 
Duke Croix: folds 
Uncalled bet (425) returned to color_singleton
color_singleton collected 850 from pot
color_singleton: doesn't show hand 
*** SUMMARY ***
Total pot 900 | Rake 50 
Board [6h 5d 5c Ad 4d]
Seat 4: Duke Croix (button) folded on the River
Seat 6: color_singleton (small blind) collected (850)
Seat 9: Manon541 (big blind) folded on the River



PokerStars Home Game Hand #217638359533: {Club #3225207}  Hold'em No Limit (50/100) - 2020/08/20 19:15:35 ET
Table 'Manuel Neuer' 9-max (Play Money) Seat #6 is the button
Seat 4: Duke Croix (26264 in chips) 
Seat 6: color_singleton (10052 in chips) 
Seat 9: Manon541 (5336 in chips) 
Manon541: posts small blind 50
Duke Croix: posts big blind 100
*** HOLE CARDS ***
Dealt to Duke Croix [9c Kc]
color_singleton: folds 
Manon541: calls 50
Duke Croix: raises 300 to 400
Manon541: calls 300
*** FLOP *** [6s 8d 2c]
Manon541: bets 378
Duke Croix: calls 378
*** TURN *** [6s 8d 2c] [4c]
Manon541: checks 
Duke Croix: bets 700
Manon541: calls 700
*** RIVER *** [6s 8d 2c 4c] [Kh]
Manon541: checks 
Duke Croix: bets 1100
Manon541: calls 1100
*** SHOW DOWN ***
Duke Croix: shows [9c Kc] (a pair of Kings)
Manon541: shows [8s 8h] (three of a kind, Eights)
Manon541 collected 4872 from pot
*** SUMMARY ***
Total pot 5156 | Rake 284 
Board [6s 8d 2c 4c Kh]
Seat 4: Duke Croix (big blind) showed [9c Kc] and lost with a pair of Kings
Seat 6: color_singleton (button) folded before Flop (didn't bet)
Seat 9: Manon541 (small blind) showed [8s 8h] and won (4872) with three of a kind, Eights



PokerStars Home Game Hand #217638375652: {Club #3225207}  Hold'em No Limit (50/100) - 2020/08/20 19:16:15 ET
Table 'Manuel Neuer' 9-max (Play Money) Seat #9 is the button
Seat 4: Duke Croix (23686 in chips) 
Seat 6: color_singleton (10052 in chips) 
Seat 9: Manon541 (7630 in chips) 
Duke Croix: posts small blind 50
color_singleton: posts big blind 100
*** HOLE CARDS ***
Dealt to Duke Croix [Tc 4d]
Manon541: calls 100
Duke Croix: calls 50
color_singleton: raises 200 to 300
Manon541: calls 200
Duke Croix: folds 
*** FLOP *** [Qc 9h 3c]
color_singleton: bets 330
Manon541: calls 330
*** TURN *** [Qc 9h 3c] [8s]
color_singleton: checks 
Manon541: checks 
*** RIVER *** [Qc 9h 3c 8s] [5s]
color_singleton: checks 
Manon541: checks 
*** SHOW DOWN ***
color_singleton: shows [4h 4s] (a pair of Fours)
Manon541: shows [Qh As] (a pair of Queens)
Manon541 collected 1285 from pot
*** SUMMARY ***
Total pot 1360 | Rake 75 
Board [Qc 9h 3c 8s 5s]
Seat 4: Duke Croix (small blind) folded before Flop
Seat 6: color_singleton (big blind) showed [4h 4s] and lost with a pair of Fours
Seat 9: Manon541 (button) showed [Qh As] and won (1285) with a pair of Queens



PokerStars Home Game Hand #217638386433: {Club #3225207}  Hold'em No Limit (50/100) - 2020/08/20 19:16:42 ET
Table 'Manuel Neuer' 9-max (Play Money) Seat #4 is the button
Seat 4: Duke Croix (23586 in chips) 
Seat 6: color_singleton (9422 in chips) 
Seat 9: Manon541 (8285 in chips) 
color_singleton: posts small blind 50
Manon541: posts big blind 100
*** HOLE CARDS ***
Dealt to Duke Croix [4s Jh]
Duke Croix: folds 
color_singleton: folds 
Uncalled bet (50) returned to Manon541
Manon541 collected 100 from pot
*** SUMMARY ***
Total pot 100 | Rake 0 
Seat 4: Duke Croix (button) folded before Flop (didn't bet)
Seat 6: color_singleton (small blind) folded before Flop
Seat 9: Manon541 (big blind) collected (100)



PokerStars Home Game Hand #217638389211: {Club #3225207}  Hold'em No Limit (50/100) - 2020/08/20 19:16:49 ET
Table 'Manuel Neuer' 9-max (Play Money) Seat #6 is the button
Seat 4: Duke Croix (23586 in chips) 
Seat 6: color_singleton (9372 in chips) 
Seat 9: Manon541 (8335 in chips) 
Manon541: posts small blind 50
Duke Croix: posts big blind 100
*** HOLE CARDS ***
Dealt to Duke Croix [Th Ts]
color_singleton: raises 100 to 200
Manon541: folds 
Duke Croix: raises 400 to 600
color_singleton: folds 
Uncalled bet (400) returned to Duke Croix
Duke Croix collected 450 from pot
*** SUMMARY ***
Total pot 450 | Rake 0 
Seat 4: Duke Croix (big blind) collected (450)
Seat 6: color_singleton (button) folded before Flop
Seat 9: Manon541 (small blind) folded before Flop



PokerStars Home Game Hand #217638398822: {Club #3225207}  Hold'em No Limit (50/100) - 2020/08/20 19:17:13 ET
Table 'Manuel Neuer' 9-max (Play Money) Seat #9 is the button
Seat 4: Duke Croix (23836 in chips) 
Seat 6: color_singleton (9172 in chips) 
Seat 9: Manon541 (8285 in chips) 
Duke Croix: posts small blind 50
color_singleton: posts big blind 100
*** HOLE CARDS ***
Dealt to Duke Croix [9c Qs]
Manon541: calls 100
Duke Croix: raises 300 to 400
color_singleton: calls 300
Manon541: calls 300
*** FLOP *** [5d 2s 4h]
Duke Croix: bets 700
color_singleton: folds 
Manon541: folds 
Uncalled bet (700) returned to Duke Croix
Duke Croix collected 1134 from pot
*** SUMMARY ***
Total pot 1200 | Rake 66 
Board [5d 2s 4h]
Seat 4: Duke Croix (small blind) collected (1134)
Seat 6: color_singleton (big blind) folded on the Flop
Seat 9: Manon541 (button) folded on the Flop



PokerStars Home Game Hand #217638408164: {Club #3225207}  Hold'em No Limit (50/100) - 2020/08/20 19:17:36 ET
Table 'Manuel Neuer' 9-max (Play Money) Seat #4 is the button
Seat 4: Duke Croix (24570 in chips) 
Seat 6: color_singleton (8772 in chips) 
Seat 9: Manon541 (7885 in chips) 
color_singleton: posts small blind 50
Manon541: posts big blind 100
*** HOLE CARDS ***
Dealt to Duke Croix [8d 4h]
Duke Croix: folds 
color_singleton: raises 200 to 300
Manon541: calls 200
*** FLOP *** [2h Js 7d]
color_singleton: bets 283
Manon541: calls 283
*** TURN *** [2h Js 7d] [2d]
color_singleton: checks 
Manon541: checks 
*** RIVER *** [2h Js 7d 2d] [Th]
color_singleton: checks 
Manon541: checks 
*** SHOW DOWN ***
color_singleton: shows [7c Qc] (two pair, Sevens and Deuces)
Manon541: mucks hand 
color_singleton collected 1102 from pot
*** SUMMARY ***
Total pot 1166 | Rake 64 
Board [2h Js 7d 2d Th]
Seat 4: Duke Croix (button) folded before Flop (didn't bet)
Seat 6: color_singleton (small blind) showed [7c Qc] and won (1102) with two pair, Sevens and Deuces
Seat 9: Manon541 (big blind) mucked [6s 9h]



PokerStars Home Game Hand #217638421039: {Club #3225207}  Hold'em No Limit (50/100) - 2020/08/20 19:18:08 ET
Table 'Manuel Neuer' 9-max (Play Money) Seat #6 is the button
Seat 4: Duke Croix (24570 in chips) 
Seat 6: color_singleton (9291 in chips) 
Seat 9: Manon541 (7302 in chips) 
Manon541: posts small blind 50
Duke Croix: posts big blind 100
*** HOLE CARDS ***
Dealt to Duke Croix [Qs Ac]
color_singleton: folds 
Manon541: calls 50
Duke Croix: raises 400 to 500
Manon541: folds 
Uncalled bet (400) returned to Duke Croix
Duke Croix collected 200 from pot
*** SUMMARY ***
Total pot 200 | Rake 0 
Seat 4: Duke Croix (big blind) collected (200)
Seat 6: color_singleton (button) folded before Flop (didn't bet)
Seat 9: Manon541 (small blind) folded before Flop



PokerStars Home Game Hand #217638427785: {Club #3225207}  Hold'em No Limit (50/100) - 2020/08/20 19:18:25 ET
Table 'Manuel Neuer' 9-max (Play Money) Seat #9 is the button
Seat 4: Duke Croix (24670 in chips) 
Seat 6: color_singleton (9291 in chips) 
Seat 9: Manon541 (7202 in chips) 
Duke Croix: posts small blind 50
color_singleton: posts big blind 100
*** HOLE CARDS ***
Dealt to Duke Croix [3d 5s]
Manon541: calls 100
Duke Croix: calls 50
color_singleton: checks 
*** FLOP *** [6h 2h 5c]
Duke Croix: bets 200
color_singleton: calls 200
Manon541: folds 
*** TURN *** [6h 2h 5c] [Ks]
Duke Croix: checks 
color_singleton: checks 
*** RIVER *** [6h 2h 5c Ks] [2c]
Duke Croix: bets 400
color_singleton: calls 400
*** SHOW DOWN ***
Duke Croix: shows [3d 5s] (two pair, Fives and Deuces)
color_singleton: shows [9h 6c] (two pair, Sixes and Deuces)
color_singleton collected 1417 from pot
*** SUMMARY ***
Total pot 1500 | Rake 83 
Board [6h 2h 5c Ks 2c]
Seat 4: Duke Croix (small blind) showed [3d 5s] and lost with two pair, Fives and Deuces
Seat 6: color_singleton (big blind) showed [9h 6c] and won (1417) with two pair, Sixes and Deuces
Seat 9: Manon541 (button) folded on the Flop



PokerStars Home Game Hand #217638442167: {Club #3225207}  Hold'em No Limit (50/100) - 2020/08/20 19:19:01 ET
Table 'Manuel Neuer' 9-max (Play Money) Seat #4 is the button
Seat 4: Duke Croix (23970 in chips) 
Seat 6: color_singleton (10008 in chips) 
Seat 9: Manon541 (7102 in chips) 
color_singleton: posts small blind 50
Manon541: posts big blind 100
*** HOLE CARDS ***
Dealt to Duke Croix [9c Jh]
Duke Croix: raises 200 to 300
color_singleton: calls 250
Manon541: calls 200
*** FLOP *** [5s Qc Tc]
color_singleton: checks 
Manon541: bets 425
Duke Croix: calls 425
color_singleton: folds 
*** TURN *** [5s Qc Tc] [As]
Manon541: bets 827
Duke Croix: calls 827
*** RIVER *** [5s Qc Tc As] [Td]
Manon541: bets 3217
Duke Croix: folds 
Uncalled bet (3217) returned to Manon541
Manon541 collected 3217 from pot
*** SUMMARY ***
Total pot 3404 | Rake 187 
Board [5s Qc Tc As Td]
Seat 4: Duke Croix (button) folded on the River
Seat 6: color_singleton (small blind) folded on the Flop
Seat 9: Manon541 (big blind) collected (3217)



PokerStars Home Game Hand #217638453969: {Club #3225207}  Hold'em No Limit (50/100) - 2020/08/20 19:19:31 ET
Table 'Manuel Neuer' 9-max (Play Money) Seat #6 is the button
Seat 4: Duke Croix (22418 in chips) 
Seat 6: color_singleton (9708 in chips) 
Seat 9: Manon541 (8767 in chips) 
Manon541: posts small blind 50
Duke Croix: posts big blind 100
*** HOLE CARDS ***
Dealt to Duke Croix [Kh Jd]
color_singleton: raises 250 to 350
Manon541: folds 
Duke Croix: calls 250
*** FLOP *** [5c 9d 5d]
Duke Croix: checks 
color_singleton: bets 354
Duke Croix: calls 354
*** TURN *** [5c 9d 5d] [Kd]
Duke Croix: checks 
color_singleton: bets 1378
Duke Croix: calls 1378
*** RIVER *** [5c 9d 5d Kd] [3c]
Duke Croix: checks 
color_singleton: checks 
*** SHOW DOWN ***
Duke Croix: shows [Kh Jd] (two pair, Kings and Fives)
color_singleton: mucks hand 
Duke Croix collected 3982 from pot
*** SUMMARY ***
Total pot 4214 | Rake 232 
Board [5c 9d 5d Kd 3c]
Seat 4: Duke Croix (big blind) showed [Kh Jd] and won (3982) with two pair, Kings and Fives
Seat 6: color_singleton (button) mucked [Ad 6s]
Seat 9: Manon541 (small blind) folded before Flop



PokerStars Home Game Hand #217638463666: {Club #3225207}  Hold'em No Limit (50/100) - 2020/08/20 19:19:55 ET
Table 'Manuel Neuer' 9-max (Play Money) Seat #9 is the button
Seat 4: Duke Croix (24318 in chips) 
Seat 6: color_singleton (7626 in chips) 
Seat 9: Manon541 (8717 in chips) 
Duke Croix: posts small blind 50
color_singleton: posts big blind 100
*** HOLE CARDS ***
Dealt to Duke Croix [7d 6h]
Manon541: calls 100
Duke Croix: calls 50
color_singleton: raises 100 to 200
Manon541: calls 100
Duke Croix: calls 100
*** FLOP *** [5d Kh 9h]
Duke Croix: checks 
color_singleton: bets 283
Manon541: calls 283
Duke Croix: folds 
*** TURN *** [5d Kh 9h] [8d]
color_singleton: bets 551
Manon541: calls 551
*** RIVER *** [5d Kh 9h 8d] [3h]
color_singleton: bets 1071
Manon541: folds 
Uncalled bet (1071) returned to color_singleton
color_singleton collected 2143 from pot
color_singleton: doesn't show hand 
*** SUMMARY ***
Total pot 2268 | Rake 125 
Board [5d Kh 9h 8d 3h]
Seat 4: Duke Croix (small blind) folded on the Flop
Seat 6: color_singleton (big blind) collected (2143)
Seat 9: Manon541 (button) folded on the River



PokerStars Home Game Hand #217638479255: {Club #3225207}  Hold'em No Limit (50/100) - 2020/08/20 19:20:34 ET
Table 'Manuel Neuer' 9-max (Play Money) Seat #4 is the button
Seat 4: Duke Croix (24118 in chips) 
Seat 6: color_singleton (8735 in chips) 
Seat 9: Manon541 (7683 in chips) 
color_singleton: posts small blind 50
Manon541: posts big blind 100
*** HOLE CARDS ***
Dealt to Duke Croix [6h Td]
Duke Croix: folds 
color_singleton: folds 
Uncalled bet (50) returned to Manon541
Manon541 collected 100 from pot
*** SUMMARY ***
Total pot 100 | Rake 0 
Seat 4: Duke Croix (button) folded before Flop (didn't bet)
Seat 6: color_singleton (small blind) folded before Flop
Seat 9: Manon541 (big blind) collected (100)



PokerStars Home Game Hand #217638481687: {Club #3225207}  Hold'em No Limit (50/100) - 2020/08/20 19:20:40 ET
Table 'Manuel Neuer' 9-max (Play Money) Seat #6 is the button
Seat 4: Duke Croix (24118 in chips) 
Seat 6: color_singleton (8685 in chips) 
Seat 9: Manon541 (7733 in chips) 
Manon541: posts small blind 50
Duke Croix: posts big blind 100
*** HOLE CARDS ***
Dealt to Duke Croix [9s 6h]
color_singleton: folds 
Manon541: calls 50
Duke Croix: checks 
*** FLOP *** [5c 9c 5d]
Manon541: checks 
Duke Croix: checks 
*** TURN *** [5c 9c 5d] [Qc]
Manon541: checks 
Duke Croix: checks 
*** RIVER *** [5c 9c 5d Qc] [Ad]
Manon541: bets 189
Duke Croix: folds 
Uncalled bet (189) returned to Manon541
Manon541 collected 189 from pot
*** SUMMARY ***
Total pot 200 | Rake 11 
Board [5c 9c 5d Qc Ad]
Seat 4: Duke Croix (big blind) folded on the River
Seat 6: color_singleton (button) folded before Flop (didn't bet)
Seat 9: Manon541 (small blind) collected (189)



PokerStars Home Game Hand #217638496003: {Club #3225207}  Hold'em No Limit (50/100) - 2020/08/20 19:21:15 ET
Table 'Manuel Neuer' 9-max (Play Money) Seat #9 is the button
Seat 4: Duke Croix (24018 in chips) 
Seat 6: color_singleton (8685 in chips) 
Seat 9: Manon541 (7822 in chips) 
Duke Croix: posts small blind 50
color_singleton: posts big blind 100
*** HOLE CARDS ***
Dealt to Duke Croix [Qd 2c]
Manon541: calls 100
Duke Croix: calls 50
color_singleton: checks 
*** FLOP *** [Ts 5d Qc]
Duke Croix: checks 
color_singleton: checks 
Manon541: checks 
*** TURN *** [Ts 5d Qc] [6c]
Duke Croix: checks 
color_singleton: checks 
Manon541: bets 141
Duke Croix: calls 141
color_singleton: folds 
*** RIVER *** [Ts 5d Qc 6c] [Ad]
Duke Croix: checks 
Manon541: bets 275
Duke Croix: calls 275
*** SHOW DOWN ***
Manon541: shows [4h 4c] (a pair of Fours)
Duke Croix: shows [Qd 2c] (a pair of Queens)
Duke Croix collected 1070 from pot
*** SUMMARY ***
Total pot 1132 | Rake 62 
Board [Ts 5d Qc 6c Ad]
Seat 4: Duke Croix (small blind) showed [Qd 2c] and won (1070) with a pair of Queens
Seat 6: color_singleton (big blind) folded on the Turn
Seat 9: Manon541 (button) showed [4h 4c] and lost with a pair of Fours



PokerStars Home Game Hand #217638516458: {Club #3225207}  Hold'em No Limit (50/100) - 2020/08/20 19:22:07 ET
Table 'Manuel Neuer' 9-max (Play Money) Seat #4 is the button
Seat 4: Duke Croix (24572 in chips) 
Seat 6: color_singleton (8585 in chips) 
Seat 9: Manon541 (7306 in chips) 
color_singleton: posts small blind 50
Manon541: posts big blind 100
*** HOLE CARDS ***
Dealt to Duke Croix [6d 4d]
Duke Croix: calls 100
color_singleton: raises 100 to 200
Manon541: folds 
Duke Croix: calls 100
*** FLOP *** [Qh 9s 8h]
color_singleton: bets 236
Duke Croix: folds 
Uncalled bet (236) returned to color_singleton
color_singleton collected 472 from pot
color_singleton: doesn't show hand 
*** SUMMARY ***
Total pot 500 | Rake 28 
Board [Qh 9s 8h]
Seat 4: Duke Croix (button) folded on the Flop
Seat 6: color_singleton (small blind) collected (472)
Seat 9: Manon541 (big blind) folded before Flop



PokerStars Home Game Hand #217638527778: {Club #3225207}  Hold'em No Limit (50/100) - 2020/08/20 19:22:36 ET
Table 'Manuel Neuer' 9-max (Play Money) Seat #6 is the button
Seat 4: Duke Croix (24372 in chips) 
Seat 6: color_singleton (8857 in chips) 
Seat 9: Manon541 (7206 in chips) 
Manon541: posts small blind 50
Duke Croix: posts big blind 100
*** HOLE CARDS ***
Dealt to Duke Croix [Ah 7c]
color_singleton: raises 100 to 200
Manon541: folds 
Duke Croix: calls 100
*** FLOP *** [9d Jh Qc]
Duke Croix: checks 
color_singleton: bets 212
Duke Croix: folds 
Uncalled bet (212) returned to color_singleton
color_singleton collected 425 from pot
color_singleton: doesn't show hand 
*** SUMMARY ***
Total pot 450 | Rake 25 
Board [9d Jh Qc]
Seat 4: Duke Croix (big blind) folded on the Flop
Seat 6: color_singleton (button) collected (425)
Seat 9: Manon541 (small blind) folded before Flop



PokerStars Home Game Hand #217638540844: {Club #3225207}  Hold'em No Limit (50/100) - 2020/08/20 19:23:09 ET
Table 'Manuel Neuer' 9-max (Play Money) Seat #9 is the button
Seat 4: Duke Croix (24172 in chips) 
Seat 6: color_singleton (9082 in chips) 
Seat 9: Manon541 (7156 in chips) 
Duke Croix: posts small blind 50
color_singleton: posts big blind 100
*** HOLE CARDS ***
Dealt to Duke Croix [4c 4d]
Manon541: calls 100
Duke Croix: raises 300 to 400
color_singleton: folds 
Manon541: folds 
Uncalled bet (300) returned to Duke Croix
Duke Croix collected 300 from pot
*** SUMMARY ***
Total pot 300 | Rake 0 
Seat 4: Duke Croix (small blind) collected (300)
Seat 6: color_singleton (big blind) folded before Flop
Seat 9: Manon541 (button) folded before Flop



PokerStars Home Game Hand #217638548369: {Club #3225207}  Hold'em No Limit (50/100) - 2020/08/20 19:23:28 ET
Table 'Manuel Neuer' 9-max (Play Money) Seat #4 is the button
Seat 4: Duke Croix (24372 in chips) 
Seat 6: color_singleton (8982 in chips) 
Seat 9: Manon541 (7056 in chips) 
color_singleton: posts small blind 50
Manon541: posts big blind 100
*** HOLE CARDS ***
Dealt to Duke Croix [Kh 8h]
Duke Croix: raises 400 to 500
color_singleton: folds 
Manon541: folds 
Uncalled bet (400) returned to Duke Croix
Duke Croix collected 250 from pot
*** SUMMARY ***
Total pot 250 | Rake 0 
Seat 4: Duke Croix (button) collected (250)
Seat 6: color_singleton (small blind) folded before Flop
Seat 9: Manon541 (big blind) folded before Flop



PokerStars Home Game Hand #217638552566: {Club #3225207}  Hold'em No Limit (50/100) - 2020/08/20 19:23:38 ET
Table 'Manuel Neuer' 9-max (Play Money) Seat #6 is the button
Seat 4: Duke Croix (24522 in chips) 
Seat 6: color_singleton (8932 in chips) 
Seat 9: Manon541 (6956 in chips) 
Manon541: posts small blind 50
Duke Croix: posts big blind 100
*** HOLE CARDS ***
Dealt to Duke Croix [Ah 8h]
color_singleton: folds 
Manon541: calls 50
Duke Croix: raises 300 to 400
Manon541: calls 300
*** FLOP *** [2c 3c 2h]
Manon541: checks 
Duke Croix: bets 400
Manon541: folds 
Uncalled bet (400) returned to Duke Croix
Duke Croix collected 756 from pot
*** SUMMARY ***
Total pot 800 | Rake 44 
Board [2c 3c 2h]
Seat 4: Duke Croix (big blind) collected (756)
Seat 6: color_singleton (button) folded before Flop (didn't bet)
Seat 9: Manon541 (small blind) folded on the Flop



PokerStars Home Game Hand #217638561260: {Club #3225207}  Hold'em No Limit (50/100) - 2020/08/20 19:24:00 ET
Table 'Manuel Neuer' 9-max (Play Money) Seat #9 is the button
Seat 4: Duke Croix (24878 in chips) 
Seat 6: color_singleton (8932 in chips) 
Seat 9: Manon541 (6556 in chips) 
Duke Croix: posts small blind 50
color_singleton: posts big blind 100
*** HOLE CARDS ***
Dealt to Duke Croix [6h 2h]
Manon541: calls 100
Duke Croix: calls 50
color_singleton: raises 100 to 200
Manon541: calls 100
Duke Croix: calls 100
*** FLOP *** [Js Qs Ks]
Duke Croix: checks 
color_singleton: checks 
Manon541: bets 283
Duke Croix: folds 
color_singleton: folds 
Uncalled bet (283) returned to Manon541
Manon541 collected 567 from pot
*** SUMMARY ***
Total pot 600 | Rake 33 
Board [Js Qs Ks]
Seat 4: Duke Croix (small blind) folded on the Flop
Seat 6: color_singleton (big blind) folded on the Flop
Seat 9: Manon541 (button) collected (567)



PokerStars Home Game Hand #217638569381: {Club #3225207}  Hold'em No Limit (50/100) - 2020/08/20 19:24:20 ET
Table 'Manuel Neuer' 9-max (Play Money) Seat #4 is the button
Seat 4: Duke Croix (24678 in chips) 
Seat 6: color_singleton (8732 in chips) 
Seat 9: Manon541 (6923 in chips) 
color_singleton: posts small blind 50
Manon541: posts big blind 100
*** HOLE CARDS ***
Dealt to Duke Croix [Ts 9c]
Duke Croix: raises 200 to 300
color_singleton: folds 
Manon541: calls 200
*** FLOP *** [Ac 4h 3d]
Manon541: checks 
Duke Croix: checks 
*** TURN *** [Ac 4h 3d] [5c]
Manon541: checks 
Duke Croix: checks 
*** RIVER *** [Ac 4h 3d 5c] [6h]
Manon541: bets 614
Duke Croix: folds 
Uncalled bet (614) returned to Manon541
Manon541 collected 614 from pot
*** SUMMARY ***
Total pot 650 | Rake 36 
Board [Ac 4h 3d 5c 6h]
Seat 4: Duke Croix (button) folded on the River
Seat 6: color_singleton (small blind) folded before Flop
Seat 9: Manon541 (big blind) collected (614)



PokerStars Home Game Hand #217638585949: {Club #3225207}  Hold'em No Limit (50/100) - 2020/08/20 19:24:53 ET
Table 'Manuel Neuer' 9-max (Play Money) Seat #6 is the button
Seat 4: Duke Croix (24378 in chips) 
Seat 6: color_singleton (8682 in chips) 
Seat 9: Manon541 (7237 in chips) 
Manon541: posts small blind 50
Duke Croix: posts big blind 100
*** HOLE CARDS ***
Dealt to Duke Croix [Jc 9d]
color_singleton: raises 100 to 200
Manon541: calls 150
Duke Croix: calls 100
*** FLOP *** [7s 7c 5c]
Manon541: checks 
Duke Croix: checks 
color_singleton: bets 283
Manon541: calls 283
Duke Croix: folds 
*** TURN *** [7s 7c 5c] [Th]
Manon541: checks 
color_singleton: bets 551
Manon541: folds 
Uncalled bet (551) returned to color_singleton
color_singleton collected 1102 from pot
color_singleton: doesn't show hand 
*** SUMMARY ***
Total pot 1166 | Rake 64 
Board [7s 7c 5c Th]
Seat 4: Duke Croix (big blind) folded on the Flop
Seat 6: color_singleton (button) collected (1102)
Seat 9: Manon541 (small blind) folded on the Turn



PokerStars Home Game Hand #217638606221: {Club #3225207}  Hold'em No Limit (50/100) - 2020/08/20 19:25:45 ET
Table 'Manuel Neuer' 9-max (Play Money) Seat #9 is the button
Seat 4: Duke Croix (24178 in chips) 
Seat 6: color_singleton (9301 in chips) 
Seat 9: Manon541 (6754 in chips) 
Duke Croix: posts small blind 50
color_singleton: posts big blind 100
*** HOLE CARDS ***
Dealt to Duke Croix [Ad Qh]
Manon541: calls 100
Duke Croix: raises 300 to 400
color_singleton: folds 
Manon541: folds 
Uncalled bet (300) returned to Duke Croix
Duke Croix collected 300 from pot
*** SUMMARY ***
Total pot 300 | Rake 0 
Seat 4: Duke Croix (small blind) collected (300)
Seat 6: color_singleton (big blind) folded before Flop
Seat 9: Manon541 (button) folded before Flop



PokerStars Home Game Hand #217638613509: {Club #3225207}  Hold'em No Limit (50/100) - 2020/08/20 19:26:03 ET
Table 'Manuel Neuer' 9-max (Play Money) Seat #4 is the button
Seat 4: Duke Croix (24378 in chips) 
Seat 6: color_singleton (9201 in chips) 
Seat 9: Manon541 (6654 in chips) 
color_singleton: posts small blind 50
Manon541: posts big blind 100
*** HOLE CARDS ***
Dealt to Duke Croix [2c Jd]
Duke Croix: folds 
color_singleton: raises 100 to 200
Manon541: folds 
Uncalled bet (100) returned to color_singleton
color_singleton collected 200 from pot
color_singleton: doesn't show hand 
*** SUMMARY ***
Total pot 200 | Rake 0 
Seat 4: Duke Croix (button) folded before Flop (didn't bet)
Seat 6: color_singleton (small blind) collected (200)
Seat 9: Manon541 (big blind) folded before Flop



PokerStars Home Game Hand #217638617874: {Club #3225207}  Hold'em No Limit (50/100) - 2020/08/20 19:26:14 ET
Table 'Manuel Neuer' 9-max (Play Money) Seat #6 is the button
Seat 4: Duke Croix (24378 in chips) 
Seat 6: color_singleton (9301 in chips) 
Seat 9: Manon541 (6554 in chips) 
Manon541: posts small blind 50
Duke Croix: posts big blind 100
*** HOLE CARDS ***
Dealt to Duke Croix [5s 2c]
color_singleton: raises 100 to 200
Manon541: folds 
Duke Croix: calls 100
*** FLOP *** [9d 6d 4d]
Duke Croix: checks 
color_singleton: bets 212
Duke Croix: folds 
Uncalled bet (212) returned to color_singleton
color_singleton collected 425 from pot
color_singleton: doesn't show hand 
*** SUMMARY ***
Total pot 450 | Rake 25 
Board [9d 6d 4d]
Seat 4: Duke Croix (big blind) folded on the Flop
Seat 6: color_singleton (button) collected (425)
Seat 9: Manon541 (small blind) folded before Flop



PokerStars Home Game Hand #217638623733: {Club #3225207}  Hold'em No Limit (50/100) - 2020/08/20 19:26:29 ET
Table 'Manuel Neuer' 9-max (Play Money) Seat #9 is the button
Seat 4: Duke Croix (24178 in chips) 
Seat 6: color_singleton (9526 in chips) 
Seat 9: Manon541 (6504 in chips) 
Duke Croix: posts small blind 50
color_singleton: posts big blind 100
*** HOLE CARDS ***
Dealt to Duke Croix [6d Jc]
Manon541: calls 100
Duke Croix: calls 50
color_singleton: raises 100 to 200
Manon541: calls 100
Duke Croix: calls 100
*** FLOP *** [9c 8c Ad]
Duke Croix: checks 
color_singleton: bets 283
Manon541: folds 
Duke Croix: folds 
Uncalled bet (283) returned to color_singleton
color_singleton collected 567 from pot
color_singleton: doesn't show hand 
*** SUMMARY ***
Total pot 600 | Rake 33 
Board [9c 8c Ad]
Seat 4: Duke Croix (small blind) folded on the Flop
Seat 6: color_singleton (big blind) collected (567)
Seat 9: Manon541 (button) folded on the Flop



PokerStars Home Game Hand #217638632636: {Club #3225207}  Hold'em No Limit (50/100) - 2020/08/20 19:26:52 ET
Table 'Manuel Neuer' 9-max (Play Money) Seat #4 is the button
Seat 4: Duke Croix (23978 in chips) 
Seat 6: color_singleton (9893 in chips) 
Seat 9: Manon541 (6304 in chips) 
color_singleton: posts small blind 50
Manon541: posts big blind 100
*** HOLE CARDS ***
Dealt to Duke Croix [Ac 5c]
Duke Croix: raises 200 to 300
color_singleton: calls 250
Manon541: calls 200
*** FLOP *** [6s Jh 5s]
color_singleton: bets 425
Manon541: folds 
Duke Croix: calls 425
*** TURN *** [6s Jh 5s] [Jd]
color_singleton: bets 827
Duke Croix: calls 827
*** RIVER *** [6s Jh 5s Jd] [6h]
color_singleton: checks 
Duke Croix: bets 1000
color_singleton: calls 1000
*** SHOW DOWN ***
Duke Croix: shows [Ac 5c] (two pair, Jacks and Sixes)
color_singleton: shows [9h 9s] (two pair, Jacks and Nines)
color_singleton collected 5107 from pot
*** SUMMARY ***
Total pot 5404 | Rake 297 
Board [6s Jh 5s Jd 6h]
Seat 4: Duke Croix (button) showed [Ac 5c] and lost with two pair, Jacks and Sixes
Seat 6: color_singleton (small blind) showed [9h 9s] and won (5107) with two pair, Jacks and Nines
Seat 9: Manon541 (big blind) folded on the Flop



PokerStars Home Game Hand #217638647822: {Club #3225207}  Hold'em No Limit (50/100) - 2020/08/20 19:27:31 ET
Table 'Manuel Neuer' 9-max (Play Money) Seat #6 is the button
Seat 4: Duke Croix (21426 in chips) 
Seat 6: color_singleton (12448 in chips) 
Seat 9: Manon541 (6004 in chips) 
Manon541: posts small blind 50
Duke Croix: posts big blind 100
*** HOLE CARDS ***
Dealt to Duke Croix [7c Qh]
color_singleton: raises 200 to 300
Manon541: folds 
Duke Croix: calls 200
*** FLOP *** [4h 9s 2d]
Duke Croix: checks 
color_singleton: bets 614
Duke Croix: folds 
Uncalled bet (614) returned to color_singleton
color_singleton collected 614 from pot
color_singleton: doesn't show hand 
*** SUMMARY ***
Total pot 650 | Rake 36 
Board [4h 9s 2d]
Seat 4: Duke Croix (big blind) folded on the Flop
Seat 6: color_singleton (button) collected (614)
Seat 9: Manon541 (small blind) folded before Flop



PokerStars Home Game Hand #217638656000: {Club #3225207}  Hold'em No Limit (50/100) - 2020/08/20 19:27:52 ET
Table 'Manuel Neuer' 9-max (Play Money) Seat #9 is the button
Seat 4: Duke Croix (21126 in chips) 
Seat 6: color_singleton (12762 in chips) 
Seat 9: Manon541 (5954 in chips) 
Duke Croix: posts small blind 50
color_singleton: posts big blind 100
*** HOLE CARDS ***
Dealt to Duke Croix [6c Kd]
Manon541: calls 100
Duke Croix: calls 50
color_singleton: raises 100 to 200
Manon541: calls 100
Duke Croix: calls 100
*** FLOP *** [7s 7h 9h]
Duke Croix: checks 
color_singleton: checks 
Manon541: bets 283
Duke Croix: folds 
color_singleton: folds 
Uncalled bet (283) returned to Manon541
Manon541 collected 567 from pot
*** SUMMARY ***
Total pot 600 | Rake 33 
Board [7s 7h 9h]
Seat 4: Duke Croix (small blind) folded on the Flop
Seat 6: color_singleton (big blind) folded on the Flop
Seat 9: Manon541 (button) collected (567)



PokerStars Home Game Hand #217638665222: {Club #3225207}  Hold'em No Limit (50/100) - 2020/08/20 19:28:16 ET
Table 'Manuel Neuer' 9-max (Play Money) Seat #4 is the button
Seat 4: Duke Croix (20926 in chips) 
Seat 6: color_singleton (12562 in chips) 
Seat 9: Manon541 (6321 in chips) 
color_singleton: posts small blind 50
Manon541: posts big blind 100
*** HOLE CARDS ***
Dealt to Duke Croix [Kh Jh]
Duke Croix: raises 300 to 400
color_singleton: folds 
Manon541: calls 300
*** FLOP *** [2c 4h Ad]
Manon541: checks 
Duke Croix: checks 
*** TURN *** [2c 4h Ad] [3h]
Manon541: bets 803
Duke Croix: calls 803
*** RIVER *** [2c 4h Ad 3h] [Td]
Manon541: bets 2321
Duke Croix: folds 
Uncalled bet (2321) returned to Manon541
Manon541 collected 2321 from pot
*** SUMMARY ***
Total pot 2456 | Rake 135 
Board [2c 4h Ad 3h Td]
Seat 4: Duke Croix (button) folded on the River
Seat 6: color_singleton (small blind) folded before Flop
Seat 9: Manon541 (big blind) collected (2321)



PokerStars Home Game Hand #217638674988: {Club #3225207}  Hold'em No Limit (50/100) - 2020/08/20 19:28:40 ET
Table 'Manuel Neuer' 9-max (Play Money) Seat #6 is the button
Seat 4: Duke Croix (19723 in chips) 
Seat 6: color_singleton (12512 in chips) 
Seat 9: Manon541 (7439 in chips) 
Manon541: posts small blind 50
Duke Croix: posts big blind 100
*** HOLE CARDS ***
Dealt to Duke Croix [7s Td]
color_singleton: raises 100 to 200
Manon541: calls 150
Duke Croix: calls 100
*** FLOP *** [3c 2s Kh]
Manon541: checks 
Duke Croix: checks 
color_singleton: checks 
*** TURN *** [3c 2s Kh] [As]
Manon541: checks 
Duke Croix: checks 
color_singleton: bets 200
Manon541: calls 200
Duke Croix: folds 
*** RIVER *** [3c 2s Kh As] [9c]
Manon541: checks 
color_singleton: bets 472
Manon541: folds 
Uncalled bet (472) returned to color_singleton
color_singleton collected 945 from pot
color_singleton: doesn't show hand 
*** SUMMARY ***
Total pot 1000 | Rake 55 
Board [3c 2s Kh As 9c]
Seat 4: Duke Croix (big blind) folded on the Turn
Seat 6: color_singleton (button) collected (945)
Seat 9: Manon541 (small blind) folded on the River



PokerStars Home Game Hand #217638688926: {Club #3225207}  Hold'em No Limit (50/100) - 2020/08/20 19:29:16 ET
Table 'Manuel Neuer' 9-max (Play Money) Seat #9 is the button
Seat 4: Duke Croix (19523 in chips) 
Seat 6: color_singleton (13057 in chips) 
Seat 9: Manon541 (7039 in chips) 
Duke Croix: posts small blind 50
color_singleton: posts big blind 100
*** HOLE CARDS ***
Dealt to Duke Croix [Jc Ts]
Manon541: folds 
Duke Croix: raises 300 to 400
color_singleton: folds 
Uncalled bet (300) returned to Duke Croix
Duke Croix collected 200 from pot
*** SUMMARY ***
Total pot 200 | Rake 0 
Seat 4: Duke Croix (small blind) collected (200)
Seat 6: color_singleton (big blind) folded before Flop
Seat 9: Manon541 (button) folded before Flop (didn't bet)



PokerStars Home Game Hand #217638692479: {Club #3225207}  Hold'em No Limit (50/100) - 2020/08/20 19:29:25 ET
Table 'Manuel Neuer' 9-max (Play Money) Seat #4 is the button
Seat 4: Duke Croix (19623 in chips) 
Seat 6: color_singleton (12957 in chips) 
Seat 9: Manon541 (7039 in chips) 
color_singleton: posts small blind 50
Manon541: posts big blind 100
*** HOLE CARDS ***
Dealt to Duke Croix [8d 5d]
Duke Croix: calls 100
color_singleton: calls 50
Manon541: checks 
*** FLOP *** [Kc 7s 2c]
color_singleton: bets 141
Manon541: calls 141
Duke Croix: folds 
*** TURN *** [Kc 7s 2c] [9c]
color_singleton: checks 
Manon541: checks 
*** RIVER *** [Kc 7s 2c 9c] [7d]
color_singleton: checks 
Manon541: checks 
*** SHOW DOWN ***
color_singleton: shows [2h Qd] (two pair, Sevens and Deuces)
Manon541: mucks hand 
color_singleton collected 550 from pot
*** SUMMARY ***
Total pot 582 | Rake 32 
Board [Kc 7s 2c 9c 7d]
Seat 4: Duke Croix (button) folded on the Flop
Seat 6: color_singleton (small blind) showed [2h Qd] and won (550) with two pair, Sevens and Deuces
Seat 9: Manon541 (big blind) mucked [3d Tc]



PokerStars Home Game Hand #217638701294: {Club #3225207}  Hold'em No Limit (50/100) - 2020/08/20 19:29:48 ET
Table 'Manuel Neuer' 9-max (Play Money) Seat #6 is the button
Seat 4: Duke Croix (19523 in chips) 
Seat 6: color_singleton (13266 in chips) 
Seat 9: Manon541 (6798 in chips) 
Manon541: posts small blind 50
Duke Croix: posts big blind 100
*** HOLE CARDS ***
Dealt to Duke Croix [6s Tc]
color_singleton: folds 
Manon541: calls 50
Duke Croix: checks 
*** FLOP *** [4d Qh 5c]
Manon541: checks 
Duke Croix: checks 
*** TURN *** [4d Qh 5c] [Qd]
Manon541: checks 
Duke Croix: checks 
*** RIVER *** [4d Qh 5c Qd] [Kd]
Manon541: checks 
Duke Croix: checks 
*** SHOW DOWN ***
Manon541: shows [As 8d] (a pair of Queens)
Duke Croix: mucks hand 
Manon541 collected 189 from pot
*** SUMMARY ***
Total pot 200 | Rake 11 
Board [4d Qh 5c Qd Kd]
Seat 4: Duke Croix (big blind) mucked [6s Tc]
Seat 6: color_singleton (button) folded before Flop (didn't bet)
Seat 9: Manon541 (small blind) showed [As 8d] and won (189) with a pair of Queens



PokerStars Home Game Hand #217638710350: {Club #3225207}  Hold'em No Limit (50/100) - 2020/08/20 19:30:10 ET
Table 'Manuel Neuer' 9-max (Play Money) Seat #9 is the button
Seat 4: Duke Croix (19423 in chips) 
Seat 6: color_singleton (13266 in chips) 
Seat 9: Manon541 (6887 in chips) 
Duke Croix: posts small blind 50
color_singleton: posts big blind 100
*** HOLE CARDS ***
Dealt to Duke Croix [3c Ks]
Manon541: calls 100
Duke Croix: calls 50
color_singleton: raises 200 to 300
Manon541: calls 200
Duke Croix: calls 200
*** FLOP *** [Kc 4h 9d]
Duke Croix: bets 400
color_singleton: calls 400
Manon541: folds 
*** TURN *** [Kc 4h 9d] [Qd]
Duke Croix: bets 900
color_singleton: calls 900
*** RIVER *** [Kc 4h 9d Qd] [2c]
Duke Croix: checks 
color_singleton: bets 1653
Duke Croix: folds 
Uncalled bet (1653) returned to color_singleton
color_singleton collected 3307 from pot
color_singleton: doesn't show hand 
*** SUMMARY ***
Total pot 3500 | Rake 193 
Board [Kc 4h 9d Qd 2c]
Seat 4: Duke Croix (small blind) folded on the River
Seat 6: color_singleton (big blind) collected (3307)
Seat 9: Manon541 (button) folded on the Flop



PokerStars Home Game Hand #217638732764: {Club #3225207}  Hold'em No Limit (50/100) - 2020/08/20 19:31:06 ET
Table 'Manuel Neuer' 9-max (Play Money) Seat #4 is the button
Seat 4: Duke Croix (17823 in chips) 
Seat 6: color_singleton (14973 in chips) 
Seat 9: Manon541 (6587 in chips) 
color_singleton: posts small blind 50
Manon541: posts big blind 100
*** HOLE CARDS ***
Dealt to Duke Croix [6h 5s]
Duke Croix: folds 
color_singleton: folds 
Uncalled bet (50) returned to Manon541
Manon541 collected 100 from pot
*** SUMMARY ***
Total pot 100 | Rake 0 
Seat 4: Duke Croix (button) folded before Flop (didn't bet)
Seat 6: color_singleton (small blind) folded before Flop
Seat 9: Manon541 (big blind) collected (100)



PokerStars Home Game Hand #217638736415: {Club #3225207}  Hold'em No Limit (50/100) - 2020/08/20 19:31:16 ET
Table 'Manuel Neuer' 9-max (Play Money) Seat #6 is the button
Seat 4: Duke Croix (17823 in chips) 
Seat 6: color_singleton (14923 in chips) 
Seat 9: Manon541 (6637 in chips) 
Manon541: posts small blind 50
Duke Croix: posts big blind 100
*** HOLE CARDS ***
Dealt to Duke Croix [Qh Qc]
color_singleton: raises 100 to 200
Manon541: folds 
Duke Croix: raises 300 to 500
color_singleton: calls 300
*** FLOP *** [Ah 4s 8c]
Duke Croix: bets 400
color_singleton: folds 
Uncalled bet (400) returned to Duke Croix
Duke Croix collected 992 from pot
*** SUMMARY ***
Total pot 1050 | Rake 58 
Board [Ah 4s 8c]
Seat 4: Duke Croix (big blind) collected (992)
Seat 6: color_singleton (button) folded on the Flop
Seat 9: Manon541 (small blind) folded before Flop



PokerStars Home Game Hand #217638743087: {Club #3225207}  Hold'em No Limit (50/100) - 2020/08/20 19:31:33 ET
Table 'Manuel Neuer' 9-max (Play Money) Seat #9 is the button
Seat 4: Duke Croix (18315 in chips) 
Seat 6: color_singleton (14423 in chips) 
Seat 9: Manon541 (6587 in chips) 
Duke Croix: posts small blind 50
color_singleton: posts big blind 100
*** HOLE CARDS ***
Dealt to Duke Croix [8s As]
Manon541: calls 100
Duke Croix: raises 400 to 500
color_singleton: calls 400
Manon541: folds 
*** FLOP *** [Kc 5c 4h]
Duke Croix: checks 
color_singleton: checks 
*** TURN *** [Kc 5c 4h] [8c]
Duke Croix: checks 
color_singleton: bets 519
Duke Croix: folds 
Uncalled bet (519) returned to color_singleton
color_singleton collected 1039 from pot
color_singleton: doesn't show hand 
*** SUMMARY ***
Total pot 1100 | Rake 61 
Board [Kc 5c 4h 8c]
Seat 4: Duke Croix (small blind) folded on the Turn
Seat 6: color_singleton (big blind) collected (1039)
Seat 9: Manon541 (button) folded before Flop



PokerStars Home Game Hand #217638757136: {Club #3225207}  Hold'em No Limit (50/100) - 2020/08/20 19:32:09 ET
Table 'Manuel Neuer' 9-max (Play Money) Seat #4 is the button
Seat 4: Duke Croix (17815 in chips) 
Seat 6: color_singleton (14962 in chips) 
Seat 9: Manon541 (6487 in chips) 
color_singleton: posts small blind 50
Manon541: posts big blind 100
*** HOLE CARDS ***
Dealt to Duke Croix [Td 6d]
Duke Croix: folds 
color_singleton: calls 50
Manon541: checks 
*** FLOP *** [4c 3s Kh]
color_singleton: bets 189
Manon541: calls 189
*** TURN *** [4c 3s Kh] [9d]
color_singleton: bets 273
Manon541: raises 273 to 546
color_singleton: folds 
Uncalled bet (273) returned to Manon541
Manon541 collected 1062 from pot
*** SUMMARY ***
Total pot 1124 | Rake 62 
Board [4c 3s Kh 9d]
Seat 4: Duke Croix (button) folded before Flop (didn't bet)
Seat 6: color_singleton (small blind) folded on the Turn
Seat 9: Manon541 (big blind) collected (1062)



PokerStars Home Game Hand #217638768696: {Club #3225207}  Hold'em No Limit (50/100) - 2020/08/20 19:32:38 ET
Table 'Manuel Neuer' 9-max (Play Money) Seat #6 is the button
Seat 4: Duke Croix (17815 in chips) 
Seat 6: color_singleton (14400 in chips) 
Seat 9: Manon541 (6987 in chips) 
Manon541: posts small blind 50
Duke Croix: posts big blind 100
*** HOLE CARDS ***
Dealt to Duke Croix [6h 7h]
color_singleton: folds 
Manon541: folds 
Uncalled bet (50) returned to Duke Croix
Duke Croix collected 100 from pot
*** SUMMARY ***
Total pot 100 | Rake 0 
Seat 4: Duke Croix (big blind) collected (100)
Seat 6: color_singleton (button) folded before Flop (didn't bet)
Seat 9: Manon541 (small blind) folded before Flop



PokerStars Home Game Hand #217638770997: {Club #3225207}  Hold'em No Limit (50/100) - 2020/08/20 19:32:44 ET
Table 'Manuel Neuer' 9-max (Play Money) Seat #9 is the button
Seat 4: Duke Croix (17865 in chips) 
Seat 6: color_singleton (14400 in chips) 
Seat 9: Manon541 (6937 in chips) 
Duke Croix: posts small blind 50
color_singleton: posts big blind 100
*** HOLE CARDS ***
Dealt to Duke Croix [8d 2d]
Manon541: folds 
Duke Croix: calls 50
color_singleton: checks 
*** FLOP *** [6c 5h 7s]
Duke Croix: bets 200
color_singleton: calls 200
*** TURN *** [6c 5h 7s] [9d]
Duke Croix: bets 500
color_singleton: calls 500
*** RIVER *** [6c 5h 7s 9d] [Qc]
Duke Croix: bets 1400
color_singleton: folds 
Uncalled bet (1400) returned to Duke Croix
Duke Croix collected 1512 from pot
*** SUMMARY ***
Total pot 1600 | Rake 88 
Board [6c 5h 7s 9d Qc]
Seat 4: Duke Croix (small blind) collected (1512)
Seat 6: color_singleton (big blind) folded on the River
Seat 9: Manon541 (button) folded before Flop (didn't bet)



PokerStars Home Game Hand #217638783382: {Club #3225207}  Hold'em No Limit (50/100) - 2020/08/20 19:33:16 ET
Table 'Manuel Neuer' 9-max (Play Money) Seat #4 is the button
Seat 4: Duke Croix (18577 in chips) 
Seat 6: color_singleton (13600 in chips) 
Seat 9: Manon541 (6937 in chips) 
color_singleton: posts small blind 50
Manon541: posts big blind 100
*** HOLE CARDS ***
Dealt to Duke Croix [Kc Kh]
Duke Croix: raises 300 to 400
color_singleton: calls 350
Manon541: calls 300
*** FLOP *** [2c Jh 9s]
color_singleton: bets 567
Manon541: folds 
Duke Croix: calls 567
*** TURN *** [2c Jh 9s] [8c]
color_singleton: bets 1103
Duke Croix: calls 1103
*** RIVER *** [2c Jh 9s 8c] [Td]
color_singleton: bets 2145
Duke Croix: calls 2145
*** SHOW DOWN ***
color_singleton: shows [Th Ad] (a pair of Tens)
Duke Croix: shows [Kc Kh] (a pair of Kings)
Duke Croix collected 8344 from pot
*** SUMMARY ***
Total pot 8830 | Rake 486 
Board [2c Jh 9s 8c Td]
Seat 4: Duke Croix (button) showed [Kc Kh] and won (8344) with a pair of Kings
Seat 6: color_singleton (small blind) showed [Th Ad] and lost with a pair of Tens
Seat 9: Manon541 (big blind) folded on the Flop



PokerStars Home Game Hand #217638799007: {Club #3225207}  Hold'em No Limit (50/100) - 2020/08/20 19:33:56 ET
Table 'Manuel Neuer' 9-max (Play Money) Seat #6 is the button
Seat 4: Duke Croix (22706 in chips) 
Seat 6: color_singleton (9385 in chips) 
Seat 9: Manon541 (6537 in chips) 
Manon541: posts small blind 50
Duke Croix: posts big blind 100
*** HOLE CARDS ***
Dealt to Duke Croix [Kd 6s]
color_singleton: raises 100 to 200
Manon541: calls 150
Duke Croix: calls 100
*** FLOP *** [Td 6c Qh]
Manon541: checks 
Duke Croix: checks 
color_singleton: bets 283
Manon541: folds 
Duke Croix: calls 283
*** TURN *** [Td 6c Qh] [4s]
Duke Croix: checks 
color_singleton: checks 
*** RIVER *** [Td 6c Qh 4s] [Ad]
Duke Croix: bets 600
color_singleton: folds 
Uncalled bet (600) returned to Duke Croix
Duke Croix collected 1102 from pot
*** SUMMARY ***
Total pot 1166 | Rake 64 
Board [Td 6c Qh 4s Ad]
Seat 4: Duke Croix (big blind) collected (1102)
Seat 6: color_singleton (button) folded on the River
Seat 9: Manon541 (small blind) folded on the Flop



PokerStars Home Game Hand #217638816957: {Club #3225207}  Hold'em No Limit (50/100) - 2020/08/20 19:34:42 ET
Table 'Manuel Neuer' 9-max (Play Money) Seat #9 is the button
Seat 4: Duke Croix (23325 in chips) 
Seat 6: color_singleton (8902 in chips) 
Seat 9: Manon541 (6337 in chips) 
Duke Croix: posts small blind 50
color_singleton: posts big blind 100
*** HOLE CARDS ***
Dealt to Duke Croix [3c 3s]
Manon541: calls 100
Duke Croix: raises 300 to 400
color_singleton: calls 300
Manon541: calls 300
*** FLOP *** [Qc Ad 5h]
Duke Croix: checks 
color_singleton: bets 567
Manon541: folds 
Duke Croix: folds 
Uncalled bet (567) returned to color_singleton
color_singleton collected 1134 from pot
color_singleton: doesn't show hand 
*** SUMMARY ***
Total pot 1200 | Rake 66 
Board [Qc Ad 5h]
Seat 4: Duke Croix (small blind) folded on the Flop
Seat 6: color_singleton (big blind) collected (1134)
Seat 9: Manon541 (button) folded on the Flop



PokerStars Home Game Hand #217638825522: {Club #3225207}  Hold'em No Limit (50/100) - 2020/08/20 19:35:04 ET
Table 'Manuel Neuer' 9-max (Play Money) Seat #4 is the button
Seat 4: Duke Croix (22925 in chips) 
Seat 6: color_singleton (9636 in chips) 
Seat 9: Manon541 (5937 in chips) 
color_singleton: posts small blind 50
Manon541: posts big blind 100
*** HOLE CARDS ***
Dealt to Duke Croix [9s Kd]
Duke Croix: raises 300 to 400
color_singleton: folds 
Manon541: calls 300
*** FLOP *** [6s 7d 5c]
Manon541: checks 
Duke Croix: checks 
*** TURN *** [6s 7d 5c] [Qh]
Manon541: checks 
Duke Croix: checks 
*** RIVER *** [6s 7d 5c Qh] [Kh]
Manon541: checks 
Duke Croix: bets 600
Manon541: folds 
Uncalled bet (600) returned to Duke Croix
Duke Croix collected 803 from pot
*** SUMMARY ***
Total pot 850 | Rake 47 
Board [6s 7d 5c Qh Kh]
Seat 4: Duke Croix (button) collected (803)
Seat 6: color_singleton (small blind) folded before Flop
Seat 9: Manon541 (big blind) folded on the River



PokerStars Home Game Hand #217638833980: {Club #3225207}  Hold'em No Limit (50/100) - 2020/08/20 19:35:25 ET
Table 'Manuel Neuer' 9-max (Play Money) Seat #6 is the button
Seat 4: Duke Croix (23328 in chips) 
Seat 6: color_singleton (9586 in chips) 
Seat 9: Manon541 (5537 in chips) 
Manon541: posts small blind 50
Duke Croix: posts big blind 100
*** HOLE CARDS ***
Dealt to Duke Croix [2c Jc]
color_singleton: raises 200 to 300
Manon541: calls 250
Duke Croix: calls 200
*** FLOP *** [6s 3h 7s]
Manon541: checks 
Duke Croix: checks 
color_singleton: bets 425
Manon541: folds 
Duke Croix: folds 
Uncalled bet (425) returned to color_singleton
color_singleton collected 850 from pot
color_singleton: doesn't show hand 
*** SUMMARY ***
Total pot 900 | Rake 50 
Board [6s 3h 7s]
Seat 4: Duke Croix (big blind) folded on the Flop
Seat 6: color_singleton (button) collected (850)
Seat 9: Manon541 (small blind) folded on the Flop



PokerStars Home Game Hand #217638840705: {Club #3225207}  Hold'em No Limit (50/100) - 2020/08/20 19:35:43 ET
Table 'Manuel Neuer' 9-max (Play Money) Seat #9 is the button
Seat 4: Duke Croix (23028 in chips) 
Seat 6: color_singleton (10136 in chips) 
Seat 9: Manon541 (5237 in chips) 
Duke Croix: posts small blind 50
color_singleton: posts big blind 100
*** HOLE CARDS ***
Dealt to Duke Croix [9s 5s]
Manon541: calls 100
Duke Croix: calls 50
color_singleton: raises 300 to 400
Manon541: folds 
Duke Croix: folds 
Uncalled bet (300) returned to color_singleton
color_singleton collected 300 from pot
color_singleton: doesn't show hand 
*** SUMMARY ***
Total pot 300 | Rake 0 
Seat 4: Duke Croix (small blind) folded before Flop
Seat 6: color_singleton (big blind) collected (300)
Seat 9: Manon541 (button) folded before Flop



PokerStars Home Game Hand #217638846670: {Club #3225207}  Hold'em No Limit (50/100) - 2020/08/20 19:35:58 ET
Table 'Manuel Neuer' 9-max (Play Money) Seat #4 is the button
Seat 4: Duke Croix (22928 in chips) 
Seat 6: color_singleton (10336 in chips) 
Seat 9: Manon541 (5137 in chips) 
color_singleton: posts small blind 50
Manon541: posts big blind 100
*** HOLE CARDS ***
Dealt to Duke Croix [3c 5d]
Duke Croix: folds 
color_singleton: raises 200 to 300
Manon541: calls 200
*** FLOP *** [8h 9h 4s]
color_singleton: bets 283
Manon541: calls 283
*** TURN *** [8h 9h 4s] [Ks]
color_singleton: bets 551
Manon541: folds 
Uncalled bet (551) returned to color_singleton
color_singleton collected 1102 from pot
color_singleton: doesn't show hand 
*** SUMMARY ***
Total pot 1166 | Rake 64 
Board [8h 9h 4s Ks]
Seat 4: Duke Croix (button) folded before Flop (didn't bet)
Seat 6: color_singleton (small blind) collected (1102)
Seat 9: Manon541 (big blind) folded on the Turn



PokerStars Home Game Hand #217638855533: {Club #3225207}  Hold'em No Limit (50/100) - 2020/08/20 19:36:21 ET
Table 'Manuel Neuer' 9-max (Play Money) Seat #6 is the button
Seat 4: Duke Croix (22928 in chips) 
Seat 6: color_singleton (10855 in chips) 
Seat 9: Manon541 (4554 in chips) 
Manon541: posts small blind 50
Duke Croix: posts big blind 100
*** HOLE CARDS ***
Dealt to Duke Croix [3d Kc]
color_singleton: raises 250 to 350
Manon541: folds 
Duke Croix: calls 250
*** FLOP *** [3c Kd Ad]
Duke Croix: checks 
color_singleton: checks 
*** TURN *** [3c Kd Ad] [2s]
Duke Croix: bets 500
color_singleton: folds 
Uncalled bet (500) returned to Duke Croix
Duke Croix collected 709 from pot
*** SUMMARY ***
Total pot 750 | Rake 41 
Board [3c Kd Ad 2s]
Seat 4: Duke Croix (big blind) collected (709)
Seat 6: color_singleton (button) folded on the Turn
Seat 9: Manon541 (small blind) folded before Flop



PokerStars Home Game Hand #217638862948: {Club #3225207}  Hold'em No Limit (50/100) - 2020/08/20 19:36:40 ET
Table 'Manuel Neuer' 9-max (Play Money) Seat #9 is the button
Seat 4: Duke Croix (23287 in chips) 
Seat 6: color_singleton (10505 in chips) 
Seat 9: Manon541 (4504 in chips) 
Duke Croix: posts small blind 50
color_singleton: posts big blind 100
*** HOLE CARDS ***
Dealt to Duke Croix [8s 9d]
Manon541: calls 100
Duke Croix: calls 50
color_singleton: checks 
*** FLOP *** [Ac 6c 9c]
Duke Croix: checks 
color_singleton: checks 
Manon541: checks 
*** TURN *** [Ac 6c 9c] [6s]
Duke Croix: bets 100
color_singleton: folds 
Manon541: calls 100
*** RIVER *** [Ac 6c 9c 6s] [Ks]
Duke Croix: checks 
Manon541: checks 
*** SHOW DOWN ***
Duke Croix: shows [8s 9d] (two pair, Nines and Sixes)
Manon541: mucks hand 
Duke Croix collected 472 from pot
*** SUMMARY ***
Total pot 500 | Rake 28 
Board [Ac 6c 9c 6s Ks]
Seat 4: Duke Croix (small blind) showed [8s 9d] and won (472) with two pair, Nines and Sixes
Seat 6: color_singleton (big blind) folded on the Turn
Seat 9: Manon541 (button) mucked [4d Jd]



PokerStars Home Game Hand #217638877053: {Club #3225207}  Hold'em No Limit (50/100) - 2020/08/20 19:37:17 ET
Table 'Manuel Neuer' 9-max (Play Money) Seat #4 is the button
Seat 4: Duke Croix (23559 in chips) 
Seat 6: color_singleton (10405 in chips) 
Seat 9: Manon541 (4304 in chips) 
color_singleton: posts small blind 50
Manon541: posts big blind 100
*** HOLE CARDS ***
Dealt to Duke Croix [6h 2d]
Duke Croix: folds 
color_singleton: calls 50
Manon541: checks 
*** FLOP *** [Qd 6s 2h]
color_singleton: checks 
Manon541: checks 
*** TURN *** [Qd 6s 2h] [8s]
color_singleton: checks 
Manon541: checks 
*** RIVER *** [Qd 6s 2h 8s] [2s]
color_singleton: checks 
Manon541: checks 
*** SHOW DOWN ***
color_singleton: shows [Jc 3c] (a pair of Deuces)
Manon541: shows [Js 3d] (a pair of Deuces)
color_singleton collected 95 from pot
Manon541 collected 94 from pot
*** SUMMARY ***
Total pot 200 | Rake 11 
Board [Qd 6s 2h 8s 2s]
Seat 4: Duke Croix (button) folded before Flop (didn't bet)
Seat 6: color_singleton (small blind) showed [Jc 3c] and won (95) with a pair of Deuces
Seat 9: Manon541 (big blind) showed [Js 3d] and won (94) with a pair of Deuces



PokerStars Home Game Hand #217638903631: {Club #3225207}  Hold'em No Limit (50/100) - 2020/08/20 19:38:12 ET
Table 'Manuel Neuer' 9-max (Play Money) Seat #6 is the button
Seat 4: Duke Croix (23559 in chips) 
Seat 6: color_singleton (10400 in chips) 
Seat 9: Manon541 (4298 in chips) 
Manon541: posts small blind 50
Duke Croix: posts big blind 100
*** HOLE CARDS ***
Dealt to Duke Croix [Tc Ks]
color_singleton: raises 200 to 300
Manon541: folds 
Duke Croix: calls 200
*** FLOP *** [Qd 2d 6s]
Duke Croix: checks 
color_singleton: bets 307
Duke Croix: folds 
Uncalled bet (307) returned to color_singleton
color_singleton collected 614 from pot
color_singleton: doesn't show hand 
*** SUMMARY ***
Total pot 650 | Rake 36 
Board [Qd 2d 6s]
Seat 4: Duke Croix (big blind) folded on the Flop
Seat 6: color_singleton (button) collected (614)
Seat 9: Manon541 (small blind) folded before Flop



PokerStars Home Game Hand #217638909857: {Club #3225207}  Hold'em No Limit (50/100) - 2020/08/20 19:38:28 ET
Table 'Manuel Neuer' 9-max (Play Money) Seat #9 is the button
Seat 4: Duke Croix (23259 in chips) 
Seat 6: color_singleton (10714 in chips) 
Seat 9: Manon541 (4248 in chips) 
Duke Croix: posts small blind 50
color_singleton: posts big blind 100
*** HOLE CARDS ***
Dealt to Duke Croix [8h 5c]
Manon541: calls 100
Duke Croix: calls 50
color_singleton: raises 300 to 400
Manon541: calls 300
Duke Croix: folds 
*** FLOP *** [Qc As Qd]
color_singleton: checks 
Manon541: checks 
*** TURN *** [Qc As Qd] [3s]
color_singleton: checks 
Manon541: checks 
*** RIVER *** [Qc As Qd 3s] [5s]
color_singleton: checks 
Manon541: checks 
*** SHOW DOWN ***
color_singleton: shows [Tc 9d] (a pair of Queens)
Manon541: shows [Jd 8s] (a pair of Queens - Ace+Jack kicker)
Manon541 collected 850 from pot
*** SUMMARY ***
Total pot 900 | Rake 50 
Board [Qc As Qd 3s 5s]
Seat 4: Duke Croix (small blind) folded before Flop
Seat 6: color_singleton (big blind) showed [Tc 9d] and lost with a pair of Queens
Seat 9: Manon541 (button) showed [Jd 8s] and won (850) with a pair of Queens



PokerStars Home Game Hand #217638920794: {Club #3225207}  Hold'em No Limit (50/100) - 2020/08/20 19:38:56 ET
Table 'Manuel Neuer' 9-max (Play Money) Seat #4 is the button
Seat 4: Duke Croix (23159 in chips) 
Seat 6: color_singleton (10314 in chips) 
Seat 9: Manon541 (4698 in chips) 
color_singleton: posts small blind 50
Manon541: posts big blind 100
*** HOLE CARDS ***
Dealt to Duke Croix [3d 6h]
Duke Croix: folds 
color_singleton: raises 200 to 300
Manon541: folds 
Uncalled bet (200) returned to color_singleton
color_singleton collected 200 from pot
color_singleton: doesn't show hand 
*** SUMMARY ***
Total pot 200 | Rake 0 
Seat 4: Duke Croix (button) folded before Flop (didn't bet)
Seat 6: color_singleton (small blind) collected (200)
Seat 9: Manon541 (big blind) folded before Flop



PokerStars Home Game Hand #217638924168: {Club #3225207}  Hold'em No Limit (50/100) - 2020/08/20 19:39:06 ET
Table 'Manuel Neuer' 9-max (Play Money) Seat #6 is the button
Seat 4: Duke Croix (23159 in chips) 
Seat 6: color_singleton (10414 in chips) 
Seat 9: Manon541 (4598 in chips) 
Manon541: posts small blind 50
Duke Croix: posts big blind 100
*** HOLE CARDS ***
Dealt to Duke Croix [3d 7d]
color_singleton: raises 200 to 300
Manon541: calls 250
Duke Croix: folds 
*** FLOP *** [8h 5h Th]
Manon541: checks 
color_singleton: bets 661
Manon541: folds 
Uncalled bet (661) returned to color_singleton
color_singleton collected 661 from pot
color_singleton: doesn't show hand 
*** SUMMARY ***
Total pot 700 | Rake 39 
Board [8h 5h Th]
Seat 4: Duke Croix (big blind) folded before Flop
Seat 6: color_singleton (button) collected (661)
Seat 9: Manon541 (small blind) folded on the Flop



PokerStars Home Game Hand #217638931450: {Club #3225207}  Hold'em No Limit (50/100) - 2020/08/20 19:39:24 ET
Table 'Manuel Neuer' 9-max (Play Money) Seat #9 is the button
Seat 4: Duke Croix (23059 in chips) 
Seat 6: color_singleton (10775 in chips) 
Seat 9: Manon541 (4298 in chips) 
Duke Croix: posts small blind 50
color_singleton: posts big blind 100
*** HOLE CARDS ***
Dealt to Duke Croix [Kc 8h]
Manon541: calls 100
Duke Croix: calls 50
color_singleton: raises 200 to 300
Manon541: calls 200
Duke Croix: calls 200
*** FLOP *** [Ac Td 7d]
Duke Croix: checks 
color_singleton: bets 850
Manon541: folds 
Duke Croix: folds 
Uncalled bet (850) returned to color_singleton
color_singleton collected 850 from pot
color_singleton: doesn't show hand 
*** SUMMARY ***
Total pot 900 | Rake 50 
Board [Ac Td 7d]
Seat 4: Duke Croix (small blind) folded on the Flop
Seat 6: color_singleton (big blind) collected (850)
Seat 9: Manon541 (button) folded on the Flop



PokerStars Home Game Hand #217638938391: {Club #3225207}  Hold'em No Limit (50/100) - 2020/08/20 19:39:43 ET
Table 'Manuel Neuer' 9-max (Play Money) Seat #4 is the button
Seat 4: Duke Croix (22759 in chips) 
Seat 6: color_singleton (11325 in chips) 
Seat 9: Manon541 (3998 in chips) 
color_singleton: posts small blind 50
Manon541: posts big blind 100
*** HOLE CARDS ***
Dealt to Duke Croix [2c Ah]
Duke Croix: raises 200 to 300
color_singleton: folds 
Manon541: folds 
Uncalled bet (200) returned to Duke Croix
Duke Croix collected 250 from pot
*** SUMMARY ***
Total pot 250 | Rake 0 
Seat 4: Duke Croix (button) collected (250)
Seat 6: color_singleton (small blind) folded before Flop
Seat 9: Manon541 (big blind) folded before Flop



PokerStars Home Game Hand #217638941537: {Club #3225207}  Hold'em No Limit (50/100) - 2020/08/20 19:39:51 ET
Table 'Manuel Neuer' 9-max (Play Money) Seat #6 is the button
Seat 4: Duke Croix (22909 in chips) 
Seat 6: color_singleton (11275 in chips) 
Seat 9: Manon541 (3898 in chips) 
Manon541: posts small blind 50
Duke Croix: posts big blind 100
*** HOLE CARDS ***
Dealt to Duke Croix [3h 6s]
color_singleton: folds 
Manon541: calls 50
Duke Croix: checks 
*** FLOP *** [8d 2d 4s]
Manon541: checks 
Duke Croix: checks 
*** TURN *** [8d 2d 4s] [9s]
Manon541: bets 100
Duke Croix: folds 
Uncalled bet (100) returned to Manon541
Manon541 collected 189 from pot
*** SUMMARY ***
Total pot 200 | Rake 11 
Board [8d 2d 4s 9s]
Seat 4: Duke Croix (big blind) folded on the Turn
Seat 6: color_singleton (button) folded before Flop (didn't bet)
Seat 9: Manon541 (small blind) collected (189)



PokerStars Home Game Hand #217638946465: {Club #3225207}  Hold'em No Limit (50/100) - 2020/08/20 19:40:04 ET
Table 'Manuel Neuer' 9-max (Play Money) Seat #9 is the button
Seat 4: Duke Croix (22809 in chips) 
Seat 6: color_singleton (11275 in chips) 
Seat 9: Manon541 (3987 in chips) 
Duke Croix: posts small blind 50
color_singleton: posts big blind 100
*** HOLE CARDS ***
Dealt to Duke Croix [2c 9c]
Manon541: calls 100
Duke Croix: calls 50
color_singleton: raises 200 to 300
Manon541: calls 200
Duke Croix: folds 
*** FLOP *** [Jd 2d 5d]
color_singleton: bets 330
Manon541: calls 330
*** TURN *** [Jd 2d 5d] [4d]
color_singleton: bets 642
Manon541: calls 642
*** RIVER *** [Jd 2d 5d 4d] [5c]
color_singleton: checks 
Manon541: checks 
*** SHOW DOWN ***
color_singleton: shows [Td Ah] (a flush, Jack high)
Manon541: shows [Ac Qd] (a flush, Queen high)
Manon541 collected 2499 from pot
*** SUMMARY ***
Total pot 2644 | Rake 145 
Board [Jd 2d 5d 4d 5c]
Seat 4: Duke Croix (small blind) folded before Flop
Seat 6: color_singleton (big blind) showed [Td Ah] and lost with a flush, Jack high
Seat 9: Manon541 (button) showed [Ac Qd] and won (2499) with a flush, Queen high



PokerStars Home Game Hand #217638961001: {Club #3225207}  Hold'em No Limit (50/100) - 2020/08/20 19:40:42 ET
Table 'Manuel Neuer' 9-max (Play Money) Seat #4 is the button
Seat 4: Duke Croix (22709 in chips) 
Seat 6: color_singleton (10003 in chips) 
Seat 9: Manon541 (5214 in chips) 
color_singleton: posts small blind 50
Manon541: posts big blind 100
*** HOLE CARDS ***
Dealt to Duke Croix [6s Ah]
Duke Croix: raises 300 to 400
color_singleton: calls 350
Manon541: calls 300
*** FLOP *** [5s Jd Qc]
color_singleton: checks 
Manon541: checks 
Duke Croix: checks 
*** TURN *** [5s Jd Qc] [6c]
color_singleton: bets 600
Manon541: folds 
Duke Croix: folds 
Uncalled bet (600) returned to color_singleton
color_singleton collected 1134 from pot
color_singleton: doesn't show hand 
*** SUMMARY ***
Total pot 1200 | Rake 66 
Board [5s Jd Qc 6c]
Seat 4: Duke Croix (button) folded on the Turn
Seat 6: color_singleton (small blind) collected (1134)
Seat 9: Manon541 (big blind) folded on the Turn



PokerStars Home Game Hand #217638971052: {Club #3225207}  Hold'em No Limit (50/100) - 2020/08/20 19:41:09 ET
Table 'Manuel Neuer' 9-max (Play Money) Seat #6 is the button
Seat 4: Duke Croix (22309 in chips) 
Seat 6: color_singleton (10737 in chips) 
Seat 9: Manon541 (4814 in chips) 
Manon541: posts small blind 50
Duke Croix: posts big blind 100
*** HOLE CARDS ***
Dealt to Duke Croix [8c Qh]
color_singleton: raises 200 to 300
Manon541: calls 250
Duke Croix: calls 200
*** FLOP *** [6c 5h Kh]
Manon541: checks 
Duke Croix: checks 
color_singleton: checks 
*** TURN *** [6c 5h Kh] [Qd]
Manon541: checks 
Duke Croix: bets 400
color_singleton: calls 400
Manon541: calls 400
*** RIVER *** [6c 5h Kh Qd] [Ts]
Manon541: checks 
Duke Croix: checks 
color_singleton: bets 1000
Manon541: folds 
Duke Croix: folds 
Uncalled bet (1000) returned to color_singleton
color_singleton collected 1984 from pot
color_singleton: doesn't show hand 
*** SUMMARY ***
Total pot 2100 | Rake 116 
Board [6c 5h Kh Qd Ts]
Seat 4: Duke Croix (big blind) folded on the River
Seat 6: color_singleton (button) collected (1984)
Seat 9: Manon541 (small blind) folded on the River



PokerStars Home Game Hand #217638988174: {Club #3225207}  Hold'em No Limit (50/100) - 2020/08/20 19:41:54 ET
Table 'Manuel Neuer' 9-max (Play Money) Seat #9 is the button
Seat 4: Duke Croix (21609 in chips) 
Seat 6: color_singleton (12021 in chips) 
Seat 9: Manon541 (4114 in chips) 
Duke Croix: posts small blind 50
color_singleton: posts big blind 100
*** HOLE CARDS ***
Dealt to Duke Croix [Qs 9h]
Manon541: calls 100
Duke Croix: raises 200 to 300
color_singleton: calls 200
Manon541: folds 
*** FLOP *** [8c Ks Th]
Duke Croix: checks 
color_singleton: bets 330
Duke Croix: folds 
Uncalled bet (330) returned to color_singleton
color_singleton collected 661 from pot
color_singleton: doesn't show hand 
*** SUMMARY ***
Total pot 700 | Rake 39 
Board [8c Ks Th]
Seat 4: Duke Croix (small blind) folded on the Flop
Seat 6: color_singleton (big blind) collected (661)
Seat 9: Manon541 (button) folded before Flop



PokerStars Home Game Hand #217638997026: {Club #3225207}  Hold'em No Limit (50/100) - 2020/08/20 19:42:17 ET
Table 'Manuel Neuer' 9-max (Play Money) Seat #4 is the button
Seat 4: Duke Croix (21309 in chips) 
Seat 6: color_singleton (12382 in chips) 
Seat 9: Manon541 (4014 in chips) 
color_singleton: posts small blind 50
Manon541: posts big blind 100
*** HOLE CARDS ***
Dealt to Duke Croix [7h 8d]
Duke Croix: raises 200 to 300
color_singleton: calls 250
Manon541: calls 200
*** FLOP *** [4s Ks Qh]
color_singleton: checks 
Manon541: bets 425
Duke Croix: folds 
color_singleton: folds 
Uncalled bet (425) returned to Manon541
Manon541 collected 850 from pot
*** SUMMARY ***
Total pot 900 | Rake 50 
Board [4s Ks Qh]
Seat 4: Duke Croix (button) folded on the Flop
Seat 6: color_singleton (small blind) folded on the Flop
Seat 9: Manon541 (big blind) collected (850)



PokerStars Home Game Hand #217639004354: {Club #3225207}  Hold'em No Limit (50/100) - 2020/08/20 19:42:36 ET
Table 'Manuel Neuer' 9-max (Play Money) Seat #6 is the button
Seat 4: Duke Croix (21009 in chips) 
Seat 6: color_singleton (12082 in chips) 
Seat 9: Manon541 (4564 in chips) 
Manon541: posts small blind 50
Duke Croix: posts big blind 100
*** HOLE CARDS ***
Dealt to Duke Croix [9c Jd]
color_singleton: raises 100 to 200
Manon541: calls 150
Duke Croix: calls 100
*** FLOP *** [Qh 9s Tc]
Manon541: checks 
Duke Croix: bets 400
color_singleton: folds 
Manon541: folds 
Uncalled bet (400) returned to Duke Croix
Duke Croix collected 567 from pot
*** SUMMARY ***
Total pot 600 | Rake 33 
Board [Qh 9s Tc]
Seat 4: Duke Croix (big blind) collected (567)
Seat 6: color_singleton (button) folded on the Flop
Seat 9: Manon541 (small blind) folded on the Flop



PokerStars Home Game Hand #217639014089: {Club #3225207}  Hold'em No Limit (50/100) - 2020/08/20 19:43:01 ET
Table 'Manuel Neuer' 9-max (Play Money) Seat #9 is the button
Seat 4: Duke Croix (21376 in chips) 
Seat 6: color_singleton (11882 in chips) 
Seat 9: Manon541 (4364 in chips) 
Duke Croix: posts small blind 50
color_singleton: posts big blind 100
*** HOLE CARDS ***
Dealt to Duke Croix [6d Kc]
Manon541: calls 100
Duke Croix: calls 50
color_singleton: checks 
*** FLOP *** [Ts 9d 3h]
Duke Croix: checks 
color_singleton: bets 141
Manon541: calls 141
Duke Croix: folds 
*** TURN *** [Ts 9d 3h] [Td]
color_singleton: bets 275
Manon541: calls 275
*** RIVER *** [Ts 9d 3h Td] [Ac]
color_singleton: checks 
Manon541: checks 
*** SHOW DOWN ***
color_singleton: shows [7c Qs] (a pair of Tens)
Manon541: shows [4h 9h] (two pair, Tens and Nines)
Manon541 collected 1070 from pot
*** SUMMARY ***
Total pot 1132 | Rake 62 
Board [Ts 9d 3h Td Ac]
Seat 4: Duke Croix (small blind) folded on the Flop
Seat 6: color_singleton (big blind) showed [7c Qs] and lost with a pair of Tens
Seat 9: Manon541 (button) showed [4h 9h] and won (1070) with two pair, Tens and Nines



PokerStars Home Game Hand #217639024555: {Club #3225207}  Hold'em No Limit (50/100) - 2020/08/20 19:43:29 ET
Table 'Manuel Neuer' 9-max (Play Money) Seat #4 is the button
Seat 4: Duke Croix (21276 in chips) 
Seat 6: color_singleton (11366 in chips) 
Seat 9: Manon541 (4918 in chips) 
color_singleton: posts small blind 50
Manon541: posts big blind 100
*** HOLE CARDS ***
Dealt to Duke Croix [8d Kh]
Duke Croix: raises 200 to 300
color_singleton: calls 250
Manon541: calls 200
*** FLOP *** [7h Tc 6h]
color_singleton: checks 
Manon541: checks 
Duke Croix: checks 
*** TURN *** [7h Tc 6h] [3d]
color_singleton: bets 425
Manon541: folds 
Duke Croix: folds 
Uncalled bet (425) returned to color_singleton
color_singleton collected 850 from pot
color_singleton: doesn't show hand 
*** SUMMARY ***
Total pot 900 | Rake 50 
Board [7h Tc 6h 3d]
Seat 4: Duke Croix (button) folded on the Turn
Seat 6: color_singleton (small blind) collected (850)
Seat 9: Manon541 (big blind) folded on the Turn



PokerStars Home Game Hand #217639031850: {Club #3225207}  Hold'em No Limit (50/100) - 2020/08/20 19:43:48 ET
Table 'Manuel Neuer' 9-max (Play Money) Seat #6 is the button
Seat 4: Duke Croix (20976 in chips) 
Seat 6: color_singleton (11916 in chips) 
Seat 9: Manon541 (4618 in chips) 
Manon541: posts small blind 50
Duke Croix: posts big blind 100
*** HOLE CARDS ***
Dealt to Duke Croix [Jh Qd]
color_singleton: raises 200 to 300
Manon541: folds 
Duke Croix: raises 400 to 700
color_singleton: calls 400
*** FLOP *** [Ad 3d 4d]
Duke Croix: bets 800
color_singleton: folds 
Uncalled bet (800) returned to Duke Croix
Duke Croix collected 1370 from pot
*** SUMMARY ***
Total pot 1450 | Rake 80 
Board [Ad 3d 4d]
Seat 4: Duke Croix (big blind) collected (1370)
Seat 6: color_singleton (button) folded on the Flop
Seat 9: Manon541 (small blind) folded before Flop



PokerStars Home Game Hand #217639040423: {Club #3225207}  Hold'em No Limit (50/100) - 2020/08/20 19:44:11 ET
Table 'Manuel Neuer' 9-max (Play Money) Seat #9 is the button
Seat 4: Duke Croix (21646 in chips) 
Seat 6: color_singleton (11216 in chips) 
Seat 9: Manon541 (4568 in chips) 
Duke Croix: posts small blind 50
color_singleton: posts big blind 100
*** HOLE CARDS ***
Dealt to Duke Croix [Ts Ad]
Manon541: calls 100
Duke Croix: raises 300 to 400
color_singleton: calls 300
Manon541: calls 300
*** FLOP *** [6c 4h 3c]
Duke Croix: checks 
color_singleton: bets 567
Manon541: folds 
Duke Croix: folds 
Uncalled bet (567) returned to color_singleton
color_singleton collected 1134 from pot
color_singleton: doesn't show hand 
*** SUMMARY ***
Total pot 1200 | Rake 66 
Board [6c 4h 3c]
Seat 4: Duke Croix (small blind) folded on the Flop
Seat 6: color_singleton (big blind) collected (1134)
Seat 9: Manon541 (button) folded on the Flop



PokerStars Home Game Hand #217639054241: {Club #3225207}  Hold'em No Limit (50/100) - 2020/08/20 19:44:48 ET
Table 'Manuel Neuer' 9-max (Play Money) Seat #4 is the button
Seat 4: Duke Croix (21246 in chips) 
Seat 6: color_singleton (11950 in chips) 
Seat 9: Manon541 (4168 in chips) 
color_singleton: posts small blind 50
Manon541: posts big blind 100
*** HOLE CARDS ***
Dealt to Duke Croix [9d 5s]
Duke Croix: folds 
color_singleton: raises 200 to 300
Manon541: calls 200
*** FLOP *** [Qd 3s 6h]
color_singleton: bets 283
Manon541: calls 283
*** TURN *** [Qd 3s 6h] [9s]
color_singleton: checks 
Manon541: checks 
*** RIVER *** [Qd 3s 6h 9s] [Jd]
color_singleton: checks 
Manon541: checks 
*** SHOW DOWN ***
color_singleton: shows [Kh 7d] (high card King)
Manon541: mucks hand 
color_singleton collected 1102 from pot
*** SUMMARY ***
Total pot 1166 | Rake 64 
Board [Qd 3s 6h 9s Jd]
Seat 4: Duke Croix (button) folded before Flop (didn't bet)
Seat 6: color_singleton (small blind) showed [Kh 7d] and won (1102) with high card King
Seat 9: Manon541 (big blind) mucked [Kd 2c]



PokerStars Home Game Hand #217639072178: {Club #3225207}  Hold'em No Limit (50/100) - 2020/08/20 19:45:14 ET
Table 'Manuel Neuer' 9-max (Play Money) Seat #6 is the button
Seat 4: Duke Croix (21246 in chips) 
Seat 6: color_singleton (12469 in chips) 
Seat 9: Manon541 (3585 in chips) 
Manon541: posts small blind 50
Duke Croix: posts big blind 100
*** HOLE CARDS ***
Dealt to Duke Croix [Ks 4c]
color_singleton: calls 100
Manon541: folds 
Duke Croix: checks 
*** FLOP *** [6c 9h Th]
Duke Croix: checks 
color_singleton: checks 
*** TURN *** [6c 9h Th] [8c]
Duke Croix: checks 
color_singleton: checks 
*** RIVER *** [6c 9h Th 8c] [Qc]
Duke Croix: checks 
color_singleton: checks 
*** SHOW DOWN ***
Duke Croix: shows [Ks 4c] (high card King)
color_singleton: shows [Js 2s] (a straight, Eight to Queen)
color_singleton collected 236 from pot
*** SUMMARY ***
Total pot 250 | Rake 14 
Board [6c 9h Th 8c Qc]
Seat 4: Duke Croix (big blind) showed [Ks 4c] and lost with high card King
Seat 6: color_singleton (button) showed [Js 2s] and won (236) with a straight, Eight to Queen
Seat 9: Manon541 (small blind) folded before Flop



PokerStars Home Game Hand #217639080043: {Club #3225207}  Hold'em No Limit (50/100) - 2020/08/20 19:45:35 ET
Table 'Manuel Neuer' 9-max (Play Money) Seat #9 is the button
Seat 4: Duke Croix (21146 in chips) 
Seat 6: color_singleton (12605 in chips) 
Seat 9: Manon541 (3535 in chips) 
Duke Croix: posts small blind 50
color_singleton: posts big blind 100
*** HOLE CARDS ***
Dealt to Duke Croix [Th Td]
Manon541: calls 100
Duke Croix: raises 300 to 400
color_singleton: folds 
Manon541: folds 
Uncalled bet (300) returned to Duke Croix
Duke Croix collected 300 from pot
*** SUMMARY ***
Total pot 300 | Rake 0 
Seat 4: Duke Croix (small blind) collected (300)
Seat 6: color_singleton (big blind) folded before Flop
Seat 9: Manon541 (button) folded before Flop



PokerStars Home Game Hand #217639084452: {Club #3225207}  Hold'em No Limit (50/100) - 2020/08/20 19:45:47 ET
Table 'Manuel Neuer' 9-max (Play Money) Seat #4 is the button
Seat 4: Duke Croix (21346 in chips) 
Seat 6: color_singleton (12505 in chips) 
Seat 9: Manon541 (3435 in chips) 
color_singleton: posts small blind 50
Manon541: posts big blind 100
*** HOLE CARDS ***
Dealt to Duke Croix [Jh 6s]
Duke Croix: calls 100
color_singleton: raises 100 to 200
Manon541: calls 100
Duke Croix: calls 100
*** FLOP *** [5c 4d 2h]
color_singleton: checks 
Manon541: checks 
Duke Croix: checks 
*** TURN *** [5c 4d 2h] [Ac]
color_singleton: checks 
Manon541: checks 
Duke Croix: checks 
*** RIVER *** [5c 4d 2h Ac] [7d]
color_singleton: bets 283
Manon541: raises 283 to 566
Duke Croix: folds 
color_singleton: calls 283
*** SHOW DOWN ***
Manon541: shows [8c 8d] (a pair of Eights)
color_singleton: shows [As Ks] (a pair of Aces)
color_singleton collected 1637 from pot
*** SUMMARY ***
Total pot 1732 | Rake 95 
Board [5c 4d 2h Ac 7d]
Seat 4: Duke Croix (button) folded on the River
Seat 6: color_singleton (small blind) showed [As Ks] and won (1637) with a pair of Aces
Seat 9: Manon541 (big blind) showed [8c 8d] and lost with a pair of Eights



PokerStars Home Game Hand #217639096249: {Club #3225207}  Hold'em No Limit (50/100) - 2020/08/20 19:46:18 ET
Table 'Manuel Neuer' 9-max (Play Money) Seat #6 is the button
Seat 4: Duke Croix (21146 in chips) 
Seat 6: color_singleton (13376 in chips) 
Seat 9: Manon541 (2669 in chips) 
Manon541: posts small blind 50
Duke Croix: posts big blind 100
*** HOLE CARDS ***
Dealt to Duke Croix [6c 9s]
color_singleton: calls 100
Manon541: calls 50
Duke Croix: checks 
*** FLOP *** [9h 3c 8h]
Manon541: checks 
Duke Croix: bets 150
color_singleton: calls 150
Manon541: calls 150
*** TURN *** [9h 3c 8h] [8s]
Manon541: checks 
Duke Croix: bets 500
color_singleton: calls 500
Manon541: folds 
*** RIVER *** [9h 3c 8h 8s] [5d]
Duke Croix: bets 900
color_singleton: folds 
Uncalled bet (900) returned to Duke Croix
Duke Croix collected 1654 from pot
*** SUMMARY ***
Total pot 1750 | Rake 96 
Board [9h 3c 8h 8s 5d]
Seat 4: Duke Croix (big blind) collected (1654)
Seat 6: color_singleton (button) folded on the River
Seat 9: Manon541 (small blind) folded on the Turn



PokerStars Home Game Hand #217639112811: {Club #3225207}  Hold'em No Limit (50/100) - 2020/08/20 19:47:03 ET
Table 'Manuel Neuer' 9-max (Play Money) Seat #9 is the button
Seat 4: Duke Croix (22050 in chips) 
Seat 6: color_singleton (12626 in chips) 
Seat 9: Manon541 (2419 in chips) 
Duke Croix: posts small blind 50
color_singleton: posts big blind 100
*** HOLE CARDS ***
Dealt to Duke Croix [4d Qs]
Manon541: calls 100
Duke Croix: calls 50
color_singleton: raises 200 to 300
Manon541: folds 
Duke Croix: folds 
Uncalled bet (200) returned to color_singleton
color_singleton collected 300 from pot
color_singleton: doesn't show hand 
*** SUMMARY ***
Total pot 300 | Rake 0 
Seat 4: Duke Croix (small blind) folded before Flop
Seat 6: color_singleton (big blind) collected (300)
Seat 9: Manon541 (button) folded before Flop



PokerStars Home Game Hand #217639119084: {Club #3225207}  Hold'em No Limit (50/100) - 2020/08/20 19:47:20 ET
Table 'Manuel Neuer' 9-max (Play Money) Seat #4 is the button
Seat 4: Duke Croix (21950 in chips) 
Seat 6: color_singleton (12826 in chips) 
Seat 9: Manon541 (2319 in chips) 
color_singleton: posts small blind 50
Manon541: posts big blind 100
*** HOLE CARDS ***
Dealt to Duke Croix [8c 6c]
Duke Croix: raises 200 to 300
color_singleton: folds 
Manon541: calls 200
*** FLOP *** [4s Ks Jd]
Manon541: checks 
Duke Croix: checks 
*** TURN *** [4s Ks Jd] [2c]
Manon541: checks 
Duke Croix: checks 
*** RIVER *** [4s Ks Jd 2c] [Qh]
Manon541: checks 
Duke Croix: checks 
*** SHOW DOWN ***
Manon541: shows [5s Ad] (high card Ace)
Duke Croix: mucks hand 
Manon541 collected 614 from pot
*** SUMMARY ***
Total pot 650 | Rake 36 
Board [4s Ks Jd 2c Qh]
Seat 4: Duke Croix (button) mucked [8c 6c]
Seat 6: color_singleton (small blind) folded before Flop
Seat 9: Manon541 (big blind) showed [5s Ad] and won (614) with high card Ace



PokerStars Home Game Hand #217639127167: {Club #3225207}  Hold'em No Limit (50/100) - 2020/08/20 19:47:41 ET
Table 'Manuel Neuer' 9-max (Play Money) Seat #6 is the button
Seat 4: Duke Croix (21650 in chips) 
Seat 6: color_singleton (12776 in chips) 
Seat 9: Manon541 (2633 in chips) 
Manon541: posts small blind 50
Duke Croix: posts big blind 100
*** HOLE CARDS ***
Dealt to Duke Croix [5h Ks]
color_singleton: raises 100 to 200
Manon541: calls 150
Duke Croix: calls 100
*** FLOP *** [Kd 6d Ac]
Manon541: checks 
Duke Croix: checks 
color_singleton: checks 
*** TURN *** [Kd 6d Ac] [Ad]
Manon541: checks 
Duke Croix: bets 283
color_singleton: calls 283
Manon541: folds 
*** RIVER *** [Kd 6d Ac Ad] [Ah]
Duke Croix: bets 999
color_singleton: calls 999
*** SHOW DOWN ***
Duke Croix: shows [5h Ks] (a full house, Aces full of Kings)
color_singleton: mucks hand 
Duke Croix collected 2990 from pot
*** SUMMARY ***
Total pot 3164 | Rake 174 
Board [Kd 6d Ac Ad Ah]
Seat 4: Duke Croix (big blind) showed [5h Ks] and won (2990) with a full house, Aces full of Kings
Seat 6: color_singleton (button) mucked [Qs 6c]
Seat 9: Manon541 (small blind) folded on the Turn



PokerStars Home Game Hand #217639139742: {Club #3225207}  Hold'em No Limit (50/100) - 2020/08/20 19:48:15 ET
Table 'Manuel Neuer' 9-max (Play Money) Seat #9 is the button
Seat 4: Duke Croix (23158 in chips) 
Seat 6: color_singleton (11294 in chips) 
Seat 9: Manon541 (2433 in chips) 
Duke Croix: posts small blind 50
color_singleton: posts big blind 100
*** HOLE CARDS ***
Dealt to Duke Croix [5d 3c]
Manon541: calls 100
Duke Croix: calls 50
color_singleton: raises 100 to 200
Manon541: calls 100
Duke Croix: calls 100
*** FLOP *** [5c 7s 4h]
Duke Croix: bets 300
color_singleton: folds 
Manon541: calls 300
*** TURN *** [5c 7s 4h] [Js]
Duke Croix: checks 
Manon541: checks 
*** RIVER *** [5c 7s 4h Js] [3s]
Duke Croix: bets 700
Manon541: folds 
Uncalled bet (700) returned to Duke Croix
Duke Croix collected 1134 from pot
*** SUMMARY ***
Total pot 1200 | Rake 66 
Board [5c 7s 4h Js 3s]
Seat 4: Duke Croix (small blind) collected (1134)
Seat 6: color_singleton (big blind) folded on the Flop
Seat 9: Manon541 (button) folded on the River



PokerStars Home Game Hand #217639154747: {Club #3225207}  Hold'em No Limit (50/100) - 2020/08/20 19:48:55 ET
Table 'Manuel Neuer' 9-max (Play Money) Seat #4 is the button
Seat 4: Duke Croix (23792 in chips) 
Seat 6: color_singleton (11094 in chips) 
Seat 9: Manon541 (1933 in chips) 
color_singleton: posts small blind 50
Manon541: posts big blind 100
*** HOLE CARDS ***
Dealt to Duke Croix [8d Kc]
Duke Croix: raises 200 to 300
color_singleton: folds 
Manon541: calls 200
*** FLOP *** [9s 9c 8h]
Manon541: checks 
Duke Croix: bets 400
Manon541: folds 
Uncalled bet (400) returned to Duke Croix
Duke Croix collected 614 from pot
*** SUMMARY ***
Total pot 650 | Rake 36 
Board [9s 9c 8h]
Seat 4: Duke Croix (button) collected (614)
Seat 6: color_singleton (small blind) folded before Flop
Seat 9: Manon541 (big blind) folded on the Flop



PokerStars Home Game Hand #217639160655: {Club #3225207}  Hold'em No Limit (50/100) - 2020/08/20 19:49:10 ET
Table 'Manuel Neuer' 9-max (Play Money) Seat #6 is the button
Seat 4: Duke Croix (24106 in chips) 
Seat 6: color_singleton (11044 in chips) 
Seat 9: Manon541 (1633 in chips) 
Manon541: posts small blind 50
Duke Croix: posts big blind 100
*** HOLE CARDS ***
Dealt to Duke Croix [3d 8d]
color_singleton: raises 100 to 200
Manon541: calls 150
Duke Croix: calls 100
*** FLOP *** [Jh 3h 6c]
Manon541: checks 
Duke Croix: bets 300
color_singleton: calls 300
Manon541: folds 
*** TURN *** [Jh 3h 6c] [Jd]
Duke Croix: bets 600
color_singleton: raises 600 to 1200
Duke Croix: folds 
Uncalled bet (600) returned to color_singleton
color_singleton collected 2268 from pot
color_singleton: doesn't show hand 
*** SUMMARY ***
Total pot 2400 | Rake 132 
Board [Jh 3h 6c Jd]
Seat 4: Duke Croix (big blind) folded on the Turn
Seat 6: color_singleton (button) collected (2268)
Seat 9: Manon541 (small blind) folded on the Flop



PokerStars Home Game Hand #217639171514: {Club #3225207}  Hold'em No Limit (50/100) - 2020/08/20 19:49:40 ET
Table 'Manuel Neuer' 9-max (Play Money) Seat #9 is the button
Seat 4: Duke Croix (23006 in chips) 
Seat 6: color_singleton (12212 in chips) 
Seat 9: Manon541 (1433 in chips) 
Duke Croix: posts small blind 50
color_singleton: posts big blind 100
*** HOLE CARDS ***
Dealt to Duke Croix [Jc 8h]
Manon541: calls 100
Duke Croix: calls 50
color_singleton: checks 
*** FLOP *** [4s 4c Js]
Duke Croix: bets 200
color_singleton: folds 
Manon541: folds 
Uncalled bet (200) returned to Duke Croix
Duke Croix collected 283 from pot
*** SUMMARY ***
Total pot 300 | Rake 17 
Board [4s 4c Js]
Seat 4: Duke Croix (small blind) collected (283)
Seat 6: color_singleton (big blind) folded on the Flop
Seat 9: Manon541 (button) folded on the Flop



PokerStars Home Game Hand #217639176438: {Club #3225207}  Hold'em No Limit (50/100) - 2020/08/20 19:49:53 ET
Table 'Manuel Neuer' 9-max (Play Money) Seat #4 is the button
Seat 4: Duke Croix (23189 in chips) 
Seat 6: color_singleton (12112 in chips) 
Seat 9: Manon541 (1333 in chips) 
color_singleton: posts small blind 50
Manon541: posts big blind 100
*** HOLE CARDS ***
Dealt to Duke Croix [7d 7s]
Duke Croix: raises 400 to 500
color_singleton: folds 
Manon541: folds 
Uncalled bet (400) returned to Duke Croix
Duke Croix collected 250 from pot
*** SUMMARY ***
Total pot 250 | Rake 0 
Seat 4: Duke Croix (button) collected (250)
Seat 6: color_singleton (small blind) folded before Flop
Seat 9: Manon541 (big blind) folded before Flop



PokerStars Home Game Hand #217639179826: {Club #3225207}  Hold'em No Limit (50/100) - 2020/08/20 19:50:02 ET
Table 'Manuel Neuer' 9-max (Play Money) Seat #6 is the button
Seat 4: Duke Croix (23339 in chips) 
Seat 6: color_singleton (12062 in chips) 
Seat 9: Manon541 (1233 in chips) 
Manon541: posts small blind 50
Duke Croix: posts big blind 100
*** HOLE CARDS ***
Dealt to Duke Croix [7s Kd]
color_singleton: folds 
Manon541: calls 50
Duke Croix: raises 300 to 400
Manon541: folds 
Uncalled bet (300) returned to Duke Croix
Duke Croix collected 200 from pot
*** SUMMARY ***
Total pot 200 | Rake 0 
Seat 4: Duke Croix (big blind) collected (200)
Seat 6: color_singleton (button) folded before Flop (didn't bet)
Seat 9: Manon541 (small blind) folded before Flop



PokerStars Home Game Hand #217639187243: {Club #3225207}  Hold'em No Limit (50/100) - 2020/08/20 19:50:22 ET
Table 'Manuel Neuer' 9-max (Play Money) Seat #9 is the button
Seat 4: Duke Croix (23439 in chips) 
Seat 6: color_singleton (12062 in chips) 
Seat 9: Manon541 (1133 in chips) 
Duke Croix: posts small blind 50
color_singleton: posts big blind 100
*** HOLE CARDS ***
Dealt to Duke Croix [Th 7s]
Manon541: calls 100
Duke Croix: calls 50
color_singleton: raises 200 to 300
Manon541: calls 200
Duke Croix: calls 200
*** FLOP *** [8d 2s 5s]
Duke Croix: checks 
color_singleton: bets 425
Manon541: calls 425
Duke Croix: folds 
*** TURN *** [8d 2s 5s] [7h]
color_singleton: checks 
Manon541: checks 
*** RIVER *** [8d 2s 5s 7h] [6h]
color_singleton: checks 
Manon541: checks 
*** SHOW DOWN ***
color_singleton: shows [Ad 2h] (a pair of Deuces)
Manon541: shows [6s Js] (a pair of Sixes)
Manon541 collected 1654 from pot
*** SUMMARY ***
Total pot 1750 | Rake 96 
Board [8d 2s 5s 7h 6h]
Seat 4: Duke Croix (small blind) folded on the Flop
Seat 6: color_singleton (big blind) showed [Ad 2h] and lost with a pair of Deuces
Seat 9: Manon541 (button) showed [6s Js] and won (1654) with a pair of Sixes



PokerStars Home Game Hand #217639200183: {Club #3225207}  Hold'em No Limit (50/100) - 2020/08/20 19:50:55 ET
Table 'Manuel Neuer' 9-max (Play Money) Seat #4 is the button
Seat 4: Duke Croix (23139 in chips) 
Seat 6: color_singleton (11337 in chips) 
Seat 9: Manon541 (2062 in chips) 
color_singleton: posts small blind 50
Manon541: posts big blind 100
*** HOLE CARDS ***
Dealt to Duke Croix [5c Jc]
Duke Croix: calls 100
color_singleton: calls 50
Manon541: checks 
*** FLOP *** [Td Js Kc]
color_singleton: checks 
Manon541: bets 141
Duke Croix: calls 141
color_singleton: folds 
*** TURN *** [Td Js Kc] [Th]
Manon541: bets 275
Duke Croix: calls 275
*** RIVER *** [Td Js Kc Th] [Kd]
Manon541: bets 535
Duke Croix: calls 535
*** SHOW DOWN ***
Manon541: shows [Jh Kh] (a full house, Kings full of Jacks)
Duke Croix: mucks hand 
Manon541 collected 2081 from pot
*** SUMMARY ***
Total pot 2202 | Rake 121 
Board [Td Js Kc Th Kd]
Seat 4: Duke Croix (button) mucked [5c Jc]
Seat 6: color_singleton (small blind) folded on the Flop
Seat 9: Manon541 (big blind) showed [Jh Kh] and won (2081) with a full house, Kings full of Jacks



PokerStars Home Game Hand #217639218053: {Club #3225207}  Hold'em No Limit (50/100) - 2020/08/20 19:51:43 ET
Table 'Manuel Neuer' 9-max (Play Money) Seat #6 is the button
Seat 4: Duke Croix (22088 in chips) 
Seat 6: color_singleton (11237 in chips) 
Seat 9: Manon541 (3092 in chips) 
Manon541: posts small blind 50
Duke Croix: posts big blind 100
*** HOLE CARDS ***
Dealt to Duke Croix [Qc 7c]
color_singleton: calls 100
Manon541: calls 50
Duke Croix: checks 
*** FLOP *** [5c 4s 5h]
Manon541: checks 
Duke Croix: checks 
color_singleton: bets 141
Manon541: calls 141
Duke Croix: calls 141
*** TURN *** [5c 4s 5h] [7h]
Manon541: checks 
Duke Croix: bets 400
color_singleton: calls 400
Manon541: folds 
*** RIVER *** [5c 4s 5h 7h] [Ts]
Duke Croix: bets 700
color_singleton: raises 700 to 1400
Duke Croix: calls 700
*** SHOW DOWN ***
color_singleton: shows [6d 3c] (a straight, Three to Seven)
Duke Croix: mucks hand 
color_singleton collected 4085 from pot
*** SUMMARY ***
Total pot 4323 | Rake 238 
Board [5c 4s 5h 7h Ts]
Seat 4: Duke Croix (big blind) mucked [Qc 7c]
Seat 6: color_singleton (button) showed [6d 3c] and won (4085) with a straight, Three to Seven
Seat 9: Manon541 (small blind) folded on the Turn



PokerStars Home Game Hand #217639239562: {Club #3225207}  Hold'em No Limit (50/100) - 2020/08/20 19:52:32 ET
Table 'Manuel Neuer' 9-max (Play Money) Seat #9 is the button
Seat 4: Duke Croix (20047 in chips) 
Seat 6: color_singleton (13281 in chips) 
Seat 9: Manon541 (2851 in chips) 
Duke Croix: posts small blind 50
color_singleton: posts big blind 100
*** HOLE CARDS ***
Dealt to Duke Croix [Ah 7s]
Manon541: calls 100
Duke Croix: calls 50
color_singleton: raises 300 to 400
Manon541: folds 
Duke Croix: calls 300
*** FLOP *** [9d Kd 3c]
Duke Croix: checks 
color_singleton: bets 425
Duke Croix: folds 
Uncalled bet (425) returned to color_singleton
color_singleton collected 850 from pot
color_singleton: doesn't show hand 
*** SUMMARY ***
Total pot 900 | Rake 50 
Board [9d Kd 3c]
Seat 4: Duke Croix (small blind) folded on the Flop
Seat 6: color_singleton (big blind) collected (850)
Seat 9: Manon541 (button) folded before Flop



PokerStars Home Game Hand #217639248757: {Club #3225207}  Hold'em No Limit (50/100) - 2020/08/20 19:52:57 ET
Table 'Manuel Neuer' 9-max (Play Money) Seat #4 is the button
Seat 4: Duke Croix (19647 in chips) 
Seat 6: color_singleton (13731 in chips) 
Seat 9: Manon541 (2751 in chips) 
color_singleton: posts small blind 50
Manon541: posts big blind 100
*** HOLE CARDS ***
Dealt to Duke Croix [5c 5h]
Duke Croix: raises 300 to 400
color_singleton: folds 
Manon541: calls 300
*** FLOP *** [8c 3d 9c]
Manon541: checks 
Duke Croix: bets 500
Manon541: folds 
Uncalled bet (500) returned to Duke Croix
Duke Croix collected 803 from pot
*** SUMMARY ***
Total pot 850 | Rake 47 
Board [8c 3d 9c]
Seat 4: Duke Croix (button) collected (803)
Seat 6: color_singleton (small blind) folded before Flop
Seat 9: Manon541 (big blind) folded on the Flop



PokerStars Home Game Hand #217639253987: {Club #3225207}  Hold'em No Limit (50/100) - 2020/08/20 19:53:11 ET
Table 'Manuel Neuer' 9-max (Play Money) Seat #6 is the button
Seat 4: Duke Croix (20050 in chips) 
Seat 6: color_singleton (13681 in chips) 
Seat 9: Manon541 (2351 in chips) 
Manon541: posts small blind 50
Duke Croix: posts big blind 100
*** HOLE CARDS ***
Dealt to Duke Croix [9s Ac]
color_singleton: raises 100 to 200
Manon541: calls 150
Duke Croix: raises 400 to 600
color_singleton: calls 400
Manon541: folds 
*** FLOP *** [Jh Ts Kc]
Duke Croix: bets 700
color_singleton: folds 
Uncalled bet (700) returned to Duke Croix
Duke Croix collected 1323 from pot
*** SUMMARY ***
Total pot 1400 | Rake 77 
Board [Jh Ts Kc]
Seat 4: Duke Croix (big blind) collected (1323)
Seat 6: color_singleton (button) folded on the Flop
Seat 9: Manon541 (small blind) folded before Flop



PokerStars Home Game Hand #217639263775: {Club #3225207}  Hold'em No Limit (50/100) - 2020/08/20 19:53:38 ET
Table 'Manuel Neuer' 9-max (Play Money) Seat #9 is the button
Seat 4: Duke Croix (20773 in chips) 
Seat 6: color_singleton (13081 in chips) 
Seat 9: Manon541 (2151 in chips) 
Duke Croix: posts small blind 50
color_singleton: posts big blind 100
*** HOLE CARDS ***
Dealt to Duke Croix [6s Kc]
Manon541: calls 100
Duke Croix: calls 50
color_singleton: raises 200 to 300
Manon541: calls 200
Duke Croix: calls 200
*** FLOP *** [4d 7h 4h]
Duke Croix: checks 
color_singleton: checks 
Manon541: checks 
*** TURN *** [4d 7h 4h] [Qc]
Duke Croix: checks 
color_singleton: bets 425
Manon541: calls 425
Duke Croix: folds 
*** RIVER *** [4d 7h 4h Qc] [9h]
color_singleton: bets 827
Manon541: folds 
Uncalled bet (827) returned to color_singleton
color_singleton collected 1654 from pot
color_singleton: doesn't show hand 
*** SUMMARY ***
Total pot 1750 | Rake 96 
Board [4d 7h 4h Qc 9h]
Seat 4: Duke Croix (small blind) folded on the Turn
Seat 6: color_singleton (big blind) collected (1654)
Seat 9: Manon541 (button) folded on the River



PokerStars Home Game Hand #217639276694: {Club #3225207}  Hold'em No Limit (50/100) - 2020/08/20 19:54:14 ET
Table 'Manuel Neuer' 9-max (Play Money) Seat #4 is the button
Seat 4: Duke Croix (20473 in chips) 
Seat 6: color_singleton (14010 in chips) 
Seat 9: Manon541 (1426 in chips) 
color_singleton: posts small blind 50
Manon541: posts big blind 100
*** HOLE CARDS ***
Dealt to Duke Croix [Ac 5d]
Duke Croix: raises 300 to 400
color_singleton: calls 350
Manon541: folds 
*** FLOP *** [7h Kd Qc]
color_singleton: checks 
Duke Croix: checks 
*** TURN *** [7h Kd Qc] [Js]
color_singleton: checks 
Duke Croix: checks 
*** RIVER *** [7h Kd Qc Js] [8d]
color_singleton: checks 
Duke Croix: checks 
*** SHOW DOWN ***
color_singleton: shows [9h Qh] (a pair of Queens)
Duke Croix: mucks hand 
color_singleton collected 850 from pot
*** SUMMARY ***
Total pot 900 | Rake 50 
Board [7h Kd Qc Js 8d]
Seat 4: Duke Croix (button) mucked [Ac 5d]
Seat 6: color_singleton (small blind) showed [9h Qh] and won (850) with a pair of Queens
Seat 9: Manon541 (big blind) folded before Flop



PokerStars Home Game Hand #217639287560: {Club #3225207}  Hold'em No Limit (50/100) - 2020/08/20 19:54:44 ET
Table 'Manuel Neuer' 9-max (Play Money) Seat #6 is the button
Seat 4: Duke Croix (20073 in chips) 
Seat 6: color_singleton (14460 in chips) 
Seat 9: Manon541 (1326 in chips) 
Manon541: posts small blind 50
Duke Croix: posts big blind 100
*** HOLE CARDS ***
Dealt to Duke Croix [8c 5h]
color_singleton: raises 100 to 200
Manon541: calls 150
Duke Croix: calls 100
*** FLOP *** [Td 4h Kd]
Manon541: bets 283
Duke Croix: folds 
color_singleton: calls 283
*** TURN *** [Td 4h Kd] [9d]
Manon541: bets 551
color_singleton: calls 551
*** RIVER *** [Td 4h Kd 9d] [6s]
Manon541: bets 292 and is all-in
color_singleton: calls 292
*** SHOW DOWN ***
Manon541: shows [3c Ks] (a pair of Kings)
color_singleton: shows [Kh Qs] (a pair of Kings - Queen kicker)
color_singleton collected 2695 from pot
*** SUMMARY ***
Total pot 2852 | Rake 157 
Board [Td 4h Kd 9d 6s]
Seat 4: Duke Croix (big blind) folded on the Flop
Seat 6: color_singleton (button) showed [Kh Qs] and won (2695) with a pair of Kings
Seat 9: Manon541 (small blind) showed [3c Ks] and lost with a pair of Kings



PokerStars Home Game Hand #217639297709: {Club #3225207}  Hold'em No Limit (50/100) - 2020/08/20 19:55:13 ET
Table 'Manuel Neuer' 9-max (Play Money) Seat #4 is the button
Seat 4: Duke Croix (19873 in chips) 
Seat 6: color_singleton (15829 in chips) 
Duke Croix: posts small blind 50
color_singleton: posts big blind 100
*** HOLE CARDS ***
Dealt to Duke Croix [Kh Qc]
Duke Croix: raises 300 to 400
color_singleton: calls 300
*** FLOP *** [Jc 5d Jh]
color_singleton: checks 
Duke Croix: bets 400
color_singleton: folds 
Uncalled bet (400) returned to Duke Croix
Duke Croix collected 756 from pot
*** SUMMARY ***
Total pot 800 | Rake 44 
Board [Jc 5d Jh]
Seat 4: Duke Croix (button) (small blind) collected (756)
Seat 6: color_singleton (big blind) folded on the Flop



PokerStars Home Game Hand #217639307829: {Club #3225207}  Hold'em No Limit (50/100) - 2020/08/20 19:55:48 ET
Table 'Manuel Neuer' 9-max (Play Money) Seat #6 is the button
Seat 4: Duke Croix (20229 in chips) 
Seat 6: color_singleton (15429 in chips) 
color_singleton: posts small blind 50
Duke Croix: posts big blind 100
*** HOLE CARDS ***
Dealt to Duke Croix [4c 7c]
color_singleton: raises 200 to 300
Duke Croix: calls 200
*** FLOP *** [5c 4s 2s]
Duke Croix: bets 300
color_singleton: calls 300
*** TURN *** [5c 4s 2s] [6d]
Duke Croix: bets 700
color_singleton: folds 
Uncalled bet (700) returned to Duke Croix
Duke Croix collected 1134 from pot
*** SUMMARY ***
Total pot 1200 | Rake 66 
Board [5c 4s 2s 6d]
Seat 4: Duke Croix (big blind) collected (1134)
Seat 6: color_singleton (button) (small blind) folded on the Turn



PokerStars Home Game Hand #217639313514: {Club #3225207}  Hold'em No Limit (50/100) - 2020/08/20 19:56:07 ET
Table 'Manuel Neuer' 9-max (Play Money) Seat #4 is the button
Seat 4: Duke Croix (20763 in chips) 
Seat 6: color_singleton (14829 in chips) 
Duke Croix: posts small blind 50
color_singleton: posts big blind 100
*** HOLE CARDS ***
Dealt to Duke Croix [6c 6d]
Duke Croix: raises 300 to 400
color_singleton: calls 300
*** FLOP *** [Jd 2d Js]
color_singleton: checks 
Duke Croix: bets 400
color_singleton: calls 400
*** TURN *** [Jd 2d Js] [7s]
color_singleton: checks 
Duke Croix: checks 
*** RIVER *** [Jd 2d Js 7s] [7c]
color_singleton: bets 1512
Duke Croix: folds 
Uncalled bet (1512) returned to color_singleton
color_singleton collected 1512 from pot
color_singleton: doesn't show hand 
*** SUMMARY ***
Total pot 1600 | Rake 88 
Board [Jd 2d Js 7s 7c]
Seat 4: Duke Croix (button) (small blind) folded on the River
Seat 6: color_singleton (big blind) collected (1512)



