PokerStars Home Game Hand #221060635488: {Club #3225207}  Hold'em No Limit (50/100) - 2020/12/03 14:55:43 ET
Table 'Winifred' 9-max (Play Money) Seat #2 is the button
Seat 2: MnnM150 (10000 in chips) 
Seat 5: Duke Croix (10000 in chips) 
MnnM150: posts small blind 50
Duke Croix: posts big blind 100
*** HOLE CARDS ***
Dealt to Duke Croix [Qs Js]
MnnM150 has timed out
MnnM150: folds 
Uncalled bet (50) returned to Duke Croix
Duke Croix collected 100 from pot
*** SUMMARY ***
Total pot 100 | Rake 0 
Seat 2: MnnM150 (button) (small blind) folded before Flop
Seat 5: Duke Croix (big blind) collected (100)



PokerStars Home Game Hand #221060695821: {Club #3225207}  Hold'em No Limit (50/100) - 2020/12/03 14:57:47 ET
Table 'Winifred' 9-max (Play Money) Seat #5 is the button
Seat 2: MnnM150 (9950 in chips) 
Seat 5: Duke Croix (10050 in chips) 
Duke Croix: posts small blind 50
MnnM150: posts big blind 100
*** HOLE CARDS ***
Dealt to Duke Croix [6h Kh]
Duke Croix: calls 50
MnnM150: checks 
*** FLOP *** [3c 5h 8s]
MnnM150: checks 
Duke Croix: checks 
*** TURN *** [3c 5h 8s] [Jh]
MnnM150: checks 
Duke Croix: bets 200
MnnM150: folds 
Uncalled bet (200) returned to Duke Croix
Duke Croix collected 189 from pot
*** SUMMARY ***
Total pot 200 | Rake 11 
Board [3c 5h 8s Jh]
Seat 2: MnnM150 (big blind) folded on the Turn
Seat 5: Duke Croix (button) (small blind) collected (189)



PokerStars Home Game Hand #221060718020: {Club #3225207}  Hold'em No Limit (50/100) - 2020/12/03 14:58:32 ET
Table 'Winifred' 9-max (Play Money) Seat #2 is the button
Seat 2: MnnM150 (9850 in chips) 
Seat 5: Duke Croix (10139 in chips) 
MnnM150: posts small blind 50
Duke Croix: posts big blind 100
*** HOLE CARDS ***
Dealt to Duke Croix [2c 2h]
MnnM150: calls 50
Duke Croix: raises 200 to 300
MnnM150: folds 
Uncalled bet (200) returned to Duke Croix
Duke Croix collected 200 from pot
*** SUMMARY ***
Total pot 200 | Rake 0 
Seat 2: MnnM150 (button) (small blind) folded before Flop
Seat 5: Duke Croix (big blind) collected (200)



PokerStars Home Game Hand #221060722078: {Club #3225207}  Hold'em No Limit (50/100) - 2020/12/03 14:58:40 ET
Table 'Winifred' 9-max (Play Money) Seat #5 is the button
Seat 2: MnnM150 (9750 in chips) 
Seat 5: Duke Croix (10239 in chips) 
Duke Croix: posts small blind 50
MnnM150: posts big blind 100
*** HOLE CARDS ***
Dealt to Duke Croix [Jh Qs]
Duke Croix said, "joshua heeft hem nog niet open -.-"
Duke Croix: raises 200 to 300
MnnM150: folds 
Uncalled bet (200) returned to Duke Croix
Duke Croix collected 200 from pot
*** SUMMARY ***
Total pot 200 | Rake 0 
Seat 2: MnnM150 (big blind) folded before Flop
Seat 5: Duke Croix (button) (small blind) collected (200)



PokerStars Home Game Hand #221060729310: {Club #3225207}  Hold'em No Limit (50/100) - 2020/12/03 14:58:55 ET
Table 'Winifred' 9-max (Play Money) Seat #2 is the button
Seat 2: MnnM150 (9650 in chips) 
Seat 5: Duke Croix (10339 in chips) 
MnnM150: posts small blind 50
Duke Croix: posts big blind 100
*** HOLE CARDS ***
Dealt to Duke Croix [3c 5d]
MnnM150: calls 50
Duke Croix: checks 
*** FLOP *** [4s 6h 8s]
Duke Croix: bets 200
MnnM150: folds 
Uncalled bet (200) returned to Duke Croix
Duke Croix collected 189 from pot
*** SUMMARY ***
Total pot 200 | Rake 11 
Board [4s 6h 8s]
Seat 2: MnnM150 (button) (small blind) folded on the Flop
Seat 5: Duke Croix (big blind) collected (189)



PokerStars Home Game Hand #221060738821: {Club #3225207}  Hold'em No Limit (50/100) - 2020/12/03 14:59:14 ET
Table 'Winifred' 9-max (Play Money) Seat #5 is the button
Seat 2: MnnM150 (9550 in chips) 
Seat 5: Duke Croix (10428 in chips) 
Duke Croix: posts small blind 50
MnnM150: posts big blind 100
*** HOLE CARDS ***
Dealt to Duke Croix [2s 3s]
Duke Croix: raises 200 to 300
MnnM150: folds 
Uncalled bet (200) returned to Duke Croix
Duke Croix collected 200 from pot
*** SUMMARY ***
Total pot 200 | Rake 0 
Seat 2: MnnM150 (big blind) folded before Flop
Seat 5: Duke Croix (button) (small blind) collected (200)



PokerStars Home Game Hand #221060743401: {Club #3225207}  Hold'em No Limit (50/100) - 2020/12/03 14:59:24 ET
Table 'Winifred' 9-max (Play Money) Seat #2 is the button
Seat 2: MnnM150 (9450 in chips) 
Seat 5: Duke Croix (10528 in chips) 
MnnM150: posts small blind 50
Duke Croix: posts big blind 100
*** HOLE CARDS ***
Dealt to Duke Croix [Ac 5h]
MnnM150: calls 50
Duke Croix: checks 
*** FLOP *** [3d 5c Qs]
Duke Croix: bets 200
MnnM150: folds 
Uncalled bet (200) returned to Duke Croix
Duke Croix collected 189 from pot
*** SUMMARY ***
Total pot 200 | Rake 11 
Board [3d 5c Qs]
Seat 2: MnnM150 (button) (small blind) folded on the Flop
Seat 5: Duke Croix (big blind) collected (189)



PokerStars Home Game Hand #221060748763: {Club #3225207}  Hold'em No Limit (50/100) - 2020/12/03 14:59:35 ET
Table 'Winifred' 9-max (Play Money) Seat #5 is the button
Seat 2: MnnM150 (9350 in chips) 
Seat 5: Duke Croix (10617 in chips) 
Duke Croix: posts small blind 50
MnnM150: posts big blind 100
*** HOLE CARDS ***
Dealt to Duke Croix [3s 2s]
Duke Croix: calls 50
MnnM150: checks 
*** FLOP *** [Qh 4c Ac]
MnnM150: checks 
Duke Croix: checks 
*** TURN *** [Qh 4c Ac] [6d]
MnnM150: checks 
Duke Croix: bets 200
MnnM150: folds 
Uncalled bet (200) returned to Duke Croix
Duke Croix collected 189 from pot
*** SUMMARY ***
Total pot 200 | Rake 11 
Board [Qh 4c Ac 6d]
Seat 2: MnnM150 (big blind) folded on the Turn
Seat 5: Duke Croix (button) (small blind) collected (189)



PokerStars Home Game Hand #221060757215: {Club #3225207}  Hold'em No Limit (50/100) - 2020/12/03 14:59:52 ET
Table 'Winifred' 9-max (Play Money) Seat #2 is the button
Seat 2: MnnM150 (9250 in chips) 
Seat 5: Duke Croix (10706 in chips) 
MnnM150: posts small blind 50
Duke Croix: posts big blind 100
*** HOLE CARDS ***
Dealt to Duke Croix [3d 3s]
MnnM150: calls 50
Duke Croix: raises 300 to 400
MnnM150: folds 
Uncalled bet (300) returned to Duke Croix
Duke Croix collected 200 from pot
*** SUMMARY ***
Total pot 200 | Rake 0 
Seat 2: MnnM150 (button) (small blind) folded before Flop
Seat 5: Duke Croix (big blind) collected (200)



PokerStars Home Game Hand #221060762326: {Club #3225207}  Hold'em No Limit (50/100) - 2020/12/03 15:00:02 ET
Table 'Winifred' 9-max (Play Money) Seat #5 is the button
Seat 2: MnnM150 (9150 in chips) 
Seat 5: Duke Croix (10806 in chips) 
Duke Croix: posts small blind 50
MnnM150: posts big blind 100
*** HOLE CARDS ***
Dealt to Duke Croix [6h Jh]
Duke Croix: calls 50
MnnM150: checks 
*** FLOP *** [6c 5d 7d]
MnnM150: checks 
Duke Croix: bets 100
MnnM150: calls 100
*** TURN *** [6c 5d 7d] [As]
MnnM150: checks 
Duke Croix: checks 
*** RIVER *** [6c 5d 7d As] [4s]
MnnM150: bets 189
Duke Croix: folds 
Uncalled bet (189) returned to MnnM150
MnnM150 collected 378 from pot
*** SUMMARY ***
Total pot 400 | Rake 22 
Board [6c 5d 7d As 4s]
Seat 2: MnnM150 (big blind) collected (378)
Seat 5: Duke Croix (button) (small blind) folded on the River



PokerStars Home Game Hand #221060773533: {Club #3225207}  Hold'em No Limit (50/100) - 2020/12/03 15:00:24 ET
Table 'Winifred' 9-max (Play Money) Seat #2 is the button
Seat 2: MnnM150 (9328 in chips) 
Seat 5: Duke Croix (10606 in chips) 
MnnM150: posts small blind 50
Duke Croix: posts big blind 100
*** HOLE CARDS ***
Dealt to Duke Croix [Js Tc]
MnnM150: folds 
Uncalled bet (50) returned to Duke Croix
Duke Croix collected 100 from pot
*** SUMMARY ***
Total pot 100 | Rake 0 
Seat 2: MnnM150 (button) (small blind) folded before Flop
Seat 5: Duke Croix (big blind) collected (100)



PokerStars Home Game Hand #221060776909: {Club #3225207}  Hold'em No Limit (50/100) - 2020/12/03 15:00:30 ET
Table 'Winifred' 9-max (Play Money) Seat #5 is the button
Seat 2: MnnM150 (9278 in chips) 
Seat 5: Duke Croix (10656 in chips) 
Duke Croix: posts small blind 50
MnnM150: posts big blind 100
*** HOLE CARDS ***
Dealt to Duke Croix [Qh Kh]
Duke Croix: raises 200 to 300
MnnM150: calls 200
*** FLOP *** [2s Js Tc]
MnnM150: checks 
Duke Croix: bets 300
MnnM150: calls 300
*** TURN *** [2s Js Tc] [9h]
MnnM150: checks 
Duke Croix: bets 600
MnnM150: calls 600
*** RIVER *** [2s Js Tc 9h] [7h]
color_singleton joins the table at seat #1 
MnnM150: bets 1134
Duke Croix: raises 1866 to 3000
MnnM150: calls 1866
*** SHOW DOWN ***
Duke Croix: shows [Qh Kh] (a straight, Nine to King)
MnnM150: mucks hand 
Duke Croix collected 7938 from pot
*** SUMMARY ***
Total pot 8400 | Rake 462 
Board [2s Js Tc 9h 7h]
Seat 2: MnnM150 (big blind) mucked [Jc 7c]
Seat 5: Duke Croix (button) (small blind) showed [Qh Kh] and won (7938) with a straight, Nine to King



PokerStars Home Game Hand #221060797731: {Club #3225207}  Hold'em No Limit (50/100) - 2020/12/03 15:01:09 ET
Table 'Winifred' 9-max (Play Money) Seat #2 is the button
Seat 1: color_singleton (10000 in chips) 
Seat 2: MnnM150 (5078 in chips) 
Seat 5: Duke Croix (14394 in chips) 
Duke Croix: posts small blind 50
color_singleton: posts big blind 100
*** HOLE CARDS ***
Dealt to Duke Croix [Js 7c]
MnnM150: folds 
Duke Croix: calls 50
color_singleton: checks 
*** FLOP *** [Qd 8d 4h]
Duke Croix: checks 
color_singleton: checks 
*** TURN *** [Qd 8d 4h] [6s]
Duke Croix: checks 
color_singleton: bets 189
Duke Croix: folds 
Uncalled bet (189) returned to color_singleton
color_singleton collected 189 from pot
color_singleton: doesn't show hand 
*** SUMMARY ***
Total pot 200 | Rake 11 
Board [Qd 8d 4h 6s]
Seat 1: color_singleton (big blind) collected (189)
Seat 2: MnnM150 (button) folded before Flop (didn't bet)
Seat 5: Duke Croix (small blind) folded on the Turn



PokerStars Home Game Hand #221060822426: {Club #3225207}  Hold'em No Limit (50/100) - 2020/12/03 15:01:51 ET
Table 'Winifred' 9-max (Play Money) Seat #5 is the button
Seat 1: color_singleton (10089 in chips) 
Seat 2: MnnM150 (5078 in chips) 
Seat 5: Duke Croix (14294 in chips) 
color_singleton: posts small blind 50
MnnM150: posts big blind 100
*** HOLE CARDS ***
Dealt to Duke Croix [2h 7s]
Duke Croix: folds 
color_singleton: folds 
Uncalled bet (50) returned to MnnM150
MnnM150 collected 100 from pot
*** SUMMARY ***
Total pot 100 | Rake 0 
Seat 1: color_singleton (small blind) folded before Flop
Seat 2: MnnM150 (big blind) collected (100)
Seat 5: Duke Croix (button) folded before Flop (didn't bet)



PokerStars Home Game Hand #221060825028: {Club #3225207}  Hold'em No Limit (50/100) - 2020/12/03 15:01:56 ET
Table 'Winifred' 9-max (Play Money) Seat #1 is the button
Seat 1: color_singleton (10039 in chips) 
Seat 2: MnnM150 (5128 in chips) 
Seat 5: Duke Croix (14294 in chips) 
MnnM150: posts small blind 50
Duke Croix: posts big blind 100
*** HOLE CARDS ***
Dealt to Duke Croix [2h 7h]
color_singleton: folds 
MnnM150: calls 50
Duke Croix: checks 
*** FLOP *** [4h Kc 4s]
MnnM150: checks 
Duke Croix: checks 
*** TURN *** [4h Kc 4s] [8s]
MnnM150: bets 189
Duke Croix: folds 
Uncalled bet (189) returned to MnnM150
MnnM150 collected 189 from pot
*** SUMMARY ***
Total pot 200 | Rake 11 
Board [4h Kc 4s 8s]
Seat 1: color_singleton (button) folded before Flop (didn't bet)
Seat 2: MnnM150 (small blind) collected (189)
Seat 5: Duke Croix (big blind) folded on the Turn



PokerStars Home Game Hand #221060837505: {Club #3225207}  Hold'em No Limit (50/100) - 2020/12/03 15:02:16 ET
Table 'Winifred' 9-max (Play Money) Seat #2 is the button
Seat 1: color_singleton (10039 in chips) 
Seat 2: MnnM150 (5217 in chips) 
Seat 5: Duke Croix (14194 in chips) 
Duke Croix: posts small blind 50
color_singleton: posts big blind 100
*** HOLE CARDS ***
Dealt to Duke Croix [Js Ts]
color_singleton said, "Hi Guys"
MnnM150: folds 
dhduncan joins the table at seat #3 
Duke Croix: raises 300 to 400
color_singleton: calls 300
*** FLOP *** [7h 6h 9h]
Duke Croix: checks 
color_singleton: checks 
*** TURN *** [7h 6h 9h] [4c]
Duke Croix: checks 
color_singleton: checks 
*** RIVER *** [7h 6h 9h 4c] [Qs]
MnnM150 said, "hi!"
Duke Croix: checks 
color_singleton: checks 
*** SHOW DOWN ***
Duke Croix: shows [Js Ts] (high card Queen)
color_singleton: shows [3s Ac] (high card Ace)
color_singleton collected 756 from pot
*** SUMMARY ***
Total pot 800 | Rake 44 
Board [7h 6h 9h 4c Qs]
Seat 1: color_singleton (big blind) showed [3s Ac] and won (756) with high card Ace
Seat 2: MnnM150 (button) folded before Flop (didn't bet)
Seat 5: Duke Croix (small blind) showed [Js Ts] and lost with high card Queen



PokerStars Home Game Hand #221060863923: {Club #3225207}  Hold'em No Limit (50/100) - 2020/12/03 15:02:57 ET
Table 'Winifred' 9-max (Play Money) Seat #5 is the button
Seat 1: color_singleton (10395 in chips) 
Seat 2: MnnM150 (5217 in chips) 
Seat 3: dhduncan (10000 in chips) 
Seat 5: Duke Croix (13794 in chips) 
color_singleton: posts small blind 50
MnnM150: posts big blind 100
dhduncan: posts big blind 100
*** HOLE CARDS ***
Dealt to Duke Croix [9d 6c]
Duke Croix said, "sup"
dhduncan said, "no zoom?"
Duke Croix said, "jan can you open another zoom?"
dhduncan: raises 100 to 200
Duke Croix: folds 
color_singleton: raises 200 to 400
MnnM150 said, "docky can"
MnnM150: calls 300
dhduncan: calls 200
*** FLOP *** [Js 5c 5s]
Duke Croix said, "or docky"
dhduncan said, "i can also"
Duke Croix said, "anybody is fine!"
color_singleton: bets 900
MnnM150: folds 
dhduncan: folds 
Uncalled bet (900) returned to color_singleton
color_singleton collected 1134 from pot
color_singleton: doesn't show hand 
*** SUMMARY ***
Total pot 1200 | Rake 66 
Board [Js 5c 5s]
Seat 1: color_singleton (small blind) collected (1134)
Seat 2: MnnM150 (big blind) folded on the Flop
Seat 3: dhduncan folded on the Flop
Seat 5: Duke Croix (button) folded before Flop (didn't bet)



PokerStars Home Game Hand #221060890687: {Club #3225207}  Hold'em No Limit (50/100) - 2020/12/03 15:03:39 ET
Table 'Winifred' 9-max (Play Money) Seat #1 is the button
Seat 1: color_singleton (11129 in chips) 
Seat 2: MnnM150 (4817 in chips) 
Seat 3: dhduncan (9600 in chips) 
Seat 5: Duke Croix (13794 in chips) 
MnnM150: posts small blind 50
dhduncan: posts big blind 100
*** HOLE CARDS ***
Dealt to Duke Croix [3d 7d]
Duke Croix: folds 
color_singleton: raises 200 to 300
MnnM150: folds 
dhduncan: calls 200
*** FLOP *** [5h 6s Qc]
dhduncan: checks 
color_singleton: checks 
*** TURN *** [5h 6s Qc] [Td]
dhduncan: checks 
color_singleton: checks 
*** RIVER *** [5h 6s Qc Td] [Jc]
dhduncan: checks 
color_singleton: checks 
*** SHOW DOWN ***
dhduncan: shows [7h Kh] (high card King)
color_singleton: shows [7c Kc] (high card King)
dhduncan collected 307 from pot
color_singleton collected 307 from pot
*** SUMMARY ***
Total pot 650 | Rake 36 
Board [5h 6s Qc Td Jc]
Seat 1: color_singleton (button) showed [7c Kc] and won (307) with high card King
Seat 2: MnnM150 (small blind) folded before Flop
Seat 3: dhduncan (big blind) showed [7h Kh] and won (307) with high card King
Seat 5: Duke Croix folded before Flop (didn't bet)



PokerStars Home Game Hand #221060908085: {Club #3225207}  Hold'em No Limit (50/100) - 2020/12/03 15:04:06 ET
Table 'Winifred' 9-max (Play Money) Seat #2 is the button
Seat 1: color_singleton (11136 in chips) 
Seat 2: MnnM150 (4767 in chips) 
Seat 3: dhduncan (9607 in chips) 
Seat 5: Duke Croix (13794 in chips) 
dhduncan: posts small blind 50
Duke Croix: posts big blind 100
*** HOLE CARDS ***
Dealt to Duke Croix [8h 4s]
dhduncan said, "nice"
color_singleton: folds 
MnnM150: folds 
dhduncan: calls 50
Duke Croix: checks 
*** FLOP *** [7c 7d Js]
dhduncan: checks 
Duke Croix: checks 
*** TURN *** [7c 7d Js] [Kd]
dhduncan: bets 189
Duke Croix: folds 
Uncalled bet (189) returned to dhduncan
dhduncan collected 189 from pot
dhduncan: doesn't show hand 
*** SUMMARY ***
Total pot 200 | Rake 11 
Board [7c 7d Js Kd]
Seat 1: color_singleton folded before Flop (didn't bet)
Seat 2: MnnM150 (button) folded before Flop (didn't bet)
Seat 3: dhduncan (small blind) collected (189)
Seat 5: Duke Croix (big blind) folded on the Turn



PokerStars Home Game Hand #221060932172: {Club #3225207}  Hold'em No Limit (50/100) - 2020/12/03 15:04:44 ET
Table 'Winifred' 9-max (Play Money) Seat #3 is the button
Seat 1: color_singleton (11136 in chips) 
Seat 2: MnnM150 (4767 in chips) 
Seat 3: dhduncan (9696 in chips) 
Seat 5: Duke Croix (13694 in chips) 
Duke Croix: posts small blind 50
color_singleton: posts big blind 100
*** HOLE CARDS ***
Dealt to Duke Croix [8d 7c]
MnnM150: folds 
dhduncan: calls 100
Duke Croix: calls 50
color_singleton: checks 
*** FLOP *** [7h Qs 3s]
Duke Croix: bets 200
color_singleton: calls 200
dhduncan: folds 
*** TURN *** [7h Qs 3s] [6s]
Duke Croix: checks 
color_singleton: checks 
*** RIVER *** [7h Qs 3s 6s] [8c]
Duke Croix: bets 600
color_singleton: folds 
Uncalled bet (600) returned to Duke Croix
Duke Croix collected 661 from pot
*** SUMMARY ***
Total pot 700 | Rake 39 
Board [7h Qs 3s 6s 8c]
Seat 1: color_singleton (big blind) folded on the River
Seat 2: MnnM150 folded before Flop (didn't bet)
Seat 3: dhduncan (button) folded on the Flop
Seat 5: Duke Croix (small blind) collected (661)



PokerStars Home Game Hand #221060978665: {Club #3225207}  Hold'em No Limit (50/100) - 2020/12/03 15:05:53 ET
Table 'Winifred' 9-max (Play Money) Seat #5 is the button
Seat 1: color_singleton (10836 in chips) 
Seat 2: MnnM150 (4767 in chips) 
Seat 3: dhduncan (9596 in chips) 
Seat 5: Duke Croix (14055 in chips) 
color_singleton: posts small blind 50
MnnM150: posts big blind 100
*** HOLE CARDS ***
Dealt to Duke Croix [Jh 6s]
dhduncan has timed out
dhduncan: folds 
Duke Croix: folds 
color_singleton: calls 50
MnnM150: checks 
*** FLOP *** [2c 7c Kd]
color_singleton: bets 189
MnnM150: raises 189 to 378
color_singleton: folds 
Uncalled bet (189) returned to MnnM150
MnnM150 collected 546 from pot
*** SUMMARY ***
Total pot 578 | Rake 32 
Board [2c 7c Kd]
Seat 1: color_singleton (small blind) folded on the Flop
Seat 2: MnnM150 (big blind) collected (546)
Seat 3: dhduncan folded before Flop (didn't bet)
Seat 5: Duke Croix (button) folded before Flop (didn't bet)



PokerStars Home Game Hand #221061006710: {Club #3225207}  Hold'em No Limit (50/100) - 2020/12/03 15:06:34 ET
Table 'Winifred' 9-max (Play Money) Seat #1 is the button
Seat 1: color_singleton (10547 in chips) 
Seat 2: MnnM150 (5024 in chips) 
Seat 5: Duke Croix (14055 in chips) 
MnnM150: posts small blind 50
Duke Croix: posts big blind 100
*** HOLE CARDS ***
Dealt to Duke Croix [8s Qc]
color_singleton: raises 200 to 300
MnnM150: folds 
Duke Croix: calls 200
*** FLOP *** [2c Jd 7d]
Duke Croix: checks 
color_singleton: bets 307
Duke Croix: folds 
Uncalled bet (307) returned to color_singleton
color_singleton collected 614 from pot
color_singleton: doesn't show hand 
*** SUMMARY ***
Total pot 650 | Rake 36 
Board [2c Jd 7d]
Seat 1: color_singleton (button) collected (614)
Seat 2: MnnM150 (small blind) folded before Flop
Seat 5: Duke Croix (big blind) folded on the Flop



PokerStars Home Game Hand #221061024931: {Club #3225207}  Hold'em No Limit (50/100) - 2020/12/03 15:07:00 ET
Table 'Winifred' 9-max (Play Money) Seat #2 is the button
Seat 1: color_singleton (10861 in chips) 
Seat 2: MnnM150 (4974 in chips) 
Seat 5: Duke Croix (13755 in chips) 
Duke Croix: posts small blind 50
color_singleton: posts big blind 100
*** HOLE CARDS ***
Dealt to Duke Croix [6c Th]
dhduncan said, "i sent a zoom link"
dhduncan said, "i think"
MnnM150: folds 
Duke Croix: calls 50
color_singleton: checks 
*** FLOP *** [Qs 5d 2s]
Duke Croix: checks 
color_singleton: checks 
*** TURN *** [Qs 5d 2s] [5h]
Duke Croix: checks 
color_singleton: checks 
*** RIVER *** [Qs 5d 2s 5h] [7d]
Duke Croix: checks 
color_singleton: checks 
*** SHOW DOWN ***
Duke Croix: shows [6c Th] (a pair of Fives)
color_singleton: shows [Td 4h] (a pair of Fives)
Duke Croix collected 95 from pot
color_singleton collected 94 from pot
*** SUMMARY ***
Total pot 200 | Rake 11 
Board [Qs 5d 2s 5h 7d]
Seat 1: color_singleton (big blind) showed [Td 4h] and won (94) with a pair of Fives
Seat 2: MnnM150 (button) folded before Flop (didn't bet)
Seat 5: Duke Croix (small blind) showed [6c Th] and won (95) with a pair of Fives



PokerStars Home Game Hand #221061047605: {Club #3225207}  Hold'em No Limit (50/100) - 2020/12/03 15:07:33 ET
Table 'Winifred' 9-max (Play Money) Seat #5 is the button
Seat 1: color_singleton (10855 in chips) 
Seat 2: MnnM150 (4974 in chips) 
Seat 5: Duke Croix (13750 in chips) 
color_singleton: posts small blind 50
MnnM150: posts big blind 100
*** HOLE CARDS ***
Dealt to Duke Croix [8d 7h]
Duke Croix: calls 100
color_singleton: raises 200 to 300
MnnM150: calls 200
Duke Croix: calls 200
*** FLOP *** [7s 4c 6h]
color_singleton: checks 
MnnM150: checks 
Duke Croix: bets 400
color_singleton: calls 400
MnnM150: folds 
*** TURN *** [7s 4c 6h] [Qd]
color_singleton: checks 
Duke Croix: checks 
*** RIVER *** [7s 4c 6h Qd] [Jd]
color_singleton: checks 
Duke Croix: checks 
*** SHOW DOWN ***
color_singleton: shows [8s Ks] (high card King)
Duke Croix: shows [8d 7h] (a pair of Sevens)
Duke Croix collected 1606 from pot
*** SUMMARY ***
Total pot 1700 | Rake 94 
Board [7s 4c 6h Qd Jd]
Seat 1: color_singleton (small blind) showed [8s Ks] and lost with high card King
Seat 2: MnnM150 (big blind) folded on the Flop
Seat 5: Duke Croix (button) showed [8d 7h] and won (1606) with a pair of Sevens



PokerStars Home Game Hand #221061085826: {Club #3225207}  Hold'em No Limit (50/100) - 2020/12/03 15:08:29 ET
Table 'Winifred' 9-max (Play Money) Seat #1 is the button
Seat 1: color_singleton (10155 in chips) 
Seat 2: MnnM150 (4674 in chips) 
Seat 3: dhduncan (9596 in chips) 
Seat 5: Duke Croix (14656 in chips) 
MnnM150: posts small blind 50
dhduncan: posts big blind 100
*** HOLE CARDS ***
Dealt to Duke Croix [8s 5d]
Duke Croix: folds 
color_singleton: raises 200 to 300
MnnM150: calls 250
dhduncan: calls 200
*** FLOP *** [Ac 8d Js]
MnnM150: bets 425
dhduncan: folds 
color_singleton: folds 
Uncalled bet (425) returned to MnnM150
MnnM150 collected 850 from pot
*** SUMMARY ***
Total pot 900 | Rake 50 
Board [Ac 8d Js]
Seat 1: color_singleton (button) folded on the Flop
Seat 2: MnnM150 (small blind) collected (850)
Seat 3: dhduncan (big blind) folded on the Flop
Seat 5: Duke Croix folded before Flop (didn't bet)



PokerStars Home Game Hand #221061109660: {Club #3225207}  Hold'em No Limit (50/100) - 2020/12/03 15:09:04 ET
Table 'Winifred' 9-max (Play Money) Seat #2 is the button
Seat 1: color_singleton (9855 in chips) 
Seat 2: MnnM150 (5224 in chips) 
Seat 3: dhduncan (9296 in chips) 
Seat 5: Duke Croix (14656 in chips) 
dhduncan: posts small blind 50
Duke Croix: posts big blind 100
*** HOLE CARDS ***
Dealt to Duke Croix [5s 3d]
color_singleton: folds 
MnnM150: calls 100
dhduncan: folds 
Duke Croix: checks 
*** FLOP *** [9h 8h Qh]
Duke Croix: checks 
MnnM150: checks 
*** TURN *** [9h 8h Qh] [Ac]
Duke Croix: checks 
MnnM150: checks 
*** RIVER *** [9h 8h Qh Ac] [6h]
Duke Croix: checks 
color_singleton said, "still cannot get in zoom"
MnnM150: checks 
*** SHOW DOWN ***
Duke Croix: shows [5s 3d] (high card Ace)
MnnM150: shows [Kc 2d] (high card Ace - King kicker)
MnnM150 collected 236 from pot
*** SUMMARY ***
Total pot 250 | Rake 14 
Board [9h 8h Qh Ac 6h]
Seat 1: color_singleton folded before Flop (didn't bet)
Seat 2: MnnM150 (button) showed [Kc 2d] and won (236) with high card Ace
Seat 3: dhduncan (small blind) folded before Flop
Seat 5: Duke Croix (big blind) showed [5s 3d] and lost with high card Ace



PokerStars Home Game Hand #221061128852: {Club #3225207}  Hold'em No Limit (50/100) - 2020/12/03 15:09:32 ET
Table 'Winifred' 9-max (Play Money) Seat #3 is the button
Seat 1: color_singleton (9855 in chips) 
Seat 2: MnnM150 (5360 in chips) 
Seat 3: dhduncan (9246 in chips) 
Seat 5: Duke Croix (14556 in chips) 
Duke Croix: posts small blind 50
color_singleton: posts big blind 100
*** HOLE CARDS ***
Dealt to Duke Croix [8c Jh]
MnnM150: folds 
Duke Croix said, "docky's link"
dhduncan: folds 
Duke Croix said, "he'll send it"
Duke Croix: calls 50
color_singleton: checks 
*** FLOP *** [5s 3d 4h]
Duke Croix: checks 
color_singleton: checks 
*** TURN *** [5s 3d 4h] [6s]
Duke Croix: checks 
color_singleton: bets 200
Duke Croix: folds 
Uncalled bet (200) returned to color_singleton
color_singleton collected 189 from pot
color_singleton: doesn't show hand 
*** SUMMARY ***
Total pot 200 | Rake 11 
Board [5s 3d 4h 6s]
Seat 1: color_singleton (big blind) collected (189)
Seat 2: MnnM150 folded before Flop (didn't bet)
Seat 3: dhduncan (button) folded before Flop (didn't bet)
Seat 5: Duke Croix (small blind) folded on the Turn



PokerStars Home Game Hand #221061161603: {Club #3225207}  Hold'em No Limit (50/100) - 2020/12/03 15:10:20 ET
Table 'Winifred' 9-max (Play Money) Seat #5 is the button
Seat 1: color_singleton (9944 in chips) 
Seat 2: MnnM150 (5360 in chips) 
Seat 3: dhduncan (9246 in chips) 
Seat 5: Duke Croix (14456 in chips) 
color_singleton: posts small blind 50
MnnM150: posts big blind 100
*** HOLE CARDS ***
Dealt to Duke Croix [As 3s]
dhduncan: calls 100
Duke Croix: calls 100
color_singleton: calls 50
MnnM150: checks 
*** FLOP *** [Ah 8d Th]
color_singleton: checks 
MnnM150: checks 
dhduncan: bets 100
Duke Croix: raises 200 to 300
color_singleton: folds 
MnnM150: folds 
dhduncan: calls 200
*** TURN *** [Ah 8d Th] [4d]
dhduncan: checks 
Duke Croix: bets 400
dhduncan: calls 400
*** RIVER *** [Ah 8d Th 4d] [8c]
dhduncan: bets 850
Duke Croix: calls 850
*** SHOW DOWN ***
dhduncan: shows [Ac 5s] (two pair, Aces and Eights)
Duke Croix: shows [As 3s] (two pair, Aces and Eights)
dhduncan collected 1654 from pot
Duke Croix collected 1653 from pot
*** SUMMARY ***
Total pot 3500 | Rake 193 
Board [Ah 8d Th 4d 8c]
Seat 1: color_singleton (small blind) folded on the Flop
Seat 2: MnnM150 (big blind) folded on the Flop
Seat 3: dhduncan showed [Ac 5s] and won (1654) with two pair, Aces and Eights
Seat 5: Duke Croix (button) showed [As 3s] and won (1653) with two pair, Aces and Eights



PokerStars Home Game Hand #221061205260: {Club #3225207}  Hold'em No Limit (50/100) - 2020/12/03 15:11:24 ET
Table 'Winifred' 9-max (Play Money) Seat #1 is the button
Seat 1: color_singleton (9844 in chips) 
Seat 2: MnnM150 (5260 in chips) 
Seat 3: dhduncan (9250 in chips) 
Seat 5: Duke Croix (14459 in chips) 
MnnM150: posts small blind 50
dhduncan: posts big blind 100
*** HOLE CARDS ***
Dealt to Duke Croix [Th 8d]
Duke Croix: folds 
color_singleton: raises 200 to 300
MnnM150: folds 
dhduncan: calls 200
*** FLOP *** [Ad 5c 3c]
dhduncan: bets 100
color_singleton: calls 100
*** TURN *** [Ad 5c 3c] [Qc]
dhduncan: bets 803
color_singleton: folds 
Uncalled bet (803) returned to dhduncan
dhduncan collected 803 from pot
dhduncan: doesn't show hand 
*** SUMMARY ***
Total pot 850 | Rake 47 
Board [Ad 5c 3c Qc]
Seat 1: color_singleton (button) folded on the Turn
Seat 2: MnnM150 (small blind) folded before Flop
Seat 3: dhduncan (big blind) collected (803)
Seat 5: Duke Croix folded before Flop (didn't bet)



PokerStars Home Game Hand #221061229725: {Club #3225207}  Hold'em No Limit (50/100) - 2020/12/03 15:12:00 ET
Table 'Winifred' 9-max (Play Money) Seat #2 is the button
Seat 1: color_singleton (9444 in chips) 
Seat 2: MnnM150 (5210 in chips) 
Seat 3: dhduncan (9653 in chips) 
Seat 5: Duke Croix (14459 in chips) 
dhduncan: posts small blind 50
Duke Croix: posts big blind 100
*** HOLE CARDS ***
Dealt to Duke Croix [Jc Qd]
color_singleton has timed out
color_singleton: folds 
MnnM150: calls 100
dhduncan: calls 50
Duke Croix: raises 300 to 400
MnnM150: calls 300
dhduncan: calls 300
*** FLOP *** [Ac 6h 7c]
dhduncan: checks 
Duke Croix: checks 
MnnM150: bets 567
dhduncan: folds 
Duke Croix: folds 
Uncalled bet (567) returned to MnnM150
MnnM150 collected 1134 from pot
*** SUMMARY ***
Total pot 1200 | Rake 66 
Board [Ac 6h 7c]
Seat 1: color_singleton folded before Flop (didn't bet)
Seat 2: MnnM150 (button) collected (1134)
Seat 3: dhduncan (small blind) folded on the Flop
Seat 5: Duke Croix (big blind) folded on the Flop



PokerStars Home Game Hand #221061281851: {Club #3225207}  Hold'em No Limit (50/100) - 2020/12/03 15:13:10 ET
Table 'Winifred' 9-max (Play Money) Seat #3 is the button
Seat 1: color_singleton (9444 in chips) 
Seat 2: MnnM150 (5944 in chips) 
Seat 3: dhduncan (9253 in chips) 
Seat 5: Duke Croix (14059 in chips) 
Duke Croix: posts small blind 50
color_singleton: posts big blind 100
*** HOLE CARDS ***
Dealt to Duke Croix [6d 9h]
MnnM150: folds 
dhduncan: calls 100
Duke Croix has timed out
Duke Croix: folds 
color_singleton: checks 
*** FLOP *** [3s Ts Qc]
color_singleton: checks 
dhduncan: bets 100
color_singleton: folds 
Uncalled bet (100) returned to dhduncan
dhduncan collected 236 from pot
dhduncan: doesn't show hand 
*** SUMMARY ***
Total pot 250 | Rake 14 
Board [3s Ts Qc]
Seat 1: color_singleton (big blind) folded on the Flop
Seat 2: MnnM150 folded before Flop (didn't bet)
Seat 3: dhduncan (button) collected (236)
Seat 5: Duke Croix (small blind) folded before Flop



PokerStars Home Game Hand #221061319575: {Club #3225207}  Hold'em No Limit (50/100) - 2020/12/03 15:14:05 ET
Table 'Winifred' 9-max (Play Money) Seat #5 is the button
Seat 1: color_singleton (9344 in chips) 
Seat 2: MnnM150 (5944 in chips) 
Seat 3: dhduncan (9389 in chips) 
Seat 5: Duke Croix (14009 in chips) 
color_singleton: posts small blind 50
MnnM150: posts big blind 100
*** HOLE CARDS ***
Dealt to Duke Croix [Kc 2c]
dhduncan: calls 100
Duke Croix: folds 
color_singleton: folds 
MnnM150: checks 
*** FLOP *** [Qd 5d 2s]
MnnM150: checks 
dhduncan: checks 
*** TURN *** [Qd 5d 2s] [8c]
MnnM150: checks 
dhduncan: checks 
*** RIVER *** [Qd 5d 2s 8c] [As]
MnnM150: bets 100
dhduncan: calls 100
*** SHOW DOWN ***
MnnM150: shows [2h 7c] (a pair of Deuces)
dhduncan: mucks hand 
MnnM150 collected 425 from pot
*** SUMMARY ***
Total pot 450 | Rake 25 
Board [Qd 5d 2s 8c As]
Seat 1: color_singleton (small blind) folded before Flop
Seat 2: MnnM150 (big blind) showed [2h 7c] and won (425) with a pair of Deuces
Seat 3: dhduncan mucked [6s Kd]
Seat 5: Duke Croix (button) folded before Flop (didn't bet)



PokerStars Home Game Hand #221061349183: {Club #3225207}  Hold'em No Limit (50/100) - 2020/12/03 15:14:48 ET
Table 'Winifred' 9-max (Play Money) Seat #1 is the button
Seat 1: color_singleton (9294 in chips) 
Seat 2: MnnM150 (6169 in chips) 
Seat 3: dhduncan (9189 in chips) 
Seat 5: Duke Croix (14009 in chips) 
MnnM150: posts small blind 50
dhduncan: posts big blind 100
*** HOLE CARDS ***
Dealt to Duke Croix [Js 9s]
Duke Croix: calls 100
color_singleton: folds 
MnnM150: calls 50
dhduncan: checks 
*** FLOP *** [3s 5c Qs]
MnnM150: checks 
dhduncan: checks 
Duke Croix: bets 300
MnnM150: calls 300
dhduncan: folds 
*** TURN *** [3s 5c Qs] [4d]
MnnM150: checks 
Duke Croix: bets 450
MnnM150: folds 
Uncalled bet (450) returned to Duke Croix
Duke Croix collected 850 from pot
*** SUMMARY ***
Total pot 900 | Rake 50 
Board [3s 5c Qs 4d]
Seat 1: color_singleton (button) folded before Flop (didn't bet)
Seat 2: MnnM150 (small blind) folded on the Turn
Seat 3: dhduncan (big blind) folded on the Flop
Seat 5: Duke Croix collected (850)



PokerStars Home Game Hand #221061381919: {Club #3225207}  Hold'em No Limit (50/100) - 2020/12/03 15:15:36 ET
Table 'Winifred' 9-max (Play Money) Seat #2 is the button
Seat 1: color_singleton (9294 in chips) 
Seat 2: MnnM150 (5769 in chips) 
Seat 3: dhduncan (9089 in chips) 
Seat 5: Duke Croix (14459 in chips) 
dhduncan: posts small blind 50
Duke Croix: posts big blind 100
*** HOLE CARDS ***
Dealt to Duke Croix [9d 6h]
color_singleton: folds 
MnnM150: calls 100
dhduncan: calls 50
Duke Croix: checks 
*** FLOP *** [2s Tc 8c]
dhduncan: checks 
Duke Croix: checks 
MnnM150: checks 
*** TURN *** [2s Tc 8c] [7s]
dhduncan: checks 
Duke Croix: bets 300
MnnM150: calls 300
dhduncan: folds 
*** RIVER *** [2s Tc 8c 7s] [9c]
Duke Croix: checks 
MnnM150: bets 425
Duke Croix: calls 425
*** SHOW DOWN ***
MnnM150: shows [9h Jc] (a straight, Seven to Jack)
Duke Croix: mucks hand 
MnnM150 collected 1654 from pot
*** SUMMARY ***
Total pot 1750 | Rake 96 
Board [2s Tc 8c 7s 9c]
Seat 1: color_singleton folded before Flop (didn't bet)
Seat 2: MnnM150 (button) showed [9h Jc] and won (1654) with a straight, Seven to Jack
Seat 3: dhduncan (small blind) folded on the Turn
Seat 5: Duke Croix (big blind) mucked [9d 6h]



PokerStars Home Game Hand #221061421068: {Club #3225207}  Hold'em No Limit (50/100) - 2020/12/03 15:16:32 ET
Table 'Winifred' 9-max (Play Money) Seat #3 is the button
Seat 1: color_singleton (9294 in chips) 
Seat 2: MnnM150 (6598 in chips) 
Seat 3: dhduncan (8989 in chips) 
Seat 5: Duke Croix (13634 in chips) 
Duke Croix: posts small blind 50
color_singleton: posts big blind 100
*** HOLE CARDS ***
Dealt to Duke Croix [6s Jc]
MnnM150: calls 100
dhduncan: calls 100
Duke Croix: folds 
color_singleton: raises 200 to 300
MnnM150: calls 200
dhduncan: folds 
*** FLOP *** [Qh 2c 4h]
color_singleton has timed out
color_singleton: checks 
MnnM150: checks 
*** TURN *** [Qh 2c 4h] [5c]
color_singleton: checks 
MnnM150: checks 
*** RIVER *** [Qh 2c 4h 5c] [3c]
color_singleton: bets 709
MnnM150: raises 709 to 1418
color_singleton: calls 709
*** SHOW DOWN ***
MnnM150: shows [Kh 6h] (a straight, Deuce to Six)
color_singleton: mucks hand 
MnnM150 collected 3389 from pot
*** SUMMARY ***
Total pot 3586 | Rake 197 
Board [Qh 2c 4h 5c 3c]
Seat 1: color_singleton (big blind) mucked [Jd Ah]
Seat 2: MnnM150 showed [Kh 6h] and won (3389) with a straight, Deuce to Six
Seat 3: dhduncan (button) folded before Flop
Seat 5: Duke Croix (small blind) folded before Flop



PokerStars Home Game Hand #221061468719: {Club #3225207}  Hold'em No Limit (50/100) - 2020/12/03 15:17:41 ET
Table 'Winifred' 9-max (Play Money) Seat #5 is the button
Seat 1: color_singleton (7576 in chips) 
Seat 2: MnnM150 (8269 in chips) 
Seat 3: dhduncan (8889 in chips) 
Seat 5: Duke Croix (13584 in chips) 
color_singleton: posts small blind 50
MnnM150: posts big blind 100
*** HOLE CARDS ***
Dealt to Duke Croix [5s Kd]
dhduncan: calls 100
Duke Croix: folds 
color_singleton: raises 100 to 200
MnnM150: folds 
dhduncan: calls 100
*** FLOP *** [6h Kh 9s]
color_singleton: checks 
dhduncan: checks 
*** TURN *** [6h Kh 9s] [8h]
color_singleton: checks 
dhduncan: bets 472
color_singleton: folds 
Uncalled bet (472) returned to dhduncan
dhduncan collected 472 from pot
dhduncan: doesn't show hand 
*** SUMMARY ***
Total pot 500 | Rake 28 
Board [6h Kh 9s 8h]
Seat 1: color_singleton (small blind) folded on the Turn
Seat 2: MnnM150 (big blind) folded before Flop
Seat 3: dhduncan collected (472)
Seat 5: Duke Croix (button) folded before Flop (didn't bet)



PokerStars Home Game Hand #221061502983: {Club #3225207}  Hold'em No Limit (50/100) - 2020/12/03 15:18:31 ET
Table 'Winifred' 9-max (Play Money) Seat #1 is the button
Seat 1: color_singleton (7376 in chips) 
Seat 2: MnnM150 (8169 in chips) 
Seat 3: dhduncan (9161 in chips) 
Seat 5: Duke Croix (13584 in chips) 
MnnM150: posts small blind 50
dhduncan: posts big blind 100
*** HOLE CARDS ***
Dealt to Duke Croix [6h 2s]
Duke Croix has timed out
Duke Croix: folds 
color_singleton: folds 
MnnM150: calls 50
dhduncan: checks 
*** FLOP *** [4d 4s Qs]
MnnM150: checks 
dhduncan: checks 
*** TURN *** [4d 4s Qs] [6s]
MnnM150: checks 
dhduncan: checks 
*** RIVER *** [4d 4s Qs 6s] [Qc]
MnnM150: checks 
dhduncan: checks 
*** SHOW DOWN ***
MnnM150: shows [7h Ad] (two pair, Queens and Fours)
dhduncan: mucks hand 
MnnM150 collected 189 from pot
*** SUMMARY ***
Total pot 200 | Rake 11 
Board [4d 4s Qs 6s Qc]
Seat 1: color_singleton (button) folded before Flop (didn't bet)
Seat 2: MnnM150 (small blind) showed [7h Ad] and won (189) with two pair, Queens and Fours
Seat 3: dhduncan (big blind) mucked [9h Kh]
Seat 5: Duke Croix folded before Flop (didn't bet)



PokerStars Home Game Hand #221061538652: {Club #3225207}  Hold'em No Limit (50/100) - 2020/12/03 15:19:22 ET
Table 'Winifred' 9-max (Play Money) Seat #2 is the button
Seat 1: color_singleton (7376 in chips) 
Seat 2: MnnM150 (8258 in chips) 
Seat 3: dhduncan (9061 in chips) 
Seat 5: Duke Croix (13584 in chips) 
dhduncan: posts small blind 50
Duke Croix: posts big blind 100
*** HOLE CARDS ***
Dealt to Duke Croix [6s Ah]
color_singleton: raises 100 to 200
MnnM150: calls 200
dhduncan: calls 150
Duke Croix: calls 100
*** FLOP *** [9s Tc Ts]
dhduncan: checks 
Duke Croix: checks 
color_singleton: checks 
MnnM150: checks 
*** TURN *** [9s Tc Ts] [3h]
dhduncan: checks 
Duke Croix: checks 
color_singleton: checks 
MnnM150: checks 
*** RIVER *** [9s Tc Ts 3h] [3s]
dhduncan: checks 
Duke Croix: checks 
color_singleton: checks 
MnnM150: bets 756
dhduncan: folds 
Duke Croix: folds 
color_singleton: folds 
Uncalled bet (756) returned to MnnM150
MnnM150 collected 756 from pot
*** SUMMARY ***
Total pot 800 | Rake 44 
Board [9s Tc Ts 3h 3s]
Seat 1: color_singleton folded on the River
Seat 2: MnnM150 (button) collected (756)
Seat 3: dhduncan (small blind) folded on the River
Seat 5: Duke Croix (big blind) folded on the River



PokerStars Home Game Hand #221061588738: {Club #3225207}  Hold'em No Limit (50/100) - 2020/12/03 15:20:35 ET
Table 'Winifred' 9-max (Play Money) Seat #3 is the button
Seat 1: color_singleton (7176 in chips) 
Seat 2: MnnM150 (8814 in chips) 
Seat 3: dhduncan (8861 in chips) 
Seat 5: Duke Croix (13384 in chips) 
Duke Croix: posts small blind 50
color_singleton: posts big blind 100
*** HOLE CARDS ***
Dealt to Duke Croix [8d 7c]
MnnM150: calls 100
dhduncan: calls 100
Duke Croix: calls 50
color_singleton: checks 
*** FLOP *** [4c Ts 2c]
Duke Croix: checks 
color_singleton has timed out
color_singleton: checks 
MnnM150: checks 
dhduncan: checks 
*** TURN *** [4c Ts 2c] [Ad]
Duke Croix: checks 
color_singleton: checks 
MnnM150: checks 
dhduncan: checks 
*** RIVER *** [4c Ts 2c Ad] [Jc]
Duke Croix: checks 
color_singleton: checks 
MnnM150: checks 
dhduncan: checks 
*** SHOW DOWN ***
Duke Croix: shows [8d 7c] (high card Ace)
color_singleton: mucks hand 
MnnM150: shows [4d 5d] (a pair of Fours)
dhduncan: mucks hand 
MnnM150 collected 378 from pot
*** SUMMARY ***
Total pot 400 | Rake 22 
Board [4c Ts 2c Ad Jc]
Seat 1: color_singleton (big blind) mucked [7s 6c]
Seat 2: MnnM150 showed [4d 5d] and won (378) with a pair of Fours
Seat 3: dhduncan (button) mucked [9d Kc]
Seat 5: Duke Croix (small blind) showed [8d 7c] and lost with high card Ace



PokerStars Home Game Hand #221061648486: {Club #3225207}  Hold'em No Limit (50/100) - 2020/12/03 15:22:01 ET
Table 'Winifred' 9-max (Play Money) Seat #5 is the button
Seat 1: color_singleton (7076 in chips) 
Seat 2: MnnM150 (9092 in chips) 
Seat 3: dhduncan (8761 in chips) 
Seat 5: Duke Croix (13284 in chips) 
color_singleton: posts small blind 50
MnnM150: posts big blind 100
*** HOLE CARDS ***
Dealt to Duke Croix [5h 3s]
dhduncan: calls 100
Duke Croix: folds 
color_singleton: folds 
MnnM150: checks 
*** FLOP *** [Qd 8h 3h]
MnnM150: checks 
dhduncan: checks 
*** TURN *** [Qd 8h 3h] [As]
MnnM150: checks 
dhduncan: bets 118
MnnM150: folds 
Uncalled bet (118) returned to dhduncan
dhduncan collected 236 from pot
dhduncan: doesn't show hand 
*** SUMMARY ***
Total pot 250 | Rake 14 
Board [Qd 8h 3h As]
Seat 1: color_singleton (small blind) folded before Flop
Seat 2: MnnM150 (big blind) folded on the Turn
Seat 3: dhduncan collected (236)
Seat 5: Duke Croix (button) folded before Flop (didn't bet)



PokerStars Home Game Hand #221061668378: {Club #3225207}  Hold'em No Limit (50/100) - 2020/12/03 15:22:30 ET
Table 'Winifred' 9-max (Play Money) Seat #1 is the button
Seat 1: color_singleton (7026 in chips) 
Seat 2: MnnM150 (8992 in chips) 
Seat 3: dhduncan (8897 in chips) 
Seat 5: Duke Croix (13284 in chips) 
MnnM150: posts small blind 50
dhduncan: posts big blind 100
*** HOLE CARDS ***
Dealt to Duke Croix [3s 9c]
Duke Croix: folds 
color_singleton: raises 100 to 200
MnnM150: folds 
dhduncan: calls 100
*** FLOP *** [Ts Kc 7h]
dhduncan: checks 
color_singleton: bets 212
dhduncan: folds 
Uncalled bet (212) returned to color_singleton
color_singleton collected 425 from pot
color_singleton: doesn't show hand 
*** SUMMARY ***
Total pot 450 | Rake 25 
Board [Ts Kc 7h]
Seat 1: color_singleton (button) collected (425)
Seat 2: MnnM150 (small blind) folded before Flop
Seat 3: dhduncan (big blind) folded on the Flop
Seat 5: Duke Croix folded before Flop (didn't bet)



PokerStars Home Game Hand #221061689748: {Club #3225207}  Hold'em No Limit (50/100) - 2020/12/03 15:23:01 ET
Table 'Winifred' 9-max (Play Money) Seat #2 is the button
Seat 1: color_singleton (7251 in chips) 
Seat 2: MnnM150 (8942 in chips) 
Seat 3: dhduncan (8697 in chips) 
Seat 5: Duke Croix (13284 in chips) 
dhduncan: posts small blind 50
Duke Croix: posts big blind 100
*** HOLE CARDS ***
Dealt to Duke Croix [Qh 6h]
color_singleton has timed out
color_singleton: folds 
MnnM150: calls 100
dhduncan: calls 50
Duke Croix: checks 
*** FLOP *** [Ah 2d 4d]
dhduncan: bets 100
Duke Croix: folds 
MnnM150: calls 100
*** TURN *** [Ah 2d 4d] [Kd]
dhduncan: bets 472
MnnM150: calls 472
*** RIVER *** [Ah 2d 4d Kd] [7d]
dhduncan: checks 
MnnM150: bets 1365
dhduncan: folds 
Uncalled bet (1365) returned to MnnM150
MnnM150 collected 1365 from pot
*** SUMMARY ***
Total pot 1444 | Rake 79 
Board [Ah 2d 4d Kd 7d]
Seat 1: color_singleton folded before Flop (didn't bet)
Seat 2: MnnM150 (button) collected (1365)
Seat 3: dhduncan (small blind) folded on the River
Seat 5: Duke Croix (big blind) folded on the Flop



PokerStars Home Game Hand #221061750351: {Club #3225207}  Hold'em No Limit (50/100) - 2020/12/03 15:24:25 ET
Table 'Winifred' 9-max (Play Money) Seat #3 is the button
Seat 2: MnnM150 (9635 in chips) 
Seat 3: dhduncan (8025 in chips) 
Seat 5: Duke Croix (13184 in chips) 
Duke Croix: posts small blind 50
MnnM150: posts big blind 100
*** HOLE CARDS ***
Dealt to Duke Croix [6c 6h]
dhduncan: folds 
Duke Croix: raises 300 to 400
MnnM150: calls 300
*** FLOP *** [Ac Qd 3c]
Duke Croix: bets 500
MnnM150: calls 500
*** TURN *** [Ac Qd 3c] [7s]
Duke Croix: bets 1000
MnnM150: folds 
Uncalled bet (1000) returned to Duke Croix
Duke Croix collected 1701 from pot
*** SUMMARY ***
Total pot 1800 | Rake 99 
Board [Ac Qd 3c 7s]
Seat 2: MnnM150 (big blind) folded on the Turn
Seat 3: dhduncan (button) folded before Flop (didn't bet)
Seat 5: Duke Croix (small blind) collected (1701)



PokerStars Home Game Hand #221061777523: {Club #3225207}  Hold'em No Limit (50/100) - 2020/12/03 15:25:04 ET
Table 'Winifred' 9-max (Play Money) Seat #5 is the button
Seat 2: MnnM150 (8735 in chips) 
Seat 3: dhduncan (8025 in chips) 
Seat 5: Duke Croix (13985 in chips) 
MnnM150: posts small blind 50
dhduncan: posts big blind 100
*** HOLE CARDS ***
Dealt to Duke Croix [7c Jc]
Duke Croix: folds 
MnnM150: folds 
Uncalled bet (50) returned to dhduncan
dhduncan collected 100 from pot
dhduncan: doesn't show hand 
*** SUMMARY ***
Total pot 100 | Rake 0 
Seat 2: MnnM150 (small blind) folded before Flop
Seat 3: dhduncan (big blind) collected (100)
Seat 5: Duke Croix (button) folded before Flop (didn't bet)



PokerStars Home Game Hand #221061781466: {Club #3225207}  Hold'em No Limit (50/100) - 2020/12/03 15:25:10 ET
Table 'Winifred' 9-max (Play Money) Seat #2 is the button
Seat 2: MnnM150 (8685 in chips) 
Seat 3: dhduncan (8075 in chips) 
Seat 5: Duke Croix (13985 in chips) 
dhduncan: posts small blind 50
Duke Croix: posts big blind 100
*** HOLE CARDS ***
Dealt to Duke Croix [6d Tc]
MnnM150: folds 
dhduncan: calls 50
Duke Croix: checks 
*** FLOP *** [Qc 5c 8c]
dhduncan: checks 
Duke Croix: bets 200
dhduncan: calls 200
*** TURN *** [Qc 5c 8c] [8h]
dhduncan: checks 
Duke Croix: checks 
*** RIVER *** [Qc 5c 8c 8h] [4s]
dhduncan: checks 
Duke Croix: checks 
*** SHOW DOWN ***
dhduncan: shows [Jd Kd] (a pair of Eights)
Duke Croix: mucks hand 
dhduncan collected 567 from pot
*** SUMMARY ***
Total pot 600 | Rake 33 
Board [Qc 5c 8c 8h 4s]
Seat 2: MnnM150 (button) folded before Flop (didn't bet)
Seat 3: dhduncan (small blind) showed [Jd Kd] and won (567) with a pair of Eights
Seat 5: Duke Croix (big blind) mucked [6d Tc]



PokerStars Home Game Hand #221061807133: {Club #3225207}  Hold'em No Limit (50/100) - 2020/12/03 15:25:47 ET
Table 'Winifred' 9-max (Play Money) Seat #3 is the button
Seat 2: MnnM150 (8685 in chips) 
Seat 3: dhduncan (8342 in chips) 
Seat 5: Duke Croix (13685 in chips) 
Duke Croix: posts small blind 50
MnnM150: posts big blind 100
*** HOLE CARDS ***
Dealt to Duke Croix [Kd 3d]
dhduncan: calls 100
Duke Croix: calls 50
MnnM150: checks 
*** FLOP *** [4d Js Jd]
Duke Croix: bets 200
MnnM150: calls 200
dhduncan: folds 
*** TURN *** [4d Js Jd] [Qc]
Duke Croix: bets 400
MnnM150: calls 400
*** RIVER *** [4d Js Jd Qc] [7h]
Duke Croix: checks 
MnnM150: checks 
*** SHOW DOWN ***
Duke Croix: shows [Kd 3d] (a pair of Jacks)
MnnM150: shows [4c Ts] (two pair, Jacks and Fours)
MnnM150 collected 1417 from pot
*** SUMMARY ***
Total pot 1500 | Rake 83 
Board [4d Js Jd Qc 7h]
Seat 2: MnnM150 (big blind) showed [4c Ts] and won (1417) with two pair, Jacks and Fours
Seat 3: dhduncan (button) folded on the Flop
Seat 5: Duke Croix (small blind) showed [Kd 3d] and lost with a pair of Jacks



PokerStars Home Game Hand #221061834863: {Club #3225207}  Hold'em No Limit (50/100) - 2020/12/03 15:26:28 ET
Table 'Winifred' 9-max (Play Money) Seat #5 is the button
Seat 2: MnnM150 (9402 in chips) 
Seat 3: dhduncan (8242 in chips) 
Seat 5: Duke Croix (12985 in chips) 
MnnM150: posts small blind 50
dhduncan: posts big blind 100
*** HOLE CARDS ***
Dealt to Duke Croix [2c Ad]
Duke Croix: raises 200 to 300
MnnM150: folds 
dhduncan: folds 
Uncalled bet (200) returned to Duke Croix
Duke Croix collected 250 from pot
*** SUMMARY ***
Total pot 250 | Rake 0 
Seat 2: MnnM150 (small blind) folded before Flop
Seat 3: dhduncan (big blind) folded before Flop
Seat 5: Duke Croix (button) collected (250)



PokerStars Home Game Hand #221061847050: {Club #3225207}  Hold'em No Limit (50/100) - 2020/12/03 15:26:45 ET
Table 'Winifred' 9-max (Play Money) Seat #2 is the button
Seat 1: color_singleton (7251 in chips) 
Seat 2: MnnM150 (9352 in chips) 
Seat 3: dhduncan (8142 in chips) 
Seat 5: Duke Croix (13135 in chips) 
dhduncan: posts small blind 50
Duke Croix: posts big blind 100
color_singleton: posts small & big blinds 150
*** HOLE CARDS ***
Dealt to Duke Croix [3h Jh]
color_singleton: checks 
MnnM150: folds 
dhduncan: folds 
Duke Croix: checks 
*** FLOP *** [3s 6d Qs]
Klemtonius joins the table at seat #8 
Duke Croix has timed out
Duke Croix: checks 
color_singleton: bets 141
Duke Croix: calls 141
*** TURN *** [3s 6d Qs] [Tc]
Duke Croix: checks 
color_singleton: bets 275
Duke Croix: folds 
Uncalled bet (275) returned to color_singleton
color_singleton collected 550 from pot
color_singleton: doesn't show hand 
*** SUMMARY ***
Total pot 582 | Rake 32 
Board [3s 6d Qs Tc]
Seat 1: color_singleton collected (550)
Seat 2: MnnM150 (button) folded before Flop (didn't bet)
Seat 3: dhduncan (small blind) folded before Flop
Seat 5: Duke Croix (big blind) folded on the Turn



PokerStars Home Game Hand #221061881594: {Club #3225207}  Hold'em No Limit (50/100) - 2020/12/03 15:27:35 ET
Table 'Winifred' 9-max (Play Money) Seat #3 is the button
Seat 1: color_singleton (7510 in chips) 
Seat 2: MnnM150 (9352 in chips) 
Seat 3: dhduncan (8092 in chips) 
Seat 5: Duke Croix (12894 in chips) 
Seat 8: Klemtonius (10000 in chips) 
Duke Croix: posts small blind 50
Klemtonius: posts big blind 100
*** HOLE CARDS ***
Dealt to Duke Croix [As 2c]
color_singleton: raises 200 to 300
MnnM150: calls 300
dhduncan: folds 
Duke Croix: folds 
Klemtonius: calls 200
*** FLOP *** [Ac Ah 7c]
Klemtonius: bets 100
color_singleton: raises 100 to 200
MnnM150: folds 
Klemtonius: folds 
Uncalled bet (100) returned to color_singleton
color_singleton collected 1087 from pot
color_singleton: doesn't show hand 
*** SUMMARY ***
Total pot 1150 | Rake 63 
Board [Ac Ah 7c]
Seat 1: color_singleton collected (1087)
Seat 2: MnnM150 folded on the Flop
Seat 3: dhduncan (button) folded before Flop (didn't bet)
Seat 5: Duke Croix (small blind) folded before Flop
Seat 8: Klemtonius (big blind) folded on the Flop



PokerStars Home Game Hand #221061917254: {Club #3225207}  Hold'em No Limit (50/100) - 2020/12/03 15:28:27 ET
Table 'Winifred' 9-max (Play Money) Seat #5 is the button
Seat 1: color_singleton (8197 in chips) 
Seat 2: MnnM150 (9052 in chips) 
Seat 3: dhduncan (8092 in chips) 
Seat 5: Duke Croix (12844 in chips) 
Seat 8: Klemtonius (9600 in chips) 
Klemtonius: posts small blind 50
color_singleton: posts big blind 100
*** HOLE CARDS ***
Dealt to Duke Croix [3c Kc]
MnnM150 has timed out
MnnM150: folds 
dhduncan: folds 
Duke Croix: folds 
Klemtonius: calls 50
color_singleton: checks 
*** FLOP *** [7c Ah 4c]
Klemtonius: checks 
color_singleton: checks 
*** TURN *** [7c Ah 4c] [8c]
Klemtonius: bets 189
color_singleton: folds 
Uncalled bet (189) returned to Klemtonius
Klemtonius collected 189 from pot
Klemtonius: doesn't show hand 
*** SUMMARY ***
Total pot 200 | Rake 11 
Board [7c Ah 4c 8c]
Seat 1: color_singleton (big blind) folded on the Turn
Seat 2: MnnM150 folded before Flop (didn't bet)
Seat 3: dhduncan folded before Flop (didn't bet)
Seat 5: Duke Croix (button) folded before Flop (didn't bet)
Seat 8: Klemtonius (small blind) collected (189)



PokerStars Home Game Hand #221061949647: {Club #3225207}  Hold'em No Limit (50/100) - 2020/12/03 15:29:14 ET
Table 'Winifred' 9-max (Play Money) Seat #8 is the button
Seat 1: color_singleton (8097 in chips) 
Seat 2: MnnM150 (9052 in chips) 
Seat 3: dhduncan (8092 in chips) 
Seat 5: Duke Croix (12844 in chips) 
Seat 8: Klemtonius (9689 in chips) 
color_singleton: posts small blind 50
MnnM150: posts big blind 100
*** HOLE CARDS ***
Dealt to Duke Croix [Qh 6c]
dhduncan: calls 100
Duke Croix has timed out
Duke Croix: folds 
Klemtonius: calls 100
color_singleton: calls 50
MnnM150: checks 
*** FLOP *** [Qd 6h 2h]
color_singleton: checks 
MnnM150: checks 
dhduncan: bets 378
Klemtonius: folds 
color_singleton: folds 
MnnM150: folds 
Uncalled bet (378) returned to dhduncan
dhduncan collected 378 from pot
dhduncan: doesn't show hand 
*** SUMMARY ***
Total pot 400 | Rake 22 
Board [Qd 6h 2h]
Seat 1: color_singleton (small blind) folded on the Flop
Seat 2: MnnM150 (big blind) folded on the Flop
Seat 3: dhduncan collected (378)
Seat 5: Duke Croix folded before Flop (didn't bet)
Seat 8: Klemtonius (button) folded on the Flop



PokerStars Home Game Hand #221061996970: {Club #3225207}  Hold'em No Limit (50/100) - 2020/12/03 15:30:23 ET
Table 'Winifred' 9-max (Play Money) Seat #1 is the button
Seat 1: color_singleton (7997 in chips) 
Seat 2: MnnM150 (8952 in chips) 
Seat 3: dhduncan (8370 in chips) 
Seat 5: Duke Croix (12844 in chips) 
Seat 8: Klemtonius (9589 in chips) 
MnnM150: posts small blind 50
dhduncan: posts big blind 100
*** HOLE CARDS ***
Dealt to Duke Croix [Qd Jh]
Duke Croix: raises 200 to 300
Klemtonius: calls 300
color_singleton: folds 
MnnM150: folds 
dhduncan: calls 200
*** FLOP *** [Kc 5d Js]
dhduncan: checks 
Duke Croix: bets 400
Klemtonius: calls 400
dhduncan: folds 
*** TURN *** [Kc 5d Js] [5s]
Duke Croix: bets 700
Klemtonius: calls 700
*** RIVER *** [Kc 5d Js 5s] [Qc]
Duke Croix: bets 1700
Klemtonius: calls 1700
*** SHOW DOWN ***
Duke Croix: shows [Qd Jh] (two pair, Queens and Jacks)
Klemtonius: shows [Ks 6s] (two pair, Kings and Fives)
Klemtonius collected 6190 from pot
*** SUMMARY ***
Total pot 6550 | Rake 360 
Board [Kc 5d Js 5s Qc]
Seat 1: color_singleton (button) folded before Flop (didn't bet)
Seat 2: MnnM150 (small blind) folded before Flop
Seat 3: dhduncan (big blind) folded on the Flop
Seat 5: Duke Croix showed [Qd Jh] and lost with two pair, Queens and Jacks
Seat 8: Klemtonius showed [Ks 6s] and won (6190) with two pair, Kings and Fives



PokerStars Home Game Hand #221062038687: {Club #3225207}  Hold'em No Limit (50/100) - 2020/12/03 15:31:24 ET
Table 'Winifred' 9-max (Play Money) Seat #2 is the button
Seat 1: color_singleton (7997 in chips) 
Seat 2: MnnM150 (8902 in chips) 
Seat 3: dhduncan (8070 in chips) 
Seat 5: Duke Croix (9744 in chips) 
Seat 8: Klemtonius (12679 in chips) 
dhduncan: posts small blind 50
Duke Croix: posts big blind 100
*** HOLE CARDS ***
Dealt to Duke Croix [Js 8d]
Klemtonius: folds 
color_singleton: raises 200 to 300
MnnM150: folds 
dhduncan: folds 
Duke Croix: calls 200
*** FLOP *** [Kd Qd 9s]
Duke Croix: checks 
color_singleton: checks 
*** TURN *** [Kd Qd 9s] [3c]
Duke Croix: checks 
color_singleton: checks 
*** RIVER *** [Kd Qd 9s 3c] [8s]
Duke Croix: checks 
color_singleton: checks 
*** SHOW DOWN ***
Duke Croix: shows [Js 8d] (a pair of Eights)
color_singleton: mucks hand 
Duke Croix collected 614 from pot
*** SUMMARY ***
Total pot 650 | Rake 36 
Board [Kd Qd 9s 3c 8s]
Seat 1: color_singleton mucked [Ad 4h]
Seat 2: MnnM150 (button) folded before Flop (didn't bet)
Seat 3: dhduncan (small blind) folded before Flop
Seat 5: Duke Croix (big blind) showed [Js 8d] and won (614) with a pair of Eights
Seat 8: Klemtonius folded before Flop (didn't bet)



PokerStars Home Game Hand #221062072305: {Club #3225207}  Hold'em No Limit (50/100) - 2020/12/03 15:32:13 ET
Table 'Winifred' 9-max (Play Money) Seat #3 is the button
Seat 1: color_singleton (7697 in chips) 
Seat 2: MnnM150 (8902 in chips) 
Seat 3: dhduncan (8020 in chips) 
Seat 5: Duke Croix (10058 in chips) 
Seat 8: Klemtonius (12679 in chips) 
Duke Croix: posts small blind 50
Klemtonius: posts big blind 100
*** HOLE CARDS ***
Dealt to Duke Croix [4c 9h]
color_singleton: folds 
MnnM150: calls 100
dhduncan: calls 100
Duke Croix: folds 
Klemtonius: raises 100 to 200
MnnM150: calls 100
dhduncan: calls 100
*** FLOP *** [4h 2s Qh]
Klemtonius: bets 400
MnnM150: folds 
dhduncan: folds 
Uncalled bet (400) returned to Klemtonius
Klemtonius collected 614 from pot
Klemtonius: doesn't show hand 
*** SUMMARY ***
Total pot 650 | Rake 36 
Board [4h 2s Qh]
Seat 1: color_singleton folded before Flop (didn't bet)
Seat 2: MnnM150 folded on the Flop
Seat 3: dhduncan (button) folded on the Flop
Seat 5: Duke Croix (small blind) folded before Flop
Seat 8: Klemtonius (big blind) collected (614)



PokerStars Home Game Hand #221062091315: {Club #3225207}  Hold'em No Limit (50/100) - 2020/12/03 15:32:40 ET
Table 'Winifred' 9-max (Play Money) Seat #5 is the button
Seat 1: color_singleton (7697 in chips) 
Seat 2: MnnM150 (8702 in chips) 
Seat 3: dhduncan (7820 in chips) 
Seat 5: Duke Croix (10008 in chips) 
Seat 8: Klemtonius (13093 in chips) 
Klemtonius: posts small blind 50
color_singleton: posts big blind 100
*** HOLE CARDS ***
Dealt to Duke Croix [7d 3h]
MnnM150: calls 100
dhduncan: folds 
Duke Croix: folds 
Klemtonius: calls 50
color_singleton: raises 100 to 200
MnnM150: calls 100
Klemtonius: calls 100
*** FLOP *** [6h 3c Jc]
Klemtonius: checks 
color_singleton: checks 
MnnM150: checks 
*** TURN *** [6h 3c Jc] [7c]
Klemtonius: bets 567
color_singleton: folds 
MnnM150: folds 
Uncalled bet (567) returned to Klemtonius
Klemtonius collected 567 from pot
Klemtonius: doesn't show hand 
*** SUMMARY ***
Total pot 600 | Rake 33 
Board [6h 3c Jc 7c]
Seat 1: color_singleton (big blind) folded on the Turn
Seat 2: MnnM150 folded on the Turn
Seat 3: dhduncan folded before Flop (didn't bet)
Seat 5: Duke Croix (button) folded before Flop (didn't bet)
Seat 8: Klemtonius (small blind) collected (567)



PokerStars Home Game Hand #221062119842: {Club #3225207}  Hold'em No Limit (50/100) - 2020/12/03 15:33:22 ET
Table 'Winifred' 9-max (Play Money) Seat #8 is the button
Seat 1: color_singleton (7497 in chips) 
Seat 2: MnnM150 (8502 in chips) 
Seat 3: dhduncan (7820 in chips) 
Seat 5: Duke Croix (10008 in chips) 
Seat 8: Klemtonius (13460 in chips) 
color_singleton: posts small blind 50
MnnM150: posts big blind 100
*** HOLE CARDS ***
Dealt to Duke Croix [Kd 8s]
dhduncan: calls 100
Duke Croix: folds 
Klemtonius: raises 350 to 450
color_singleton: calls 400
MnnM150: folds 
dhduncan: calls 350
*** FLOP *** [Tc Jh 4h]
color_singleton: checks 
dhduncan: checks 
Klemtonius: checks 
*** TURN *** [Tc Jh 4h] [Ks]
color_singleton: bets 685
dhduncan: calls 685
Klemtonius: calls 685
*** RIVER *** [Tc Jh 4h Ks] [3h]
color_singleton: bets 1656
dhduncan: calls 1656
Klemtonius: raises 1656 to 3312
color_singleton: folds 
dhduncan: calls 1656
*** SHOW DOWN ***
Klemtonius: shows [Ac Qs] (a straight, Ten to Ace)
dhduncan: shows [9h Kh] (a flush, King high)
dhduncan collected 11137 from pot
*** SUMMARY ***
Total pot 11785 | Rake 648 
Board [Tc Jh 4h Ks 3h]
Seat 1: color_singleton (small blind) folded on the River
Seat 2: MnnM150 (big blind) folded before Flop
Seat 3: dhduncan showed [9h Kh] and won (11137) with a flush, King high
Seat 5: Duke Croix folded before Flop (didn't bet)
Seat 8: Klemtonius (button) showed [Ac Qs] and lost with a straight, Ten to Ace



PokerStars Home Game Hand #221062167572: {Club #3225207}  Hold'em No Limit (50/100) - 2020/12/03 15:34:20 ET
Table 'Winifred' 9-max (Play Money) Seat #1 is the button
Seat 1: color_singleton (4706 in chips) 
Seat 2: MnnM150 (8402 in chips) 
Seat 3: dhduncan (14510 in chips) 
Seat 5: Duke Croix (10008 in chips) 
Seat 8: Klemtonius (9013 in chips) 
MnnM150: posts small blind 50
dhduncan: posts big blind 100
*** HOLE CARDS ***
Dealt to Duke Croix [Qh Qc]
Duke Croix: raises 400 to 500
Klemtonius: calls 500
color_singleton: raises 800 to 1300
MnnM150: folds 
dhduncan: folds 
Duke Croix: calls 800
Klemtonius: folds 
*** FLOP *** [2c Jc 2d]
Duke Croix: bets 8708 and is all-in
color_singleton: calls 3406 and is all-in
Uncalled bet (5302) returned to Duke Croix
*** TURN *** [2c Jc 2d] [Qd]
*** RIVER *** [2c Jc 2d Qd] [4c]
*** SHOW DOWN ***
Duke Croix: shows [Qh Qc] (a full house, Queens full of Deuces)
color_singleton: shows [Kd Kc] (two pair, Kings and Deuces)
Duke Croix collected 9509 from pot
*** SUMMARY ***
Total pot 10062 | Rake 553 
Board [2c Jc 2d Qd 4c]
Seat 1: color_singleton (button) showed [Kd Kc] and lost with two pair, Kings and Deuces
Seat 2: MnnM150 (small blind) folded before Flop
Seat 3: dhduncan (big blind) folded before Flop
Seat 5: Duke Croix showed [Qh Qc] and won (9509) with a full house, Queens full of Deuces
Seat 8: Klemtonius folded before Flop



PokerStars Home Game Hand #221062191999: {Club #3225207}  Hold'em No Limit (50/100) - 2020/12/03 15:34:55 ET
Table 'Winifred' 9-max (Play Money) Seat #2 is the button
Seat 2: MnnM150 (8352 in chips) 
Seat 3: dhduncan (14410 in chips) 
Seat 5: Duke Croix (14811 in chips) 
Seat 8: Klemtonius (8513 in chips) 
dhduncan: posts small blind 50
Duke Croix: posts big blind 100
*** HOLE CARDS ***
Dealt to Duke Croix [6s 6h]
Klemtonius: calls 100
MnnM150: raises 100 to 200
dhduncan: folds 
Duke Croix: calls 100
Klemtonius: calls 100
*** FLOP *** [4c 6d As]
Duke Croix: checks 
Klemtonius: checks 
MnnM150: checks 
*** TURN *** [4c 6d As] [Tc]
Duke Croix: bets 400
Klemtonius: folds 
MnnM150: calls 400
*** RIVER *** [4c 6d As Tc] [Js]
Duke Croix: bets 700
MnnM150: raises 700 to 1400
Duke Croix: raises 900 to 2300
MnnM150: raises 900 to 3200
Duke Croix: calls 900
*** SHOW DOWN ***
MnnM150: shows [Jd Jc] (three of a kind, Jacks)
Duke Croix: mucks hand 
MnnM150 collected 7418 from pot
*** SUMMARY ***
Total pot 7850 | Rake 432 
Board [4c 6d As Tc Js]
Seat 2: MnnM150 (button) showed [Jd Jc] and won (7418) with three of a kind, Jacks
Seat 3: dhduncan (small blind) folded before Flop
Seat 5: Duke Croix (big blind) mucked [6s 6h]
Seat 8: Klemtonius folded on the Turn



PokerStars Home Game Hand #221062231279: {Club #3225207}  Hold'em No Limit (50/100) - 2020/12/03 15:35:53 ET
Table 'Winifred' 9-max (Play Money) Seat #3 is the button
Seat 1: color_singleton (10000 in chips) 
Seat 2: MnnM150 (11970 in chips) 
Seat 3: dhduncan (14360 in chips) 
Seat 5: Duke Croix (11011 in chips) 
Seat 8: Klemtonius (8313 in chips) 
Duke Croix: posts small blind 50
Klemtonius: posts big blind 100
*** HOLE CARDS ***
Dealt to Duke Croix [Jd 7h]
color_singleton: raises 100 to 200
MnnM150: folds 
dhduncan: folds 
Duke Croix: folds 
Klemtonius: calls 100
*** FLOP *** [5s Jc 2d]
Klemtonius: checks 
color_singleton: bets 212
Klemtonius: folds 
Uncalled bet (212) returned to color_singleton
color_singleton collected 425 from pot
color_singleton: doesn't show hand 
*** SUMMARY ***
Total pot 450 | Rake 25 
Board [5s Jc 2d]
Seat 1: color_singleton collected (425)
Seat 2: MnnM150 folded before Flop (didn't bet)
Seat 3: dhduncan (button) folded before Flop (didn't bet)
Seat 5: Duke Croix (small blind) folded before Flop
Seat 8: Klemtonius (big blind) folded on the Flop



PokerStars Home Game Hand #221062248537: {Club #3225207}  Hold'em No Limit (50/100) - 2020/12/03 15:36:18 ET
Table 'Winifred' 9-max (Play Money) Seat #5 is the button
Seat 1: color_singleton (10225 in chips) 
Seat 2: MnnM150 (11970 in chips) 
Seat 3: dhduncan (14360 in chips) 
Seat 5: Duke Croix (10961 in chips) 
Seat 8: Klemtonius (8113 in chips) 
Klemtonius: posts small blind 50
color_singleton: posts big blind 100
*** HOLE CARDS ***
Dealt to Duke Croix [Jd Kd]
MnnM150: folds 
dhduncan: calls 100
Duke Croix: raises 300 to 400
Klemtonius: calls 350
color_singleton: calls 300
dhduncan: calls 300
*** FLOP *** [Th 6c Ts]
Klemtonius: checks 
color_singleton: checks 
dhduncan: checks 
Duke Croix: checks 
*** TURN *** [Th 6c Ts] [8d]
Klemtonius: bets 1512
color_singleton: calls 1512
dhduncan: folds 
Duke Croix: folds 
*** RIVER *** [Th 6c Ts 8d] [3s]
Klemtonius: checks 
color_singleton: checks 
*** SHOW DOWN ***
Klemtonius: shows [4h 7c] (a pair of Tens)
color_singleton: shows [Ks 8s] (two pair, Tens and Eights)
color_singleton collected 4370 from pot
*** SUMMARY ***
Total pot 4624 | Rake 254 
Board [Th 6c Ts 8d 3s]
Seat 1: color_singleton (big blind) showed [Ks 8s] and won (4370) with two pair, Tens and Eights
Seat 2: MnnM150 folded before Flop (didn't bet)
Seat 3: dhduncan folded on the Turn
Seat 5: Duke Croix (button) folded on the Turn
Seat 8: Klemtonius (small blind) showed [4h 7c] and lost with a pair of Tens



PokerStars Home Game Hand #221062285723: {Club #3225207}  Hold'em No Limit (50/100) - 2020/12/03 15:37:12 ET
Table 'Winifred' 9-max (Play Money) Seat #8 is the button
Seat 1: color_singleton (12683 in chips) 
Seat 2: MnnM150 (11970 in chips) 
Seat 3: dhduncan (13960 in chips) 
Seat 5: Duke Croix (10561 in chips) 
Seat 8: Klemtonius (6201 in chips) 
color_singleton: posts small blind 50
MnnM150: posts big blind 100
*** HOLE CARDS ***
Dealt to Duke Croix [Ac 4h]
dhduncan: calls 100
Duke Croix: raises 300 to 400
Klemtonius: folds 
color_singleton: calls 350
MnnM150: folds 
dhduncan: folds 
*** FLOP *** [3h As 2d]
color_singleton: checks 
Duke Croix: bets 500
color_singleton: folds 
Uncalled bet (500) returned to Duke Croix
Duke Croix collected 945 from pot
*** SUMMARY ***
Total pot 1000 | Rake 55 
Board [3h As 2d]
Seat 1: color_singleton (small blind) folded on the Flop
Seat 2: MnnM150 (big blind) folded before Flop
Seat 3: dhduncan folded before Flop
Seat 5: Duke Croix collected (945)
Seat 8: Klemtonius (button) folded before Flop (didn't bet)



PokerStars Home Game Hand #221062308110: {Club #3225207}  Hold'em No Limit (50/100) - 2020/12/03 15:37:45 ET
Table 'Winifred' 9-max (Play Money) Seat #1 is the button
Seat 1: color_singleton (12283 in chips) 
Seat 2: MnnM150 (11870 in chips) 
Seat 3: dhduncan (13860 in chips) 
Seat 5: Duke Croix (11106 in chips) 
Seat 8: Klemtonius (6201 in chips) 
MnnM150: posts small blind 50
dhduncan: posts big blind 100
*** HOLE CARDS ***
Dealt to Duke Croix [6h Jc]
Duke Croix: folds 
Klemtonius: folds 
color_singleton: raises 200 to 300
MnnM150: folds 
dhduncan: folds 
Uncalled bet (200) returned to color_singleton
color_singleton collected 250 from pot
color_singleton: doesn't show hand 
*** SUMMARY ***
Total pot 250 | Rake 0 
Seat 1: color_singleton (button) collected (250)
Seat 2: MnnM150 (small blind) folded before Flop
Seat 3: dhduncan (big blind) folded before Flop
Seat 5: Duke Croix folded before Flop (didn't bet)
Seat 8: Klemtonius folded before Flop (didn't bet)



PokerStars Home Game Hand #221062317753: {Club #3225207}  Hold'em No Limit (50/100) - 2020/12/03 15:37:59 ET
Table 'Winifred' 9-max (Play Money) Seat #2 is the button
Seat 1: color_singleton (12433 in chips) 
Seat 2: MnnM150 (11820 in chips) 
Seat 3: dhduncan (13760 in chips) 
Seat 5: Duke Croix (11106 in chips) 
Seat 8: Klemtonius (6201 in chips) 
dhduncan: posts small blind 50
Duke Croix: posts big blind 100
*** HOLE CARDS ***
Dealt to Duke Croix [Jc 6h]
Klemtonius: raises 100 to 200
color_singleton: folds 
MnnM150: folds 
dhduncan: folds 
Duke Croix: calls 100
*** FLOP *** [Tc 4h Jh]
Duke Croix: bets 300
Klemtonius: calls 300
*** TURN *** [Tc 4h Jh] [Qd]
Duke Croix: checks 
Klemtonius: checks 
*** RIVER *** [Tc 4h Jh Qd] [3d]
Duke Croix: bets 500
Klemtonius: folds 
Uncalled bet (500) returned to Duke Croix
Duke Croix collected 992 from pot
*** SUMMARY ***
Total pot 1050 | Rake 58 
Board [Tc 4h Jh Qd 3d]
Seat 1: color_singleton folded before Flop (didn't bet)
Seat 2: MnnM150 (button) folded before Flop (didn't bet)
Seat 3: dhduncan (small blind) folded before Flop
Seat 5: Duke Croix (big blind) collected (992)
Seat 8: Klemtonius folded on the River



PokerStars Home Game Hand #221062342044: {Club #3225207}  Hold'em No Limit (50/100) - 2020/12/03 15:38:35 ET
Table 'Winifred' 9-max (Play Money) Seat #3 is the button
Seat 1: color_singleton (12433 in chips) 
Seat 2: MnnM150 (11820 in chips) 
Seat 3: dhduncan (13710 in chips) 
Seat 5: Duke Croix (11598 in chips) 
Seat 8: Klemtonius (5701 in chips) 
Duke Croix: posts small blind 50
Klemtonius: posts big blind 100
*** HOLE CARDS ***
Dealt to Duke Croix [8s 7s]
color_singleton: folds 
MnnM150: calls 100
dhduncan: calls 100
Duke Croix: calls 50
Klemtonius: checks 
*** FLOP *** [Kc 7h 4h]
Duke Croix: checks 
Klemtonius: checks 
MnnM150: checks 
dhduncan: bets 100
Duke Croix: calls 100
Klemtonius: calls 100
MnnM150: calls 100
*** TURN *** [Kc 7h 4h] [Ad]
Duke Croix: checks 
Klemtonius: checks 
MnnM150: checks 
dhduncan: bets 100
Duke Croix: calls 100
Klemtonius: calls 100
MnnM150: calls 100
*** RIVER *** [Kc 7h 4h Ad] [4d]
Duke Croix: checks 
Klemtonius: checks 
MnnM150: checks 
dhduncan: checks 
*** SHOW DOWN ***
Duke Croix: shows [8s 7s] (two pair, Sevens and Fours)
Klemtonius: mucks hand 
MnnM150: mucks hand 
dhduncan: shows [Qh Kh] (two pair, Kings and Fours)
dhduncan collected 1134 from pot
*** SUMMARY ***
Total pot 1200 | Rake 66 
Board [Kc 7h 4h Ad 4d]
Seat 1: color_singleton folded before Flop (didn't bet)
Seat 2: MnnM150 mucked [Qs Jh]
Seat 3: dhduncan (button) showed [Qh Kh] and won (1134) with two pair, Kings and Fours
Seat 5: Duke Croix (small blind) showed [8s 7s] and lost with two pair, Sevens and Fours
Seat 8: Klemtonius (big blind) mucked [Qd 5d]



PokerStars Home Game Hand #221062388385: {Club #3225207}  Hold'em No Limit (50/100) - 2020/12/03 15:39:44 ET
Table 'Winifred' 9-max (Play Money) Seat #5 is the button
Seat 1: color_singleton (12433 in chips) 
Seat 2: MnnM150 (11520 in chips) 
Seat 3: dhduncan (14544 in chips) 
Seat 5: Duke Croix (11298 in chips) 
Seat 8: Klemtonius (5401 in chips) 
Klemtonius: posts small blind 50
color_singleton: posts big blind 100
*** HOLE CARDS ***
Dealt to Duke Croix [5h Js]
MnnM150: folds 
dhduncan: folds 
Duke Croix: folds 
Klemtonius: raises 100 to 200
color_singleton: calls 100
*** FLOP *** [Kd 7h Jd]
Klemtonius: checks 
color_singleton: bets 189
Klemtonius: folds 
Uncalled bet (189) returned to color_singleton
color_singleton collected 378 from pot
color_singleton: doesn't show hand 
*** SUMMARY ***
Total pot 400 | Rake 22 
Board [Kd 7h Jd]
Seat 1: color_singleton (big blind) collected (378)
Seat 2: MnnM150 folded before Flop (didn't bet)
Seat 3: dhduncan folded before Flop (didn't bet)
Seat 5: Duke Croix (button) folded before Flop (didn't bet)
Seat 8: Klemtonius (small blind) folded on the Flop



PokerStars Home Game Hand #221062403005: {Club #3225207}  Hold'em No Limit (50/100) - 2020/12/03 15:40:06 ET
Table 'Winifred' 9-max (Play Money) Seat #8 is the button
Seat 1: color_singleton (12611 in chips) 
Seat 2: MnnM150 (11520 in chips) 
Seat 3: dhduncan (14544 in chips) 
Seat 5: Duke Croix (11298 in chips) 
Seat 8: Klemtonius (5201 in chips) 
color_singleton: posts small blind 50
MnnM150: posts big blind 100
*** HOLE CARDS ***
Dealt to Duke Croix [Ts Qs]
dhduncan: calls 100
Duke Croix: raises 300 to 400
Klemtonius: folds 
color_singleton: folds 
MnnM150: folds 
dhduncan: calls 300
*** FLOP *** [Jh 6h 5d]
dhduncan: checks 
Duke Croix: checks 
*** TURN *** [Jh 6h 5d] [9d]
dhduncan has timed out
dhduncan: checks 
Duke Croix: bets 500
dhduncan: folds 
Uncalled bet (500) returned to Duke Croix
Duke Croix collected 898 from pot
*** SUMMARY ***
Total pot 950 | Rake 52 
Board [Jh 6h 5d 9d]
Seat 1: color_singleton (small blind) folded before Flop
Seat 2: MnnM150 (big blind) folded before Flop
Seat 3: dhduncan folded on the Turn
Seat 5: Duke Croix collected (898)
Seat 8: Klemtonius (button) folded before Flop (didn't bet)



PokerStars Home Game Hand #221062439155: {Club #3225207}  Hold'em No Limit (50/100) - 2020/12/03 15:40:59 ET
Table 'Winifred' 9-max (Play Money) Seat #1 is the button
Seat 1: color_singleton (12561 in chips) 
Seat 2: MnnM150 (11420 in chips) 
Seat 3: dhduncan (14144 in chips) 
Seat 5: Duke Croix (11796 in chips) 
Seat 8: Klemtonius (5201 in chips) 
MnnM150: posts small blind 50
dhduncan: posts big blind 100
*** HOLE CARDS ***
Dealt to Duke Croix [9d 8h]
Duke Croix: calls 100
Klemtonius: calls 100
color_singleton: raises 100 to 200
MnnM150: calls 150
dhduncan: folds 
Duke Croix: calls 100
Klemtonius: calls 100
*** FLOP *** [Qc 6h As]
MnnM150: checks 
Duke Croix: checks 
Klemtonius: checks 
color_singleton: checks 
*** TURN *** [Qc 6h As] [Qs]
MnnM150: checks 
Duke Croix: checks 
Klemtonius: checks 
color_singleton: checks 
*** RIVER *** [Qc 6h As Qs] [6d]
MnnM150: checks 
Duke Croix: checks 
Klemtonius: checks 
color_singleton: checks 
*** SHOW DOWN ***
MnnM150: shows [4s Ks] (two pair, Queens and Sixes)
Duke Croix: shows [9d 8h] (two pair, Queens and Sixes)
Klemtonius: shows [Js Th] (two pair, Queens and Sixes)
color_singleton: shows [4d Kd] (two pair, Queens and Sixes)
MnnM150 collected 213 from pot
Duke Croix collected 213 from pot
Klemtonius collected 212 from pot
color_singleton collected 212 from pot
*** SUMMARY ***
Total pot 900 | Rake 50 
Board [Qc 6h As Qs 6d]
Seat 1: color_singleton (button) showed [4d Kd] and won (212) with two pair, Queens and Sixes
Seat 2: MnnM150 (small blind) showed [4s Ks] and won (213) with two pair, Queens and Sixes
Seat 3: dhduncan (big blind) folded before Flop
Seat 5: Duke Croix showed [9d 8h] and won (213) with two pair, Queens and Sixes
Seat 8: Klemtonius showed [Js Th] and won (212) with two pair, Queens and Sixes



PokerStars Home Game Hand #221062476843: {Club #3225207}  Hold'em No Limit (50/100) - 2020/12/03 15:41:55 ET
Table 'Winifred' 9-max (Play Money) Seat #2 is the button
Seat 1: color_singleton (12573 in chips) 
Seat 2: MnnM150 (11433 in chips) 
Seat 3: dhduncan (14044 in chips) 
Seat 5: Duke Croix (11809 in chips) 
Seat 8: Klemtonius (5213 in chips) 
dhduncan: posts small blind 50
Duke Croix: posts big blind 100
*** HOLE CARDS ***
Dealt to Duke Croix [7s 8d]
Klemtonius: calls 100
color_singleton has timed out
color_singleton: folds 
MnnM150: folds 
dhduncan: calls 50
Duke Croix: checks 
*** FLOP *** [3d 5s Td]
dhduncan: checks 
Duke Croix: checks 
Klemtonius: checks 
*** TURN *** [3d 5s Td] [4s]
dhduncan has timed out
dhduncan: checks 
Duke Croix: checks 
Klemtonius: checks 
*** RIVER *** [3d 5s Td 4s] [6s]
dhduncan: checks 
Duke Croix: checks 
Klemtonius: checks 
*** SHOW DOWN ***
dhduncan: shows [2d Kc] (a straight, Deuce to Six)
Duke Croix: shows [7s 8d] (a straight, Four to Eight)
Klemtonius: mucks hand 
Duke Croix collected 283 from pot
*** SUMMARY ***
Total pot 300 | Rake 17 
Board [3d 5s Td 4s 6s]
Seat 1: color_singleton folded before Flop (didn't bet)
Seat 2: MnnM150 (button) folded before Flop (didn't bet)
Seat 3: dhduncan (small blind) showed [2d Kc] and lost with a straight, Deuce to Six
Seat 5: Duke Croix (big blind) showed [7s 8d] and won (283) with a straight, Four to Eight
Seat 8: Klemtonius mucked [Qc 5c]



PokerStars Home Game Hand #221062528586: {Club #3225207}  Hold'em No Limit (50/100) - 2020/12/03 15:43:12 ET
Table 'Winifred' 9-max (Play Money) Seat #3 is the button
Seat 1: color_singleton (12573 in chips) 
Seat 2: MnnM150 (11433 in chips) 
Seat 3: dhduncan (13944 in chips) 
Seat 5: Duke Croix (11992 in chips) 
Seat 8: Klemtonius (5113 in chips) 
Duke Croix: posts small blind 50
Klemtonius: posts big blind 100
*** HOLE CARDS ***
Dealt to Duke Croix [Jh Ks]
color_singleton: folds 
MnnM150: folds 
dhduncan: folds 
Duke Croix: raises 200 to 300
Klemtonius: calls 200
*** FLOP *** [7c Kh Jc]
Duke Croix: checks 
Klemtonius: bets 567
Duke Croix has timed out
Duke Croix: folds 
Uncalled bet (567) returned to Klemtonius
Klemtonius collected 567 from pot
Klemtonius: doesn't show hand 
*** SUMMARY ***
Total pot 600 | Rake 33 
Board [7c Kh Jc]
Seat 1: color_singleton folded before Flop (didn't bet)
Seat 2: MnnM150 folded before Flop (didn't bet)
Seat 3: dhduncan (button) folded before Flop (didn't bet)
Seat 5: Duke Croix (small blind) folded on the Flop
Seat 8: Klemtonius (big blind) collected (567)



PokerStars Home Game Hand #221062588417: {Club #3225207}  Hold'em No Limit (50/100) - 2020/12/03 15:44:41 ET
Table 'Winifred' 9-max (Play Money) Seat #1 is the button
Seat 1: color_singleton (12473 in chips) 
Seat 2: MnnM150 (11333 in chips) 
Seat 3: dhduncan (14390 in chips) 
Seat 5: Duke Croix (11692 in chips) 
Seat 8: Klemtonius (5091 in chips) 
MnnM150: posts small blind 50
dhduncan: posts big blind 100
*** HOLE CARDS ***
Dealt to Duke Croix [7c 7h]
Duke Croix: raises 300 to 400
Klemtonius: folds 
color_singleton: calls 400
MnnM150: folds 
dhduncan: calls 300
*** FLOP *** [Jd 4h Ac]
dhduncan: checks 
Duke Croix: checks 
color_singleton: bets 590
dhduncan: folds 
Duke Croix: folds 
Uncalled bet (590) returned to color_singleton
color_singleton collected 1181 from pot
color_singleton: doesn't show hand 
*** SUMMARY ***
Total pot 1250 | Rake 69 
Board [Jd 4h Ac]
Seat 1: color_singleton (button) collected (1181)
Seat 2: MnnM150 (small blind) folded before Flop
Seat 3: dhduncan (big blind) folded on the Flop
Seat 5: Duke Croix folded on the Flop
Seat 8: Klemtonius folded before Flop (didn't bet)



PokerStars Home Game Hand #221062611751: {Club #3225207}  Hold'em No Limit (50/100) - 2020/12/03 15:45:16 ET
Table 'Winifred' 9-max (Play Money) Seat #2 is the button
Seat 1: color_singleton (13254 in chips) 
Seat 2: MnnM150 (11283 in chips) 
Seat 3: dhduncan (13990 in chips) 
Seat 5: Duke Croix (11292 in chips) 
Seat 8: Klemtonius (5091 in chips) 
dhduncan: posts small blind 50
Duke Croix: posts big blind 100
*** HOLE CARDS ***
Dealt to Duke Croix [Ks 7h]
Klemtonius: calls 100
color_singleton: calls 100
MnnM150: calls 100
dhduncan: calls 50
Duke Croix: checks 
*** FLOP *** [5d Ad 8d]
dhduncan: checks 
Duke Croix: checks 
Klemtonius: checks 
color_singleton: checks 
MnnM150: bets 236
dhduncan: calls 236
Duke Croix: folds 
Klemtonius: calls 236
color_singleton: calls 236
*** TURN *** [5d Ad 8d] [Qc]
dhduncan: checks 
Klemtonius: checks 
color_singleton: checks 
MnnM150: checks 
*** RIVER *** [5d Ad 8d Qc] [Ac]
dhduncan: checks 
Klemtonius: checks 
color_singleton: checks 
MnnM150: checks 
*** SHOW DOWN ***
dhduncan: shows [Td Qs] (two pair, Aces and Queens)
Klemtonius: mucks hand 
color_singleton: mucks hand 
MnnM150: mucks hand 
dhduncan collected 1365 from pot
*** SUMMARY ***
Total pot 1444 | Rake 79 
Board [5d Ad 8d Qc Ac]
Seat 1: color_singleton mucked [Kc 5c]
Seat 2: MnnM150 (button) mucked [2h 2d]
Seat 3: dhduncan (small blind) showed [Td Qs] and won (1365) with two pair, Aces and Queens
Seat 5: Duke Croix (big blind) folded on the Flop
Seat 8: Klemtonius mucked [6d 7s]



PokerStars Home Game Hand #221062661783: {Club #3225207}  Hold'em No Limit (50/100) - 2020/12/03 15:46:30 ET
Table 'Winifred' 9-max (Play Money) Seat #3 is the button
Seat 1: color_singleton (12918 in chips) 
Seat 2: MnnM150 (10947 in chips) 
Seat 3: dhduncan (15019 in chips) 
Seat 5: Duke Croix (11192 in chips) 
Seat 8: Klemtonius (4755 in chips) 
Duke Croix: posts small blind 50
Klemtonius: posts big blind 100
*** HOLE CARDS ***
Dealt to Duke Croix [8d 2h]
color_singleton: folds 
MnnM150: folds 
dhduncan: folds 
Duke Croix: calls 50
Klemtonius: raises 100 to 200
Duke Croix: folds 
Uncalled bet (100) returned to Klemtonius
Klemtonius collected 200 from pot
Klemtonius: doesn't show hand 
*** SUMMARY ***
Total pot 200 | Rake 0 
Seat 1: color_singleton folded before Flop (didn't bet)
Seat 2: MnnM150 folded before Flop (didn't bet)
Seat 3: dhduncan (button) folded before Flop (didn't bet)
Seat 5: Duke Croix (small blind) folded before Flop
Seat 8: Klemtonius (big blind) collected (200)



PokerStars Home Game Hand #221062680897: {Club #3225207}  Hold'em No Limit (50/100) - 2020/12/03 15:46:59 ET
Table 'Winifred' 9-max (Play Money) Seat #5 is the button
Seat 1: color_singleton (12918 in chips) 
Seat 2: MnnM150 (10947 in chips) 
Seat 3: dhduncan (15019 in chips) 
Seat 5: Duke Croix (11092 in chips) 
Seat 8: Klemtonius (4855 in chips) 
Klemtonius: posts small blind 50
color_singleton: posts big blind 100
*** HOLE CARDS ***
Dealt to Duke Croix [4d 3s]
MnnM150: folds 
dhduncan: calls 100
Duke Croix: folds 
Klemtonius: calls 50
color_singleton: checks 
*** FLOP *** [Jh As 9c]
Klemtonius: checks 
color_singleton: checks 
dhduncan: checks 
*** TURN *** [Jh As 9c] [Ts]
Klemtonius: checks 
color_singleton: bets 141
dhduncan: calls 141
Klemtonius: folds 
*** RIVER *** [Jh As 9c Ts] [8c]
color_singleton: bets 550
dhduncan: folds 
Uncalled bet (550) returned to color_singleton
color_singleton collected 550 from pot
color_singleton: doesn't show hand 
*** SUMMARY ***
Total pot 582 | Rake 32 
Board [Jh As 9c Ts 8c]
Seat 1: color_singleton (big blind) collected (550)
Seat 2: MnnM150 folded before Flop (didn't bet)
Seat 3: dhduncan folded on the River
Seat 5: Duke Croix (button) folded before Flop (didn't bet)
Seat 8: Klemtonius (small blind) folded on the Turn



PokerStars Home Game Hand #221062705459: {Club #3225207}  Hold'em No Limit (50/100) - 2020/12/03 15:47:35 ET
Table 'Winifred' 9-max (Play Money) Seat #8 is the button
Seat 1: color_singleton (13227 in chips) 
Seat 2: MnnM150 (10947 in chips) 
Seat 3: dhduncan (14778 in chips) 
Seat 5: Duke Croix (11092 in chips) 
Seat 8: Klemtonius (4755 in chips) 
color_singleton: posts small blind 50
MnnM150: posts big blind 100
*** HOLE CARDS ***
Dealt to Duke Croix [4d 9h]
dhduncan: folds 
Duke Croix: folds 
Klemtonius: calls 100
color_singleton: calls 50
MnnM150: checks 
*** FLOP *** [8d 6d 4s]
color_singleton: checks 
MnnM150: checks 
Klemtonius: checks 
*** TURN *** [8d 6d 4s] [3s]
color_singleton: checks 
MnnM150: checks 
Klemtonius: checks 
*** RIVER *** [8d 6d 4s 3s] [7c]
color_singleton: checks 
MnnM150: bets 283
Klemtonius: folds 
color_singleton: folds 
Uncalled bet (283) returned to MnnM150
MnnM150 collected 283 from pot
*** SUMMARY ***
Total pot 300 | Rake 17 
Board [8d 6d 4s 3s 7c]
Seat 1: color_singleton (small blind) folded on the River
Seat 2: MnnM150 (big blind) collected (283)
Seat 3: dhduncan folded before Flop (didn't bet)
Seat 5: Duke Croix folded before Flop (didn't bet)
Seat 8: Klemtonius (button) folded on the River



PokerStars Home Game Hand #221062725132: {Club #3225207}  Hold'em No Limit (50/100) - 2020/12/03 15:48:04 ET
Table 'Winifred' 9-max (Play Money) Seat #1 is the button
Seat 1: color_singleton (13127 in chips) 
Seat 2: MnnM150 (11130 in chips) 
Seat 3: dhduncan (14778 in chips) 
Seat 5: Duke Croix (11092 in chips) 
Seat 8: Klemtonius (4655 in chips) 
MnnM150: posts small blind 50
dhduncan: posts big blind 100
*** HOLE CARDS ***
Dealt to Duke Croix [As Js]
Duke Croix: raises 300 to 400
Klemtonius: folds 
color_singleton: calls 400
MnnM150: folds 
dhduncan: folds 
*** FLOP *** [7h 6s 8c]
Duke Croix: checks 
color_singleton: checks 
*** TURN *** [7h 6s 8c] [Th]
Duke Croix: bets 400
color_singleton: folds 
Uncalled bet (400) returned to Duke Croix
Duke Croix collected 898 from pot
*** SUMMARY ***
Total pot 950 | Rake 52 
Board [7h 6s 8c Th]
Seat 1: color_singleton (button) folded on the Turn
Seat 2: MnnM150 (small blind) folded before Flop
Seat 3: dhduncan (big blind) folded before Flop
Seat 5: Duke Croix collected (898)
Seat 8: Klemtonius folded before Flop (didn't bet)



PokerStars Home Game Hand #221062747676: {Club #3225207}  Hold'em No Limit (50/100) - 2020/12/03 15:48:34 ET
Table 'Winifred' 9-max (Play Money) Seat #2 is the button
Seat 1: color_singleton (12727 in chips) 
Seat 2: MnnM150 (11080 in chips) 
Seat 3: dhduncan (14678 in chips) 
Seat 5: Duke Croix (11590 in chips) 
Seat 8: Klemtonius (4655 in chips) 
dhduncan: posts small blind 50
Duke Croix: posts big blind 100
*** HOLE CARDS ***
Dealt to Duke Croix [6c 2c]
Klemtonius: calls 100
color_singleton: folds 
MnnM150: folds 
dhduncan: folds 
Duke Croix: checks 
*** FLOP *** [Tc Jd 8h]
Duke Croix: checks 
Klemtonius: bets 236
Duke Croix: folds 
Uncalled bet (236) returned to Klemtonius
Klemtonius collected 236 from pot
Klemtonius: doesn't show hand 
*** SUMMARY ***
Total pot 250 | Rake 14 
Board [Tc Jd 8h]
Seat 1: color_singleton folded before Flop (didn't bet)
Seat 2: MnnM150 (button) folded before Flop (didn't bet)
Seat 3: dhduncan (small blind) folded before Flop
Seat 5: Duke Croix (big blind) folded on the Flop
Seat 8: Klemtonius collected (236)



PokerStars Home Game Hand #221062764356: {Club #3225207}  Hold'em No Limit (50/100) - 2020/12/03 15:49:00 ET
Table 'Winifred' 9-max (Play Money) Seat #3 is the button
Seat 1: color_singleton (12727 in chips) 
Seat 2: MnnM150 (11080 in chips) 
Seat 3: dhduncan (14628 in chips) 
Seat 5: Duke Croix (11490 in chips) 
Seat 8: Klemtonius (4791 in chips) 
Duke Croix: posts small blind 50
Klemtonius: posts big blind 100
*** HOLE CARDS ***
Dealt to Duke Croix [9c 9h]
color_singleton: raises 200 to 300
MnnM150: calls 300
dhduncan: folds 
Duke Croix: raises 300 to 600
Klemtonius: calls 500
color_singleton: calls 300
MnnM150: folds 
*** FLOP *** [Kd Js 4d]
Duke Croix: bets 800
Klemtonius: folds 
color_singleton: folds 
Uncalled bet (800) returned to Duke Croix
Duke Croix collected 1984 from pot
*** SUMMARY ***
Total pot 2100 | Rake 116 
Board [Kd Js 4d]
Seat 1: color_singleton folded on the Flop
Seat 2: MnnM150 folded before Flop
Seat 3: dhduncan (button) folded before Flop (didn't bet)
Seat 5: Duke Croix (small blind) collected (1984)
Seat 8: Klemtonius (big blind) folded on the Flop



PokerStars Home Game Hand #221062787015: {Club #3225207}  Hold'em No Limit (50/100) - 2020/12/03 15:49:33 ET
Table 'Winifred' 9-max (Play Money) Seat #5 is the button
Seat 1: color_singleton (12127 in chips) 
Seat 2: MnnM150 (10780 in chips) 
Seat 3: dhduncan (14628 in chips) 
Seat 5: Duke Croix (12874 in chips) 
Seat 8: Klemtonius (4191 in chips) 
Klemtonius: posts small blind 50
color_singleton: posts big blind 100
*** HOLE CARDS ***
Dealt to Duke Croix [6c As]
MnnM150: raises 100 to 200
dhduncan: folds 
Duke Croix: raises 300 to 500
Klemtonius: folds 
color_singleton: folds 
MnnM150: calls 300
*** FLOP *** [Qh 4s 3c]
MnnM150: bets 543
Duke Croix: folds 
Uncalled bet (543) returned to MnnM150
MnnM150 collected 1087 from pot
*** SUMMARY ***
Total pot 1150 | Rake 63 
Board [Qh 4s 3c]
Seat 1: color_singleton (big blind) folded before Flop
Seat 2: MnnM150 collected (1087)
Seat 3: dhduncan folded before Flop (didn't bet)
Seat 5: Duke Croix (button) folded on the Flop
Seat 8: Klemtonius (small blind) folded before Flop



PokerStars Home Game Hand #221062808192: {Club #3225207}  Hold'em No Limit (50/100) - 2020/12/03 15:50:05 ET
Table 'Winifred' 9-max (Play Money) Seat #8 is the button
Seat 1: color_singleton (12027 in chips) 
Seat 2: MnnM150 (11367 in chips) 
Seat 3: dhduncan (14628 in chips) 
Seat 5: Duke Croix (12374 in chips) 
Seat 8: Klemtonius (4141 in chips) 
color_singleton: posts small blind 50
MnnM150: posts big blind 100
*** HOLE CARDS ***
Dealt to Duke Croix [Ad 4h]
dhduncan: raises 100 to 200
Duke Croix: calls 200
Klemtonius: calls 200
color_singleton: folds 
MnnM150: calls 100
*** FLOP *** [6h 5h 3d]
MnnM150: checks 
dhduncan: checks 
Duke Croix: bets 400
Klemtonius: calls 400
MnnM150: folds 
dhduncan: calls 400
*** TURN *** [6h 5h 3d] [2s]
dhduncan: checks 
Duke Croix: bets 1000
Klemtonius: folds 
dhduncan: folds 
Uncalled bet (1000) returned to Duke Croix
Duke Croix collected 1937 from pot
*** SUMMARY ***
Total pot 2050 | Rake 113 
Board [6h 5h 3d 2s]
Seat 1: color_singleton (small blind) folded before Flop
Seat 2: MnnM150 (big blind) folded on the Flop
Seat 3: dhduncan folded on the Turn
Seat 5: Duke Croix collected (1937)
Seat 8: Klemtonius (button) folded on the Turn



PokerStars Home Game Hand #221062844204: {Club #3225207}  Hold'em No Limit (50/100) - 2020/12/03 15:50:59 ET
Table 'Winifred' 9-max (Play Money) Seat #1 is the button
Seat 1: color_singleton (11977 in chips) 
Seat 2: MnnM150 (11167 in chips) 
Seat 3: dhduncan (14028 in chips) 
Seat 5: Duke Croix (13711 in chips) 
Seat 8: Klemtonius (3541 in chips) 
MnnM150: posts small blind 50
dhduncan: posts big blind 100
*** HOLE CARDS ***
Dealt to Duke Croix [4h 6h]
Duke Croix: calls 100
Klemtonius: calls 100
color_singleton: folds 
MnnM150: calls 50
dhduncan: checks 
*** FLOP *** [Td Th 3s]
MnnM150: checks 
dhduncan: checks 
Duke Croix: checks 
Klemtonius: bets 100
MnnM150: folds 
dhduncan: folds 
Duke Croix: folds 
Uncalled bet (100) returned to Klemtonius
Klemtonius collected 378 from pot
Klemtonius: doesn't show hand 
*** SUMMARY ***
Total pot 400 | Rake 22 
Board [Td Th 3s]
Seat 1: color_singleton (button) folded before Flop (didn't bet)
Seat 2: MnnM150 (small blind) folded on the Flop
Seat 3: dhduncan (big blind) folded on the Flop
Seat 5: Duke Croix folded on the Flop
Seat 8: Klemtonius collected (378)



PokerStars Home Game Hand #221062871573: {Club #3225207}  Hold'em No Limit (50/100) - 2020/12/03 15:51:40 ET
Table 'Winifred' 9-max (Play Money) Seat #2 is the button
Seat 1: color_singleton (11977 in chips) 
Seat 2: MnnM150 (11067 in chips) 
Seat 3: dhduncan (13928 in chips) 
Seat 5: Duke Croix (13611 in chips) 
Seat 8: Klemtonius (3819 in chips) 
dhduncan: posts small blind 50
Duke Croix: posts big blind 100
*** HOLE CARDS ***
Dealt to Duke Croix [3s Ad]
Klemtonius: calls 100
color_singleton: calls 100
MnnM150: calls 100
dhduncan: calls 50
Duke Croix: checks 
*** FLOP *** [Qh 2h Jh]
dhduncan: checks 
Duke Croix: checks 
Klemtonius: checks 
color_singleton: checks 
MnnM150: checks 
*** TURN *** [Qh 2h Jh] [3d]
dhduncan: checks 
Duke Croix: checks 
Klemtonius: checks 
color_singleton: checks 
MnnM150: checks 
*** RIVER *** [Qh 2h Jh 3d] [9d]
dhduncan: bets 100
Duke Croix: folds 
Klemtonius: calls 100
color_singleton: folds 
MnnM150: folds 
*** SHOW DOWN ***
dhduncan: shows [Qs 9s] (two pair, Queens and Nines)
Klemtonius: mucks hand 
dhduncan collected 661 from pot
*** SUMMARY ***
Total pot 700 | Rake 39 
Board [Qh 2h Jh 3d 9d]
Seat 1: color_singleton folded on the River
Seat 2: MnnM150 (button) folded on the River
Seat 3: dhduncan (small blind) showed [Qs 9s] and won (661) with two pair, Queens and Nines
Seat 5: Duke Croix (big blind) folded on the River
Seat 8: Klemtonius mucked [3c 4d]



PokerStars Home Game Hand #221062927344: {Club #3225207}  Hold'em No Limit (50/100) - 2020/12/03 15:53:03 ET
Table 'Winifred' 9-max (Play Money) Seat #3 is the button
Seat 1: color_singleton (11877 in chips) 
Seat 2: MnnM150 (10967 in chips) 
Seat 3: dhduncan (14389 in chips) 
Seat 5: Duke Croix (13511 in chips) 
Seat 8: Klemtonius (3619 in chips) 
Duke Croix: posts small blind 50
Klemtonius: posts big blind 100
*** HOLE CARDS ***
Dealt to Duke Croix [Jc 3h]
color_singleton: folds 
MnnM150: folds 
dhduncan: calls 100
Duke Croix: calls 50
Klemtonius: checks 
*** FLOP *** [6h 9s Qs]
Duke Croix has timed out
Duke Croix: checks 
Klemtonius: checks 
dhduncan: checks 
*** TURN *** [6h 9s Qs] [6c]
Duke Croix: checks 
Klemtonius: checks 
dhduncan: checks 
*** RIVER *** [6h 9s Qs 6c] [As]
Duke Croix: checks 
Klemtonius: checks 
dhduncan: bets 283
Duke Croix: folds 
Klemtonius: folds 
Uncalled bet (283) returned to dhduncan
dhduncan collected 283 from pot
dhduncan: doesn't show hand 
*** SUMMARY ***
Total pot 300 | Rake 17 
Board [6h 9s Qs 6c As]
Seat 1: color_singleton folded before Flop (didn't bet)
Seat 2: MnnM150 folded before Flop (didn't bet)
Seat 3: dhduncan (button) collected (283)
Seat 5: Duke Croix (small blind) folded on the River
Seat 8: Klemtonius (big blind) folded on the River



PokerStars Home Game Hand #221062969339: {Club #3225207}  Hold'em No Limit (50/100) - 2020/12/03 15:54:06 ET
Table 'Winifred' 9-max (Play Money) Seat #5 is the button
Seat 1: color_singleton (11877 in chips) 
Seat 2: MnnM150 (10967 in chips) 
Seat 3: dhduncan (14572 in chips) 
Seat 5: Duke Croix (13411 in chips) 
Seat 8: Klemtonius (3519 in chips) 
Klemtonius: posts small blind 50
color_singleton: posts big blind 100
*** HOLE CARDS ***
Dealt to Duke Croix [2h 7h]
MnnM150: folds 
dhduncan: calls 100
Duke Croix: folds 
Klemtonius: calls 50
color_singleton: checks 
*** FLOP *** [Kd Ks 6h]
Klemtonius: checks 
color_singleton: checks 
dhduncan: checks 
*** TURN *** [Kd Ks 6h] [Ad]
Klemtonius: checks 
color_singleton: checks 
dhduncan: bets 100
Klemtonius: calls 100
color_singleton: folds 
*** RIVER *** [Kd Ks 6h Ad] [Kc]
Klemtonius: checks 
dhduncan: checks 
*** SHOW DOWN ***
Klemtonius: shows [4c 2d] (three of a kind, Kings)
dhduncan: shows [4d Jd] (three of a kind, Kings - Ace+Jack kicker)
dhduncan collected 472 from pot
*** SUMMARY ***
Total pot 500 | Rake 28 
Board [Kd Ks 6h Ad Kc]
Seat 1: color_singleton (big blind) folded on the Turn
Seat 2: MnnM150 folded before Flop (didn't bet)
Seat 3: dhduncan showed [4d Jd] and won (472) with three of a kind, Kings
Seat 5: Duke Croix (button) folded before Flop (didn't bet)
Seat 8: Klemtonius (small blind) showed [4c 2d] and lost with three of a kind, Kings



PokerStars Home Game Hand #221063002012: {Club #3225207}  Hold'em No Limit (50/100) - 2020/12/03 15:54:55 ET
Table 'Winifred' 9-max (Play Money) Seat #8 is the button
Seat 1: color_singleton (11777 in chips) 
Seat 2: MnnM150 (10967 in chips) 
Seat 3: dhduncan (14844 in chips) 
Seat 5: Duke Croix (13411 in chips) 
Seat 8: Klemtonius (3319 in chips) 
color_singleton: posts small blind 50
MnnM150: posts big blind 100
*** HOLE CARDS ***
Dealt to Duke Croix [7d 3s]
dhduncan: calls 100
Duke Croix: folds 
Klemtonius: folds 
color_singleton: raises 100 to 200
MnnM150: calls 100
dhduncan: calls 100
*** FLOP *** [Ad Kc 9d]
color_singleton: checks 
MnnM150: bets 283
dhduncan: calls 283
color_singleton: folds 
*** TURN *** [Ad Kc 9d] [6h]
MnnM150: bets 551
dhduncan: folds 
Uncalled bet (551) returned to MnnM150
MnnM150 collected 1102 from pot
*** SUMMARY ***
Total pot 1166 | Rake 64 
Board [Ad Kc 9d 6h]
Seat 1: color_singleton (small blind) folded on the Flop
Seat 2: MnnM150 (big blind) collected (1102)
Seat 3: dhduncan folded on the Turn
Seat 5: Duke Croix folded before Flop (didn't bet)
Seat 8: Klemtonius (button) folded before Flop (didn't bet)



PokerStars Home Game Hand #221063024851: {Club #3225207}  Hold'em No Limit (50/100) - 2020/12/03 15:55:33 ET
Table 'Winifred' 9-max (Play Money) Seat #1 is the button
Seat 1: color_singleton (11577 in chips) 
Seat 2: MnnM150 (11586 in chips) 
Seat 3: dhduncan (14361 in chips) 
Seat 5: Duke Croix (13411 in chips) 
Seat 8: Klemtonius (3319 in chips) 
MnnM150: posts small blind 50
dhduncan: posts big blind 100
*** HOLE CARDS ***
Dealt to Duke Croix [3h Ah]
Duke Croix: raises 200 to 300
Klemtonius: calls 300
color_singleton: folds 
MnnM150: folds 
dhduncan: calls 200
*** FLOP *** [Ts 3s 3d]
dhduncan: checks 
Duke Croix: bets 500
Klemtonius: calls 500
dhduncan: folds 
*** TURN *** [Ts 3s 3d] [8d]
Duke Croix: bets 900
Klemtonius: folds 
Uncalled bet (900) returned to Duke Croix
Duke Croix collected 1843 from pot
*** SUMMARY ***
Total pot 1950 | Rake 107 
Board [Ts 3s 3d 8d]
Seat 1: color_singleton (button) folded before Flop (didn't bet)
Seat 2: MnnM150 (small blind) folded before Flop
Seat 3: dhduncan (big blind) folded on the Flop
Seat 5: Duke Croix collected (1843)
Seat 8: Klemtonius folded on the Turn



PokerStars Home Game Hand #221063043974: {Club #3225207}  Hold'em No Limit (50/100) - 2020/12/03 15:56:12 ET
Table 'Winifred' 9-max (Play Money) Seat #2 is the button
Seat 1: color_singleton (11577 in chips) 
Seat 2: MnnM150 (11536 in chips) 
Seat 3: dhduncan (14061 in chips) 
Seat 5: Duke Croix (14454 in chips) 
Seat 8: Klemtonius (2519 in chips) 
dhduncan: posts small blind 50
Duke Croix: posts big blind 100
*** HOLE CARDS ***
Dealt to Duke Croix [4s 5h]
Klemtonius: calls 100
color_singleton: calls 100
MnnM150: folds 
dhduncan: calls 50
Duke Croix: checks 
*** FLOP *** [6d 6s Ah]
dhduncan: bets 189
Duke Croix: folds 
Klemtonius: folds 
color_singleton: calls 189
*** TURN *** [6d 6s Ah] [7d]
dhduncan: bets 367
color_singleton: folds 
Uncalled bet (367) returned to dhduncan
dhduncan collected 735 from pot
dhduncan: doesn't show hand 
*** SUMMARY ***
Total pot 778 | Rake 43 
Board [6d 6s Ah 7d]
Seat 1: color_singleton folded on the Turn
Seat 2: MnnM150 (button) folded before Flop (didn't bet)
Seat 3: dhduncan (small blind) collected (735)
Seat 5: Duke Croix (big blind) folded on the Flop
Seat 8: Klemtonius folded on the Flop



PokerStars Home Game Hand #221063060767: {Club #3225207}  Hold'em No Limit (50/100) - 2020/12/03 15:56:46 ET
Table 'Winifred' 9-max (Play Money) Seat #3 is the button
Seat 1: color_singleton (11288 in chips) 
Seat 2: MnnM150 (11536 in chips) 
Seat 3: dhduncan (14507 in chips) 
Seat 5: Duke Croix (14354 in chips) 
Seat 8: Klemtonius (2419 in chips) 
Duke Croix: posts small blind 50
Klemtonius: posts big blind 100
*** HOLE CARDS ***
Dealt to Duke Croix [7h Jh]
color_singleton: folds 
MnnM150: calls 100
dhduncan: folds 
Duke Croix: calls 50
Klemtonius: checks 
*** FLOP *** [6h Qh Kc]
Duke Croix: bets 300
Klemtonius: folds 
MnnM150: calls 300
*** TURN *** [6h Qh Kc] [Tc]
Duke Croix: bets 500
MnnM150: folds 
Uncalled bet (500) returned to Duke Croix
Duke Croix collected 850 from pot
*** SUMMARY ***
Total pot 900 | Rake 50 
Board [6h Qh Kc Tc]
Seat 1: color_singleton folded before Flop (didn't bet)
Seat 2: MnnM150 folded on the Turn
Seat 3: dhduncan (button) folded before Flop (didn't bet)
Seat 5: Duke Croix (small blind) collected (850)
Seat 8: Klemtonius (big blind) folded on the Flop



PokerStars Home Game Hand #221063087727: {Club #3225207}  Hold'em No Limit (50/100) - 2020/12/03 15:57:39 ET
Table 'Winifred' 9-max (Play Money) Seat #5 is the button
Seat 1: color_singleton (11288 in chips) 
Seat 2: MnnM150 (11136 in chips) 
Seat 3: dhduncan (14507 in chips) 
Seat 5: Duke Croix (14804 in chips) 
Seat 8: Klemtonius (2319 in chips) 
Klemtonius: posts small blind 50
color_singleton: posts big blind 100
*** HOLE CARDS ***
Dealt to Duke Croix [Ts Kc]
MnnM150: folds 
dhduncan: calls 100
Duke Croix: raises 100 to 200
Klemtonius: calls 150
color_singleton: calls 100
dhduncan: folds 
*** FLOP *** [8h 7c Kd]
Klemtonius: checks 
color_singleton: checks 
Duke Croix: bets 400
Klemtonius: folds 
color_singleton: folds 
Uncalled bet (400) returned to Duke Croix
Duke Croix collected 661 from pot
*** SUMMARY ***
Total pot 700 | Rake 39 
Board [8h 7c Kd]
Seat 1: color_singleton (big blind) folded on the Flop
Seat 2: MnnM150 folded before Flop (didn't bet)
Seat 3: dhduncan folded before Flop
Seat 5: Duke Croix (button) collected (661)
Seat 8: Klemtonius (small blind) folded on the Flop



PokerStars Home Game Hand #221063117256: {Club #3225207}  Hold'em No Limit (50/100) - 2020/12/03 15:58:38 ET
Table 'Winifred' 9-max (Play Money) Seat #8 is the button
Seat 1: color_singleton (11088 in chips) 
Seat 2: MnnM150 (11136 in chips) 
Seat 3: dhduncan (14407 in chips) 
Seat 5: Duke Croix (15265 in chips) 
Seat 8: Klemtonius (2119 in chips) 
color_singleton: posts small blind 50
MnnM150: posts big blind 100
*** HOLE CARDS ***
Dealt to Duke Croix [7d Qd]
dhduncan: calls 100
Duke Croix: calls 100
Klemtonius: calls 100
color_singleton: raises 300 to 400
MnnM150: calls 300
dhduncan: calls 300
Duke Croix: folds 
Klemtonius: folds 
*** FLOP *** [8s 5c 2s]
color_singleton: bets 661
MnnM150: calls 661
dhduncan: raises 661 to 1322
color_singleton: folds 
MnnM150: folds 
Uncalled bet (661) returned to dhduncan
dhduncan collected 3197 from pot
dhduncan: doesn't show hand 
*** SUMMARY ***
Total pot 3383 | Rake 186 
Board [8s 5c 2s]
Seat 1: color_singleton (small blind) folded on the Flop
Seat 2: MnnM150 (big blind) folded on the Flop
Seat 3: dhduncan collected (3197)
Seat 5: Duke Croix folded before Flop
Seat 8: Klemtonius (button) folded before Flop



PokerStars Home Game Hand #221063149072: {Club #3225207}  Hold'em No Limit (50/100) - 2020/12/03 15:59:41 ET
Table 'Winifred' 9-max (Play Money) Seat #1 is the button
Seat 1: color_singleton (10027 in chips) 
Seat 2: MnnM150 (10075 in chips) 
Seat 3: dhduncan (16543 in chips) 
Seat 5: Duke Croix (15165 in chips) 
Seat 8: Klemtonius (2019 in chips) 
MnnM150: posts small blind 50
dhduncan: posts big blind 100
*** HOLE CARDS ***
Dealt to Duke Croix [2d 8s]
Duke Croix: folds 
Klemtonius: calls 100
color_singleton: raises 200 to 300
MnnM150: folds 
dhduncan: folds 
Klemtonius: calls 200
*** FLOP *** [2s 6s 9d]
Klemtonius: checks 
color_singleton: bets 354
Klemtonius: calls 354
*** TURN *** [2s 6s 9d] [Ac]
Klemtonius: bets 1365 and is all-in
color_singleton: folds 
Uncalled bet (1365) returned to Klemtonius
Klemtonius collected 1378 from pot
Klemtonius: doesn't show hand 
*** SUMMARY ***
Total pot 1458 | Rake 80 
Board [2s 6s 9d Ac]
Seat 1: color_singleton (button) folded on the Turn
Seat 2: MnnM150 (small blind) folded before Flop
Seat 3: dhduncan (big blind) folded before Flop
Seat 5: Duke Croix folded before Flop (didn't bet)
Seat 8: Klemtonius collected (1378)



PokerStars Home Game Hand #221063173624: {Club #3225207}  Hold'em No Limit (50/100) - 2020/12/03 16:00:28 ET
Table 'Winifred' 9-max (Play Money) Seat #2 is the button
Seat 1: color_singleton (9373 in chips) 
Seat 2: MnnM150 (10025 in chips) 
Seat 3: dhduncan (16443 in chips) 
Seat 5: Duke Croix (15165 in chips) 
Seat 8: Klemtonius (2743 in chips) 
dhduncan: posts small blind 50
Duke Croix: posts big blind 100
*** HOLE CARDS ***
Dealt to Duke Croix [8d 5h]
Klemtonius: calls 100
color_singleton: raises 200 to 300
MnnM150: folds 
dhduncan: calls 250
Duke Croix: folds 
Klemtonius: calls 200
*** FLOP *** [Ah 4s 2d]
dhduncan: bets 100
Klemtonius: calls 100
color_singleton: raises 300 to 400
dhduncan: calls 300
Klemtonius: folds 
*** TURN *** [Ah 4s 2d] [Kh]
dhduncan: bets 897
color_singleton: raises 897 to 1794
dhduncan: calls 897
*** RIVER *** [Ah 4s 2d Kh] [6d]
dhduncan: checks 
color_singleton: bets 5186
dhduncan: calls 5186
*** SHOW DOWN ***
color_singleton: shows [Ks As] (two pair, Aces and Kings)
dhduncan: mucks hand 
color_singleton collected 14988 from pot
*** SUMMARY ***
Total pot 15860 | Rake 872 
Board [Ah 4s 2d Kh 6d]
Seat 1: color_singleton showed [Ks As] and won (14988) with two pair, Aces and Kings
Seat 2: MnnM150 (button) folded before Flop (didn't bet)
Seat 3: dhduncan (small blind) mucked [Qs Ad]
Seat 5: Duke Croix (big blind) folded before Flop
Seat 8: Klemtonius folded on the Flop



PokerStars Home Game Hand #221063210163: {Club #3225207}  Hold'em No Limit (50/100) - 2020/12/03 16:01:31 ET
Table 'Winifred' 9-max (Play Money) Seat #3 is the button
Seat 1: color_singleton (16681 in chips) 
Seat 2: MnnM150 (10025 in chips) 
Seat 3: dhduncan (8763 in chips) 
Seat 5: Duke Croix (15065 in chips) 
Seat 8: Klemtonius (2343 in chips) 
Duke Croix: posts small blind 50
Klemtonius: posts big blind 100
*** HOLE CARDS ***
Dealt to Duke Croix [2d Qh]
color_singleton: folds 
MnnM150: folds 
dhduncan: folds 
Duke Croix: calls 50
Klemtonius: checks 
*** FLOP *** [4s Kc 5s]
Duke Croix: checks 
Klemtonius: checks 
*** TURN *** [4s Kc 5s] [Ts]
Duke Croix: checks 
Klemtonius: checks 
*** RIVER *** [4s Kc 5s Ts] [8s]
Duke Croix: checks 
Klemtonius: bets 100
Duke Croix: folds 
Uncalled bet (100) returned to Klemtonius
Klemtonius collected 189 from pot
Klemtonius: doesn't show hand 
*** SUMMARY ***
Total pot 200 | Rake 11 
Board [4s Kc 5s Ts 8s]
Seat 1: color_singleton folded before Flop (didn't bet)
Seat 2: MnnM150 folded before Flop (didn't bet)
Seat 3: dhduncan (button) folded before Flop (didn't bet)
Seat 5: Duke Croix (small blind) folded on the River
Seat 8: Klemtonius (big blind) collected (189)



PokerStars Home Game Hand #221063236674: {Club #3225207}  Hold'em No Limit (50/100) - 2020/12/03 16:02:13 ET
Table 'Winifred' 9-max (Play Money) Seat #5 is the button
Seat 1: color_singleton (16681 in chips) 
Seat 2: MnnM150 (10025 in chips) 
Seat 3: dhduncan (8763 in chips) 
Seat 5: Duke Croix (14965 in chips) 
Seat 8: Klemtonius (2432 in chips) 
Klemtonius: posts small blind 50
color_singleton: posts big blind 100
*** HOLE CARDS ***
Dealt to Duke Croix [Kh 9c]
MnnM150: calls 100
dhduncan: folds 
Duke Croix: raises 300 to 400
Klemtonius: folds 
color_singleton: folds 
MnnM150: folds 
Uncalled bet (300) returned to Duke Croix
Duke Croix collected 350 from pot
*** SUMMARY ***
Total pot 350 | Rake 0 
Seat 1: color_singleton (big blind) folded before Flop
Seat 2: MnnM150 folded before Flop
Seat 3: dhduncan folded before Flop (didn't bet)
Seat 5: Duke Croix (button) collected (350)
Seat 8: Klemtonius (small blind) folded before Flop



PokerStars Home Game Hand #221063248732: {Club #3225207}  Hold'em No Limit (50/100) - 2020/12/03 16:02:31 ET
Table 'Winifred' 9-max (Play Money) Seat #8 is the button
Seat 1: color_singleton (16581 in chips) 
Seat 2: MnnM150 (9925 in chips) 
Seat 3: dhduncan (8763 in chips) 
Seat 5: Duke Croix (15215 in chips) 
Seat 8: Klemtonius (2382 in chips) 
color_singleton: posts small blind 50
MnnM150: posts big blind 100
*** HOLE CARDS ***
Dealt to Duke Croix [3d 4d]
dhduncan: calls 100
Duke Croix: calls 100
Klemtonius: calls 100
color_singleton: calls 50
MnnM150: checks 
*** FLOP *** [2s Ad Jc]
color_singleton: checks 
MnnM150: bets 236
dhduncan: calls 236
Duke Croix: folds 
Klemtonius: folds 
color_singleton: folds 
*** TURN *** [2s Ad Jc] [4s]
MnnM150: bets 459
dhduncan: folds 
Uncalled bet (459) returned to MnnM150
MnnM150 collected 919 from pot
*** SUMMARY ***
Total pot 972 | Rake 53 
Board [2s Ad Jc 4s]
Seat 1: color_singleton (small blind) folded on the Flop
Seat 2: MnnM150 (big blind) collected (919)
Seat 3: dhduncan folded on the Turn
Seat 5: Duke Croix folded on the Flop
Seat 8: Klemtonius (button) folded on the Flop



PokerStars Home Game Hand #221063278549: {Club #3225207}  Hold'em No Limit (50/100) - 2020/12/03 16:03:16 ET
Table 'Winifred' 9-max (Play Money) Seat #1 is the button
Seat 1: color_singleton (16481 in chips) 
Seat 2: MnnM150 (10508 in chips) 
Seat 3: dhduncan (8427 in chips) 
Seat 5: Duke Croix (15115 in chips) 
Seat 8: Klemtonius (2282 in chips) 
MnnM150: posts small blind 50
dhduncan: posts big blind 100
*** HOLE CARDS ***
Dealt to Duke Croix [7s 7c]
Duke Croix: raises 300 to 400
Klemtonius: folds 
color_singleton: folds 
MnnM150: calls 350
dhduncan: folds 
*** FLOP *** [Kc Ad 3h]
MnnM150: bets 425
Duke Croix: folds 
Uncalled bet (425) returned to MnnM150
MnnM150 collected 850 from pot
*** SUMMARY ***
Total pot 900 | Rake 50 
Board [Kc Ad 3h]
Seat 1: color_singleton (button) folded before Flop (didn't bet)
Seat 2: MnnM150 (small blind) collected (850)
Seat 3: dhduncan (big blind) folded before Flop
Seat 5: Duke Croix folded on the Flop
Seat 8: Klemtonius folded before Flop (didn't bet)



PokerStars Home Game Hand #221063298986: {Club #3225207}  Hold'em No Limit (50/100) - 2020/12/03 16:03:48 ET
Table 'Winifred' 9-max (Play Money) Seat #2 is the button
Seat 1: color_singleton (16481 in chips) 
Seat 2: MnnM150 (10958 in chips) 
Seat 3: dhduncan (8327 in chips) 
Seat 5: Duke Croix (14715 in chips) 
Seat 8: Klemtonius (2282 in chips) 
dhduncan: posts small blind 50
Duke Croix: posts big blind 100
*** HOLE CARDS ***
Dealt to Duke Croix [Td 7s]
Klemtonius: calls 100
color_singleton: folds 
MnnM150: folds 
dhduncan: calls 50
Duke Croix: checks 
*** FLOP *** [8c 8s 3h]
dhduncan: checks 
Duke Croix: checks 
Klemtonius: bets 283
dhduncan: folds 
Duke Croix: folds 
Uncalled bet (283) returned to Klemtonius
Klemtonius collected 283 from pot
Klemtonius: doesn't show hand 
*** SUMMARY ***
Total pot 300 | Rake 17 
Board [8c 8s 3h]
Seat 1: color_singleton folded before Flop (didn't bet)
Seat 2: MnnM150 (button) folded before Flop (didn't bet)
Seat 3: dhduncan (small blind) folded on the Flop
Seat 5: Duke Croix (big blind) folded on the Flop
Seat 8: Klemtonius collected (283)



PokerStars Home Game Hand #221063316971: {Club #3225207}  Hold'em No Limit (50/100) - 2020/12/03 16:04:15 ET
Table 'Winifred' 9-max (Play Money) Seat #3 is the button
Seat 1: color_singleton (16481 in chips) 
Seat 2: MnnM150 (10958 in chips) 
Seat 3: dhduncan (8227 in chips) 
Seat 5: Duke Croix (14615 in chips) 
Seat 8: Klemtonius (2465 in chips) 
Duke Croix: posts small blind 50
Klemtonius: posts big blind 100
*** HOLE CARDS ***
Dealt to Duke Croix [Kc Qd]
color_singleton: raises 100 to 200
MnnM150: calls 200
dhduncan: calls 200
Duke Croix: calls 150
Klemtonius: calls 100
*** FLOP *** [Qc Th 3d]
Duke Croix: bets 500
Klemtonius: folds 
color_singleton: folds 
MnnM150: folds 
dhduncan: calls 500
*** TURN *** [Qc Th 3d] [5s]
Duke Croix: bets 800
dhduncan: calls 800
*** RIVER *** [Qc Th 3d 5s] [Qs]
Duke Croix: bets 1800
dhduncan: raises 1800 to 3600
Duke Croix: calls 1800
*** SHOW DOWN ***
dhduncan: shows [Qh Kh] (three of a kind, Queens)
Duke Croix: shows [Kc Qd] (three of a kind, Queens)
Duke Croix collected 5103 from pot
dhduncan collected 5103 from pot
*** SUMMARY ***
Total pot 10800 | Rake 594 
Board [Qc Th 3d 5s Qs]
Seat 1: color_singleton folded on the Flop
Seat 2: MnnM150 folded on the Flop
Seat 3: dhduncan (button) showed [Qh Kh] and won (5103) with three of a kind, Queens
Seat 5: Duke Croix (small blind) showed [Kc Qd] and won (5103) with three of a kind, Queens
Seat 8: Klemtonius (big blind) folded on the Flop



PokerStars Home Game Hand #221063356471: {Club #3225207}  Hold'em No Limit (50/100) - 2020/12/03 16:05:13 ET
Table 'Winifred' 9-max (Play Money) Seat #5 is the button
Seat 1: color_singleton (16281 in chips) 
Seat 2: MnnM150 (10758 in chips) 
Seat 3: dhduncan (8230 in chips) 
Seat 5: Duke Croix (14618 in chips) 
Seat 8: Klemtonius (2265 in chips) 
Klemtonius: posts small blind 50
color_singleton: posts big blind 100
*** HOLE CARDS ***
Dealt to Duke Croix [Ks Kh]
MnnM150: calls 100
dhduncan: calls 100
Duke Croix: raises 300 to 400
Klemtonius: calls 350
color_singleton: calls 300
MnnM150: calls 300
dhduncan: calls 300
*** FLOP *** [5c 2d 5h]
Klemtonius: bets 1865 and is all-in
color_singleton: folds 
MnnM150: folds 
dhduncan: folds 
Duke Croix: calls 1865
*** TURN *** [5c 2d 5h] [Jd]
*** RIVER *** [5c 2d 5h Jd] [4c]
*** SHOW DOWN ***
Klemtonius: shows [Ac Qc] (a pair of Fives)
Duke Croix: shows [Ks Kh] (two pair, Kings and Fives)
Duke Croix collected 5415 from pot
*** SUMMARY ***
Total pot 5730 | Rake 315 
Board [5c 2d 5h Jd 4c]
Seat 1: color_singleton (big blind) folded on the Flop
Seat 2: MnnM150 folded on the Flop
Seat 3: dhduncan folded on the Flop
Seat 5: Duke Croix (button) showed [Ks Kh] and won (5415) with two pair, Kings and Fives
Seat 8: Klemtonius (small blind) showed [Ac Qc] and lost with a pair of Fives



PokerStars Home Game Hand #221063383843: {Club #3225207}  Hold'em No Limit (50/100) - 2020/12/03 16:05:54 ET
Table 'Winifred' 9-max (Play Money) Seat #1 is the button
Seat 1: color_singleton (15881 in chips) 
Seat 2: MnnM150 (10358 in chips) 
Seat 3: dhduncan (7830 in chips) 
Seat 5: Duke Croix (17768 in chips) 
MnnM150: posts small blind 50
dhduncan: posts big blind 100
*** HOLE CARDS ***
Dealt to Duke Croix [Js 3d]
Duke Croix: folds 
color_singleton: raises 100 to 200
MnnM150: calls 150
dhduncan: folds 
*** FLOP *** [7s Jd Jc]
MnnM150: checks 
color_singleton: bets 472
MnnM150: folds 
Uncalled bet (472) returned to color_singleton
color_singleton collected 472 from pot
color_singleton: doesn't show hand 
*** SUMMARY ***
Total pot 500 | Rake 28 
Board [7s Jd Jc]
Seat 1: color_singleton (button) collected (472)
Seat 2: MnnM150 (small blind) folded on the Flop
Seat 3: dhduncan (big blind) folded before Flop
Seat 5: Duke Croix folded before Flop (didn't bet)



PokerStars Home Game Hand #221063396592: {Club #3225207}  Hold'em No Limit (50/100) - 2020/12/03 16:06:13 ET
Table 'Winifred' 9-max (Play Money) Seat #2 is the button
Seat 1: color_singleton (16153 in chips) 
Seat 2: MnnM150 (10158 in chips) 
Seat 3: dhduncan (7730 in chips) 
Seat 5: Duke Croix (17768 in chips) 
dhduncan: posts small blind 50
Duke Croix: posts big blind 100
*** HOLE CARDS ***
Dealt to Duke Croix [6h 4c]
color_singleton: folds 
MnnM150: folds 
dhduncan: calls 50
Duke Croix: checks 
*** FLOP *** [5h 4d 7d]
Klemtonius leaves the table
dhduncan: checks 
Duke Croix: bets 200
dhduncan: folds 
Uncalled bet (200) returned to Duke Croix
Duke Croix collected 189 from pot
*** SUMMARY ***
Total pot 200 | Rake 11 
Board [5h 4d 7d]
Seat 1: color_singleton folded before Flop (didn't bet)
Seat 2: MnnM150 (button) folded before Flop (didn't bet)
Seat 3: dhduncan (small blind) folded on the Flop
Seat 5: Duke Croix (big blind) collected (189)



PokerStars Home Game Hand #221063412945: {Club #3225207}  Hold'em No Limit (50/100) - 2020/12/03 16:06:34 ET
Table 'Winifred' 9-max (Play Money) Seat #3 is the button
Seat 1: color_singleton (16153 in chips) 
Seat 2: MnnM150 (10158 in chips) 
Seat 3: dhduncan (7630 in chips) 
Seat 5: Duke Croix (17857 in chips) 
Duke Croix: posts small blind 50
color_singleton: posts big blind 100
*** HOLE CARDS ***
Dealt to Duke Croix [4s 7c]
MnnM150: calls 100
dhduncan: folds 
Duke Croix: calls 50
color_singleton: checks 
*** FLOP *** [Jd 6h Td]
Duke Croix: checks 
color_singleton: bets 200
MnnM150: calls 200
Duke Croix: folds 
*** TURN *** [Jd 6h Td] [9h]
color_singleton: bets 330
MnnM150: calls 330
*** RIVER *** [Jd 6h Td 9h] [3s]
color_singleton: checks 
MnnM150: checks 
*** SHOW DOWN ***
color_singleton: shows [Jc 2c] (a pair of Jacks)
MnnM150: mucks hand 
color_singleton collected 1285 from pot
*** SUMMARY ***
Total pot 1360 | Rake 75 
Board [Jd 6h Td 9h 3s]
Seat 1: color_singleton (big blind) showed [Jc 2c] and won (1285) with a pair of Jacks
Seat 2: MnnM150 mucked [Ac Kh]
Seat 3: dhduncan (button) folded before Flop (didn't bet)
Seat 5: Duke Croix (small blind) folded on the Flop



PokerStars Home Game Hand #221063434312: {Club #3225207}  Hold'em No Limit (50/100) - 2020/12/03 16:07:06 ET
Table 'Winifred' 9-max (Play Money) Seat #5 is the button
Seat 1: color_singleton (16808 in chips) 
Seat 2: MnnM150 (9528 in chips) 
Seat 3: dhduncan (7630 in chips) 
Seat 5: Duke Croix (17757 in chips) 
color_singleton: posts small blind 50
MnnM150: posts big blind 100
*** HOLE CARDS ***
Dealt to Duke Croix [2d 8c]
dhduncan: calls 100
Duke Croix: folds 
color_singleton: raises 100 to 200
MnnM150: calls 100
dhduncan: calls 100
*** FLOP *** [5d 7c Jc]
MrOB1reader joins the table at seat #8 
color_singleton: bets 283
MnnM150: calls 283
dhduncan: calls 283
*** TURN *** [5d 7c Jc] [4d]
color_singleton: checks 
MnnM150: bets 684
dhduncan: folds 
color_singleton: calls 684
*** RIVER *** [5d 7c Jc 4d] [Kd]
color_singleton: checks 
MnnM150: bets 2662
color_singleton: folds 
Uncalled bet (2662) returned to MnnM150
MnnM150 collected 2662 from pot
*** SUMMARY ***
Total pot 2817 | Rake 155 
Board [5d 7c Jc 4d Kd]
Seat 1: color_singleton (small blind) folded on the River
Seat 2: MnnM150 (big blind) collected (2662)
Seat 3: dhduncan folded on the Turn
Seat 5: Duke Croix (button) folded before Flop (didn't bet)



PokerStars Home Game Hand #221063465428: {Club #3225207}  Hold'em No Limit (50/100) - 2020/12/03 16:07:52 ET
Table 'Winifred' 9-max (Play Money) Seat #1 is the button
Seat 1: color_singleton (15641 in chips) 
Seat 2: MnnM150 (11023 in chips) 
Seat 3: dhduncan (7147 in chips) 
Seat 5: Duke Croix (17757 in chips) 
Seat 8: MrOB1reader (10000 in chips) 
MnnM150: posts small blind 50
dhduncan: posts big blind 100
MrOB1reader: posts big blind 100
*** HOLE CARDS ***
Dealt to Duke Croix [Ad Qc]
Duke Croix: raises 300 to 400
MrOB1reader: calls 300
color_singleton: calls 400
MnnM150: folds 
dhduncan: folds 
*** FLOP *** [Ks Td Tc]
Duke Croix: checks 
MrOB1reader: checks 
color_singleton: checks 
*** TURN *** [Ks Td Tc] [9h]
Duke Croix: bets 600
MrOB1reader: folds 
color_singleton: calls 600
*** RIVER *** [Ks Td Tc 9h] [5d]
Duke Croix: bets 1000
color_singleton: calls 1000
*** SHOW DOWN ***
Duke Croix: shows [Ad Qc] (a pair of Tens)
color_singleton: shows [9c As] (two pair, Tens and Nines)
color_singleton collected 4300 from pot
*** SUMMARY ***
Total pot 4550 | Rake 250 
Board [Ks Td Tc 9h 5d]
Seat 1: color_singleton (button) showed [9c As] and won (4300) with two pair, Tens and Nines
Seat 2: MnnM150 (small blind) folded before Flop
Seat 3: dhduncan (big blind) folded before Flop
Seat 5: Duke Croix showed [Ad Qc] and lost with a pair of Tens
Seat 8: MrOB1reader folded on the Turn



PokerStars Home Game Hand #221063486047: {Club #3225207}  Hold'em No Limit (50/100) - 2020/12/03 16:08:23 ET
Table 'Winifred' 9-max (Play Money) Seat #2 is the button
Seat 1: color_singleton (17941 in chips) 
Seat 2: MnnM150 (10973 in chips) 
Seat 3: dhduncan (7047 in chips) 
Seat 5: Duke Croix (15757 in chips) 
Seat 8: MrOB1reader (9600 in chips) 
dhduncan: posts small blind 50
Duke Croix: posts big blind 100
*** HOLE CARDS ***
Dealt to Duke Croix [9d 5d]
MrOB1reader: calls 100
color_singleton: raises 100 to 200
MnnM150: calls 200
dhduncan: folds 
Duke Croix: calls 100
MrOB1reader: calls 100
*** FLOP *** [Jh Qs 6s]
Duke Croix: checks 
MrOB1reader: bets 100
color_singleton: calls 100
MnnM150: calls 100
Duke Croix: folds 
*** TURN *** [Jh Qs 6s] [2s]
MrOB1reader: bets 100
color_singleton: calls 100
MnnM150: calls 100
*** RIVER *** [Jh Qs 6s 2s] [8h]
MrOB1reader: bets 100
color_singleton: folds 
MnnM150: calls 100
*** SHOW DOWN ***
MrOB1reader: shows [5c 5s] (a pair of Fives)
MnnM150: mucks hand 
MrOB1reader collected 1559 from pot
*** SUMMARY ***
Total pot 1650 | Rake 91 
Board [Jh Qs 6s 2s 8h]
Seat 1: color_singleton folded on the River
Seat 2: MnnM150 (button) mucked [4c 4s]
Seat 3: dhduncan (small blind) folded before Flop
Seat 5: Duke Croix (big blind) folded on the Flop
Seat 8: MrOB1reader showed [5c 5s] and won (1559) with a pair of Fives



PokerStars Home Game Hand #221063513918: {Club #3225207}  Hold'em No Limit (50/100) - 2020/12/03 16:09:05 ET
Table 'Winifred' 9-max (Play Money) Seat #3 is the button
Seat 1: color_singleton (17541 in chips) 
Seat 2: MnnM150 (10473 in chips) 
Seat 3: dhduncan (6997 in chips) 
Seat 5: Duke Croix (15557 in chips) 
Seat 8: MrOB1reader (10659 in chips) 
Duke Croix: posts small blind 50
MrOB1reader: posts big blind 100
*** HOLE CARDS ***
Dealt to Duke Croix [8d 6h]
color_singleton: raises 200 to 300
MnnM150: folds 
dhduncan: folds 
Duke Croix: folds 
MrOB1reader: calls 200
*** FLOP *** [4d Ks 8h]
MrOB1reader: checks 
color_singleton: checks 
*** TURN *** [4d Ks 8h] [As]
MrOB1reader: checks 
color_singleton: checks 
*** RIVER *** [4d Ks 8h As] [7d]
MrOB1reader: checks 
color_singleton: bets 307
MrOB1reader: folds 
Uncalled bet (307) returned to color_singleton
color_singleton collected 614 from pot
color_singleton: doesn't show hand 
*** SUMMARY ***
Total pot 650 | Rake 36 
Board [4d Ks 8h As 7d]
Seat 1: color_singleton collected (614)
Seat 2: MnnM150 folded before Flop (didn't bet)
Seat 3: dhduncan (button) folded before Flop (didn't bet)
Seat 5: Duke Croix (small blind) folded before Flop
Seat 8: MrOB1reader (big blind) folded on the River



PokerStars Home Game Hand #221063537015: {Club #3225207}  Hold'em No Limit (50/100) - 2020/12/03 16:09:40 ET
Table 'Winifred' 9-max (Play Money) Seat #5 is the button
Seat 1: color_singleton (17855 in chips) 
Seat 2: MnnM150 (10473 in chips) 
Seat 3: dhduncan (6997 in chips) 
Seat 5: Duke Croix (15507 in chips) 
Seat 8: MrOB1reader (10359 in chips) 
MrOB1reader: posts small blind 50
color_singleton: posts big blind 100
*** HOLE CARDS ***
Dealt to Duke Croix [7d 3d]
MnnM150: folds 
dhduncan: calls 100
Duke Croix: folds 
MrOB1reader: calls 50
color_singleton: checks 
*** FLOP *** [As 2s 7c]
MrOB1reader: checks 
color_singleton: checks 
dhduncan: checks 
*** TURN *** [As 2s 7c] [5c]
MrOB1reader: checks 
color_singleton: bets 141
dhduncan: calls 141
MrOB1reader: folds 
*** RIVER *** [As 2s 7c 5c] [6d]
color_singleton: bets 275
dhduncan: folds 
Uncalled bet (275) returned to color_singleton
color_singleton collected 550 from pot
color_singleton: doesn't show hand 
*** SUMMARY ***
Total pot 582 | Rake 32 
Board [As 2s 7c 5c 6d]
Seat 1: color_singleton (big blind) collected (550)
Seat 2: MnnM150 folded before Flop (didn't bet)
Seat 3: dhduncan folded on the River
Seat 5: Duke Croix (button) folded before Flop (didn't bet)
Seat 8: MrOB1reader (small blind) folded on the Turn



PokerStars Home Game Hand #221063565857: {Club #3225207}  Hold'em No Limit (50/100) - 2020/12/03 16:10:24 ET
Table 'Winifred' 9-max (Play Money) Seat #8 is the button
Seat 1: color_singleton (18164 in chips) 
Seat 2: MnnM150 (10473 in chips) 
Seat 3: dhduncan (6756 in chips) 
Seat 5: Duke Croix (15507 in chips) 
Seat 8: MrOB1reader (10259 in chips) 
color_singleton: posts small blind 50
MnnM150: posts big blind 100
*** HOLE CARDS ***
Dealt to Duke Croix [Ah 8h]
dhduncan: folds 
Duke Croix: raises 200 to 300
MrOB1reader: calls 300
color_singleton: calls 250
MnnM150: calls 200
*** FLOP *** [9c 9d Qs]
color_singleton: checks 
MnnM150: checks 
Duke Croix: checks 
MrOB1reader: checks 
*** TURN *** [9c 9d Qs] [Kd]
color_singleton: checks 
MnnM150: checks 
Duke Croix: checks 
MrOB1reader: bets 100
color_singleton: calls 100
MnnM150: calls 100
Duke Croix: folds 
*** RIVER *** [9c 9d Qs Kd] [7d]
color_singleton: checks 
MnnM150: checks 
MrOB1reader: bets 100
color_singleton: calls 100
MnnM150: calls 100
*** SHOW DOWN ***
MrOB1reader: shows [Ac 3d] (a pair of Nines)
color_singleton: shows [Tc 7c] (two pair, Nines and Sevens)
MnnM150: mucks hand 
color_singleton collected 1701 from pot
*** SUMMARY ***
Total pot 1800 | Rake 99 
Board [9c 9d Qs Kd 7d]
Seat 1: color_singleton (small blind) showed [Tc 7c] and won (1701) with two pair, Nines and Sevens
Seat 2: MnnM150 (big blind) mucked [Ad 5c]
Seat 3: dhduncan folded before Flop (didn't bet)
Seat 5: Duke Croix folded on the Turn
Seat 8: MrOB1reader (button) showed [Ac 3d] and lost with a pair of Nines



PokerStars Home Game Hand #221063618666: {Club #3225207}  Hold'em No Limit (50/100) - 2020/12/03 16:11:38 ET
Table 'Winifred' 9-max (Play Money) Seat #1 is the button
Seat 1: color_singleton (19365 in chips) 
Seat 2: MnnM150 (9973 in chips) 
Seat 3: dhduncan (6756 in chips) 
Seat 5: Duke Croix (15207 in chips) 
Seat 8: MrOB1reader (9759 in chips) 
MnnM150: posts small blind 50
dhduncan: posts big blind 100
*** HOLE CARDS ***
Dealt to Duke Croix [9d 9s]
Duke Croix: raises 300 to 400
MrOB1reader: folds 
color_singleton: calls 400
MnnM150: folds 
dhduncan: folds 
*** FLOP *** [9c 2c 4c]
Duke Croix: bets 400
color_singleton: calls 400
*** TURN *** [9c 2c 4c] [Jc]
Duke Croix: checks 
color_singleton: checks 
*** RIVER *** [9c 2c 4c Jc] [3h]
Duke Croix: checks 
color_singleton: bets 1654
Duke Croix: folds 
Uncalled bet (1654) returned to color_singleton
color_singleton collected 1654 from pot
color_singleton: doesn't show hand 
*** SUMMARY ***
Total pot 1750 | Rake 96 
Board [9c 2c 4c Jc 3h]
Seat 1: color_singleton (button) collected (1654)
Seat 2: MnnM150 (small blind) folded before Flop
Seat 3: dhduncan (big blind) folded before Flop
Seat 5: Duke Croix folded on the River
Seat 8: MrOB1reader folded before Flop (didn't bet)



PokerStars Home Game Hand #221063642945: {Club #3225207}  Hold'em No Limit (50/100) - 2020/12/03 16:12:14 ET
Table 'Winifred' 9-max (Play Money) Seat #2 is the button
Seat 1: color_singleton (20219 in chips) 
Seat 2: MnnM150 (9923 in chips) 
Seat 3: dhduncan (6656 in chips) 
Seat 5: Duke Croix (14407 in chips) 
Seat 8: MrOB1reader (9759 in chips) 
dhduncan: posts small blind 50
Duke Croix: posts big blind 100
*** HOLE CARDS ***
Dealt to Duke Croix [Ks 5h]
MrOB1reader: calls 100
color_singleton: raises 100 to 200
MnnM150: calls 200
dhduncan: calls 150
Duke Croix: folds 
MrOB1reader: calls 100
*** FLOP *** [Tc 9c 2c]
dhduncan: checks 
MrOB1reader: checks 
color_singleton: bets 425
MnnM150: folds 
dhduncan: folds 
MrOB1reader: folds 
Uncalled bet (425) returned to color_singleton
color_singleton collected 850 from pot
color_singleton: doesn't show hand 
*** SUMMARY ***
Total pot 900 | Rake 50 
Board [Tc 9c 2c]
Seat 1: color_singleton collected (850)
Seat 2: MnnM150 (button) folded on the Flop
Seat 3: dhduncan (small blind) folded on the Flop
Seat 5: Duke Croix (big blind) folded before Flop
Seat 8: MrOB1reader folded on the Flop



PokerStars Home Game Hand #221063662423: {Club #3225207}  Hold'em No Limit (50/100) - 2020/12/03 16:12:44 ET
Table 'Winifred' 9-max (Play Money) Seat #3 is the button
Seat 1: color_singleton (20869 in chips) 
Seat 2: MnnM150 (9723 in chips) 
Seat 3: dhduncan (6456 in chips) 
Seat 5: Duke Croix (14307 in chips) 
Seat 8: MrOB1reader (9559 in chips) 
Duke Croix: posts small blind 50
MrOB1reader: posts big blind 100
*** HOLE CARDS ***
Dealt to Duke Croix [5h Tc]
color_singleton: raises 100 to 200
MnnM150: folds 
dhduncan: calls 200
Duke Croix: folds 
MrOB1reader: calls 100
*** FLOP *** [Qh 3h 9d]
MrOB1reader: checks 
color_singleton: bets 307
dhduncan: folds 
MrOB1reader: folds 
Uncalled bet (307) returned to color_singleton
color_singleton collected 614 from pot
color_singleton: doesn't show hand 
*** SUMMARY ***
Total pot 650 | Rake 36 
Board [Qh 3h 9d]
Seat 1: color_singleton collected (614)
Seat 2: MnnM150 folded before Flop (didn't bet)
Seat 3: dhduncan (button) folded on the Flop
Seat 5: Duke Croix (small blind) folded before Flop
Seat 8: MrOB1reader (big blind) folded on the Flop



PokerStars Home Game Hand #221063681033: {Club #3225207}  Hold'em No Limit (50/100) - 2020/12/03 16:13:11 ET
Table 'Winifred' 9-max (Play Money) Seat #5 is the button
Seat 1: color_singleton (21283 in chips) 
Seat 2: MnnM150 (9723 in chips) 
Seat 3: dhduncan (6256 in chips) 
Seat 5: Duke Croix (14257 in chips) 
Seat 8: MrOB1reader (9359 in chips) 
MrOB1reader: posts small blind 50
color_singleton: posts big blind 100
*** HOLE CARDS ***
Dealt to Duke Croix [3h 6s]
MnnM150: folds 
dhduncan: folds 
Duke Croix: folds 
MrOB1reader: calls 50
color_singleton: raises 300 to 400
MrOB1reader: calls 300
*** FLOP *** [8h 9s Tc]
MrOB1reader: checks 
color_singleton: checks 
*** TURN *** [8h 9s Tc] [4c]
MrOB1reader: bets 100
color_singleton: raises 100 to 200
MrOB1reader: calls 100
*** RIVER *** [8h 9s Tc 4c] [Ad]
MrOB1reader: checks 
color_singleton: checks 
*** SHOW DOWN ***
MrOB1reader: shows [3s 4s] (a pair of Fours)
color_singleton: shows [Ks Kd] (a pair of Kings)
color_singleton collected 1134 from pot
*** SUMMARY ***
Total pot 1200 | Rake 66 
Board [8h 9s Tc 4c Ad]
Seat 1: color_singleton (big blind) showed [Ks Kd] and won (1134) with a pair of Kings
Seat 2: MnnM150 folded before Flop (didn't bet)
Seat 3: dhduncan folded before Flop (didn't bet)
Seat 5: Duke Croix (button) folded before Flop (didn't bet)
Seat 8: MrOB1reader (small blind) showed [3s 4s] and lost with a pair of Fours



PokerStars Home Game Hand #221063703944: {Club #3225207}  Hold'em No Limit (50/100) - 2020/12/03 16:13:46 ET
Table 'Winifred' 9-max (Play Money) Seat #8 is the button
Seat 1: color_singleton (21817 in chips) 
Seat 2: MnnM150 (9723 in chips) 
Seat 3: dhduncan (6256 in chips) 
Seat 5: Duke Croix (14257 in chips) 
Seat 8: MrOB1reader (8759 in chips) 
color_singleton: posts small blind 50
MnnM150: posts big blind 100
*** HOLE CARDS ***
Dealt to Duke Croix [8s 4h]
dhduncan: raises 100 to 200
Duke Croix: folds 
MrOB1reader: calls 200
color_singleton: calls 150
MnnM150: folds 
*** FLOP *** [8h 2d 6h]
color_singleton: checks 
dhduncan: checks 
MrOB1reader: checks 
*** TURN *** [8h 2d 6h] [4c]
color_singleton: checks 
dhduncan: checks 
MrOB1reader: checks 
*** RIVER *** [8h 2d 6h 4c] [7d]
color_singleton: checks 
dhduncan: checks 
MrOB1reader: checks 
*** SHOW DOWN ***
color_singleton: shows [Js 9h] (high card Jack)
dhduncan: shows [Qs Ac] (high card Ace)
MrOB1reader: shows [Jc 7c] (a pair of Sevens)
MrOB1reader collected 661 from pot
*** SUMMARY ***
Total pot 700 | Rake 39 
Board [8h 2d 6h 4c 7d]
Seat 1: color_singleton (small blind) showed [Js 9h] and lost with high card Jack
Seat 2: MnnM150 (big blind) folded before Flop
Seat 3: dhduncan showed [Qs Ac] and lost with high card Ace
Seat 5: Duke Croix folded before Flop (didn't bet)
Seat 8: MrOB1reader (button) showed [Jc 7c] and won (661) with a pair of Sevens



PokerStars Home Game Hand #221063739409: {Club #3225207}  Hold'em No Limit (50/100) - 2020/12/03 16:14:39 ET
Table 'Winifred' 9-max (Play Money) Seat #1 is the button
Seat 1: color_singleton (21617 in chips) 
Seat 2: MnnM150 (9623 in chips) 
Seat 3: dhduncan (6056 in chips) 
Seat 5: Duke Croix (14257 in chips) 
Seat 8: MrOB1reader (9220 in chips) 
MnnM150: posts small blind 50
dhduncan: posts big blind 100
*** HOLE CARDS ***
Dealt to Duke Croix [8c 3d]
Duke Croix: folds 
MrOB1reader: calls 100
color_singleton: calls 100
MnnM150: calls 50
dhduncan: checks 
*** FLOP *** [Qh Jd 7s]
MnnM150: checks 
dhduncan: checks 
MrOB1reader: bets 100
color_singleton: calls 100
MnnM150: folds 
dhduncan: calls 100
*** TURN *** [Qh Jd 7s] [8h]
dhduncan: checks 
MrOB1reader: bets 661
color_singleton has timed out
color_singleton: folds 
dhduncan: folds 
Uncalled bet (661) returned to MrOB1reader
MrOB1reader collected 661 from pot
MrOB1reader: doesn't show hand 
*** SUMMARY ***
Total pot 700 | Rake 39 
Board [Qh Jd 7s 8h]
Seat 1: color_singleton (button) folded on the Turn
Seat 2: MnnM150 (small blind) folded on the Flop
Seat 3: dhduncan (big blind) folded on the Turn
Seat 5: Duke Croix folded before Flop (didn't bet)
Seat 8: MrOB1reader collected (661)



PokerStars Home Game Hand #221063785771: {Club #3225207}  Hold'em No Limit (50/100) - 2020/12/03 16:15:46 ET
Table 'Winifred' 9-max (Play Money) Seat #2 is the button
Seat 2: MnnM150 (9523 in chips) 
Seat 3: dhduncan (5856 in chips) 
Seat 5: Duke Croix (14257 in chips) 
Seat 8: MrOB1reader (9681 in chips) 
dhduncan: posts small blind 50
Duke Croix: posts big blind 100
*** HOLE CARDS ***
Dealt to Duke Croix [As Js]
MrOB1reader: folds 
MnnM150: calls 100
dhduncan: calls 50
Duke Croix: raises 400 to 500
MnnM150: folds 
dhduncan: folds 
Uncalled bet (400) returned to Duke Croix
Duke Croix collected 300 from pot
*** SUMMARY ***
Total pot 300 | Rake 0 
Seat 2: MnnM150 (button) folded before Flop
Seat 3: dhduncan (small blind) folded before Flop
Seat 5: Duke Croix (big blind) collected (300)
Seat 8: MrOB1reader folded before Flop (didn't bet)



PokerStars Home Game Hand #221063800051: {Club #3225207}  Hold'em No Limit (50/100) - 2020/12/03 16:16:07 ET
Table 'Winifred' 9-max (Play Money) Seat #3 is the button
Seat 1: color_singleton (21417 in chips) 
Seat 2: MnnM150 (9423 in chips) 
Seat 3: dhduncan (5756 in chips) 
Seat 5: Duke Croix (14457 in chips) 
Seat 8: MrOB1reader (9681 in chips) 
Duke Croix: posts small blind 50
MrOB1reader: posts big blind 100
*** HOLE CARDS ***
Dealt to Duke Croix [Jc 3s]
color_singleton: raises 200 to 300
MnnM150: folds 
dhduncan: folds 
Duke Croix has timed out
Duke Croix: folds 
MrOB1reader: calls 200
*** FLOP *** [Qc 4s 6c]
MrOB1reader: checks 
color_singleton: checks 
*** TURN *** [Qc 4s 6c] [2d]
MrOB1reader: bets 100
color_singleton: raises 200 to 300
MrOB1reader: calls 200
*** RIVER *** [Qc 4s 6c 2d] [9d]
MrOB1reader: checks 
color_singleton: bets 590
MrOB1reader: folds 
Uncalled bet (590) returned to color_singleton
color_singleton collected 1181 from pot
color_singleton: doesn't show hand 
*** SUMMARY ***
Total pot 1250 | Rake 69 
Board [Qc 4s 6c 2d 9d]
Seat 1: color_singleton collected (1181)
Seat 2: MnnM150 folded before Flop (didn't bet)
Seat 3: dhduncan (button) folded before Flop (didn't bet)
Seat 5: Duke Croix (small blind) folded before Flop
Seat 8: MrOB1reader (big blind) folded on the River



PokerStars Home Game Hand #221063839178: {Club #3225207}  Hold'em No Limit (50/100) - 2020/12/03 16:17:03 ET
Table 'Winifred' 9-max (Play Money) Seat #5 is the button
Seat 1: color_singleton (21998 in chips) 
Seat 2: MnnM150 (9423 in chips) 
Seat 3: dhduncan (5756 in chips) 
Seat 5: Duke Croix (14407 in chips) 
color_singleton: posts small blind 50
MnnM150: posts big blind 100
*** HOLE CARDS ***
Dealt to Duke Croix [Ah 2d]
dhduncan: calls 100
Duke Croix: calls 100
color_singleton: calls 50
MnnM150: checks 
*** FLOP *** [Qh 6s 3h]
color_singleton: bets 189
MnnM150: calls 189
dhduncan: folds 
Duke Croix: folds 
*** TURN *** [Qh 6s 3h] [6c]
color_singleton: bets 367
MnnM150: raises 734 to 1101
color_singleton: folds 
Uncalled bet (734) returned to MnnM150
MnnM150 collected 1429 from pot
*** SUMMARY ***
Total pot 1512 | Rake 83 
Board [Qh 6s 3h 6c]
Seat 1: color_singleton (small blind) folded on the Turn
Seat 2: MnnM150 (big blind) collected (1429)
Seat 3: dhduncan folded on the Flop
Seat 5: Duke Croix (button) folded on the Flop



PokerStars Home Game Hand #221063878939: {Club #3225207}  Hold'em No Limit (50/100) - 2020/12/03 16:18:01 ET
Table 'Winifred' 9-max (Play Money) Seat #1 is the button
Seat 1: color_singleton (21342 in chips) 
Seat 2: MnnM150 (10196 in chips) 
Seat 3: dhduncan (5656 in chips) 
Seat 5: Duke Croix (14307 in chips) 
MnnM150: posts small blind 50
dhduncan: posts big blind 100
*** HOLE CARDS ***
Dealt to Duke Croix [Ks 7s]
Duke Croix: raises 300 to 400
color_singleton: calls 400
MnnM150: calls 350
dhduncan: folds 
*** FLOP *** [3c Kc 6h]
MnnM150: checks 
Duke Croix: bets 900
color_singleton: folds 
MnnM150: folds 
Uncalled bet (900) returned to Duke Croix
Duke Croix collected 1228 from pot
*** SUMMARY ***
Total pot 1300 | Rake 72 
Board [3c Kc 6h]
Seat 1: color_singleton (button) folded on the Flop
Seat 2: MnnM150 (small blind) folded on the Flop
Seat 3: dhduncan (big blind) folded before Flop
Seat 5: Duke Croix collected (1228)



PokerStars Home Game Hand #221063895454: {Club #3225207}  Hold'em No Limit (50/100) - 2020/12/03 16:18:25 ET
Table 'Winifred' 9-max (Play Money) Seat #2 is the button
Seat 1: color_singleton (20942 in chips) 
Seat 2: MnnM150 (9796 in chips) 
Seat 3: dhduncan (5556 in chips) 
Seat 5: Duke Croix (15135 in chips) 
dhduncan: posts small blind 50
Duke Croix: posts big blind 100
*** HOLE CARDS ***
Dealt to Duke Croix [Kd 4h]
color_singleton: folds 
MnnM150: raises 100 to 200
dhduncan: calls 150
Duke Croix: calls 100
*** FLOP *** [Jh 5h 3c]
dhduncan: checks 
Duke Croix: checks 
MnnM150: checks 
*** TURN *** [Jh 5h 3c] [Ah]
dhduncan: checks 
Duke Croix: checks 
MnnM150: bets 567
dhduncan: folds 
Duke Croix: folds 
Uncalled bet (567) returned to MnnM150
MnnM150 collected 567 from pot
*** SUMMARY ***
Total pot 600 | Rake 33 
Board [Jh 5h 3c Ah]
Seat 1: color_singleton folded before Flop (didn't bet)
Seat 2: MnnM150 (button) collected (567)
Seat 3: dhduncan (small blind) folded on the Turn
Seat 5: Duke Croix (big blind) folded on the Turn



PokerStars Home Game Hand #221063925627: {Club #3225207}  Hold'em No Limit (50/100) - 2020/12/03 16:19:09 ET
Table 'Winifred' 9-max (Play Money) Seat #3 is the button
Seat 1: color_singleton (20942 in chips) 
Seat 2: MnnM150 (10163 in chips) 
Seat 3: dhduncan (5356 in chips) 
Seat 5: Duke Croix (14935 in chips) 
Duke Croix: posts small blind 50
color_singleton: posts big blind 100
*** HOLE CARDS ***
Dealt to Duke Croix [6s 3s]
MnnM150: folds 
dhduncan: calls 100
Duke Croix: calls 50
color_singleton: raises 200 to 300
dhduncan: folds 
Duke Croix: calls 200
*** FLOP *** [Jh Qs 6d]
Duke Croix: checks 
color_singleton: checks 
*** TURN *** [Jh Qs 6d] [Kd]
Duke Croix: checks 
color_singleton: checks 
*** RIVER *** [Jh Qs 6d Kd] [9d]
Duke Croix: checks 
color_singleton: checks 
*** SHOW DOWN ***
Duke Croix: shows [6s 3s] (a pair of Sixes)
color_singleton: mucks hand 
Duke Croix collected 661 from pot
*** SUMMARY ***
Total pot 700 | Rake 39 
Board [Jh Qs 6d Kd 9d]
Seat 1: color_singleton (big blind) mucked [Ah 4h]
Seat 2: MnnM150 folded before Flop (didn't bet)
Seat 3: dhduncan (button) folded before Flop
Seat 5: Duke Croix (small blind) showed [6s 3s] and won (661) with a pair of Sixes



PokerStars Home Game Hand #221063949051: {Club #3225207}  Hold'em No Limit (50/100) - 2020/12/03 16:19:43 ET
Table 'Winifred' 9-max (Play Money) Seat #5 is the button
Seat 1: color_singleton (20642 in chips) 
Seat 3: dhduncan (5256 in chips) 
Seat 5: Duke Croix (15296 in chips) 
color_singleton: posts small blind 50
dhduncan: posts big blind 100
*** HOLE CARDS ***
Dealt to Duke Croix [9h Jc]
Duke Croix: folds 
color_singleton: folds 
Uncalled bet (50) returned to dhduncan
dhduncan collected 100 from pot
dhduncan: doesn't show hand 
*** SUMMARY ***
Total pot 100 | Rake 0 
Seat 1: color_singleton (small blind) folded before Flop
Seat 3: dhduncan (big blind) collected (100)
Seat 5: Duke Croix (button) folded before Flop (didn't bet)



PokerStars Home Game Hand #221063952019: {Club #3225207}  Hold'em No Limit (50/100) - 2020/12/03 16:19:47 ET
Table 'Winifred' 9-max (Play Money) Seat #1 is the button
Seat 1: color_singleton (20592 in chips) 
Seat 3: dhduncan (5306 in chips) 
Seat 5: Duke Croix (15296 in chips) 
dhduncan: posts small blind 50
Duke Croix: posts big blind 100
*** HOLE CARDS ***
Dealt to Duke Croix [Jh 6d]
color_singleton: folds 
dhduncan: calls 50
Duke Croix: checks 
*** FLOP *** [Ks Qh 3c]
dhduncan: bets 189
Duke Croix: folds 
Uncalled bet (189) returned to dhduncan
dhduncan collected 189 from pot
dhduncan: doesn't show hand 
*** SUMMARY ***
Total pot 200 | Rake 11 
Board [Ks Qh 3c]
Seat 1: color_singleton (button) folded before Flop (didn't bet)
Seat 3: dhduncan (small blind) collected (189)
Seat 5: Duke Croix (big blind) folded on the Flop



PokerStars Home Game Hand #221063959969: {Club #3225207}  Hold'em No Limit (50/100) - 2020/12/03 16:19:59 ET
Table 'Winifred' 9-max (Play Money) Seat #3 is the button
Seat 1: color_singleton (20592 in chips) 
Seat 3: dhduncan (5395 in chips) 
Seat 5: Duke Croix (15196 in chips) 
Duke Croix: posts small blind 50
color_singleton: posts big blind 100
*** HOLE CARDS ***
Dealt to Duke Croix [4c 2c]
dhduncan: calls 100
Duke Croix: calls 50
color_singleton: checks 
*** FLOP *** [Kh 5c 6c]
Duke Croix: bets 200
color_singleton: folds 
dhduncan: calls 200
*** TURN *** [Kh 5c 6c] [Ks]
Duke Croix: bets 400
dhduncan: calls 400
*** RIVER *** [Kh 5c 6c Ks] [6d]
Duke Croix: bets 800
dhduncan: raises 3895 to 4695 and is all-in
Duke Croix: folds 
Uncalled bet (3895) returned to dhduncan
dhduncan collected 2929 from pot
dhduncan: doesn't show hand 
*** SUMMARY ***
Total pot 3100 | Rake 171 
Board [Kh 5c 6c Ks 6d]
Seat 1: color_singleton (big blind) folded on the Flop
Seat 3: dhduncan (button) collected (2929)
Seat 5: Duke Croix (small blind) folded on the River



PokerStars Home Game Hand #221064003899: {Club #3225207}  Hold'em No Limit (50/100) - 2020/12/03 16:21:03 ET
Table 'Winifred' 9-max (Play Money) Seat #5 is the button
Seat 1: color_singleton (20492 in chips) 
Seat 3: dhduncan (6824 in chips) 
Seat 5: Duke Croix (13696 in chips) 
color_singleton: posts small blind 50
dhduncan: posts big blind 100
*** HOLE CARDS ***
Dealt to Duke Croix [4s 6d]
Duke Croix: folds 
color_singleton: raises 100 to 200
dhduncan: folds 
Uncalled bet (100) returned to color_singleton
color_singleton collected 200 from pot
color_singleton: doesn't show hand 
*** SUMMARY ***
Total pot 200 | Rake 0 
Seat 1: color_singleton (small blind) collected (200)
Seat 3: dhduncan (big blind) folded before Flop
Seat 5: Duke Croix (button) folded before Flop (didn't bet)



PokerStars Home Game Hand #221064019043: {Club #3225207}  Hold'em No Limit (50/100) - 2020/12/03 16:21:24 ET
Table 'Winifred' 9-max (Play Money) Seat #1 is the button
Seat 1: color_singleton (20592 in chips) 
Seat 3: dhduncan (6724 in chips) 
Seat 5: Duke Croix (13696 in chips) 
dhduncan: posts small blind 50
Duke Croix: posts big blind 100
*** HOLE CARDS ***
Dealt to Duke Croix [4d Kc]
color_singleton has timed out
color_singleton: folds 
dhduncan: calls 50
Duke Croix: checks 
*** FLOP *** [Th 2c 8h]
dhduncan: checks 
Duke Croix: checks 
*** TURN *** [Th 2c 8h] [Jh]
dhduncan: checks 
Duke Croix: checks 
*** RIVER *** [Th 2c 8h Jh] [Kh]
dhduncan: bets 189
Duke Croix: calls 189
*** SHOW DOWN ***
dhduncan: shows [Qh As] (a flush, King high)
Duke Croix: mucks hand 
dhduncan collected 546 from pot
*** SUMMARY ***
Total pot 578 | Rake 32 
Board [Th 2c 8h Jh Kh]
Seat 1: color_singleton (button) folded before Flop (didn't bet)
Seat 3: dhduncan (small blind) showed [Qh As] and won (546) with a flush, King high
Seat 5: Duke Croix (big blind) mucked [4d Kc]



PokerStars Home Game Hand #221064060429: {Club #3225207}  Hold'em No Limit (50/100) - 2020/12/03 16:22:21 ET
Table 'Winifred' 9-max (Play Money) Seat #3 is the button
Seat 1: color_singleton (20592 in chips) 
Seat 2: MnnM150 (10163 in chips) 
Seat 3: dhduncan (6981 in chips) 
Seat 5: Duke Croix (13407 in chips) 
Duke Croix: posts small blind 50
color_singleton: posts big blind 100
MnnM150: posts small & big blinds 150
*** HOLE CARDS ***
Dealt to Duke Croix [Qc 3h]
MnnM150: checks 
dhduncan: folds 
Duke Croix: folds 
color_singleton: checks 
*** FLOP *** [9s 2s 7h]
color_singleton: checks 
MnnM150: checks 
*** TURN *** [9s 2s 7h] [8h]
color_singleton: bets 141
MnnM150: folds 
Uncalled bet (141) returned to color_singleton
color_singleton collected 283 from pot
color_singleton: doesn't show hand 
*** SUMMARY ***
Total pot 300 | Rake 17 
Board [9s 2s 7h 8h]
Seat 1: color_singleton (big blind) collected (283)
Seat 2: MnnM150 folded on the Turn (didn't bet)
Seat 3: dhduncan (button) folded before Flop (didn't bet)
Seat 5: Duke Croix (small blind) folded before Flop



PokerStars Home Game Hand #221064082984: {Club #3225207}  Hold'em No Limit (50/100) - 2020/12/03 16:22:54 ET
Table 'Winifred' 9-max (Play Money) Seat #5 is the button
Seat 1: color_singleton (20775 in chips) 
Seat 2: MnnM150 (10013 in chips) 
Seat 3: dhduncan (6981 in chips) 
Seat 5: Duke Croix (13357 in chips) 
color_singleton: posts small blind 50
MnnM150: posts big blind 100
*** HOLE CARDS ***
Dealt to Duke Croix [6s 3s]
dhduncan: folds 
Duke Croix: folds 
color_singleton: calls 50
MnnM150: raises 100 to 200
color_singleton: calls 100
*** FLOP *** [2s 5d Kd]
color_singleton: checks 
MnnM150: bets 100
color_singleton: folds 
Uncalled bet (100) returned to MnnM150
MnnM150 collected 378 from pot
*** SUMMARY ***
Total pot 400 | Rake 22 
Board [2s 5d Kd]
Seat 1: color_singleton (small blind) folded on the Flop
Seat 2: MnnM150 (big blind) collected (378)
Seat 3: dhduncan folded before Flop (didn't bet)
Seat 5: Duke Croix (button) folded before Flop (didn't bet)



PokerStars Home Game Hand #221064100349: {Club #3225207}  Hold'em No Limit (50/100) - 2020/12/03 16:23:19 ET
Table 'Winifred' 9-max (Play Money) Seat #1 is the button
Seat 1: color_singleton (20575 in chips) 
Seat 2: MnnM150 (10191 in chips) 
Seat 3: dhduncan (6981 in chips) 
Seat 5: Duke Croix (13357 in chips) 
MnnM150: posts small blind 50
dhduncan: posts big blind 100
*** HOLE CARDS ***
Dealt to Duke Croix [Ad 5h]
Duke Croix: folds 
color_singleton: folds 
MnnM150: folds 
Uncalled bet (50) returned to dhduncan
dhduncan collected 100 from pot
dhduncan: doesn't show hand 
*** SUMMARY ***
Total pot 100 | Rake 0 
Seat 1: color_singleton (button) folded before Flop (didn't bet)
Seat 2: MnnM150 (small blind) folded before Flop
Seat 3: dhduncan (big blind) collected (100)
Seat 5: Duke Croix folded before Flop (didn't bet)



PokerStars Home Game Hand #221064105157: {Club #3225207}  Hold'em No Limit (50/100) - 2020/12/03 16:23:26 ET
Table 'Winifred' 9-max (Play Money) Seat #2 is the button
Seat 1: color_singleton (20575 in chips) 
Seat 2: MnnM150 (10141 in chips) 
Seat 3: dhduncan (7031 in chips) 
Seat 5: Duke Croix (13357 in chips) 
dhduncan: posts small blind 50
Duke Croix: posts big blind 100
*** HOLE CARDS ***
Dealt to Duke Croix [6h 4c]
color_singleton has timed out
color_singleton: folds 
MnnM150: calls 100
dhduncan: calls 50
Duke Croix: checks 
*** FLOP *** [Jh 9h Kh]
dhduncan: checks 
Duke Croix: checks 
MnnM150: bets 141
dhduncan: folds 
Duke Croix: folds 
Uncalled bet (141) returned to MnnM150
MnnM150 collected 283 from pot
*** SUMMARY ***
Total pot 300 | Rake 17 
Board [Jh 9h Kh]
Seat 1: color_singleton folded before Flop (didn't bet)
Seat 2: MnnM150 (button) collected (283)
Seat 3: dhduncan (small blind) folded on the Flop
Seat 5: Duke Croix (big blind) folded on the Flop



PokerStars Home Game Hand #221064127607: {Club #3225207}  Hold'em No Limit (50/100) - 2020/12/03 16:23:59 ET
Table 'Winifred' 9-max (Play Money) Seat #3 is the button
Seat 2: MnnM150 (10324 in chips) 
Seat 3: dhduncan (6931 in chips) 
Seat 5: Duke Croix (13257 in chips) 
Duke Croix: posts small blind 50
MnnM150: posts big blind 100
*** HOLE CARDS ***
Dealt to Duke Croix [9s 2c]
dhduncan: calls 100
Duke Croix: folds 
MnnM150: raises 100 to 200
dhduncan: calls 100
*** FLOP *** [5s 6h 4d]
MnnM150: bets 100
dhduncan: folds 
Uncalled bet (100) returned to MnnM150
MnnM150 collected 425 from pot
*** SUMMARY ***
Total pot 450 | Rake 25 
Board [5s 6h 4d]
Seat 2: MnnM150 (big blind) collected (425)
Seat 3: dhduncan (button) folded on the Flop
Seat 5: Duke Croix (small blind) folded before Flop



PokerStars Home Game Hand #221064142135: {Club #3225207}  Hold'em No Limit (50/100) - 2020/12/03 16:24:21 ET
Table 'Winifred' 9-max (Play Money) Seat #5 is the button
Seat 2: MnnM150 (10549 in chips) 
Seat 3: dhduncan (6731 in chips) 
Seat 5: Duke Croix (13207 in chips) 
MnnM150: posts small blind 50
dhduncan: posts big blind 100
*** HOLE CARDS ***
Dealt to Duke Croix [7h Jh]
Duke Croix: calls 100
MnnM150: calls 50
dhduncan: checks 
*** FLOP *** [Kc 4s 8s]
MnnM150: bets 100
dhduncan: folds 
Duke Croix: folds 
Uncalled bet (100) returned to MnnM150
MnnM150 collected 283 from pot
*** SUMMARY ***
Total pot 300 | Rake 17 
Board [Kc 4s 8s]
Seat 2: MnnM150 (small blind) collected (283)
Seat 3: dhduncan (big blind) folded on the Flop
Seat 5: Duke Croix (button) folded on the Flop



PokerStars Home Game Hand #221064163325: {Club #3225207}  Hold'em No Limit (50/100) - 2020/12/03 16:24:52 ET
Table 'Winifred' 9-max (Play Money) Seat #2 is the button
Seat 2: MnnM150 (10732 in chips) 
Seat 3: dhduncan (6631 in chips) 
Seat 5: Duke Croix (13107 in chips) 
dhduncan: posts small blind 50
Duke Croix: posts big blind 100
*** HOLE CARDS ***
Dealt to Duke Croix [Jd 2d]
MnnM150: folds 
dhduncan: calls 50
Duke Croix: checks 
*** FLOP *** [9c 4h 9s]
dhduncan: checks 
Duke Croix: checks 
*** TURN *** [9c 4h 9s] [Ks]
dhduncan: checks 
Duke Croix: checks 
*** RIVER *** [9c 4h 9s Ks] [Ad]
dhduncan: checks 
Duke Croix: checks 
*** SHOW DOWN ***
dhduncan: shows [5s Qs] (a pair of Nines)
Duke Croix: mucks hand 
dhduncan collected 189 from pot
*** SUMMARY ***
Total pot 200 | Rake 11 
Board [9c 4h 9s Ks Ad]
Seat 2: MnnM150 (button) folded before Flop (didn't bet)
Seat 3: dhduncan (small blind) showed [5s Qs] and won (189) with a pair of Nines
Seat 5: Duke Croix (big blind) mucked [Jd 2d]



PokerStars Home Game Hand #221064182658: {Club #3225207}  Hold'em No Limit (50/100) - 2020/12/03 16:25:20 ET
Table 'Winifred' 9-max (Play Money) Seat #3 is the button
Seat 1: color_singleton (20575 in chips) 
Seat 2: MnnM150 (10732 in chips) 
Seat 3: dhduncan (6720 in chips) 
Seat 5: Duke Croix (13007 in chips) 
Seat 8: MrOB1reader (9081 in chips) 
Duke Croix: posts small blind 50
MrOB1reader: posts big blind 100
color_singleton: posts small & big blinds 150
*** HOLE CARDS ***
Dealt to Duke Croix [8c 9s]
color_singleton: checks 
MnnM150: calls 100
dhduncan: raises 100 to 200
Duke Croix: folds 
MrOB1reader: calls 100
color_singleton: calls 100
MnnM150: calls 100
*** FLOP *** [Tc 4h 7h]
MrOB1reader: checks 
color_singleton: checks 
MnnM150: checks 
dhduncan: bets 100
MrOB1reader: folds 
color_singleton: calls 100
MnnM150: calls 100
*** TURN *** [Tc 4h 7h] [8s]
color_singleton: bets 567
MnnM150: folds 
dhduncan: calls 567
*** RIVER *** [Tc 4h 7h 8s] [2s]
color_singleton: checks 
dhduncan: checks 
*** SHOW DOWN ***
color_singleton: shows [8h 6h] (a pair of Eights)
dhduncan: shows [Ad Ac] (a pair of Aces)
dhduncan collected 2206 from pot
*** SUMMARY ***
Total pot 2334 | Rake 128 
Board [Tc 4h 7h 8s 2s]
Seat 1: color_singleton showed [8h 6h] and lost with a pair of Eights
Seat 2: MnnM150 folded on the Turn
Seat 3: dhduncan (button) showed [Ad Ac] and won (2206) with a pair of Aces
Seat 5: Duke Croix (small blind) folded before Flop
Seat 8: MrOB1reader (big blind) folded on the Flop



PokerStars Home Game Hand #221064227449: {Club #3225207}  Hold'em No Limit (50/100) - 2020/12/03 16:26:26 ET
Table 'Winifred' 9-max (Play Money) Seat #5 is the button
Seat 1: color_singleton (19658 in chips) 
Seat 2: MnnM150 (10432 in chips) 
Seat 3: dhduncan (8059 in chips) 
Seat 5: Duke Croix (12957 in chips) 
Seat 8: MrOB1reader (8881 in chips) 
MrOB1reader: posts small blind 50
color_singleton: posts big blind 100
*** HOLE CARDS ***
Dealt to Duke Croix [Ts 3d]
MnnM150: folds 
dhduncan: calls 100
Duke Croix: folds 
MrOB1reader: calls 50
color_singleton: raises 200 to 300
dhduncan: calls 200
MrOB1reader: calls 200
*** FLOP *** [5s 8s 7d]
MrOB1reader: bets 100
color_singleton: calls 100
dhduncan: calls 100
*** TURN *** [5s 8s 7d] [6d]
MrOB1reader: checks 
color_singleton: bets 567
dhduncan: folds 
MrOB1reader: calls 567
*** RIVER *** [5s 8s 7d 6d] [6h]
MrOB1reader: checks 
color_singleton: checks 
*** SHOW DOWN ***
MrOB1reader: shows [9d 6s] (a straight, Five to Nine)
color_singleton: mucks hand 
MrOB1reader collected 2206 from pot
*** SUMMARY ***
Total pot 2334 | Rake 128 
Board [5s 8s 7d 6d 6h]
Seat 1: color_singleton (big blind) mucked [8d 5d]
Seat 2: MnnM150 folded before Flop (didn't bet)
Seat 3: dhduncan folded on the Turn
Seat 5: Duke Croix (button) folded before Flop (didn't bet)
Seat 8: MrOB1reader (small blind) showed [9d 6s] and won (2206) with a straight, Five to Nine



PokerStars Home Game Hand #221064269238: {Club #3225207}  Hold'em No Limit (50/100) - 2020/12/03 16:27:27 ET
Table 'Winifred' 9-max (Play Money) Seat #8 is the button
Seat 1: color_singleton (18691 in chips) 
Seat 2: MnnM150 (10432 in chips) 
Seat 3: dhduncan (7659 in chips) 
Seat 5: Duke Croix (12957 in chips) 
Seat 8: MrOB1reader (10120 in chips) 
color_singleton: posts small blind 50
MnnM150: posts big blind 100
*** HOLE CARDS ***
Dealt to Duke Croix [7s Ah]
dhduncan: calls 100
Duke Croix: raises 300 to 400
MrOB1reader: calls 400
color_singleton: folds 
MnnM150: folds 
dhduncan: folds 
*** FLOP *** [9d Td Kh]
Duke Croix: checks 
MrOB1reader: checks 
*** TURN *** [9d Td Kh] [Jd]
Duke Croix: checks 
MrOB1reader: bets 100
Duke Croix: calls 100
*** RIVER *** [9d Td Kh Jd] [3c]
Duke Croix: checks 
MrOB1reader: bets 100
Duke Croix: calls 100
*** SHOW DOWN ***
MrOB1reader: shows [Qs 4h] (a straight, Nine to King)
Duke Croix: mucks hand 
MrOB1reader collected 1370 from pot
*** SUMMARY ***
Total pot 1450 | Rake 80 
Board [9d Td Kh Jd 3c]
Seat 1: color_singleton (small blind) folded before Flop
Seat 2: MnnM150 (big blind) folded before Flop
Seat 3: dhduncan folded before Flop
Seat 5: Duke Croix mucked [7s Ah]
Seat 8: MrOB1reader (button) showed [Qs 4h] and won (1370) with a straight, Nine to King



PokerStars Home Game Hand #221064308591: {Club #3225207}  Hold'em No Limit (50/100) - 2020/12/03 16:28:25 ET
Table 'Winifred' 9-max (Play Money) Seat #1 is the button
Seat 1: color_singleton (18641 in chips) 
Seat 2: MnnM150 (10332 in chips) 
Seat 3: dhduncan (7559 in chips) 
Seat 5: Duke Croix (12357 in chips) 
Seat 8: MrOB1reader (10890 in chips) 
MnnM150: posts small blind 50
dhduncan: posts big blind 100
*** HOLE CARDS ***
Dealt to Duke Croix [7h Qd]
Duke Croix: calls 100
MrOB1reader: raises 100 to 200
color_singleton: calls 200
MnnM150: folds 
dhduncan: folds 
Duke Croix: calls 100
*** FLOP *** [3h 8s 9h]
Duke Croix: checks 
MrOB1reader: checks 
color_singleton: bets 400
Duke Croix: folds 
MrOB1reader: folds 
Uncalled bet (400) returned to color_singleton
color_singleton collected 709 from pot
color_singleton: doesn't show hand 
*** SUMMARY ***
Total pot 750 | Rake 41 
Board [3h 8s 9h]
Seat 1: color_singleton (button) collected (709)
Seat 2: MnnM150 (small blind) folded before Flop
Seat 3: dhduncan (big blind) folded before Flop
Seat 5: Duke Croix folded on the Flop
Seat 8: MrOB1reader folded on the Flop



PokerStars Home Game Hand #221064340719: {Club #3225207}  Hold'em No Limit (50/100) - 2020/12/03 16:29:13 ET
Table 'Winifred' 9-max (Play Money) Seat #2 is the button
Seat 1: color_singleton (19150 in chips) 
Seat 2: MnnM150 (10282 in chips) 
Seat 3: dhduncan (7459 in chips) 
Seat 5: Duke Croix (12157 in chips) 
Seat 8: MrOB1reader (10690 in chips) 
dhduncan: posts small blind 50
Duke Croix: posts big blind 100
*** HOLE CARDS ***
Dealt to Duke Croix [Jh Ad]
MrOB1reader: folds 
color_singleton: raises 200 to 300
MnnM150: folds 
dhduncan: folds 
Duke Croix: calls 200
*** FLOP *** [2h 7d As]
Duke Croix: checks 
color_singleton: checks 
*** TURN *** [2h 7d As] [4c]
Duke Croix: bets 500
color_singleton: folds 
Uncalled bet (500) returned to Duke Croix
Duke Croix collected 614 from pot
*** SUMMARY ***
Total pot 650 | Rake 36 
Board [2h 7d As 4c]
Seat 1: color_singleton folded on the Turn
Seat 2: MnnM150 (button) folded before Flop (didn't bet)
Seat 3: dhduncan (small blind) folded before Flop
Seat 5: Duke Croix (big blind) collected (614)
Seat 8: MrOB1reader folded before Flop (didn't bet)



PokerStars Home Game Hand #221064361565: {Club #3225207}  Hold'em No Limit (50/100) - 2020/12/03 16:29:39 ET
Table 'Winifred' 9-max (Play Money) Seat #3 is the button
Seat 1: color_singleton (18850 in chips) 
Seat 2: MnnM150 (10282 in chips) 
Seat 3: dhduncan (7409 in chips) 
Seat 5: Duke Croix (12471 in chips) 
Seat 8: MrOB1reader (10690 in chips) 
Duke Croix: posts small blind 50
MrOB1reader: posts big blind 100
*** HOLE CARDS ***
Dealt to Duke Croix [3h 6s]
color_singleton: raises 200 to 300
MnnM150: folds 
dhduncan: folds 
Duke Croix: folds 
MrOB1reader: calls 200
*** FLOP *** [Kc Ah Qd]
MrOB1reader: checks 
color_singleton: checks 
*** TURN *** [Kc Ah Qd] [Kh]
MrOB1reader: checks 
color_singleton: bets 307
MrOB1reader: folds 
Uncalled bet (307) returned to color_singleton
color_singleton collected 614 from pot
color_singleton: doesn't show hand 
*** SUMMARY ***
Total pot 650 | Rake 36 
Board [Kc Ah Qd Kh]
Seat 1: color_singleton collected (614)
Seat 2: MnnM150 folded before Flop (didn't bet)
Seat 3: dhduncan (button) folded before Flop (didn't bet)
Seat 5: Duke Croix (small blind) folded before Flop
Seat 8: MrOB1reader (big blind) folded on the Turn



PokerStars Home Game Hand #221064389161: {Club #3225207}  Hold'em No Limit (50/100) - 2020/12/03 16:30:20 ET
Table 'Winifred' 9-max (Play Money) Seat #5 is the button
Seat 1: color_singleton (19164 in chips) 
Seat 2: MnnM150 (10282 in chips) 
Seat 3: dhduncan (7409 in chips) 
Seat 5: Duke Croix (12421 in chips) 
Seat 8: MrOB1reader (10390 in chips) 
MrOB1reader: posts small blind 50
color_singleton: posts big blind 100
*** HOLE CARDS ***
Dealt to Duke Croix [8s Qh]
MnnM150: calls 100
dhduncan: folds 
Duke Croix: folds 
MrOB1reader: calls 50
color_singleton: checks 
*** FLOP *** [7s Ac 9d]
MrOB1reader: checks 
color_singleton: checks 
MnnM150: checks 
*** TURN *** [7s Ac 9d] [2c]
MrOB1reader: bets 222
color_singleton: folds 
MnnM150: folds 
Uncalled bet (222) returned to MrOB1reader
MrOB1reader collected 283 from pot
MrOB1reader: doesn't show hand 
*** SUMMARY ***
Total pot 300 | Rake 17 
Board [7s Ac 9d 2c]
Seat 1: color_singleton (big blind) folded on the Turn
Seat 2: MnnM150 folded on the Turn
Seat 3: dhduncan folded before Flop (didn't bet)
Seat 5: Duke Croix (button) folded before Flop (didn't bet)
Seat 8: MrOB1reader (small blind) collected (283)



PokerStars Home Game Hand #221064413248: {Club #3225207}  Hold'em No Limit (50/100) - 2020/12/03 16:30:55 ET
Table 'Winifred' 9-max (Play Money) Seat #8 is the button
Seat 1: color_singleton (19064 in chips) 
Seat 2: MnnM150 (10182 in chips) 
Seat 3: dhduncan (7409 in chips) 
Seat 5: Duke Croix (12421 in chips) 
Seat 8: MrOB1reader (10573 in chips) 
color_singleton: posts small blind 50
MnnM150: posts big blind 100
*** HOLE CARDS ***
Dealt to Duke Croix [9s Jd]
dhduncan: folds 
Duke Croix: calls 100
MrOB1reader: calls 100
color_singleton: calls 50
MnnM150: checks 
*** FLOP *** [Qs Ts Ah]
color_singleton: checks 
MnnM150: checks 
Duke Croix: bets 200
MrOB1reader: calls 200
color_singleton: calls 200
MnnM150: calls 200
*** TURN *** [Qs Ts Ah] [Qc]
color_singleton: checks 
MnnM150: checks 
Duke Croix: checks 
MrOB1reader: checks 
*** RIVER *** [Qs Ts Ah Qc] [8d]
color_singleton: checks 
MnnM150: checks 
Duke Croix: bets 850
MrOB1reader: folds 
color_singleton: folds 
MnnM150: folds 
Uncalled bet (850) returned to Duke Croix
Duke Croix collected 1134 from pot
*** SUMMARY ***
Total pot 1200 | Rake 66 
Board [Qs Ts Ah Qc 8d]
Seat 1: color_singleton (small blind) folded on the River
Seat 2: MnnM150 (big blind) folded on the River
Seat 3: dhduncan folded before Flop (didn't bet)
Seat 5: Duke Croix collected (1134)
Seat 8: MrOB1reader (button) folded on the River



PokerStars Home Game Hand #221064456746: {Club #3225207}  Hold'em No Limit (50/100) - 2020/12/03 16:32:00 ET
Table 'Winifred' 9-max (Play Money) Seat #1 is the button
Seat 1: color_singleton (18764 in chips) 
Seat 2: MnnM150 (9882 in chips) 
Seat 3: dhduncan (7409 in chips) 
Seat 5: Duke Croix (13255 in chips) 
Seat 8: MrOB1reader (10273 in chips) 
MnnM150: posts small blind 50
dhduncan: posts big blind 100
*** HOLE CARDS ***
Dealt to Duke Croix [Js Ad]
Duke Croix: raises 200 to 300
MrOB1reader: calls 300
color_singleton: folds 
MnnM150 has timed out
MnnM150: folds 
dhduncan: folds 
*** FLOP *** [Td 2c 4d]
Duke Croix: checks 
MrOB1reader: checks 
*** TURN *** [Td 2c 4d] [9c]
Duke Croix: bets 400
MrOB1reader: folds 
Uncalled bet (400) returned to Duke Croix
Duke Croix collected 709 from pot
*** SUMMARY ***
Total pot 750 | Rake 41 
Board [Td 2c 4d 9c]
Seat 1: color_singleton (button) folded before Flop (didn't bet)
Seat 2: MnnM150 (small blind) folded before Flop
Seat 3: dhduncan (big blind) folded before Flop
Seat 5: Duke Croix collected (709)
Seat 8: MrOB1reader folded on the Turn



PokerStars Home Game Hand #221064482771: {Club #3225207}  Hold'em No Limit (50/100) - 2020/12/03 16:32:39 ET
Table 'Winifred' 9-max (Play Money) Seat #2 is the button
Seat 1: color_singleton (18764 in chips) 
Seat 2: MnnM150 (9832 in chips) 
Seat 3: dhduncan (7309 in chips) 
Seat 5: Duke Croix (13664 in chips) 
Seat 8: MrOB1reader (9973 in chips) 
dhduncan: posts small blind 50
Duke Croix: posts big blind 100
*** HOLE CARDS ***
Dealt to Duke Croix [6h 6c]
MrOB1reader: calls 100
color_singleton: raises 300 to 400
MnnM150: folds 
dhduncan: folds 
Duke Croix: calls 300
MrOB1reader: calls 300
*** FLOP *** [3c Tc 7d]
Duke Croix: bets 600
MrOB1reader: folds 
color_singleton: calls 600
*** TURN *** [3c Tc 7d] [8s]
Duke Croix: bets 1100
color_singleton: raises 1100 to 2200
Duke Croix: calls 1100
*** RIVER *** [3c Tc 7d 8s] [Ad]
Duke Croix: checks 
color_singleton: checks 
*** SHOW DOWN ***
Duke Croix: shows [6h 6c] (a pair of Sixes)
color_singleton: shows [Qs Qd] (a pair of Queens)
color_singleton collected 6473 from pot
*** SUMMARY ***
Total pot 6850 | Rake 377 
Board [3c Tc 7d 8s Ad]
Seat 1: color_singleton showed [Qs Qd] and won (6473) with a pair of Queens
Seat 2: MnnM150 (button) folded before Flop (didn't bet)
Seat 3: dhduncan (small blind) folded before Flop
Seat 5: Duke Croix (big blind) showed [6h 6c] and lost with a pair of Sixes
Seat 8: MrOB1reader folded on the Flop



PokerStars Home Game Hand #221064526089: {Club #3225207}  Hold'em No Limit (50/100) - 2020/12/03 16:33:44 ET
Table 'Winifred' 9-max (Play Money) Seat #3 is the button
Seat 1: color_singleton (22037 in chips) 
Seat 2: MnnM150 (9832 in chips) 
Seat 3: dhduncan (7259 in chips) 
Seat 5: Duke Croix (10464 in chips) 
Seat 8: MrOB1reader (9573 in chips) 
Duke Croix: posts small blind 50
MrOB1reader: posts big blind 100
*** HOLE CARDS ***
Dealt to Duke Croix [9c 2h]
color_singleton: folds 
MnnM150: calls 100
dhduncan: calls 100
Duke Croix: folds 
MrOB1reader: checks 
*** FLOP *** [3s 5s 7h]
MrOB1reader: checks 
MnnM150: checks 
dhduncan: checks 
*** TURN *** [3s 5s 7h] [Jd]
MrOB1reader: checks 
MnnM150: checks 
dhduncan: checks 
*** RIVER *** [3s 5s 7h Jd] [Td]
MrOB1reader: checks 
MnnM150: bets 165
dhduncan: folds 
MrOB1reader: folds 
Uncalled bet (165) returned to MnnM150
MnnM150 collected 331 from pot
*** SUMMARY ***
Total pot 350 | Rake 19 
Board [3s 5s 7h Jd Td]
Seat 1: color_singleton folded before Flop (didn't bet)
Seat 2: MnnM150 collected (331)
Seat 3: dhduncan (button) folded on the River
Seat 5: Duke Croix (small blind) folded before Flop
Seat 8: MrOB1reader (big blind) folded on the River



PokerStars Home Game Hand #221064556797: {Club #3225207}  Hold'em No Limit (50/100) - 2020/12/03 16:34:30 ET
Table 'Winifred' 9-max (Play Money) Seat #5 is the button
Seat 1: color_singleton (22037 in chips) 
Seat 2: MnnM150 (10063 in chips) 
Seat 3: dhduncan (7159 in chips) 
Seat 5: Duke Croix (10414 in chips) 
Seat 8: MrOB1reader (9473 in chips) 
MrOB1reader: posts small blind 50
color_singleton: posts big blind 100
*** HOLE CARDS ***
Dealt to Duke Croix [7s 8c]
MnnM150: folds 
dhduncan: folds 
Duke Croix: raises 200 to 300
MrOB1reader: calls 250
color_singleton: calls 200
*** FLOP *** [2c 8h 9c]
MrOB1reader: checks 
color_singleton: checks 
Duke Croix: bets 500
MrOB1reader: folds 
color_singleton: folds 
Uncalled bet (500) returned to Duke Croix
Duke Croix collected 850 from pot
*** SUMMARY ***
Total pot 900 | Rake 50 
Board [2c 8h 9c]
Seat 1: color_singleton (big blind) folded on the Flop
Seat 2: MnnM150 folded before Flop (didn't bet)
Seat 3: dhduncan folded before Flop (didn't bet)
Seat 5: Duke Croix (button) collected (850)
Seat 8: MrOB1reader (small blind) folded on the Flop



PokerStars Home Game Hand #221064575707: {Club #3225207}  Hold'em No Limit (50/100) - 2020/12/03 16:34:58 ET
Table 'Winifred' 9-max (Play Money) Seat #8 is the button
Seat 1: color_singleton (21737 in chips) 
Seat 2: MnnM150 (10063 in chips) 
Seat 5: Duke Croix (10964 in chips) 
Seat 8: MrOB1reader (9173 in chips) 
color_singleton: posts small blind 50
MnnM150: posts big blind 100
*** HOLE CARDS ***
Dealt to Duke Croix [5h Kd]
Duke Croix: folds 
MrOB1reader: calls 100
color_singleton: raises 100 to 200
MnnM150: calls 100
MrOB1reader: calls 100
*** FLOP *** [Ac Kh Ts]
color_singleton: checks 
MnnM150: checks 
MrOB1reader: checks 
*** TURN *** [Ac Kh Ts] [Jh]
color_singleton: bets 283
MnnM150: folds 
MrOB1reader: folds 
Uncalled bet (283) returned to color_singleton
color_singleton collected 567 from pot
color_singleton: doesn't show hand 
*** SUMMARY ***
Total pot 600 | Rake 33 
Board [Ac Kh Ts Jh]
Seat 1: color_singleton (small blind) collected (567)
Seat 2: MnnM150 (big blind) folded on the Turn
Seat 5: Duke Croix folded before Flop (didn't bet)
Seat 8: MrOB1reader (button) folded on the Turn



PokerStars Home Game Hand #221064602040: {Club #3225207}  Hold'em No Limit (50/100) - 2020/12/03 16:35:38 ET
Table 'Winifred' 9-max (Play Money) Seat #1 is the button
Seat 1: color_singleton (22104 in chips) 
Seat 2: MnnM150 (9863 in chips) 
Seat 5: Duke Croix (10964 in chips) 
Seat 8: MrOB1reader (8973 in chips) 
MnnM150: posts small blind 50
Duke Croix: posts big blind 100
*** HOLE CARDS ***
Dealt to Duke Croix [4d Ks]
MrOB1reader: calls 100
color_singleton: folds 
MnnM150: calls 50
Duke Croix: checks 
*** FLOP *** [3d Qh 5c]
MnnM150: checks 
Duke Croix: checks 
MrOB1reader: checks 
*** TURN *** [3d Qh 5c] [4c]
MnnM150: checks 
Duke Croix: checks 
MrOB1reader: checks 
*** RIVER *** [3d Qh 5c 4c] [Jh]
MnnM150: bets 141
Duke Croix: calls 141
MrOB1reader: folds 
*** SHOW DOWN ***
MnnM150: shows [Jd Ah] (a pair of Jacks)
Duke Croix: mucks hand 
MnnM150 collected 550 from pot
*** SUMMARY ***
Total pot 582 | Rake 32 
Board [3d Qh 5c 4c Jh]
Seat 1: color_singleton (button) folded before Flop (didn't bet)
Seat 2: MnnM150 (small blind) showed [Jd Ah] and won (550) with a pair of Jacks
Seat 5: Duke Croix (big blind) mucked [4d Ks]
Seat 8: MrOB1reader folded on the River



PokerStars Home Game Hand #221064624985: {Club #3225207}  Hold'em No Limit (50/100) - 2020/12/03 16:36:12 ET
Table 'Winifred' 9-max (Play Money) Seat #2 is the button
Seat 1: color_singleton (22104 in chips) 
Seat 2: MnnM150 (10172 in chips) 
Seat 5: Duke Croix (10723 in chips) 
Seat 8: MrOB1reader (8873 in chips) 
Duke Croix: posts small blind 50
MrOB1reader: posts big blind 100
*** HOLE CARDS ***
Dealt to Duke Croix [Ah Kd]
color_singleton: raises 200 to 300
MnnM150: calls 300
Duke Croix: calls 250
MrOB1reader: calls 200
*** FLOP *** [2h 8c 6d]
Duke Croix: checks 
MrOB1reader: checks 
color_singleton: checks 
MnnM150: checks 
*** TURN *** [2h 8c 6d] [4h]
Duke Croix: checks 
MrOB1reader: checks 
color_singleton: checks 
MnnM150: checks 
*** RIVER *** [2h 8c 6d 4h] [3h]
Duke Croix: checks 
MrOB1reader: bets 100
color_singleton: calls 100
MnnM150: raises 1434 to 1534
Duke Croix: folds 
MrOB1reader: folds 
color_singleton: folds 
Uncalled bet (1434) returned to MnnM150
MnnM150 collected 1417 from pot
*** SUMMARY ***
Total pot 1500 | Rake 83 
Board [2h 8c 6d 4h 3h]
Seat 1: color_singleton folded on the River
Seat 2: MnnM150 (button) collected (1417)
Seat 5: Duke Croix (small blind) folded on the River
Seat 8: MrOB1reader (big blind) folded on the River



PokerStars Home Game Hand #221064665030: {Club #3225207}  Hold'em No Limit (50/100) - 2020/12/03 16:37:12 ET
Table 'Winifred' 9-max (Play Money) Seat #5 is the button
Seat 1: color_singleton (21704 in chips) 
Seat 2: MnnM150 (11189 in chips) 
Seat 3: dhduncan (7159 in chips) 
Seat 5: Duke Croix (10423 in chips) 
Seat 8: MrOB1reader (8473 in chips) 
MrOB1reader: posts small blind 50
color_singleton: posts big blind 100
dhduncan: posts small & big blinds 150
*** HOLE CARDS ***
Dealt to Duke Croix [5h 4s]
MnnM150: calls 100
dhduncan: checks 
Duke Croix: calls 100
MrOB1reader: calls 50
color_singleton: checks 
*** FLOP *** [Kc Js 8h]
MrOB1reader: checks 
color_singleton: checks 
MnnM150: bets 100
dhduncan: calls 100
Duke Croix: folds 
MrOB1reader: folds 
color_singleton: calls 100
*** TURN *** [Kc Js 8h] [Th]
color_singleton: checks 
MnnM150: checks 
dhduncan: checks 
*** RIVER *** [Kc Js 8h Th] [Jc]
color_singleton: checks 
MnnM150: bets 401
dhduncan: folds 
color_singleton: folds 
Uncalled bet (401) returned to MnnM150
MnnM150 collected 803 from pot
*** SUMMARY ***
Total pot 850 | Rake 47 
Board [Kc Js 8h Th Jc]
Seat 1: color_singleton (big blind) folded on the River
Seat 2: MnnM150 collected (803)
Seat 3: dhduncan folded on the River
Seat 5: Duke Croix (button) folded on the Flop
Seat 8: MrOB1reader (small blind) folded on the Flop



PokerStars Home Game Hand #221064712433: {Club #3225207}  Hold'em No Limit (50/100) - 2020/12/03 16:38:24 ET
Table 'Winifred' 9-max (Play Money) Seat #8 is the button
Seat 1: color_singleton (21504 in chips) 
Seat 2: MnnM150 (11792 in chips) 
Seat 3: dhduncan (6909 in chips) 
Seat 5: Duke Croix (10323 in chips) 
Seat 8: MrOB1reader (8373 in chips) 
color_singleton: posts small blind 50
MnnM150: posts big blind 100
*** HOLE CARDS ***
Dealt to Duke Croix [2s 6h]
dhduncan: folds 
Duke Croix: folds 
MrOB1reader: calls 100
color_singleton: raises 200 to 300
MnnM150: folds 
MrOB1reader: folds 
Uncalled bet (200) returned to color_singleton
color_singleton collected 300 from pot
color_singleton: doesn't show hand 
*** SUMMARY ***
Total pot 300 | Rake 0 
Seat 1: color_singleton (small blind) collected (300)
Seat 2: MnnM150 (big blind) folded before Flop
Seat 3: dhduncan folded before Flop (didn't bet)
Seat 5: Duke Croix folded before Flop (didn't bet)
Seat 8: MrOB1reader (button) folded before Flop



PokerStars Home Game Hand #221064729471: {Club #3225207}  Hold'em No Limit (50/100) - 2020/12/03 16:38:50 ET
Table 'Winifred' 9-max (Play Money) Seat #1 is the button
Seat 1: color_singleton (21704 in chips) 
Seat 2: MnnM150 (11692 in chips) 
Seat 3: dhduncan (6909 in chips) 
Seat 5: Duke Croix (10323 in chips) 
Seat 8: MrOB1reader (8273 in chips) 
MnnM150: posts small blind 50
dhduncan: posts big blind 100
*** HOLE CARDS ***
Dealt to Duke Croix [3h Ts]
Duke Croix: folds 
MrOB1reader: calls 100
color_singleton: folds 
MnnM150: calls 50
dhduncan: checks 
*** FLOP *** [Qh Kd Ah]
MnnM150: bets 141
dhduncan: folds 
MrOB1reader: calls 141
*** TURN *** [Qh Kd Ah] [3d]
MnnM150: bets 550
MrOB1reader: folds 
Uncalled bet (550) returned to MnnM150
MnnM150 collected 550 from pot
*** SUMMARY ***
Total pot 582 | Rake 32 
Board [Qh Kd Ah 3d]
Seat 1: color_singleton (button) folded before Flop (didn't bet)
Seat 2: MnnM150 (small blind) collected (550)
Seat 3: dhduncan (big blind) folded on the Flop
Seat 5: Duke Croix folded before Flop (didn't bet)
Seat 8: MrOB1reader folded on the Turn



PokerStars Home Game Hand #221064769709: {Club #3225207}  Hold'em No Limit (50/100) - 2020/12/03 16:39:42 ET
Table 'Winifred' 9-max (Play Money) Seat #2 is the button
Seat 1: color_singleton (21704 in chips) 
Seat 2: MnnM150 (12001 in chips) 
Seat 3: dhduncan (6809 in chips) 
Seat 5: Duke Croix (10323 in chips) 
Seat 8: MrOB1reader (8032 in chips) 
dhduncan: posts small blind 50
Duke Croix: posts big blind 100
*** HOLE CARDS ***
Dealt to Duke Croix [4h 6s]
MrOB1reader: calls 100
color_singleton: calls 100
MnnM150: calls 100
dhduncan: calls 50
Duke Croix has timed out
Duke Croix: checks 
*** FLOP *** [6c 9s 4s]
dhduncan: checks 
Duke Croix: bets 400
MrOB1reader: folds 
color_singleton: calls 400
MnnM150: folds 
dhduncan: folds 
*** TURN *** [6c 9s 4s] [Qh]
Duke Croix: bets 900
color_singleton: calls 900
*** RIVER *** [6c 9s 4s Qh] [Jd]
Duke Croix: checks 
color_singleton: bets 1464
Duke Croix: calls 1464
*** SHOW DOWN ***
color_singleton: shows [Js 9d] (two pair, Jacks and Nines)
Duke Croix: mucks hand 
color_singleton collected 5696 from pot
*** SUMMARY ***
Total pot 6028 | Rake 332 
Board [6c 9s 4s Qh Jd]
Seat 1: color_singleton showed [Js 9d] and won (5696) with two pair, Jacks and Nines
Seat 2: MnnM150 (button) folded on the Flop
Seat 3: dhduncan (small blind) folded on the Flop
Seat 5: Duke Croix (big blind) mucked [4h 6s]
Seat 8: MrOB1reader folded on the Flop



PokerStars Home Game Hand #221064816070: {Club #3225207}  Hold'em No Limit (50/100) - 2020/12/03 16:40:53 ET
Table 'Winifred' 9-max (Play Money) Seat #3 is the button
Seat 1: color_singleton (24536 in chips) 
Seat 2: MnnM150 (11901 in chips) 
Seat 3: dhduncan (6709 in chips) 
Seat 5: Duke Croix (7459 in chips) 
Seat 8: MrOB1reader (7932 in chips) 
Duke Croix: posts small blind 50
MrOB1reader: posts big blind 100
*** HOLE CARDS ***
Dealt to Duke Croix [7s 9c]
color_singleton: folds 
MnnM150: calls 100
dhduncan: calls 100
Duke Croix: calls 50
MrOB1reader: checks 
*** FLOP *** [As Ah 2s]
Duke Croix: checks 
MrOB1reader: checks 
MnnM150: checks 
dhduncan: checks 
*** TURN *** [As Ah 2s] [Jh]
Duke Croix: checks 
MrOB1reader: checks 
MnnM150: checks 
dhduncan: checks 
*** RIVER *** [As Ah 2s Jh] [2h]
Duke Croix: checks 
MrOB1reader: checks 
MnnM150: checks 
dhduncan: bets 100
Duke Croix: folds 
MrOB1reader: folds 
MnnM150: folds 
Uncalled bet (100) returned to dhduncan
dhduncan collected 378 from pot
dhduncan: doesn't show hand 
*** SUMMARY ***
Total pot 400 | Rake 22 
Board [As Ah 2s Jh 2h]
Seat 1: color_singleton folded before Flop (didn't bet)
Seat 2: MnnM150 folded on the River
Seat 3: dhduncan (button) collected (378)
Seat 5: Duke Croix (small blind) folded on the River
Seat 8: MrOB1reader (big blind) folded on the River



PokerStars Home Game Hand #221064857076: {Club #3225207}  Hold'em No Limit (50/100) - 2020/12/03 16:41:56 ET
Table 'Winifred' 9-max (Play Money) Seat #5 is the button
Seat 1: color_singleton (24536 in chips) 
Seat 2: MnnM150 (11801 in chips) 
Seat 3: dhduncan (6987 in chips) 
Seat 5: Duke Croix (7359 in chips) 
Seat 8: MrOB1reader (7832 in chips) 
MrOB1reader: posts small blind 50
color_singleton: posts big blind 100
*** HOLE CARDS ***
Dealt to Duke Croix [3d 3c]
MnnM150: folds 
dhduncan: folds 
Duke Croix has timed out
Duke Croix: folds 
MrOB1reader: calls 50
color_singleton: checks 
*** FLOP *** [8d Qs 4s]
MrOB1reader: checks 
color_singleton: checks 
*** TURN *** [8d Qs 4s] [Kd]
MrOB1reader: checks 
color_singleton: checks 
*** RIVER *** [8d Qs 4s Kd] [Qh]
MrOB1reader: bets 100
color_singleton: calls 100
*** SHOW DOWN ***
MrOB1reader: shows [9h Th] (a pair of Queens)
color_singleton: shows [4h Tc] (two pair, Queens and Fours)
color_singleton collected 378 from pot
*** SUMMARY ***
Total pot 400 | Rake 22 
Board [8d Qs 4s Kd Qh]
Seat 1: color_singleton (big blind) showed [4h Tc] and won (378) with two pair, Queens and Fours
Seat 2: MnnM150 folded before Flop (didn't bet)
Seat 3: dhduncan folded before Flop (didn't bet)
Seat 5: Duke Croix (button) folded before Flop (didn't bet)
Seat 8: MrOB1reader (small blind) showed [9h Th] and lost with a pair of Queens



PokerStars Home Game Hand #221064928835: {Club #3225207}  Hold'em No Limit (50/100) - 2020/12/03 16:43:46 ET
Table 'Winifred' 9-max (Play Money) Seat #2 is the button
Seat 1: color_singleton (25868 in chips) 
Seat 2: MnnM150 (11551 in chips) 
Seat 3: dhduncan (6487 in chips) 
Seat 5: Duke Croix (7359 in chips) 
Seat 8: MrOB1reader (7132 in chips) 
dhduncan: posts small blind 50
Duke Croix: posts big blind 100
*** HOLE CARDS ***
Dealt to Duke Croix [Qd 4d]
MrOB1reader: folds 
color_singleton: folds 
MnnM150: calls 100
dhduncan: folds 
Duke Croix: checks 
*** FLOP *** [Kh 6c Td]
Duke Croix: checks 
MnnM150: bets 118
Duke Croix: folds 
Uncalled bet (118) returned to MnnM150
MnnM150 collected 236 from pot
*** SUMMARY ***
Total pot 250 | Rake 14 
Board [Kh 6c Td]
Seat 1: color_singleton folded before Flop (didn't bet)
Seat 2: MnnM150 (button) collected (236)
Seat 3: dhduncan (small blind) folded before Flop
Seat 5: Duke Croix (big blind) folded on the Flop
Seat 8: MrOB1reader folded before Flop (didn't bet)



PokerStars Home Game Hand #221064940433: {Club #3225207}  Hold'em No Limit (50/100) - 2020/12/03 16:44:04 ET
Table 'Winifred' 9-max (Play Money) Seat #3 is the button
Seat 1: color_singleton (25868 in chips) 
Seat 2: MnnM150 (11687 in chips) 
Seat 3: dhduncan (6437 in chips) 
Seat 5: Duke Croix (7259 in chips) 
Seat 8: MrOB1reader (7132 in chips) 
Duke Croix: posts small blind 50
MrOB1reader: posts big blind 100
*** HOLE CARDS ***
Dealt to Duke Croix [Jd 9h]
color_singleton: folds 
MnnM150: folds 
dhduncan: folds 
Duke Croix: calls 50
MrOB1reader: checks 
*** FLOP *** [4c Ts Kd]
Duke Croix: checks 
MrOB1reader: bets 100
Duke Croix: calls 100
*** TURN *** [4c Ts Kd] [As]
Duke Croix: checks 
MrOB1reader: checks 
*** RIVER *** [4c Ts Kd As] [6c]
Duke Croix: checks 
MrOB1reader: checks 
*** SHOW DOWN ***
Duke Croix: shows [Jd 9h] (high card Ace)
MrOB1reader: shows [6h 3d] (a pair of Sixes)
MrOB1reader collected 378 from pot
*** SUMMARY ***
Total pot 400 | Rake 22 
Board [4c Ts Kd As 6c]
Seat 1: color_singleton folded before Flop (didn't bet)
Seat 2: MnnM150 folded before Flop (didn't bet)
Seat 3: dhduncan (button) folded before Flop (didn't bet)
Seat 5: Duke Croix (small blind) showed [Jd 9h] and lost with high card Ace
Seat 8: MrOB1reader (big blind) showed [6h 3d] and won (378) with a pair of Sixes



PokerStars Home Game Hand #221064964975: {Club #3225207}  Hold'em No Limit (50/100) - 2020/12/03 16:44:42 ET
Table 'Winifred' 9-max (Play Money) Seat #5 is the button
Seat 1: color_singleton (25868 in chips) 
Seat 2: MnnM150 (11687 in chips) 
Seat 3: dhduncan (6437 in chips) 
Seat 5: Duke Croix (7059 in chips) 
Seat 8: MrOB1reader (7310 in chips) 
MrOB1reader: posts small blind 50
color_singleton: posts big blind 100
*** HOLE CARDS ***
Dealt to Duke Croix [Js 4h]
MnnM150: calls 100
dhduncan: folds 
Duke Croix: folds 
MrOB1reader: calls 50
color_singleton: checks 
*** FLOP *** [3s Jd 7h]
MrOB1reader: bets 283
color_singleton: calls 283
MnnM150: folds 
*** TURN *** [3s Jd 7h] [Th]
MrOB1reader: bets 818
color_singleton: folds 
Uncalled bet (818) returned to MrOB1reader
MrOB1reader collected 818 from pot
MrOB1reader: doesn't show hand 
*** SUMMARY ***
Total pot 866 | Rake 48 
Board [3s Jd 7h Th]
Seat 1: color_singleton (big blind) folded on the Turn
Seat 2: MnnM150 folded on the Flop
Seat 3: dhduncan folded before Flop (didn't bet)
Seat 5: Duke Croix (button) folded before Flop (didn't bet)
Seat 8: MrOB1reader (small blind) collected (818)



PokerStars Home Game Hand #221064990785: {Club #3225207}  Hold'em No Limit (50/100) - 2020/12/03 16:45:21 ET
Table 'Winifred' 9-max (Play Money) Seat #8 is the button
Seat 1: color_singleton (25485 in chips) 
Seat 2: MnnM150 (11587 in chips) 
Seat 3: dhduncan (6437 in chips) 
Seat 5: Duke Croix (7059 in chips) 
Seat 8: MrOB1reader (7745 in chips) 
color_singleton: posts small blind 50
MnnM150: posts big blind 100
*** HOLE CARDS ***
Dealt to Duke Croix [5h 5d]
dhduncan: calls 100
Duke Croix: raises 300 to 400
MrOB1reader: folds 
color_singleton: calls 350
MnnM150: folds 
dhduncan: folds 
*** FLOP *** [6d Qh Ks]
color_singleton: checks 
Duke Croix: checks 
*** TURN *** [6d Qh Ks] [7h]
color_singleton: checks 
Duke Croix: checks 
*** RIVER *** [6d Qh Ks 7h] [Kc]
color_singleton: checks 
Duke Croix: checks 
*** SHOW DOWN ***
color_singleton: shows [4h Ac] (a pair of Kings)
Duke Croix: shows [5h 5d] (two pair, Kings and Fives)
Duke Croix collected 945 from pot
*** SUMMARY ***
Total pot 1000 | Rake 55 
Board [6d Qh Ks 7h Kc]
Seat 1: color_singleton (small blind) showed [4h Ac] and lost with a pair of Kings
Seat 2: MnnM150 (big blind) folded before Flop
Seat 3: dhduncan folded before Flop
Seat 5: Duke Croix showed [5h 5d] and won (945) with two pair, Kings and Fives
Seat 8: MrOB1reader (button) folded before Flop (didn't bet)



PokerStars Home Game Hand #221065013466: {Club #3225207}  Hold'em No Limit (50/100) - 2020/12/03 16:45:56 ET
Table 'Winifred' 9-max (Play Money) Seat #1 is the button
Seat 1: color_singleton (25085 in chips) 
Seat 2: MnnM150 (11487 in chips) 
Seat 3: dhduncan (6337 in chips) 
Seat 5: Duke Croix (7604 in chips) 
Seat 8: MrOB1reader (7745 in chips) 
MnnM150: posts small blind 50
dhduncan: posts big blind 100
*** HOLE CARDS ***
Dealt to Duke Croix [8c Kh]
Duke Croix: calls 100
MrOB1reader: raises 100 to 200
color_singleton: calls 200
MnnM150: calls 150
dhduncan: folds 
Duke Croix: calls 100
*** FLOP *** [Jc 2c Jh]
MnnM150: checks 
Duke Croix: checks 
MrOB1reader: checks 
color_singleton: checks 
*** TURN *** [Jc 2c Jh] [3h]
MnnM150: checks 
Duke Croix: checks 
MrOB1reader: bets 850
color_singleton: folds 
MnnM150: folds 
Duke Croix: folds 
Uncalled bet (850) returned to MrOB1reader
MrOB1reader collected 850 from pot
MrOB1reader: doesn't show hand 
*** SUMMARY ***
Total pot 900 | Rake 50 
Board [Jc 2c Jh 3h]
Seat 1: color_singleton (button) folded on the Turn
Seat 2: MnnM150 (small blind) folded on the Turn
Seat 3: dhduncan (big blind) folded before Flop
Seat 5: Duke Croix folded on the Turn
Seat 8: MrOB1reader collected (850)



PokerStars Home Game Hand #221065033065: {Club #3225207}  Hold'em No Limit (50/100) - 2020/12/03 16:46:26 ET
Table 'Winifred' 9-max (Play Money) Seat #2 is the button
Seat 1: color_singleton (24885 in chips) 
Seat 2: MnnM150 (11287 in chips) 
Seat 3: dhduncan (6237 in chips) 
Seat 5: Duke Croix (7404 in chips) 
Seat 8: MrOB1reader (8395 in chips) 
dhduncan: posts small blind 50
Duke Croix: posts big blind 100
*** HOLE CARDS ***
Dealt to Duke Croix [4h 8h]
MrOB1reader: raises 100 to 200
color_singleton: folds 
MnnM150: calls 200
dhduncan: folds 
Duke Croix: calls 100
*** FLOP *** [6c Qc 7h]
Duke Croix: checks 
MrOB1reader: checks 
MnnM150: checks 
*** TURN *** [6c Qc 7h] [Jd]
Duke Croix: checks 
MrOB1reader: bets 307
MnnM150: folds 
Duke Croix: folds 
Uncalled bet (307) returned to MrOB1reader
MrOB1reader collected 614 from pot
MrOB1reader: doesn't show hand 
*** SUMMARY ***
Total pot 650 | Rake 36 
Board [6c Qc 7h Jd]
Seat 1: color_singleton folded before Flop (didn't bet)
Seat 2: MnnM150 (button) folded on the Turn
Seat 3: dhduncan (small blind) folded before Flop
Seat 5: Duke Croix (big blind) folded on the Turn
Seat 8: MrOB1reader collected (614)



PokerStars Home Game Hand #221065048227: {Club #3225207}  Hold'em No Limit (50/100) - 2020/12/03 16:46:49 ET
Table 'Winifred' 9-max (Play Money) Seat #3 is the button
Seat 1: color_singleton (24885 in chips) 
Seat 2: MnnM150 (11087 in chips) 
Seat 3: dhduncan (6187 in chips) 
Seat 5: Duke Croix (7204 in chips) 
Seat 8: MrOB1reader (8809 in chips) 
Duke Croix: posts small blind 50
MrOB1reader: posts big blind 100
*** HOLE CARDS ***
Dealt to Duke Croix [3c 2c]
color_singleton: raises 200 to 300
MnnM150: calls 300
dhduncan: folds 
Duke Croix: calls 250
MrOB1reader: calls 200
*** FLOP *** [9h Th 3s]
Duke Croix: checks 
MrOB1reader: bets 567
color_singleton: calls 567
MnnM150: folds 
Duke Croix: folds 
*** TURN *** [9h Th 3s] [6h]
MrOB1reader: bets 1103
color_singleton: calls 1103
*** RIVER *** [9h Th 3s 6h] [Ts]
MrOB1reader: checks 
color_singleton: checks 
*** SHOW DOWN ***
MrOB1reader: shows [6d 6s] (a full house, Sixes full of Tens)
color_singleton: mucks hand 
MrOB1reader collected 4290 from pot
*** SUMMARY ***
Total pot 4540 | Rake 250 
Board [9h Th 3s 6h Ts]
Seat 1: color_singleton mucked [Ad Jh]
Seat 2: MnnM150 folded on the Flop
Seat 3: dhduncan (button) folded before Flop (didn't bet)
Seat 5: Duke Croix (small blind) folded on the Flop
Seat 8: MrOB1reader (big blind) showed [6d 6s] and won (4290) with a full house, Sixes full of Tens



PokerStars Home Game Hand #221065090203: {Club #3225207}  Hold'em No Limit (50/100) - 2020/12/03 16:47:40 ET
Table 'Winifred' 9-max (Play Money) Seat #5 is the button
Seat 1: color_singleton (22915 in chips) 
Seat 2: MnnM150 (10787 in chips) 
Seat 3: dhduncan (6187 in chips) 
Seat 5: Duke Croix (6904 in chips) 
Seat 8: MrOB1reader (11129 in chips) 
MrOB1reader: posts small blind 50
color_singleton: posts big blind 100
*** HOLE CARDS ***
Dealt to Duke Croix [6d 8h]
MnnM150: calls 100
dhduncan: calls 100
Duke Croix: folds 
MrOB1reader: raises 100 to 200
color_singleton: calls 100
MnnM150: calls 100
dhduncan: calls 100
*** FLOP *** [7s 9d 5d]
MrOB1reader: checks 
color_singleton: checks 
MnnM150: checks 
dhduncan: checks 
*** TURN *** [7s 9d 5d] [4d]
MrOB1reader: checks 
color_singleton: checks 
MnnM150: checks 
dhduncan: checks 
*** RIVER *** [7s 9d 5d 4d] [4c]
MrOB1reader: bets 100
color_singleton: calls 100
MnnM150: calls 100
dhduncan: folds 
*** SHOW DOWN ***
MrOB1reader: shows [2d 2s] (two pair, Fours and Deuces)
color_singleton: shows [5h 3h] (two pair, Fives and Fours)
MnnM150: mucks hand 
color_singleton collected 1039 from pot
*** SUMMARY ***
Total pot 1100 | Rake 61 
Board [7s 9d 5d 4d 4c]
Seat 1: color_singleton (big blind) showed [5h 3h] and won (1039) with two pair, Fives and Fours
Seat 2: MnnM150 mucked [3d Kh]
Seat 3: dhduncan folded on the River
Seat 5: Duke Croix (button) folded before Flop (didn't bet)
Seat 8: MrOB1reader (small blind) showed [2d 2s] and lost with two pair, Fours and Deuces



PokerStars Home Game Hand #221065122657: {Club #3225207}  Hold'em No Limit (50/100) - 2020/12/03 16:48:29 ET
Table 'Winifred' 9-max (Play Money) Seat #8 is the button
Seat 1: color_singleton (23654 in chips) 
Seat 2: MnnM150 (10487 in chips) 
Seat 3: dhduncan (5987 in chips) 
Seat 5: Duke Croix (6904 in chips) 
Seat 8: MrOB1reader (10829 in chips) 
color_singleton: posts small blind 50
MnnM150: posts big blind 100
*** HOLE CARDS ***
Dealt to Duke Croix [4h 2c]
dhduncan: calls 100
Duke Croix: folds 
MrOB1reader: calls 100
color_singleton: calls 50
MnnM150: checks 
*** FLOP *** [8h Qd Th]
color_singleton: checks 
MnnM150: checks 
dhduncan: bets 100
MrOB1reader: calls 100
color_singleton: calls 100
MnnM150: calls 100
*** TURN *** [8h Qd Th] [3s]
color_singleton: checks 
MnnM150: checks 
dhduncan: bets 100
MrOB1reader: calls 100
color_singleton: calls 100
MnnM150: calls 100
*** RIVER *** [8h Qd Th 3s] [Ah]
color_singleton: checks 
MnnM150: checks 
dhduncan: checks 
MrOB1reader: checks 
*** SHOW DOWN ***
color_singleton: shows [9s Jc] (a straight, Eight to Queen)
MnnM150: mucks hand 
dhduncan: mucks hand 
MrOB1reader: mucks hand 
color_singleton collected 1134 from pot
*** SUMMARY ***
Total pot 1200 | Rake 66 
Board [8h Qd Th 3s Ah]
Seat 1: color_singleton (small blind) showed [9s Jc] and won (1134) with a straight, Eight to Queen
Seat 2: MnnM150 (big blind) mucked [6c 7c]
Seat 3: dhduncan mucked [Ks Qs]
Seat 5: Duke Croix folded before Flop (didn't bet)
Seat 8: MrOB1reader (button) mucked [2s 2d]



PokerStars Home Game Hand #221065160154: {Club #3225207}  Hold'em No Limit (50/100) - 2020/12/03 16:49:26 ET
Table 'Winifred' 9-max (Play Money) Seat #1 is the button
Seat 1: color_singleton (24488 in chips) 
Seat 2: MnnM150 (10187 in chips) 
Seat 3: dhduncan (5687 in chips) 
Seat 5: Duke Croix (6904 in chips) 
Seat 8: MrOB1reader (10529 in chips) 
MnnM150: posts small blind 50
dhduncan: posts big blind 100
*** HOLE CARDS ***
Dealt to Duke Croix [5s 7h]
Duke Croix: folds 
MrOB1reader: calls 100
color_singleton: folds 
MnnM150: calls 50
dhduncan: checks 
*** FLOP *** [6d Qc Td]
MnnM150: checks 
dhduncan: checks 
MrOB1reader: checks 
*** TURN *** [6d Qc Td] [8h]
MnnM150: checks 
dhduncan: checks 
MrOB1reader: checks 
*** RIVER *** [6d Qc Td 8h] [Kh]
MnnM150: checks 
dhduncan: checks 
MrOB1reader: checks 
*** SHOW DOWN ***
MnnM150: shows [Ad 3d] (high card Ace)
dhduncan: shows [8s 7c] (a pair of Eights)
MrOB1reader: mucks hand 
dhduncan collected 283 from pot
*** SUMMARY ***
Total pot 300 | Rake 17 
Board [6d Qc Td 8h Kh]
Seat 1: color_singleton (button) folded before Flop (didn't bet)
Seat 2: MnnM150 (small blind) showed [Ad 3d] and lost with high card Ace
Seat 3: dhduncan (big blind) showed [8s 7c] and won (283) with a pair of Eights
Seat 5: Duke Croix folded before Flop (didn't bet)
Seat 8: MrOB1reader mucked [6s 3c]



PokerStars Home Game Hand #221065187250: {Club #3225207}  Hold'em No Limit (50/100) - 2020/12/03 16:50:08 ET
Table 'Winifred' 9-max (Play Money) Seat #2 is the button
Seat 1: color_singleton (24488 in chips) 
Seat 2: MnnM150 (10087 in chips) 
Seat 3: dhduncan (5870 in chips) 
Seat 5: Duke Croix (6904 in chips) 
Seat 8: MrOB1reader (10429 in chips) 
dhduncan: posts small blind 50
Duke Croix: posts big blind 100
*** HOLE CARDS ***
Dealt to Duke Croix [6s 2s]
MrOB1reader: calls 100
color_singleton: calls 100
MnnM150: calls 100
dhduncan: folds 
Duke Croix: checks 
*** FLOP *** [5c Kh 9s]
Duke Croix: checks 
MrOB1reader: checks 
color_singleton: checks 
MnnM150: checks 
*** TURN *** [5c Kh 9s] [Ac]
Duke Croix: checks 
MrOB1reader: checks 
color_singleton: bets 212
MnnM150: calls 212
Duke Croix: folds 
MrOB1reader: folds 
*** RIVER *** [5c Kh 9s Ac] [Kc]
color_singleton: bets 826
MnnM150: calls 826
*** SHOW DOWN ***
color_singleton: shows [7c 8c] (a flush, Ace high)
MnnM150: mucks hand 
color_singleton collected 2387 from pot
*** SUMMARY ***
Total pot 2526 | Rake 139 
Board [5c Kh 9s Ac Kc]
Seat 1: color_singleton showed [7c 8c] and won (2387) with a flush, Ace high
Seat 2: MnnM150 (button) mucked [As 2c]
Seat 3: dhduncan (small blind) folded before Flop
Seat 5: Duke Croix (big blind) folded on the Turn
Seat 8: MrOB1reader folded on the Turn



PokerStars Home Game Hand #221065222947: {Club #3225207}  Hold'em No Limit (50/100) - 2020/12/03 16:51:02 ET
Table 'Winifred' 9-max (Play Money) Seat #3 is the button
Seat 1: color_singleton (25737 in chips) 
Seat 2: MnnM150 (8949 in chips) 
Seat 3: dhduncan (5820 in chips) 
Seat 5: Duke Croix (6804 in chips) 
Seat 8: MrOB1reader (10329 in chips) 
Duke Croix: posts small blind 50
MrOB1reader: posts big blind 100
*** HOLE CARDS ***
Dealt to Duke Croix [3s 7h]
color_singleton: folds 
MnnM150: calls 100
dhduncan: folds 
Duke Croix: folds 
MrOB1reader: raises 100 to 200
MnnM150: calls 100
*** FLOP *** [Jh Jd Ts]
MrOB1reader: bets 425
MnnM150: folds 
Uncalled bet (425) returned to MrOB1reader
MrOB1reader collected 425 from pot
MrOB1reader: doesn't show hand 
*** SUMMARY ***
Total pot 450 | Rake 25 
Board [Jh Jd Ts]
Seat 1: color_singleton folded before Flop (didn't bet)
Seat 2: MnnM150 folded on the Flop
Seat 3: dhduncan (button) folded before Flop (didn't bet)
Seat 5: Duke Croix (small blind) folded before Flop
Seat 8: MrOB1reader (big blind) collected (425)



PokerStars Home Game Hand #221065239538: {Club #3225207}  Hold'em No Limit (50/100) - 2020/12/03 16:51:28 ET
Table 'Winifred' 9-max (Play Money) Seat #5 is the button
Seat 1: color_singleton (25737 in chips) 
Seat 2: MnnM150 (8749 in chips) 
Seat 3: dhduncan (5820 in chips) 
Seat 5: Duke Croix (6754 in chips) 
Seat 8: MrOB1reader (10554 in chips) 
MrOB1reader: posts small blind 50
color_singleton: posts big blind 100
*** HOLE CARDS ***
Dealt to Duke Croix [4d 4s]
MnnM150: calls 100
dhduncan: calls 100
Duke Croix: raises 400 to 500
MrOB1reader: calls 450
color_singleton: folds 
MnnM150: folds 
dhduncan: calls 400
*** FLOP *** [7c Jc 2c]
MrOB1reader: bets 1606
dhduncan: folds 
Duke Croix: folds 
Uncalled bet (1606) returned to MrOB1reader
MrOB1reader collected 1606 from pot
MrOB1reader: doesn't show hand 
*** SUMMARY ***
Total pot 1700 | Rake 94 
Board [7c Jc 2c]
Seat 1: color_singleton (big blind) folded before Flop
Seat 2: MnnM150 folded before Flop
Seat 3: dhduncan folded on the Flop
Seat 5: Duke Croix (button) folded on the Flop
Seat 8: MrOB1reader (small blind) collected (1606)



PokerStars Home Game Hand #221065258365: {Club #3225207}  Hold'em No Limit (50/100) - 2020/12/03 16:51:57 ET
Table 'Winifred' 9-max (Play Money) Seat #8 is the button
Seat 1: color_singleton (25637 in chips) 
Seat 2: MnnM150 (8649 in chips) 
Seat 3: dhduncan (5320 in chips) 
Seat 5: Duke Croix (6254 in chips) 
Seat 8: MrOB1reader (11660 in chips) 
color_singleton: posts small blind 50
MnnM150: posts big blind 100
*** HOLE CARDS ***
Dealt to Duke Croix [Kh 7c]
dhduncan: folds 
Duke Croix: calls 100
MrOB1reader: calls 100
color_singleton: raises 200 to 300
MnnM150: folds 
Duke Croix: calls 200
MrOB1reader: calls 200
*** FLOP *** [8s Qc 3d]
color_singleton: checks 
Duke Croix: checks 
MrOB1reader: checks 
*** TURN *** [8s Qc 3d] [9h]
color_singleton: checks 
Duke Croix: checks 
MrOB1reader: checks 
*** RIVER *** [8s Qc 3d 9h] [6c]
color_singleton: checks 
Duke Croix: checks 
MrOB1reader: checks 
*** SHOW DOWN ***
color_singleton: shows [Kd Ah] (high card Ace)
Duke Croix: mucks hand 
MrOB1reader: mucks hand 
color_singleton collected 945 from pot
*** SUMMARY ***
Total pot 1000 | Rake 55 
Board [8s Qc 3d 9h 6c]
Seat 1: color_singleton (small blind) showed [Kd Ah] and won (945) with high card Ace
Seat 2: MnnM150 (big blind) folded before Flop
Seat 3: dhduncan folded before Flop (didn't bet)
Seat 5: Duke Croix mucked [Kh 7c]
Seat 8: MrOB1reader (button) mucked [Js 5d]



PokerStars Home Game Hand #221065293260: {Club #3225207}  Hold'em No Limit (50/100) - 2020/12/03 16:52:50 ET
Table 'Winifred' 9-max (Play Money) Seat #1 is the button
Seat 1: color_singleton (26282 in chips) 
Seat 2: MnnM150 (8549 in chips) 
Seat 3: dhduncan (5320 in chips) 
Seat 5: Duke Croix (5954 in chips) 
Seat 8: MrOB1reader (11360 in chips) 
MnnM150: posts small blind 50
dhduncan: posts big blind 100
*** HOLE CARDS ***
Dealt to Duke Croix [Kd 3c]
Duke Croix: folds 
MrOB1reader: raises 100 to 200
color_singleton: folds 
MnnM150: calls 150
dhduncan: calls 100
*** FLOP *** [4c 9h 3d]
MnnM150: checks 
dhduncan: checks 
MrOB1reader: bets 100
MnnM150: raises 100 to 200
dhduncan: folds 
MrOB1reader: raises 100 to 300
MnnM150: calls 100
*** TURN *** [4c 9h 3d] [6s]
MnnM150: checks 
MrOB1reader: bets 100
MnnM150: raises 100 to 200
MrOB1reader: calls 100
*** RIVER *** [4c 9h 3d 6s] [Qs]
MnnM150: bets 100
MrOB1reader: calls 100
*** SHOW DOWN ***
MnnM150: shows [Tc Ts] (a pair of Tens)
MrOB1reader: mucks hand 
MnnM150 collected 1701 from pot
*** SUMMARY ***
Total pot 1800 | Rake 99 
Board [4c 9h 3d 6s Qs]
Seat 1: color_singleton (button) folded before Flop (didn't bet)
Seat 2: MnnM150 (small blind) showed [Tc Ts] and won (1701) with a pair of Tens
Seat 3: dhduncan (big blind) folded on the Flop
Seat 5: Duke Croix folded before Flop (didn't bet)
Seat 8: MrOB1reader mucked [8h 8c]



PokerStars Home Game Hand #221065329691: {Club #3225207}  Hold'em No Limit (50/100) - 2020/12/03 16:53:47 ET
Table 'Winifred' 9-max (Play Money) Seat #2 is the button
Seat 1: color_singleton (26282 in chips) 
Seat 2: MnnM150 (9450 in chips) 
Seat 3: dhduncan (5120 in chips) 
Seat 5: Duke Croix (5954 in chips) 
Seat 8: MrOB1reader (10560 in chips) 
dhduncan: posts small blind 50
Duke Croix: posts big blind 100
*** HOLE CARDS ***
Dealt to Duke Croix [Qd Td]
MrOB1reader: calls 100
color_singleton: folds 
MnnM150: calls 100
dhduncan: calls 50
Duke Croix: raises 300 to 400
MrOB1reader: folds 
MnnM150: calls 300
dhduncan: calls 300
*** FLOP *** [5c 2d Jh]
dhduncan: checks 
Duke Croix: checks 
MnnM150: checks 
*** TURN *** [5c 2d Jh] [Kh]
dhduncan: bets 614
Duke Croix: calls 614
MnnM150: folds 
*** RIVER *** [5c 2d Jh Kh] [Jc]
dhduncan: bets 2389
Duke Croix: folds 
Uncalled bet (2389) returned to dhduncan
dhduncan collected 2389 from pot
dhduncan: doesn't show hand 
*** SUMMARY ***
Total pot 2528 | Rake 139 
Board [5c 2d Jh Kh Jc]
Seat 1: color_singleton folded before Flop (didn't bet)
Seat 2: MnnM150 (button) folded on the Turn
Seat 3: dhduncan (small blind) collected (2389)
Seat 5: Duke Croix (big blind) folded on the River
Seat 8: MrOB1reader folded before Flop



PokerStars Home Game Hand #221065372849: {Club #3225207}  Hold'em No Limit (50/100) - 2020/12/03 16:54:53 ET
Table 'Winifred' 9-max (Play Money) Seat #3 is the button
Seat 1: color_singleton (26282 in chips) 
Seat 2: MnnM150 (9050 in chips) 
Seat 3: dhduncan (6495 in chips) 
Seat 5: Duke Croix (4940 in chips) 
Seat 8: MrOB1reader (10460 in chips) 
Duke Croix: posts small blind 50
MrOB1reader: posts big blind 100
*** HOLE CARDS ***
Dealt to Duke Croix [Ts 2d]
color_singleton: folds 
MnnM150: folds 
dhduncan: calls 100
Duke Croix: folds 
MrOB1reader: checks 
*** FLOP *** [Kh 5d Qh]
MrOB1reader: bets 100
dhduncan: calls 100
*** TURN *** [Kh 5d Qh] [Jd]
MrOB1reader: checks 
dhduncan: bets 425
MrOB1reader: folds 
Uncalled bet (425) returned to dhduncan
dhduncan collected 425 from pot
dhduncan: doesn't show hand 
*** SUMMARY ***
Total pot 450 | Rake 25 
Board [Kh 5d Qh Jd]
Seat 1: color_singleton folded before Flop (didn't bet)
Seat 2: MnnM150 folded before Flop (didn't bet)
Seat 3: dhduncan (button) collected (425)
Seat 5: Duke Croix (small blind) folded before Flop
Seat 8: MrOB1reader (big blind) folded on the Turn



PokerStars Home Game Hand #221065395829: {Club #3225207}  Hold'em No Limit (50/100) - 2020/12/03 16:55:33 ET
Table 'Winifred' 9-max (Play Money) Seat #5 is the button
Seat 1: color_singleton (26282 in chips) 
Seat 2: MnnM150 (9050 in chips) 
Seat 3: dhduncan (6720 in chips) 
Seat 5: Duke Croix (4890 in chips) 
Seat 8: MrOB1reader (10260 in chips) 
MrOB1reader: posts small blind 50
color_singleton: posts big blind 100
*** HOLE CARDS ***
Dealt to Duke Croix [4s As]
MnnM150: calls 100
dhduncan: folds 
Duke Croix: raises 200 to 300
MrOB1reader: calls 250
color_singleton: calls 200
MnnM150: folds 
*** FLOP *** [4d 8c Kh]
MrOB1reader: checks 
color_singleton: checks 
Duke Croix: checks 
*** TURN *** [4d 8c Kh] [6s]
MrOB1reader: checks 
color_singleton: checks 
Duke Croix: checks 
*** RIVER *** [4d 8c Kh 6s] [Qh]
MrOB1reader: checks 
color_singleton: bets 945
Duke Croix: folds 
MrOB1reader: folds 
Uncalled bet (945) returned to color_singleton
color_singleton collected 945 from pot
color_singleton: doesn't show hand 
*** SUMMARY ***
Total pot 1000 | Rake 55 
Board [4d 8c Kh 6s Qh]
Seat 1: color_singleton (big blind) collected (945)
Seat 2: MnnM150 folded before Flop
Seat 3: dhduncan folded before Flop (didn't bet)
Seat 5: Duke Croix (button) folded on the River
Seat 8: MrOB1reader (small blind) folded on the River



PokerStars Home Game Hand #221065420433: {Club #3225207}  Hold'em No Limit (50/100) - 2020/12/03 16:56:24 ET
Table 'Winifred' 9-max (Play Money) Seat #8 is the button
Seat 1: color_singleton (26927 in chips) 
Seat 2: MnnM150 (8950 in chips) 
Seat 3: dhduncan (6720 in chips) 
Seat 5: Duke Croix (4590 in chips) 
Seat 8: MrOB1reader (9960 in chips) 
color_singleton: posts small blind 50
MnnM150: posts big blind 100
*** HOLE CARDS ***
Dealt to Duke Croix [3s Th]
dhduncan: calls 100
Duke Croix: folds 
MrOB1reader: calls 100
color_singleton: calls 50
MnnM150: checks 
*** FLOP *** [6s 8c 6c]
color_singleton: checks 
MnnM150: checks 
dhduncan: checks 
MrOB1reader: checks 
*** TURN *** [6s 8c 6c] [Kc]
color_singleton: checks 
MnnM150: bets 189
dhduncan: calls 189
MrOB1reader: folds 
color_singleton: folds 
*** RIVER *** [6s 8c 6c Kc] [3d]
MnnM150: bets 367
dhduncan: folds 
Uncalled bet (367) returned to MnnM150
MnnM150 collected 735 from pot
*** SUMMARY ***
Total pot 778 | Rake 43 
Board [6s 8c 6c Kc 3d]
Seat 1: color_singleton (small blind) folded on the Turn
Seat 2: MnnM150 (big blind) collected (735)
Seat 3: dhduncan folded on the River
Seat 5: Duke Croix folded before Flop (didn't bet)
Seat 8: MrOB1reader (button) folded on the Turn



PokerStars Home Game Hand #221065444441: {Club #3225207}  Hold'em No Limit (50/100) - 2020/12/03 16:57:14 ET
Table 'Winifred' 9-max (Play Money) Seat #1 is the button
Seat 1: color_singleton (26827 in chips) 
Seat 2: MnnM150 (9396 in chips) 
Seat 3: dhduncan (6431 in chips) 
Seat 5: Duke Croix (4590 in chips) 
Seat 8: MrOB1reader (9860 in chips) 
MnnM150: posts small blind 50
dhduncan: posts big blind 100
*** HOLE CARDS ***
Dealt to Duke Croix [5d Qc]
Duke Croix: folds 
MrOB1reader: calls 100
color_singleton: folds 
MnnM150: calls 50
dhduncan: checks 
*** FLOP *** [2c 7c 8s]
MnnM150: checks 
dhduncan: checks 
MrOB1reader: checks 
*** TURN *** [2c 7c 8s] [4d]
MnnM150: checks 
dhduncan: checks 
MrOB1reader: checks 
*** RIVER *** [2c 7c 8s 4d] [7d]
MnnM150: checks 
dhduncan: checks 
MrOB1reader: checks 
*** SHOW DOWN ***
MnnM150: shows [Qs Th] (a pair of Sevens)
dhduncan: shows [2s Kh] (two pair, Sevens and Deuces)
MrOB1reader: shows [Ts 4s] (two pair, Sevens and Fours)
MrOB1reader collected 283 from pot
*** SUMMARY ***
Total pot 300 | Rake 17 
Board [2c 7c 8s 4d 7d]
Seat 1: color_singleton (button) folded before Flop (didn't bet)
Seat 2: MnnM150 (small blind) showed [Qs Th] and lost with a pair of Sevens
Seat 3: dhduncan (big blind) showed [2s Kh] and lost with two pair, Sevens and Deuces
Seat 5: Duke Croix folded before Flop (didn't bet)
Seat 8: MrOB1reader showed [Ts 4s] and won (283) with two pair, Sevens and Fours



PokerStars Home Game Hand #221065466760: {Club #3225207}  Hold'em No Limit (50/100) - 2020/12/03 16:58:00 ET
Table 'Winifred' 9-max (Play Money) Seat #2 is the button
Seat 1: color_singleton (26827 in chips) 
Seat 2: MnnM150 (9296 in chips) 
Seat 3: dhduncan (6331 in chips) 
Seat 5: Duke Croix (4590 in chips) 
Seat 8: MrOB1reader (10043 in chips) 
dhduncan: posts small blind 50
Duke Croix: posts big blind 100
*** HOLE CARDS ***
Dealt to Duke Croix [2h Td]
MrOB1reader: calls 100
color_singleton: raises 200 to 300
MnnM150: calls 300
dhduncan: calls 250
Duke Croix: folds 
MrOB1reader: calls 200
*** FLOP *** [Ts 8s 3c]
dhduncan: checks 
MrOB1reader: bets 100
color_singleton: calls 100
MnnM150: calls 100
dhduncan: calls 100
*** TURN *** [Ts 8s 3c] [5h]
dhduncan: checks 
MrOB1reader: bets 100
color_singleton: folds 
MnnM150: folds 
dhduncan: calls 100
*** RIVER *** [Ts 8s 3c 5h] [Kd]
dhduncan: checks 
MrOB1reader: bets 100
dhduncan: calls 100
*** SHOW DOWN ***
MrOB1reader: shows [2s Tc] (a pair of Tens)
dhduncan: mucks hand 
MrOB1reader collected 1984 from pot
*** SUMMARY ***
Total pot 2100 | Rake 116 
Board [Ts 8s 3c 5h Kd]
Seat 1: color_singleton folded on the Turn
Seat 2: MnnM150 (button) folded on the Turn
Seat 3: dhduncan (small blind) mucked [Ac Jd]
Seat 5: Duke Croix (big blind) folded before Flop
Seat 8: MrOB1reader showed [2s Tc] and won (1984) with a pair of Tens



PokerStars Home Game Hand #221065502382: {Club #3225207}  Hold'em No Limit (50/100) - 2020/12/03 16:59:12 ET
Table 'Winifred' 9-max (Play Money) Seat #3 is the button
Seat 1: color_singleton (26427 in chips) 
Seat 2: MnnM150 (8896 in chips) 
Seat 3: dhduncan (5731 in chips) 
Seat 5: Duke Croix (4490 in chips) 
Seat 8: MrOB1reader (11427 in chips) 
Duke Croix: posts small blind 50
MrOB1reader: posts big blind 100
*** HOLE CARDS ***
Dealt to Duke Croix [4h 2h]
color_singleton: raises 200 to 300
MnnM150: folds 
dhduncan: calls 300
Duke Croix: folds 
MrOB1reader: calls 200
*** FLOP *** [Kc Qh Qc]
MrOB1reader: checks 
color_singleton: checks 
dhduncan: bets 449
MrOB1reader: folds 
color_singleton: folds 
Uncalled bet (449) returned to dhduncan
dhduncan collected 898 from pot
dhduncan: doesn't show hand 
*** SUMMARY ***
Total pot 950 | Rake 52 
Board [Kc Qh Qc]
Seat 1: color_singleton folded on the Flop
Seat 2: MnnM150 folded before Flop (didn't bet)
Seat 3: dhduncan (button) collected (898)
Seat 5: Duke Croix (small blind) folded before Flop
Seat 8: MrOB1reader (big blind) folded on the Flop



PokerStars Home Game Hand #221065520484: {Club #3225207}  Hold'em No Limit (50/100) - 2020/12/03 16:59:49 ET
Table 'Winifred' 9-max (Play Money) Seat #5 is the button
Seat 1: color_singleton (26127 in chips) 
Seat 2: MnnM150 (8896 in chips) 
Seat 3: dhduncan (6329 in chips) 
Seat 5: Duke Croix (4440 in chips) 
Seat 8: MrOB1reader (11127 in chips) 
MrOB1reader: posts small blind 50
color_singleton: posts big blind 100
*** HOLE CARDS ***
Dealt to Duke Croix [9c 5d]
MnnM150: calls 100
dhduncan: calls 100
Duke Croix: folds 
MrOB1reader: calls 50
color_singleton: checks 
*** FLOP *** [Kh 9h Td]
MrOB1reader: checks 
color_singleton: bets 189
MnnM150: calls 189
dhduncan: calls 189
MrOB1reader: folds 
*** TURN *** [Kh 9h Td] [Js]
color_singleton: bets 457
MnnM150: calls 457
dhduncan: raises 457 to 914
color_singleton: calls 457
MnnM150: calls 457
*** RIVER *** [Kh 9h Td Js] [8d]
color_singleton: checks 
MnnM150: checks 
dhduncan: bets 3505
color_singleton: folds 
MnnM150: folds 
Uncalled bet (3505) returned to dhduncan
dhduncan collected 3505 from pot
dhduncan: doesn't show hand 
*** SUMMARY ***
Total pot 3709 | Rake 204 
Board [Kh 9h Td Js 8d]
Seat 1: color_singleton (big blind) folded on the River
Seat 2: MnnM150 folded on the River
Seat 3: dhduncan collected (3505)
Seat 5: Duke Croix (button) folded before Flop (didn't bet)
Seat 8: MrOB1reader (small blind) folded on the Flop



PokerStars Home Game Hand #221065559190: {Club #3225207}  Hold'em No Limit (50/100) - 2020/12/03 17:00:57 ET
Table 'Winifred' 9-max (Play Money) Seat #8 is the button
Seat 1: color_singleton (24924 in chips) 
Seat 2: MnnM150 (7693 in chips) 
Seat 3: dhduncan (8631 in chips) 
Seat 5: Duke Croix (4440 in chips) 
Seat 8: MrOB1reader (11027 in chips) 
color_singleton: posts small blind 50
MnnM150: posts big blind 100
*** HOLE CARDS ***
Dealt to Duke Croix [Jd 7s]
dhduncan: folds 
Duke Croix: folds 
MrOB1reader: calls 100
color_singleton: raises 200 to 300
MnnM150: calls 200
MrOB1reader: calls 200
*** FLOP *** [Td 8s Kh]
color_singleton: checks 
MnnM150: checks 
MrOB1reader: checks 
*** TURN *** [Td 8s Kh] [9s]
color_singleton: checks 
MnnM150: checks 
MrOB1reader: checks 
*** RIVER *** [Td 8s Kh 9s] [7c]
color_singleton: checks 
MnnM150: checks 
MrOB1reader: checks 
*** SHOW DOWN ***
color_singleton: shows [9c Ah] (a pair of Nines)
MnnM150: mucks hand 
MrOB1reader: mucks hand 
color_singleton collected 850 from pot
*** SUMMARY ***
Total pot 900 | Rake 50 
Board [Td 8s Kh 9s 7c]
Seat 1: color_singleton (small blind) showed [9c Ah] and won (850) with a pair of Nines
Seat 2: MnnM150 (big blind) mucked [As 4d]
Seat 3: dhduncan folded before Flop (didn't bet)
Seat 5: Duke Croix folded before Flop (didn't bet)
Seat 8: MrOB1reader (button) mucked [7h 4s]



PokerStars Home Game Hand #221065582885: {Club #3225207}  Hold'em No Limit (50/100) - 2020/12/03 17:01:36 ET
Table 'Winifred' 9-max (Play Money) Seat #1 is the button
Seat 1: color_singleton (25474 in chips) 
Seat 2: MnnM150 (7393 in chips) 
Seat 3: dhduncan (8631 in chips) 
Seat 5: Duke Croix (4440 in chips) 
Seat 8: MrOB1reader (10727 in chips) 
MnnM150: posts small blind 50
dhduncan: posts big blind 100
*** HOLE CARDS ***
Dealt to Duke Croix [Kd 5d]
Duke Croix: folds 
MrOB1reader: raises 100 to 200
color_singleton: calls 200
MnnM150: folds 
dhduncan: folds 
*** FLOP *** [5h 6c As]
MrOB1reader: bets 100
color_singleton: calls 100
*** TURN *** [5h 6c As] [Qh]
MrOB1reader: checks 
color_singleton: checks 
*** RIVER *** [5h 6c As Qh] [9c]
MrOB1reader: bets 100
color_singleton: calls 100
*** SHOW DOWN ***
MrOB1reader: shows [5s Ac] (two pair, Aces and Fives)
color_singleton: mucks hand 
MrOB1reader collected 898 from pot
*** SUMMARY ***
Total pot 950 | Rake 52 
Board [5h 6c As Qh 9c]
Seat 1: color_singleton (button) mucked [Td Js]
Seat 2: MnnM150 (small blind) folded before Flop
Seat 3: dhduncan (big blind) folded before Flop
Seat 5: Duke Croix folded before Flop (didn't bet)
Seat 8: MrOB1reader showed [5s Ac] and won (898) with two pair, Aces and Fives



PokerStars Home Game Hand #221065605219: {Club #3225207}  Hold'em No Limit (50/100) - 2020/12/03 17:02:11 ET
Table 'Winifred' 9-max (Play Money) Seat #2 is the button
Seat 1: color_singleton (25074 in chips) 
Seat 2: MnnM150 (7343 in chips) 
Seat 3: dhduncan (8531 in chips) 
Seat 5: Duke Croix (4440 in chips) 
Seat 8: MrOB1reader (11225 in chips) 
dhduncan: posts small blind 50
Duke Croix: posts big blind 100
*** HOLE CARDS ***
Dealt to Duke Croix [7h 7s]
MrOB1reader: calls 100
color_singleton: raises 200 to 300
MnnM150: calls 300
dhduncan: calls 250
Duke Croix: calls 200
MrOB1reader: calls 200
*** FLOP *** [Td Ad Qs]
dhduncan: bets 708
Duke Croix: folds 
MrOB1reader: calls 708
color_singleton: calls 708
MnnM150: folds 
*** TURN *** [Td Ad Qs] [Js]
dhduncan: bets 3425
MrOB1reader: calls 3425
color_singleton: calls 3425
*** RIVER *** [Td Ad Qs Js] [Qh]
dhduncan: checks 
MrOB1reader: checks 
color_singleton: bets 13135
dhduncan: folds 
MrOB1reader: folds 
Uncalled bet (13135) returned to color_singleton
color_singleton collected 13135 from pot
color_singleton: doesn't show hand 
*** SUMMARY ***
Total pot 13899 | Rake 764 
Board [Td Ad Qs Js Qh]
Seat 1: color_singleton collected (13135)
Seat 2: MnnM150 (button) folded on the Flop
Seat 3: dhduncan (small blind) folded on the River
Seat 5: Duke Croix (big blind) folded on the Flop
Seat 8: MrOB1reader folded on the River



PokerStars Home Game Hand #221065660423: {Club #3225207}  Hold'em No Limit (50/100) - 2020/12/03 17:03:34 ET
Table 'Winifred' 9-max (Play Money) Seat #3 is the button
Seat 1: color_singleton (33776 in chips) 
Seat 2: MnnM150 (7043 in chips) 
Seat 3: dhduncan (4098 in chips) 
Seat 5: Duke Croix (4140 in chips) 
Seat 8: MrOB1reader (6792 in chips) 
Duke Croix: posts small blind 50
MrOB1reader: posts big blind 100
*** HOLE CARDS ***
Dealt to Duke Croix [7c 7s]
color_singleton: folds 
MnnM150: folds 
dhduncan: calls 100
Duke Croix: raises 300 to 400
MrOB1reader: calls 300
dhduncan: calls 300
*** FLOP *** [3c 8h Ts]
Duke Croix: bets 600
MrOB1reader: folds 
dhduncan: folds 
Uncalled bet (600) returned to Duke Croix
Duke Croix collected 1134 from pot
*** SUMMARY ***
Total pot 1200 | Rake 66 
Board [3c 8h Ts]
Seat 1: color_singleton folded before Flop (didn't bet)
Seat 2: MnnM150 folded before Flop (didn't bet)
Seat 3: dhduncan (button) folded on the Flop
Seat 5: Duke Croix (small blind) collected (1134)
Seat 8: MrOB1reader (big blind) folded on the Flop



PokerStars Home Game Hand #221065692442: {Club #3225207}  Hold'em No Limit (50/100) - 2020/12/03 17:04:23 ET
Table 'Winifred' 9-max (Play Money) Seat #5 is the button
Seat 1: color_singleton (33776 in chips) 
Seat 2: MnnM150 (7043 in chips) 
Seat 3: dhduncan (3698 in chips) 
Seat 5: Duke Croix (4874 in chips) 
Seat 8: MrOB1reader (6392 in chips) 
MrOB1reader: posts small blind 50
color_singleton: posts big blind 100
*** HOLE CARDS ***
Dealt to Duke Croix [3s 8c]
MnnM150: calls 100
dhduncan: folds 
Duke Croix: folds 
MrOB1reader: calls 50
color_singleton: raises 200 to 300
MnnM150: calls 200
MrOB1reader: calls 200
*** FLOP *** [Jh 5h Qc]
MrOB1reader: checks 
color_singleton: checks 
MnnM150: checks 
*** TURN *** [Jh 5h Qc] [Th]
MrOB1reader: checks 
color_singleton: checks 
MnnM150: bets 425
MrOB1reader: folds 
color_singleton: calls 425
*** RIVER *** [Jh 5h Qc Th] [4h]
color_singleton: checks 
MnnM150: bets 1654
color_singleton: folds 
Uncalled bet (1654) returned to MnnM150
MnnM150 collected 1654 from pot
*** SUMMARY ***
Total pot 1750 | Rake 96 
Board [Jh 5h Qc Th 4h]
Seat 1: color_singleton (big blind) folded on the River
Seat 2: MnnM150 collected (1654)
Seat 3: dhduncan folded before Flop (didn't bet)
Seat 5: Duke Croix (button) folded before Flop (didn't bet)
Seat 8: MrOB1reader (small blind) folded on the Turn



PokerStars Home Game Hand #221065727822: {Club #3225207}  Hold'em No Limit (50/100) - 2020/12/03 17:05:16 ET
Table 'Winifred' 9-max (Play Money) Seat #8 is the button
Seat 1: color_singleton (33051 in chips) 
Seat 2: MnnM150 (7972 in chips) 
Seat 3: dhduncan (3698 in chips) 
Seat 5: Duke Croix (4874 in chips) 
Seat 8: MrOB1reader (6092 in chips) 
color_singleton: posts small blind 50
MnnM150: posts big blind 100
*** HOLE CARDS ***
Dealt to Duke Croix [7c 2c]
dhduncan: calls 100
Duke Croix: folds 
MrOB1reader: calls 100
color_singleton: calls 50
MnnM150: checks 
*** FLOP *** [5c Kc Jc]
color_singleton: checks 
MnnM150: checks 
dhduncan: checks 
MrOB1reader: checks 
*** TURN *** [5c Kc Jc] [9h]
color_singleton: checks 
MnnM150: checks 
dhduncan: checks 
MrOB1reader: bets 234
color_singleton: folds 
MnnM150: calls 234
dhduncan: calls 234
*** RIVER *** [5c Kc Jc 9h] [2d]
MnnM150: checks 
dhduncan: checks 
MrOB1reader: bets 345
MnnM150: calls 345
dhduncan: calls 345
*** SHOW DOWN ***
MrOB1reader: shows [Jd 9s] (two pair, Jacks and Nines)
MnnM150: mucks hand 
dhduncan: mucks hand 
MrOB1reader collected 2019 from pot
*** SUMMARY ***
Total pot 2137 | Rake 118 
Board [5c Kc Jc 9h 2d]
Seat 1: color_singleton (small blind) folded on the Turn
Seat 2: MnnM150 (big blind) mucked [As 9c]
Seat 3: dhduncan mucked [4s Kd]
Seat 5: Duke Croix folded before Flop (didn't bet)
Seat 8: MrOB1reader (button) showed [Jd 9s] and won (2019) with two pair, Jacks and Nines



PokerStars Home Game Hand #221065771040: {Club #3225207}  Hold'em No Limit (50/100) - 2020/12/03 17:06:22 ET
Table 'Winifred' 9-max (Play Money) Seat #1 is the button
Seat 1: color_singleton (32951 in chips) 
Seat 2: MnnM150 (7293 in chips) 
Seat 3: dhduncan (3019 in chips) 
Seat 5: Duke Croix (4874 in chips) 
Seat 8: MrOB1reader (7432 in chips) 
MnnM150: posts small blind 50
dhduncan: posts big blind 100
*** HOLE CARDS ***
Dealt to Duke Croix [9c 6h]
Duke Croix: folds 
MrOB1reader: calls 100
color_singleton: raises 200 to 300
MnnM150: folds 
dhduncan: folds 
MrOB1reader: calls 200
*** FLOP *** [Jh Td Ks]
MrOB1reader: checks 
color_singleton: bets 354
MrOB1reader: calls 354
*** TURN *** [Jh Td Ks] [4s]
MrOB1reader: checks 
color_singleton: checks 
*** RIVER *** [Jh Td Ks 4s] [Ts]
MrOB1reader: checks 
color_singleton: checks 
*** SHOW DOWN ***
MrOB1reader: shows [5c 8c] (a pair of Tens)
color_singleton: shows [Ad 4d] (two pair, Tens and Fours)
color_singleton collected 1378 from pot
*** SUMMARY ***
Total pot 1458 | Rake 80 
Board [Jh Td Ks 4s Ts]
Seat 1: color_singleton (button) showed [Ad 4d] and won (1378) with two pair, Tens and Fours
Seat 2: MnnM150 (small blind) folded before Flop
Seat 3: dhduncan (big blind) folded before Flop
Seat 5: Duke Croix folded before Flop (didn't bet)
Seat 8: MrOB1reader showed [5c 8c] and lost with a pair of Tens



PokerStars Home Game Hand #221065808122: {Club #3225207}  Hold'em No Limit (50/100) - 2020/12/03 17:07:18 ET
Table 'Winifred' 9-max (Play Money) Seat #2 is the button
Seat 1: color_singleton (33675 in chips) 
Seat 2: MnnM150 (7243 in chips) 
Seat 3: dhduncan (2919 in chips) 
Seat 5: Duke Croix (4874 in chips) 
Seat 8: MrOB1reader (6778 in chips) 
dhduncan: posts small blind 50
Duke Croix: posts big blind 100
*** HOLE CARDS ***
Dealt to Duke Croix [9h Kd]
MrOB1reader: calls 100
color_singleton: calls 100
MnnM150: calls 100
dhduncan: calls 50
Duke Croix: checks 
*** FLOP *** [8d 4c 5d]
dhduncan: checks 
Duke Croix: checks 
MrOB1reader: bets 100
color_singleton: calls 100
MnnM150: calls 100
dhduncan: calls 100
Duke Croix: calls 100
*** TURN *** [8d 4c 5d] [9d]
dhduncan: bets 100
Duke Croix: raises 300 to 400
MrOB1reader: folds 
color_singleton: folds 
MnnM150: folds 
dhduncan: folds 
Uncalled bet (300) returned to Duke Croix
Duke Croix collected 1134 from pot
*** SUMMARY ***
Total pot 1200 | Rake 66 
Board [8d 4c 5d 9d]
Seat 1: color_singleton folded on the Turn
Seat 2: MnnM150 (button) folded on the Turn
Seat 3: dhduncan (small blind) folded on the Turn
Seat 5: Duke Croix (big blind) collected (1134)
Seat 8: MrOB1reader folded on the Turn



PokerStars Home Game Hand #221065844435: {Club #3225207}  Hold'em No Limit (50/100) - 2020/12/03 17:08:13 ET
Table 'Winifred' 9-max (Play Money) Seat #3 is the button
Seat 1: color_singleton (33475 in chips) 
Seat 2: MnnM150 (7043 in chips) 
Seat 3: dhduncan (2619 in chips) 
Seat 5: Duke Croix (5708 in chips) 
Seat 8: MrOB1reader (6578 in chips) 
Duke Croix: posts small blind 50
MrOB1reader: posts big blind 100
*** HOLE CARDS ***
Dealt to Duke Croix [Tc Th]
color_singleton: raises 100 to 200
MnnM150: folds 
dhduncan: folds 
Duke Croix: raises 400 to 600
MrOB1reader: calls 500
color_singleton: calls 400
*** FLOP *** [5h 4s 8s]
Duke Croix: bets 1200
MrOB1reader: calls 1200
color_singleton: calls 1200
*** TURN *** [5h 4s 8s] [6d]
Duke Croix: bets 3908 and is all-in
MrOB1reader: folds 
color_singleton: calls 3908
*** RIVER *** [5h 4s 8s 6d] [3c]
*** SHOW DOWN ***
Duke Croix: shows [Tc Th] (a pair of Tens)
color_singleton: shows [8c 6c] (two pair, Eights and Sixes)
color_singleton collected 12489 from pot
*** SUMMARY ***
Total pot 13216 | Rake 727 
Board [5h 4s 8s 6d 3c]
Seat 1: color_singleton showed [8c 6c] and won (12489) with two pair, Eights and Sixes
Seat 2: MnnM150 folded before Flop (didn't bet)
Seat 3: dhduncan (button) folded before Flop (didn't bet)
Seat 5: Duke Croix (small blind) showed [Tc Th] and lost with a pair of Tens
Seat 8: MrOB1reader (big blind) folded on the Turn



PokerStars Home Game Hand #221065908829: {Club #3225207}  Hold'em No Limit (50/100) - 2020/12/03 17:09:50 ET
Table 'Winifred' 9-max (Play Money) Seat #1 is the button
Seat 1: color_singleton (41090 in chips) 
Seat 2: MnnM150 (6743 in chips) 
Seat 5: Duke Croix (10000 in chips) 
Seat 8: MrOB1reader (4478 in chips) 
MnnM150: posts small blind 50
Duke Croix: posts big blind 100
*** HOLE CARDS ***
Dealt to Duke Croix [3h 2c]
MrOB1reader: calls 100
color_singleton: raises 100 to 200
MnnM150: folds 
Duke Croix: calls 100
MrOB1reader: calls 100
*** FLOP *** [2h 3d 4s]
Duke Croix: bets 400
MrOB1reader: folds 
color_singleton: folds 
Uncalled bet (400) returned to Duke Croix
Duke Croix collected 614 from pot
*** SUMMARY ***
Total pot 650 | Rake 36 
Board [2h 3d 4s]
Seat 1: color_singleton (button) folded on the Flop
Seat 2: MnnM150 (small blind) folded before Flop
Seat 5: Duke Croix (big blind) collected (614)
Seat 8: MrOB1reader folded on the Flop



PokerStars Home Game Hand #221065926846: {Club #3225207}  Hold'em No Limit (50/100) - 2020/12/03 17:10:17 ET
Table 'Winifred' 9-max (Play Money) Seat #2 is the button
Seat 1: color_singleton (40890 in chips) 
Seat 2: MnnM150 (6693 in chips) 
Seat 5: Duke Croix (10414 in chips) 
Seat 8: MrOB1reader (4278 in chips) 
Duke Croix: posts small blind 50
MrOB1reader: posts big blind 100
*** HOLE CARDS ***
Dealt to Duke Croix [Ah 2d]
color_singleton has timed out
color_singleton: folds 
MnnM150: calls 100
Duke Croix: calls 50
MrOB1reader: checks 
*** FLOP *** [2h Ad Th]
Duke Croix: bets 300
MrOB1reader: folds 
MnnM150: folds 
Uncalled bet (300) returned to Duke Croix
Duke Croix collected 283 from pot
*** SUMMARY ***
Total pot 300 | Rake 17 
Board [2h Ad Th]
Seat 1: color_singleton folded before Flop (didn't bet)
Seat 2: MnnM150 (button) folded on the Flop
Seat 5: Duke Croix (small blind) collected (283)
Seat 8: MrOB1reader (big blind) folded on the Flop



PokerStars Home Game Hand #221065949821: {Club #3225207}  Hold'em No Limit (50/100) - 2020/12/03 17:10:52 ET
Table 'Winifred' 9-max (Play Money) Seat #5 is the button
Seat 2: MnnM150 (6593 in chips) 
Seat 3: dhduncan (2319 in chips) 
Seat 5: Duke Croix (10597 in chips) 
Seat 8: MrOB1reader (4178 in chips) 
MrOB1reader: posts small blind 50
MnnM150: posts big blind 100
dhduncan: posts small & big blinds 150
*** HOLE CARDS ***
Dealt to Duke Croix [Ts 5d]
dhduncan: checks 
Duke Croix: folds 
MrOB1reader: calls 50
MnnM150: checks 
*** FLOP *** [Kh 7d 6c]
MrOB1reader: checks 
MnnM150: checks 
dhduncan: bets 100
MrOB1reader: calls 100
MnnM150: folds 
*** TURN *** [Kh 7d 6c] [Jc]
MrOB1reader: bets 520
dhduncan: folds 
Uncalled bet (520) returned to MrOB1reader
MrOB1reader collected 520 from pot
MrOB1reader: doesn't show hand 
*** SUMMARY ***
Total pot 550 | Rake 30 
Board [Kh 7d 6c Jc]
Seat 2: MnnM150 (big blind) folded on the Flop
Seat 3: dhduncan folded on the Turn
Seat 5: Duke Croix (button) folded before Flop (didn't bet)
Seat 8: MrOB1reader (small blind) collected (520)



PokerStars Home Game Hand #221065973182: {Club #3225207}  Hold'em No Limit (50/100) - 2020/12/03 17:11:28 ET
Table 'Winifred' 9-max (Play Money) Seat #8 is the button
Seat 2: MnnM150 (6493 in chips) 
Seat 3: dhduncan (2069 in chips) 
Seat 5: Duke Croix (10597 in chips) 
Seat 8: MrOB1reader (4498 in chips) 
MnnM150: posts small blind 50
dhduncan: posts big blind 100
*** HOLE CARDS ***
Dealt to Duke Croix [Kc Qh]
Duke Croix: raises 300 to 400
MrOB1reader: folds 
MnnM150: folds 
dhduncan: folds 
Uncalled bet (300) returned to Duke Croix
Duke Croix collected 250 from pot
*** SUMMARY ***
Total pot 250 | Rake 0 
Seat 2: MnnM150 (small blind) folded before Flop
Seat 3: dhduncan (big blind) folded before Flop
Seat 5: Duke Croix collected (250)
Seat 8: MrOB1reader (button) folded before Flop (didn't bet)



PokerStars Home Game Hand #221065979882: {Club #3225207}  Hold'em No Limit (50/100) - 2020/12/03 17:11:38 ET
Table 'Winifred' 9-max (Play Money) Seat #2 is the button
Seat 2: MnnM150 (6443 in chips) 
Seat 3: dhduncan (1969 in chips) 
Seat 5: Duke Croix (10747 in chips) 
Seat 8: MrOB1reader (4498 in chips) 
dhduncan: posts small blind 50
Duke Croix: posts big blind 100
*** HOLE CARDS ***
Dealt to Duke Croix [5s 5d]
MrOB1reader: calls 100
MnnM150: folds 
dhduncan: folds 
Duke Croix: raises 300 to 400
MrOB1reader: calls 300
*** FLOP *** [2c Kc Qd]
Duke Croix: bets 400
MrOB1reader: folds 
Uncalled bet (400) returned to Duke Croix
Duke Croix collected 803 from pot
*** SUMMARY ***
Total pot 850 | Rake 47 
Board [2c Kc Qd]
Seat 2: MnnM150 (button) folded before Flop (didn't bet)
Seat 3: dhduncan (small blind) folded before Flop
Seat 5: Duke Croix (big blind) collected (803)
Seat 8: MrOB1reader folded on the Flop



PokerStars Home Game Hand #221065991588: {Club #3225207}  Hold'em No Limit (50/100) - 2020/12/03 17:11:56 ET
Table 'Winifred' 9-max (Play Money) Seat #3 is the button
Seat 2: MnnM150 (6443 in chips) 
Seat 3: dhduncan (1919 in chips) 
Seat 5: Duke Croix (11150 in chips) 
Seat 8: MrOB1reader (4098 in chips) 
Duke Croix: posts small blind 50
MrOB1reader: posts big blind 100
*** HOLE CARDS ***
Dealt to Duke Croix [Ks 8c]
MnnM150: folds 
dhduncan: folds 
Duke Croix: calls 50
MrOB1reader: raises 100 to 200
Duke Croix: calls 100
*** FLOP *** [Ac 6c 7h]
Duke Croix: checks 
MrOB1reader: bets 378
Duke Croix: folds 
Uncalled bet (378) returned to MrOB1reader
MrOB1reader collected 378 from pot
MrOB1reader: doesn't show hand 
*** SUMMARY ***
Total pot 400 | Rake 22 
Board [Ac 6c 7h]
Seat 2: MnnM150 folded before Flop (didn't bet)
Seat 3: dhduncan (button) folded before Flop (didn't bet)
Seat 5: Duke Croix (small blind) folded on the Flop
Seat 8: MrOB1reader (big blind) collected (378)



PokerStars Home Game Hand #221066002630: {Club #3225207}  Hold'em No Limit (50/100) - 2020/12/03 17:12:13 ET
Table 'Winifred' 9-max (Play Money) Seat #5 is the button
Seat 2: MnnM150 (6443 in chips) 
Seat 3: dhduncan (1919 in chips) 
Seat 5: Duke Croix (10950 in chips) 
Seat 8: MrOB1reader (4276 in chips) 
MrOB1reader: posts small blind 50
MnnM150: posts big blind 100
*** HOLE CARDS ***
Dealt to Duke Croix [Ks 9c]
dhduncan: calls 100
Duke Croix: calls 100
MrOB1reader: raises 100 to 200
MnnM150: folds 
dhduncan: calls 100
Duke Croix: calls 100
*** FLOP *** [2d 5h 6d]
MrOB1reader: bets 100
dhduncan: calls 100
Duke Croix: folds 
*** TURN *** [2d 5h 6d] [7d]
MrOB1reader: bets 100
dhduncan: folds 
Uncalled bet (100) returned to MrOB1reader
MrOB1reader collected 850 from pot
MrOB1reader: doesn't show hand 
*** SUMMARY ***
Total pot 900 | Rake 50 
Board [2d 5h 6d 7d]
Seat 2: MnnM150 (big blind) folded before Flop
Seat 3: dhduncan folded on the Turn
Seat 5: Duke Croix (button) folded on the Flop
Seat 8: MrOB1reader (small blind) collected (850)



PokerStars Home Game Hand #221066028959: {Club #3225207}  Hold'em No Limit (50/100) - 2020/12/03 17:12:52 ET
Table 'Winifred' 9-max (Play Money) Seat #8 is the button
Seat 2: MnnM150 (6343 in chips) 
Seat 3: dhduncan (1619 in chips) 
Seat 5: Duke Croix (10750 in chips) 
Seat 8: MrOB1reader (4826 in chips) 
MnnM150: posts small blind 50
dhduncan: posts big blind 100
*** HOLE CARDS ***
Dealt to Duke Croix [Tc Js]
Duke Croix: raises 300 to 400
MrOB1reader: calls 400
MnnM150: calls 350
dhduncan: folds 
*** FLOP *** [Ac Qc Jh]
MnnM150: checks 
Duke Croix: bets 700
MrOB1reader: folds 
MnnM150: calls 700
*** TURN *** [Ac Qc Jh] [Th]
MnnM150: bets 1275
Duke Croix: calls 1275
*** RIVER *** [Ac Qc Jh Th] [8s]
MnnM150: bets 3968 and is all-in
Duke Croix: folds 
Uncalled bet (3968) returned to MnnM150
MnnM150 collected 4961 from pot
*** SUMMARY ***
Total pot 5250 | Rake 289 
Board [Ac Qc Jh Th 8s]
Seat 2: MnnM150 (small blind) collected (4961)
Seat 3: dhduncan (big blind) folded before Flop
Seat 5: Duke Croix folded on the River
Seat 8: MrOB1reader (button) folded on the Flop



PokerStars Home Game Hand #221066059448: {Club #3225207}  Hold'em No Limit (50/100) - 2020/12/03 17:13:33 ET
Table 'Winifred' 9-max (Play Money) Seat #2 is the button
Seat 1: color_singleton (40890 in chips) 
Seat 2: MnnM150 (8929 in chips) 
Seat 3: dhduncan (1519 in chips) 
Seat 5: Duke Croix (8375 in chips) 
Seat 8: MrOB1reader (4426 in chips) 
dhduncan: posts small blind 50
Duke Croix: posts big blind 100
color_singleton: posts small & big blinds 150
*** HOLE CARDS ***
Dealt to Duke Croix [3s 3c]
MrOB1reader: calls 100
color_singleton: checks 
MnnM150: folds 
dhduncan: calls 50
Duke Croix: raises 200 to 300
MrOB1reader: calls 200
color_singleton: calls 200
dhduncan: calls 200
*** FLOP *** [3h 6d 8d]
dhduncan: checks 
Duke Croix: bets 700
MrOB1reader: folds 
color_singleton: calls 700
dhduncan: folds 
*** TURN *** [3h 6d 8d] [6s]
Duke Croix: checks 
color_singleton: checks 
*** RIVER *** [3h 6d 8d 6s] [Kd]
Duke Croix: bets 1600
color_singleton: calls 1600
*** SHOW DOWN ***
Duke Croix: shows [3s 3c] (a full house, Threes full of Sixes)
color_singleton: mucks hand 
Duke Croix collected 5528 from pot
*** SUMMARY ***
Total pot 5850 | Rake 322 
Board [3h 6d 8d 6s Kd]
Seat 1: color_singleton mucked [6h 2s]
Seat 2: MnnM150 (button) folded before Flop (didn't bet)
Seat 3: dhduncan (small blind) folded on the Flop
Seat 5: Duke Croix (big blind) showed [3s 3c] and won (5528) with a full house, Threes full of Sixes
Seat 8: MrOB1reader folded on the Flop



PokerStars Home Game Hand #221066087711: {Club #3225207}  Hold'em No Limit (50/100) - 2020/12/03 17:14:16 ET
Table 'Winifred' 9-max (Play Money) Seat #3 is the button
Seat 1: color_singleton (38240 in chips) 
Seat 2: MnnM150 (8929 in chips) 
Seat 3: dhduncan (1219 in chips) 
Seat 5: Duke Croix (11303 in chips) 
Seat 8: MrOB1reader (4126 in chips) 
Duke Croix: posts small blind 50
MrOB1reader: posts big blind 100
*** HOLE CARDS ***
Dealt to Duke Croix [7s 3c]
color_singleton: raises 100 to 200
MnnM150: folds 
dhduncan: calls 200
Duke Croix: folds 
MrOB1reader: calls 100
*** FLOP *** [Th 2s 6c]
MrOB1reader: bets 307
color_singleton: folds 
dhduncan: folds 
Uncalled bet (307) returned to MrOB1reader
MrOB1reader collected 614 from pot
MrOB1reader: doesn't show hand 
*** SUMMARY ***
Total pot 650 | Rake 36 
Board [Th 2s 6c]
Seat 1: color_singleton folded on the Flop
Seat 2: MnnM150 folded before Flop (didn't bet)
Seat 3: dhduncan (button) folded on the Flop
Seat 5: Duke Croix (small blind) folded before Flop
Seat 8: MrOB1reader (big blind) collected (614)



PokerStars Home Game Hand #221066106398: {Club #3225207}  Hold'em No Limit (50/100) - 2020/12/03 17:14:45 ET
Table 'Winifred' 9-max (Play Money) Seat #5 is the button
Seat 1: color_singleton (38040 in chips) 
Seat 2: MnnM150 (8929 in chips) 
Seat 3: dhduncan (1019 in chips) 
Seat 5: Duke Croix (11253 in chips) 
Seat 8: MrOB1reader (4540 in chips) 
MrOB1reader: posts small blind 50
color_singleton: posts big blind 100
*** HOLE CARDS ***
Dealt to Duke Croix [6d 8s]
MnnM150: folds 
dhduncan: folds 
Duke Croix: folds 
MrOB1reader: calls 50
color_singleton: checks 
*** FLOP *** [5h 2h Ah]
MrOB1reader: checks 
color_singleton: checks 
*** TURN *** [5h 2h Ah] [9c]
MrOB1reader: bets 189
color_singleton: folds 
Uncalled bet (189) returned to MrOB1reader
MrOB1reader collected 189 from pot
MrOB1reader: doesn't show hand 
*** SUMMARY ***
Total pot 200 | Rake 11 
Board [5h 2h Ah 9c]
Seat 1: color_singleton (big blind) folded on the Turn
Seat 2: MnnM150 folded before Flop (didn't bet)
Seat 3: dhduncan folded before Flop (didn't bet)
Seat 5: Duke Croix (button) folded before Flop (didn't bet)
Seat 8: MrOB1reader (small blind) collected (189)



PokerStars Home Game Hand #221066119768: {Club #3225207}  Hold'em No Limit (50/100) - 2020/12/03 17:15:05 ET
Table 'Winifred' 9-max (Play Money) Seat #8 is the button
Seat 1: color_singleton (37940 in chips) 
Seat 2: MnnM150 (8929 in chips) 
Seat 3: dhduncan (1019 in chips) 
Seat 5: Duke Croix (11253 in chips) 
Seat 8: MrOB1reader (4629 in chips) 
color_singleton: posts small blind 50
MnnM150: posts big blind 100
*** HOLE CARDS ***
Dealt to Duke Croix [4s 9c]
dhduncan: calls 100
Duke Croix has timed out
Duke Croix: folds 
MrOB1reader: calls 100
color_singleton: calls 50
MnnM150: checks 
*** FLOP *** [Kc Jd Ks]
color_singleton: checks 
MnnM150: checks 
dhduncan: checks 
MrOB1reader: checks 
*** TURN *** [Kc Jd Ks] [5c]
color_singleton: checks 
MnnM150: checks 
dhduncan: checks 
MrOB1reader: checks 
*** RIVER *** [Kc Jd Ks 5c] [9s]
color_singleton: bets 378
MnnM150: calls 378
dhduncan: folds 
MrOB1reader: folds 
*** SHOW DOWN ***
color_singleton: shows [8c Kh] (three of a kind, Kings)
MnnM150: mucks hand 
color_singleton collected 1092 from pot
*** SUMMARY ***
Total pot 1156 | Rake 64 
Board [Kc Jd Ks 5c 9s]
Seat 1: color_singleton (small blind) showed [8c Kh] and won (1092) with three of a kind, Kings
Seat 2: MnnM150 (big blind) mucked [Td 5d]
Seat 3: dhduncan folded on the River
Seat 5: Duke Croix folded before Flop (didn't bet)
Seat 8: MrOB1reader (button) folded on the River



PokerStars Home Game Hand #221066158158: {Club #3225207}  Hold'em No Limit (50/100) - 2020/12/03 17:16:04 ET
Table 'Winifred' 9-max (Play Money) Seat #1 is the button
Seat 1: color_singleton (38554 in chips) 
Seat 2: MnnM150 (8451 in chips) 
Seat 3: dhduncan (919 in chips) 
Seat 5: Duke Croix (11253 in chips) 
Seat 8: MrOB1reader (4529 in chips) 
MnnM150: posts small blind 50
dhduncan: posts big blind 100
*** HOLE CARDS ***
Dealt to Duke Croix [6h 4c]
Duke Croix: folds 
MrOB1reader: calls 100
color_singleton: raises 100 to 200
MnnM150: folds 
dhduncan: raises 300 to 500
MrOB1reader: calls 400
color_singleton: calls 300
*** FLOP *** [9h 9c Qc]
dhduncan: bets 419 and is all-in
MrOB1reader: raises 419 to 838
color_singleton: folds 
Uncalled bet (419) returned to MrOB1reader
*** TURN *** [9h 9c Qc] [Js]
*** RIVER *** [9h 9c Qc Js] [Qd]
*** SHOW DOWN ***
dhduncan: shows [2c 2h] (two pair, Queens and Nines)
MrOB1reader: shows [7c 8c] (two pair, Queens and Nines)
dhduncan collected 1129 from pot
MrOB1reader collected 1128 from pot
*** SUMMARY ***
Total pot 2388 | Rake 131 
Board [9h 9c Qc Js Qd]
Seat 1: color_singleton (button) folded on the Flop
Seat 2: MnnM150 (small blind) folded before Flop
Seat 3: dhduncan (big blind) showed [2c 2h] and won (1129) with two pair, Queens and Nines
Seat 5: Duke Croix folded before Flop (didn't bet)
Seat 8: MrOB1reader showed [7c 8c] and won (1128) with two pair, Queens and Nines



PokerStars Home Game Hand #221066189632: {Club #3225207}  Hold'em No Limit (50/100) - 2020/12/03 17:16:52 ET
Table 'Winifred' 9-max (Play Money) Seat #2 is the button
Seat 1: color_singleton (38054 in chips) 
Seat 2: MnnM150 (8401 in chips) 
Seat 3: dhduncan (1129 in chips) 
Seat 5: Duke Croix (11253 in chips) 
Seat 8: MrOB1reader (4738 in chips) 
dhduncan: posts small blind 50
Duke Croix: posts big blind 100
*** HOLE CARDS ***
Dealt to Duke Croix [8s 9c]
MrOB1reader: raises 100 to 200
color_singleton: calls 200
MnnM150: calls 200
dhduncan: calls 150
Duke Croix: calls 100
*** FLOP *** [3c Kc Jh]
dhduncan: checks 
Duke Croix: checks 
MrOB1reader: bets 945
color_singleton: calls 945
MnnM150: calls 945
dhduncan: calls 929 and is all-in
Duke Croix: folds 
*** TURN *** [3c Kc Jh] [Ad]
MrOB1reader: checks 
color_singleton: checks 
MnnM150: checks 
*** RIVER *** [3c Kc Jh Ad] [6h]
MrOB1reader: checks 
color_singleton: checks 
MnnM150: checks 
*** SHOW DOWN ***
MrOB1reader: shows [9h 9s] (a pair of Nines)
color_singleton: shows [Jd Th] (a pair of Jacks)
MnnM150: shows [Ah Qc] (a pair of Aces)
MnnM150 collected 45 from side pot
dhduncan: mucks hand 
MnnM150 collected 4457 from main pot
*** SUMMARY ***
Total pot 4764 Main pot 4457. Side pot 45. | Rake 262 
Board [3c Kc Jh Ad 6h]
Seat 1: color_singleton showed [Jd Th] and lost with a pair of Jacks
Seat 2: MnnM150 (button) showed [Ah Qc] and won (4502) with a pair of Aces
Seat 3: dhduncan (small blind) mucked [Qd Kh]
Seat 5: Duke Croix (big blind) folded on the Flop
Seat 8: MrOB1reader showed [9h 9s] and lost with a pair of Nines



PokerStars Home Game Hand #221066226513: {Club #3225207}  Hold'em No Limit (50/100) - 2020/12/03 17:17:49 ET
Table 'Winifred' 9-max (Play Money) Seat #5 is the button
Seat 1: color_singleton (36909 in chips) 
Seat 2: MnnM150 (11758 in chips) 
Seat 5: Duke Croix (11053 in chips) 
Seat 8: MrOB1reader (3593 in chips) 
MrOB1reader: posts small blind 50
color_singleton: posts big blind 100
*** HOLE CARDS ***
Dealt to Duke Croix [5c 5d]
MnnM150: calls 100
Duke Croix: raises 300 to 400
MrOB1reader: calls 350
color_singleton: calls 300
MnnM150: calls 300
*** FLOP *** [3s 2c 4c]
MrOB1reader: bets 1512
color_singleton: calls 1512
MnnM150: folds 
Duke Croix: calls 1512
*** TURN *** [3s 2c 4c] [2s]
MrOB1reader: bets 1681 and is all-in
color_singleton: calls 1681
Duke Croix: calls 1681
*** RIVER *** [3s 2c 4c 2s] [Td]
color_singleton: checks 
Duke Croix: checks 
*** SHOW DOWN ***
MrOB1reader: shows [Jc 8c] (a pair of Deuces)
color_singleton: shows [Kc Ad] (a pair of Deuces - Ace kicker)
Duke Croix: shows [5c 5d] (two pair, Fives and Deuces)
Duke Croix collected 10564 from pot
*** SUMMARY ***
Total pot 11179 | Rake 615 
Board [3s 2c 4c 2s Td]
Seat 1: color_singleton (big blind) showed [Kc Ad] and lost with a pair of Deuces
Seat 2: MnnM150 folded on the Flop
Seat 5: Duke Croix (button) showed [5c 5d] and won (10564) with two pair, Fives and Deuces
Seat 8: MrOB1reader (small blind) showed [Jc 8c] and lost with a pair of Deuces



PokerStars Home Game Hand #221066250611: {Club #3225207}  Hold'em No Limit (50/100) - 2020/12/03 17:18:26 ET
Table 'Winifred' 9-max (Play Money) Seat #1 is the button
Seat 1: color_singleton (33316 in chips) 
Seat 2: MnnM150 (11358 in chips) 
Seat 3: dhduncan (10000 in chips) 
Seat 5: Duke Croix (18024 in chips) 
MnnM150: posts small blind 50
dhduncan: posts big blind 100
*** HOLE CARDS ***
Dealt to Duke Croix [4c Qc]
Duke Croix: folds 
color_singleton: raises 100 to 200
MnnM150 has timed out
MnnM150: folds 
dhduncan: folds 
Uncalled bet (100) returned to color_singleton
color_singleton collected 250 from pot
color_singleton: doesn't show hand 
*** SUMMARY ***
Total pot 250 | Rake 0 
Seat 1: color_singleton (button) collected (250)
Seat 2: MnnM150 (small blind) folded before Flop
Seat 3: dhduncan (big blind) folded before Flop
Seat 5: Duke Croix folded before Flop (didn't bet)



PokerStars Home Game Hand #221066267790: {Club #3225207}  Hold'em No Limit (50/100) - 2020/12/03 17:18:52 ET
Table 'Winifred' 9-max (Play Money) Seat #3 is the button
Seat 1: color_singleton (33466 in chips) 
Seat 3: dhduncan (9900 in chips) 
Seat 5: Duke Croix (18024 in chips) 
Seat 8: MrOB1reader (10000 in chips) 
Duke Croix: posts small blind 50
MrOB1reader: posts big blind 100
*** HOLE CARDS ***
Dealt to Duke Croix [8d 9h]
color_singleton: raises 200 to 300
dhduncan: calls 300
Duke Croix: folds 
MrOB1reader: calls 200
*** FLOP *** [4c 9d As]
MrOB1reader: checks 
color_singleton: checks 
dhduncan: checks 
*** TURN *** [4c 9d As] [3h]
MrOB1reader: checks 
color_singleton: checks 
dhduncan: checks 
*** RIVER *** [4c 9d As 3h] [6d]
MrOB1reader: checks 
color_singleton: checks 
dhduncan: checks 
*** SHOW DOWN ***
MrOB1reader: shows [5h Kc] (high card Ace)
color_singleton: mucks hand 
dhduncan: mucks hand 
MrOB1reader collected 898 from pot
*** SUMMARY ***
Total pot 950 | Rake 52 
Board [4c 9d As 3h 6d]
Seat 1: color_singleton mucked [Ts Jc]
Seat 3: dhduncan (button) mucked [Tc Qd]
Seat 5: Duke Croix (small blind) folded before Flop
Seat 8: MrOB1reader (big blind) showed [5h Kc] and won (898) with high card Ace



PokerStars Home Game Hand #221066294545: {Club #3225207}  Hold'em No Limit (50/100) - 2020/12/03 17:19:34 ET
Table 'Winifred' 9-max (Play Money) Seat #5 is the button
Seat 1: color_singleton (33166 in chips) 
Seat 3: dhduncan (9600 in chips) 
Seat 5: Duke Croix (17974 in chips) 
Seat 8: MrOB1reader (10598 in chips) 
MrOB1reader: posts small blind 50
color_singleton: posts big blind 100
*** HOLE CARDS ***
Dealt to Duke Croix [5c 5d]
dhduncan: calls 100
Duke Croix: raises 300 to 400
MrOB1reader: calls 350
color_singleton: folds 
dhduncan: calls 300
*** FLOP *** [3s Ks Qh]
MrOB1reader: bets 322
dhduncan: calls 322
Duke Croix: folds 
*** TURN *** [3s Ks Qh] [8d]
MrOB1reader: bets 918
dhduncan: calls 918
*** RIVER *** [3s Ks Qh 8d] [Qs]
MrOB1reader: bets 3572
dhduncan: folds 
Uncalled bet (3572) returned to MrOB1reader
MrOB1reader collected 3572 from pot
MrOB1reader: doesn't show hand 
*** SUMMARY ***
Total pot 3780 | Rake 208 
Board [3s Ks Qh 8d Qs]
Seat 1: color_singleton (big blind) folded before Flop
Seat 3: dhduncan folded on the River
Seat 5: Duke Croix (button) folded on the Flop
Seat 8: MrOB1reader (small blind) collected (3572)



PokerStars Home Game Hand #221066334514: {Club #3225207}  Hold'em No Limit (50/100) - 2020/12/03 17:20:35 ET
Table 'Winifred' 9-max (Play Money) Seat #8 is the button
Seat 1: color_singleton (33066 in chips) 
Seat 3: dhduncan (7960 in chips) 
Seat 5: Duke Croix (17574 in chips) 
Seat 8: MrOB1reader (12530 in chips) 
color_singleton: posts small blind 50
dhduncan: posts big blind 100
*** HOLE CARDS ***
Dealt to Duke Croix [8c Qd]
Duke Croix: calls 100
MrOB1reader: raises 100 to 200
color_singleton: calls 150
dhduncan: folds 
Duke Croix: calls 100
*** FLOP *** [5h 8d Th]
color_singleton: checks 
Duke Croix: checks 
MrOB1reader: bets 330
color_singleton: calls 330
Duke Croix: calls 330
*** TURN *** [5h 8d Th] [2h]
color_singleton: checks 
Duke Croix: checks 
MrOB1reader: bets 100
color_singleton: calls 100
Duke Croix: calls 100
*** RIVER *** [5h 8d Th 2h] [As]
color_singleton: checks 
Duke Croix: checks 
MrOB1reader: bets 200
color_singleton: folds 
Duke Croix: calls 200
*** SHOW DOWN ***
MrOB1reader: shows [9h Kh] (a flush, King high)
Duke Croix: mucks hand 
MrOB1reader collected 2259 from pot
*** SUMMARY ***
Total pot 2390 | Rake 131 
Board [5h 8d Th 2h As]
Seat 1: color_singleton (small blind) folded on the River
Seat 3: dhduncan (big blind) folded before Flop
Seat 5: Duke Croix mucked [8c Qd]
Seat 8: MrOB1reader (button) showed [9h Kh] and won (2259) with a flush, King high



PokerStars Home Game Hand #221066371677: {Club #3225207}  Hold'em No Limit (50/100) - 2020/12/03 17:21:33 ET
Table 'Winifred' 9-max (Play Money) Seat #1 is the button
Seat 1: color_singleton (32436 in chips) 
Seat 3: dhduncan (7860 in chips) 
Seat 5: Duke Croix (16744 in chips) 
Seat 8: MrOB1reader (13959 in chips) 
dhduncan: posts small blind 50
Duke Croix: posts big blind 100
*** HOLE CARDS ***
Dealt to Duke Croix [2h 3h]
MrOB1reader: raises 100 to 200
color_singleton: folds 
dhduncan: folds 
Duke Croix: calls 100
*** FLOP *** [Kd 3s 6d]
Duke Croix: checks 
MrOB1reader: bets 425
Duke Croix: folds 
Uncalled bet (425) returned to MrOB1reader
MrOB1reader collected 425 from pot
MrOB1reader: doesn't show hand 
*** SUMMARY ***
Total pot 450 | Rake 25 
Board [Kd 3s 6d]
Seat 1: color_singleton (button) folded before Flop (didn't bet)
Seat 3: dhduncan (small blind) folded before Flop
Seat 5: Duke Croix (big blind) folded on the Flop
Seat 8: MrOB1reader collected (425)



PokerStars Home Game Hand #221066382516: {Club #3225207}  Hold'em No Limit (50/100) - 2020/12/03 17:21:50 ET
Table 'Winifred' 9-max (Play Money) Seat #3 is the button
Seat 1: color_singleton (32436 in chips) 
Seat 2: MnnM150 (11308 in chips) 
Seat 3: dhduncan (7810 in chips) 
Seat 5: Duke Croix (16544 in chips) 
Seat 8: MrOB1reader (14184 in chips) 
Duke Croix: posts small blind 50
MrOB1reader: posts big blind 100
MnnM150: posts small & big blinds 150
*** HOLE CARDS ***
Dealt to Duke Croix [6d 8s]
color_singleton: raises 200 to 300
MnnM150: calls 200
dhduncan: folds 
Duke Croix: folds 
MrOB1reader: calls 200
*** FLOP *** [Qh 4c As]
MrOB1reader: bets 945
color_singleton: folds 
MnnM150: calls 945
*** TURN *** [Qh 4c As] [3d]
MrOB1reader: bets 333
MnnM150: folds 
Uncalled bet (333) returned to MrOB1reader
MrOB1reader collected 2731 from pot
MrOB1reader: doesn't show hand 
*** SUMMARY ***
Total pot 2890 | Rake 159 
Board [Qh 4c As 3d]
Seat 1: color_singleton folded on the Flop
Seat 2: MnnM150 folded on the Turn
Seat 3: dhduncan (button) folded before Flop (didn't bet)
Seat 5: Duke Croix (small blind) folded before Flop
Seat 8: MrOB1reader (big blind) collected (2731)



PokerStars Home Game Hand #221066404515: {Club #3225207}  Hold'em No Limit (50/100) - 2020/12/03 17:22:24 ET
Table 'Winifred' 9-max (Play Money) Seat #5 is the button
Seat 1: color_singleton (32136 in chips) 
Seat 2: MnnM150 (10013 in chips) 
Seat 3: dhduncan (7810 in chips) 
Seat 5: Duke Croix (16494 in chips) 
Seat 8: MrOB1reader (15670 in chips) 
MrOB1reader: posts small blind 50
color_singleton: posts big blind 100
*** HOLE CARDS ***
Dealt to Duke Croix [Tc 6d]
MnnM150: calls 100
dhduncan: calls 100
Duke Croix: folds 
MrOB1reader: calls 50
color_singleton: checks 
*** FLOP *** [9c 9d 2s]
MrOB1reader: checks 
color_singleton: checks 
MnnM150: checks 
dhduncan: checks 
*** TURN *** [9c 9d 2s] [5c]
MrOB1reader: checks 
color_singleton: bets 189
MnnM150: calls 189
dhduncan: calls 189
MrOB1reader: calls 189
*** RIVER *** [9c 9d 2s 5c] [4s]
MrOB1reader: checks 
color_singleton: bets 546
MnnM150: folds 
dhduncan: folds 
MrOB1reader: folds 
Uncalled bet (546) returned to color_singleton
color_singleton collected 1092 from pot
color_singleton: doesn't show hand 
*** SUMMARY ***
Total pot 1156 | Rake 64 
Board [9c 9d 2s 5c 4s]
Seat 1: color_singleton (big blind) collected (1092)
Seat 2: MnnM150 folded on the River
Seat 3: dhduncan folded on the River
Seat 5: Duke Croix (button) folded before Flop (didn't bet)
Seat 8: MrOB1reader (small blind) folded on the River



PokerStars Home Game Hand #221066440430: {Club #3225207}  Hold'em No Limit (50/100) - 2020/12/03 17:23:20 ET
Table 'Winifred' 9-max (Play Money) Seat #8 is the button
Seat 1: color_singleton (32939 in chips) 
Seat 2: MnnM150 (9724 in chips) 
Seat 5: Duke Croix (16494 in chips) 
Seat 8: MrOB1reader (15381 in chips) 
color_singleton: posts small blind 50
MnnM150: posts big blind 100
*** HOLE CARDS ***
Dealt to Duke Croix [8c Tc]
Duke Croix: raises 200 to 300
MrOB1reader: folds 
color_singleton: folds 
MnnM150: folds 
Uncalled bet (200) returned to Duke Croix
Duke Croix collected 250 from pot
*** SUMMARY ***
Total pot 250 | Rake 0 
Seat 1: color_singleton (small blind) folded before Flop
Seat 2: MnnM150 (big blind) folded before Flop
Seat 5: Duke Croix collected (250)
Seat 8: MrOB1reader (button) folded before Flop (didn't bet)



PokerStars Home Game Hand #221066451095: {Club #3225207}  Hold'em No Limit (50/100) - 2020/12/03 17:23:36 ET
Table 'Winifred' 9-max (Play Money) Seat #1 is the button
Seat 1: color_singleton (32889 in chips) 
Seat 2: MnnM150 (9624 in chips) 
Seat 5: Duke Croix (16644 in chips) 
Seat 8: MrOB1reader (15381 in chips) 
MnnM150: posts small blind 50
Duke Croix: posts big blind 100
*** HOLE CARDS ***
Dealt to Duke Croix [4d Kd]
MrOB1reader: folds 
color_singleton: folds 
MnnM150: calls 50
Duke Croix: checks 
*** FLOP *** [Ad 6c 2d]
MnnM150: checks 
Duke Croix: bets 200
MnnM150: calls 200
*** TURN *** [Ad 6c 2d] [Kc]
MnnM150: checks 
Duke Croix: bets 400
MnnM150: folds 
Uncalled bet (400) returned to Duke Croix
Duke Croix collected 567 from pot
*** SUMMARY ***
Total pot 600 | Rake 33 
Board [Ad 6c 2d Kc]
Seat 1: color_singleton (button) folded before Flop (didn't bet)
Seat 2: MnnM150 (small blind) folded on the Turn
Seat 5: Duke Croix (big blind) collected (567)
Seat 8: MrOB1reader folded before Flop (didn't bet)



PokerStars Home Game Hand #221066472959: {Club #3225207}  Hold'em No Limit (50/100) - 2020/12/03 17:24:11 ET
Table 'Winifred' 9-max (Play Money) Seat #2 is the button
Seat 1: color_singleton (32889 in chips) 
Seat 2: MnnM150 (9324 in chips) 
Seat 5: Duke Croix (16911 in chips) 
Seat 8: MrOB1reader (15381 in chips) 
Duke Croix: posts small blind 50
MrOB1reader: posts big blind 100
*** HOLE CARDS ***
Dealt to Duke Croix [5d As]
color_singleton: raises 200 to 300
MnnM150: calls 300
Duke Croix: calls 250
MrOB1reader: raises 200 to 500
color_singleton: raises 200 to 700
MnnM150: calls 400
Duke Croix: folds 
MrOB1reader: raises 200 to 900
color_singleton: raises 1900 to 2800
MnnM150: folds 
MrOB1reader: calls 1900
*** FLOP *** [3s 2h 4h]
MrOB1reader: checks 
color_singleton: bets 6237
MrOB1reader: folds 
Uncalled bet (6237) returned to color_singleton
color_singleton collected 6237 from pot
color_singleton: doesn't show hand 
*** SUMMARY ***
Total pot 6600 | Rake 363 
Board [3s 2h 4h]
Seat 1: color_singleton collected (6237)
Seat 2: MnnM150 (button) folded before Flop
Seat 5: Duke Croix (small blind) folded before Flop
Seat 8: MrOB1reader (big blind) folded on the Flop



PokerStars Home Game Hand #221066521305: {Club #3225207}  Hold'em No Limit (50/100) - 2020/12/03 17:25:22 ET
Table 'Winifred' 9-max (Play Money) Seat #5 is the button
Seat 1: color_singleton (36326 in chips) 
Seat 2: MnnM150 (8624 in chips) 
Seat 3: dhduncan (7521 in chips) 
Seat 5: Duke Croix (16611 in chips) 
Seat 8: MrOB1reader (12581 in chips) 
MrOB1reader: posts small blind 50
color_singleton: posts big blind 100
dhduncan: posts small & big blinds 150
*** HOLE CARDS ***
Dealt to Duke Croix [4c As]
MnnM150: calls 100
dhduncan: checks 
Duke Croix: folds 
MrOB1reader: calls 50
color_singleton: checks 
*** FLOP *** [4h Ah 6d]
MrOB1reader: checks 
color_singleton: bets 212
MnnM150: folds 
dhduncan: calls 212
MrOB1reader: folds 
*** TURN *** [4h Ah 6d] [5d]
color_singleton: bets 413
dhduncan: calls 413
*** RIVER *** [4h Ah 6d 5d] [4d]
color_singleton: bets 803
dhduncan: calls 803
*** SHOW DOWN ***
color_singleton: shows [2c 3c] (a straight, Deuce to Six)
dhduncan: mucks hand 
color_singleton collected 3124 from pot
*** SUMMARY ***
Total pot 3306 | Rake 182 
Board [4h Ah 6d 5d 4d]
Seat 1: color_singleton (big blind) showed [2c 3c] and won (3124) with a straight, Deuce to Six
Seat 2: MnnM150 folded on the Flop
Seat 3: dhduncan mucked [Ac Jh]
Seat 5: Duke Croix (button) folded before Flop (didn't bet)
Seat 8: MrOB1reader (small blind) folded on the Flop



PokerStars Home Game Hand #221066546510: {Club #3225207}  Hold'em No Limit (50/100) - 2020/12/03 17:26:02 ET
Table 'Winifred' 9-max (Play Money) Seat #8 is the button
Seat 1: color_singleton (37922 in chips) 
Seat 2: MnnM150 (8524 in chips) 
Seat 3: dhduncan (5943 in chips) 
Seat 5: Duke Croix (16611 in chips) 
Seat 8: MrOB1reader (12481 in chips) 
color_singleton: posts small blind 50
MnnM150: posts big blind 100
*** HOLE CARDS ***
Dealt to Duke Croix [4c 9h]
dhduncan: calls 100
Duke Croix: folds 
MrOB1reader: calls 100
color_singleton: calls 50
MnnM150: checks 
*** FLOP *** [4s 2s Td]
color_singleton: checks 
MnnM150: bets 378
dhduncan: calls 378
MrOB1reader: calls 378
color_singleton: calls 378
*** TURN *** [4s 2s Td] [Kh]
color_singleton: checks 
MnnM150: checks 
dhduncan: checks 
MrOB1reader: checks 
*** RIVER *** [4s 2s Td Kh] [3c]
color_singleton: checks 
MnnM150: checks 
dhduncan: checks 
MrOB1reader: checks 
*** SHOW DOWN ***
color_singleton: shows [6c Ad] (high card Ace)
MnnM150: shows [2c Tc] (two pair, Tens and Deuces)
dhduncan: mucks hand 
MrOB1reader: mucks hand 
MnnM150 collected 1807 from pot
*** SUMMARY ***
Total pot 1912 | Rake 105 
Board [4s 2s Td Kh 3c]
Seat 1: color_singleton (small blind) showed [6c Ad] and lost with high card Ace
Seat 2: MnnM150 (big blind) showed [2c Tc] and won (1807) with two pair, Tens and Deuces
Seat 3: dhduncan mucked [Qh Ac]
Seat 5: Duke Croix folded before Flop (didn't bet)
Seat 8: MrOB1reader (button) mucked [9d 8h]



PokerStars Home Game Hand #221066574128: {Club #3225207}  Hold'em No Limit (50/100) - 2020/12/03 17:26:45 ET
Table 'Winifred' 9-max (Play Money) Seat #1 is the button
Seat 1: color_singleton (37444 in chips) 
Seat 2: MnnM150 (9853 in chips) 
Seat 3: dhduncan (5465 in chips) 
Seat 5: Duke Croix (16611 in chips) 
Seat 8: MrOB1reader (12003 in chips) 
MnnM150: posts small blind 50
dhduncan: posts big blind 100
*** HOLE CARDS ***
Dealt to Duke Croix [6c 6h]
Duke Croix: raises 300 to 400
MrOB1reader: folds 
color_singleton: calls 400
MnnM150: calls 350
dhduncan: folds 
*** FLOP *** [Ac Js Qd]
MnnM150: checks 
Duke Croix: checks 
color_singleton: bets 614
MnnM150: folds 
Duke Croix: folds 
Uncalled bet (614) returned to color_singleton
color_singleton collected 1228 from pot
color_singleton: doesn't show hand 
*** SUMMARY ***
Total pot 1300 | Rake 72 
Board [Ac Js Qd]
Seat 1: color_singleton (button) collected (1228)
Seat 2: MnnM150 (small blind) folded on the Flop
Seat 3: dhduncan (big blind) folded before Flop
Seat 5: Duke Croix folded on the Flop
Seat 8: MrOB1reader folded before Flop (didn't bet)



PokerStars Home Game Hand #221066609629: {Club #3225207}  Hold'em No Limit (50/100) - 2020/12/03 17:27:41 ET
Table 'Winifred' 9-max (Play Money) Seat #2 is the button
Seat 1: color_singleton (38272 in chips) 
Seat 2: MnnM150 (9453 in chips) 
Seat 3: dhduncan (5365 in chips) 
Seat 5: Duke Croix (16211 in chips) 
Seat 8: MrOB1reader (12003 in chips) 
dhduncan: posts small blind 50
Duke Croix: posts big blind 100
*** HOLE CARDS ***
Dealt to Duke Croix [Ac Qd]
MrOB1reader: calls 100
color_singleton: raises 100 to 200
MnnM150: folds 
dhduncan: folds 
Duke Croix: raises 300 to 500
MrOB1reader: folds 
color_singleton: calls 300
*** FLOP *** [Jd Qc Js]
Duke Croix: bets 600
color_singleton: calls 600
*** TURN *** [Jd Qc Js] [4c]
Duke Croix: bets 1100
color_singleton: calls 1100
*** RIVER *** [Jd Qc Js 4c] [Ks]
Duke Croix has timed out
Duke Croix: checks 
color_singleton: bets 2150
Duke Croix: folds 
Uncalled bet (2150) returned to color_singleton
color_singleton collected 4300 from pot
color_singleton: doesn't show hand 
*** SUMMARY ***
Total pot 4550 | Rake 250 
Board [Jd Qc Js 4c Ks]
Seat 1: color_singleton collected (4300)
Seat 2: MnnM150 (button) folded before Flop (didn't bet)
Seat 3: dhduncan (small blind) folded before Flop
Seat 5: Duke Croix (big blind) folded on the River
Seat 8: MrOB1reader folded before Flop



PokerStars Home Game Hand #221066668904: {Club #3225207}  Hold'em No Limit (50/100) - 2020/12/03 17:29:16 ET
Table 'Winifred' 9-max (Play Money) Seat #3 is the button
Seat 1: color_singleton (40372 in chips) 
Seat 2: MnnM150 (9453 in chips) 
Seat 3: dhduncan (5315 in chips) 
Seat 5: Duke Croix (14011 in chips) 
Seat 8: MrOB1reader (11903 in chips) 
Duke Croix: posts small blind 50
MrOB1reader: posts big blind 100
*** HOLE CARDS ***
Dealt to Duke Croix [Tc 2h]
color_singleton: raises 200 to 300
MnnM150: folds 
dhduncan: calls 300
Duke Croix: folds 
MrOB1reader: calls 200
*** FLOP *** [3s 4d Qh]
MrOB1reader: bets 449
color_singleton: folds 
dhduncan: raises 449 to 898
MrOB1reader: calls 449
*** TURN *** [3s 4d Qh] [Qs]
MrOB1reader: checks 
dhduncan: bets 100
MrOB1reader: calls 100
*** RIVER *** [3s 4d Qh Qs] [Td]
MrOB1reader: checks 
dhduncan: bets 1000
MrOB1reader: raises 1000 to 2000
dhduncan: calls 1000
*** SHOW DOWN ***
MrOB1reader: shows [9h Qc] (three of a kind, Queens)
dhduncan: shows [Ks Qd] (three of a kind, Queens - King kicker)
dhduncan collected 6564 from pot
*** SUMMARY ***
Total pot 6946 | Rake 382 
Board [3s 4d Qh Qs Td]
Seat 1: color_singleton folded on the Flop
Seat 2: MnnM150 folded before Flop (didn't bet)
Seat 3: dhduncan (button) showed [Ks Qd] and won (6564) with three of a kind, Queens
Seat 5: Duke Croix (small blind) folded before Flop
Seat 8: MrOB1reader (big blind) showed [9h Qc] and lost with three of a kind, Queens



PokerStars Home Game Hand #221066700323: {Club #3225207}  Hold'em No Limit (50/100) - 2020/12/03 17:30:06 ET
Table 'Winifred' 9-max (Play Money) Seat #5 is the button
Seat 1: color_singleton (40072 in chips) 
Seat 2: MnnM150 (9453 in chips) 
Seat 3: dhduncan (8581 in chips) 
Seat 5: Duke Croix (13961 in chips) 
Seat 8: MrOB1reader (8605 in chips) 
MrOB1reader: posts small blind 50
color_singleton: posts big blind 100
*** HOLE CARDS ***
Dealt to Duke Croix [2d 4c]
MnnM150: calls 100
dhduncan: calls 100
Duke Croix: folds 
MrOB1reader: raises 100 to 200
color_singleton: calls 100
MnnM150: calls 100
dhduncan: calls 100
*** FLOP *** [As 6c Kh]
MrOB1reader: checks 
color_singleton: checks 
MnnM150: checks 
dhduncan: checks 
*** TURN *** [As 6c Kh] [5d]
MrOB1reader: checks 
color_singleton: bets 378
MnnM150: folds 
dhduncan: folds 
MrOB1reader: folds 
Uncalled bet (378) returned to color_singleton
color_singleton collected 756 from pot
color_singleton: doesn't show hand 
*** SUMMARY ***
Total pot 800 | Rake 44 
Board [As 6c Kh 5d]
Seat 1: color_singleton (big blind) collected (756)
Seat 2: MnnM150 folded on the Turn
Seat 3: dhduncan folded on the Turn
Seat 5: Duke Croix (button) folded before Flop (didn't bet)
Seat 8: MrOB1reader (small blind) folded on the Turn



PokerStars Home Game Hand #221066737650: {Club #3225207}  Hold'em No Limit (50/100) - 2020/12/03 17:31:06 ET
Table 'Winifred' 9-max (Play Money) Seat #8 is the button
Seat 1: color_singleton (40628 in chips) 
Seat 2: MnnM150 (9253 in chips) 
Seat 3: dhduncan (8381 in chips) 
Seat 5: Duke Croix (13961 in chips) 
Seat 8: MrOB1reader (8405 in chips) 
color_singleton: posts small blind 50
MnnM150: posts big blind 100
*** HOLE CARDS ***
Dealt to Duke Croix [3c Qc]
dhduncan: folds 
Duke Croix: folds 
MrOB1reader: calls 100
color_singleton: calls 50
MnnM150: checks 
*** FLOP *** [Ah Qs 9h]
color_singleton: checks 
MnnM150: checks 
MrOB1reader: checks 
*** TURN *** [Ah Qs 9h] [Tc]
color_singleton: checks 
MnnM150: checks 
MrOB1reader: checks 
*** RIVER *** [Ah Qs 9h Tc] [6s]
color_singleton: checks 
MnnM150: bets 141
MrOB1reader: folds 
color_singleton: folds 
Uncalled bet (141) returned to MnnM150
MnnM150 collected 283 from pot
*** SUMMARY ***
Total pot 300 | Rake 17 
Board [Ah Qs 9h Tc 6s]
Seat 1: color_singleton (small blind) folded on the River
Seat 2: MnnM150 (big blind) collected (283)
Seat 3: dhduncan folded before Flop (didn't bet)
Seat 5: Duke Croix folded before Flop (didn't bet)
Seat 8: MrOB1reader (button) folded on the River



PokerStars Home Game Hand #221066764626: {Club #3225207}  Hold'em No Limit (50/100) - 2020/12/03 17:31:49 ET
Table 'Winifred' 9-max (Play Money) Seat #1 is the button
Seat 1: color_singleton (40528 in chips) 
Seat 2: MnnM150 (9436 in chips) 
Seat 3: dhduncan (8381 in chips) 
Seat 5: Duke Croix (13961 in chips) 
Seat 8: MrOB1reader (8305 in chips) 
MnnM150: posts small blind 50
dhduncan: posts big blind 100
*** HOLE CARDS ***
Dealt to Duke Croix [4s 8s]
Duke Croix: folds 
MrOB1reader: calls 100
color_singleton: folds 
MnnM150: calls 50
dhduncan: checks 
*** FLOP *** [4h 4d 7h]
MnnM150: checks 
dhduncan: bets 100
MrOB1reader: folds 
MnnM150: calls 100
*** TURN *** [4h 4d 7h] [8d]
MnnM150: checks 
dhduncan: bets 472
MnnM150: calls 472
*** RIVER *** [4h 4d 7h 8d] [Kc]
MnnM150: checks 
dhduncan: checks 
*** SHOW DOWN ***
MnnM150: shows [7s Jd] (two pair, Sevens and Fours)
dhduncan: shows [5h 8h] (two pair, Eights and Fours)
dhduncan collected 1365 from pot
*** SUMMARY ***
Total pot 1444 | Rake 79 
Board [4h 4d 7h 8d Kc]
Seat 1: color_singleton (button) folded before Flop (didn't bet)
Seat 2: MnnM150 (small blind) showed [7s Jd] and lost with two pair, Sevens and Fours
Seat 3: dhduncan (big blind) showed [5h 8h] and won (1365) with two pair, Eights and Fours
Seat 5: Duke Croix folded before Flop (didn't bet)
Seat 8: MrOB1reader folded on the Flop



PokerStars Home Game Hand #221066783050: {Club #3225207}  Hold'em No Limit (50/100) - 2020/12/03 17:32:19 ET
Table 'Winifred' 9-max (Play Money) Seat #2 is the button
Seat 1: color_singleton (40528 in chips) 
Seat 2: MnnM150 (8764 in chips) 
Seat 3: dhduncan (9074 in chips) 
Seat 5: Duke Croix (13961 in chips) 
Seat 8: MrOB1reader (8205 in chips) 
dhduncan: posts small blind 50
Duke Croix: posts big blind 100
*** HOLE CARDS ***
Dealt to Duke Croix [Th 7c]
MrOB1reader: raises 100 to 200
color_singleton: folds 
MnnM150: calls 200
dhduncan: calls 150
Duke Croix: calls 100
*** FLOP *** [8h Ah 4c]
dhduncan: checks 
Duke Croix: checks 
MrOB1reader: checks 
MnnM150: checks 
*** TURN *** [8h Ah 4c] [Kc]
dhduncan: bets 756
Duke Croix: folds 
MrOB1reader: folds 
MnnM150: calls 756
*** RIVER *** [8h Ah 4c Kc] [5c]
dhduncan: checks 
MnnM150: checks 
*** SHOW DOWN ***
dhduncan: shows [Tc Ks] (a pair of Kings)
MnnM150: mucks hand 
dhduncan collected 2185 from pot
*** SUMMARY ***
Total pot 2312 | Rake 127 
Board [8h Ah 4c Kc 5c]
Seat 1: color_singleton folded before Flop (didn't bet)
Seat 2: MnnM150 (button) mucked [9d Kd]
Seat 3: dhduncan (small blind) showed [Tc Ks] and won (2185) with a pair of Kings
Seat 5: Duke Croix (big blind) folded on the Turn
Seat 8: MrOB1reader folded on the Turn



PokerStars Home Game Hand #221066814522: {Club #3225207}  Hold'em No Limit (50/100) - 2020/12/03 17:33:02 ET
Table 'Winifred' 9-max (Play Money) Seat #3 is the button
Seat 1: color_singleton (40528 in chips) 
Seat 2: MnnM150 (7808 in chips) 
Seat 3: dhduncan (10303 in chips) 
Seat 5: Duke Croix (13761 in chips) 
Seat 8: MrOB1reader (8005 in chips) 
Duke Croix: posts small blind 50
MrOB1reader: posts big blind 100
*** HOLE CARDS ***
Dealt to Duke Croix [9d 4h]
color_singleton: raises 100 to 200
MnnM150: calls 200
dhduncan: calls 200
Duke Croix: folds 
MrOB1reader: calls 100
*** FLOP *** [5h Ts Qh]
MrOB1reader: bets 803
color_singleton: folds 
MnnM150: calls 803
dhduncan: folds 
*** TURN *** [5h Ts Qh] [8s]
MrOB1reader: bets 2321
MnnM150: folds 
Uncalled bet (2321) returned to MrOB1reader
MrOB1reader collected 2321 from pot
MrOB1reader: doesn't show hand 
*** SUMMARY ***
Total pot 2456 | Rake 135 
Board [5h Ts Qh 8s]
Seat 1: color_singleton folded on the Flop
Seat 2: MnnM150 folded on the Turn
Seat 3: dhduncan (button) folded on the Flop
Seat 5: Duke Croix (small blind) folded before Flop
Seat 8: MrOB1reader (big blind) collected (2321)



PokerStars Home Game Hand #221066830242: {Club #3225207}  Hold'em No Limit (50/100) - 2020/12/03 17:33:27 ET
Table 'Winifred' 9-max (Play Money) Seat #5 is the button
Seat 1: color_singleton (40328 in chips) 
Seat 2: MnnM150 (6805 in chips) 
Seat 3: dhduncan (10103 in chips) 
Seat 5: Duke Croix (13711 in chips) 
Seat 8: MrOB1reader (9323 in chips) 
MrOB1reader: posts small blind 50
color_singleton: posts big blind 100
*** HOLE CARDS ***
Dealt to Duke Croix [6d Tc]
MnnM150: folds 
dhduncan: calls 100
Duke Croix: folds 
MrOB1reader: calls 50
color_singleton: checks 
*** FLOP *** [Jd Kd 2s]
MrOB1reader: checks 
color_singleton: bets 141
dhduncan: folds 
MrOB1reader: calls 141
*** TURN *** [Jd Kd 2s] [9c]
MrOB1reader: bets 275
color_singleton: calls 275
*** RIVER *** [Jd Kd 2s 9c] [6s]
MrOB1reader: bets 535
color_singleton: calls 535
*** SHOW DOWN ***
MrOB1reader: shows [8c Th] (high card King)
color_singleton: shows [Kc 4h] (a pair of Kings)
color_singleton collected 2081 from pot
*** SUMMARY ***
Total pot 2202 | Rake 121 
Board [Jd Kd 2s 9c 6s]
Seat 1: color_singleton (big blind) showed [Kc 4h] and won (2081) with a pair of Kings
Seat 2: MnnM150 folded before Flop (didn't bet)
Seat 3: dhduncan folded on the Flop
Seat 5: Duke Croix (button) folded before Flop (didn't bet)
Seat 8: MrOB1reader (small blind) showed [8c Th] and lost with high card King



PokerStars Home Game Hand #221066856236: {Club #3225207}  Hold'em No Limit (50/100) - 2020/12/03 17:34:10 ET
Table 'Winifred' 9-max (Play Money) Seat #8 is the button
Seat 1: color_singleton (41358 in chips) 
Seat 2: MnnM150 (6805 in chips) 
Seat 3: dhduncan (10003 in chips) 
Seat 5: Duke Croix (13711 in chips) 
Seat 8: MrOB1reader (8272 in chips) 
color_singleton: posts small blind 50
MnnM150: posts big blind 100
*** HOLE CARDS ***
Dealt to Duke Croix [6c Kc]
dhduncan: folds 
Duke Croix: calls 100
MrOB1reader: raises 100 to 200
color_singleton: calls 150
MnnM150: raises 100 to 300
Duke Croix: calls 200
MrOB1reader: calls 100
color_singleton: calls 100
*** FLOP *** [8d Ad 7c]
color_singleton: checks 
MnnM150: bets 567
Duke Croix: folds 
MrOB1reader: raises 567 to 1134
color_singleton: folds 
MnnM150: calls 567
*** TURN *** [8d Ad 7c] [5h]
MnnM150: checks 
MrOB1reader: bets 600
MnnM150: calls 600
*** RIVER *** [8d Ad 7c 5h] [Td]
MnnM150: checks 
MrOB1reader: bets 2205
MnnM150: calls 2205
*** SHOW DOWN ***
MrOB1reader: shows [As Jh] (a pair of Aces)
MnnM150: shows [Ah Kh] (a pair of Aces - King kicker)
MnnM150 collected 8579 from pot
*** SUMMARY ***
Total pot 9078 | Rake 499 
Board [8d Ad 7c 5h Td]
Seat 1: color_singleton (small blind) folded on the Flop
Seat 2: MnnM150 (big blind) showed [Ah Kh] and won (8579) with a pair of Aces
Seat 3: dhduncan folded before Flop (didn't bet)
Seat 5: Duke Croix folded on the Flop
Seat 8: MrOB1reader (button) showed [As Jh] and lost with a pair of Aces



PokerStars Home Game Hand #221066886979: {Club #3225207}  Hold'em No Limit (50/100) - 2020/12/03 17:34:59 ET
Table 'Winifred' 9-max (Play Money) Seat #1 is the button
Seat 1: color_singleton (41058 in chips) 
Seat 2: MnnM150 (11145 in chips) 
Seat 3: dhduncan (10003 in chips) 
Seat 5: Duke Croix (13411 in chips) 
Seat 8: MrOB1reader (4033 in chips) 
MnnM150: posts small blind 50
dhduncan: posts big blind 100
*** HOLE CARDS ***
Dealt to Duke Croix [2c 4s]
Duke Croix has timed out
Duke Croix: folds 
MrOB1reader: calls 100
color_singleton: raises 100 to 200
MnnM150: calls 150
dhduncan: calls 100
MrOB1reader: calls 100
*** FLOP *** [2d Ac Kc]
MnnM150: checks 
dhduncan: checks 
MrOB1reader: bets 322
color_singleton: calls 322
MnnM150: folds 
dhduncan: calls 322
*** TURN *** [2d Ac Kc] [8h]
dhduncan: bets 100
MrOB1reader: calls 100
color_singleton: calls 100
*** RIVER *** [2d Ac Kc 8h] [8c]
dhduncan: checks 
MrOB1reader: bets 976
color_singleton: calls 976
dhduncan: folds 
*** SHOW DOWN ***
MrOB1reader: shows [6c 3c] (a flush, Ace high)
color_singleton: mucks hand 
MrOB1reader collected 3797 from pot
*** SUMMARY ***
Total pot 4018 | Rake 221 
Board [2d Ac Kc 8h 8c]
Seat 1: color_singleton (button) mucked [4c Ah]
Seat 2: MnnM150 (small blind) folded on the Flop
Seat 3: dhduncan (big blind) folded on the River
Seat 5: Duke Croix folded before Flop (didn't bet)
Seat 8: MrOB1reader showed [6c 3c] and won (3797) with a flush, Ace high



PokerStars Home Game Hand #221066932417: {Club #3225207}  Hold'em No Limit (50/100) - 2020/12/03 17:36:13 ET
Table 'Winifred' 9-max (Play Money) Seat #2 is the button
Seat 1: color_singleton (39460 in chips) 
Seat 2: MnnM150 (10945 in chips) 
Seat 3: dhduncan (9381 in chips) 
Seat 5: Duke Croix (13411 in chips) 
Seat 8: MrOB1reader (6232 in chips) 
dhduncan: posts small blind 50
Duke Croix: posts big blind 100
*** HOLE CARDS ***
Dealt to Duke Croix [Ks 6s]
MrOB1reader: raises 300 to 400
color_singleton: folds 
MnnM150: calls 400
dhduncan: calls 350
Duke Croix: calls 300
*** FLOP *** [2c 7h 9s]
dhduncan: checks 
Duke Croix: checks 
MrOB1reader: bets 400
MnnM150: folds 
dhduncan: calls 400
Duke Croix: folds 
*** TURN *** [2c 7h 9s] [Js]
dhduncan: checks 
MrOB1reader: bets 1134
dhduncan: folds 
Uncalled bet (1134) returned to MrOB1reader
MrOB1reader collected 2268 from pot
MrOB1reader: doesn't show hand 
*** SUMMARY ***
Total pot 2400 | Rake 132 
Board [2c 7h 9s Js]
Seat 1: color_singleton folded before Flop (didn't bet)
Seat 2: MnnM150 (button) folded on the Flop
Seat 3: dhduncan (small blind) folded on the Turn
Seat 5: Duke Croix (big blind) folded on the Flop
Seat 8: MrOB1reader collected (2268)



PokerStars Home Game Hand #221066961125: {Club #3225207}  Hold'em No Limit (50/100) - 2020/12/03 17:37:00 ET
Table 'Winifred' 9-max (Play Money) Seat #3 is the button
Seat 1: color_singleton (39460 in chips) 
Seat 2: MnnM150 (10545 in chips) 
Seat 3: dhduncan (8581 in chips) 
Seat 5: Duke Croix (13011 in chips) 
Seat 8: MrOB1reader (7700 in chips) 
Duke Croix: posts small blind 50
MrOB1reader: posts big blind 100
*** HOLE CARDS ***
Dealt to Duke Croix [9c Js]
color_singleton: raises 200 to 300
MnnM150: folds 
dhduncan: calls 300
Duke Croix: calls 250
MrOB1reader: calls 200
*** FLOP *** [Qc 5c 3c]
Duke Croix: checks 
MrOB1reader: checks 
color_singleton: bets 567
dhduncan: folds 
Duke Croix: folds 
MrOB1reader: folds 
Uncalled bet (567) returned to color_singleton
color_singleton collected 1134 from pot
color_singleton: doesn't show hand 
*** SUMMARY ***
Total pot 1200 | Rake 66 
Board [Qc 5c 3c]
Seat 1: color_singleton collected (1134)
Seat 2: MnnM150 folded before Flop (didn't bet)
Seat 3: dhduncan (button) folded on the Flop
Seat 5: Duke Croix (small blind) folded on the Flop
Seat 8: MrOB1reader (big blind) folded on the Flop



PokerStars Home Game Hand #221066979620: {Club #3225207}  Hold'em No Limit (50/100) - 2020/12/03 17:37:30 ET
Table 'Winifred' 9-max (Play Money) Seat #5 is the button
Seat 1: color_singleton (40294 in chips) 
Seat 2: MnnM150 (10545 in chips) 
Seat 3: dhduncan (8281 in chips) 
Seat 5: Duke Croix (12711 in chips) 
Seat 8: MrOB1reader (7400 in chips) 
MrOB1reader: posts small blind 50
color_singleton: posts big blind 100
*** HOLE CARDS ***
Dealt to Duke Croix [Tc 9s]
MnnM150: folds 
dhduncan: folds 
Duke Croix: calls 100
MrOB1reader: calls 50
color_singleton: raises 300 to 400
Duke Croix: calls 300
MrOB1reader: calls 300
*** FLOP *** [2d 2s 8s]
MrOB1reader: bets 567
color_singleton: calls 567
Duke Croix: folds 
*** TURN *** [2d 2s 8s] [3h]
MrOB1reader: bets 1103
color_singleton: folds 
Uncalled bet (1103) returned to MrOB1reader
MrOB1reader collected 2206 from pot
MrOB1reader: doesn't show hand 
*** SUMMARY ***
Total pot 2334 | Rake 128 
Board [2d 2s 8s 3h]
Seat 1: color_singleton (big blind) folded on the Turn
Seat 2: MnnM150 folded before Flop (didn't bet)
Seat 3: dhduncan folded before Flop (didn't bet)
Seat 5: Duke Croix (button) folded on the Flop
Seat 8: MrOB1reader (small blind) collected (2206)



PokerStars Home Game Hand #221067003372: {Club #3225207}  Hold'em No Limit (50/100) - 2020/12/03 17:38:09 ET
Table 'Winifred' 9-max (Play Money) Seat #8 is the button
Seat 1: color_singleton (39327 in chips) 
Seat 2: MnnM150 (10545 in chips) 
Seat 3: dhduncan (8281 in chips) 
Seat 5: Duke Croix (12311 in chips) 
Seat 8: MrOB1reader (8639 in chips) 
color_singleton: posts small blind 50
MnnM150: posts big blind 100
*** HOLE CARDS ***
Dealt to Duke Croix [5h Tc]
dhduncan: calls 100
Duke Croix: folds 
MrOB1reader: calls 100
color_singleton: calls 50
MnnM150: raises 100 to 200
dhduncan: calls 100
MrOB1reader: calls 100
color_singleton: calls 100
*** FLOP *** [5c Ac 9c]
color_singleton: checks 
MnnM150: checks 
dhduncan: checks 
MrOB1reader: checks 
*** TURN *** [5c Ac 9c] [8h]
color_singleton: checks 
MnnM150: checks 
dhduncan: checks 
MrOB1reader: bets 378
color_singleton: folds 
MnnM150: calls 378
dhduncan: folds 
*** RIVER *** [5c Ac 9c 8h] [8c]
MnnM150: checks 
MrOB1reader: checks 
*** SHOW DOWN ***
MnnM150: shows [Qc Ks] (a flush, Ace high)
MrOB1reader: mucks hand 
MnnM150 collected 1470 from pot
*** SUMMARY ***
Total pot 1556 | Rake 86 
Board [5c Ac 9c 8h 8c]
Seat 1: color_singleton (small blind) folded on the Turn
Seat 2: MnnM150 (big blind) showed [Qc Ks] and won (1470) with a flush, Ace high
Seat 3: dhduncan folded on the Turn
Seat 5: Duke Croix folded before Flop (didn't bet)
Seat 8: MrOB1reader (button) mucked [3s Jd]



PokerStars Home Game Hand #221067033099: {Club #3225207}  Hold'em No Limit (50/100) - 2020/12/03 17:38:57 ET
Table 'Winifred' 9-max (Play Money) Seat #1 is the button
Seat 1: color_singleton (39127 in chips) 
Seat 2: MnnM150 (11437 in chips) 
Seat 3: dhduncan (8081 in chips) 
Seat 5: Duke Croix (12311 in chips) 
Seat 8: MrOB1reader (8061 in chips) 
MnnM150: posts small blind 50
dhduncan: posts big blind 100
*** HOLE CARDS ***
Dealt to Duke Croix [Ks 5c]
Duke Croix: folds 
MrOB1reader: raises 100 to 200
color_singleton: calls 200
MnnM150: calls 150
dhduncan: calls 100
*** FLOP *** [Jh 2s Tc]
MnnM150: checks 
dhduncan: bets 100
MrOB1reader: calls 100
color_singleton: calls 100
MnnM150: calls 100
*** TURN *** [Jh 2s Tc] [7d]
MnnM150: checks 
dhduncan: checks 
MrOB1reader: checks 
color_singleton: checks 
*** RIVER *** [Jh 2s Tc 7d] [Jd]
MnnM150: bets 567
dhduncan: folds 
MrOB1reader: folds 
color_singleton: calls 567
*** SHOW DOWN ***
MnnM150: shows [6c 7c] (two pair, Jacks and Sevens)
color_singleton: shows [Ad 7s] (two pair, Jacks and Sevens - Ace kicker)
color_singleton collected 2206 from pot
*** SUMMARY ***
Total pot 2334 | Rake 128 
Board [Jh 2s Tc 7d Jd]
Seat 1: color_singleton (button) showed [Ad 7s] and won (2206) with two pair, Jacks and Sevens
Seat 2: MnnM150 (small blind) showed [6c 7c] and lost with two pair, Jacks and Sevens
Seat 3: dhduncan (big blind) folded on the River
Seat 5: Duke Croix folded before Flop (didn't bet)
Seat 8: MrOB1reader folded on the River



PokerStars Home Game Hand #221067057099: {Club #3225207}  Hold'em No Limit (50/100) - 2020/12/03 17:39:36 ET
Table 'Winifred' 9-max (Play Money) Seat #2 is the button
Seat 1: color_singleton (40466 in chips) 
Seat 2: MnnM150 (10570 in chips) 
Seat 3: dhduncan (7781 in chips) 
Seat 5: Duke Croix (12311 in chips) 
Seat 8: MrOB1reader (7761 in chips) 
dhduncan: posts small blind 50
Duke Croix: posts big blind 100
*** HOLE CARDS ***
Dealt to Duke Croix [Qc 4h]
MrOB1reader: calls 100
color_singleton: folds 
MnnM150: folds 
dhduncan: calls 50
Duke Croix: checks 
*** FLOP *** [Jc 4d 7d]
dhduncan: checks 
Duke Croix: checks 
MrOB1reader: checks 
*** TURN *** [Jc 4d 7d] [Ks]
dhduncan: bets 100
Duke Croix: calls 100
MrOB1reader: folds 
*** RIVER *** [Jc 4d 7d Ks] [5s]
dhduncan: bets 472
Duke Croix: folds 
Uncalled bet (472) returned to dhduncan
dhduncan collected 472 from pot
dhduncan: doesn't show hand 
*** SUMMARY ***
Total pot 500 | Rake 28 
Board [Jc 4d 7d Ks 5s]
Seat 1: color_singleton folded before Flop (didn't bet)
Seat 2: MnnM150 (button) folded before Flop (didn't bet)
Seat 3: dhduncan (small blind) collected (472)
Seat 5: Duke Croix (big blind) folded on the River
Seat 8: MrOB1reader folded on the Turn



PokerStars Home Game Hand #221067081679: {Club #3225207}  Hold'em No Limit (50/100) - 2020/12/03 17:40:17 ET
Table 'Winifred' 9-max (Play Money) Seat #3 is the button
Seat 1: color_singleton (40466 in chips) 
Seat 2: MnnM150 (10570 in chips) 
Seat 3: dhduncan (8053 in chips) 
Seat 5: Duke Croix (12111 in chips) 
Seat 8: MrOB1reader (7661 in chips) 
Duke Croix: posts small blind 50
MrOB1reader: posts big blind 100
*** HOLE CARDS ***
Dealt to Duke Croix [Kh Qh]
color_singleton: raises 200 to 300
MnnM150: folds 
dhduncan: calls 300
Duke Croix: raises 400 to 700
MrOB1reader: calls 600
color_singleton: calls 400
dhduncan: calls 400
*** FLOP *** [3c 6s Ad]
Duke Croix: checks 
MrOB1reader: checks 
color_singleton: checks 
dhduncan: bets 100
Duke Croix: folds 
MrOB1reader: calls 100
color_singleton: calls 100
*** TURN *** [3c 6s Ad] [Ac]
MrOB1reader: checks 
color_singleton: checks 
dhduncan: checks 
*** RIVER *** [3c 6s Ad Ac] [Tc]
MrOB1reader: checks 
color_singleton: checks 
dhduncan: checks 
*** SHOW DOWN ***
MrOB1reader: shows [4s 9s] (a pair of Aces)
color_singleton: shows [Jd Jh] (two pair, Aces and Jacks)
dhduncan: mucks hand 
color_singleton collected 2929 from pot
*** SUMMARY ***
Total pot 3100 | Rake 171 
Board [3c 6s Ad Ac Tc]
Seat 1: color_singleton showed [Jd Jh] and won (2929) with two pair, Aces and Jacks
Seat 2: MnnM150 folded before Flop (didn't bet)
Seat 3: dhduncan (button) mucked [Kc Qs]
Seat 5: Duke Croix (small blind) folded on the Flop
Seat 8: MrOB1reader (big blind) showed [4s 9s] and lost with a pair of Aces



PokerStars Home Game Hand #221067113080: {Club #3225207}  Hold'em No Limit (50/100) - 2020/12/03 17:41:08 ET
Table 'Winifred' 9-max (Play Money) Seat #5 is the button
Seat 1: color_singleton (42595 in chips) 
Seat 2: MnnM150 (10570 in chips) 
Seat 3: dhduncan (7253 in chips) 
Seat 5: Duke Croix (11411 in chips) 
Seat 8: MrOB1reader (6861 in chips) 
MrOB1reader: posts small blind 50
color_singleton: posts big blind 100
*** HOLE CARDS ***
Dealt to Duke Croix [Kc 6d]
MnnM150: calls 100
dhduncan: calls 100
Duke Croix: folds 
MrOB1reader: calls 50
color_singleton: checks 
*** FLOP *** [5s Js 8d]
MrOB1reader: bets 100
color_singleton: calls 100
MnnM150: calls 100
dhduncan: calls 100
*** TURN *** [5s Js 8d] [4d]
MrOB1reader: checks 
color_singleton: checks 
MnnM150: checks 
dhduncan: checks 
*** RIVER *** [5s Js 8d 4d] [6c]
MrOB1reader: checks 
color_singleton: checks 
MnnM150: bets 378
dhduncan: folds 
MrOB1reader: folds 
color_singleton: calls 378
*** SHOW DOWN ***
MnnM150: shows [3c 5c] (a pair of Fives)
color_singleton: shows [Kh 6h] (a pair of Sixes)
color_singleton collected 1470 from pot
*** SUMMARY ***
Total pot 1556 | Rake 86 
Board [5s Js 8d 4d 6c]
Seat 1: color_singleton (big blind) showed [Kh 6h] and won (1470) with a pair of Sixes
Seat 2: MnnM150 showed [3c 5c] and lost with a pair of Fives
Seat 3: dhduncan folded on the River
Seat 5: Duke Croix (button) folded before Flop (didn't bet)
Seat 8: MrOB1reader (small blind) folded on the River



PokerStars Home Game Hand #221067137233: {Club #3225207}  Hold'em No Limit (50/100) - 2020/12/03 17:41:48 ET
Table 'Winifred' 9-max (Play Money) Seat #8 is the button
Seat 1: color_singleton (43487 in chips) 
Seat 2: MnnM150 (9992 in chips) 
Seat 3: dhduncan (7053 in chips) 
Seat 5: Duke Croix (11411 in chips) 
Seat 8: MrOB1reader (6661 in chips) 
color_singleton: posts small blind 50
MnnM150: posts big blind 100
*** HOLE CARDS ***
Dealt to Duke Croix [2h Jc]
dhduncan: calls 100
Duke Croix: folds 
MrOB1reader: calls 100
color_singleton: raises 200 to 300
MnnM150: folds 
dhduncan: folds 
MrOB1reader: calls 200
*** FLOP *** [7c 6s Jd]
color_singleton: checks 
MrOB1reader: bets 100
color_singleton: calls 100
*** TURN *** [7c 6s Jd] [9s]
color_singleton: checks 
MrOB1reader: bets 100
color_singleton: calls 100
*** RIVER *** [7c 6s Jd 9s] [9d]
color_singleton: checks 
MrOB1reader: checks 
*** SHOW DOWN ***
color_singleton: shows [Td Kc] (a pair of Nines)
MrOB1reader: shows [6d Qs] (two pair, Nines and Sixes)
MrOB1reader collected 1134 from pot
*** SUMMARY ***
Total pot 1200 | Rake 66 
Board [7c 6s Jd 9s 9d]
Seat 1: color_singleton (small blind) showed [Td Kc] and lost with a pair of Nines
Seat 2: MnnM150 (big blind) folded before Flop
Seat 3: dhduncan folded before Flop
Seat 5: Duke Croix folded before Flop (didn't bet)
Seat 8: MrOB1reader (button) showed [6d Qs] and won (1134) with two pair, Nines and Sixes



PokerStars Home Game Hand #221067164603: {Club #3225207}  Hold'em No Limit (50/100) - 2020/12/03 17:42:34 ET
Table 'Winifred' 9-max (Play Money) Seat #1 is the button
Seat 1: color_singleton (42987 in chips) 
Seat 2: MnnM150 (9892 in chips) 
Seat 3: dhduncan (6953 in chips) 
Seat 5: Duke Croix (11411 in chips) 
Seat 8: MrOB1reader (7295 in chips) 
MnnM150: posts small blind 50
dhduncan: posts big blind 100
*** HOLE CARDS ***
Dealt to Duke Croix [7d 8h]
Duke Croix: calls 100
MrOB1reader: raises 100 to 200
color_singleton: folds 
MnnM150: calls 150
dhduncan: folds 
Duke Croix: calls 100
*** FLOP *** [2s 9h 3d]
MnnM150: checks 
Duke Croix: checks 
MrOB1reader: bets 661
MnnM150: calls 661
Duke Croix: folds 
*** TURN *** [2s 9h 3d] [8d]
MnnM150: checks 
MrOB1reader: bets 955
MnnM150: folds 
Uncalled bet (955) returned to MrOB1reader
MrOB1reader collected 1911 from pot
MrOB1reader: doesn't show hand 
*** SUMMARY ***
Total pot 2022 | Rake 111 
Board [2s 9h 3d 8d]
Seat 1: color_singleton (button) folded before Flop (didn't bet)
Seat 2: MnnM150 (small blind) folded on the Turn
Seat 3: dhduncan (big blind) folded before Flop
Seat 5: Duke Croix folded on the Flop
Seat 8: MrOB1reader collected (1911)



PokerStars Home Game Hand #221067187185: {Club #3225207}  Hold'em No Limit (50/100) - 2020/12/03 17:43:11 ET
Table 'Winifred' 9-max (Play Money) Seat #2 is the button
Seat 1: color_singleton (42987 in chips) 
Seat 2: MnnM150 (9031 in chips) 
Seat 3: dhduncan (6853 in chips) 
Seat 5: Duke Croix (11211 in chips) 
Seat 8: MrOB1reader (8345 in chips) 
dhduncan: posts small blind 50
Duke Croix: posts big blind 100
*** HOLE CARDS ***
Dealt to Duke Croix [3s Qc]
MrOB1reader: calls 100
color_singleton: raises 100 to 200
MnnM150: calls 200
dhduncan: calls 150
Duke Croix: folds 
MrOB1reader: calls 100
*** FLOP *** [Kh 3d Jh]
dhduncan: checks 
MrOB1reader: checks 
color_singleton: bets 425
MnnM150: calls 425
dhduncan: folds 
MrOB1reader: folds 
*** TURN *** [Kh 3d Jh] [4h]
color_singleton: bets 827
MnnM150: folds 
Uncalled bet (827) returned to color_singleton
color_singleton collected 1654 from pot
color_singleton: doesn't show hand 
*** SUMMARY ***
Total pot 1750 | Rake 96 
Board [Kh 3d Jh 4h]
Seat 1: color_singleton collected (1654)
Seat 2: MnnM150 (button) folded on the Turn
Seat 3: dhduncan (small blind) folded on the Flop
Seat 5: Duke Croix (big blind) folded before Flop
Seat 8: MrOB1reader folded on the Flop



PokerStars Home Game Hand #221067210528: {Club #3225207}  Hold'em No Limit (50/100) - 2020/12/03 17:43:50 ET
Table 'Winifred' 9-max (Play Money) Seat #3 is the button
Seat 1: color_singleton (44016 in chips) 
Seat 2: MnnM150 (8406 in chips) 
Seat 3: dhduncan (6653 in chips) 
Seat 5: Duke Croix (11111 in chips) 
Seat 8: MrOB1reader (8145 in chips) 
Duke Croix: posts small blind 50
MrOB1reader: posts big blind 100
*** HOLE CARDS ***
Dealt to Duke Croix [2d Jh]
color_singleton: raises 200 to 300
MnnM150: calls 300
dhduncan: calls 300
Duke Croix: folds 
MrOB1reader: calls 200
*** FLOP *** [6s Kc 6h]
MrOB1reader: checks 
color_singleton: bets 590
MnnM150: raises 590 to 1180
dhduncan: folds 
MrOB1reader: calls 1180
color_singleton: calls 590
*** TURN *** [6s Kc 6h] [3h]
MrOB1reader: checks 
color_singleton: checks 
MnnM150: bets 4527
MrOB1reader: folds 
color_singleton: folds 
Uncalled bet (4527) returned to MnnM150
MnnM150 collected 4527 from pot
*** SUMMARY ***
Total pot 4790 | Rake 263 
Board [6s Kc 6h 3h]
Seat 1: color_singleton folded on the Turn
Seat 2: MnnM150 collected (4527)
Seat 3: dhduncan (button) folded on the Flop
Seat 5: Duke Croix (small blind) folded before Flop
Seat 8: MrOB1reader (big blind) folded on the Turn



PokerStars Home Game Hand #221067250827: {Club #3225207}  Hold'em No Limit (50/100) - 2020/12/03 17:44:57 ET
Table 'Winifred' 9-max (Play Money) Seat #5 is the button
Seat 1: color_singleton (42536 in chips) 
Seat 2: MnnM150 (11453 in chips) 
Seat 3: dhduncan (6353 in chips) 
Seat 5: Duke Croix (11061 in chips) 
Seat 8: MrOB1reader (6665 in chips) 
MrOB1reader: posts small blind 50
color_singleton: posts big blind 100
*** HOLE CARDS ***
Dealt to Duke Croix [Kc 7s]
MnnM150: calls 100
dhduncan: folds 
Duke Croix: calls 100
MrOB1reader: calls 50
color_singleton: raises 200 to 300
MnnM150: calls 200
Duke Croix: calls 200
MrOB1reader: calls 200
*** FLOP *** [Ks 9d 9h]
MrOB1reader: checks 
color_singleton: checks 
MnnM150: bets 567
Duke Croix: calls 567
MrOB1reader: folds 
color_singleton: calls 567
*** TURN *** [Ks 9d 9h] [Ac]
color_singleton: checks 
MnnM150: bets 2741
Duke Croix: folds 
color_singleton: calls 2741
*** RIVER *** [Ks 9d 9h Ac] [2d]
color_singleton: checks 
MnnM150: bets 7845 and is all-in
color_singleton: folds 
Uncalled bet (7845) returned to MnnM150
MnnM150 collected 7922 from pot
*** SUMMARY ***
Total pot 8383 | Rake 461 
Board [Ks 9d 9h Ac 2d]
Seat 1: color_singleton (big blind) folded on the River
Seat 2: MnnM150 collected (7922)
Seat 3: dhduncan folded before Flop (didn't bet)
Seat 5: Duke Croix (button) folded on the Turn
Seat 8: MrOB1reader (small blind) folded on the Flop



PokerStars Home Game Hand #221067296276: {Club #3225207}  Hold'em No Limit (50/100) - 2020/12/03 17:46:13 ET
Table 'Winifred' 9-max (Play Money) Seat #8 is the button
Seat 1: color_singleton (38928 in chips) 
Seat 2: MnnM150 (15767 in chips) 
Seat 3: dhduncan (6353 in chips) 
Seat 5: Duke Croix (10194 in chips) 
Seat 8: MrOB1reader (6365 in chips) 
color_singleton: posts small blind 50
MnnM150: posts big blind 100
*** HOLE CARDS ***
Dealt to Duke Croix [Qd 5c]
dhduncan: folds 
Duke Croix: folds 
MrOB1reader: calls 100
color_singleton: calls 50
MnnM150: checks 
*** FLOP *** [2c 7h 7d]
color_singleton: checks 
MnnM150: checks 
MrOB1reader: checks 
*** TURN *** [2c 7h 7d] [6s]
color_singleton: bets 141
MnnM150: calls 141
MrOB1reader: folds 
*** RIVER *** [2c 7h 7d 6s] [6d]
color_singleton: bets 550
MnnM150: folds 
Uncalled bet (550) returned to color_singleton
color_singleton collected 550 from pot
color_singleton: doesn't show hand 
*** SUMMARY ***
Total pot 582 | Rake 32 
Board [2c 7h 7d 6s 6d]
Seat 1: color_singleton (small blind) collected (550)
Seat 2: MnnM150 (big blind) folded on the River
Seat 3: dhduncan folded before Flop (didn't bet)
Seat 5: Duke Croix folded before Flop (didn't bet)
Seat 8: MrOB1reader (button) folded on the Turn



PokerStars Home Game Hand #221067324070: {Club #3225207}  Hold'em No Limit (50/100) - 2020/12/03 17:47:00 ET
Table 'Winifred' 9-max (Play Money) Seat #1 is the button
Seat 1: color_singleton (39237 in chips) 
Seat 2: MnnM150 (15526 in chips) 
Seat 3: dhduncan (6353 in chips) 
Seat 5: Duke Croix (10194 in chips) 
Seat 8: MrOB1reader (6265 in chips) 
MnnM150: posts small blind 50
dhduncan: posts big blind 100
*** HOLE CARDS ***
Dealt to Duke Croix [Jh 7s]
Duke Croix: folds 
MrOB1reader: calls 100
color_singleton: raises 200 to 300
MnnM150: calls 250
dhduncan: folds 
MrOB1reader: calls 200
*** FLOP *** [Ah Td 3d]
MnnM150: bets 472
MrOB1reader: folds 
color_singleton: calls 472
*** TURN *** [Ah Td 3d] [3h]
MnnM150: bets 918
color_singleton: calls 918
*** RIVER *** [Ah Td 3d 3h] [2s]
MnnM150: bets 1786
color_singleton: folds 
Uncalled bet (1786) returned to MnnM150
MnnM150 collected 3572 from pot
*** SUMMARY ***
Total pot 3780 | Rake 208 
Board [Ah Td 3d 3h 2s]
Seat 1: color_singleton (button) folded on the River
Seat 2: MnnM150 (small blind) collected (3572)
Seat 3: dhduncan (big blind) folded before Flop
Seat 5: Duke Croix folded before Flop (didn't bet)
Seat 8: MrOB1reader folded on the Flop



PokerStars Home Game Hand #221067345105: {Club #3225207}  Hold'em No Limit (50/100) - 2020/12/03 17:47:36 ET
Table 'Winifred' 9-max (Play Money) Seat #2 is the button
Seat 1: color_singleton (37547 in chips) 
Seat 2: MnnM150 (17408 in chips) 
Seat 3: dhduncan (6253 in chips) 
Seat 5: Duke Croix (10194 in chips) 
dhduncan: posts small blind 50
Duke Croix: posts big blind 100
*** HOLE CARDS ***
Dealt to Duke Croix [2d 8s]
color_singleton: folds 
MnnM150: calls 100
dhduncan: calls 50
Duke Croix: checks 
*** FLOP *** [Qd 3c Jd]
dhduncan: checks 
Duke Croix: checks 
MnnM150: checks 
*** TURN *** [Qd 3c Jd] [7h]
dhduncan: checks 
Duke Croix: checks 
MnnM150: bets 141
dhduncan: folds 
Duke Croix: folds 
Uncalled bet (141) returned to MnnM150
MnnM150 collected 283 from pot
*** SUMMARY ***
Total pot 300 | Rake 17 
Board [Qd 3c Jd 7h]
Seat 1: color_singleton folded before Flop (didn't bet)
Seat 2: MnnM150 (button) collected (283)
Seat 3: dhduncan (small blind) folded on the Turn
Seat 5: Duke Croix (big blind) folded on the Turn



PokerStars Home Game Hand #221067364324: {Club #3225207}  Hold'em No Limit (50/100) - 2020/12/03 17:48:01 ET
Table 'Winifred' 9-max (Play Money) Seat #3 is the button
Seat 1: color_singleton (37547 in chips) 
Seat 2: MnnM150 (17591 in chips) 
Seat 3: dhduncan (6153 in chips) 
Seat 5: Duke Croix (10094 in chips) 
Duke Croix: posts small blind 50
color_singleton: posts big blind 100
*** HOLE CARDS ***
Dealt to Duke Croix [5d 2s]
MnnM150: folds 
dhduncan: calls 100
Duke Croix: calls 50
color_singleton has timed out
color_singleton: checks 
*** FLOP *** [2c 4d Qs]
Duke Croix: checks 
color_singleton has timed out
color_singleton: checks 
dhduncan: checks 
*** TURN *** [2c 4d Qs] [9c]
Duke Croix: checks 
color_singleton: checks 
dhduncan: checks 
*** RIVER *** [2c 4d Qs 9c] [8h]
Duke Croix: bets 200
color_singleton: folds 
dhduncan: folds 
Uncalled bet (200) returned to Duke Croix
Duke Croix collected 283 from pot
*** SUMMARY ***
Total pot 300 | Rake 17 
Board [2c 4d Qs 9c 8h]
Seat 1: color_singleton (big blind) folded on the River
Seat 2: MnnM150 folded before Flop (didn't bet)
Seat 3: dhduncan (button) folded on the River
Seat 5: Duke Croix (small blind) collected (283)



PokerStars Home Game Hand #221067418670: {Club #3225207}  Hold'em No Limit (50/100) - 2020/12/03 17:49:34 ET
Table 'Winifred' 9-max (Play Money) Seat #5 is the button
Seat 1: color_singleton (37447 in chips) 
Seat 2: MnnM150 (17591 in chips) 
Seat 3: dhduncan (6053 in chips) 
Seat 5: Duke Croix (10277 in chips) 
color_singleton: posts small blind 50
MnnM150: posts big blind 100
*** HOLE CARDS ***
Dealt to Duke Croix [As 3s]
dhduncan: folds 
Duke Croix: raises 200 to 300
color_singleton: folds 
MnnM150: folds 
Uncalled bet (200) returned to Duke Croix
Duke Croix collected 250 from pot
*** SUMMARY ***
Total pot 250 | Rake 0 
Seat 1: color_singleton (small blind) folded before Flop
Seat 2: MnnM150 (big blind) folded before Flop
Seat 3: dhduncan folded before Flop (didn't bet)
Seat 5: Duke Croix (button) collected (250)



PokerStars Home Game Hand #221067424187: {Club #3225207}  Hold'em No Limit (50/100) - 2020/12/03 17:49:43 ET
Table 'Winifred' 9-max (Play Money) Seat #1 is the button
Seat 1: color_singleton (37397 in chips) 
Seat 2: MnnM150 (17491 in chips) 
Seat 3: dhduncan (6053 in chips) 
Seat 5: Duke Croix (10427 in chips) 
Seat 8: MrOB1reader (5965 in chips) 
MnnM150: posts small blind 50
dhduncan: posts big blind 100
MrOB1reader: posts small & big blinds 150
*** HOLE CARDS ***
Dealt to Duke Croix [Ts Qh]
Duke Croix: raises 300 to 400
MrOB1reader: calls 300
color_singleton: calls 400
MnnM150: calls 350
dhduncan: folds 
*** FLOP *** [Jd Kd Td]
MnnM150: bets 827
Duke Croix: calls 827
MrOB1reader: folds 
color_singleton: calls 827
*** TURN *** [Jd Kd Td] [Ac]
MnnM150: bets 3998
Duke Croix: calls 3998
color_singleton: folds 
*** RIVER *** [Jd Kd Td Ac] [4s]
MnnM150: checks 
Duke Croix: checks 
*** SHOW DOWN ***
MnnM150: shows [As Th] (two pair, Aces and Tens)
Duke Croix: shows [Ts Qh] (a straight, Ten to Ace)
Duke Croix collected 11555 from pot
*** SUMMARY ***
Total pot 12227 | Rake 672 
Board [Jd Kd Td Ac 4s]
Seat 1: color_singleton (button) folded on the Turn
Seat 2: MnnM150 (small blind) showed [As Th] and lost with two pair, Aces and Tens
Seat 3: dhduncan (big blind) folded before Flop
Seat 5: Duke Croix showed [Ts Qh] and won (11555) with a straight, Ten to Ace
Seat 8: MrOB1reader folded on the Flop



PokerStars Home Game Hand #221067461901: {Club #3225207}  Hold'em No Limit (50/100) - 2020/12/03 17:50:48 ET
Table 'Winifred' 9-max (Play Money) Seat #2 is the button
Seat 1: color_singleton (36170 in chips) 
Seat 2: MnnM150 (12266 in chips) 
Seat 5: Duke Croix (16757 in chips) 
Seat 8: MrOB1reader (5515 in chips) 
Duke Croix: posts small blind 50
MrOB1reader: posts big blind 100
*** HOLE CARDS ***
Dealt to Duke Croix [As 5h]
color_singleton: folds 
MnnM150: calls 100
Duke Croix: calls 50
MrOB1reader: checks 
*** FLOP *** [5s 2d 9h]
Duke Croix: checks 
MrOB1reader: checks 
MnnM150: checks 
*** TURN *** [5s 2d 9h] [Kh]
Duke Croix: checks 
MrOB1reader: checks 
MnnM150: checks 
*** RIVER *** [5s 2d 9h Kh] [6s]
Duke Croix: checks 
MrOB1reader: checks 
MnnM150: checks 
*** SHOW DOWN ***
Duke Croix: shows [As 5h] (a pair of Fives)
MrOB1reader: mucks hand 
MnnM150: shows [Kc 4d] (a pair of Kings)
MnnM150 collected 283 from pot
*** SUMMARY ***
Total pot 300 | Rake 17 
Board [5s 2d 9h Kh 6s]
Seat 1: color_singleton folded before Flop (didn't bet)
Seat 2: MnnM150 (button) showed [Kc 4d] and won (283) with a pair of Kings
Seat 5: Duke Croix (small blind) showed [As 5h] and lost with a pair of Fives
Seat 8: MrOB1reader (big blind) mucked [4h 7d]



PokerStars Home Game Hand #221067482842: {Club #3225207}  Hold'em No Limit (50/100) - 2020/12/03 17:51:24 ET
Table 'Winifred' 9-max (Play Money) Seat #5 is the button
Seat 1: color_singleton (36170 in chips) 
Seat 2: MnnM150 (12449 in chips) 
Seat 5: Duke Croix (16657 in chips) 
Seat 8: MrOB1reader (5415 in chips) 
MrOB1reader: posts small blind 50
color_singleton: posts big blind 100
*** HOLE CARDS ***
Dealt to Duke Croix [8s 6d]
MnnM150: folds 
Duke Croix: folds 
MrOB1reader: calls 50
color_singleton: raises 200 to 300
MrOB1reader: folds 
Uncalled bet (200) returned to color_singleton
color_singleton collected 200 from pot
color_singleton: doesn't show hand 
*** SUMMARY ***
Total pot 200 | Rake 0 
Seat 1: color_singleton (big blind) collected (200)
Seat 2: MnnM150 folded before Flop (didn't bet)
Seat 5: Duke Croix (button) folded before Flop (didn't bet)
Seat 8: MrOB1reader (small blind) folded before Flop



PokerStars Home Game Hand #221067492137: {Club #3225207}  Hold'em No Limit (50/100) - 2020/12/03 17:51:41 ET
Table 'Winifred' 9-max (Play Money) Seat #8 is the button
Seat 1: color_singleton (36270 in chips) 
Seat 2: MnnM150 (12449 in chips) 
Seat 3: dhduncan (5953 in chips) 
Seat 5: Duke Croix (16657 in chips) 
Seat 8: MrOB1reader (5315 in chips) 
color_singleton: posts small blind 50
MnnM150: posts big blind 100
dhduncan: posts small blind 50
*** HOLE CARDS ***
Dealt to Duke Croix [Js 6c]
dhduncan: folds 
Duke Croix: folds 
MrOB1reader: calls 100
color_singleton: calls 50
MnnM150: checks 
*** FLOP *** [8h 5c 4d]
color_singleton: checks 
MnnM150: checks 
MrOB1reader: bets 100
color_singleton: calls 100
MnnM150: calls 100
*** TURN *** [8h 5c 4d] [8d]
color_singleton: checks 
MnnM150: checks 
MrOB1reader: checks 
*** RIVER *** [8h 5c 4d 8d] [3c]
color_singleton: checks 
MnnM150: checks 
MrOB1reader: bets 100
color_singleton: folds 
MnnM150: calls 100
*** SHOW DOWN ***
MrOB1reader: shows [3s 4h] (two pair, Eights and Fours)
MnnM150: shows [Th 4s] (two pair, Eights and Fours - Ten kicker)
MnnM150 collected 803 from pot
*** SUMMARY ***
Total pot 850 | Rake 47 
Board [8h 5c 4d 8d 3c]
Seat 1: color_singleton (small blind) folded on the River
Seat 2: MnnM150 (big blind) showed [Th 4s] and won (803) with two pair, Eights and Fours
Seat 3: dhduncan folded before Flop (didn't bet)
Seat 5: Duke Croix folded before Flop (didn't bet)
Seat 8: MrOB1reader (button) showed [3s 4h] and lost with two pair, Eights and Fours



PokerStars Home Game Hand #221067529302: {Club #3225207}  Hold'em No Limit (50/100) - 2020/12/03 17:52:46 ET
Table 'Winifred' 9-max (Play Money) Seat #1 is the button
Seat 1: color_singleton (36070 in chips) 
Seat 2: MnnM150 (12952 in chips) 
Seat 3: dhduncan (5903 in chips) 
Seat 5: Duke Croix (16657 in chips) 
Seat 8: MrOB1reader (5015 in chips) 
MnnM150: posts small blind 50
dhduncan: posts big blind 100
*** HOLE CARDS ***
Dealt to Duke Croix [Jd Jh]
Duke Croix has timed out
Duke Croix: folds 
MrOB1reader: calls 100
color_singleton: raises 200 to 300
MnnM150: calls 250
dhduncan: folds 
MrOB1reader: calls 200
*** FLOP *** [Jc 2d 7d]
MnnM150: bets 472
MrOB1reader: folds 
color_singleton: raises 472 to 944
MnnM150: raises 472 to 1416
color_singleton: calls 472
*** TURN *** [Jc 2d 7d] [7s]
MnnM150: checks 
color_singleton: bets 1810
MnnM150: calls 1810
*** RIVER *** [Jc 2d 7d 7s] [7c]
MnnM150: bets 7042
color_singleton: calls 7042
*** SHOW DOWN ***
MnnM150: shows [Js Ks] (a full house, Sevens full of Jacks)
color_singleton: shows [Qd Qc] (a full house, Sevens full of Queens)
color_singleton collected 20352 from pot
*** SUMMARY ***
Total pot 21536 | Rake 1184 
Board [Jc 2d 7d 7s 7c]
Seat 1: color_singleton (button) showed [Qd Qc] and won (20352) with a full house, Sevens full of Queens
Seat 2: MnnM150 (small blind) showed [Js Ks] and lost with a full house, Sevens full of Jacks
Seat 3: dhduncan (big blind) folded before Flop
Seat 5: Duke Croix folded before Flop (didn't bet)
Seat 8: MrOB1reader folded on the Flop



PokerStars Home Game Hand #221067567461: {Club #3225207}  Hold'em No Limit (50/100) - 2020/12/03 17:53:53 ET
Table 'Winifred' 9-max (Play Money) Seat #2 is the button
Seat 1: color_singleton (45854 in chips) 
Seat 2: MnnM150 (2384 in chips) 
Seat 3: dhduncan (5803 in chips) 
Seat 5: Duke Croix (16657 in chips) 
Seat 8: MrOB1reader (4715 in chips) 
dhduncan: posts small blind 50
Duke Croix: posts big blind 100
*** HOLE CARDS ***
Dealt to Duke Croix [Qh 7s]
MrOB1reader: calls 100
color_singleton: folds 
MnnM150: folds 
dhduncan: calls 50
Duke Croix has timed out
Duke Croix: checks 
*** FLOP *** [8s 4s 5s]
dhduncan: checks 
Duke Croix has timed out
Duke Croix: checks 
MrOB1reader: bets 100
dhduncan: folds 
Duke Croix has timed out
Duke Croix: folds 
Uncalled bet (100) returned to MrOB1reader
MrOB1reader collected 283 from pot
MrOB1reader: doesn't show hand 
*** SUMMARY ***
Total pot 300 | Rake 17 
Board [8s 4s 5s]
Seat 1: color_singleton folded before Flop (didn't bet)
Seat 2: MnnM150 (button) folded before Flop (didn't bet)
Seat 3: dhduncan (small blind) folded on the Flop
Seat 5: Duke Croix (big blind) folded on the Flop
Seat 8: MrOB1reader collected (283)



PokerStars Home Game Hand #221067666516: {Club #3225207}  Hold'em No Limit (50/100) - 2020/12/03 17:57:17 ET
Table 'Winifred' 9-max (Play Money) Seat #2 is the button
Seat 1: color_singleton (45026 in chips) 
Seat 2: MnnM150 (3537 in chips) 
Seat 3: dhduncan (5628 in chips) 
Seat 5: Duke Croix (16557 in chips) 
Seat 8: MrOB1reader (4498 in chips) 
dhduncan: posts small blind 50
Duke Croix: posts big blind 100
*** HOLE CARDS ***
Dealt to Duke Croix [Qd 2c]
MrOB1reader: calls 100
color_singleton: calls 100
MnnM150: calls 100
dhduncan: raises 100 to 200
Duke Croix: calls 100
MrOB1reader: calls 100
color_singleton: calls 100
MnnM150: calls 100
*** FLOP *** [7h Ah Jd]
dhduncan: checks 
Duke Croix: checks 
MrOB1reader: checks 
color_singleton: bets 472
MnnM150: raises 472 to 944
dhduncan: folds 
Duke Croix: folds 
MrOB1reader: folds 
color_singleton: calls 472
*** TURN *** [7h Ah Jd] [3h]
color_singleton: checks 
MnnM150: checks 
*** RIVER *** [7h Ah Jd 3h] [As]
color_singleton: bets 1364
MnnM150: raises 1029 to 2393 and is all-in
color_singleton: calls 1029
*** SHOW DOWN ***
MnnM150: shows [Ad 8c] (three of a kind, Aces)
color_singleton: shows [6s Ac] (three of a kind, Aces - lower kicker)
MnnM150 collected 7252 from pot
*** SUMMARY ***
Total pot 7674 | Rake 422 
Board [7h Ah Jd 3h As]
Seat 1: color_singleton showed [6s Ac] and lost with three of a kind, Aces
Seat 2: MnnM150 (button) showed [Ad 8c] and won (7252) with three of a kind, Aces
Seat 3: dhduncan (small blind) folded on the Flop
Seat 5: Duke Croix (big blind) folded on the Flop
Seat 8: MrOB1reader folded on the Flop



PokerStars Home Game Hand #221067701826: {Club #3225207}  Hold'em No Limit (50/100) - 2020/12/03 17:58:28 ET
Table 'Winifred' 9-max (Play Money) Seat #3 is the button
Seat 1: color_singleton (41489 in chips) 
Seat 2: MnnM150 (7252 in chips) 
Seat 3: dhduncan (5428 in chips) 
Seat 5: Duke Croix (16357 in chips) 
Seat 8: MrOB1reader (4298 in chips) 
Duke Croix: posts small blind 50
MrOB1reader: posts big blind 100
*** HOLE CARDS ***
Dealt to Duke Croix [As 9d]
color_singleton: folds 
MnnM150: calls 100
dhduncan: calls 100
Duke Croix: calls 50
MrOB1reader: checks 
*** FLOP *** [7d Ad Td]
Duke Croix: bets 300
MrOB1reader: folds 
MnnM150: calls 300
dhduncan: calls 300
*** TURN *** [7d Ad Td] [4h]
Duke Croix: bets 700
MnnM150: calls 700
dhduncan: folds 
*** RIVER *** [7d Ad Td 4h] [9h]
Duke Croix: bets 1800
MnnM150: folds 
Uncalled bet (1800) returned to Duke Croix
Duke Croix collected 2551 from pot
*** SUMMARY ***
Total pot 2700 | Rake 149 
Board [7d Ad Td 4h 9h]
Seat 1: color_singleton folded before Flop (didn't bet)
Seat 2: MnnM150 folded on the River
Seat 3: dhduncan (button) folded on the Turn
Seat 5: Duke Croix (small blind) collected (2551)
Seat 8: MrOB1reader (big blind) folded on the Flop



PokerStars Home Game Hand #221067727829: {Club #3225207}  Hold'em No Limit (50/100) - 2020/12/03 17:59:28 ET
Table 'Winifred' 9-max (Play Money) Seat #5 is the button
Seat 1: color_singleton (41489 in chips) 
Seat 2: MnnM150 (6152 in chips) 
Seat 3: dhduncan (5028 in chips) 
Seat 5: Duke Croix (17808 in chips) 
Seat 8: MrOB1reader (4198 in chips) 
MrOB1reader: posts small blind 50
color_singleton: posts big blind 100
*** HOLE CARDS ***
Dealt to Duke Croix [7c 2d]
MnnM150: calls 100
dhduncan: folds 
Duke Croix: folds 
MrOB1reader: calls 50
color_singleton: checks 
*** FLOP *** [Ks Jh Kh]
MrOB1reader: checks 
color_singleton: checks 
MnnM150: checks 
*** TURN *** [Ks Jh Kh] [As]
MrOB1reader: checks 
color_singleton: checks 
MnnM150 has timed out
MnnM150: checks 
*** RIVER *** [Ks Jh Kh As] [Ts]
MrOB1reader: checks 
color_singleton: checks 
MnnM150: checks 
*** SHOW DOWN ***
MrOB1reader: shows [2c 4c] (a pair of Kings)
color_singleton: shows [4d 8s] (a pair of Kings)
MnnM150: shows [9d 7h] (a pair of Kings)
MrOB1reader collected 95 from pot
color_singleton collected 94 from pot
MnnM150 collected 94 from pot
*** SUMMARY ***
Total pot 300 | Rake 17 
Board [Ks Jh Kh As Ts]
Seat 1: color_singleton (big blind) showed [4d 8s] and won (94) with a pair of Kings
Seat 2: MnnM150 showed [9d 7h] and won (94) with a pair of Kings
Seat 3: dhduncan folded before Flop (didn't bet)
Seat 5: Duke Croix (button) folded before Flop (didn't bet)
Seat 8: MrOB1reader (small blind) showed [2c 4c] and won (95) with a pair of Kings



PokerStars Home Game Hand #221067762732: {Club #3225207}  Hold'em No Limit (50/100) - 2020/12/03 18:00:48 ET
Table 'Winifred' 9-max (Play Money) Seat #8 is the button
Seat 1: color_singleton (41483 in chips) 
Seat 2: MnnM150 (6146 in chips) 
Seat 3: dhduncan (5028 in chips) 
Seat 5: Duke Croix (17808 in chips) 
Seat 8: MrOB1reader (4193 in chips) 
color_singleton: posts small blind 50
MnnM150: posts big blind 100
*** HOLE CARDS ***
Dealt to Duke Croix [Td 5h]
dhduncan: calls 100
Duke Croix: folds 
MrOB1reader: calls 100
color_singleton: calls 50
MnnM150: checks 
*** FLOP *** [Qh 3h 3d]
color_singleton: checks 
MnnM150: checks 
dhduncan: checks 
MrOB1reader: bets 100
color_singleton: folds 
MnnM150: calls 100
dhduncan: calls 100
*** TURN *** [Qh 3h 3d] [Jc]
MnnM150: checks 
dhduncan: checks 
MrOB1reader: checks 
*** RIVER *** [Qh 3h 3d Jc] [Ah]
MnnM150: checks 
dhduncan: bets 661
MrOB1reader: calls 661
MnnM150: folds 
*** SHOW DOWN ***
dhduncan: shows [As Th] (two pair, Aces and Threes)
MrOB1reader: mucks hand 
dhduncan collected 1911 from pot
*** SUMMARY ***
Total pot 2022 | Rake 111 
Board [Qh 3h 3d Jc Ah]
Seat 1: color_singleton (small blind) folded on the Flop
Seat 2: MnnM150 (big blind) folded on the River
Seat 3: dhduncan showed [As Th] and won (1911) with two pair, Aces and Threes
Seat 5: Duke Croix folded before Flop (didn't bet)
Seat 8: MrOB1reader (button) mucked [5s Qc]



PokerStars Home Game Hand #221067798324: {Club #3225207}  Hold'em No Limit (50/100) - 2020/12/03 18:01:57 ET
Table 'Winifred' 9-max (Play Money) Seat #1 is the button
Seat 1: color_singleton (41383 in chips) 
Seat 2: MnnM150 (5946 in chips) 
Seat 3: dhduncan (6078 in chips) 
Seat 5: Duke Croix (17808 in chips) 
Seat 8: MrOB1reader (3332 in chips) 
MnnM150: posts small blind 50
dhduncan: posts big blind 100
*** HOLE CARDS ***
Dealt to Duke Croix [4c 7c]
Duke Croix: folds 
MrOB1reader: calls 100
color_singleton: folds 
MnnM150: calls 50
dhduncan: checks 
*** FLOP *** [Ac 9s 6c]
MnnM150: checks 
dhduncan: checks 
MrOB1reader: checks 
*** TURN *** [Ac 9s 6c] [5h]
MnnM150: checks 
dhduncan: checks 
MrOB1reader: checks 
*** RIVER *** [Ac 9s 6c 5h] [Ks]
MnnM150: bets 141
dhduncan: folds 
MrOB1reader: folds 
Uncalled bet (141) returned to MnnM150
MnnM150 collected 283 from pot
*** SUMMARY ***
Total pot 300 | Rake 17 
Board [Ac 9s 6c 5h Ks]
Seat 1: color_singleton (button) folded before Flop (didn't bet)
Seat 2: MnnM150 (small blind) collected (283)
Seat 3: dhduncan (big blind) folded on the River
Seat 5: Duke Croix folded before Flop (didn't bet)
Seat 8: MrOB1reader folded on the River



PokerStars Home Game Hand #221067831759: {Club #3225207}  Hold'em No Limit (50/100) - 2020/12/03 18:02:51 ET
Table 'Winifred' 9-max (Play Money) Seat #2 is the button
Seat 1: color_singleton (41383 in chips) 
Seat 2: MnnM150 (6129 in chips) 
Seat 3: dhduncan (5978 in chips) 
Seat 5: Duke Croix (17808 in chips) 
Seat 8: MrOB1reader (3232 in chips) 
dhduncan: posts small blind 50
Duke Croix: posts big blind 100
*** HOLE CARDS ***
Dealt to Duke Croix [5s Ad]
MrOB1reader: calls 100
color_singleton: folds 
MnnM150: calls 100
dhduncan: calls 50
Duke Croix: checks 
*** FLOP *** [Th 6h 5d]
dhduncan: checks 
Duke Croix: checks 
MrOB1reader: checks 
MnnM150: checks 
*** TURN *** [Th 6h 5d] [8h]
dhduncan: checks 
Duke Croix: checks 
MrOB1reader: checks 
MnnM150: checks 
*** RIVER *** [Th 6h 5d 8h] [2h]
dhduncan: checks 
Duke Croix: checks 
MrOB1reader: bets 100
MnnM150: raises 578 to 678
dhduncan: folds 
Duke Croix: folds 
MrOB1reader: calls 578
*** SHOW DOWN ***
MnnM150: shows [Tc 5h] (a flush, Ten high)
MrOB1reader: mucks hand 
MnnM150 collected 1659 from pot
*** SUMMARY ***
Total pot 1756 | Rake 97 
Board [Th 6h 5d 8h 2h]
Seat 1: color_singleton folded before Flop (didn't bet)
Seat 2: MnnM150 (button) showed [Tc 5h] and won (1659) with a flush, Ten high
Seat 3: dhduncan (small blind) folded on the River
Seat 5: Duke Croix (big blind) folded on the River
Seat 8: MrOB1reader mucked [4s 4h]



PokerStars Home Game Hand #221067858448: {Club #3225207}  Hold'em No Limit (50/100) - 2020/12/03 18:03:40 ET
Table 'Winifred' 9-max (Play Money) Seat #3 is the button
Seat 1: color_singleton (41383 in chips) 
Seat 2: MnnM150 (7010 in chips) 
Seat 3: dhduncan (5878 in chips) 
Seat 5: Duke Croix (17708 in chips) 
Seat 8: MrOB1reader (2454 in chips) 
Duke Croix: posts small blind 50
MrOB1reader: posts big blind 100
*** HOLE CARDS ***
Dealt to Duke Croix [2h 7s]
color_singleton: raises 100 to 200
MnnM150: calls 200
dhduncan: calls 200
Duke Croix: folds 
MrOB1reader: calls 100
*** FLOP *** [Qs Jc 8s]
MrOB1reader: checks 
color_singleton: checks 
MnnM150: checks 
dhduncan: bets 200
MrOB1reader: calls 200
color_singleton: folds 
MnnM150: calls 200
*** TURN *** [Qs Jc 8s] [Js]
MrOB1reader: checks 
MnnM150: checks 
dhduncan: bets 100
MrOB1reader: folds 
MnnM150: calls 100
*** RIVER *** [Qs Jc 8s Js] [4s]
MnnM150: checks 
dhduncan: checks 
*** SHOW DOWN ***
MnnM150: shows [Kc 7c] (a pair of Jacks)
dhduncan: shows [Qh 5h] (two pair, Queens and Jacks)
dhduncan collected 1559 from pot
*** SUMMARY ***
Total pot 1650 | Rake 91 
Board [Qs Jc 8s Js 4s]
Seat 1: color_singleton folded on the Flop
Seat 2: MnnM150 showed [Kc 7c] and lost with a pair of Jacks
Seat 3: dhduncan (button) showed [Qh 5h] and won (1559) with two pair, Queens and Jacks
Seat 5: Duke Croix (small blind) folded before Flop
Seat 8: MrOB1reader (big blind) folded on the Turn



PokerStars Home Game Hand #221067896316: {Club #3225207}  Hold'em No Limit (50/100) - 2020/12/03 18:04:49 ET
Table 'Winifred' 9-max (Play Money) Seat #5 is the button
Seat 1: color_singleton (41183 in chips) 
Seat 2: MnnM150 (6510 in chips) 
Seat 3: dhduncan (6937 in chips) 
Seat 5: Duke Croix (17658 in chips) 
Seat 8: MrOB1reader (2054 in chips) 
MrOB1reader: posts small blind 50
color_singleton: posts big blind 100
*** HOLE CARDS ***
Dealt to Duke Croix [Tc 9d]
MnnM150: calls 100
dhduncan: calls 100
Duke Croix has timed out
Duke Croix: folds 
MrOB1reader: calls 50
color_singleton: raises 200 to 300
MnnM150: calls 200
dhduncan: folds 
MrOB1reader: calls 200
*** FLOP *** [Jd 7d 7h]
MrOB1reader: checks 
color_singleton: checks 
MnnM150: checks 
*** TURN *** [Jd 7d 7h] [Ah]
MrOB1reader: checks 
color_singleton: checks 
MnnM150: checks 
*** RIVER *** [Jd 7d 7h Ah] [Jh]
MrOB1reader: checks 
color_singleton: checks 
MnnM150: checks 
*** SHOW DOWN ***
MrOB1reader: shows [4c 2c] (two pair, Jacks and Sevens)
color_singleton: shows [9c Qd] (two pair, Jacks and Sevens)
MnnM150: shows [Qc 2d] (two pair, Jacks and Sevens)
MrOB1reader collected 315 from pot
color_singleton collected 315 from pot
MnnM150 collected 315 from pot
*** SUMMARY ***
Total pot 1000 | Rake 55 
Board [Jd 7d 7h Ah Jh]
Seat 1: color_singleton (big blind) showed [9c Qd] and won (315) with two pair, Jacks and Sevens
Seat 2: MnnM150 showed [Qc 2d] and won (315) with two pair, Jacks and Sevens
Seat 3: dhduncan folded before Flop
Seat 5: Duke Croix (button) folded before Flop (didn't bet)
Seat 8: MrOB1reader (small blind) showed [4c 2c] and won (315) with two pair, Jacks and Sevens



PokerStars Home Game Hand #221067935024: {Club #3225207}  Hold'em No Limit (50/100) - 2020/12/03 18:05:59 ET
Table 'Winifred' 9-max (Play Money) Seat #8 is the button
Seat 1: color_singleton (41198 in chips) 
Seat 2: MnnM150 (6525 in chips) 
Seat 3: dhduncan (6837 in chips) 
Seat 5: Duke Croix (17658 in chips) 
Seat 8: MrOB1reader (2069 in chips) 
color_singleton: posts small blind 50
MnnM150: posts big blind 100
*** HOLE CARDS ***
Dealt to Duke Croix [3c 4h]
dhduncan: calls 100
Duke Croix: folds 
MrOB1reader: calls 100
color_singleton: raises 200 to 300
MnnM150: folds 
dhduncan: calls 200
MrOB1reader: calls 200
*** FLOP *** [Ac Ah Td]
color_singleton: checks 
dhduncan: checks 
MrOB1reader: checks 
*** TURN *** [Ac Ah Td] [6d]
color_singleton: bets 472
dhduncan: folds 
MrOB1reader: folds 
Uncalled bet (472) returned to color_singleton
color_singleton collected 945 from pot
color_singleton: doesn't show hand 
*** SUMMARY ***
Total pot 1000 | Rake 55 
Board [Ac Ah Td 6d]
Seat 1: color_singleton (small blind) collected (945)
Seat 2: MnnM150 (big blind) folded before Flop
Seat 3: dhduncan folded on the Turn
Seat 5: Duke Croix folded before Flop (didn't bet)
Seat 8: MrOB1reader (button) folded on the Turn



PokerStars Home Game Hand #221067953187: {Club #3225207}  Hold'em No Limit (50/100) - 2020/12/03 18:06:32 ET
Table 'Winifred' 9-max (Play Money) Seat #1 is the button
Seat 1: color_singleton (41843 in chips) 
Seat 2: MnnM150 (6425 in chips) 
Seat 3: dhduncan (6537 in chips) 
Seat 5: Duke Croix (17658 in chips) 
Seat 8: MrOB1reader (1769 in chips) 
MnnM150: posts small blind 50
dhduncan: posts big blind 100
*** HOLE CARDS ***
Dealt to Duke Croix [Ks 2d]
Duke Croix: folds 
MrOB1reader: calls 100
color_singleton: calls 100
MnnM150: calls 50
dhduncan: checks 
*** FLOP *** [2c Jc Tc]
MnnM150: checks 
dhduncan: checks 
MrOB1reader: checks 
color_singleton: checks 
*** TURN *** [2c Jc Tc] [Js]
MnnM150: checks 
dhduncan: checks 
MrOB1reader: checks 
color_singleton: bets 189
MnnM150: calls 189
dhduncan: folds 
MrOB1reader: folds 
*** RIVER *** [2c Jc Tc Js] [5s]
MnnM150: checks 
color_singleton: checks 
*** SHOW DOWN ***
MnnM150: shows [3c Ad] (a pair of Jacks)
color_singleton: shows [Th 7d] (two pair, Jacks and Tens)
color_singleton collected 735 from pot
*** SUMMARY ***
Total pot 778 | Rake 43 
Board [2c Jc Tc Js 5s]
Seat 1: color_singleton (button) showed [Th 7d] and won (735) with two pair, Jacks and Tens
Seat 2: MnnM150 (small blind) showed [3c Ad] and lost with a pair of Jacks
Seat 3: dhduncan (big blind) folded on the Turn
Seat 5: Duke Croix folded before Flop (didn't bet)
Seat 8: MrOB1reader folded on the Turn



PokerStars Home Game Hand #221067986270: {Club #3225207}  Hold'em No Limit (50/100) - 2020/12/03 18:07:32 ET
Table 'Winifred' 9-max (Play Money) Seat #2 is the button
Seat 1: color_singleton (42289 in chips) 
Seat 2: MnnM150 (6136 in chips) 
Seat 3: dhduncan (6437 in chips) 
Seat 5: Duke Croix (17658 in chips) 
Seat 8: MrOB1reader (1669 in chips) 
dhduncan: posts small blind 50
Duke Croix: posts big blind 100
*** HOLE CARDS ***
Dealt to Duke Croix [4s 5s]
MrOB1reader: folds 
color_singleton: folds 
MnnM150: folds 
dhduncan: calls 50
Duke Croix: checks 
*** FLOP *** [8d 6d Kc]
dhduncan: bets 100
Duke Croix: calls 100
*** TURN *** [8d 6d Kc] [Jd]
dhduncan: bets 100
Duke Croix: folds 
Uncalled bet (100) returned to dhduncan
dhduncan collected 378 from pot
dhduncan: doesn't show hand 
*** SUMMARY ***
Total pot 400 | Rake 22 
Board [8d 6d Kc Jd]
Seat 1: color_singleton folded before Flop (didn't bet)
Seat 2: MnnM150 (button) folded before Flop (didn't bet)
Seat 3: dhduncan (small blind) collected (378)
Seat 5: Duke Croix (big blind) folded on the Turn
Seat 8: MrOB1reader folded before Flop (didn't bet)



PokerStars Home Game Hand #221068000128: {Club #3225207}  Hold'em No Limit (50/100) - 2020/12/03 18:07:57 ET
Table 'Winifred' 9-max (Play Money) Seat #3 is the button
Seat 1: color_singleton (42289 in chips) 
Seat 2: MnnM150 (6136 in chips) 
Seat 3: dhduncan (6615 in chips) 
Seat 5: Duke Croix (17458 in chips) 
Seat 8: MrOB1reader (1669 in chips) 
Duke Croix: posts small blind 50
MrOB1reader: posts big blind 100
*** HOLE CARDS ***
Dealt to Duke Croix [Js 4h]
color_singleton: folds 
MnnM150: folds 
dhduncan: folds 
Duke Croix: folds 
Uncalled bet (50) returned to MrOB1reader
MrOB1reader collected 100 from pot
MrOB1reader: doesn't show hand 
*** SUMMARY ***
Total pot 100 | Rake 0 
Seat 1: color_singleton folded before Flop (didn't bet)
Seat 2: MnnM150 folded before Flop (didn't bet)
Seat 3: dhduncan (button) folded before Flop (didn't bet)
Seat 5: Duke Croix (small blind) folded before Flop
Seat 8: MrOB1reader (big blind) collected (100)



PokerStars Home Game Hand #221068005260: {Club #3225207}  Hold'em No Limit (50/100) - 2020/12/03 18:08:06 ET
Table 'Winifred' 9-max (Play Money) Seat #5 is the button
Seat 1: color_singleton (42289 in chips) 
Seat 2: MnnM150 (6136 in chips) 
Seat 3: dhduncan (6615 in chips) 
Seat 5: Duke Croix (17408 in chips) 
Seat 8: MrOB1reader (1719 in chips) 
MrOB1reader: posts small blind 50
color_singleton: posts big blind 100
*** HOLE CARDS ***
Dealt to Duke Croix [4h Qc]
MnnM150: folds 
dhduncan: folds 
Duke Croix: raises 300 to 400
MrOB1reader: raises 300 to 700
color_singleton: folds 
Duke Croix: folds 
Uncalled bet (300) returned to MrOB1reader
MrOB1reader collected 900 from pot
MrOB1reader: doesn't show hand 
*** SUMMARY ***
Total pot 900 | Rake 0 
Seat 1: color_singleton (big blind) folded before Flop
Seat 2: MnnM150 folded before Flop (didn't bet)
Seat 3: dhduncan folded before Flop (didn't bet)
Seat 5: Duke Croix (button) folded before Flop
Seat 8: MrOB1reader (small blind) collected (900)



PokerStars Home Game Hand #221068021537: {Club #3225207}  Hold'em No Limit (50/100) - 2020/12/03 18:08:36 ET
Table 'Winifred' 9-max (Play Money) Seat #8 is the button
Seat 1: color_singleton (42189 in chips) 
Seat 2: MnnM150 (6136 in chips) 
Seat 3: dhduncan (6615 in chips) 
Seat 5: Duke Croix (17008 in chips) 
Seat 8: MrOB1reader (2219 in chips) 
color_singleton: posts small blind 50
MnnM150: posts big blind 100
*** HOLE CARDS ***
Dealt to Duke Croix [9h Jh]
dhduncan: calls 100
Duke Croix: calls 100
MrOB1reader: folds 
color_singleton: calls 50
MnnM150: checks 
*** FLOP *** [7s 5d Ad]
color_singleton: checks 
MnnM150: checks 
dhduncan: checks 
Duke Croix: checks 
*** TURN *** [7s 5d Ad] [As]
color_singleton: bets 189
MnnM150: calls 189
dhduncan: folds 
Duke Croix: folds 
*** RIVER *** [7s 5d Ad As] [Jc]
color_singleton: checks 
MnnM150: bets 367
color_singleton: folds 
Uncalled bet (367) returned to MnnM150
MnnM150 collected 735 from pot
*** SUMMARY ***
Total pot 778 | Rake 43 
Board [7s 5d Ad As Jc]
Seat 1: color_singleton (small blind) folded on the River
Seat 2: MnnM150 (big blind) collected (735)
Seat 3: dhduncan folded on the Turn
Seat 5: Duke Croix folded on the Turn
Seat 8: MrOB1reader (button) folded before Flop (didn't bet)



PokerStars Home Game Hand #221068046671: {Club #3225207}  Hold'em No Limit (50/100) - 2020/12/03 18:09:22 ET
Table 'Winifred' 9-max (Play Money) Seat #1 is the button
Seat 1: color_singleton (41900 in chips) 
Seat 2: MnnM150 (6582 in chips) 
Seat 3: dhduncan (6515 in chips) 
Seat 5: Duke Croix (16908 in chips) 
Seat 8: MrOB1reader (2219 in chips) 
MnnM150: posts small blind 50
dhduncan: posts big blind 100
*** HOLE CARDS ***
Dealt to Duke Croix [Qh 6d]
Duke Croix: folds 
MrOB1reader: calls 100
color_singleton: folds 
MnnM150: calls 50
dhduncan: checks 
*** FLOP *** [7h Tc Kc]
MnnM150: checks 
dhduncan: checks 
MrOB1reader: checks 
*** TURN *** [7h Tc Kc] [9s]
MnnM150: checks 
dhduncan: checks 
MrOB1reader: checks 
*** RIVER *** [7h Tc Kc 9s] [7c]
MnnM150: checks 
dhduncan: checks 
MrOB1reader: checks 
*** SHOW DOWN ***
MnnM150: shows [Jc 6c] (a flush, King high)
dhduncan: mucks hand 
MrOB1reader: mucks hand 
MnnM150 collected 283 from pot
*** SUMMARY ***
Total pot 300 | Rake 17 
Board [7h Tc Kc 9s 7c]
Seat 1: color_singleton (button) folded before Flop (didn't bet)
Seat 2: MnnM150 (small blind) showed [Jc 6c] and won (283) with a flush, King high
Seat 3: dhduncan (big blind) mucked [9d 5d]
Seat 5: Duke Croix folded before Flop (didn't bet)
Seat 8: MrOB1reader mucked [Qc Ts]



PokerStars Home Game Hand #221068073477: {Club #3225207}  Hold'em No Limit (50/100) - 2020/12/03 18:10:12 ET
Table 'Winifred' 9-max (Play Money) Seat #2 is the button
Seat 1: color_singleton (41900 in chips) 
Seat 2: MnnM150 (6765 in chips) 
Seat 3: dhduncan (6415 in chips) 
Seat 5: Duke Croix (16908 in chips) 
Seat 8: MrOB1reader (2119 in chips) 
dhduncan: posts small blind 50
Duke Croix: posts big blind 100
*** HOLE CARDS ***
Dealt to Duke Croix [9h Jc]
MrOB1reader: raises 250 to 350
color_singleton: calls 350
MnnM150: calls 350
dhduncan: folds 
Duke Croix: calls 250
*** FLOP *** [Kc 7c 4h]
Duke Croix: checks 
MrOB1reader: bets 685
color_singleton: folds 
MnnM150: folds 
Duke Croix: folds 
Uncalled bet (685) returned to MrOB1reader
MrOB1reader collected 1370 from pot
MrOB1reader: doesn't show hand 
*** SUMMARY ***
Total pot 1450 | Rake 80 
Board [Kc 7c 4h]
Seat 1: color_singleton folded on the Flop
Seat 2: MnnM150 (button) folded on the Flop
Seat 3: dhduncan (small blind) folded before Flop
Seat 5: Duke Croix (big blind) folded on the Flop
Seat 8: MrOB1reader collected (1370)



PokerStars Home Game Hand #221068089778: {Club #3225207}  Hold'em No Limit (50/100) - 2020/12/03 18:10:42 ET
Table 'Winifred' 9-max (Play Money) Seat #3 is the button
Seat 1: color_singleton (41550 in chips) 
Seat 2: MnnM150 (6415 in chips) 
Seat 3: dhduncan (6365 in chips) 
Seat 5: Duke Croix (16558 in chips) 
Seat 8: MrOB1reader (3139 in chips) 
Duke Croix: posts small blind 50
MrOB1reader: posts big blind 100
*** HOLE CARDS ***
Dealt to Duke Croix [9h 5h]
color_singleton: folds 
MnnM150: calls 100
dhduncan: calls 100
Duke Croix: calls 50
MrOB1reader: checks 
*** FLOP *** [3d Ac 3c]
Duke Croix: checks 
MrOB1reader: bets 100
MnnM150: calls 100
dhduncan: calls 100
Duke Croix: folds 
*** TURN *** [3d Ac 3c] [Qc]
MrOB1reader: checks 
MnnM150: checks 
dhduncan: checks 
*** RIVER *** [3d Ac 3c Qc] [2c]
MrOB1reader: bets 661
MnnM150: raises 661 to 1322
dhduncan: folds 
MrOB1reader: calls 661
*** SHOW DOWN ***
MnnM150: shows [6c Ks] (a flush, Ace high)
MrOB1reader: mucks hand 
MnnM150 collected 3160 from pot
*** SUMMARY ***
Total pot 3344 | Rake 184 
Board [3d Ac 3c Qc 2c]
Seat 1: color_singleton folded before Flop (didn't bet)
Seat 2: MnnM150 showed [6c Ks] and won (3160) with a flush, Ace high
Seat 3: dhduncan (button) folded on the River
Seat 5: Duke Croix (small blind) folded on the Flop
Seat 8: MrOB1reader (big blind) mucked [4s 5d]



PokerStars Home Game Hand #221068121901: {Club #3225207}  Hold'em No Limit (50/100) - 2020/12/03 18:11:42 ET
Table 'Winifred' 9-max (Play Money) Seat #5 is the button
Seat 1: color_singleton (41550 in chips) 
Seat 2: MnnM150 (8053 in chips) 
Seat 3: dhduncan (6165 in chips) 
Seat 5: Duke Croix (16458 in chips) 
Seat 8: MrOB1reader (1617 in chips) 
MrOB1reader: posts small blind 50
color_singleton: posts big blind 100
*** HOLE CARDS ***
Dealt to Duke Croix [7s 2c]
MnnM150: calls 100
dhduncan: folds 
Duke Croix: folds 
MrOB1reader: calls 50
color_singleton: raises 300 to 400
MnnM150: calls 300
MrOB1reader: calls 300
*** FLOP *** [Th Qd 3h]
MrOB1reader: bets 1134
color_singleton: folds 
MnnM150: calls 1134
*** TURN *** [Th Qd 3h] [6h]
MrOB1reader: bets 83 and is all-in
MnnM150: calls 83
*** RIVER *** [Th Qd 3h 6h] [4s]
*** SHOW DOWN ***
MrOB1reader: shows [Qc 5s] (a pair of Queens)
MnnM150: shows [Kh Td] (a pair of Tens)
MrOB1reader collected 3434 from pot
*** SUMMARY ***
Total pot 3634 | Rake 200 
Board [Th Qd 3h 6h 4s]
Seat 1: color_singleton (big blind) folded on the Flop
Seat 2: MnnM150 showed [Kh Td] and lost with a pair of Tens
Seat 3: dhduncan folded before Flop (didn't bet)
Seat 5: Duke Croix (button) folded before Flop (didn't bet)
Seat 8: MrOB1reader (small blind) showed [Qc 5s] and won (3434) with a pair of Queens



PokerStars Home Game Hand #221068143250: {Club #3225207}  Hold'em No Limit (50/100) - 2020/12/03 18:12:22 ET
Table 'Winifred' 9-max (Play Money) Seat #8 is the button
Seat 1: color_singleton (41150 in chips) 
Seat 2: MnnM150 (6436 in chips) 
Seat 3: dhduncan (6165 in chips) 
Seat 5: Duke Croix (16458 in chips) 
Seat 8: MrOB1reader (3434 in chips) 
color_singleton: posts small blind 50
MnnM150: posts big blind 100
*** HOLE CARDS ***
Dealt to Duke Croix [Qc 6s]
dhduncan: folds 
Duke Croix: folds 
MrOB1reader: folds 
color_singleton: raises 200 to 300
MnnM150: calls 200
*** FLOP *** [Ks 8s 6d]
color_singleton: checks 
MnnM150: checks 
*** TURN *** [Ks 8s 6d] [7s]
color_singleton: checks 
MnnM150: checks 
*** RIVER *** [Ks 8s 6d 7s] [Js]
color_singleton: bets 283
MnnM150: calls 283
*** SHOW DOWN ***
color_singleton: shows [Ac Jc] (a pair of Jacks)
MnnM150: mucks hand 
color_singleton collected 1102 from pot
*** SUMMARY ***
Total pot 1166 | Rake 64 
Board [Ks 8s 6d 7s Js]
Seat 1: color_singleton (small blind) showed [Ac Jc] and won (1102) with a pair of Jacks
Seat 2: MnnM150 (big blind) mucked [7h 5h]
Seat 3: dhduncan folded before Flop (didn't bet)
Seat 5: Duke Croix folded before Flop (didn't bet)
Seat 8: MrOB1reader (button) folded before Flop (didn't bet)



PokerStars Home Game Hand #221068157972: {Club #3225207}  Hold'em No Limit (50/100) - 2020/12/03 18:12:50 ET
Table 'Winifred' 9-max (Play Money) Seat #1 is the button
Seat 1: color_singleton (41669 in chips) 
Seat 2: MnnM150 (5853 in chips) 
Seat 3: dhduncan (6165 in chips) 
Seat 5: Duke Croix (16458 in chips) 
Seat 8: MrOB1reader (3434 in chips) 
MnnM150: posts small blind 50
dhduncan: posts big blind 100
*** HOLE CARDS ***
Dealt to Duke Croix [Ks 3s]
Duke Croix: calls 100
MrOB1reader: calls 100
color_singleton: folds 
MnnM150: calls 50
dhduncan: checks 
*** FLOP *** [Qd 9d 6h]
MnnM150: checks 
dhduncan: checks 
Duke Croix: checks 
MrOB1reader: bets 378
MnnM150: calls 378
dhduncan: folds 
Duke Croix: folds 
*** TURN *** [Qd 9d 6h] [Td]
MnnM150: checks 
MrOB1reader: bets 546
MnnM150: folds 
Uncalled bet (546) returned to MrOB1reader
MrOB1reader collected 1092 from pot
MrOB1reader: doesn't show hand 
*** SUMMARY ***
Total pot 1156 | Rake 64 
Board [Qd 9d 6h Td]
Seat 1: color_singleton (button) folded before Flop (didn't bet)
Seat 2: MnnM150 (small blind) folded on the Turn
Seat 3: dhduncan (big blind) folded on the Flop
Seat 5: Duke Croix folded on the Flop
Seat 8: MrOB1reader collected (1092)



PokerStars Home Game Hand #221068180896: {Club #3225207}  Hold'em No Limit (50/100) - 2020/12/03 18:13:33 ET
Table 'Winifred' 9-max (Play Money) Seat #2 is the button
Seat 1: color_singleton (41669 in chips) 
Seat 2: MnnM150 (5375 in chips) 
Seat 3: dhduncan (6065 in chips) 
Seat 5: Duke Croix (16358 in chips) 
Seat 8: MrOB1reader (4048 in chips) 
dhduncan: posts small blind 50
Duke Croix: posts big blind 100
*** HOLE CARDS ***
Dealt to Duke Croix [7d 6s]
MrOB1reader: calls 100
color_singleton: raises 200 to 300
MnnM150: calls 300
dhduncan: folds 
Duke Croix: calls 200
MrOB1reader: calls 200
*** FLOP *** [9h 4h 7c]
Duke Croix: checks 
MrOB1reader: bets 590
color_singleton: calls 590
MnnM150: folds 
Duke Croix: folds 
*** TURN *** [9h 4h 7c] [7h]
MrOB1reader: checks 
color_singleton: checks 
*** RIVER *** [9h 4h 7c 7h] [Ks]
MrOB1reader: bets 400
color_singleton: calls 400
*** SHOW DOWN ***
MrOB1reader: shows [5h Th] (a flush, Ten high)
color_singleton: mucks hand 
MrOB1reader collected 3052 from pot
*** SUMMARY ***
Total pot 3230 | Rake 178 
Board [9h 4h 7c 7h Ks]
Seat 1: color_singleton mucked [As Td]
Seat 2: MnnM150 (button) folded on the Flop
Seat 3: dhduncan (small blind) folded before Flop
Seat 5: Duke Croix (big blind) folded on the Flop
Seat 8: MrOB1reader showed [5h Th] and won (3052) with a flush, Ten high



PokerStars Home Game Hand #221068223521: {Club #3225207}  Hold'em No Limit (50/100) - 2020/12/03 18:14:47 ET
Table 'Winifred' 9-max (Play Money) Seat #3 is the button
Seat 1: color_singleton (40379 in chips) 
Seat 2: MnnM150 (5075 in chips) 
Seat 3: dhduncan (6015 in chips) 
Seat 5: Duke Croix (16058 in chips) 
Seat 8: MrOB1reader (5810 in chips) 
Duke Croix: posts small blind 50
MrOB1reader: posts big blind 100
*** HOLE CARDS ***
Dealt to Duke Croix [8h Ad]
color_singleton: folds 
MnnM150: calls 100
dhduncan: folds 
Duke Croix: raises 200 to 300
MrOB1reader: calls 200
MnnM150: calls 200
*** FLOP *** [6d Js Ks]
Duke Croix: checks 
MrOB1reader: checks 
MnnM150: checks 
*** TURN *** [6d Js Ks] [2c]
Duke Croix: checks 
MrOB1reader: checks 
MnnM150: bets 100
Duke Croix: folds 
MrOB1reader: folds 
Uncalled bet (100) returned to MnnM150
MnnM150 collected 850 from pot
*** SUMMARY ***
Total pot 900 | Rake 50 
Board [6d Js Ks 2c]
Seat 1: color_singleton folded before Flop (didn't bet)
Seat 2: MnnM150 collected (850)
Seat 3: dhduncan (button) folded before Flop (didn't bet)
Seat 5: Duke Croix (small blind) folded on the Turn
Seat 8: MrOB1reader (big blind) folded on the Turn



PokerStars Home Game Hand #221068247825: {Club #3225207}  Hold'em No Limit (50/100) - 2020/12/03 18:15:33 ET
Table 'Winifred' 9-max (Play Money) Seat #5 is the button
Seat 1: color_singleton (40379 in chips) 
Seat 2: MnnM150 (5625 in chips) 
Seat 3: dhduncan (6015 in chips) 
Seat 5: Duke Croix (15758 in chips) 
Seat 8: MrOB1reader (5510 in chips) 
MrOB1reader: posts small blind 50
color_singleton: posts big blind 100
*** HOLE CARDS ***
Dealt to Duke Croix [Qd 5d]
MnnM150: folds 
dhduncan: folds 
Duke Croix: folds 
MrOB1reader: calls 50
color_singleton: checks 
*** FLOP *** [Jd 9c 3d]
MrOB1reader: checks 
color_singleton: checks 
*** TURN *** [Jd 9c 3d] [7h]
MrOB1reader: bets 100
color_singleton: folds 
Uncalled bet (100) returned to MrOB1reader
MrOB1reader collected 189 from pot
MrOB1reader: doesn't show hand 
*** SUMMARY ***
Total pot 200 | Rake 11 
Board [Jd 9c 3d 7h]
Seat 1: color_singleton (big blind) folded on the Turn
Seat 2: MnnM150 folded before Flop (didn't bet)
Seat 3: dhduncan folded before Flop (didn't bet)
Seat 5: Duke Croix (button) folded before Flop (didn't bet)
Seat 8: MrOB1reader (small blind) collected (189)



PokerStars Home Game Hand #221068261701: {Club #3225207}  Hold'em No Limit (50/100) - 2020/12/03 18:16:00 ET
Table 'Winifred' 9-max (Play Money) Seat #8 is the button
Seat 1: color_singleton (40279 in chips) 
Seat 2: MnnM150 (5625 in chips) 
Seat 3: dhduncan (6015 in chips) 
Seat 5: Duke Croix (15758 in chips) 
Seat 8: MrOB1reader (5599 in chips) 
color_singleton: posts small blind 50
MnnM150: posts big blind 100
*** HOLE CARDS ***
Dealt to Duke Croix [5c 7s]
dhduncan: folds 
Duke Croix: folds 
MrOB1reader: raises 100 to 200
color_singleton: folds 
MnnM150: folds 
Uncalled bet (100) returned to MrOB1reader
MrOB1reader collected 250 from pot
MrOB1reader: doesn't show hand 
*** SUMMARY ***
Total pot 250 | Rake 0 
Seat 1: color_singleton (small blind) folded before Flop
Seat 2: MnnM150 (big blind) folded before Flop
Seat 3: dhduncan folded before Flop (didn't bet)
Seat 5: Duke Croix folded before Flop (didn't bet)
Seat 8: MrOB1reader (button) collected (250)



PokerStars Home Game Hand #221068267717: {Club #3225207}  Hold'em No Limit (50/100) - 2020/12/03 18:16:11 ET
Table 'Winifred' 9-max (Play Money) Seat #1 is the button
Seat 1: color_singleton (40229 in chips) 
Seat 2: MnnM150 (5525 in chips) 
Seat 3: dhduncan (6015 in chips) 
Seat 5: Duke Croix (15758 in chips) 
Seat 8: MrOB1reader (5749 in chips) 
MnnM150: posts small blind 50
dhduncan: posts big blind 100
*** HOLE CARDS ***
Dealt to Duke Croix [7d 5s]
Duke Croix: folds 
MrOB1reader: calls 100
color_singleton: raises 100 to 200
MnnM150: calls 150
dhduncan: folds 
MrOB1reader: calls 100
*** FLOP *** [8d Td 3c]
MnnM150: checks 
MrOB1reader: checks 
color_singleton: checks 
*** TURN *** [8d Td 3c] [7h]
MnnM150: checks 
MrOB1reader: checks 
color_singleton: bets 330
MnnM150: folds 
MrOB1reader: folds 
Uncalled bet (330) returned to color_singleton
color_singleton collected 661 from pot
color_singleton: doesn't show hand 
*** SUMMARY ***
Total pot 700 | Rake 39 
Board [8d Td 3c 7h]
Seat 1: color_singleton (button) collected (661)
Seat 2: MnnM150 (small blind) folded on the Turn
Seat 3: dhduncan (big blind) folded before Flop
Seat 5: Duke Croix folded before Flop (didn't bet)
Seat 8: MrOB1reader folded on the Turn



PokerStars Home Game Hand #221068287792: {Club #3225207}  Hold'em No Limit (50/100) - 2020/12/03 18:16:49 ET
Table 'Winifred' 9-max (Play Money) Seat #2 is the button
Seat 1: color_singleton (40690 in chips) 
Seat 2: MnnM150 (5325 in chips) 
Seat 3: dhduncan (5915 in chips) 
Seat 5: Duke Croix (15758 in chips) 
Seat 8: MrOB1reader (5549 in chips) 
dhduncan: posts small blind 50
Duke Croix: posts big blind 100
*** HOLE CARDS ***
Dealt to Duke Croix [3h 3s]
MrOB1reader: calls 100
color_singleton: folds 
MnnM150: folds 
dhduncan: calls 50
Duke Croix: checks 
*** FLOP *** [Ts Ah Jh]
dhduncan: checks 
Duke Croix: checks 
MrOB1reader: checks 
*** TURN *** [Ts Ah Jh] [Jd]
dhduncan: checks 
Duke Croix: checks 
MrOB1reader: checks 
*** RIVER *** [Ts Ah Jh Jd] [2c]
dhduncan: checks 
Duke Croix: checks 
MrOB1reader: checks 
*** SHOW DOWN ***
dhduncan: shows [Qs 5s] (a pair of Jacks)
Duke Croix: shows [3h 3s] (two pair, Jacks and Threes)
MrOB1reader: mucks hand 
Duke Croix collected 283 from pot
*** SUMMARY ***
Total pot 300 | Rake 17 
Board [Ts Ah Jh Jd 2c]
Seat 1: color_singleton folded before Flop (didn't bet)
Seat 2: MnnM150 (button) folded before Flop (didn't bet)
Seat 3: dhduncan (small blind) showed [Qs 5s] and lost with a pair of Jacks
Seat 5: Duke Croix (big blind) showed [3h 3s] and won (283) with two pair, Jacks and Threes
Seat 8: MrOB1reader mucked [3c 4s]



PokerStars Home Game Hand #221068316126: {Club #3225207}  Hold'em No Limit (50/100) - 2020/12/03 18:17:43 ET
Table 'Winifred' 9-max (Play Money) Seat #3 is the button
Seat 1: color_singleton (40690 in chips) 
Seat 2: MnnM150 (5325 in chips) 
Seat 3: dhduncan (5815 in chips) 
Seat 5: Duke Croix (15941 in chips) 
Seat 8: MrOB1reader (5449 in chips) 
Duke Croix: posts small blind 50
MrOB1reader: posts big blind 100
*** HOLE CARDS ***
Dealt to Duke Croix [2d Tc]
color_singleton: folds 
MnnM150: calls 100
dhduncan: folds 
Duke Croix: folds 
MrOB1reader: checks 
*** FLOP *** [Ah 8s 6s]
MrOB1reader: checks 
MnnM150: checks 
*** TURN *** [Ah 8s 6s] [Ks]
MrOB1reader: checks 
MnnM150: checks 
*** RIVER *** [Ah 8s 6s Ks] [9c]
MrOB1reader: checks 
MnnM150: checks 
*** SHOW DOWN ***
MrOB1reader: shows [2c 7d] (high card Ace)
MnnM150: shows [Td Qs] (high card Ace - King+Queen kicker)
MnnM150 collected 236 from pot
*** SUMMARY ***
Total pot 250 | Rake 14 
Board [Ah 8s 6s Ks 9c]
Seat 1: color_singleton folded before Flop (didn't bet)
Seat 2: MnnM150 showed [Td Qs] and won (236) with high card Ace
Seat 3: dhduncan (button) folded before Flop (didn't bet)
Seat 5: Duke Croix (small blind) folded before Flop
Seat 8: MrOB1reader (big blind) showed [2c 7d] and lost with high card Ace



PokerStars Home Game Hand #221068334672: {Club #3225207}  Hold'em No Limit (50/100) - 2020/12/03 18:18:18 ET
Table 'Winifred' 9-max (Play Money) Seat #5 is the button
Seat 1: color_singleton (40690 in chips) 
Seat 2: MnnM150 (5461 in chips) 
Seat 3: dhduncan (5815 in chips) 
Seat 5: Duke Croix (15891 in chips) 
Seat 8: MrOB1reader (5349 in chips) 
MrOB1reader: posts small blind 50
color_singleton: posts big blind 100
*** HOLE CARDS ***
Dealt to Duke Croix [Kc 5h]
MnnM150: folds 
dhduncan: calls 100
Duke Croix: folds 
MrOB1reader: calls 50
color_singleton: raises 200 to 300
dhduncan: calls 200
MrOB1reader: calls 200
*** FLOP *** [3s 2h 4h]
MrOB1reader: checks 
color_singleton: bets 850
dhduncan: folds 
MrOB1reader: folds 
Uncalled bet (850) returned to color_singleton
color_singleton collected 850 from pot
color_singleton: doesn't show hand 
*** SUMMARY ***
Total pot 900 | Rake 50 
Board [3s 2h 4h]
Seat 1: color_singleton (big blind) collected (850)
Seat 2: MnnM150 folded before Flop (didn't bet)
Seat 3: dhduncan folded on the Flop
Seat 5: Duke Croix (button) folded before Flop (didn't bet)
Seat 8: MrOB1reader (small blind) folded on the Flop



PokerStars Home Game Hand #221068348953: {Club #3225207}  Hold'em No Limit (50/100) - 2020/12/03 18:18:45 ET
Table 'Winifred' 9-max (Play Money) Seat #8 is the button
Seat 1: color_singleton (41240 in chips) 
Seat 2: MnnM150 (5461 in chips) 
Seat 3: dhduncan (5515 in chips) 
Seat 5: Duke Croix (15891 in chips) 
Seat 8: MrOB1reader (5049 in chips) 
color_singleton: posts small blind 50
MnnM150: posts big blind 100
*** HOLE CARDS ***
Dealt to Duke Croix [3d Ad]
dhduncan: calls 100
Duke Croix: raises 200 to 300
MrOB1reader: folds 
color_singleton: calls 250
MnnM150: folds 
dhduncan: calls 200
*** FLOP *** [2h 2s 6c]
color_singleton: checks 
dhduncan: checks 
Duke Croix: checks 
*** TURN *** [2h 2s 6c] [4c]
color_singleton: checks 
dhduncan: checks 
Duke Croix: bets 500
color_singleton: calls 500
dhduncan: folds 
*** RIVER *** [2h 2s 6c 4c] [Ks]
color_singleton: checks 
Duke Croix: bets 1000
color_singleton: folds 
Uncalled bet (1000) returned to Duke Croix
Duke Croix collected 1890 from pot
*** SUMMARY ***
Total pot 2000 | Rake 110 
Board [2h 2s 6c 4c Ks]
Seat 1: color_singleton (small blind) folded on the River
Seat 2: MnnM150 (big blind) folded before Flop
Seat 3: dhduncan folded on the Turn
Seat 5: Duke Croix collected (1890)
Seat 8: MrOB1reader (button) folded before Flop (didn't bet)



PokerStars Home Game Hand #221068367646: {Club #3225207}  Hold'em No Limit (50/100) - 2020/12/03 18:19:22 ET
Table 'Winifred' 9-max (Play Money) Seat #1 is the button
Seat 1: color_singleton (40440 in chips) 
Seat 2: MnnM150 (5361 in chips) 
Seat 3: dhduncan (5215 in chips) 
Seat 5: Duke Croix (16981 in chips) 
Seat 8: MrOB1reader (5049 in chips) 
MnnM150: posts small blind 50
dhduncan: posts big blind 100
*** HOLE CARDS ***
Dealt to Duke Croix [7d Kc]
Duke Croix: calls 100
MrOB1reader: raises 100 to 200
color_singleton: calls 200
MnnM150: calls 150
dhduncan: folds 
Duke Croix: calls 100
*** FLOP *** [As 2d 6h]
MnnM150: checks 
Duke Croix: checks 
MrOB1reader: checks 
color_singleton: bets 425
MnnM150: calls 425
Duke Croix: folds 
MrOB1reader: folds 
*** TURN *** [As 2d 6h] [Th]
MnnM150: checks 
color_singleton: bets 827
MnnM150: calls 827
*** RIVER *** [As 2d 6h Th] [7c]
MnnM150: checks 
color_singleton: checks 
*** SHOW DOWN ***
MnnM150: shows [3s 4s] (high card Ace)
color_singleton: shows [9d Ah] (a pair of Aces)
color_singleton collected 3217 from pot
*** SUMMARY ***
Total pot 3404 | Rake 187 
Board [As 2d 6h Th 7c]
Seat 1: color_singleton (button) showed [9d Ah] and won (3217) with a pair of Aces
Seat 2: MnnM150 (small blind) showed [3s 4s] and lost with high card Ace
Seat 3: dhduncan (big blind) folded before Flop
Seat 5: Duke Croix folded on the Flop
Seat 8: MrOB1reader folded on the Flop



PokerStars Home Game Hand #221068395548: {Club #3225207}  Hold'em No Limit (50/100) - 2020/12/03 18:20:16 ET
Table 'Winifred' 9-max (Play Money) Seat #2 is the button
Seat 1: color_singleton (42205 in chips) 
Seat 2: MnnM150 (3909 in chips) 
Seat 3: dhduncan (5115 in chips) 
Seat 5: Duke Croix (16781 in chips) 
Seat 8: MrOB1reader (4849 in chips) 
dhduncan: posts small blind 50
Duke Croix: posts big blind 100
*** HOLE CARDS ***
Dealt to Duke Croix [Jh 3s]
MrOB1reader: folds 
color_singleton: raises 100 to 200
MnnM150: folds 
dhduncan: calls 150
Duke Croix: calls 100
*** FLOP *** [2s Td 8c]
dhduncan: bets 283
Duke Croix: folds 
color_singleton: calls 283
*** TURN *** [2s Td 8c] [Tc]
dhduncan: bets 551
color_singleton: folds 
Uncalled bet (551) returned to dhduncan
dhduncan collected 1102 from pot
dhduncan: doesn't show hand 
*** SUMMARY ***
Total pot 1166 | Rake 64 
Board [2s Td 8c Tc]
Seat 1: color_singleton folded on the Turn
Seat 2: MnnM150 (button) folded before Flop (didn't bet)
Seat 3: dhduncan (small blind) collected (1102)
Seat 5: Duke Croix (big blind) folded on the Flop
Seat 8: MrOB1reader folded before Flop (didn't bet)



PokerStars Home Game Hand #221068414616: {Club #3225207}  Hold'em No Limit (50/100) - 2020/12/03 18:20:53 ET
Table 'Winifred' 9-max (Play Money) Seat #3 is the button
Seat 1: color_singleton (41722 in chips) 
Seat 2: MnnM150 (3909 in chips) 
Seat 3: dhduncan (5734 in chips) 
Seat 5: Duke Croix (16581 in chips) 
Seat 8: MrOB1reader (4849 in chips) 
Duke Croix: posts small blind 50
MrOB1reader: posts big blind 100
*** HOLE CARDS ***
Dealt to Duke Croix [3d 9h]
color_singleton: folds 
MnnM150: calls 100
dhduncan: calls 100
Duke Croix: folds 
MrOB1reader: checks 
*** FLOP *** [7c Qc Tc]
MrOB1reader: checks 
MnnM150: checks 
dhduncan: checks 
*** TURN *** [7c Qc Tc] [5h]
MrOB1reader: checks 
MnnM150: checks 
dhduncan: checks 
*** RIVER *** [7c Qc Tc 5h] [6c]
MrOB1reader: bets 100
MnnM150: calls 100
dhduncan: raises 100 to 200
MrOB1reader: calls 100
MnnM150: calls 100
*** SHOW DOWN ***
dhduncan: shows [8c Ad] (a flush, Queen high)
MrOB1reader: mucks hand 
MnnM150: mucks hand 
dhduncan collected 898 from pot
*** SUMMARY ***
Total pot 950 | Rake 52 
Board [7c Qc Tc 5h 6c]
Seat 1: color_singleton folded before Flop (didn't bet)
Seat 2: MnnM150 mucked [7h Kd]
Seat 3: dhduncan (button) showed [8c Ad] and won (898) with a flush, Queen high
Seat 5: Duke Croix (small blind) folded before Flop
Seat 8: MrOB1reader (big blind) mucked [Td 6d]



PokerStars Home Game Hand #221068431222: {Club #3225207}  Hold'em No Limit (50/100) - 2020/12/03 18:21:26 ET
Table 'Winifred' 9-max (Play Money) Seat #5 is the button
Seat 1: color_singleton (41722 in chips) 
Seat 2: MnnM150 (3609 in chips) 
Seat 3: dhduncan (6332 in chips) 
Seat 5: Duke Croix (16531 in chips) 
Seat 8: MrOB1reader (4549 in chips) 
MrOB1reader: posts small blind 50
color_singleton: posts big blind 100
*** HOLE CARDS ***
Dealt to Duke Croix [Th 6d]
MnnM150: folds 
dhduncan: calls 100
Duke Croix: folds 
MrOB1reader: raises 100 to 200
color_singleton: calls 100
dhduncan: calls 100
*** FLOP *** [5d Qh 4h]
MrOB1reader: checks 
color_singleton: checks 
dhduncan: bets 100
MrOB1reader: calls 100
color_singleton: raises 100 to 200
dhduncan: calls 100
MrOB1reader: raises 100 to 300
color_singleton: raises 100 to 400
dhduncan: calls 200
MrOB1reader: raises 100 to 500
color_singleton: raises 500 to 1000
dhduncan: calls 600
MrOB1reader: raises 3349 to 4349 and is all-in
color_singleton: calls 3349
dhduncan: calls 3349
*** TURN *** [5d Qh 4h] [5h]
color_singleton: bets 12896
dhduncan: calls 1783 and is all-in
Uncalled bet (11113) returned to color_singleton
*** RIVER *** [5d Qh 4h 5h] [6c]
*** SHOW DOWN ***
color_singleton: shows [4c 4d] (a full house, Fours full of Fives)
dhduncan: shows [2h Ah] (a flush, Ace high)
color_singleton collected 3370 from side pot
MrOB1reader: shows [Ks Kd] (two pair, Kings and Fives)
color_singleton collected 12896 from main pot
*** SUMMARY ***
Total pot 17213 Main pot 12896. Side pot 3370. | Rake 947 
Board [5d Qh 4h 5h 6c]
Seat 1: color_singleton (big blind) showed [4c 4d] and won (16266) with a full house, Fours full of Fives
Seat 2: MnnM150 folded before Flop (didn't bet)
Seat 3: dhduncan showed [2h Ah] and lost with a flush, Ace high
Seat 5: Duke Croix (button) folded before Flop (didn't bet)
Seat 8: MrOB1reader (small blind) showed [Ks Kd] and lost with two pair, Kings and Fives



PokerStars Home Game Hand #221068466928: {Club #3225207}  Hold'em No Limit (50/100) - 2020/12/03 18:22:36 ET
Table 'Winifred' 9-max (Play Money) Seat #1 is the button
Seat 1: color_singleton (51656 in chips) 
Seat 2: MnnM150 (3609 in chips) 
Seat 5: Duke Croix (16531 in chips) 
MnnM150: posts small blind 50
Duke Croix: posts big blind 100
*** HOLE CARDS ***
Dealt to Duke Croix [8c Ks]
color_singleton: folds 
MnnM150 has timed out
MnnM150: folds 
Uncalled bet (50) returned to Duke Croix
Duke Croix collected 100 from pot
*** SUMMARY ***
Total pot 100 | Rake 0 
Seat 1: color_singleton (button) folded before Flop (didn't bet)
Seat 2: MnnM150 (small blind) folded before Flop
Seat 5: Duke Croix (big blind) collected (100)



PokerStars Home Game Hand #221068481079: {Club #3225207}  Hold'em No Limit (50/100) - 2020/12/03 18:23:04 ET
Table 'Winifred' 9-max (Play Money) Seat #5 is the button
Seat 1: color_singleton (51656 in chips) 
Seat 3: dhduncan (10000 in chips) 
Seat 5: Duke Croix (16581 in chips) 
color_singleton: posts small blind 50
dhduncan: posts big blind 100
*** HOLE CARDS ***
Dealt to Duke Croix [2c 4h]
Duke Croix: folds 
color_singleton: raises 200 to 300
dhduncan: calls 200
*** FLOP *** [Qc 5d 5h]
color_singleton: checks 
dhduncan: checks 
*** TURN *** [Qc 5d 5h] [Ac]
color_singleton: bets 567
dhduncan: calls 567
*** RIVER *** [Qc 5d 5h Ac] [Js]
color_singleton: checks 
dhduncan: checks 
*** SHOW DOWN ***
color_singleton: shows [Ah 8d] (two pair, Aces and Fives)
dhduncan: shows [Kc As] (two pair, Aces and Fives - King kicker)
dhduncan collected 1639 from pot
*** SUMMARY ***
Total pot 1734 | Rake 95 
Board [Qc 5d 5h Ac Js]
Seat 1: color_singleton (small blind) showed [Ah 8d] and lost with two pair, Aces and Fives
Seat 3: dhduncan (big blind) showed [Kc As] and won (1639) with two pair, Aces and Fives
Seat 5: Duke Croix (button) folded before Flop (didn't bet)



PokerStars Home Game Hand #221068494748: {Club #3225207}  Hold'em No Limit (50/100) - 2020/12/03 18:23:31 ET
Table 'Winifred' 9-max (Play Money) Seat #1 is the button
Seat 1: color_singleton (50789 in chips) 
Seat 3: dhduncan (10772 in chips) 
Seat 5: Duke Croix (16581 in chips) 
dhduncan: posts small blind 50
Duke Croix: posts big blind 100
*** HOLE CARDS ***
Dealt to Duke Croix [2c 9c]
color_singleton: folds 
dhduncan: folds 
Uncalled bet (50) returned to Duke Croix
Duke Croix collected 100 from pot
*** SUMMARY ***
Total pot 100 | Rake 0 
Seat 1: color_singleton (button) folded before Flop (didn't bet)
Seat 3: dhduncan (small blind) folded before Flop
Seat 5: Duke Croix (big blind) collected (100)



PokerStars Home Game Hand #221068503372: {Club #3225207}  Hold'em No Limit (50/100) - 2020/12/03 18:23:48 ET
Table 'Winifred' 9-max (Play Money) Seat #3 is the button
Seat 1: color_singleton (50789 in chips) 
Seat 3: dhduncan (10722 in chips) 
Seat 5: Duke Croix (16631 in chips) 
Seat 8: MrOB1reader (10000 in chips) 
Duke Croix: posts small blind 50
MrOB1reader: posts big blind 100
*** HOLE CARDS ***
Dealt to Duke Croix [9s 6h]
color_singleton: raises 200 to 300
dhduncan: folds 
Duke Croix: folds 
MrOB1reader: calls 200
*** FLOP *** [5h Kd 9d]
MrOB1reader: bets 100
color_singleton: folds 
Uncalled bet (100) returned to MrOB1reader
MrOB1reader collected 614 from pot
MrOB1reader: doesn't show hand 
*** SUMMARY ***
Total pot 650 | Rake 36 
Board [5h Kd 9d]
Seat 1: color_singleton folded on the Flop
Seat 3: dhduncan (button) folded before Flop (didn't bet)
Seat 5: Duke Croix (small blind) folded before Flop
Seat 8: MrOB1reader (big blind) collected (614)



PokerStars Home Game Hand #221068525553: {Club #3225207}  Hold'em No Limit (50/100) - 2020/12/03 18:24:16 ET
Table 'Winifred' 9-max (Play Money) Seat #5 is the button
Seat 1: color_singleton (50489 in chips) 
Seat 3: dhduncan (10722 in chips) 
Seat 5: Duke Croix (16581 in chips) 
Seat 8: MrOB1reader (10314 in chips) 
MrOB1reader: posts small blind 50
color_singleton: posts big blind 100
*** HOLE CARDS ***
Dealt to Duke Croix [Td Ac]
dhduncan: raises 100 to 200
Duke Croix: raises 200 to 400
MrOB1reader: calls 350
color_singleton: calls 300
dhduncan: raises 200 to 600
Duke Croix: calls 200
MrOB1reader: folds 
color_singleton: calls 200
*** FLOP *** [Kh 2c 9c]
color_singleton: checks 
dhduncan: bets 2079
Duke Croix: folds 
color_singleton: folds 
Uncalled bet (2079) returned to dhduncan
dhduncan collected 2079 from pot
dhduncan: doesn't show hand 
*** SUMMARY ***
Total pot 2200 | Rake 121 
Board [Kh 2c 9c]
Seat 1: color_singleton (big blind) folded on the Flop
Seat 3: dhduncan collected (2079)
Seat 5: Duke Croix (button) folded on the Flop
Seat 8: MrOB1reader (small blind) folded before Flop



PokerStars Home Game Hand #221068546230: {Club #3225207}  Hold'em No Limit (50/100) - 2020/12/03 18:24:56 ET
Table 'Winifred' 9-max (Play Money) Seat #8 is the button
Seat 1: color_singleton (49889 in chips) 
Seat 2: MnnM150 (3559 in chips) 
Seat 3: dhduncan (12201 in chips) 
Seat 5: Duke Croix (15981 in chips) 
Seat 8: MrOB1reader (9914 in chips) 
color_singleton: posts small blind 50
MnnM150: posts big blind 100
*** HOLE CARDS ***
Dealt to Duke Croix [6s 9c]
dhduncan: calls 100
Duke Croix: folds 
MrOB1reader: raises 100 to 200
color_singleton: raises 100 to 300
MnnM150: folds 
dhduncan: calls 200
MrOB1reader: raises 100 to 400
color_singleton: calls 100
dhduncan: calls 100
*** FLOP *** [Td 8h 8d]
color_singleton: checks 
dhduncan: bets 100
MrOB1reader: calls 100
color_singleton: calls 100
*** TURN *** [Td 8h 8d] [Kc]
color_singleton: checks 
dhduncan: bets 100
MrOB1reader: calls 100
color_singleton: calls 100
*** RIVER *** [Td 8h 8d Kc] [Ks]
color_singleton: checks 
dhduncan: checks 
MrOB1reader: checks 
*** SHOW DOWN ***
color_singleton: shows [4c Ah] (two pair, Kings and Eights)
dhduncan: shows [Qd Ad] (two pair, Kings and Eights)
MrOB1reader: shows [Qs Ac] (two pair, Kings and Eights)
color_singleton collected 599 from pot
dhduncan collected 598 from pot
MrOB1reader collected 598 from pot
*** SUMMARY ***
Total pot 1900 | Rake 105 
Board [Td 8h 8d Kc Ks]
Seat 1: color_singleton (small blind) showed [4c Ah] and won (599) with two pair, Kings and Eights
Seat 2: MnnM150 (big blind) folded before Flop
Seat 3: dhduncan showed [Qd Ad] and won (598) with two pair, Kings and Eights
Seat 5: Duke Croix folded before Flop (didn't bet)
Seat 8: MrOB1reader (button) showed [Qs Ac] and won (598) with two pair, Kings and Eights



PokerStars Home Game Hand #221068576330: {Club #3225207}  Hold'em No Limit (50/100) - 2020/12/03 18:25:55 ET
Table 'Winifred' 9-max (Play Money) Seat #1 is the button
Seat 1: color_singleton (49888 in chips) 
Seat 2: MnnM150 (3459 in chips) 
Seat 3: dhduncan (12199 in chips) 
Seat 5: Duke Croix (15981 in chips) 
Seat 8: MrOB1reader (9912 in chips) 
MnnM150: posts small blind 50
dhduncan: posts big blind 100
*** HOLE CARDS ***
Dealt to Duke Croix [5c Th]
Duke Croix: folds 
MrOB1reader: raises 100 to 200
color_singleton: calls 200
MnnM150: calls 150
dhduncan: calls 100
*** FLOP *** [2h 6c Td]
MnnM150: checks 
dhduncan: checks 
MrOB1reader: bets 378
color_singleton: folds 
MnnM150: folds 
dhduncan: folds 
Uncalled bet (378) returned to MrOB1reader
MrOB1reader collected 756 from pot
MrOB1reader: doesn't show hand 
*** SUMMARY ***
Total pot 800 | Rake 44 
Board [2h 6c Td]
Seat 1: color_singleton (button) folded on the Flop
Seat 2: MnnM150 (small blind) folded on the Flop
Seat 3: dhduncan (big blind) folded on the Flop
Seat 5: Duke Croix folded before Flop (didn't bet)
Seat 8: MrOB1reader collected (756)



PokerStars Home Game Hand #221068590703: {Club #3225207}  Hold'em No Limit (50/100) - 2020/12/03 18:26:24 ET
Table 'Winifred' 9-max (Play Money) Seat #2 is the button
Seat 1: color_singleton (49688 in chips) 
Seat 2: MnnM150 (3259 in chips) 
Seat 3: dhduncan (11999 in chips) 
Seat 5: Duke Croix (15981 in chips) 
Seat 8: MrOB1reader (10468 in chips) 
dhduncan: posts small blind 50
Duke Croix: posts big blind 100
*** HOLE CARDS ***
Dealt to Duke Croix [4s Qd]
MrOB1reader: calls 100
color_singleton: folds 
MnnM150: calls 100
dhduncan: calls 50
Duke Croix: checks 
*** FLOP *** [9h Jh Tc]
dhduncan: checks 
Duke Croix: checks 
MrOB1reader: bets 100
MnnM150: calls 100
dhduncan: folds 
Duke Croix: calls 100
*** TURN *** [9h Jh Tc] [Td]
Duke Croix: bets 300
MrOB1reader: calls 300
MnnM150: calls 300
*** RIVER *** [9h Jh Tc Td] [Kh]
Duke Croix: bets 900
MrOB1reader: raises 900 to 1800
MnnM150: folds 
Duke Croix: calls 900
*** SHOW DOWN ***
MrOB1reader: shows [Qh 2d] (a straight, Nine to King)
Duke Croix: shows [4s Qd] (a straight, Nine to King)
Duke Croix collected 2457 from pot
MrOB1reader collected 2457 from pot
*** SUMMARY ***
Total pot 5200 | Rake 286 
Board [9h Jh Tc Td Kh]
Seat 1: color_singleton folded before Flop (didn't bet)
Seat 2: MnnM150 (button) folded on the River
Seat 3: dhduncan (small blind) folded on the Flop
Seat 5: Duke Croix (big blind) showed [4s Qd] and won (2457) with a straight, Nine to King
Seat 8: MrOB1reader showed [Qh 2d] and won (2457) with a straight, Nine to King



PokerStars Home Game Hand #221068613443: {Club #3225207}  Hold'em No Limit (50/100) - 2020/12/03 18:27:08 ET
Table 'Winifred' 9-max (Play Money) Seat #3 is the button
Seat 1: color_singleton (49688 in chips) 
Seat 2: MnnM150 (2759 in chips) 
Seat 3: dhduncan (11899 in chips) 
Seat 5: Duke Croix (16138 in chips) 
Seat 8: MrOB1reader (10625 in chips) 
Duke Croix: posts small blind 50
MrOB1reader: posts big blind 100
*** HOLE CARDS ***
Dealt to Duke Croix [8h 6s]
color_singleton: raises 100 to 200
MnnM150: calls 200
dhduncan: calls 200
Duke Croix: folds 
MrOB1reader: calls 100
*** FLOP *** [9h 3c As]
MrOB1reader: checks 
color_singleton: checks 
MnnM150: bets 401
dhduncan: calls 401
MrOB1reader: folds 
color_singleton: folds 
*** TURN *** [9h 3c As] [Th]
MnnM150: bets 780
dhduncan: calls 780
*** RIVER *** [9h 3c As Th] [7c]
MnnM150: bets 1378 and is all-in
dhduncan: calls 1378
*** SHOW DOWN ***
MnnM150: shows [9d 9c] (three of a kind, Nines)
dhduncan: shows [7s Ah] (two pair, Aces and Sevens)
MnnM150 collected 5640 from pot
*** SUMMARY ***
Total pot 5968 | Rake 328 
Board [9h 3c As Th 7c]
Seat 1: color_singleton folded on the Flop
Seat 2: MnnM150 showed [9d 9c] and won (5640) with three of a kind, Nines
Seat 3: dhduncan (button) showed [7s Ah] and lost with two pair, Aces and Sevens
Seat 5: Duke Croix (small blind) folded before Flop
Seat 8: MrOB1reader (big blind) folded on the Flop



PokerStars Home Game Hand #221068650849: {Club #3225207}  Hold'em No Limit (50/100) - 2020/12/03 18:28:22 ET
Table 'Winifred' 9-max (Play Money) Seat #5 is the button
Seat 1: color_singleton (49488 in chips) 
Seat 2: MnnM150 (5640 in chips) 
Seat 3: dhduncan (9140 in chips) 
Seat 5: Duke Croix (16088 in chips) 
Seat 8: MrOB1reader (10425 in chips) 
MrOB1reader: posts small blind 50
color_singleton: posts big blind 100
*** HOLE CARDS ***
Dealt to Duke Croix [3h 9s]
MnnM150: calls 100
dhduncan: calls 100
Duke Croix: folds 
MrOB1reader: calls 50
color_singleton: checks 
*** FLOP *** [Td Ac Jd]
MrOB1reader: checks 
color_singleton: checks 
MnnM150: bets 189
dhduncan: folds 
MrOB1reader: folds 
color_singleton: folds 
Uncalled bet (189) returned to MnnM150
MnnM150 collected 378 from pot
*** SUMMARY ***
Total pot 400 | Rake 22 
Board [Td Ac Jd]
Seat 1: color_singleton (big blind) folded on the Flop
Seat 2: MnnM150 collected (378)
Seat 3: dhduncan folded on the Flop
Seat 5: Duke Croix (button) folded before Flop (didn't bet)
Seat 8: MrOB1reader (small blind) folded on the Flop



PokerStars Home Game Hand #221068663760: {Club #3225207}  Hold'em No Limit (50/100) - 2020/12/03 18:28:48 ET
Table 'Winifred' 9-max (Play Money) Seat #8 is the button
Seat 1: color_singleton (49388 in chips) 
Seat 2: MnnM150 (5918 in chips) 
Seat 3: dhduncan (9040 in chips) 
Seat 5: Duke Croix (16088 in chips) 
Seat 8: MrOB1reader (10325 in chips) 
color_singleton: posts small blind 50
MnnM150: posts big blind 100
*** HOLE CARDS ***
Dealt to Duke Croix [Ad 4d]
dhduncan: folds 
Duke Croix: raises 300 to 400
MrOB1reader: calls 400
color_singleton: folds 
MnnM150: raises 300 to 700
Duke Croix: calls 300
MrOB1reader: calls 300
*** FLOP *** [Ks Kd 7c]
MnnM150: checks 
Duke Croix: checks 
MrOB1reader: checks 
*** TURN *** [Ks Kd 7c] [Jc]
MnnM150: checks 
Duke Croix: checks 
MrOB1reader: bets 100
MnnM150: calls 100
Duke Croix: calls 100
*** RIVER *** [Ks Kd 7c Jc] [4h]
MnnM150: checks 
Duke Croix: bets 1000
MrOB1reader: raises 1000 to 2000
MnnM150: folds 
Duke Croix: folds 
Uncalled bet (1000) returned to MrOB1reader
MrOB1reader collected 4205 from pot
MrOB1reader: doesn't show hand 
*** SUMMARY ***
Total pot 4450 | Rake 245 
Board [Ks Kd 7c Jc 4h]
Seat 1: color_singleton (small blind) folded before Flop
Seat 2: MnnM150 (big blind) folded on the River
Seat 3: dhduncan folded before Flop (didn't bet)
Seat 5: Duke Croix folded on the River
Seat 8: MrOB1reader (button) collected (4205)



PokerStars Home Game Hand #221068695580: {Club #3225207}  Hold'em No Limit (50/100) - 2020/12/03 18:29:52 ET
Table 'Winifred' 9-max (Play Money) Seat #1 is the button
Seat 1: color_singleton (49338 in chips) 
Seat 2: MnnM150 (5118 in chips) 
Seat 3: dhduncan (9040 in chips) 
Seat 5: Duke Croix (14288 in chips) 
Seat 8: MrOB1reader (12730 in chips) 
MnnM150: posts small blind 50
dhduncan: posts big blind 100
*** HOLE CARDS ***
Dealt to Duke Croix [7s 6h]
Duke Croix: calls 100
MrOB1reader: calls 100
color_singleton: calls 100
MnnM150: calls 50
dhduncan: checks 
*** FLOP *** [2h Ad 4c]
MnnM150: bets 236
dhduncan: folds 
Duke Croix: folds 
MrOB1reader: calls 236
color_singleton: folds 
*** TURN *** [2h Ad 4c] [5s]
MnnM150: bets 459
MrOB1reader: calls 459
*** RIVER *** [2h Ad 4c 5s] [4h]
MnnM150: bets 893
MrOB1reader: folds 
Uncalled bet (893) returned to MnnM150
MnnM150 collected 1786 from pot
*** SUMMARY ***
Total pot 1890 | Rake 104 
Board [2h Ad 4c 5s 4h]
Seat 1: color_singleton (button) folded on the Flop
Seat 2: MnnM150 (small blind) collected (1786)
Seat 3: dhduncan (big blind) folded on the Flop
Seat 5: Duke Croix folded on the Flop
Seat 8: MrOB1reader folded on the River



PokerStars Home Game Hand #221068714123: {Club #3225207}  Hold'em No Limit (50/100) - 2020/12/03 18:30:29 ET
Table 'Winifred' 9-max (Play Money) Seat #2 is the button
Seat 1: color_singleton (49238 in chips) 
Seat 2: MnnM150 (6109 in chips) 
Seat 3: dhduncan (8940 in chips) 
Seat 5: Duke Croix (14188 in chips) 
Seat 8: MrOB1reader (11935 in chips) 
dhduncan: posts small blind 50
Duke Croix: posts big blind 100
*** HOLE CARDS ***
Dealt to Duke Croix [9c 7s]
MrOB1reader: calls 100
color_singleton: calls 100
MnnM150: calls 100
dhduncan: calls 50
Duke Croix: checks 
*** FLOP *** [2c 2d Ts]
dhduncan: bets 100
Duke Croix: folds 
MrOB1reader: calls 100
color_singleton: calls 100
MnnM150: calls 100
*** TURN *** [2c 2d Ts] [9h]
dhduncan: checks 
MrOB1reader: bets 100
color_singleton: calls 100
MnnM150: raises 100 to 200
dhduncan: calls 200
MrOB1reader: calls 100
color_singleton: calls 100
*** RIVER *** [2c 2d Ts 9h] [8c]
dhduncan: checks 
MrOB1reader: checks 
color_singleton: checks 
MnnM150: bets 803
dhduncan: folds 
MrOB1reader: calls 803
color_singleton: folds 
*** SHOW DOWN ***
MnnM150: shows [8d 8h] (a full house, Eights full of Deuces)
MrOB1reader: mucks hand 
MnnM150 collected 3124 from pot
*** SUMMARY ***
Total pot 3306 | Rake 182 
Board [2c 2d Ts 9h 8c]
Seat 1: color_singleton folded on the River
Seat 2: MnnM150 (button) showed [8d 8h] and won (3124) with a full house, Eights full of Deuces
Seat 3: dhduncan (small blind) folded on the River
Seat 5: Duke Croix (big blind) folded on the Flop
Seat 8: MrOB1reader mucked [Td Jc]



PokerStars Home Game Hand #221068752814: {Club #3225207}  Hold'em No Limit (50/100) - 2020/12/03 18:31:46 ET
Table 'Winifred' 9-max (Play Money) Seat #3 is the button
Seat 1: color_singleton (48838 in chips) 
Seat 2: MnnM150 (8030 in chips) 
Seat 3: dhduncan (8540 in chips) 
Seat 5: Duke Croix (14088 in chips) 
Seat 8: MrOB1reader (10732 in chips) 
Duke Croix: posts small blind 50
MrOB1reader: posts big blind 100
*** HOLE CARDS ***
Dealt to Duke Croix [9h Kh]
color_singleton: folds 
MnnM150: calls 100
dhduncan: calls 100
Duke Croix: calls 50
MrOB1reader: raises 100 to 200
MnnM150: calls 100
dhduncan: calls 100
Duke Croix: calls 100
*** FLOP *** [4c 8c 6d]
Duke Croix: checks 
MrOB1reader: checks 
MnnM150: checks 
dhduncan: checks 
*** TURN *** [4c 8c 6d] [Td]
Duke Croix: checks 
MrOB1reader: bets 100
MnnM150: folds 
dhduncan: calls 100
Duke Croix: folds 
*** RIVER *** [4c 8c 6d Td] [9s]
MrOB1reader: bets 472
dhduncan: folds 
Uncalled bet (472) returned to MrOB1reader
MrOB1reader collected 945 from pot
MrOB1reader: doesn't show hand 
*** SUMMARY ***
Total pot 1000 | Rake 55 
Board [4c 8c 6d Td 9s]
Seat 1: color_singleton folded before Flop (didn't bet)
Seat 2: MnnM150 folded on the Turn
Seat 3: dhduncan (button) folded on the River
Seat 5: Duke Croix (small blind) folded on the Turn
Seat 8: MrOB1reader (big blind) collected (945)



PokerStars Home Game Hand #221068775883: {Club #3225207}  Hold'em No Limit (50/100) - 2020/12/03 18:32:32 ET
Table 'Winifred' 9-max (Play Money) Seat #5 is the button
Seat 1: color_singleton (48838 in chips) 
Seat 2: MnnM150 (7830 in chips) 
Seat 3: dhduncan (8240 in chips) 
Seat 5: Duke Croix (13888 in chips) 
Seat 8: MrOB1reader (11377 in chips) 
MrOB1reader: posts small blind 50
color_singleton: posts big blind 100
*** HOLE CARDS ***
Dealt to Duke Croix [7s 7h]
MnnM150: folds 
dhduncan: folds 
Duke Croix: raises 300 to 400
MrOB1reader: calls 350
color_singleton: calls 300
*** FLOP *** [As 5s 8s]
MrOB1reader: bets 700
color_singleton: folds 
Duke Croix: calls 700
*** TURN *** [As 5s 8s] [2s]
MrOB1reader: bets 500
Duke Croix: calls 500
*** RIVER *** [As 5s 8s 2s] [Th]
MrOB1reader: checks 
Duke Croix: bets 1900
MrOB1reader: folds 
Uncalled bet (1900) returned to Duke Croix
Duke Croix collected 3402 from pot
*** SUMMARY ***
Total pot 3600 | Rake 198 
Board [As 5s 8s 2s Th]
Seat 1: color_singleton (big blind) folded on the Flop
Seat 2: MnnM150 folded before Flop (didn't bet)
Seat 3: dhduncan folded before Flop (didn't bet)
Seat 5: Duke Croix (button) collected (3402)
Seat 8: MrOB1reader (small blind) folded on the River



PokerStars Home Game Hand #221068797987: {Club #3225207}  Hold'em No Limit (50/100) - 2020/12/03 18:33:15 ET
Table 'Winifred' 9-max (Play Money) Seat #8 is the button
Seat 1: color_singleton (48438 in chips) 
Seat 2: MnnM150 (7830 in chips) 
Seat 5: Duke Croix (15690 in chips) 
Seat 8: MrOB1reader (9777 in chips) 
color_singleton: posts small blind 50
MnnM150: posts big blind 100
*** HOLE CARDS ***
Dealt to Duke Croix [2c 5c]
Duke Croix: folds 
MrOB1reader: folds 
color_singleton has timed out
color_singleton: folds 
Uncalled bet (50) returned to MnnM150
MnnM150 collected 100 from pot
*** SUMMARY ***
Total pot 100 | Rake 0 
Seat 1: color_singleton (small blind) folded before Flop
Seat 2: MnnM150 (big blind) collected (100)
Seat 5: Duke Croix folded before Flop (didn't bet)
Seat 8: MrOB1reader (button) folded before Flop (didn't bet)



PokerStars Home Game Hand #221068812720: {Club #3225207}  Hold'em No Limit (50/100) - 2020/12/03 18:33:44 ET
Table 'Winifred' 9-max (Play Money) Seat #2 is the button
Seat 2: MnnM150 (7880 in chips) 
Seat 5: Duke Croix (15690 in chips) 
MnnM150: posts small blind 50
Duke Croix: posts big blind 100
*** HOLE CARDS ***
Dealt to Duke Croix [7c Jh]
MnnM150: calls 50
Duke Croix: checks 
*** FLOP *** [5d Ks Kh]
Duke Croix: checks 
MnnM150: checks 
*** TURN *** [5d Ks Kh] [Qs]
Duke Croix: checks 
MnnM150: bets 100
Duke Croix: folds 
Uncalled bet (100) returned to MnnM150
MnnM150 collected 189 from pot
*** SUMMARY ***
Total pot 200 | Rake 11 
Board [5d Ks Kh Qs]
Seat 2: MnnM150 (button) (small blind) collected (189)
Seat 5: Duke Croix (big blind) folded on the Turn



PokerStars Home Game Hand #221068832133: {Club #3225207}  Hold'em No Limit (50/100) - 2020/12/03 18:34:22 ET
Table 'Winifred' 9-max (Play Money) Seat #2 is the button
Seat 1: color_singleton (48388 in chips) 
Seat 2: MnnM150 (7969 in chips) 
Seat 5: Duke Croix (15590 in chips) 
Duke Croix: posts small blind 50
color_singleton: posts big blind 100
*** HOLE CARDS ***
Dealt to Duke Croix [6c Ks]
MnnM150: calls 100
Duke Croix: folds 
color_singleton: checks 
*** FLOP *** [2h 3c 4s]
color_singleton: bets 118
dhduncan leaves the table
MnnM150: calls 118
*** TURN *** [2h 3c 4s] [4h]
color_singleton: bets 229
MnnM150: calls 229
*** RIVER *** [2h 3c 4s 4h] [9s]
color_singleton: bets 446
MnnM150: calls 446
*** SHOW DOWN ***
color_singleton: shows [7d 4c] (three of a kind, Fours)
MnnM150: mucks hand 
color_singleton collected 1735 from pot
*** SUMMARY ***
Total pot 1836 | Rake 101 
Board [2h 3c 4s 4h 9s]
Seat 1: color_singleton (big blind) showed [7d 4c] and won (1735) with three of a kind, Fours
Seat 2: MnnM150 (button) mucked [3h Kd]
Seat 5: Duke Croix (small blind) folded before Flop



PokerStars Home Game Hand #221068844144: {Club #3225207}  Hold'em No Limit (50/100) - 2020/12/03 18:34:46 ET
Table 'Winifred' 9-max (Play Money) Seat #5 is the button
Seat 1: color_singleton (49230 in chips) 
Seat 2: MnnM150 (7076 in chips) 
Seat 5: Duke Croix (15540 in chips) 
color_singleton: posts small blind 50
MnnM150: posts big blind 100
*** HOLE CARDS ***
Dealt to Duke Croix [3c 7d]
Duke Croix: folds 
color_singleton: folds 
Uncalled bet (50) returned to MnnM150
MnnM150 collected 100 from pot
*** SUMMARY ***
Total pot 100 | Rake 0 
Seat 1: color_singleton (small blind) folded before Flop
Seat 2: MnnM150 (big blind) collected (100)
Seat 5: Duke Croix (button) folded before Flop (didn't bet)



