PokerStars Home Game Hand #226310645210: {DaPokaStars}  Hold'em No Limit (50/100) - 2021/04/29 15:32:37 ET
Table 'yes_sir' 9-max (Play Money) Seat #2 is the button
Seat 1: color_singleton (10361 in chips) 
Seat 2: manon327 (10849 in chips) 
Seat 3: GillesdeH (9305 in chips) 
Seat 4: PokerStarMan123 (10000 in chips) 
Seat 6: Klemtonius (10125 in chips) 
Seat 9: dhduncan (6919 in chips) 
GillesdeH: posts small blind 50
PokerStarMan123: posts big blind 100
*** HOLE CARDS ***
Dealt to PokerStarMan123 [6h Tc]
Klemtonius: raises 250 to 350
dhduncan: calls 350
color_singleton: calls 350
manon327: folds 
GillesdeH: folds 
PokerStarMan123: folds 
*** FLOP *** [Jh 4c 8s]
Klemtonius: checks 
dhduncan: checks 
color_singleton: checks 
*** TURN *** [Jh 4c 8s] [Kc]
Klemtonius: checks 
dhduncan: checks 
color_singleton: checks 
*** RIVER *** [Jh 4c 8s Kc] [7h]
Klemtonius: bets 100
dhduncan: calls 100
color_singleton: calls 100
*** SHOW DOWN ***
Klemtonius: shows [Ts Ac] (high card Ace)
dhduncan: shows [8d As] (a pair of Eights)
color_singleton: mucks hand 
dhduncan collected 1417 from pot
*** SUMMARY ***
Total pot 1500 | Rake 83 
Board [Jh 4c 8s Kc 7h]
Seat 1: color_singleton mucked [5c 5d]
Seat 2: manon327 (button) folded before Flop (didn't bet)
Seat 3: GillesdeH (small blind) folded before Flop
Seat 4: PokerStarMan123 (big blind) folded before Flop
Seat 6: Klemtonius showed [Ts Ac] and lost with high card Ace
Seat 9: dhduncan showed [8d As] and won (1417) with a pair of Eights



PokerStars Home Game Hand #226310674365: {DaPokaStars}  Hold'em No Limit (50/100) - 2021/04/29 15:33:28 ET
Table 'yes_sir' 9-max (Play Money) Seat #3 is the button
Seat 1: color_singleton (9911 in chips) 
Seat 2: manon327 (10849 in chips) 
Seat 3: GillesdeH (9255 in chips) 
Seat 4: PokerStarMan123 (9900 in chips) 
Seat 6: Klemtonius (9675 in chips) 
Seat 9: dhduncan (7886 in chips) 
PokerStarMan123: posts small blind 50
Klemtonius: posts big blind 100
*** HOLE CARDS ***
Dealt to PokerStarMan123 [5c 7c]
dhduncan: calls 100
color_singleton: calls 100
manon327: raises 100 to 200
GillesdeH: folds 
PokerStarMan123: calls 150
Klemtonius: calls 100
dhduncan: calls 100
color_singleton: calls 100
*** FLOP *** [7d 9c 2c]
PokerStarMan123: bets 600
Klemtonius: raises 600 to 1200
dhduncan: folds 
color_singleton: folds 
manon327: calls 1200
PokerStarMan123: calls 600
*** TURN *** [7d 9c 2c] [Qs]
PokerStarMan123: checks 
Klemtonius: bets 2173
manon327: calls 2173
PokerStarMan123: calls 2173
*** RIVER *** [7d 9c 2c Qs] [Jd]
PokerStarMan123: checks 
Klemtonius: checks 
manon327: checks 
*** SHOW DOWN ***
PokerStarMan123: shows [5c 7c] (a pair of Sevens)
Klemtonius: mucks hand 
manon327: shows [Ac Ah] (a pair of Aces)
manon327 collected 10507 from pot
*** SUMMARY ***
Total pot 11119 | Rake 612 
Board [7d 9c 2c Qs Jd]
Seat 1: color_singleton folded on the Flop
Seat 2: manon327 showed [Ac Ah] and won (10507) with a pair of Aces
Seat 3: GillesdeH (button) folded before Flop (didn't bet)
Seat 4: PokerStarMan123 (small blind) showed [5c 7c] and lost with a pair of Sevens
Seat 6: Klemtonius (big blind) mucked [6c 4c]
Seat 9: dhduncan folded on the Flop



PokerStars Home Game Hand #226310727215: {DaPokaStars}  Hold'em No Limit (50/100) - 2021/04/29 15:34:59 ET
Table 'yes_sir' 9-max (Play Money) Seat #4 is the button
Seat 1: color_singleton (9711 in chips) 
Seat 2: manon327 (17783 in chips) 
Seat 3: GillesdeH (9255 in chips) 
Seat 4: PokerStarMan123 (6327 in chips) 
Seat 6: Klemtonius (6102 in chips) 
Seat 9: dhduncan (7686 in chips) 
Klemtonius: posts small blind 50
dhduncan: posts big blind 100
*** HOLE CARDS ***
Dealt to PokerStarMan123 [9h Tc]
color_singleton: raises 200 to 300
manon327: calls 300
GillesdeH: folds 
PokerStarMan123: calls 300
Klemtonius: folds 
dhduncan: calls 200
*** FLOP *** [Qd Th 4h]
dhduncan: checks 
color_singleton: bets 590
manon327: calls 590
PokerStarMan123: folds 
dhduncan: folds 
*** TURN *** [Qd Th 4h] [8c]
color_singleton: bets 1148
manon327: folds 
Uncalled bet (1148) returned to color_singleton
color_singleton collected 2296 from pot
color_singleton: doesn't show hand 
*** SUMMARY ***
Total pot 2430 | Rake 134 
Board [Qd Th 4h 8c]
Seat 1: color_singleton collected (2296)
Seat 2: manon327 folded on the Turn
Seat 3: GillesdeH folded before Flop (didn't bet)
Seat 4: PokerStarMan123 (button) folded on the Flop
Seat 6: Klemtonius (small blind) folded before Flop
Seat 9: dhduncan (big blind) folded on the Flop



PokerStars Home Game Hand #226310762318: {DaPokaStars}  Hold'em No Limit (50/100) - 2021/04/29 15:36:00 ET
Table 'yes_sir' 9-max (Play Money) Seat #6 is the button
Seat 1: color_singleton (11117 in chips) 
Seat 2: manon327 (16893 in chips) 
Seat 3: GillesdeH (9255 in chips) 
Seat 4: PokerStarMan123 (6027 in chips) 
Seat 6: Klemtonius (6052 in chips) 
color_singleton: posts small blind 50
manon327: posts big blind 100
*** HOLE CARDS ***
Dealt to PokerStarMan123 [7c 4s]
GillesdeH: calls 100
PokerStarMan123: folds 
Klemtonius: calls 100
color_singleton: calls 50
manon327: checks 
*** FLOP *** [Js 8h 8s]
color_singleton: checks 
manon327: checks 
GillesdeH: bets 378
Klemtonius: folds 
color_singleton: folds 
manon327: folds 
Uncalled bet (378) returned to GillesdeH
GillesdeH collected 378 from pot
*** SUMMARY ***
Total pot 400 | Rake 22 
Board [Js 8h 8s]
Seat 1: color_singleton (small blind) folded on the Flop
Seat 2: manon327 (big blind) folded on the Flop
Seat 3: GillesdeH collected (378)
Seat 4: PokerStarMan123 folded before Flop (didn't bet)
Seat 6: Klemtonius (button) folded on the Flop



PokerStars Home Game Hand #226310782019: {DaPokaStars}  Hold'em No Limit (50/100) - 2021/04/29 15:36:35 ET
Table 'yes_sir' 9-max (Play Money) Seat #1 is the button
Seat 1: color_singleton (11017 in chips) 
Seat 2: manon327 (16793 in chips) 
Seat 3: GillesdeH (9533 in chips) 
Seat 4: PokerStarMan123 (6027 in chips) 
Seat 6: Klemtonius (5952 in chips) 
Seat 9: dhduncan (7386 in chips) 
manon327: posts small blind 50
GillesdeH: posts big blind 100
dhduncan: posts small blind 50
*** HOLE CARDS ***
Dealt to PokerStarMan123 [Ah Ad]
PokerStarMan123: raises 300 to 400
Klemtonius: folds 
dhduncan: folds 
color_singleton: calls 400
manon327: calls 350
GillesdeH: folds 
*** FLOP *** [Qs 3c Jd]
manon327: checks 
PokerStarMan123: bets 700
color_singleton: calls 700
manon327: folds 
*** TURN *** [Qs 3c Jd] [9c]
PokerStarMan123: bets 4927 and is all-in
color_singleton: folds 
Uncalled bet (4927) returned to PokerStarMan123
PokerStarMan123 collected 2599 from pot
*** SUMMARY ***
Total pot 2750 | Rake 151 
Board [Qs 3c Jd 9c]
Seat 1: color_singleton (button) folded on the Turn
Seat 2: manon327 (small blind) folded on the Flop
Seat 3: GillesdeH (big blind) folded before Flop
Seat 4: PokerStarMan123 collected (2599)
Seat 6: Klemtonius folded before Flop (didn't bet)
Seat 9: dhduncan folded before Flop (didn't bet)



PokerStars Home Game Hand #226310816991: {DaPokaStars}  Hold'em No Limit (50/100) - 2021/04/29 15:37:35 ET
Table 'yes_sir' 9-max (Play Money) Seat #2 is the button
Seat 1: color_singleton (9917 in chips) 
Seat 2: manon327 (16393 in chips) 
Seat 3: GillesdeH (9433 in chips) 
Seat 4: PokerStarMan123 (7526 in chips) 
Seat 6: Klemtonius (5952 in chips) 
Seat 9: dhduncan (7336 in chips) 
GillesdeH: posts small blind 50
PokerStarMan123: posts big blind 100
*** HOLE CARDS ***
Dealt to PokerStarMan123 [6d 2c]
Klemtonius: raises 200 to 300
dhduncan: calls 300
color_singleton: folds 
manon327: calls 300
GillesdeH: calls 250
PokerStarMan123: folds 
*** FLOP *** [2d Js Kh]
GillesdeH: checks 
Klemtonius: bets 614
dhduncan: folds 
manon327: calls 614
GillesdeH: folds 
*** TURN *** [2d Js Kh] [7c]
Klemtonius: bets 1194
manon327: folds 
Uncalled bet (1194) returned to Klemtonius
Klemtonius collected 2389 from pot
Klemtonius: doesn't show hand 
*** SUMMARY ***
Total pot 2528 | Rake 139 
Board [2d Js Kh 7c]
Seat 1: color_singleton folded before Flop (didn't bet)
Seat 2: manon327 (button) folded on the Turn
Seat 3: GillesdeH (small blind) folded on the Flop
Seat 4: PokerStarMan123 (big blind) folded before Flop
Seat 6: Klemtonius collected (2389)
Seat 9: dhduncan folded on the Flop



PokerStars Home Game Hand #226310851219: {DaPokaStars}  Hold'em No Limit (50/100) - 2021/04/29 15:38:35 ET
Table 'yes_sir' 9-max (Play Money) Seat #3 is the button
Seat 1: color_singleton (9917 in chips) 
Seat 2: manon327 (15479 in chips) 
Seat 3: GillesdeH (9133 in chips) 
Seat 4: PokerStarMan123 (7426 in chips) 
Seat 6: Klemtonius (7427 in chips) 
Seat 9: dhduncan (7036 in chips) 
PokerStarMan123: posts small blind 50
Klemtonius: posts big blind 100
*** HOLE CARDS ***
Dealt to PokerStarMan123 [9s 8c]
dhduncan: folds 
color_singleton: folds 
manon327: folds 
GillesdeH: calls 100
PokerStarMan123: calls 50
Klemtonius: checks 
*** FLOP *** [Qc Qh 7c]
PokerStarMan123: checks 
Klemtonius: checks 
GillesdeH: bets 283
PokerStarMan123: folds 
Klemtonius: folds 
Uncalled bet (283) returned to GillesdeH
GillesdeH collected 283 from pot
*** SUMMARY ***
Total pot 300 | Rake 17 
Board [Qc Qh 7c]
Seat 1: color_singleton folded before Flop (didn't bet)
Seat 2: manon327 folded before Flop (didn't bet)
Seat 3: GillesdeH (button) collected (283)
Seat 4: PokerStarMan123 (small blind) folded on the Flop
Seat 6: Klemtonius (big blind) folded on the Flop
Seat 9: dhduncan folded before Flop (didn't bet)



PokerStars Home Game Hand #226310874822: {DaPokaStars}  Hold'em No Limit (50/100) - 2021/04/29 15:39:16 ET
Table 'yes_sir' 9-max (Play Money) Seat #4 is the button
Seat 1: color_singleton (9917 in chips) 
Seat 2: manon327 (15479 in chips) 
Seat 3: GillesdeH (9316 in chips) 
Seat 4: PokerStarMan123 (7326 in chips) 
Seat 6: Klemtonius (7327 in chips) 
Seat 9: dhduncan (7036 in chips) 
Klemtonius: posts small blind 50
dhduncan: posts big blind 100
*** HOLE CARDS ***
Dealt to PokerStarMan123 [Th Qs]
color_singleton: folds 
manon327: calls 100
GillesdeH: calls 100
PokerStarMan123: raises 300 to 400
Klemtonius: folds 
dhduncan: folds 
manon327: calls 300
GillesdeH: calls 300
*** FLOP *** [4d Jc 9h]
JeBoyDirk joins the table at seat #8 
manon327: checks 
GillesdeH: checks 
PokerStarMan123: bets 600
manon327: calls 600
GillesdeH: folds 
*** TURN *** [4d Jc 9h] [Qc]
manon327: checks 
PokerStarMan123: bets 1300
manon327: folds 
Uncalled bet (1300) returned to PokerStarMan123
PokerStarMan123 collected 2410 from pot
*** SUMMARY ***
Total pot 2550 | Rake 140 
Board [4d Jc 9h Qc]
Seat 1: color_singleton folded before Flop (didn't bet)
Seat 2: manon327 folded on the Turn
Seat 3: GillesdeH folded on the Flop
Seat 4: PokerStarMan123 (button) collected (2410)
Seat 6: Klemtonius (small blind) folded before Flop
Seat 9: dhduncan (big blind) folded before Flop



PokerStars Home Game Hand #226310901445: {DaPokaStars}  Hold'em No Limit (50/100) - 2021/04/29 15:40:03 ET
Table 'yes_sir' 9-max (Play Money) Seat #6 is the button
Seat 1: color_singleton (9917 in chips) 
Seat 2: manon327 (14479 in chips) 
Seat 3: GillesdeH (8916 in chips) 
Seat 4: PokerStarMan123 (8736 in chips) 
Seat 6: Klemtonius (7277 in chips) 
Seat 9: dhduncan (6936 in chips) 
dhduncan: posts small blind 50
color_singleton: posts big blind 100
*** HOLE CARDS ***
Dealt to PokerStarMan123 [Ts 7h]
manon327: calls 100
GillesdeH: calls 100
PokerStarMan123: folds 
Klemtonius: calls 100
dhduncan: calls 50
color_singleton: checks 
*** FLOP *** [7c 8d 4d]
dhduncan: bets 100
color_singleton: folds 
manon327: calls 100
GillesdeH: calls 100
Klemtonius: folds 
*** TURN *** [7c 8d 4d] [5d]
dhduncan: checks 
manon327: checks 
GillesdeH: bets 378
dhduncan: folds 
manon327: calls 378
*** RIVER *** [7c 8d 4d 5d] [Th]
manon327: bets 735
GillesdeH: calls 735
*** SHOW DOWN ***
manon327: shows [7d Ac] (a pair of Sevens)
GillesdeH: shows [5c 8h] (two pair, Eights and Fives)
GillesdeH collected 2860 from pot
*** SUMMARY ***
Total pot 3026 | Rake 166 
Board [7c 8d 4d 5d Th]
Seat 1: color_singleton (big blind) folded on the Flop
Seat 2: manon327 showed [7d Ac] and lost with a pair of Sevens
Seat 3: GillesdeH showed [5c 8h] and won (2860) with two pair, Eights and Fives
Seat 4: PokerStarMan123 folded before Flop (didn't bet)
Seat 6: Klemtonius (button) folded on the Flop
Seat 9: dhduncan (small blind) folded on the Turn



PokerStars Home Game Hand #226310938295: {DaPokaStars}  Hold'em No Limit (50/100) - 2021/04/29 15:41:07 ET
Table 'yes_sir' 9-max (Play Money) Seat #9 is the button
Seat 1: color_singleton (9817 in chips) 
Seat 2: manon327 (13166 in chips) 
Seat 3: GillesdeH (10463 in chips) 
Seat 4: PokerStarMan123 (8736 in chips) 
Seat 6: Klemtonius (7177 in chips) 
Seat 8: JeBoyDirk (10000 in chips) 
Seat 9: dhduncan (6736 in chips) 
color_singleton: posts small blind 50
manon327: posts big blind 100
JeBoyDirk: posts big blind 100
*** HOLE CARDS ***
Dealt to PokerStarMan123 [Ad 9s]
GillesdeH: calls 100
PokerStarMan123: raises 300 to 400
Klemtonius: calls 400
JeBoyDirk: folds 
dhduncan: calls 400
color_singleton: folds 
manon327: folds 
GillesdeH: calls 300
*** FLOP *** [2s 8s 8d]
GillesdeH: checks 
PokerStarMan123: bets 900
Klemtonius: folds 
dhduncan: folds 
GillesdeH: folds 
Uncalled bet (900) returned to PokerStarMan123
PokerStarMan123 collected 1748 from pot
*** SUMMARY ***
Total pot 1850 | Rake 102 
Board [2s 8s 8d]
Seat 1: color_singleton (small blind) folded before Flop
Seat 2: manon327 (big blind) folded before Flop
Seat 3: GillesdeH folded on the Flop
Seat 4: PokerStarMan123 collected (1748)
Seat 6: Klemtonius folded on the Flop
Seat 8: JeBoyDirk folded before Flop (didn't bet)
Seat 9: dhduncan (button) folded on the Flop



PokerStars Home Game Hand #226310970178: {DaPokaStars}  Hold'em No Limit (50/100) - 2021/04/29 15:42:02 ET
Table 'yes_sir' 9-max (Play Money) Seat #1 is the button
Seat 1: color_singleton (9767 in chips) 
Seat 2: manon327 (13066 in chips) 
Seat 3: GillesdeH (10063 in chips) 
Seat 4: PokerStarMan123 (10084 in chips) 
Seat 6: Klemtonius (6777 in chips) 
Seat 8: JeBoyDirk (9900 in chips) 
Seat 9: dhduncan (6336 in chips) 
manon327: posts small blind 50
GillesdeH: posts big blind 100
*** HOLE CARDS ***
Dealt to PokerStarMan123 [8s 3s]
PokerStarMan123: folds 
Klemtonius: folds 
JeBoyDirk: calls 100
dhduncan: folds 
color_singleton: folds 
manon327: calls 50
GillesdeH: checks 
*** FLOP *** [5h 6h 7s]
manon327: checks 
GillesdeH: bets 283
JeBoyDirk: calls 283
manon327: calls 283
*** TURN *** [5h 6h 7s] [Jc]
manon327: checks 
GillesdeH: bets 1086
JeBoyDirk: calls 1086
manon327: folds 
*** RIVER *** [5h 6h 7s Jc] [6c]
GillesdeH: checks 
JeBoyDirk: bets 2500
GillesdeH: calls 2500
*** SHOW DOWN ***
JeBoyDirk: shows [Th 7h] (two pair, Sevens and Sixes)
GillesdeH: shows [4s 3h] (a straight, Three to Seven)
GillesdeH collected 7863 from pot
*** SUMMARY ***
Total pot 8321 | Rake 458 
Board [5h 6h 7s Jc 6c]
Seat 1: color_singleton (button) folded before Flop (didn't bet)
Seat 2: manon327 (small blind) folded on the Turn
Seat 3: GillesdeH (big blind) showed [4s 3h] and won (7863) with a straight, Three to Seven
Seat 4: PokerStarMan123 folded before Flop (didn't bet)
Seat 6: Klemtonius folded before Flop (didn't bet)
Seat 8: JeBoyDirk showed [Th 7h] and lost with two pair, Sevens and Sixes
Seat 9: dhduncan folded before Flop (didn't bet)



PokerStars Home Game Hand #226311008925: {DaPokaStars}  Hold'em No Limit (50/100) - 2021/04/29 15:43:05 ET
Table 'yes_sir' 9-max (Play Money) Seat #2 is the button
Seat 1: color_singleton (9767 in chips) 
Seat 2: manon327 (12683 in chips) 
Seat 3: GillesdeH (13957 in chips) 
Seat 4: PokerStarMan123 (10084 in chips) 
Seat 6: Klemtonius (6777 in chips) 
Seat 8: JeBoyDirk (5931 in chips) 
Seat 9: dhduncan (6336 in chips) 
GillesdeH: posts small blind 50
PokerStarMan123: posts big blind 100
*** HOLE CARDS ***
Dealt to PokerStarMan123 [Ac 7c]
Klemtonius: folds 
JeBoyDirk: folds 
dhduncan: calls 100
color_singleton: folds 
manon327: raises 100 to 200
GillesdeH: calls 150
PokerStarMan123: raises 300 to 500
dhduncan: calls 400
manon327: calls 300
GillesdeH: folds 
*** FLOP *** [3s 6c Qs]
PokerStarMan123: checks 
dhduncan: checks 
manon327: checks 
*** TURN *** [3s 6c Qs] [Qc]
PokerStarMan123: bets 900
dhduncan: folds 
manon327: calls 900
*** RIVER *** [3s 6c Qs Qc] [Jc]
PokerStarMan123: bets 2600
manon327: folds 
Uncalled bet (2600) returned to PokerStarMan123
PokerStarMan123 collected 3307 from pot
*** SUMMARY ***
Total pot 3500 | Rake 193 
Board [3s 6c Qs Qc Jc]
Seat 1: color_singleton folded before Flop (didn't bet)
Seat 2: manon327 (button) folded on the River
Seat 3: GillesdeH (small blind) folded before Flop
Seat 4: PokerStarMan123 (big blind) collected (3307)
Seat 6: Klemtonius folded before Flop (didn't bet)
Seat 8: JeBoyDirk folded before Flop (didn't bet)
Seat 9: dhduncan folded on the Turn



PokerStars Home Game Hand #226311039538: {DaPokaStars}  Hold'em No Limit (50/100) - 2021/04/29 15:43:58 ET
Table 'yes_sir' 9-max (Play Money) Seat #3 is the button
Seat 1: color_singleton (9767 in chips) 
Seat 2: manon327 (11283 in chips) 
Seat 3: GillesdeH (13757 in chips) 
Seat 4: PokerStarMan123 (11991 in chips) 
Seat 6: Klemtonius (6777 in chips) 
Seat 8: JeBoyDirk (5931 in chips) 
Seat 9: dhduncan (5836 in chips) 
PokerStarMan123: posts small blind 50
Klemtonius: posts big blind 100
*** HOLE CARDS ***
Dealt to PokerStarMan123 [Ad Qh]
JeBoyDirk: folds 
dhduncan: calls 100
color_singleton: folds 
manon327: calls 100
GillesdeH: calls 100
PokerStarMan123: calls 50
Klemtonius: raises 500 to 600
dhduncan: calls 500
manon327: folds 
GillesdeH: folds 
PokerStarMan123: calls 500
*** FLOP *** [9c 2s 2d]
PokerStarMan123: checks 
Klemtonius: checks 
dhduncan: checks 
*** TURN *** [9c 2s 2d] [Qd]
PokerStarMan123: bets 1000
Klemtonius: raises 1000 to 2000
dhduncan: folds 
PokerStarMan123: calls 1000
*** RIVER *** [9c 2s 2d Qd] [3c]
PokerStarMan123: bets 3000
Klemtonius: raises 1177 to 4177 and is all-in
PokerStarMan123: calls 1177
*** SHOW DOWN ***
Klemtonius: shows [Ks Kh] (two pair, Kings and Deuces)
PokerStarMan123: shows [Ad Qh] (two pair, Queens and Deuces)
Klemtonius collected 13565 from pot
*** SUMMARY ***
Total pot 14354 | Rake 789 
Board [9c 2s 2d Qd 3c]
Seat 1: color_singleton folded before Flop (didn't bet)
Seat 2: manon327 folded before Flop
Seat 3: GillesdeH (button) folded before Flop
Seat 4: PokerStarMan123 (small blind) showed [Ad Qh] and lost with two pair, Queens and Deuces
Seat 6: Klemtonius (big blind) showed [Ks Kh] and won (13565) with two pair, Kings and Deuces
Seat 8: JeBoyDirk folded before Flop (didn't bet)
Seat 9: dhduncan folded on the Turn



PokerStars Home Game Hand #226311070393: {DaPokaStars}  Hold'em No Limit (50/100) - 2021/04/29 15:44:51 ET
Table 'yes_sir' 9-max (Play Money) Seat #4 is the button
Seat 1: color_singleton (9767 in chips) 
Seat 2: manon327 (11183 in chips) 
Seat 3: GillesdeH (13657 in chips) 
Seat 4: PokerStarMan123 (5214 in chips) 
Seat 6: Klemtonius (13565 in chips) 
Seat 8: JeBoyDirk (5931 in chips) 
Seat 9: dhduncan (5236 in chips) 
Klemtonius: posts small blind 50
JeBoyDirk: posts big blind 100
*** HOLE CARDS ***
Dealt to PokerStarMan123 [5d Qd]
dhduncan: calls 100
color_singleton: raises 100 to 200
manon327: calls 200
GillesdeH: calls 200
PokerStarMan123: folds 
Klemtonius: calls 150
JeBoyDirk: folds 
dhduncan: calls 100
*** FLOP *** [2s 9h 7s]
Klemtonius: checks 
dhduncan: checks 
color_singleton: checks 
manon327: checks 
GillesdeH: checks 
*** TURN *** [2s 9h 7s] [Kc]
Klemtonius: checks 
dhduncan: checks 
color_singleton: bets 800
manon327: folds 
GillesdeH: calls 800
Klemtonius: folds 
dhduncan: folds 
*** RIVER *** [2s 9h 7s Kc] [As]
color_singleton: checks 
GillesdeH: bets 2551
color_singleton: folds 
Uncalled bet (2551) returned to GillesdeH
GillesdeH collected 2551 from pot
*** SUMMARY ***
Total pot 2700 | Rake 149 
Board [2s 9h 7s Kc As]
Seat 1: color_singleton folded on the River
Seat 2: manon327 folded on the Turn
Seat 3: GillesdeH collected (2551)
Seat 4: PokerStarMan123 (button) folded before Flop (didn't bet)
Seat 6: Klemtonius (small blind) folded on the Turn
Seat 8: JeBoyDirk (big blind) folded before Flop
Seat 9: dhduncan folded on the Turn



PokerStars Home Game Hand #226311116242: {DaPokaStars}  Hold'em No Limit (50/100) - 2021/04/29 15:46:10 ET
Table 'yes_sir' 9-max (Play Money) Seat #6 is the button
Seat 1: color_singleton (8767 in chips) 
Seat 2: manon327 (10983 in chips) 
Seat 3: GillesdeH (15208 in chips) 
Seat 4: PokerStarMan123 (5214 in chips) 
Seat 6: Klemtonius (13365 in chips) 
Seat 8: JeBoyDirk (5831 in chips) 
Seat 9: dhduncan (5036 in chips) 
JeBoyDirk: posts small blind 50
dhduncan: posts big blind 100
*** HOLE CARDS ***
Dealt to PokerStarMan123 [7c 6h]
color_singleton: raises 200 to 300
manon327: calls 300
GillesdeH: calls 300
PokerStarMan123: calls 300
Klemtonius: calls 300
JeBoyDirk: folds 
dhduncan: folds 
*** FLOP *** [As 2h 9c]
color_singleton: bets 779
manon327: folds 
GillesdeH: folds 
PokerStarMan123: folds 
Klemtonius: folds 
Uncalled bet (779) returned to color_singleton
color_singleton collected 1559 from pot
color_singleton: doesn't show hand 
*** SUMMARY ***
Total pot 1650 | Rake 91 
Board [As 2h 9c]
Seat 1: color_singleton collected (1559)
Seat 2: manon327 folded on the Flop
Seat 3: GillesdeH folded on the Flop
Seat 4: PokerStarMan123 folded on the Flop
Seat 6: Klemtonius (button) folded on the Flop
Seat 8: JeBoyDirk (small blind) folded before Flop
Seat 9: dhduncan (big blind) folded before Flop



PokerStars Home Game Hand #226311140550: {DaPokaStars}  Hold'em No Limit (50/100) - 2021/04/29 15:46:52 ET
Table 'yes_sir' 9-max (Play Money) Seat #8 is the button
Seat 1: color_singleton (10026 in chips) 
Seat 2: manon327 (10683 in chips) 
Seat 3: GillesdeH (14908 in chips) 
Seat 4: PokerStarMan123 (4914 in chips) 
Seat 6: Klemtonius (13065 in chips) 
Seat 8: JeBoyDirk (5781 in chips) 
Seat 9: dhduncan (4936 in chips) 
dhduncan: posts small blind 50
color_singleton: posts big blind 100
*** HOLE CARDS ***
Dealt to PokerStarMan123 [6s 9s]
manon327: calls 100
GillesdeH: calls 100
PokerStarMan123: folds 
Klemtonius: calls 100
JeBoyDirk: calls 100
dhduncan: calls 50
color_singleton: checks 
*** FLOP *** [8d Ah Ts]
dhduncan: checks 
color_singleton: checks 
manon327: checks 
GillesdeH: checks 
Klemtonius: checks 
JeBoyDirk: checks 
*** TURN *** [8d Ah Ts] [2c]
dhduncan: checks 
color_singleton: checks 
manon327: checks 
GillesdeH: checks 
Klemtonius: checks 
JeBoyDirk: checks 
*** RIVER *** [8d Ah Ts 2c] [2s]
dhduncan: checks 
color_singleton: checks 
manon327: checks 
GillesdeH: checks 
Klemtonius: checks 
JeBoyDirk: checks 
*** SHOW DOWN ***
dhduncan: shows [Ks 3c] (a pair of Deuces)
color_singleton: mucks hand 
manon327: mucks hand 
GillesdeH: mucks hand 
Klemtonius: mucks hand 
JeBoyDirk: shows [7s 8h] (two pair, Eights and Deuces)
JeBoyDirk collected 567 from pot
*** SUMMARY ***
Total pot 600 | Rake 33 
Board [8d Ah Ts 2c 2s]
Seat 1: color_singleton (big blind) mucked [Jh 3h]
Seat 2: manon327 mucked [9d 4d]
Seat 3: GillesdeH mucked [3d 7h]
Seat 4: PokerStarMan123 folded before Flop (didn't bet)
Seat 6: Klemtonius mucked [Qc 6c]
Seat 8: JeBoyDirk (button) showed [7s 8h] and won (567) with two pair, Eights and Deuces
Seat 9: dhduncan (small blind) showed [Ks 3c] and lost with a pair of Deuces



PokerStars Home Game Hand #226311182765: {DaPokaStars}  Hold'em No Limit (50/100) - 2021/04/29 15:48:04 ET
Table 'yes_sir' 9-max (Play Money) Seat #9 is the button
Seat 1: color_singleton (9926 in chips) 
Seat 2: manon327 (10583 in chips) 
Seat 3: GillesdeH (14808 in chips) 
Seat 4: PokerStarMan123 (4914 in chips) 
Seat 6: Klemtonius (12965 in chips) 
Seat 8: JeBoyDirk (6248 in chips) 
Seat 9: dhduncan (4836 in chips) 
color_singleton: posts small blind 50
manon327: posts big blind 100
*** HOLE CARDS ***
Dealt to PokerStarMan123 [Qh 2c]
GillesdeH: calls 100
PokerStarMan123: folds 
Klemtonius: raises 350 to 450
JeBoyDirk: calls 450
dhduncan: folds 
color_singleton: calls 400
manon327: folds 
GillesdeH: calls 350
*** FLOP *** [3c 6s Kh]
color_singleton: checks 
GillesdeH: checks 
Klemtonius: bets 300
JeBoyDirk: folds 
color_singleton: calls 300
GillesdeH: folds 
*** TURN *** [3c 6s Kh] [4h]
color_singleton: checks 
Klemtonius: bets 1200
color_singleton: calls 1200
*** RIVER *** [3c 6s Kh 4h] [As]
color_singleton: checks 
Klemtonius: checks 
*** SHOW DOWN ***
color_singleton: shows [Ah Jh] (a pair of Aces)
Klemtonius: mucks hand 
color_singleton collected 4630 from pot
*** SUMMARY ***
Total pot 4900 | Rake 270 
Board [3c 6s Kh 4h As]
Seat 1: color_singleton (small blind) showed [Ah Jh] and won (4630) with a pair of Aces
Seat 2: manon327 (big blind) folded before Flop
Seat 3: GillesdeH folded on the Flop
Seat 4: PokerStarMan123 folded before Flop (didn't bet)
Seat 6: Klemtonius mucked [3d Qd]
Seat 8: JeBoyDirk folded on the Flop
Seat 9: dhduncan (button) folded before Flop (didn't bet)



PokerStars Home Game Hand #226311218957: {DaPokaStars}  Hold'em No Limit (50/100) - 2021/04/29 15:49:07 ET
Table 'yes_sir' 9-max (Play Money) Seat #1 is the button
Seat 1: color_singleton (12606 in chips) 
Seat 2: manon327 (10483 in chips) 
Seat 3: GillesdeH (14358 in chips) 
Seat 4: PokerStarMan123 (4914 in chips) 
Seat 6: Klemtonius (11015 in chips) 
Seat 8: JeBoyDirk (5798 in chips) 
Seat 9: dhduncan (4836 in chips) 
manon327: posts small blind 50
GillesdeH: posts big blind 100
*** HOLE CARDS ***
Dealt to PokerStarMan123 [6s Kh]
PokerStarMan123: folds 
Klemtonius: raises 100 to 200
JeBoyDirk: raises 200 to 400
dhduncan: calls 400
color_singleton: folds 
manon327: calls 350
GillesdeH: folds 
Klemtonius: calls 200
*** FLOP *** [9s Td 3d]
manon327: checks 
Klemtonius: checks 
JeBoyDirk: bets 700
dhduncan: calls 700
manon327: calls 700
Klemtonius: folds 
*** TURN *** [9s Td 3d] [5d]
manon327: checks 
JeBoyDirk: checks 
dhduncan: checks 
*** RIVER *** [9s Td 3d 5d] [Jd]
manon327: checks 
JeBoyDirk: checks 
dhduncan: bets 1795
manon327: folds 
JeBoyDirk: folds 
Uncalled bet (1795) returned to dhduncan
dhduncan collected 3591 from pot
dhduncan: doesn't show hand 
*** SUMMARY ***
Total pot 3800 | Rake 209 
Board [9s Td 3d 5d Jd]
Seat 1: color_singleton (button) folded before Flop (didn't bet)
Seat 2: manon327 (small blind) folded on the River
Seat 3: GillesdeH (big blind) folded before Flop
Seat 4: PokerStarMan123 folded before Flop (didn't bet)
Seat 6: Klemtonius folded on the Flop
Seat 8: JeBoyDirk folded on the River
Seat 9: dhduncan collected (3591)



PokerStars Home Game Hand #226311273322: {DaPokaStars}  Hold'em No Limit (50/100) - 2021/04/29 15:50:31 ET
Table 'yes_sir' 9-max (Play Money) Seat #2 is the button
Seat 1: color_singleton (12606 in chips) 
Seat 2: manon327 (9383 in chips) 
Seat 3: GillesdeH (14258 in chips) 
Seat 4: PokerStarMan123 (4914 in chips) 
Seat 6: Klemtonius (10615 in chips) 
Seat 8: JeBoyDirk (4698 in chips) 
Seat 9: dhduncan (7327 in chips) 
GillesdeH: posts small blind 50
PokerStarMan123: posts big blind 100
*** HOLE CARDS ***
Dealt to PokerStarMan123 [3c 7s]
Klemtonius: raises 100 to 200
JeBoyDirk: folds 
dhduncan: folds 
color_singleton: folds 
manon327: folds 
GillesdeH: calls 150
PokerStarMan123: calls 100
*** FLOP *** [2s 4h Ks]
GillesdeH: bets 567
PokerStarMan123: folds 
Klemtonius: folds 
Uncalled bet (567) returned to GillesdeH
GillesdeH collected 567 from pot
*** SUMMARY ***
Total pot 600 | Rake 33 
Board [2s 4h Ks]
Seat 1: color_singleton folded before Flop (didn't bet)
Seat 2: manon327 (button) folded before Flop (didn't bet)
Seat 3: GillesdeH (small blind) collected (567)
Seat 4: PokerStarMan123 (big blind) folded on the Flop
Seat 6: Klemtonius folded on the Flop
Seat 8: JeBoyDirk folded before Flop (didn't bet)
Seat 9: dhduncan folded before Flop (didn't bet)



PokerStars Home Game Hand #226311291952: {DaPokaStars}  Hold'em No Limit (50/100) - 2021/04/29 15:51:03 ET
Table 'yes_sir' 9-max (Play Money) Seat #3 is the button
Seat 1: color_singleton (12606 in chips) 
Seat 3: GillesdeH (14625 in chips) 
Seat 4: PokerStarMan123 (4714 in chips) 
Seat 6: Klemtonius (10415 in chips) 
Seat 8: JeBoyDirk (4698 in chips) 
Seat 9: dhduncan (7327 in chips) 
PokerStarMan123: posts small blind 50
Klemtonius: posts big blind 100
*** HOLE CARDS ***
Dealt to PokerStarMan123 [2h Js]
JeBoyDirk: folds 
dhduncan: calls 100
color_singleton: folds 
GillesdeH: calls 100
PokerStarMan123: folds 
Klemtonius: checks 
*** FLOP *** [8h Ac 2d]
Klemtonius: checks 
dhduncan: checks 
GillesdeH: checks 
*** TURN *** [8h Ac 2d] [4h]
Klemtonius: checks 
dhduncan: checks 
GillesdeH: checks 
*** RIVER *** [8h Ac 2d 4h] [7d]
Klemtonius: checks 
dhduncan: checks 
GillesdeH: checks 
*** SHOW DOWN ***
Klemtonius: shows [3c 9s] (high card Ace)
dhduncan: shows [Td Ks] (high card Ace - King kicker)
GillesdeH: mucks hand 
dhduncan collected 331 from pot
*** SUMMARY ***
Total pot 350 | Rake 19 
Board [8h Ac 2d 4h 7d]
Seat 1: color_singleton folded before Flop (didn't bet)
Seat 3: GillesdeH (button) mucked [5d Jd]
Seat 4: PokerStarMan123 (small blind) folded before Flop
Seat 6: Klemtonius (big blind) showed [3c 9s] and lost with high card Ace
Seat 8: JeBoyDirk folded before Flop (didn't bet)
Seat 9: dhduncan showed [Td Ks] and won (331) with high card Ace



PokerStars Home Game Hand #226311323537: {DaPokaStars}  Hold'em No Limit (50/100) - 2021/04/29 15:51:58 ET
Table 'yes_sir' 9-max (Play Money) Seat #4 is the button
Seat 1: color_singleton (12606 in chips) 
Seat 3: GillesdeH (14525 in chips) 
Seat 4: PokerStarMan123 (4664 in chips) 
Seat 6: Klemtonius (10315 in chips) 
Seat 8: JeBoyDirk (4698 in chips) 
Seat 9: dhduncan (7558 in chips) 
Klemtonius: posts small blind 50
JeBoyDirk: posts big blind 100
*** HOLE CARDS ***
Dealt to PokerStarMan123 [4c 9s]
dhduncan: calls 100
color_singleton has timed out
color_singleton: folds 
GillesdeH: calls 100
PokerStarMan123: folds 
Klemtonius: raises 100 to 200
JeBoyDirk: calls 100
dhduncan: calls 100
GillesdeH: calls 100
*** FLOP *** [Jd 3h Td]
Klemtonius: checks 
JeBoyDirk: checks 
dhduncan: bets 200
GillesdeH: folds 
Klemtonius: calls 200
JeBoyDirk: folds 
*** TURN *** [Jd 3h Td] [Kd]
Klemtonius: checks 
dhduncan: checks 
*** RIVER *** [Jd 3h Td Kd] [2c]
Klemtonius: bets 1134
dhduncan: calls 1134
*** SHOW DOWN ***
Klemtonius: shows [3d 3s] (three of a kind, Threes)
dhduncan: mucks hand 
Klemtonius collected 3277 from pot
*** SUMMARY ***
Total pot 3468 | Rake 191 
Board [Jd 3h Td Kd 2c]
Seat 1: color_singleton folded before Flop (didn't bet)
Seat 3: GillesdeH folded on the Flop
Seat 4: PokerStarMan123 (button) folded before Flop (didn't bet)
Seat 6: Klemtonius (small blind) showed [3d 3s] and won (3277) with three of a kind, Threes
Seat 8: JeBoyDirk (big blind) folded on the Flop
Seat 9: dhduncan mucked [Js 2h]



PokerStars Home Game Hand #226311381596: {DaPokaStars}  Hold'em No Limit (50/100) - 2021/04/29 15:53:24 ET
Table 'yes_sir' 9-max (Play Money) Seat #6 is the button
Seat 1: color_singleton (12606 in chips) 
Seat 2: manon327 (9383 in chips) 
Seat 3: GillesdeH (14325 in chips) 
Seat 4: PokerStarMan123 (4664 in chips) 
Seat 6: Klemtonius (12058 in chips) 
Seat 8: JeBoyDirk (4498 in chips) 
Seat 9: dhduncan (6024 in chips) 
JeBoyDirk: posts small blind 50
dhduncan: posts big blind 100
*** HOLE CARDS ***
Dealt to PokerStarMan123 [7c 5h]
color_singleton: folds 
manon327: calls 100
GillesdeH: calls 100
PokerStarMan123: folds 
Klemtonius: calls 100
JeBoyDirk: folds 
dhduncan: checks 
*** FLOP *** [Jd 4c Tc]
dhduncan: checks 
manon327: bets 100
GillesdeH: calls 100
Klemtonius: calls 100
dhduncan: folds 
*** TURN *** [Jd 4c Tc] [Js]
manon327: checks 
GillesdeH: checks 
Klemtonius: checks 
*** RIVER *** [Jd 4c Tc Js] [6c]
manon327: bets 709
GillesdeH: folds 
Klemtonius: folds 
Uncalled bet (709) returned to manon327
manon327 collected 709 from pot
*** SUMMARY ***
Total pot 750 | Rake 41 
Board [Jd 4c Tc Js 6c]
Seat 1: color_singleton folded before Flop (didn't bet)
Seat 2: manon327 collected (709)
Seat 3: GillesdeH folded on the River
Seat 4: PokerStarMan123 folded before Flop (didn't bet)
Seat 6: Klemtonius (button) folded on the River
Seat 8: JeBoyDirk (small blind) folded before Flop
Seat 9: dhduncan (big blind) folded on the Flop



PokerStars Home Game Hand #226311411883: {DaPokaStars}  Hold'em No Limit (50/100) - 2021/04/29 15:54:16 ET
Table 'yes_sir' 9-max (Play Money) Seat #8 is the button
Seat 1: color_singleton (12606 in chips) 
Seat 2: manon327 (9892 in chips) 
Seat 3: GillesdeH (14125 in chips) 
Seat 4: PokerStarMan123 (4664 in chips) 
Seat 6: Klemtonius (11858 in chips) 
Seat 8: JeBoyDirk (4448 in chips) 
Seat 9: dhduncan (5924 in chips) 
dhduncan: posts small blind 50
color_singleton: posts big blind 100
*** HOLE CARDS ***
Dealt to PokerStarMan123 [8c 9s]
manon327: calls 100
GillesdeH: calls 100
PokerStarMan123: calls 100
Klemtonius: raises 200 to 300
JeBoyDirk: folds 
dhduncan: folds 
color_singleton: folds 
manon327: calls 200
GillesdeH: calls 200
PokerStarMan123: calls 200
*** FLOP *** [7c Ks 5d]
manon327: checks 
GillesdeH: checks 
PokerStarMan123: checks 
Klemtonius: checks 
*** TURN *** [7c Ks 5d] [Tc]
manon327: checks 
GillesdeH: checks 
PokerStarMan123: checks 
Klemtonius: bets 638
manon327: folds 
GillesdeH: folds 
PokerStarMan123: calls 638
*** RIVER *** [7c Ks 5d Tc] [Ah]
PokerStarMan123: checks 
Klemtonius: bets 1400
PokerStarMan123: folds 
Uncalled bet (1400) returned to Klemtonius
Klemtonius collected 2482 from pot
Klemtonius: doesn't show hand 
*** SUMMARY ***
Total pot 2626 | Rake 144 
Board [7c Ks 5d Tc Ah]
Seat 1: color_singleton (big blind) folded before Flop
Seat 2: manon327 folded on the Turn
Seat 3: GillesdeH folded on the Turn
Seat 4: PokerStarMan123 folded on the River
Seat 6: Klemtonius collected (2482)
Seat 8: JeBoyDirk (button) folded before Flop (didn't bet)
Seat 9: dhduncan (small blind) folded before Flop



PokerStars Home Game Hand #226311458157: {DaPokaStars}  Hold'em No Limit (50/100) - 2021/04/29 15:55:42 ET
Table 'yes_sir' 9-max (Play Money) Seat #9 is the button
Seat 1: color_singleton (12506 in chips) 
Seat 2: manon327 (9592 in chips) 
Seat 3: GillesdeH (13825 in chips) 
Seat 4: PokerStarMan123 (3726 in chips) 
Seat 6: Klemtonius (13402 in chips) 
Seat 8: JeBoyDirk (4448 in chips) 
Seat 9: dhduncan (5874 in chips) 
color_singleton: posts small blind 50
manon327: posts big blind 100
*** HOLE CARDS ***
Dealt to PokerStarMan123 [9c Ad]
GillesdeH: calls 100
PokerStarMan123: raises 300 to 400
Klemtonius: folds 
JeBoyDirk: calls 400
dhduncan: folds 
color_singleton: folds 
manon327: folds 
GillesdeH: calls 300
*** FLOP *** [8d 4s 9d]
GillesdeH: checks 
PokerStarMan123: bets 700
JeBoyDirk: folds 
GillesdeH: calls 700
*** TURN *** [8d 4s 9d] [Kd]
GillesdeH: checks 
PokerStarMan123: bets 2626 and is all-in
GillesdeH: calls 2626
*** RIVER *** [8d 4s 9d Kd] [7s]
*** SHOW DOWN ***
GillesdeH: shows [Ts Tc] (a pair of Tens)
PokerStarMan123: shows [9c Ad] (a pair of Nines)
GillesdeH collected 7562 from pot
*** SUMMARY ***
Total pot 8002 | Rake 440 
Board [8d 4s 9d Kd 7s]
Seat 1: color_singleton (small blind) folded before Flop
Seat 2: manon327 (big blind) folded before Flop
Seat 3: GillesdeH showed [Ts Tc] and won (7562) with a pair of Tens
Seat 4: PokerStarMan123 showed [9c Ad] and lost with a pair of Nines
Seat 6: Klemtonius folded before Flop (didn't bet)
Seat 8: JeBoyDirk folded on the Flop
Seat 9: dhduncan (button) folded before Flop (didn't bet)



PokerStars Home Game Hand #226311611773: {DaPokaStars}  Hold'em No Limit (50/100) - 2021/04/29 16:01:21 ET
Table 'yes_sir' 9-max (Play Money) Seat #6 is the button
Seat 1: color_singleton (8508 in chips) 
Seat 2: manon327 (8992 in chips) 
Seat 3: GillesdeH (19518 in chips) 
Seat 4: PokerStarMan123 (10000 in chips) 
Seat 6: Klemtonius (14287 in chips) 
Seat 8: JeBoyDirk (6475 in chips) 
Seat 9: dhduncan (4424 in chips) 
JeBoyDirk: posts small blind 50
dhduncan: posts big blind 100
PokerStarMan123: posts small & big blinds 150
*** HOLE CARDS ***
Dealt to PokerStarMan123 [3h 6s]
color_singleton: folds 
manon327: calls 100
GillesdeH has timed out
GillesdeH: folds 
PokerStarMan123: checks 
Klemtonius: calls 100
JeBoyDirk: calls 50
dhduncan: checks 
*** FLOP *** [2s 3d Ts]
JeBoyDirk: checks 
dhduncan: bets 100
manon327: folds 
PokerStarMan123: calls 100
Klemtonius: calls 100
JeBoyDirk: folds 
*** TURN *** [2s 3d Ts] [Qh]
dhduncan: checks 
PokerStarMan123: checks 
Klemtonius: checks 
*** RIVER *** [2s 3d Ts Qh] [5c]
dhduncan: bets 100
PokerStarMan123: calls 100
Klemtonius: folds 
*** SHOW DOWN ***
dhduncan: shows [6c Th] (a pair of Tens)
PokerStarMan123: mucks hand 
dhduncan collected 992 from pot
*** SUMMARY ***
Total pot 1050 | Rake 58 
Board [2s 3d Ts Qh 5c]
Seat 1: color_singleton folded before Flop (didn't bet)
Seat 2: manon327 folded on the Flop
Seat 3: GillesdeH folded before Flop (didn't bet)
Seat 4: PokerStarMan123 mucked [3h 6s]
Seat 6: Klemtonius (button) folded on the River
Seat 8: JeBoyDirk (small blind) folded on the Flop
Seat 9: dhduncan (big blind) showed [6c Th] and won (992) with a pair of Tens



PokerStars Home Game Hand #226311662336: {DaPokaStars}  Hold'em No Limit (50/100) - 2021/04/29 16:02:51 ET
Table 'yes_sir' 9-max (Play Money) Seat #8 is the button
Seat 1: color_singleton (8508 in chips) 
Seat 2: manon327 (8892 in chips) 
Seat 3: GillesdeH (19518 in chips) 
Seat 4: PokerStarMan123 (9650 in chips) 
Seat 6: Klemtonius (14087 in chips) 
Seat 8: JeBoyDirk (6375 in chips) 
Seat 9: dhduncan (5116 in chips) 
dhduncan: posts small blind 50
color_singleton: posts big blind 100
*** HOLE CARDS ***
Dealt to PokerStarMan123 [5h Ac]
manon327: calls 100
GillesdeH: calls 100
PokerStarMan123: calls 100
Klemtonius: calls 100
JeBoyDirk: calls 100
dhduncan: calls 50
color_singleton: checks 
*** FLOP *** [9s Ad 7s]
dhduncan: checks 
color_singleton: checks 
manon327: checks 
GillesdeH: checks 
PokerStarMan123: bets 400
Klemtonius: folds 
JeBoyDirk: calls 400
dhduncan: folds 
color_singleton: calls 400
manon327: folds 
GillesdeH: folds 
*** TURN *** [9s Ad 7s] [6h]
color_singleton: checks 
PokerStarMan123: bets 900
JeBoyDirk: folds 
color_singleton: raises 900 to 1800
PokerStarMan123: calls 900
*** RIVER *** [9s Ad 7s 6h] [5d]
color_singleton: checks 
PokerStarMan123: bets 2000
color_singleton: calls 2000
*** SHOW DOWN ***
PokerStarMan123: shows [5h Ac] (two pair, Aces and Fives)
color_singleton: mucks hand 
PokerStarMan123 collected 8977 from pot
*** SUMMARY ***
Total pot 9500 | Rake 523 
Board [9s Ad 7s 6h 5d]
Seat 1: color_singleton (big blind) mucked [7d 6c]
Seat 2: manon327 folded on the Flop
Seat 3: GillesdeH folded on the Flop
Seat 4: PokerStarMan123 showed [5h Ac] and won (8977) with two pair, Aces and Fives
Seat 6: Klemtonius folded on the Flop
Seat 8: JeBoyDirk (button) folded on the Turn
Seat 9: dhduncan (small blind) folded on the Flop



PokerStars Home Game Hand #226311726693: {DaPokaStars}  Hold'em No Limit (50/100) - 2021/04/29 16:04:40 ET
Table 'yes_sir' 9-max (Play Money) Seat #9 is the button
Seat 1: color_singleton (4208 in chips) 
Seat 2: manon327 (8792 in chips) 
Seat 3: GillesdeH (19418 in chips) 
Seat 4: PokerStarMan123 (14327 in chips) 
Seat 6: Klemtonius (13987 in chips) 
Seat 8: JeBoyDirk (5875 in chips) 
Seat 9: dhduncan (5016 in chips) 
color_singleton: posts small blind 50
manon327: posts big blind 100
*** HOLE CARDS ***
Dealt to PokerStarMan123 [3c Jc]
GillesdeH: calls 100
PokerStarMan123: folds 
Klemtonius: raises 350 to 450
JeBoyDirk: folds 
dhduncan: folds 
color_singleton: folds 
manon327: calls 350
GillesdeH: calls 350
*** FLOP *** [Kd Kh Ac]
manon327: checks 
GillesdeH: bets 100
Klemtonius: raises 761 to 861
manon327: calls 861
GillesdeH: folds 
*** TURN *** [Kd Kh Ac] [Qh]
manon327: checks 
Klemtonius: bets 1522
manon327: folds 
Uncalled bet (1522) returned to Klemtonius
Klemtonius collected 3045 from pot
Klemtonius: doesn't show hand 
*** SUMMARY ***
Total pot 3222 | Rake 177 
Board [Kd Kh Ac Qh]
Seat 1: color_singleton (small blind) folded before Flop
Seat 2: manon327 (big blind) folded on the Turn
Seat 3: GillesdeH folded on the Flop
Seat 4: PokerStarMan123 folded before Flop (didn't bet)
Seat 6: Klemtonius collected (3045)
Seat 8: JeBoyDirk folded before Flop (didn't bet)
Seat 9: dhduncan (button) folded before Flop (didn't bet)



PokerStars Home Game Hand #226311762307: {DaPokaStars}  Hold'em No Limit (50/100) - 2021/04/29 16:05:40 ET
Table 'yes_sir' 9-max (Play Money) Seat #1 is the button
Seat 1: color_singleton (4158 in chips) 
Seat 2: manon327 (7481 in chips) 
Seat 3: GillesdeH (18868 in chips) 
Seat 4: PokerStarMan123 (14327 in chips) 
Seat 6: Klemtonius (15721 in chips) 
Seat 8: JeBoyDirk (5875 in chips) 
Seat 9: dhduncan (5016 in chips) 
manon327: posts small blind 50
GillesdeH: posts big blind 100
*** HOLE CARDS ***
Dealt to PokerStarMan123 [8c Ts]
PokerStarMan123: folds 
Klemtonius: folds 
JeBoyDirk: folds 
dhduncan: folds 
color_singleton: calls 100
manon327: calls 50
GillesdeH: checks 
*** FLOP *** [5d Kd Ac]
manon327: checks 
GillesdeH: checks 
color_singleton: bets 141
manon327: calls 141
GillesdeH: calls 141
*** TURN *** [5d Kd Ac] [8d]
manon327: checks 
GillesdeH: checks 
color_singleton: checks 
*** RIVER *** [5d Kd Ac 8d] [8h]
manon327: checks 
GillesdeH: checks 
color_singleton: checks 
*** SHOW DOWN ***
manon327: shows [Ad 2h] (two pair, Aces and Eights)
GillesdeH: mucks hand 
color_singleton: mucks hand 
manon327 collected 683 from pot
*** SUMMARY ***
Total pot 723 | Rake 40 
Board [5d Kd Ac 8d 8h]
Seat 1: color_singleton (button) mucked [Kh 6s]
Seat 2: manon327 (small blind) showed [Ad 2h] and won (683) with two pair, Aces and Eights
Seat 3: GillesdeH (big blind) mucked [Th 6d]
Seat 4: PokerStarMan123 folded before Flop (didn't bet)
Seat 6: Klemtonius folded before Flop (didn't bet)
Seat 8: JeBoyDirk folded before Flop (didn't bet)
Seat 9: dhduncan folded before Flop (didn't bet)



PokerStars Home Game Hand #226311799305: {DaPokaStars}  Hold'em No Limit (50/100) - 2021/04/29 16:06:43 ET
Table 'yes_sir' 9-max (Play Money) Seat #2 is the button
Seat 1: color_singleton (3917 in chips) 
Seat 2: manon327 (7923 in chips) 
Seat 3: GillesdeH (18627 in chips) 
Seat 4: PokerStarMan123 (14327 in chips) 
Seat 6: Klemtonius (15721 in chips) 
Seat 8: JeBoyDirk (5875 in chips) 
Seat 9: dhduncan (5016 in chips) 
GillesdeH: posts small blind 50
PokerStarMan123: posts big blind 100
*** HOLE CARDS ***
Dealt to PokerStarMan123 [2s 6c]
Klemtonius: calls 100
JeBoyDirk: folds 
dhduncan: calls 100
color_singleton: folds 
manon327: folds 
GillesdeH: calls 50
PokerStarMan123: checks 
*** FLOP *** [3h 6d Qd]
GillesdeH: bets 500
PokerStarMan123: folds 
Klemtonius: folds 
dhduncan: folds 
Uncalled bet (500) returned to GillesdeH
GillesdeH collected 378 from pot
*** SUMMARY ***
Total pot 400 | Rake 22 
Board [3h 6d Qd]
Seat 1: color_singleton folded before Flop (didn't bet)
Seat 2: manon327 (button) folded before Flop (didn't bet)
Seat 3: GillesdeH (small blind) collected (378)
Seat 4: PokerStarMan123 (big blind) folded on the Flop
Seat 6: Klemtonius folded on the Flop
Seat 8: JeBoyDirk folded before Flop (didn't bet)
Seat 9: dhduncan folded on the Flop



PokerStars Home Game Hand #226311825787: {DaPokaStars}  Hold'em No Limit (50/100) - 2021/04/29 16:07:28 ET
Table 'yes_sir' 9-max (Play Money) Seat #3 is the button
Seat 1: color_singleton (3917 in chips) 
Seat 2: manon327 (7923 in chips) 
Seat 3: GillesdeH (18905 in chips) 
Seat 4: PokerStarMan123 (14227 in chips) 
Seat 6: Klemtonius (15621 in chips) 
Seat 8: JeBoyDirk (5875 in chips) 
Seat 9: dhduncan (4916 in chips) 
PokerStarMan123: posts small blind 50
Klemtonius: posts big blind 100
*** HOLE CARDS ***
Dealt to PokerStarMan123 [5d Ks]
JeBoyDirk: folds 
dhduncan: folds 
color_singleton: calls 100
manon327: folds 
GillesdeH: calls 100
PokerStarMan123: calls 50
Klemtonius: raises 400 to 500
color_singleton: calls 400
GillesdeH: calls 400
PokerStarMan123: folds 
*** FLOP *** [8d Tc 7d]
Klemtonius: bets 1512
color_singleton: folds 
GillesdeH: folds 
Uncalled bet (1512) returned to Klemtonius
Klemtonius collected 1512 from pot
Klemtonius: doesn't show hand 
*** SUMMARY ***
Total pot 1600 | Rake 88 
Board [8d Tc 7d]
Seat 1: color_singleton folded on the Flop
Seat 2: manon327 folded before Flop (didn't bet)
Seat 3: GillesdeH (button) folded on the Flop
Seat 4: PokerStarMan123 (small blind) folded before Flop
Seat 6: Klemtonius (big blind) collected (1512)
Seat 8: JeBoyDirk folded before Flop (didn't bet)
Seat 9: dhduncan folded before Flop (didn't bet)



PokerStars Home Game Hand #226311849035: {DaPokaStars}  Hold'em No Limit (50/100) - 2021/04/29 16:08:07 ET
Table 'yes_sir' 9-max (Play Money) Seat #4 is the button
Seat 1: color_singleton (3417 in chips) 
Seat 2: manon327 (7923 in chips) 
Seat 3: GillesdeH (18405 in chips) 
Seat 4: PokerStarMan123 (14127 in chips) 
Seat 6: Klemtonius (16633 in chips) 
Seat 8: JeBoyDirk (5875 in chips) 
Seat 9: dhduncan (4916 in chips) 
Klemtonius: posts small blind 50
JeBoyDirk: posts big blind 100
*** HOLE CARDS ***
Dealt to PokerStarMan123 [Jh 4d]
dhduncan: calls 100
color_singleton: raises 300 to 400
manon327: folds 
GillesdeH: calls 400
PokerStarMan123: folds 
Klemtonius: folds 
JeBoyDirk: folds 
dhduncan: calls 300
*** FLOP *** [Qd 4h 8h]
dhduncan: checks 
color_singleton: checks 
GillesdeH: checks 
*** TURN *** [Qd 4h 8h] [Ah]
dhduncan: checks 
color_singleton: checks 
GillesdeH: checks 
*** RIVER *** [Qd 4h 8h Ah] [8c]
dhduncan: checks 
color_singleton: checks 
GillesdeH: checks 
*** SHOW DOWN ***
dhduncan: shows [Ks 2c] (a pair of Eights)
color_singleton: shows [7h 7d] (two pair, Eights and Sevens)
GillesdeH: mucks hand 
color_singleton collected 1276 from pot
*** SUMMARY ***
Total pot 1350 | Rake 74 
Board [Qd 4h 8h Ah 8c]
Seat 1: color_singleton showed [7h 7d] and won (1276) with two pair, Eights and Sevens
Seat 2: manon327 folded before Flop (didn't bet)
Seat 3: GillesdeH mucked [2d Jd]
Seat 4: PokerStarMan123 (button) folded before Flop (didn't bet)
Seat 6: Klemtonius (small blind) folded before Flop
Seat 8: JeBoyDirk (big blind) folded before Flop
Seat 9: dhduncan showed [Ks 2c] and lost with a pair of Eights



PokerStars Home Game Hand #226311881069: {DaPokaStars}  Hold'em No Limit (50/100) - 2021/04/29 16:09:02 ET
Table 'yes_sir' 9-max (Play Money) Seat #6 is the button
Seat 1: color_singleton (4293 in chips) 
Seat 2: manon327 (7923 in chips) 
Seat 3: GillesdeH (18005 in chips) 
Seat 4: PokerStarMan123 (14127 in chips) 
Seat 6: Klemtonius (16583 in chips) 
Seat 8: JeBoyDirk (5775 in chips) 
Seat 9: dhduncan (4516 in chips) 
JeBoyDirk: posts small blind 50
dhduncan: posts big blind 100
*** HOLE CARDS ***
Dealt to PokerStarMan123 [7d Td]
color_singleton: folds 
manon327: calls 100
GillesdeH: calls 100
PokerStarMan123: calls 100
Klemtonius: folds 
JeBoyDirk: calls 50
dhduncan: checks 
*** FLOP *** [3d 4h As]
JeBoyDirk: checks 
dhduncan: checks 
manon327: checks 
GillesdeH: bets 100
PokerStarMan123: folds 
JeBoyDirk: folds 
dhduncan: calls 100
manon327: calls 100
*** TURN *** [3d 4h As] [6d]
dhduncan: checks 
manon327: checks 
GillesdeH: checks 
*** RIVER *** [3d 4h As 6d] [8h]
dhduncan: checks 
manon327: bets 378
GillesdeH: calls 378
dhduncan: folds 
*** SHOW DOWN ***
manon327: shows [Qd 3h] (a pair of Threes)
GillesdeH: shows [Kd Ah] (a pair of Aces)
GillesdeH collected 1470 from pot
*** SUMMARY ***
Total pot 1556 | Rake 86 
Board [3d 4h As 6d 8h]
Seat 1: color_singleton folded before Flop (didn't bet)
Seat 2: manon327 showed [Qd 3h] and lost with a pair of Threes
Seat 3: GillesdeH showed [Kd Ah] and won (1470) with a pair of Aces
Seat 4: PokerStarMan123 folded on the Flop
Seat 6: Klemtonius (button) folded before Flop (didn't bet)
Seat 8: JeBoyDirk (small blind) folded on the Flop
Seat 9: dhduncan (big blind) folded on the River



PokerStars Home Game Hand #226311934827: {DaPokaStars}  Hold'em No Limit (50/100) - 2021/04/29 16:10:34 ET
Table 'yes_sir' 9-max (Play Money) Seat #8 is the button
Seat 1: color_singleton (4293 in chips) 
Seat 2: manon327 (7345 in chips) 
Seat 3: GillesdeH (18897 in chips) 
Seat 4: PokerStarMan123 (14027 in chips) 
Seat 6: Klemtonius (16583 in chips) 
Seat 8: JeBoyDirk (5675 in chips) 
Seat 9: dhduncan (4316 in chips) 
dhduncan: posts small blind 50
color_singleton: posts big blind 100
*** HOLE CARDS ***
Dealt to PokerStarMan123 [As 3s]
manon327: folds 
GillesdeH: calls 100
PokerStarMan123: raises 200 to 300
Klemtonius: calls 300
JeBoyDirk: folds 
dhduncan: folds 
color_singleton: calls 200
GillesdeH: calls 200
*** FLOP *** [Kc 5d 2c]
color_singleton: bets 1181
GillesdeH: folds 
PokerStarMan123: folds 
Klemtonius: folds 
Uncalled bet (1181) returned to color_singleton
color_singleton collected 1181 from pot
color_singleton: doesn't show hand 
*** SUMMARY ***
Total pot 1250 | Rake 69 
Board [Kc 5d 2c]
Seat 1: color_singleton (big blind) collected (1181)
Seat 2: manon327 folded before Flop (didn't bet)
Seat 3: GillesdeH folded on the Flop
Seat 4: PokerStarMan123 folded on the Flop
Seat 6: Klemtonius folded on the Flop
Seat 8: JeBoyDirk (button) folded before Flop (didn't bet)
Seat 9: dhduncan (small blind) folded before Flop



PokerStars Home Game Hand #226311964132: {DaPokaStars}  Hold'em No Limit (50/100) - 2021/04/29 16:11:24 ET
Table 'yes_sir' 9-max (Play Money) Seat #9 is the button
Seat 1: color_singleton (5174 in chips) 
Seat 2: manon327 (7345 in chips) 
Seat 3: GillesdeH (18597 in chips) 
Seat 4: PokerStarMan123 (13727 in chips) 
Seat 6: Klemtonius (16283 in chips) 
Seat 8: JeBoyDirk (5675 in chips) 
Seat 9: dhduncan (4266 in chips) 
color_singleton: posts small blind 50
manon327: posts big blind 100
*** HOLE CARDS ***
Dealt to PokerStarMan123 [6d Qh]
GillesdeH: calls 100
PokerStarMan123: folds 
Klemtonius: calls 100
JeBoyDirk: folds 
dhduncan: calls 100
color_singleton: raises 200 to 300
manon327: calls 200
GillesdeH: calls 200
Klemtonius: calls 200
dhduncan: calls 200
*** FLOP *** [4s 9s Kc]
color_singleton: checks 
manon327: checks 
GillesdeH: checks 
Klemtonius: checks 
dhduncan: checks 
*** TURN *** [4s 9s Kc] [5s]
color_singleton: checks 
manon327: bets 708
GillesdeH: folds 
Klemtonius: folds 
dhduncan: folds 
color_singleton: folds 
Uncalled bet (708) returned to manon327
manon327 collected 1417 from pot
*** SUMMARY ***
Total pot 1500 | Rake 83 
Board [4s 9s Kc 5s]
Seat 1: color_singleton (small blind) folded on the Turn
Seat 2: manon327 (big blind) collected (1417)
Seat 3: GillesdeH folded on the Turn
Seat 4: PokerStarMan123 folded before Flop (didn't bet)
Seat 6: Klemtonius folded on the Turn
Seat 8: JeBoyDirk folded before Flop (didn't bet)
Seat 9: dhduncan (button) folded on the Turn



PokerStars Home Game Hand #226312003128: {DaPokaStars}  Hold'em No Limit (50/100) - 2021/04/29 16:12:22 ET
Table 'yes_sir' 9-max (Play Money) Seat #1 is the button
Seat 1: color_singleton (4874 in chips) 
Seat 2: manon327 (8462 in chips) 
Seat 3: GillesdeH (18297 in chips) 
Seat 4: PokerStarMan123 (13727 in chips) 
Seat 6: Klemtonius (15983 in chips) 
Seat 8: JeBoyDirk (5675 in chips) 
Seat 9: dhduncan (3966 in chips) 
manon327: posts small blind 50
GillesdeH: posts big blind 100
*** HOLE CARDS ***
Dealt to PokerStarMan123 [As 8h]
PokerStarMan123 has timed out
PokerStarMan123: folds 
Klemtonius: calls 100
JeBoyDirk: folds 
dhduncan: folds 
color_singleton: folds 
manon327: calls 50
GillesdeH: checks 
*** FLOP *** [5d Qs Ad]
manon327: checks 
GillesdeH: checks 
Klemtonius: bets 141
manon327: calls 141
GillesdeH: raises 141 to 282
Klemtonius: calls 141
manon327: calls 141
*** TURN *** [5d Qs Ad] [Qh]
manon327: checks 
GillesdeH: bets 1083
Klemtonius: folds 
manon327: folds 
Uncalled bet (1083) returned to GillesdeH
GillesdeH collected 1083 from pot
*** SUMMARY ***
Total pot 1146 | Rake 63 
Board [5d Qs Ad Qh]
Seat 1: color_singleton (button) folded before Flop (didn't bet)
Seat 2: manon327 (small blind) folded on the Turn
Seat 3: GillesdeH (big blind) collected (1083)
Seat 4: PokerStarMan123 folded before Flop (didn't bet)
Seat 6: Klemtonius folded on the Turn
Seat 8: JeBoyDirk folded before Flop (didn't bet)
Seat 9: dhduncan folded before Flop (didn't bet)



PokerStars Home Game Hand #226312041876: {DaPokaStars}  Hold'em No Limit (50/100) - 2021/04/29 16:13:28 ET
Table 'yes_sir' 9-max (Play Money) Seat #2 is the button
Seat 1: color_singleton (4874 in chips) 
Seat 2: manon327 (8080 in chips) 
Seat 3: GillesdeH (18998 in chips) 
Seat 4: PokerStarMan123 (13727 in chips) 
Seat 6: Klemtonius (15601 in chips) 
Seat 8: JeBoyDirk (5675 in chips) 
Seat 9: dhduncan (3966 in chips) 
GillesdeH: posts small blind 50
PokerStarMan123: posts big blind 100
*** HOLE CARDS ***
Dealt to PokerStarMan123 [3d 8d]
Klemtonius: calls 100
JeBoyDirk: folds 
dhduncan: calls 100
color_singleton: folds 
manon327: calls 100
GillesdeH: calls 50
PokerStarMan123: checks 
*** FLOP *** [Jd Tc 7c]
GillesdeH: bets 472
PokerStarMan123: folds 
Klemtonius: calls 472
dhduncan: calls 472
manon327: calls 472
*** TURN *** [Jd Tc 7c] [Kh]
GillesdeH: bets 600
Klemtonius: raises 1800 to 2400
dhduncan: calls 2400
manon327: folds 
GillesdeH: calls 1800
*** RIVER *** [Jd Tc 7c Kh] [Th]
GillesdeH: checks 
Klemtonius: bets 3500
dhduncan: calls 994 and is all-in
GillesdeH: calls 3500
*** SHOW DOWN ***
Klemtonius: shows [8h Qs] (a pair of Tens)
GillesdeH: shows [Ks Kd] (a full house, Kings full of Tens)
GillesdeH collected 4736 from side pot
dhduncan: mucks hand 
GillesdeH collected 11879 from main pot
*** SUMMARY ***
Total pot 17582 Main pot 11879. Side pot 4736. | Rake 967 
Board [Jd Tc 7c Kh Th]
Seat 1: color_singleton folded before Flop (didn't bet)
Seat 2: manon327 (button) folded on the Turn
Seat 3: GillesdeH (small blind) showed [Ks Kd] and won (16615) with a full house, Kings full of Tens
Seat 4: PokerStarMan123 (big blind) folded on the Flop
Seat 6: Klemtonius showed [8h Qs] and lost with a pair of Tens
Seat 8: JeBoyDirk folded before Flop (didn't bet)
Seat 9: dhduncan mucked [Qc 9c]



PokerStars Home Game Hand #226312081208: {DaPokaStars}  Hold'em No Limit (50/100) - 2021/04/29 16:14:36 ET
Table 'yes_sir' 9-max (Play Money) Seat #3 is the button
Seat 1: color_singleton (4874 in chips) 
Seat 2: manon327 (7508 in chips) 
Seat 3: GillesdeH (29141 in chips) 
Seat 4: PokerStarMan123 (13627 in chips) 
Seat 6: Klemtonius (9129 in chips) 
Seat 8: JeBoyDirk (5675 in chips) 
PokerStarMan123: posts small blind 50
Klemtonius: posts big blind 100
*** HOLE CARDS ***
Dealt to PokerStarMan123 [Th Tc]
JeBoyDirk: folds 
color_singleton: calls 100
manon327: folds 
GillesdeH: calls 100
PokerStarMan123: raises 200 to 300
Klemtonius: folds 
color_singleton: calls 200
GillesdeH: calls 200
*** FLOP *** [Ac 7c Ad]
PokerStarMan123: bets 500
color_singleton: folds 
GillesdeH: folds 
Uncalled bet (500) returned to PokerStarMan123
PokerStarMan123 collected 945 from pot
*** SUMMARY ***
Total pot 1000 | Rake 55 
Board [Ac 7c Ad]
Seat 1: color_singleton folded on the Flop
Seat 2: manon327 folded before Flop (didn't bet)
Seat 3: GillesdeH (button) folded on the Flop
Seat 4: PokerStarMan123 (small blind) collected (945)
Seat 6: Klemtonius (big blind) folded before Flop
Seat 8: JeBoyDirk folded before Flop (didn't bet)



PokerStars Home Game Hand #226312119770: {DaPokaStars}  Hold'em No Limit (50/100) - 2021/04/29 16:15:41 ET
Table 'yes_sir' 9-max (Play Money) Seat #4 is the button
Seat 1: color_singleton (4574 in chips) 
Seat 2: manon327 (7508 in chips) 
Seat 3: GillesdeH (28841 in chips) 
Seat 4: PokerStarMan123 (14272 in chips) 
Seat 6: Klemtonius (9029 in chips) 
Seat 8: JeBoyDirk (5675 in chips) 
Seat 9: dhduncan (10000 in chips) 
Klemtonius: posts small blind 50
JeBoyDirk: posts big blind 100
*** HOLE CARDS ***
Dealt to PokerStarMan123 [3c 2h]
dhduncan: folds 
color_singleton: folds 
manon327: calls 100
GillesdeH: calls 100
PokerStarMan123: folds 
Klemtonius: calls 50
JeBoyDirk: checks 
*** FLOP *** [Ah 9c Kc]
Klemtonius: bets 189
JeBoyDirk: raises 189 to 378
manon327: calls 378
GillesdeH: calls 378
Klemtonius: calls 189
*** TURN *** [Ah 9c Kc] [Kh]
Klemtonius: checks 
JeBoyDirk: bets 300
manon327: calls 300
GillesdeH: calls 300
Klemtonius: calls 300
*** RIVER *** [Ah 9c Kc Kh] [5s]
Klemtonius: checks 
JeBoyDirk: bets 2000
manon327: folds 
GillesdeH: folds 
Klemtonius: raises 3700 to 5700
JeBoyDirk: calls 2897 and is all-in
Uncalled bet (803) returned to Klemtonius
*** SHOW DOWN ***
Klemtonius: shows [Kd 4d] (three of a kind, Kings)
JeBoyDirk: shows [9h 9d] (a full house, Nines full of Kings)
JeBoyDirk collected 12196 from pot
*** SUMMARY ***
Total pot 12906 | Rake 710 
Board [Ah 9c Kc Kh 5s]
Seat 1: color_singleton folded before Flop (didn't bet)
Seat 2: manon327 folded on the River
Seat 3: GillesdeH folded on the River
Seat 4: PokerStarMan123 (button) folded before Flop (didn't bet)
Seat 6: Klemtonius (small blind) showed [Kd 4d] and lost with three of a kind, Kings
Seat 8: JeBoyDirk (big blind) showed [9h 9d] and won (12196) with a full house, Nines full of Kings
Seat 9: dhduncan folded before Flop (didn't bet)



PokerStars Home Game Hand #226312161461: {DaPokaStars}  Hold'em No Limit (50/100) - 2021/04/29 16:16:51 ET
Table 'yes_sir' 9-max (Play Money) Seat #6 is the button
Seat 1: color_singleton (4574 in chips) 
Seat 2: manon327 (6730 in chips) 
Seat 3: GillesdeH (28063 in chips) 
Seat 4: PokerStarMan123 (14272 in chips) 
Seat 6: Klemtonius (3354 in chips) 
Seat 8: JeBoyDirk (12196 in chips) 
Seat 9: dhduncan (10000 in chips) 
JeBoyDirk: posts small blind 50
dhduncan: posts big blind 100
*** HOLE CARDS ***
Dealt to PokerStarMan123 [9s 7d]
color_singleton: raises 200 to 300
manon327: folds 
GillesdeH: calls 300
PokerStarMan123: calls 300
Klemtonius: calls 300
JeBoyDirk: calls 250
dhduncan: calls 200
*** FLOP *** [Ks Ac 4c]
JeBoyDirk: checks 
dhduncan: checks 
color_singleton: checks 
GillesdeH: checks 
PokerStarMan123: checks 
Klemtonius: checks 
*** TURN *** [Ks Ac 4c] [5h]
JeBoyDirk: bets 600
dhduncan: calls 600
color_singleton: folds 
GillesdeH: folds 
PokerStarMan123: folds 
Klemtonius: folds 
*** RIVER *** [Ks Ac 4c 5h] [Th]
JeBoyDirk: bets 1100
dhduncan: raises 1100 to 2200
JeBoyDirk: calls 1100
*** SHOW DOWN ***
dhduncan: shows [Qh Jc] (a straight, Ten to Ace)
JeBoyDirk: mucks hand 
dhduncan collected 6993 from pot
*** SUMMARY ***
Total pot 7400 | Rake 407 
Board [Ks Ac 4c 5h Th]
Seat 1: color_singleton folded on the Turn
Seat 2: manon327 folded before Flop (didn't bet)
Seat 3: GillesdeH folded on the Turn
Seat 4: PokerStarMan123 folded on the Turn
Seat 6: Klemtonius (button) folded on the Turn
Seat 8: JeBoyDirk (small blind) mucked [Td As]
Seat 9: dhduncan (big blind) showed [Qh Jc] and won (6993) with a straight, Ten to Ace



PokerStars Home Game Hand #226312213170: {DaPokaStars}  Hold'em No Limit (50/100) - 2021/04/29 16:18:17 ET
Table 'yes_sir' 9-max (Play Money) Seat #8 is the button
Seat 1: color_singleton (4274 in chips) 
Seat 2: manon327 (6730 in chips) 
Seat 3: GillesdeH (27763 in chips) 
Seat 4: PokerStarMan123 (13972 in chips) 
Seat 6: Klemtonius (3054 in chips) 
Seat 8: JeBoyDirk (9096 in chips) 
Seat 9: dhduncan (13893 in chips) 
dhduncan: posts small blind 50
color_singleton: posts big blind 100
*** HOLE CARDS ***
Dealt to PokerStarMan123 [9s 3d]
manon327: calls 100
GillesdeH: calls 100
PokerStarMan123: folds 
Klemtonius: calls 100
JeBoyDirk: calls 100
dhduncan: calls 50
color_singleton: checks 
*** FLOP *** [8c 3c 2s]
manon327 is disconnected 
dhduncan: checks 
color_singleton: bets 283
manon327: calls 283
GillesdeH: calls 283
Klemtonius: folds 
JeBoyDirk: folds 
dhduncan: calls 283
*** TURN *** [8c 3c 2s] [2c]
dhduncan: checks 
color_singleton: bets 818
manon327: folds 
GillesdeH: folds 
dhduncan: calls 818
*** RIVER *** [8c 3c 2s 2c] [Qh]
dhduncan: checks 
color_singleton: bets 1591
dhduncan: calls 1591
*** SHOW DOWN ***
color_singleton: shows [3h 2h] (a full house, Deuces full of Threes)
dhduncan: mucks hand 
color_singleton collected 6190 from pot
*** SUMMARY ***
Total pot 6550 | Rake 360 
Board [8c 3c 2s 2c Qh]
Seat 1: color_singleton (big blind) showed [3h 2h] and won (6190) with a full house, Deuces full of Threes
Seat 2: manon327 folded on the Turn
Seat 3: GillesdeH folded on the Turn
Seat 4: PokerStarMan123 folded before Flop (didn't bet)
Seat 6: Klemtonius folded on the Flop
Seat 8: JeBoyDirk (button) folded on the Flop
Seat 9: dhduncan (small blind) mucked [7c 5c]



PokerStars Home Game Hand #226312263550: {DaPokaStars}  Hold'em No Limit (50/100) - 2021/04/29 16:19:41 ET
Table 'yes_sir' 9-max (Play Money) Seat #9 is the button
Seat 1: color_singleton (7672 in chips) 
Seat 2: manon327 (6347 in chips) 
Seat 3: GillesdeH (27380 in chips) 
Seat 4: PokerStarMan123 (13972 in chips) 
Seat 6: Klemtonius (2954 in chips) 
Seat 8: JeBoyDirk (8996 in chips) 
Seat 9: dhduncan (11101 in chips) 
color_singleton: posts small blind 50
manon327: posts big blind 100
*** HOLE CARDS ***
Dealt to PokerStarMan123 [8h 4s]
GillesdeH: folds 
PokerStarMan123: folds 
Klemtonius: calls 100
JeBoyDirk: folds 
dhduncan: calls 100
color_singleton: calls 50
manon327: checks 
*** FLOP *** [2c Qh Td]
color_singleton: checks 
manon327: bets 189
Klemtonius: folds 
dhduncan: calls 189
color_singleton: calls 189
*** TURN *** [2c Qh Td] [3h]
color_singleton: checks 
manon327: checks 
dhduncan: checks 
*** RIVER *** [2c Qh Td 3h] [2d]
color_singleton: checks 
manon327: bets 457
dhduncan has timed out
dhduncan: folds 
color_singleton: folds 
Uncalled bet (457) returned to manon327
manon327 collected 914 from pot
*** SUMMARY ***
Total pot 967 | Rake 53 
Board [2c Qh Td 3h 2d]
Seat 1: color_singleton (small blind) folded on the River
Seat 2: manon327 (big blind) collected (914)
Seat 3: GillesdeH folded before Flop (didn't bet)
Seat 4: PokerStarMan123 folded before Flop (didn't bet)
Seat 6: Klemtonius folded on the Flop
Seat 8: JeBoyDirk folded before Flop (didn't bet)
Seat 9: dhduncan (button) folded on the River



PokerStars Home Game Hand #226312318558: {DaPokaStars}  Hold'em No Limit (50/100) - 2021/04/29 16:21:00 ET
Table 'yes_sir' 9-max (Play Money) Seat #1 is the button
Seat 1: color_singleton (7383 in chips) 
Seat 2: manon327 (6972 in chips) 
Seat 3: GillesdeH (27380 in chips) 
Seat 4: PokerStarMan123 (13972 in chips) 
Seat 6: Klemtonius (2854 in chips) 
Seat 8: JeBoyDirk (8996 in chips) 
manon327: posts small blind 50
GillesdeH: posts big blind 100
*** HOLE CARDS ***
Dealt to PokerStarMan123 [Td Ac]
PokerStarMan123: raises 300 to 400
Klemtonius: calls 400
JeBoyDirk: folds 
color_singleton: folds 
manon327: calls 350
GillesdeH: calls 300
*** FLOP *** [8c 9h 9d]
manon327: bets 756
GillesdeH: folds 
PokerStarMan123: folds 
Klemtonius: folds 
Uncalled bet (756) returned to manon327
manon327 collected 1512 from pot
*** SUMMARY ***
Total pot 1600 | Rake 88 
Board [8c 9h 9d]
Seat 1: color_singleton (button) folded before Flop (didn't bet)
Seat 2: manon327 (small blind) collected (1512)
Seat 3: GillesdeH (big blind) folded on the Flop
Seat 4: PokerStarMan123 folded on the Flop
Seat 6: Klemtonius folded on the Flop
Seat 8: JeBoyDirk folded before Flop (didn't bet)



PokerStars Home Game Hand #226312340478: {DaPokaStars}  Hold'em No Limit (50/100) - 2021/04/29 16:21:36 ET
Table 'yes_sir' 9-max (Play Money) Seat #2 is the button
Seat 1: color_singleton (7383 in chips) 
Seat 2: manon327 (8084 in chips) 
Seat 3: GillesdeH (26980 in chips) 
Seat 4: PokerStarMan123 (13572 in chips) 
Seat 6: Klemtonius (2454 in chips) 
Seat 8: JeBoyDirk (8996 in chips) 
Seat 9: dhduncan (10812 in chips) 
GillesdeH: posts small blind 50
PokerStarMan123: posts big blind 100
*** HOLE CARDS ***
Dealt to PokerStarMan123 [Qc 2d]
Klemtonius: calls 100
JeBoyDirk: folds 
dhduncan: folds 
color_singleton: raises 200 to 300
manon327: folds 
GillesdeH: calls 250
PokerStarMan123: folds 
Klemtonius: raises 200 to 500
color_singleton: calls 200
GillesdeH: calls 200
*** FLOP *** [3c 3h 5c]
GillesdeH: checks 
Klemtonius: checks 
color_singleton: checks 
*** TURN *** [3c 3h 5c] [7s]
GillesdeH: checks 
Klemtonius: bets 400
color_singleton: folds 
GillesdeH: calls 400
*** RIVER *** [3c 3h 5c 7s] [9c]
GillesdeH: bets 1134
Klemtonius: folds 
Uncalled bet (1134) returned to GillesdeH
GillesdeH collected 2268 from pot
*** SUMMARY ***
Total pot 2400 | Rake 132 
Board [3c 3h 5c 7s 9c]
Seat 1: color_singleton folded on the Turn
Seat 2: manon327 (button) folded before Flop (didn't bet)
Seat 3: GillesdeH (small blind) collected (2268)
Seat 4: PokerStarMan123 (big blind) folded before Flop
Seat 6: Klemtonius folded on the River
Seat 8: JeBoyDirk folded before Flop (didn't bet)
Seat 9: dhduncan folded before Flop (didn't bet)



PokerStars Home Game Hand #226312389219: {DaPokaStars}  Hold'em No Limit (50/100) - 2021/04/29 16:22:57 ET
Table 'yes_sir' 9-max (Play Money) Seat #3 is the button
Seat 1: color_singleton (6883 in chips) 
Seat 2: manon327 (8084 in chips) 
Seat 3: GillesdeH (28348 in chips) 
Seat 4: PokerStarMan123 (13472 in chips) 
Seat 6: Klemtonius (1554 in chips) 
Seat 8: JeBoyDirk (8996 in chips) 
Seat 9: dhduncan (10812 in chips) 
PokerStarMan123: posts small blind 50
Klemtonius: posts big blind 100
*** HOLE CARDS ***
Dealt to PokerStarMan123 [Jc Ah]
JeBoyDirk: folds 
dhduncan: calls 100
color_singleton: raises 200 to 300
manon327: calls 300
GillesdeH: calls 300
PokerStarMan123: calls 250
Klemtonius: calls 200
dhduncan: calls 200
*** FLOP *** [Ts 8h 7c]
PokerStarMan123: checks 
Klemtonius: bets 1254 and is all-in
dhduncan: folds 
color_singleton: folds 
manon327: folds 
GillesdeH: calls 1254
PokerStarMan123: calls 1254
*** TURN *** [Ts 8h 7c] [4h]
PokerStarMan123: checks 
GillesdeH: checks 
*** RIVER *** [Ts 8h 7c 4h] [2h]
PokerStarMan123: checks 
GillesdeH: bets 1000
PokerStarMan123: folds 
Uncalled bet (1000) returned to GillesdeH
*** SHOW DOWN ***
GillesdeH: shows [Qs Qd] (a pair of Queens)
Klemtonius: shows [9c Qh] (high card Queen)
GillesdeH collected 5256 from pot
*** SUMMARY ***
Total pot 5562 | Rake 306 
Board [Ts 8h 7c 4h 2h]
Seat 1: color_singleton folded on the Flop
Seat 2: manon327 folded on the Flop
Seat 3: GillesdeH (button) showed [Qs Qd] and won (5256) with a pair of Queens
Seat 4: PokerStarMan123 (small blind) folded on the River
Seat 6: Klemtonius (big blind) showed [9c Qh] and lost with high card Queen
Seat 8: JeBoyDirk folded before Flop (didn't bet)
Seat 9: dhduncan folded on the Flop



PokerStars Home Game Hand #226312415939: {DaPokaStars}  Hold'em No Limit (50/100) - 2021/04/29 16:23:42 ET
Table 'yes_sir' 9-max (Play Money) Seat #4 is the button
Seat 1: color_singleton (6583 in chips) 
Seat 2: manon327 (7784 in chips) 
Seat 3: GillesdeH (32050 in chips) 
Seat 4: PokerStarMan123 (11918 in chips) 
Seat 8: JeBoyDirk (8996 in chips) 
Seat 9: dhduncan (10512 in chips) 
JeBoyDirk: posts small blind 50
dhduncan: posts big blind 100
*** HOLE CARDS ***
Dealt to PokerStarMan123 [Jh 8c]
color_singleton: raises 200 to 300
manon327: folds 
GillesdeH: calls 300
PokerStarMan123: folds 
JeBoyDirk: folds 
dhduncan: folds 
*** FLOP *** [Ks Js 3d]
color_singleton: checks 
GillesdeH: checks 
*** TURN *** [Ks Js 3d] [Ts]
color_singleton: checks 
GillesdeH: checks 
*** RIVER *** [Ks Js 3d Ts] [9d]
color_singleton: checks 
GillesdeH: checks 
*** SHOW DOWN ***
color_singleton: shows [Ac 4h] (high card Ace)
GillesdeH: shows [4s Ah] (high card Ace)
color_singleton collected 355 from pot
GillesdeH collected 354 from pot
*** SUMMARY ***
Total pot 750 | Rake 41 
Board [Ks Js 3d Ts 9d]
Seat 1: color_singleton showed [Ac 4h] and won (355) with high card Ace
Seat 2: manon327 folded before Flop (didn't bet)
Seat 3: GillesdeH showed [4s Ah] and won (354) with high card Ace
Seat 4: PokerStarMan123 (button) folded before Flop (didn't bet)
Seat 8: JeBoyDirk (small blind) folded before Flop
Seat 9: dhduncan (big blind) folded before Flop



PokerStars Home Game Hand #226312438373: {DaPokaStars}  Hold'em No Limit (50/100) - 2021/04/29 16:24:19 ET
Table 'yes_sir' 9-max (Play Money) Seat #8 is the button
Seat 1: color_singleton (6638 in chips) 
Seat 2: manon327 (7784 in chips) 
Seat 3: GillesdeH (32104 in chips) 
Seat 4: PokerStarMan123 (11918 in chips) 
Seat 6: Klemtonius (10000 in chips) 
Seat 8: JeBoyDirk (8946 in chips) 
Seat 9: dhduncan (10412 in chips) 
dhduncan: posts small blind 50
color_singleton: posts big blind 100
Klemtonius: posts small blind 50
*** HOLE CARDS ***
Dealt to PokerStarMan123 [5h 3d]
manon327: folds 
GillesdeH: calls 100
PokerStarMan123: folds 
Klemtonius: raises 100 to 200
JeBoyDirk: folds 
dhduncan: calls 150
color_singleton: calls 100
GillesdeH: calls 100
*** FLOP *** [6h 9d Qd]
dhduncan: bets 100
color_singleton: calls 100
GillesdeH: calls 100
Klemtonius: calls 100
*** TURN *** [6h 9d Qd] [8h]
dhduncan: bets 590
color_singleton: folds 
GillesdeH: folds 
Klemtonius: folds 
Uncalled bet (590) returned to dhduncan
dhduncan collected 1181 from pot
dhduncan: doesn't show hand 
*** SUMMARY ***
Total pot 1250 | Rake 69 
Board [6h 9d Qd 8h]
Seat 1: color_singleton (big blind) folded on the Turn
Seat 2: manon327 folded before Flop (didn't bet)
Seat 3: GillesdeH folded on the Turn
Seat 4: PokerStarMan123 folded before Flop (didn't bet)
Seat 6: Klemtonius folded on the Turn
Seat 8: JeBoyDirk (button) folded before Flop (didn't bet)
Seat 9: dhduncan (small blind) collected (1181)



PokerStars Home Game Hand #226312481881: {DaPokaStars}  Hold'em No Limit (50/100) - 2021/04/29 16:25:18 ET
Table 'yes_sir' 9-max (Play Money) Seat #9 is the button
Seat 1: color_singleton (6338 in chips) 
Seat 2: manon327 (7784 in chips) 
Seat 3: GillesdeH (31804 in chips) 
Seat 4: PokerStarMan123 (11918 in chips) 
Seat 6: Klemtonius (9650 in chips) 
Seat 8: JeBoyDirk (8946 in chips) 
Seat 9: dhduncan (11293 in chips) 
color_singleton: posts small blind 50
manon327: posts big blind 100
*** HOLE CARDS ***
Dealt to PokerStarMan123 [3d 4d]
GillesdeH: folds 
PokerStarMan123: calls 100
Klemtonius: calls 100
JeBoyDirk: folds 
dhduncan: folds 
color_singleton: raises 200 to 300
manon327: calls 200
PokerStarMan123: calls 200
Klemtonius: calls 200
*** FLOP *** [Kc 4h Jc]
color_singleton: checks 
manon327: checks 
PokerStarMan123: checks 
Klemtonius: bets 567
color_singleton: folds 
manon327: calls 567
PokerStarMan123: folds 
*** TURN *** [Kc 4h Jc] [9c]
manon327: bets 1103
Klemtonius: raises 1103 to 2206
manon327: calls 1103
*** RIVER *** [Kc 4h Jc 9c] [5h]
manon327: bets 4711 and is all-in
Klemtonius: folds 
Uncalled bet (4711) returned to manon327
manon327 collected 6375 from pot
*** SUMMARY ***
Total pot 6746 | Rake 371 
Board [Kc 4h Jc 9c 5h]
Seat 1: color_singleton (small blind) folded on the Flop
Seat 2: manon327 (big blind) collected (6375)
Seat 3: GillesdeH folded before Flop (didn't bet)
Seat 4: PokerStarMan123 folded on the Flop
Seat 6: Klemtonius folded on the River
Seat 8: JeBoyDirk folded before Flop (didn't bet)
Seat 9: dhduncan (button) folded before Flop (didn't bet)



PokerStars Home Game Hand #226312533962: {DaPokaStars}  Hold'em No Limit (50/100) - 2021/04/29 16:26:46 ET
Table 'yes_sir' 9-max (Play Money) Seat #1 is the button
Seat 1: color_singleton (6038 in chips) 
Seat 2: manon327 (11086 in chips) 
Seat 3: GillesdeH (31804 in chips) 
Seat 4: PokerStarMan123 (11618 in chips) 
Seat 6: Klemtonius (6577 in chips) 
Seat 8: JeBoyDirk (8946 in chips) 
Seat 9: dhduncan (11293 in chips) 
manon327: posts small blind 50
GillesdeH: posts big blind 100
*** HOLE CARDS ***
Dealt to PokerStarMan123 [5d 4c]
PokerStarMan123: calls 100
Klemtonius: calls 100
JeBoyDirk: folds 
dhduncan: folds 
color_singleton: raises 200 to 300
manon327: calls 250
GillesdeH: calls 200
PokerStarMan123: calls 200
Klemtonius: calls 200
*** FLOP *** [8s Jh 9c]
manon327: checks 
GillesdeH: checks 
PokerStarMan123: checks 
Klemtonius: checks 
color_singleton: checks 
*** TURN *** [8s Jh 9c] [Ad]
manon327: checks 
GillesdeH: checks 
PokerStarMan123: checks 
Klemtonius: checks 
color_singleton: bets 708
manon327: calls 708
GillesdeH: calls 708
PokerStarMan123: folds 
Klemtonius: calls 708
*** RIVER *** [8s Jh 9c Ad] [Th]
manon327: checks 
GillesdeH: checks 
Klemtonius: checks 
color_singleton: checks 
*** SHOW DOWN ***
manon327: shows [Ks Kc] (a pair of Kings)
GillesdeH: shows [Ah 3s] (a pair of Aces)
Klemtonius: shows [Qd 7c] (a straight, Eight to Queen)
color_singleton: mucks hand 
Klemtonius collected 4094 from pot
*** SUMMARY ***
Total pot 4332 | Rake 238 
Board [8s Jh 9c Ad Th]
Seat 1: color_singleton (button) mucked [As 3c]
Seat 2: manon327 (small blind) showed [Ks Kc] and lost with a pair of Kings
Seat 3: GillesdeH (big blind) showed [Ah 3s] and lost with a pair of Aces
Seat 4: PokerStarMan123 folded on the Turn
Seat 6: Klemtonius showed [Qd 7c] and won (4094) with a straight, Eight to Queen
Seat 8: JeBoyDirk folded before Flop (didn't bet)
Seat 9: dhduncan folded before Flop (didn't bet)



PokerStars Home Game Hand #226312585379: {DaPokaStars}  Hold'em No Limit (50/100) - 2021/04/29 16:28:12 ET
Table 'yes_sir' 9-max (Play Money) Seat #2 is the button
Seat 1: color_singleton (5030 in chips) 
Seat 2: manon327 (10078 in chips) 
Seat 3: GillesdeH (30796 in chips) 
Seat 4: PokerStarMan123 (11318 in chips) 
Seat 6: Klemtonius (9663 in chips) 
Seat 8: JeBoyDirk (8946 in chips) 
Seat 9: dhduncan (11293 in chips) 
GillesdeH: posts small blind 50
PokerStarMan123: posts big blind 100
*** HOLE CARDS ***
Dealt to PokerStarMan123 [3c 8h]
Klemtonius: folds 
JeBoyDirk: raises 200 to 300
dhduncan: folds 
color_singleton: calls 300
manon327: calls 300
GillesdeH: folds 
PokerStarMan123: folds 
*** FLOP *** [8d 4d Kc]
JeBoyDirk: bets 500
color_singleton: folds 
manon327: folds 
Uncalled bet (500) returned to JeBoyDirk
JeBoyDirk collected 992 from pot
*** SUMMARY ***
Total pot 1050 | Rake 58 
Board [8d 4d Kc]
Seat 1: color_singleton folded on the Flop
Seat 2: manon327 (button) folded on the Flop
Seat 3: GillesdeH (small blind) folded before Flop
Seat 4: PokerStarMan123 (big blind) folded before Flop
Seat 6: Klemtonius folded before Flop (didn't bet)
Seat 8: JeBoyDirk collected (992)
Seat 9: dhduncan folded before Flop (didn't bet)



PokerStars Home Game Hand #226312606668: {DaPokaStars}  Hold'em No Limit (50/100) - 2021/04/29 16:28:48 ET
Table 'yes_sir' 9-max (Play Money) Seat #3 is the button
Seat 1: color_singleton (4730 in chips) 
Seat 2: manon327 (9778 in chips) 
Seat 3: GillesdeH (30746 in chips) 
Seat 4: PokerStarMan123 (11218 in chips) 
Seat 6: Klemtonius (9663 in chips) 
Seat 8: JeBoyDirk (9638 in chips) 
Seat 9: dhduncan (11293 in chips) 
PokerStarMan123: posts small blind 50
Klemtonius: posts big blind 100
*** HOLE CARDS ***
Dealt to PokerStarMan123 [Ks 5d]
JeBoyDirk: raises 100 to 200
dhduncan: folds 
color_singleton: calls 200
manon327: folds 
GillesdeH: calls 200
PokerStarMan123: folds 
Klemtonius: calls 100
*** FLOP *** [8s 6d 5s]
Klemtonius: checks 
JeBoyDirk: checks 
color_singleton: bets 803
GillesdeH: folds 
Klemtonius: folds 
JeBoyDirk: folds 
Uncalled bet (803) returned to color_singleton
color_singleton collected 803 from pot
color_singleton: doesn't show hand 
*** SUMMARY ***
Total pot 850 | Rake 47 
Board [8s 6d 5s]
Seat 1: color_singleton collected (803)
Seat 2: manon327 folded before Flop (didn't bet)
Seat 3: GillesdeH (button) folded on the Flop
Seat 4: PokerStarMan123 (small blind) folded before Flop
Seat 6: Klemtonius (big blind) folded on the Flop
Seat 8: JeBoyDirk folded on the Flop
Seat 9: dhduncan folded before Flop (didn't bet)



PokerStars Home Game Hand #226312630391: {DaPokaStars}  Hold'em No Limit (50/100) - 2021/04/29 16:29:28 ET
Table 'yes_sir' 9-max (Play Money) Seat #4 is the button
Seat 1: color_singleton (5333 in chips) 
Seat 2: manon327 (9778 in chips) 
Seat 3: GillesdeH (30546 in chips) 
Seat 4: PokerStarMan123 (11168 in chips) 
Seat 6: Klemtonius (9463 in chips) 
Seat 8: JeBoyDirk (9438 in chips) 
Seat 9: dhduncan (11293 in chips) 
Klemtonius: posts small blind 50
JeBoyDirk: posts big blind 100
*** HOLE CARDS ***
Dealt to PokerStarMan123 [7c 8c]
dhduncan: folds 
color_singleton: calls 100
manon327: calls 100
GillesdeH: calls 100
PokerStarMan123: calls 100
Klemtonius: calls 50
JeBoyDirk: checks 
*** FLOP *** [8d 9c 5h]
Klemtonius: bets 283
JeBoyDirk: folds 
color_singleton: calls 283
manon327: folds 
GillesdeH: calls 283
PokerStarMan123: calls 283
*** TURN *** [8d 9c 5h] [3h]
Klemtonius: checks 
color_singleton: checks 
GillesdeH: checks 
PokerStarMan123: checks 
*** RIVER *** [8d 9c 5h 3h] [3s]
Klemtonius: checks 
color_singleton: checks 
GillesdeH: checks 
PokerStarMan123: checks 
*** SHOW DOWN ***
Klemtonius: shows [Qh Jc] (a pair of Threes)
color_singleton: shows [Qs 5s] (two pair, Fives and Threes)
GillesdeH: mucks hand 
PokerStarMan123: shows [7c 8c] (two pair, Eights and Threes)
PokerStarMan123 collected 1637 from pot
*** SUMMARY ***
Total pot 1732 | Rake 95 
Board [8d 9c 5h 3h 3s]
Seat 1: color_singleton showed [Qs 5s] and lost with two pair, Fives and Threes
Seat 2: manon327 folded on the Flop
Seat 3: GillesdeH mucked [Th Ah]
Seat 4: PokerStarMan123 (button) showed [7c 8c] and won (1637) with two pair, Eights and Threes
Seat 6: Klemtonius (small blind) showed [Qh Jc] and lost with a pair of Threes
Seat 8: JeBoyDirk (big blind) folded on the Flop
Seat 9: dhduncan folded before Flop (didn't bet)



PokerStars Home Game Hand #226312673770: {DaPokaStars}  Hold'em No Limit (50/100) - 2021/04/29 16:30:41 ET
Table 'yes_sir' 9-max (Play Money) Seat #6 is the button
Seat 1: color_singleton (4950 in chips) 
Seat 2: manon327 (9678 in chips) 
Seat 3: GillesdeH (30163 in chips) 
Seat 4: PokerStarMan123 (12422 in chips) 
Seat 6: Klemtonius (9080 in chips) 
Seat 8: JeBoyDirk (9338 in chips) 
Seat 9: dhduncan (11293 in chips) 
JeBoyDirk: posts small blind 50
dhduncan: posts big blind 100
*** HOLE CARDS ***
Dealt to PokerStarMan123 [Qs 2s]
color_singleton: folds 
manon327: calls 100
GillesdeH: calls 100
PokerStarMan123: folds 
Klemtonius: calls 100
JeBoyDirk: calls 50
dhduncan: checks 
*** FLOP *** [2d 8c 5s]
JeBoyDirk: checks 
dhduncan: bets 100
manon327: calls 100
GillesdeH: calls 100
Klemtonius: calls 100
JeBoyDirk: folds 
*** TURN *** [2d 8c 5s] [2c]
dhduncan: bets 425
manon327: folds 
GillesdeH: calls 425
Klemtonius: calls 425
*** RIVER *** [2d 8c 5s 2c] [4s]
dhduncan: bets 1027
GillesdeH: folds 
Klemtonius: raises 1027 to 2054
dhduncan: calls 1027
*** SHOW DOWN ***
Klemtonius: shows [Ac 3s] (a straight, Ace to Five)
dhduncan: mucks hand 
Klemtonius collected 5937 from pot
*** SUMMARY ***
Total pot 6283 | Rake 346 
Board [2d 8c 5s 2c 4s]
Seat 1: color_singleton folded before Flop (didn't bet)
Seat 2: manon327 folded on the Turn
Seat 3: GillesdeH folded on the River
Seat 4: PokerStarMan123 folded before Flop (didn't bet)
Seat 6: Klemtonius (button) showed [Ac 3s] and won (5937) with a straight, Ace to Five
Seat 8: JeBoyDirk (small blind) folded on the Flop
Seat 9: dhduncan (big blind) mucked [8s 5h]



PokerStars Home Game Hand #226312706229: {DaPokaStars}  Hold'em No Limit (50/100) - 2021/04/29 16:31:36 ET
Table 'yes_sir' 9-max (Play Money) Seat #8 is the button
Seat 1: color_singleton (4950 in chips) 
Seat 3: GillesdeH (29538 in chips) 
Seat 4: PokerStarMan123 (12422 in chips) 
Seat 6: Klemtonius (12338 in chips) 
Seat 8: JeBoyDirk (9238 in chips) 
Seat 9: dhduncan (8614 in chips) 
dhduncan: posts small blind 50
color_singleton: posts big blind 100
*** HOLE CARDS ***
Dealt to PokerStarMan123 [Kd Tc]
GillesdeH: calls 100
PokerStarMan123: calls 100
Klemtonius: raises 200 to 300
JeBoyDirk: folds 
dhduncan: folds 
color_singleton: folds 
GillesdeH: calls 200
PokerStarMan123: calls 200
*** FLOP *** [5d 8c 6d]
GillesdeH: checks 
PokerStarMan123: checks 
Klemtonius: bets 496
GillesdeH: calls 496
PokerStarMan123: calls 496
*** TURN *** [5d 8c 6d] [9s]
GillesdeH: bets 2398
PokerStarMan123: folds 
Klemtonius: folds 
Uncalled bet (2398) returned to GillesdeH
GillesdeH collected 2398 from pot
*** SUMMARY ***
Total pot 2538 | Rake 140 
Board [5d 8c 6d 9s]
Seat 1: color_singleton (big blind) folded before Flop
Seat 3: GillesdeH collected (2398)
Seat 4: PokerStarMan123 folded on the Turn
Seat 6: Klemtonius folded on the Turn
Seat 8: JeBoyDirk (button) folded before Flop (didn't bet)
Seat 9: dhduncan (small blind) folded before Flop



PokerStars Home Game Hand #226312745929: {DaPokaStars}  Hold'em No Limit (50/100) - 2021/04/29 16:32:44 ET
Table 'yes_sir' 9-max (Play Money) Seat #9 is the button
Seat 1: color_singleton (4850 in chips) 
Seat 2: manon327 (9478 in chips) 
Seat 3: GillesdeH (31140 in chips) 
Seat 4: PokerStarMan123 (11626 in chips) 
Seat 6: Klemtonius (11542 in chips) 
Seat 8: JeBoyDirk (9238 in chips) 
Seat 9: dhduncan (8564 in chips) 
color_singleton: posts small blind 50
manon327: posts big blind 100
*** HOLE CARDS ***
Dealt to PokerStarMan123 [8c Qd]
GillesdeH: calls 100
PokerStarMan123: folds 
Klemtonius: raises 100 to 200
JeBoyDirk: folds 
dhduncan: folds 
color_singleton: folds 
manon327: folds 
GillesdeH: calls 100
*** FLOP *** [5h Jc Ah]
GillesdeH: checks 
Klemtonius: bets 520
GillesdeH: folds 
Uncalled bet (520) returned to Klemtonius
Klemtonius collected 520 from pot
Klemtonius: doesn't show hand 
*** SUMMARY ***
Total pot 550 | Rake 30 
Board [5h Jc Ah]
Seat 1: color_singleton (small blind) folded before Flop
Seat 2: manon327 (big blind) folded before Flop
Seat 3: GillesdeH folded on the Flop
Seat 4: PokerStarMan123 folded before Flop (didn't bet)
Seat 6: Klemtonius collected (520)
Seat 8: JeBoyDirk folded before Flop (didn't bet)
Seat 9: dhduncan (button) folded before Flop (didn't bet)



PokerStars Home Game Hand #226312783364: {DaPokaStars}  Hold'em No Limit (50/100) - 2021/04/29 16:33:46 ET
Table 'yes_sir' 9-max (Play Money) Seat #1 is the button
Seat 1: color_singleton (4800 in chips) 
Seat 2: manon327 (9378 in chips) 
Seat 3: GillesdeH (30940 in chips) 
Seat 4: PokerStarMan123 (11626 in chips) 
Seat 6: Klemtonius (11862 in chips) 
Seat 8: JeBoyDirk (9238 in chips) 
Seat 9: dhduncan (8564 in chips) 
manon327: posts small blind 50
GillesdeH: posts big blind 100
*** HOLE CARDS ***
Dealt to PokerStarMan123 [8d 2c]
PokerStarMan123: folds 
Klemtonius: raises 250 to 350
JeBoyDirk: folds 
dhduncan: folds 
color_singleton: folds 
manon327: calls 300
GillesdeH: calls 250
*** FLOP *** [Kc Jh 7h]
manon327: checks 
GillesdeH: checks 
Klemtonius: bets 496
manon327: folds 
GillesdeH: calls 496
*** TURN *** [Kc Jh 7h] [Qd]
GillesdeH: checks 
Klemtonius: bets 1930
GillesdeH: folds 
Uncalled bet (1930) returned to Klemtonius
Klemtonius collected 1930 from pot
Klemtonius: doesn't show hand 
*** SUMMARY ***
Total pot 2042 | Rake 112 
Board [Kc Jh 7h Qd]
Seat 1: color_singleton (button) folded before Flop (didn't bet)
Seat 2: manon327 (small blind) folded on the Flop
Seat 3: GillesdeH (big blind) folded on the Turn
Seat 4: PokerStarMan123 folded before Flop (didn't bet)
Seat 6: Klemtonius collected (1930)
Seat 8: JeBoyDirk folded before Flop (didn't bet)
Seat 9: dhduncan folded before Flop (didn't bet)



PokerStars Home Game Hand #226312819294: {DaPokaStars}  Hold'em No Limit (50/100) - 2021/04/29 16:34:47 ET
Table 'yes_sir' 9-max (Play Money) Seat #2 is the button
Seat 1: color_singleton (4800 in chips) 
Seat 2: manon327 (9028 in chips) 
Seat 3: GillesdeH (30094 in chips) 
Seat 4: PokerStarMan123 (11626 in chips) 
Seat 6: Klemtonius (12946 in chips) 
Seat 8: JeBoyDirk (9238 in chips) 
Seat 9: dhduncan (8564 in chips) 
GillesdeH: posts small blind 50
PokerStarMan123: posts big blind 100
*** HOLE CARDS ***
Dealt to PokerStarMan123 [6d 5d]
Klemtonius: calls 100
JeBoyDirk: folds 
dhduncan: folds 
color_singleton: folds 
manon327: calls 100
GillesdeH: calls 50
PokerStarMan123: checks 
*** FLOP *** [2h 5h 3s]
GillesdeH: checks 
PokerStarMan123: bets 300
Klemtonius: raises 978 to 1278
manon327: folds 
GillesdeH: folds 
PokerStarMan123: folds 
Uncalled bet (978) returned to Klemtonius
Klemtonius collected 945 from pot
Klemtonius: doesn't show hand 
*** SUMMARY ***
Total pot 1000 | Rake 55 
Board [2h 5h 3s]
Seat 1: color_singleton folded before Flop (didn't bet)
Seat 2: manon327 (button) folded on the Flop
Seat 3: GillesdeH (small blind) folded on the Flop
Seat 4: PokerStarMan123 (big blind) folded on the Flop
Seat 6: Klemtonius collected (945)
Seat 8: JeBoyDirk folded before Flop (didn't bet)
Seat 9: dhduncan folded before Flop (didn't bet)



PokerStars Home Game Hand #226312849279: {DaPokaStars}  Hold'em No Limit (50/100) - 2021/04/29 16:35:37 ET
Table 'yes_sir' 9-max (Play Money) Seat #3 is the button
Seat 1: color_singleton (4800 in chips) 
Seat 2: manon327 (8928 in chips) 
Seat 3: GillesdeH (29994 in chips) 
Seat 4: PokerStarMan123 (11226 in chips) 
Seat 6: Klemtonius (13491 in chips) 
Seat 8: JeBoyDirk (9238 in chips) 
Seat 9: dhduncan (8564 in chips) 
PokerStarMan123: posts small blind 50
Klemtonius: posts big blind 100
*** HOLE CARDS ***
Dealt to PokerStarMan123 [Ah 8h]
JeBoyDirk: folds 
dhduncan: calls 100
color_singleton: folds 
manon327: folds 
GillesdeH: calls 100
PokerStarMan123: raises 300 to 400
Klemtonius: calls 300
dhduncan: folds 
GillesdeH: calls 300
*** FLOP *** [4d 7s Qh]
PokerStarMan123: checks 
Klemtonius: checks 
GillesdeH: checks 
*** TURN *** [4d 7s Qh] [5s]
PokerStarMan123: checks 
Klemtonius: checks 
GillesdeH: checks 
*** RIVER *** [4d 7s Qh 5s] [Jd]
PokerStarMan123: checks 
Klemtonius: bets 614
GillesdeH: folds 
PokerStarMan123: folds 
Uncalled bet (614) returned to Klemtonius
Klemtonius collected 1228 from pot
Klemtonius: doesn't show hand 
*** SUMMARY ***
Total pot 1300 | Rake 72 
Board [4d 7s Qh 5s Jd]
Seat 1: color_singleton folded before Flop (didn't bet)
Seat 2: manon327 folded before Flop (didn't bet)
Seat 3: GillesdeH (button) folded on the River
Seat 4: PokerStarMan123 (small blind) folded on the River
Seat 6: Klemtonius (big blind) collected (1228)
Seat 8: JeBoyDirk folded before Flop (didn't bet)
Seat 9: dhduncan folded before Flop



PokerStars Home Game Hand #226312905167: {DaPokaStars}  Hold'em No Limit (50/100) - 2021/04/29 16:37:13 ET
Table 'yes_sir' 9-max (Play Money) Seat #4 is the button
Seat 1: color_singleton (4800 in chips) 
Seat 2: manon327 (8928 in chips) 
Seat 3: GillesdeH (29594 in chips) 
Seat 4: PokerStarMan123 (10826 in chips) 
Seat 6: Klemtonius (14319 in chips) 
Seat 8: JeBoyDirk (9238 in chips) 
Seat 9: dhduncan (8464 in chips) 
Klemtonius: posts small blind 50
JeBoyDirk: posts big blind 100
*** HOLE CARDS ***
Dealt to PokerStarMan123 [Js 6s]
dhduncan: folds 
color_singleton: folds 
manon327: folds 
GillesdeH: calls 100
PokerStarMan123: folds 
Klemtonius: calls 50
JeBoyDirk: checks 
*** FLOP *** [3h 9c Ad]
Klemtonius: checks 
JeBoyDirk: checks 
GillesdeH: bets 141
Klemtonius: folds 
JeBoyDirk: folds 
Uncalled bet (141) returned to GillesdeH
GillesdeH collected 283 from pot
*** SUMMARY ***
Total pot 300 | Rake 17 
Board [3h 9c Ad]
Seat 1: color_singleton folded before Flop (didn't bet)
Seat 2: manon327 folded before Flop (didn't bet)
Seat 3: GillesdeH collected (283)
Seat 4: PokerStarMan123 (button) folded before Flop (didn't bet)
Seat 6: Klemtonius (small blind) folded on the Flop
Seat 8: JeBoyDirk (big blind) folded on the Flop
Seat 9: dhduncan folded before Flop (didn't bet)



PokerStars Home Game Hand #226312936498: {DaPokaStars}  Hold'em No Limit (50/100) - 2021/04/29 16:37:54 ET
Table 'yes_sir' 9-max (Play Money) Seat #6 is the button
Seat 1: color_singleton (4800 in chips) 
Seat 2: manon327 (8928 in chips) 
Seat 3: GillesdeH (29777 in chips) 
Seat 4: PokerStarMan123 (10826 in chips) 
Seat 6: Klemtonius (14219 in chips) 
Seat 8: JeBoyDirk (9138 in chips) 
Seat 9: dhduncan (8464 in chips) 
JeBoyDirk: posts small blind 50
dhduncan: posts big blind 100
*** HOLE CARDS ***
Dealt to PokerStarMan123 [Kd 4s]
color_singleton: folds 
manon327: calls 100
GillesdeH: raises 200 to 300
PokerStarMan123: folds 
Klemtonius: calls 300
JeBoyDirk: folds 
dhduncan: folds 
manon327: folds 
*** FLOP *** [8c 7c 5d]
GillesdeH: bets 401
Klemtonius: calls 401
*** TURN *** [8c 7c 5d] [5s]
GillesdeH: checks 
Klemtonius: checks 
*** RIVER *** [8c 7c 5d 5s] [3c]
GillesdeH: checks 
Klemtonius: bets 780
GillesdeH: calls 780
*** SHOW DOWN ***
Klemtonius: shows [Qh Tc] (a pair of Fives)
GillesdeH: shows [Ad 9h] (a pair of Fives - Ace kicker)
GillesdeH collected 3035 from pot
*** SUMMARY ***
Total pot 3212 | Rake 177 
Board [8c 7c 5d 5s 3c]
Seat 1: color_singleton folded before Flop (didn't bet)
Seat 2: manon327 folded before Flop
Seat 3: GillesdeH showed [Ad 9h] and won (3035) with a pair of Fives
Seat 4: PokerStarMan123 folded before Flop (didn't bet)
Seat 6: Klemtonius (button) showed [Qh Tc] and lost with a pair of Fives
Seat 8: JeBoyDirk (small blind) folded before Flop
Seat 9: dhduncan (big blind) folded before Flop



PokerStars Home Game Hand #226312971350: {DaPokaStars}  Hold'em No Limit (50/100) - 2021/04/29 16:38:54 ET
Table 'yes_sir' 9-max (Play Money) Seat #8 is the button
Seat 1: color_singleton (4800 in chips) 
Seat 2: manon327 (8828 in chips) 
Seat 3: GillesdeH (31331 in chips) 
Seat 4: PokerStarMan123 (10826 in chips) 
Seat 6: Klemtonius (12738 in chips) 
Seat 8: JeBoyDirk (9088 in chips) 
Seat 9: dhduncan (8364 in chips) 
dhduncan: posts small blind 50
color_singleton: posts big blind 100
*** HOLE CARDS ***
Dealt to PokerStarMan123 [5d 6s]
manon327: calls 100
GillesdeH: calls 100
PokerStarMan123: calls 100
Klemtonius: calls 100
JeBoyDirk: folds 
dhduncan: folds 
color_singleton: checks 
*** FLOP *** [Ad Qh Th]
color_singleton: checks 
manon327: checks 
GillesdeH: checks 
PokerStarMan123: checks 
Klemtonius: checks 
*** TURN *** [Ad Qh Th] [As]
color_singleton: checks 
manon327: checks 
GillesdeH: checks 
PokerStarMan123: checks 
Klemtonius: checks 
*** RIVER *** [Ad Qh Th As] [9c]
color_singleton: checks 
manon327: checks 
GillesdeH: bets 1400
PokerStarMan123: folds 
Klemtonius: folds 
color_singleton: folds 
manon327: folds 
Uncalled bet (1400) returned to GillesdeH
GillesdeH collected 520 from pot
*** SUMMARY ***
Total pot 550 | Rake 30 
Board [Ad Qh Th As 9c]
Seat 1: color_singleton (big blind) folded on the River
Seat 2: manon327 folded on the River
Seat 3: GillesdeH collected (520)
Seat 4: PokerStarMan123 folded on the River
Seat 6: Klemtonius folded on the River
Seat 8: JeBoyDirk (button) folded before Flop (didn't bet)
Seat 9: dhduncan (small blind) folded before Flop



PokerStars Home Game Hand #226313014746: {DaPokaStars}  Hold'em No Limit (50/100) - 2021/04/29 16:40:10 ET
Table 'yes_sir' 9-max (Play Money) Seat #1 is the button
Seat 1: color_singleton (4700 in chips) 
Seat 2: manon327 (8728 in chips) 
Seat 3: GillesdeH (31751 in chips) 
Seat 4: PokerStarMan123 (10726 in chips) 
Seat 6: Klemtonius (12638 in chips) 
Seat 8: JeBoyDirk (9088 in chips) 
manon327: posts small blind 50
GillesdeH: posts big blind 100
*** HOLE CARDS ***
Dealt to PokerStarMan123 [5s Qc]
PokerStarMan123: folds 
Klemtonius: calls 100
JeBoyDirk: calls 100
color_singleton: calls 100
manon327: calls 50
GillesdeH: checks 
*** FLOP *** [7c 4d 9s]
manon327: checks 
GillesdeH: checks 
Klemtonius: checks 
JeBoyDirk: bets 200
color_singleton: folds 
manon327: folds 
GillesdeH: calls 200
Klemtonius: folds 
*** TURN *** [7c 4d 9s] [6h]
GillesdeH: checks 
JeBoyDirk: bets 400
GillesdeH: calls 400
*** RIVER *** [7c 4d 9s 6h] [Qd]
GillesdeH: checks 
JeBoyDirk: checks 
*** SHOW DOWN ***
GillesdeH: shows [7d 8d] (a pair of Sevens)
JeBoyDirk: shows [Td 9h] (a pair of Nines)
JeBoyDirk collected 1606 from pot
*** SUMMARY ***
Total pot 1700 | Rake 94 
Board [7c 4d 9s 6h Qd]
Seat 1: color_singleton (button) folded on the Flop
Seat 2: manon327 (small blind) folded on the Flop
Seat 3: GillesdeH (big blind) showed [7d 8d] and lost with a pair of Sevens
Seat 4: PokerStarMan123 folded before Flop (didn't bet)
Seat 6: Klemtonius folded on the Flop
Seat 8: JeBoyDirk showed [Td 9h] and won (1606) with a pair of Nines



PokerStars Home Game Hand #226313060422: {DaPokaStars}  Hold'em No Limit (50/100) - 2021/04/29 16:41:29 ET
Table 'yes_sir' 9-max (Play Money) Seat #2 is the button
Seat 1: color_singleton (4600 in chips) 
Seat 2: manon327 (8628 in chips) 
Seat 3: GillesdeH (31051 in chips) 
Seat 4: PokerStarMan123 (10726 in chips) 
Seat 6: Klemtonius (12538 in chips) 
Seat 8: JeBoyDirk (9994 in chips) 
Seat 9: dhduncan (8314 in chips) 
GillesdeH: posts small blind 50
PokerStarMan123: posts big blind 100
*** HOLE CARDS ***
Dealt to PokerStarMan123 [7d Th]
Klemtonius: calls 100
JeBoyDirk: folds 
dhduncan: folds 
color_singleton: folds 
manon327: calls 100
GillesdeH: calls 50
PokerStarMan123: checks 
*** FLOP *** [9d 6s 5h]
GillesdeH: bets 378
PokerStarMan123: calls 378
Klemtonius: folds 
manon327: calls 378
*** TURN *** [9d 6s 5h] [5c]
GillesdeH has timed out
GillesdeH: checks 
PokerStarMan123: checks 
manon327: bets 1450
GillesdeH: calls 1450
PokerStarMan123: folds 
*** RIVER *** [9d 6s 5h 5c] [3d]
GillesdeH: checks 
manon327: bets 4190
GillesdeH: calls 4190
*** SHOW DOWN ***
manon327: shows [Kc Ks] (two pair, Kings and Fives)
GillesdeH: shows [6d 6h] (a full house, Sixes full of Fives)
GillesdeH collected 12109 from pot
*** SUMMARY ***
Total pot 12814 | Rake 705 
Board [9d 6s 5h 5c 3d]
Seat 1: color_singleton folded before Flop (didn't bet)
Seat 2: manon327 (button) showed [Kc Ks] and lost with two pair, Kings and Fives
Seat 3: GillesdeH (small blind) showed [6d 6h] and won (12109) with a full house, Sixes full of Fives
Seat 4: PokerStarMan123 (big blind) folded on the Turn
Seat 6: Klemtonius folded on the Flop
Seat 8: JeBoyDirk folded before Flop (didn't bet)
Seat 9: dhduncan folded before Flop (didn't bet)



PokerStars Home Game Hand #226313112398: {DaPokaStars}  Hold'em No Limit (50/100) - 2021/04/29 16:42:59 ET
Table 'yes_sir' 9-max (Play Money) Seat #3 is the button
Seat 1: color_singleton (4600 in chips) 
Seat 2: manon327 (2510 in chips) 
Seat 3: GillesdeH (37042 in chips) 
Seat 4: PokerStarMan123 (10248 in chips) 
Seat 6: Klemtonius (12438 in chips) 
Seat 8: JeBoyDirk (9994 in chips) 
Seat 9: dhduncan (8314 in chips) 
PokerStarMan123: posts small blind 50
Klemtonius: posts big blind 100
*** HOLE CARDS ***
Dealt to PokerStarMan123 [Jc Td]
JeBoyDirk: folds 
dhduncan: folds 
color_singleton: raises 100 to 200
manon327: calls 200
GillesdeH: calls 200
PokerStarMan123: calls 150
Klemtonius: calls 100
*** FLOP *** [2s 8s 2d]
PokerStarMan123: checks 
Klemtonius: bets 100
color_singleton: calls 100
manon327: raises 622 to 722
GillesdeH: folds 
PokerStarMan123: folds 
Klemtonius: folds 
color_singleton: raises 622 to 1344
manon327: calls 622
*** TURN *** [2s 8s 2d] [Th]
color_singleton: bets 1790
manon327: calls 966 and is all-in
Uncalled bet (824) returned to color_singleton
*** RIVER *** [2s 8s 2d Th] [Ac]
*** SHOW DOWN ***
color_singleton: shows [2c As] (a full house, Deuces full of Aces)
manon327: shows [Qc 2h] (three of a kind, Deuces)
color_singleton collected 5405 from pot
*** SUMMARY ***
Total pot 5720 | Rake 315 
Board [2s 8s 2d Th Ac]
Seat 1: color_singleton showed [2c As] and won (5405) with a full house, Deuces full of Aces
Seat 2: manon327 showed [Qc 2h] and lost with three of a kind, Deuces
Seat 3: GillesdeH (button) folded on the Flop
Seat 4: PokerStarMan123 (small blind) folded on the Flop
Seat 6: Klemtonius (big blind) folded on the Flop
Seat 8: JeBoyDirk folded before Flop (didn't bet)
Seat 9: dhduncan folded before Flop (didn't bet)



PokerStars Home Game Hand #226313162848: {DaPokaStars}  Hold'em No Limit (50/100) - 2021/04/29 16:44:27 ET
Table 'yes_sir' 9-max (Play Money) Seat #4 is the button
Seat 1: color_singleton (7495 in chips) 
Seat 3: GillesdeH (36842 in chips) 
Seat 4: PokerStarMan123 (10048 in chips) 
Seat 6: Klemtonius (12138 in chips) 
Seat 8: JeBoyDirk (9994 in chips) 
Seat 9: dhduncan (8314 in chips) 
Klemtonius: posts small blind 50
JeBoyDirk: posts big blind 100
*** HOLE CARDS ***
Dealt to PokerStarMan123 [5c 4c]
dhduncan: folds 
color_singleton: raises 200 to 300
GillesdeH: calls 300
PokerStarMan123: calls 300
Klemtonius: calls 250
JeBoyDirk: folds 
*** FLOP *** [8h 2s Kc]
Klemtonius: checks 
color_singleton: bets 614
GillesdeH: folds 
PokerStarMan123: folds 
Klemtonius: folds 
Uncalled bet (614) returned to color_singleton
color_singleton collected 1228 from pot
color_singleton: doesn't show hand 
*** SUMMARY ***
Total pot 1300 | Rake 72 
Board [8h 2s Kc]
Seat 1: color_singleton collected (1228)
Seat 3: GillesdeH folded on the Flop
Seat 4: PokerStarMan123 (button) folded on the Flop
Seat 6: Klemtonius (small blind) folded on the Flop
Seat 8: JeBoyDirk (big blind) folded before Flop
Seat 9: dhduncan folded before Flop (didn't bet)



PokerStars Home Game Hand #226313189967: {DaPokaStars}  Hold'em No Limit (50/100) - 2021/04/29 16:45:14 ET
Table 'yes_sir' 9-max (Play Money) Seat #6 is the button
Seat 1: color_singleton (8423 in chips) 
Seat 2: manon327 (10000 in chips) 
Seat 3: GillesdeH (36542 in chips) 
Seat 4: PokerStarMan123 (9748 in chips) 
Seat 6: Klemtonius (11838 in chips) 
Seat 8: JeBoyDirk (9894 in chips) 
Seat 9: dhduncan (8314 in chips) 
JeBoyDirk: posts small blind 50
dhduncan: posts big blind 100
*** HOLE CARDS ***
Dealt to PokerStarMan123 [4s 8c]
color_singleton: raises 200 to 300
manon327: folds 
GillesdeH: calls 300
PokerStarMan123: folds 
Klemtonius: folds 
JeBoyDirk: calls 250
dhduncan: folds 
*** FLOP *** [2s 5c Qs]
JeBoyDirk: checks 
color_singleton: checks 
GillesdeH: checks 
*** TURN *** [2s 5c Qs] [Jh]
JeBoyDirk: checks 
color_singleton: checks 
GillesdeH: checks 
*** RIVER *** [2s 5c Qs Jh] [5h]
JeBoyDirk: checks 
color_singleton: checks 
GillesdeH: checks 
*** SHOW DOWN ***
JeBoyDirk: shows [As 7d] (a pair of Fives)
color_singleton: shows [9c Ah] (a pair of Fives)
GillesdeH: mucks hand 
JeBoyDirk collected 473 from pot
color_singleton collected 472 from pot
*** SUMMARY ***
Total pot 1000 | Rake 55 
Board [2s 5c Qs Jh 5h]
Seat 1: color_singleton showed [9c Ah] and won (472) with a pair of Fives
Seat 2: manon327 folded before Flop (didn't bet)
Seat 3: GillesdeH mucked [8s Tc]
Seat 4: PokerStarMan123 folded before Flop (didn't bet)
Seat 6: Klemtonius (button) folded before Flop (didn't bet)
Seat 8: JeBoyDirk (small blind) showed [As 7d] and won (473) with a pair of Fives
Seat 9: dhduncan (big blind) folded before Flop



PokerStars Home Game Hand #226313220890: {DaPokaStars}  Hold'em No Limit (50/100) - 2021/04/29 16:46:07 ET
Table 'yes_sir' 9-max (Play Money) Seat #8 is the button
Seat 1: color_singleton (8595 in chips) 
Seat 2: manon327 (10000 in chips) 
Seat 3: GillesdeH (36242 in chips) 
Seat 4: PokerStarMan123 (9748 in chips) 
Seat 6: Klemtonius (11838 in chips) 
Seat 8: JeBoyDirk (10067 in chips) 
Seat 9: dhduncan (8214 in chips) 
dhduncan: posts small blind 50
color_singleton: posts big blind 100
*** HOLE CARDS ***
Dealt to PokerStarMan123 [Th 7c]
manon327: folds 
GillesdeH: calls 100
PokerStarMan123: folds 
Klemtonius: calls 100
JeBoyDirk: folds 
dhduncan: folds 
color_singleton: raises 200 to 300
GillesdeH: calls 200
Klemtonius: calls 200
*** FLOP *** [2c 9d Jd]
color_singleton: checks 
GillesdeH: checks 
Klemtonius: bets 449
color_singleton: calls 449
GillesdeH: folds 
*** TURN *** [2c 9d Jd] [Qd]
color_singleton: checks 
Klemtonius: bets 873
color_singleton: calls 873
*** RIVER *** [2c 9d Jd Qd] [3d]
color_singleton: bets 1698
Klemtonius: calls 1698
*** SHOW DOWN ***
color_singleton: shows [Ad Ac] (a flush, Ace high)
Klemtonius: mucks hand 
color_singleton collected 6606 from pot
*** SUMMARY ***
Total pot 6990 | Rake 384 
Board [2c 9d Jd Qd 3d]
Seat 1: color_singleton (big blind) showed [Ad Ac] and won (6606) with a flush, Ace high
Seat 2: manon327 folded before Flop (didn't bet)
Seat 3: GillesdeH folded on the Flop
Seat 4: PokerStarMan123 folded before Flop (didn't bet)
Seat 6: Klemtonius mucked [Js Td]
Seat 8: JeBoyDirk (button) folded before Flop (didn't bet)
Seat 9: dhduncan (small blind) folded before Flop



PokerStars Home Game Hand #226313271738: {DaPokaStars}  Hold'em No Limit (50/100) - 2021/04/29 16:47:30 ET
Table 'yes_sir' 9-max (Play Money) Seat #9 is the button
Seat 1: color_singleton (11881 in chips) 
Seat 2: manon327 (10000 in chips) 
Seat 3: GillesdeH (35942 in chips) 
Seat 4: PokerStarMan123 (9748 in chips) 
Seat 6: Klemtonius (8518 in chips) 
Seat 8: JeBoyDirk (10067 in chips) 
Seat 9: dhduncan (8164 in chips) 
color_singleton: posts small blind 50
manon327: posts big blind 100
*** HOLE CARDS ***
Dealt to PokerStarMan123 [7s Js]
GillesdeH: calls 100
PokerStarMan123: calls 100
Klemtonius: folds 
JeBoyDirk: calls 100
dhduncan: calls 100
color_singleton: calls 50
manon327: checks 
*** FLOP *** [Qh 8s 7c]
color_singleton: checks 
manon327: checks 
GillesdeH: checks 
PokerStarMan123: checks 
JeBoyDirk: checks 
dhduncan: checks 
*** TURN *** [Qh 8s 7c] [Tc]
color_singleton: bets 283
manon327: folds 
GillesdeH: calls 283
PokerStarMan123: calls 283
JeBoyDirk: raises 717 to 1000
dhduncan: folds 
color_singleton: calls 717
GillesdeH: folds 
PokerStarMan123: folds 
*** RIVER *** [Qh 8s 7c Tc] [9h]
color_singleton: checks 
JeBoyDirk: checks 
*** SHOW DOWN ***
color_singleton: shows [8h Qs] (two pair, Queens and Eights)
JeBoyDirk: shows [9s 6s] (a straight, Six to Ten)
JeBoyDirk collected 2992 from pot
*** SUMMARY ***
Total pot 3166 | Rake 174 
Board [Qh 8s 7c Tc 9h]
Seat 1: color_singleton (small blind) showed [8h Qs] and lost with two pair, Queens and Eights
Seat 2: manon327 (big blind) folded on the Turn
Seat 3: GillesdeH folded on the Turn
Seat 4: PokerStarMan123 folded on the Turn
Seat 6: Klemtonius folded before Flop (didn't bet)
Seat 8: JeBoyDirk showed [9s 6s] and won (2992) with a straight, Six to Ten
Seat 9: dhduncan (button) folded on the Turn



PokerStars Home Game Hand #226313312079: {DaPokaStars}  Hold'em No Limit (50/100) - 2021/04/29 16:48:39 ET
Table 'yes_sir' 9-max (Play Money) Seat #1 is the button
Seat 1: color_singleton (10781 in chips) 
Seat 2: manon327 (9900 in chips) 
Seat 3: GillesdeH (35559 in chips) 
Seat 4: PokerStarMan123 (9365 in chips) 
Seat 6: Klemtonius (8518 in chips) 
Seat 8: JeBoyDirk (11959 in chips) 
Seat 9: dhduncan (8064 in chips) 
manon327: posts small blind 50
GillesdeH: posts big blind 100
*** HOLE CARDS ***
Dealt to PokerStarMan123 [8h Td]
PokerStarMan123: folds 
Klemtonius: calls 100
JeBoyDirk: folds 
dhduncan: calls 100
color_singleton: folds 
manon327: calls 50
GillesdeH: checks 
*** FLOP *** [4h Kc 3s]
manon327: checks 
GillesdeH: checks 
Klemtonius: checks 
dhduncan: checks 
*** TURN *** [4h Kc 3s] [7d]
manon327: checks 
GillesdeH: checks 
Klemtonius: checks 
dhduncan: checks 
*** RIVER *** [4h Kc 3s 7d] [5h]
manon327: checks 
GillesdeH: checks 
Klemtonius: checks 
dhduncan: checks 
*** SHOW DOWN ***
manon327: shows [8d Qc] (high card King)
GillesdeH: shows [As 9d] (high card Ace)
Klemtonius: shows [4s 2s] (a pair of Fours)
dhduncan: shows [Ah 7s] (a pair of Sevens)
dhduncan collected 378 from pot
*** SUMMARY ***
Total pot 400 | Rake 22 
Board [4h Kc 3s 7d 5h]
Seat 1: color_singleton (button) folded before Flop (didn't bet)
Seat 2: manon327 (small blind) showed [8d Qc] and lost with high card King
Seat 3: GillesdeH (big blind) showed [As 9d] and lost with high card Ace
Seat 4: PokerStarMan123 folded before Flop (didn't bet)
Seat 6: Klemtonius showed [4s 2s] and lost with a pair of Fours
Seat 8: JeBoyDirk folded before Flop (didn't bet)
Seat 9: dhduncan showed [Ah 7s] and won (378) with a pair of Sevens



PokerStars Home Game Hand #226313347132: {DaPokaStars}  Hold'em No Limit (50/100) - 2021/04/29 16:49:39 ET
Table 'yes_sir' 9-max (Play Money) Seat #2 is the button
Seat 1: color_singleton (10781 in chips) 
Seat 2: manon327 (9800 in chips) 
Seat 3: GillesdeH (35459 in chips) 
Seat 4: PokerStarMan123 (9365 in chips) 
Seat 6: Klemtonius (8418 in chips) 
Seat 8: JeBoyDirk (11959 in chips) 
Seat 9: dhduncan (8342 in chips) 
GillesdeH: posts small blind 50
PokerStarMan123: posts big blind 100
*** HOLE CARDS ***
Dealt to PokerStarMan123 [Jd 7s]
Klemtonius: raises 200 to 300
JeBoyDirk: calls 300
dhduncan: folds 
color_singleton has timed out
color_singleton: folds 
manon327: calls 300
GillesdeH: calls 250
PokerStarMan123: calls 200
*** FLOP *** [Jh 7c 5c]
GillesdeH: checks 
PokerStarMan123: checks 
Klemtonius: checks 
JeBoyDirk: checks 
manon327: checks 
*** TURN *** [Jh 7c 5c] [3h]
GillesdeH: checks 
PokerStarMan123: bets 900
Klemtonius: folds 
JeBoyDirk: folds 
manon327: folds 
GillesdeH: folds 
Uncalled bet (900) returned to PokerStarMan123
PokerStarMan123 collected 1417 from pot
*** SUMMARY ***
Total pot 1500 | Rake 83 
Board [Jh 7c 5c 3h]
Seat 1: color_singleton folded before Flop (didn't bet)
Seat 2: manon327 (button) folded on the Turn
Seat 3: GillesdeH (small blind) folded on the Turn
Seat 4: PokerStarMan123 (big blind) collected (1417)
Seat 6: Klemtonius folded on the Turn
Seat 8: JeBoyDirk folded on the Turn
Seat 9: dhduncan folded before Flop (didn't bet)



PokerStars Home Game Hand #226313398709: {DaPokaStars}  Hold'em No Limit (50/100) - 2021/04/29 16:50:56 ET
Table 'yes_sir' 9-max (Play Money) Seat #3 is the button
Seat 1: color_singleton (10781 in chips) 
Seat 2: manon327 (9500 in chips) 
Seat 3: GillesdeH (35159 in chips) 
Seat 4: PokerStarMan123 (10482 in chips) 
Seat 6: Klemtonius (8118 in chips) 
Seat 8: JeBoyDirk (11659 in chips) 
Seat 9: dhduncan (8342 in chips) 
PokerStarMan123: posts small blind 50
Klemtonius: posts big blind 100
*** HOLE CARDS ***
Dealt to PokerStarMan123 [7s 8d]
JeBoyDirk: folds 
dhduncan: calls 100
color_singleton: folds 
manon327: calls 100
GillesdeH: calls 100
PokerStarMan123: calls 50
Klemtonius: checks 
*** FLOP *** [4s Ks 5c]
PokerStarMan123: checks 
Klemtonius: checks 
dhduncan: checks 
manon327: checks 
GillesdeH: checks 
*** TURN *** [4s Ks 5c] [Kd]
PokerStarMan123: checks 
Klemtonius: checks 
dhduncan: checks 
manon327: checks 
GillesdeH: checks 
*** RIVER *** [4s Ks 5c Kd] [Qs]
PokerStarMan123: checks 
Klemtonius: checks 
dhduncan: checks 
manon327: checks 
GillesdeH: checks 
*** SHOW DOWN ***
PokerStarMan123: shows [7s 8d] (a pair of Kings)
Klemtonius: shows [3d Jh] (a pair of Kings - Queen+Jack kicker)
dhduncan: mucks hand 
manon327: shows [9c Js] (a pair of Kings - Queen+Jack+Nine kicker)
GillesdeH: shows [Ad 4c] (two pair, Kings and Fours)
GillesdeH collected 472 from pot
*** SUMMARY ***
Total pot 500 | Rake 28 
Board [4s Ks 5c Kd Qs]
Seat 1: color_singleton folded before Flop (didn't bet)
Seat 2: manon327 showed [9c Js] and lost with a pair of Kings
Seat 3: GillesdeH (button) showed [Ad 4c] and won (472) with two pair, Kings and Fours
Seat 4: PokerStarMan123 (small blind) showed [7s 8d] and lost with a pair of Kings
Seat 6: Klemtonius (big blind) showed [3d Jh] and lost with a pair of Kings
Seat 8: JeBoyDirk folded before Flop (didn't bet)
Seat 9: dhduncan mucked [Th 3h]



PokerStars Home Game Hand #226313428210: {DaPokaStars}  Hold'em No Limit (50/100) - 2021/04/29 16:51:47 ET
Table 'yes_sir' 9-max (Play Money) Seat #4 is the button
Seat 1: color_singleton (10781 in chips) 
Seat 2: manon327 (9400 in chips) 
Seat 3: GillesdeH (35531 in chips) 
Seat 4: PokerStarMan123 (10382 in chips) 
Seat 6: Klemtonius (8018 in chips) 
Seat 8: JeBoyDirk (11659 in chips) 
Seat 9: dhduncan (8242 in chips) 
Klemtonius: posts small blind 50
JeBoyDirk: posts big blind 100
*** HOLE CARDS ***
Dealt to PokerStarMan123 [7s Ac]
dhduncan: folds 
color_singleton: raises 200 to 300
manon327: folds 
GillesdeH: calls 300
PokerStarMan123: calls 300
Klemtonius: folds 
JeBoyDirk: folds 
*** FLOP *** [7c 2d Ks]
color_singleton: checks 
GillesdeH: bets 992
PokerStarMan123: calls 992
color_singleton: folds 
*** TURN *** [7c 2d Ks] [Js]
GillesdeH: bets 1433
PokerStarMan123: folds 
Uncalled bet (1433) returned to GillesdeH
GillesdeH collected 2867 from pot
*** SUMMARY ***
Total pot 3034 | Rake 167 
Board [7c 2d Ks Js]
Seat 1: color_singleton folded on the Flop
Seat 2: manon327 folded before Flop (didn't bet)
Seat 3: GillesdeH collected (2867)
Seat 4: PokerStarMan123 (button) folded on the Turn
Seat 6: Klemtonius (small blind) folded before Flop
Seat 8: JeBoyDirk (big blind) folded before Flop
Seat 9: dhduncan folded before Flop (didn't bet)



PokerStars Home Game Hand #226313445753: {DaPokaStars}  Hold'em No Limit (50/100) - 2021/04/29 16:52:17 ET
Table 'yes_sir' 9-max (Play Money) Seat #6 is the button
Seat 1: color_singleton (10481 in chips) 
Seat 2: manon327 (9400 in chips) 
Seat 3: GillesdeH (37106 in chips) 
Seat 4: PokerStarMan123 (9090 in chips) 
Seat 6: Klemtonius (7968 in chips) 
Seat 8: JeBoyDirk (11559 in chips) 
Seat 9: dhduncan (8242 in chips) 
JeBoyDirk: posts small blind 50
dhduncan: posts big blind 100
*** HOLE CARDS ***
Dealt to PokerStarMan123 [5d Jd]
color_singleton: raises 200 to 300
manon327: folds 
GillesdeH: calls 300
PokerStarMan123: calls 300
Klemtonius: calls 300
JeBoyDirk: folds 
dhduncan: folds 
*** FLOP *** [Tc 6h 4s]
color_singleton: checks 
GillesdeH: bets 638
PokerStarMan123: folds 
Klemtonius: raises 638 to 1276
color_singleton: folds 
GillesdeH: calls 638
*** TURN *** [Tc 6h 4s] [5c]
GillesdeH: checks 
Klemtonius: checks 
*** RIVER *** [Tc 6h 4s 5c] [9d]
GillesdeH: checks 
Klemtonius: bets 1843
GillesdeH: calls 1843
*** SHOW DOWN ***
Klemtonius: shows [Js Th] (a pair of Tens)
GillesdeH: shows [Ad Td] (a pair of Tens - Ace kicker)
GillesdeH collected 7171 from pot
*** SUMMARY ***
Total pot 7588 | Rake 417 
Board [Tc 6h 4s 5c 9d]
Seat 1: color_singleton folded on the Flop
Seat 2: manon327 folded before Flop (didn't bet)
Seat 3: GillesdeH showed [Ad Td] and won (7171) with a pair of Tens
Seat 4: PokerStarMan123 folded on the Flop
Seat 6: Klemtonius (button) showed [Js Th] and lost with a pair of Tens
Seat 8: JeBoyDirk (small blind) folded before Flop
Seat 9: dhduncan (big blind) folded before Flop



PokerStars Home Game Hand #226313486474: {DaPokaStars}  Hold'em No Limit (50/100) - 2021/04/29 16:53:28 ET
Table 'yes_sir' 9-max (Play Money) Seat #8 is the button
Seat 1: color_singleton (10181 in chips) 
Seat 2: manon327 (9400 in chips) 
Seat 3: GillesdeH (40858 in chips) 
Seat 4: PokerStarMan123 (8790 in chips) 
Seat 6: Klemtonius (4549 in chips) 
Seat 8: JeBoyDirk (11509 in chips) 
Seat 9: dhduncan (8142 in chips) 
dhduncan: posts small blind 50
color_singleton: posts big blind 100
*** HOLE CARDS ***
Dealt to PokerStarMan123 [Th Jd]
manon327: folds 
GillesdeH: calls 100
PokerStarMan123: calls 100
Klemtonius: calls 100
JeBoyDirk: calls 100
dhduncan: calls 50
color_singleton: checks 
*** FLOP *** [Kh 5d Jh]
dhduncan: checks 
color_singleton: checks 
GillesdeH: checks 
PokerStarMan123: checks 
Klemtonius: checks 
JeBoyDirk: checks 
*** TURN *** [Kh 5d Jh] [5s]
dhduncan: checks 
color_singleton: checks 
GillesdeH: checks 
PokerStarMan123: bets 400
Klemtonius: folds 
JeBoyDirk: folds 
dhduncan: folds 
color_singleton: calls 400
GillesdeH: calls 400
*** RIVER *** [Kh 5d Jh 5s] [7h]
color_singleton: bets 1000
GillesdeH: folds 
PokerStarMan123: folds 
Uncalled bet (1000) returned to color_singleton
color_singleton collected 1701 from pot
color_singleton: doesn't show hand 
*** SUMMARY ***
Total pot 1800 | Rake 99 
Board [Kh 5d Jh 5s 7h]
Seat 1: color_singleton (big blind) collected (1701)
Seat 2: manon327 folded before Flop (didn't bet)
Seat 3: GillesdeH folded on the River
Seat 4: PokerStarMan123 folded on the River
Seat 6: Klemtonius folded on the Turn
Seat 8: JeBoyDirk (button) folded on the Turn
Seat 9: dhduncan (small blind) folded on the Turn



PokerStars Home Game Hand #226313534465: {DaPokaStars}  Hold'em No Limit (50/100) - 2021/04/29 16:54:52 ET
Table 'yes_sir' 9-max (Play Money) Seat #9 is the button
Seat 1: color_singleton (11382 in chips) 
Seat 2: manon327 (9400 in chips) 
Seat 3: GillesdeH (40358 in chips) 
Seat 4: PokerStarMan123 (8290 in chips) 
Seat 6: Klemtonius (4449 in chips) 
Seat 8: JeBoyDirk (11409 in chips) 
Seat 9: dhduncan (8042 in chips) 
color_singleton: posts small blind 50
manon327: posts big blind 100
*** HOLE CARDS ***
Dealt to PokerStarMan123 [9c 6h]
GillesdeH: calls 100
PokerStarMan123: folds 
Klemtonius: raises 100 to 200
JeBoyDirk: folds 
dhduncan: calls 200
color_singleton: folds 
manon327: calls 100
GillesdeH: calls 100
*** FLOP *** [4h 7c Qc]
manon327: bets 401
GillesdeH: calls 401
Klemtonius: raises 401 to 802
dhduncan: calls 802
manon327: calls 401
GillesdeH: folds 
*** TURN *** [4h 7c Qc] [9s]
manon327: checks 
Klemtonius: bets 1728
dhduncan: folds 
manon327: folds 
Uncalled bet (1728) returned to Klemtonius
Klemtonius collected 3456 from pot
Klemtonius: doesn't show hand 
*** SUMMARY ***
Total pot 3657 | Rake 201 
Board [4h 7c Qc 9s]
Seat 1: color_singleton (small blind) folded before Flop
Seat 2: manon327 (big blind) folded on the Turn
Seat 3: GillesdeH folded on the Flop
Seat 4: PokerStarMan123 folded before Flop (didn't bet)
Seat 6: Klemtonius collected (3456)
Seat 8: JeBoyDirk folded before Flop (didn't bet)
Seat 9: dhduncan (button) folded on the Turn



PokerStars Home Game Hand #226313576293: {DaPokaStars}  Hold'em No Limit (50/100) - 2021/04/29 16:56:23 ET
Table 'yes_sir' 9-max (Play Money) Seat #1 is the button
Seat 1: color_singleton (11332 in chips) 
Seat 2: manon327 (8398 in chips) 
Seat 3: GillesdeH (39757 in chips) 
Seat 4: PokerStarMan123 (8290 in chips) 
Seat 6: Klemtonius (6903 in chips) 
Seat 8: JeBoyDirk (11409 in chips) 
Seat 9: dhduncan (7040 in chips) 
manon327: posts small blind 50
GillesdeH: posts big blind 100
*** HOLE CARDS ***
Dealt to PokerStarMan123 [2c 3h]
PokerStarMan123: folds 
Klemtonius: calls 100
JeBoyDirk: calls 100
dhduncan: folds 
color_singleton: raises 200 to 300
manon327: calls 250
GillesdeH: folds 
Klemtonius: calls 200
JeBoyDirk: calls 200
*** FLOP *** [4h Js 5d]
manon327: checks 
Klemtonius: checks 
JeBoyDirk: bets 300
color_singleton: raises 300 to 600
manon327: folds 
Klemtonius: folds 
JeBoyDirk: folds 
Uncalled bet (300) returned to color_singleton
color_singleton collected 1795 from pot
color_singleton: doesn't show hand 
*** SUMMARY ***
Total pot 1900 | Rake 105 
Board [4h Js 5d]
Seat 1: color_singleton (button) collected (1795)
Seat 2: manon327 (small blind) folded on the Flop
Seat 3: GillesdeH (big blind) folded before Flop
Seat 4: PokerStarMan123 folded before Flop (didn't bet)
Seat 6: Klemtonius folded on the Flop
Seat 8: JeBoyDirk folded on the Flop
Seat 9: dhduncan folded before Flop (didn't bet)



PokerStars Home Game Hand #226313601578: {DaPokaStars}  Hold'em No Limit (50/100) - 2021/04/29 16:57:23 ET
Table 'yes_sir' 9-max (Play Money) Seat #2 is the button
Seat 1: color_singleton (12527 in chips) 
Seat 2: manon327 (8098 in chips) 
Seat 3: GillesdeH (39657 in chips) 
Seat 4: PokerStarMan123 (8290 in chips) 
Seat 6: Klemtonius (6603 in chips) 
Seat 8: JeBoyDirk (10809 in chips) 
Seat 9: dhduncan (7040 in chips) 
GillesdeH: posts small blind 50
PokerStarMan123: posts big blind 100
*** HOLE CARDS ***
Dealt to PokerStarMan123 [7c Qc]
Klemtonius: raises 100 to 200
JeBoyDirk: folds 
dhduncan: calls 200
color_singleton: folds 
manon327: folds 
GillesdeH has timed out
GillesdeH: folds 
PokerStarMan123: calls 100
*** FLOP *** [Qh Kc Ad]
PokerStarMan123: checks 
Klemtonius: bets 614
dhduncan: calls 614
PokerStarMan123: folds 
*** TURN *** [Qh Kc Ad] [5s]
Klemtonius: bets 1775
dhduncan: folds 
Uncalled bet (1775) returned to Klemtonius
Klemtonius collected 1775 from pot
Klemtonius: doesn't show hand 
*** SUMMARY ***
Total pot 1878 | Rake 103 
Board [Qh Kc Ad 5s]
Seat 1: color_singleton folded before Flop (didn't bet)
Seat 2: manon327 (button) folded before Flop (didn't bet)
Seat 3: GillesdeH (small blind) folded before Flop
Seat 4: PokerStarMan123 (big blind) folded on the Flop
Seat 6: Klemtonius collected (1775)
Seat 8: JeBoyDirk folded before Flop (didn't bet)
Seat 9: dhduncan folded on the Turn



PokerStars Home Game Hand #226313629046: {DaPokaStars}  Hold'em No Limit (50/100) - 2021/04/29 16:58:26 ET
Table 'yes_sir' 9-max (Play Money) Seat #3 is the button
Seat 1: color_singleton (12527 in chips) 
Seat 2: manon327 (8098 in chips) 
Seat 3: GillesdeH (39607 in chips) 
Seat 4: PokerStarMan123 (8090 in chips) 
Seat 6: Klemtonius (7564 in chips) 
Seat 8: JeBoyDirk (10809 in chips) 
Seat 9: dhduncan (6226 in chips) 
PokerStarMan123: posts small blind 50
Klemtonius: posts big blind 100
*** HOLE CARDS ***
Dealt to PokerStarMan123 [9s Qh]
JeBoyDirk: folds 
dhduncan: calls 100
color_singleton: calls 100
manon327: folds 
GillesdeH: raises 200 to 300
PokerStarMan123: calls 250
Klemtonius: folds 
dhduncan: calls 200
color_singleton: calls 200
*** FLOP *** [5h 5c 2s]
PokerStarMan123: checks 
dhduncan: bets 100
color_singleton: folds 
GillesdeH has timed out
GillesdeH: folds 
PokerStarMan123: calls 100
*** TURN *** [5h 5c 2s] [Jc]
PokerStarMan123: checks 
dhduncan: bets 100
PokerStarMan123: calls 100
*** RIVER *** [5h 5c 2s Jc] [Qs]
PokerStarMan123: checks 
dhduncan: bets 100
PokerStarMan123: raises 900 to 1000
dhduncan: calls 900
*** SHOW DOWN ***
PokerStarMan123: shows [9s Qh] (two pair, Queens and Fives)
dhduncan: mucks hand 
PokerStarMan123 collected 3496 from pot
*** SUMMARY ***
Total pot 3700 | Rake 204 
Board [5h 5c 2s Jc Qs]
Seat 1: color_singleton folded on the Flop
Seat 2: manon327 folded before Flop (didn't bet)
Seat 3: GillesdeH (button) folded on the Flop
Seat 4: PokerStarMan123 (small blind) showed [9s Qh] and won (3496) with two pair, Queens and Fives
Seat 6: Klemtonius (big blind) folded before Flop
Seat 8: JeBoyDirk folded before Flop (didn't bet)
Seat 9: dhduncan mucked [2c Ah]



PokerStars Home Game Hand #226313657153: {DaPokaStars}  Hold'em No Limit (50/100) - 2021/04/29 16:59:31 ET
Table 'yes_sir' 9-max (Play Money) Seat #4 is the button
Seat 1: color_singleton (12227 in chips) 
Seat 2: manon327 (8098 in chips) 
Seat 3: GillesdeH (39307 in chips) 
Seat 4: PokerStarMan123 (10086 in chips) 
Seat 6: Klemtonius (7464 in chips) 
Seat 8: JeBoyDirk (10809 in chips) 
Seat 9: dhduncan (4726 in chips) 
Klemtonius: posts small blind 50
JeBoyDirk: posts big blind 100
*** HOLE CARDS ***
Dealt to PokerStarMan123 [5s Jc]
dhduncan: folds 
color_singleton: folds 
manon327: folds 
GillesdeH: calls 100
PokerStarMan123: folds 
Klemtonius: raises 100 to 200
JeBoyDirk: calls 100
GillesdeH: calls 100
*** FLOP *** [Qc Kc 2d]
Klemtonius: bets 283
JeBoyDirk has timed out
JeBoyDirk: folds 
GillesdeH: calls 283
*** TURN *** [Qc Kc 2d] [3s]
Klemtonius: checks 
GillesdeH: checks 
*** RIVER *** [Qc Kc 2d 3s] [6c]
Klemtonius: checks 
GillesdeH: bets 551
Klemtonius: folds 
Uncalled bet (551) returned to GillesdeH
GillesdeH collected 1102 from pot
*** SUMMARY ***
Total pot 1166 | Rake 64 
Board [Qc Kc 2d 3s 6c]
Seat 1: color_singleton folded before Flop (didn't bet)
Seat 2: manon327 folded before Flop (didn't bet)
Seat 3: GillesdeH collected (1102)
Seat 4: PokerStarMan123 (button) folded before Flop (didn't bet)
Seat 6: Klemtonius (small blind) folded on the River
Seat 8: JeBoyDirk (big blind) folded on the Flop
Seat 9: dhduncan folded before Flop (didn't bet)



PokerStars Home Game Hand #226313677179: {DaPokaStars}  Hold'em No Limit (50/100) - 2021/04/29 17:00:18 ET
Table 'yes_sir' 9-max (Play Money) Seat #6 is the button
Seat 1: color_singleton (12227 in chips) 
Seat 2: manon327 (8098 in chips) 
Seat 3: GillesdeH (39926 in chips) 
Seat 4: PokerStarMan123 (10086 in chips) 
Seat 6: Klemtonius (6981 in chips) 
Seat 8: JeBoyDirk (10609 in chips) 
Seat 9: dhduncan (4726 in chips) 
JeBoyDirk: posts small blind 50
dhduncan: posts big blind 100
*** HOLE CARDS ***
Dealt to PokerStarMan123 [5s Js]
color_singleton: raises 200 to 300
manon327: calls 300
GillesdeH: calls 300
PokerStarMan123: folds 
Klemtonius: calls 300
JeBoyDirk: folds 
dhduncan: folds 
*** FLOP *** [3h 2h Qc]
color_singleton: checks 
manon327: checks 
GillesdeH: bets 638
Klemtonius: folds 
color_singleton: folds 
manon327: folds 
Uncalled bet (638) returned to GillesdeH
GillesdeH collected 1276 from pot
*** SUMMARY ***
Total pot 1350 | Rake 74 
Board [3h 2h Qc]
Seat 1: color_singleton folded on the Flop
Seat 2: manon327 folded on the Flop
Seat 3: GillesdeH collected (1276)
Seat 4: PokerStarMan123 folded before Flop (didn't bet)
Seat 6: Klemtonius (button) folded on the Flop
Seat 8: JeBoyDirk (small blind) folded before Flop
Seat 9: dhduncan (big blind) folded before Flop



PokerStars Home Game Hand #226313690198: {DaPokaStars}  Hold'em No Limit (50/100) - 2021/04/29 17:00:47 ET
Table 'yes_sir' 9-max (Play Money) Seat #8 is the button
Seat 1: color_singleton (11927 in chips) 
Seat 2: manon327 (7798 in chips) 
Seat 3: GillesdeH (40902 in chips) 
Seat 4: PokerStarMan123 (10086 in chips) 
Seat 6: Klemtonius (6681 in chips) 
Seat 8: JeBoyDirk (10559 in chips) 
Seat 9: dhduncan (4626 in chips) 
dhduncan: posts small blind 50
color_singleton: posts big blind 100
*** HOLE CARDS ***
Dealt to PokerStarMan123 [6c 5c]
manon327: folds 
GillesdeH: calls 100
PokerStarMan123: calls 100
Klemtonius: raises 100 to 200
JeBoyDirk: folds 
dhduncan: raises 100 to 300
color_singleton: folds 
GillesdeH: calls 200
PokerStarMan123: calls 200
Klemtonius: calls 100
*** FLOP *** [6d 3s 9d]
dhduncan: bets 100
GillesdeH: calls 100
PokerStarMan123: calls 100
Klemtonius: raises 814 to 914
dhduncan: raises 814 to 1728
GillesdeH: folds 
PokerStarMan123: folds 
Klemtonius: calls 814
*** TURN *** [6d 3s 9d] [3d]
dhduncan: checks 
Klemtonius: checks 
*** RIVER *** [6d 3s 9d 3d] [Ac]
dhduncan: bets 2598 and is all-in
Klemtonius: folds 
Uncalled bet (2598) returned to dhduncan
dhduncan collected 4683 from pot
dhduncan: doesn't show hand 
*** SUMMARY ***
Total pot 4956 | Rake 273 
Board [6d 3s 9d 3d Ac]
Seat 1: color_singleton (big blind) folded before Flop
Seat 2: manon327 folded before Flop (didn't bet)
Seat 3: GillesdeH folded on the Flop
Seat 4: PokerStarMan123 folded on the Flop
Seat 6: Klemtonius folded on the River
Seat 8: JeBoyDirk (button) folded before Flop (didn't bet)
Seat 9: dhduncan (small blind) collected (4683)



PokerStars Home Game Hand #226313731115: {DaPokaStars}  Hold'em No Limit (50/100) - 2021/04/29 17:02:06 ET
Table 'yes_sir' 9-max (Play Money) Seat #9 is the button
Seat 1: color_singleton (11827 in chips) 
Seat 2: manon327 (7798 in chips) 
Seat 3: GillesdeH (40502 in chips) 
Seat 4: PokerStarMan123 (9686 in chips) 
Seat 6: Klemtonius (4653 in chips) 
Seat 8: JeBoyDirk (10559 in chips) 
Seat 9: dhduncan (7281 in chips) 
color_singleton: posts small blind 50
manon327: posts big blind 100
*** HOLE CARDS ***
Dealt to PokerStarMan123 [3c Qs]
GillesdeH: calls 100
PokerStarMan123: folds 
Klemtonius: folds 
JeBoyDirk: folds 
dhduncan: folds 
color_singleton: raises 200 to 300
manon327: calls 200
GillesdeH: calls 200
*** FLOP *** [8d Ah 2c]
color_singleton: checks 
manon327: bets 425
GillesdeH: calls 425
color_singleton: calls 425
*** TURN *** [8d Ah 2c] [4d]
color_singleton: checks 
manon327: bets 2055
GillesdeH: folds 
color_singleton: calls 2055
*** RIVER *** [8d Ah 2c 4d] [7c]
color_singleton: checks 
manon327: checks 
*** SHOW DOWN ***
color_singleton: shows [Ac Kc] (a pair of Aces)
manon327: mucks hand 
color_singleton collected 5939 from pot
*** SUMMARY ***
Total pot 6285 | Rake 346 
Board [8d Ah 2c 4d 7c]
Seat 1: color_singleton (small blind) showed [Ac Kc] and won (5939) with a pair of Aces
Seat 2: manon327 (big blind) mucked [Kh Kd]
Seat 3: GillesdeH folded on the Turn
Seat 4: PokerStarMan123 folded before Flop (didn't bet)
Seat 6: Klemtonius folded before Flop (didn't bet)
Seat 8: JeBoyDirk folded before Flop (didn't bet)
Seat 9: dhduncan (button) folded before Flop (didn't bet)



PokerStars Home Game Hand #226313767648: {DaPokaStars}  Hold'em No Limit (50/100) - 2021/04/29 17:03:12 ET
Table 'yes_sir' 9-max (Play Money) Seat #1 is the button
Seat 1: color_singleton (14986 in chips) 
Seat 2: manon327 (5018 in chips) 
Seat 3: GillesdeH (39777 in chips) 
Seat 4: PokerStarMan123 (9686 in chips) 
Seat 6: Klemtonius (4653 in chips) 
Seat 8: JeBoyDirk (10559 in chips) 
Seat 9: dhduncan (7281 in chips) 
manon327: posts small blind 50
GillesdeH: posts big blind 100
*** HOLE CARDS ***
Dealt to PokerStarMan123 [8c Jh]
PokerStarMan123: calls 100
Klemtonius: calls 100
JeBoyDirk: folds 
dhduncan: calls 100
color_singleton: calls 100
manon327: calls 50
GillesdeH: checks 
*** FLOP *** [2h Qh 9c]
manon327: bets 283
GillesdeH: calls 283
PokerStarMan123: folds 
Klemtonius: calls 283
dhduncan: folds 
color_singleton: folds 
*** TURN *** [2h Qh 9c] [7c]
manon327: checks 
GillesdeH: bets 684
Klemtonius: calls 684
manon327: folds 
*** RIVER *** [2h Qh 9c 7c] [Ts]
GillesdeH: bets 2662
Klemtonius: calls 2662
*** SHOW DOWN ***
GillesdeH: shows [9s 7h] (two pair, Nines and Sevens)
Klemtonius: mucks hand 
GillesdeH collected 7693 from pot
*** SUMMARY ***
Total pot 8141 | Rake 448 
Board [2h Qh 9c 7c Ts]
Seat 1: color_singleton (button) folded on the Flop
Seat 2: manon327 (small blind) folded on the Turn
Seat 3: GillesdeH (big blind) showed [9s 7h] and won (7693) with two pair, Nines and Sevens
Seat 4: PokerStarMan123 folded on the Flop
Seat 6: Klemtonius mucked [3c Qd]
Seat 8: JeBoyDirk folded before Flop (didn't bet)
Seat 9: dhduncan folded on the Flop



PokerStars Home Game Hand #226313821017: {DaPokaStars}  Hold'em No Limit (50/100) - 2021/04/29 17:04:46 ET
Table 'yes_sir' 9-max (Play Money) Seat #2 is the button
Seat 1: color_singleton (14886 in chips) 
Seat 2: manon327 (4635 in chips) 
Seat 3: GillesdeH (43741 in chips) 
Seat 4: PokerStarMan123 (9586 in chips) 
Seat 6: Klemtonius (924 in chips) 
Seat 8: JeBoyDirk (10559 in chips) 
Seat 9: dhduncan (7181 in chips) 
GillesdeH: posts small blind 50
PokerStarMan123: posts big blind 100
*** HOLE CARDS ***
Dealt to PokerStarMan123 [Ad 2c]
Klemtonius: raises 100 to 200
JeBoyDirk: folds 
dhduncan: calls 200
color_singleton: calls 200
manon327: calls 200
GillesdeH: calls 150
PokerStarMan123: calls 100
*** FLOP *** [4h 9c 9s]
GillesdeH: checks 
PokerStarMan123: checks 
Klemtonius: bets 724 and is all-in
dhduncan: folds 
color_singleton: folds 
manon327: calls 724
GillesdeH: calls 724
PokerStarMan123: folds 
*** TURN *** [4h 9c 9s] [Js]
GillesdeH: checks 
manon327: bets 1593
GillesdeH: folds 
Uncalled bet (1593) returned to manon327
*** RIVER *** [4h 9c 9s Js] [5c]
*** SHOW DOWN ***
Klemtonius: shows [2d 2s] (two pair, Nines and Deuces)
manon327: shows [9h Qd] (three of a kind, Nines)
manon327 collected 3187 from pot
*** SUMMARY ***
Total pot 3372 | Rake 185 
Board [4h 9c 9s Js 5c]
Seat 1: color_singleton folded on the Flop
Seat 2: manon327 (button) showed [9h Qd] and won (3187) with three of a kind, Nines
Seat 3: GillesdeH (small blind) folded on the Turn
Seat 4: PokerStarMan123 (big blind) folded on the Flop
Seat 6: Klemtonius showed [2d 2s] and lost with two pair, Nines and Deuces
Seat 8: JeBoyDirk folded before Flop (didn't bet)
Seat 9: dhduncan folded on the Flop



PokerStars Home Game Hand #226313863145: {DaPokaStars}  Hold'em No Limit (50/100) - 2021/04/29 17:05:52 ET
Table 'yes_sir' 9-max (Play Money) Seat #3 is the button
Seat 1: color_singleton (14686 in chips) 
Seat 2: manon327 (6898 in chips) 
Seat 3: GillesdeH (42817 in chips) 
Seat 4: PokerStarMan123 (9386 in chips) 
Seat 8: JeBoyDirk (10559 in chips) 
Seat 9: dhduncan (6981 in chips) 
PokerStarMan123: posts small blind 50
JeBoyDirk: posts big blind 100
*** HOLE CARDS ***
Dealt to PokerStarMan123 [3d Qs]
dhduncan: calls 100
color_singleton: raises 200 to 300
manon327: calls 300
GillesdeH: calls 300
PokerStarMan123: folds 
JeBoyDirk: folds 
dhduncan: calls 200
*** FLOP *** [Js 5c 8c]
dhduncan: bets 638
color_singleton: calls 638
manon327: calls 638
GillesdeH: folds 
*** TURN *** [Js 5c 8c] [Tc]
dhduncan: checks 
color_singleton: bets 1542
manon327: folds 
dhduncan: folds 
Uncalled bet (1542) returned to color_singleton
color_singleton collected 3084 from pot
color_singleton: doesn't show hand 
*** SUMMARY ***
Total pot 3264 | Rake 180 
Board [Js 5c 8c Tc]
Seat 1: color_singleton collected (3084)
Seat 2: manon327 folded on the Turn
Seat 3: GillesdeH (button) folded on the Flop
Seat 4: PokerStarMan123 (small blind) folded before Flop
Seat 8: JeBoyDirk (big blind) folded before Flop
Seat 9: dhduncan folded on the Turn



PokerStars Home Game Hand #226313896344: {DaPokaStars}  Hold'em No Limit (50/100) - 2021/04/29 17:06:49 ET
Table 'yes_sir' 9-max (Play Money) Seat #4 is the button
Seat 1: color_singleton (16832 in chips) 
Seat 2: manon327 (5960 in chips) 
Seat 3: GillesdeH (42517 in chips) 
Seat 4: PokerStarMan123 (9336 in chips) 
Seat 8: JeBoyDirk (10459 in chips) 
Seat 9: dhduncan (6043 in chips) 
JeBoyDirk: posts small blind 50
dhduncan: posts big blind 100
*** HOLE CARDS ***
Dealt to PokerStarMan123 [8c 2h]
color_singleton: raises 100 to 200
manon327: calls 200
GillesdeH: calls 200
PokerStarMan123: folds 
JeBoyDirk: folds 
dhduncan: calls 100
*** FLOP *** [8s Jd 2s]
dhduncan: bets 401
color_singleton: folds 
manon327: folds 
GillesdeH: calls 401
*** TURN *** [8s Jd 2s] [4c]
dhduncan: bets 780
GillesdeH: folds 
Uncalled bet (780) returned to dhduncan
dhduncan collected 1561 from pot
dhduncan: doesn't show hand 
*** SUMMARY ***
Total pot 1652 | Rake 91 
Board [8s Jd 2s 4c]
Seat 1: color_singleton folded on the Flop
Seat 2: manon327 folded on the Flop
Seat 3: GillesdeH folded on the Turn
Seat 4: PokerStarMan123 (button) folded before Flop (didn't bet)
Seat 8: JeBoyDirk (small blind) folded before Flop
Seat 9: dhduncan (big blind) collected (1561)



PokerStars Home Game Hand #226313918868: {DaPokaStars}  Hold'em No Limit (50/100) - 2021/04/29 17:07:29 ET
Table 'yes_sir' 9-max (Play Money) Seat #8 is the button
Seat 1: color_singleton (16632 in chips) 
Seat 2: manon327 (5760 in chips) 
Seat 3: GillesdeH (41916 in chips) 
Seat 4: PokerStarMan123 (9336 in chips) 
Seat 6: Klemtonius (10000 in chips) 
Seat 8: JeBoyDirk (10409 in chips) 
Seat 9: dhduncan (7003 in chips) 
dhduncan: posts small blind 50
color_singleton: posts big blind 100
Klemtonius: posts small & big blinds 150
*** HOLE CARDS ***
Dealt to PokerStarMan123 [7c Ks]
manon327: calls 100
GillesdeH: calls 100
PokerStarMan123: calls 100
Klemtonius: checks 
JeBoyDirk: folds 
dhduncan: raises 100 to 200
color_singleton: calls 100
manon327: calls 100
GillesdeH: calls 100
PokerStarMan123: calls 100
Klemtonius: calls 100
*** FLOP *** [Js 7h Ad]
dhduncan: bets 590
color_singleton: folds 
manon327: calls 590
GillesdeH: folds 
PokerStarMan123: folds 
Klemtonius: folds 
*** TURN *** [Js 7h Ad] [Kc]
dhduncan: bets 1148
manon327: raises 3822 to 4970 and is all-in
dhduncan: calls 3822
*** RIVER *** [Js 7h Ad Kc] [9c]
*** SHOW DOWN ***
dhduncan: shows [Tc Ac] (a pair of Aces)
manon327: shows [Qh Ts] (a straight, Ten to Ace)
manon327 collected 11690 from pot
*** SUMMARY ***
Total pot 12370 | Rake 680 
Board [Js 7h Ad Kc 9c]
Seat 1: color_singleton (big blind) folded on the Flop
Seat 2: manon327 showed [Qh Ts] and won (11690) with a straight, Ten to Ace
Seat 3: GillesdeH folded on the Flop
Seat 4: PokerStarMan123 folded on the Flop
Seat 6: Klemtonius folded on the Flop
Seat 8: JeBoyDirk (button) folded before Flop (didn't bet)
Seat 9: dhduncan (small blind) showed [Tc Ac] and lost with a pair of Aces



PokerStars Home Game Hand #226313966081: {DaPokaStars}  Hold'em No Limit (50/100) - 2021/04/29 17:08:51 ET
Table 'yes_sir' 9-max (Play Money) Seat #9 is the button
Seat 1: color_singleton (16432 in chips) 
Seat 2: manon327 (11690 in chips) 
Seat 3: GillesdeH (41716 in chips) 
Seat 4: PokerStarMan123 (9136 in chips) 
Seat 6: Klemtonius (9750 in chips) 
Seat 8: JeBoyDirk (10409 in chips) 
Seat 9: dhduncan (1243 in chips) 
color_singleton: posts small blind 50
manon327: posts big blind 100
*** HOLE CARDS ***
Dealt to PokerStarMan123 [9s 2d]
GillesdeH: calls 100
PokerStarMan123: folds 
Klemtonius: calls 100
JeBoyDirk: calls 100
dhduncan: calls 100
color_singleton: calls 50
manon327: checks 
*** FLOP *** [6d 3h Ad]
color_singleton: checks 
manon327: checks 
GillesdeH: checks 
Klemtonius: checks 
JeBoyDirk: checks 
dhduncan: checks 
*** TURN *** [6d 3h Ad] [6c]
color_singleton: checks 
manon327: bets 567
GillesdeH: folds 
Klemtonius: folds 
JeBoyDirk: folds 
dhduncan: folds 
color_singleton: folds 
Uncalled bet (567) returned to manon327
manon327 collected 567 from pot
*** SUMMARY ***
Total pot 600 | Rake 33 
Board [6d 3h Ad 6c]
Seat 1: color_singleton (small blind) folded on the Turn
Seat 2: manon327 (big blind) collected (567)
Seat 3: GillesdeH folded on the Turn
Seat 4: PokerStarMan123 folded before Flop (didn't bet)
Seat 6: Klemtonius folded on the Turn
Seat 8: JeBoyDirk folded on the Turn
Seat 9: dhduncan (button) folded on the Turn



PokerStars Home Game Hand #226314009771: {DaPokaStars}  Hold'em No Limit (50/100) - 2021/04/29 17:10:07 ET
Table 'yes_sir' 9-max (Play Money) Seat #1 is the button
Seat 1: color_singleton (16332 in chips) 
Seat 2: manon327 (12157 in chips) 
Seat 3: GillesdeH (41616 in chips) 
Seat 4: PokerStarMan123 (9136 in chips) 
Seat 6: Klemtonius (9650 in chips) 
Seat 8: JeBoyDirk (10309 in chips) 
Seat 9: dhduncan (1143 in chips) 
manon327: posts small blind 50
GillesdeH: posts big blind 100
*** HOLE CARDS ***
Dealt to PokerStarMan123 [Kh 7d]
PokerStarMan123: calls 100
Klemtonius: folds 
JeBoyDirk: folds 
dhduncan: folds 
color_singleton: calls 100
manon327: folds 
GillesdeH: checks 
*** FLOP *** [3c 6c 2d]
GillesdeH: checks 
PokerStarMan123: checks 
color_singleton: checks 
*** TURN *** [3c 6c 2d] [8d]
GillesdeH: checks 
PokerStarMan123: checks 
color_singleton: bets 165
GillesdeH: calls 165
PokerStarMan123: folds 
*** RIVER *** [3c 6c 2d 8d] [Qc]
GillesdeH: bets 643
color_singleton: calls 643
*** SHOW DOWN ***
GillesdeH: shows [9h Jd] (high card Queen)
color_singleton: shows [8c 7h] (a pair of Eights)
color_singleton collected 1858 from pot
*** SUMMARY ***
Total pot 1966 | Rake 108 
Board [3c 6c 2d 8d Qc]
Seat 1: color_singleton (button) showed [8c 7h] and won (1858) with a pair of Eights
Seat 2: manon327 (small blind) folded before Flop
Seat 3: GillesdeH (big blind) showed [9h Jd] and lost with high card Queen
Seat 4: PokerStarMan123 folded on the Turn
Seat 6: Klemtonius folded before Flop (didn't bet)
Seat 8: JeBoyDirk folded before Flop (didn't bet)
Seat 9: dhduncan folded before Flop (didn't bet)



PokerStars Home Game Hand #226314049002: {DaPokaStars}  Hold'em No Limit (50/100) - 2021/04/29 17:11:17 ET
Table 'yes_sir' 9-max (Play Money) Seat #2 is the button
Seat 1: color_singleton (17282 in chips) 
Seat 2: manon327 (12107 in chips) 
Seat 4: PokerStarMan123 (9036 in chips) 
Seat 6: Klemtonius (9650 in chips) 
Seat 8: JeBoyDirk (10309 in chips) 
Seat 9: dhduncan (1143 in chips) 
PokerStarMan123: posts small blind 50
Klemtonius: posts big blind 100
*** HOLE CARDS ***
Dealt to PokerStarMan123 [Jh 8d]
JeBoyDirk: folds 
dhduncan: calls 100
color_singleton: folds 
manon327: calls 100
PokerStarMan123: calls 50
Klemtonius: raises 400 to 500
dhduncan: calls 400
manon327: folds 
PokerStarMan123: folds 
*** FLOP *** [Th 3d 8c]
Klemtonius: checks 
dhduncan: checks 
*** TURN *** [Th 3d 8c] [9s]
Klemtonius: bets 1134
dhduncan: folds 
Uncalled bet (1134) returned to Klemtonius
Klemtonius collected 1134 from pot
Klemtonius: doesn't show hand 
*** SUMMARY ***
Total pot 1200 | Rake 66 
Board [Th 3d 8c 9s]
Seat 1: color_singleton folded before Flop (didn't bet)
Seat 2: manon327 (button) folded before Flop
Seat 4: PokerStarMan123 (small blind) folded before Flop
Seat 6: Klemtonius (big blind) collected (1134)
Seat 8: JeBoyDirk folded before Flop (didn't bet)
Seat 9: dhduncan folded on the Turn



PokerStars Home Game Hand #226314075112: {DaPokaStars}  Hold'em No Limit (50/100) - 2021/04/29 17:12:03 ET
Table 'yes_sir' 9-max (Play Money) Seat #4 is the button
Seat 1: color_singleton (17282 in chips) 
Seat 2: manon327 (12007 in chips) 
Seat 4: PokerStarMan123 (8936 in chips) 
Seat 6: Klemtonius (10284 in chips) 
Seat 8: JeBoyDirk (10309 in chips) 
Seat 9: dhduncan (643 in chips) 
Klemtonius: posts small blind 50
JeBoyDirk: posts big blind 100
*** HOLE CARDS ***
Dealt to PokerStarMan123 [8h 2c]
dhduncan: folds 
color_singleton: raises 200 to 300
manon327: calls 300
PokerStarMan123: folds 
Klemtonius: calls 250
JeBoyDirk: calls 200
*** FLOP *** [2s 8d Ac]
Klemtonius: checks 
JeBoyDirk: checks 
color_singleton: checks 
manon327: checks 
*** TURN *** [2s 8d Ac] [3d]
Klemtonius: checks 
JeBoyDirk: checks 
color_singleton: checks 
manon327: checks 
*** RIVER *** [2s 8d Ac 3d] [Ah]
Klemtonius: checks 
JeBoyDirk: checks 
color_singleton: checks 
manon327: checks 
*** SHOW DOWN ***
Klemtonius: shows [Jc 9c] (a pair of Aces)
JeBoyDirk: mucks hand 
color_singleton: mucks hand 
manon327: shows [3c Jh] (two pair, Aces and Threes)
manon327 collected 1134 from pot
*** SUMMARY ***
Total pot 1200 | Rake 66 
Board [2s 8d Ac 3d Ah]
Seat 1: color_singleton mucked [6s 7s]
Seat 2: manon327 showed [3c Jh] and won (1134) with two pair, Aces and Threes
Seat 4: PokerStarMan123 (button) folded before Flop (didn't bet)
Seat 6: Klemtonius (small blind) showed [Jc 9c] and lost with a pair of Aces
Seat 8: JeBoyDirk (big blind) mucked [7h 9h]
Seat 9: dhduncan folded before Flop (didn't bet)



PokerStars Home Game Hand #226314123215: {DaPokaStars}  Hold'em No Limit (50/100) - 2021/04/29 17:13:18 ET
Table 'yes_sir' 9-max (Play Money) Seat #8 is the button
Seat 1: color_singleton (16982 in chips) 
Seat 2: manon327 (12841 in chips) 
Seat 3: GillesdeH (40708 in chips) 
Seat 4: PokerStarMan123 (8936 in chips) 
Seat 8: JeBoyDirk (10009 in chips) 
Seat 9: dhduncan (643 in chips) 
dhduncan: posts small blind 50
color_singleton: posts big blind 100
GillesdeH: posts small blind 50
*** HOLE CARDS ***
Dealt to PokerStarMan123 [4d 7h]
manon327: calls 100
GillesdeH: calls 100
PokerStarMan123: folds 
JeBoyDirk: folds 
dhduncan: calls 50
color_singleton: raises 300 to 400
manon327: calls 300
GillesdeH: calls 300
dhduncan: raises 243 to 643 and is all-in
color_singleton: calls 243
manon327: calls 243
GillesdeH: calls 243
*** FLOP *** [4h 3s Tc]
color_singleton: checks 
manon327: checks 
GillesdeH: checks 
*** TURN *** [4h 3s Tc] [7d]
color_singleton: checks 
manon327: checks 
GillesdeH: checks 
*** RIVER *** [4h 3s Tc 7d] [4s]
color_singleton: checks 
manon327: checks 
GillesdeH: checks 
*** SHOW DOWN ***
dhduncan: shows [8h 8d] (two pair, Eights and Fours)
color_singleton: mucks hand 
manon327: mucks hand 
GillesdeH: mucks hand 
dhduncan collected 2478 from pot
*** SUMMARY ***
Total pot 2622 | Rake 144 
Board [4h 3s Tc 7d 4s]
Seat 1: color_singleton (big blind) mucked [Kd Ac]
Seat 2: manon327 mucked [As Qh]
Seat 3: GillesdeH mucked [Ks 5h]
Seat 4: PokerStarMan123 folded before Flop (didn't bet)
Seat 8: JeBoyDirk (button) folded before Flop (didn't bet)
Seat 9: dhduncan (small blind) showed [8h 8d] and won (2478) with two pair, Eights and Fours



PokerStars Home Game Hand #226314160892: {DaPokaStars}  Hold'em No Limit (50/100) - 2021/04/29 17:14:27 ET
Table 'yes_sir' 9-max (Play Money) Seat #9 is the button
Seat 1: color_singleton (16339 in chips) 
Seat 2: manon327 (12198 in chips) 
Seat 3: GillesdeH (40015 in chips) 
Seat 4: PokerStarMan123 (8936 in chips) 
Seat 8: JeBoyDirk (10009 in chips) 
Seat 9: dhduncan (2478 in chips) 
color_singleton: posts small blind 50
manon327: posts big blind 100
*** HOLE CARDS ***
Dealt to PokerStarMan123 [7d 9h]
GillesdeH: folds 
PokerStarMan123: folds 
JeBoyDirk: raises 100 to 200
dhduncan: calls 200
color_singleton: calls 150
manon327: calls 100
*** FLOP *** [Tc Ts 3d]
color_singleton: checks 
manon327: checks 
JeBoyDirk: bets 500
dhduncan: folds 
color_singleton: folds 
manon327: folds 
Uncalled bet (500) returned to JeBoyDirk
JeBoyDirk collected 756 from pot
*** SUMMARY ***
Total pot 800 | Rake 44 
Board [Tc Ts 3d]
Seat 1: color_singleton (small blind) folded on the Flop
Seat 2: manon327 (big blind) folded on the Flop
Seat 3: GillesdeH folded before Flop (didn't bet)
Seat 4: PokerStarMan123 folded before Flop (didn't bet)
Seat 8: JeBoyDirk collected (756)
Seat 9: dhduncan (button) folded on the Flop



PokerStars Home Game Hand #226314177788: {DaPokaStars}  Hold'em No Limit (50/100) - 2021/04/29 17:14:57 ET
Table 'yes_sir' 9-max (Play Money) Seat #1 is the button
Seat 1: color_singleton (16139 in chips) 
Seat 2: manon327 (11998 in chips) 
Seat 3: GillesdeH (40015 in chips) 
Seat 4: PokerStarMan123 (8936 in chips) 
Seat 8: JeBoyDirk (10565 in chips) 
Seat 9: dhduncan (2278 in chips) 
manon327: posts small blind 50
GillesdeH: posts big blind 100
*** HOLE CARDS ***
Dealt to PokerStarMan123 [Jd Kh]
PokerStarMan123: raises 300 to 400
JeBoyDirk: calls 400
dhduncan: calls 400
color_singleton: calls 400
manon327: folds 
GillesdeH: calls 300
*** FLOP *** [Qd 6s Th]
GillesdeH: checks 
PokerStarMan123: bets 700
JeBoyDirk: folds 
dhduncan: folds 
color_singleton: raises 700 to 1400
GillesdeH: folds 
PokerStarMan123: calls 700
*** TURN *** [Qd 6s Th] [Qs]
PokerStarMan123: checks 
color_singleton: checks 
*** RIVER *** [Qd 6s Th Qs] [4d]
PokerStarMan123: bets 2300
color_singleton: calls 2300
*** SHOW DOWN ***
PokerStarMan123: shows [Jd Kh] (a pair of Queens)
color_singleton: shows [Td Js] (two pair, Queens and Tens)
color_singleton collected 8930 from pot
*** SUMMARY ***
Total pot 9450 | Rake 520 
Board [Qd 6s Th Qs 4d]
Seat 1: color_singleton (button) showed [Td Js] and won (8930) with two pair, Queens and Tens
Seat 2: manon327 (small blind) folded before Flop
Seat 3: GillesdeH (big blind) folded on the Flop
Seat 4: PokerStarMan123 showed [Jd Kh] and lost with a pair of Queens
Seat 8: JeBoyDirk folded on the Flop
Seat 9: dhduncan folded on the Flop



PokerStars Home Game Hand #226314219741: {DaPokaStars}  Hold'em No Limit (50/100) - 2021/04/29 17:16:11 ET
Table 'yes_sir' 9-max (Play Money) Seat #2 is the button
Seat 1: color_singleton (20969 in chips) 
Seat 2: manon327 (11948 in chips) 
Seat 3: GillesdeH (39615 in chips) 
Seat 4: PokerStarMan123 (4836 in chips) 
Seat 8: JeBoyDirk (10165 in chips) 
Seat 9: dhduncan (1878 in chips) 
GillesdeH: posts small blind 50
PokerStarMan123: posts big blind 100
*** HOLE CARDS ***
Dealt to PokerStarMan123 [Kc 9s]
JeBoyDirk: folds 
dhduncan: calls 100
color_singleton: folds 
manon327: folds 
GillesdeH: calls 50
PokerStarMan123: checks 
*** FLOP *** [Ac Qs 2c]
GillesdeH: checks 
PokerStarMan123: checks 
dhduncan: checks 
*** TURN *** [Ac Qs 2c] [7d]
GillesdeH: checks 
PokerStarMan123: checks 
dhduncan: checks 
*** RIVER *** [Ac Qs 2c 7d] [4d]
GillesdeH: checks 
PokerStarMan123: checks 
dhduncan: checks 
*** SHOW DOWN ***
GillesdeH: shows [Jd 3h] (high card Ace)
PokerStarMan123: shows [Kc 9s] (high card Ace - King kicker)
dhduncan: mucks hand 
PokerStarMan123 collected 283 from pot
*** SUMMARY ***
Total pot 300 | Rake 17 
Board [Ac Qs 2c 7d 4d]
Seat 1: color_singleton folded before Flop (didn't bet)
Seat 2: manon327 (button) folded before Flop (didn't bet)
Seat 3: GillesdeH (small blind) showed [Jd 3h] and lost with high card Ace
Seat 4: PokerStarMan123 (big blind) showed [Kc 9s] and won (283) with high card Ace
Seat 8: JeBoyDirk folded before Flop (didn't bet)
Seat 9: dhduncan mucked [5h Th]



PokerStars Home Game Hand #226314243282: {DaPokaStars}  Hold'em No Limit (50/100) - 2021/04/29 17:16:52 ET
Table 'yes_sir' 9-max (Play Money) Seat #3 is the button
Seat 1: color_singleton (20969 in chips) 
Seat 3: GillesdeH (39515 in chips) 
Seat 4: PokerStarMan123 (5019 in chips) 
Seat 8: JeBoyDirk (10165 in chips) 
Seat 9: dhduncan (1778 in chips) 
PokerStarMan123: posts small blind 50
JeBoyDirk: posts big blind 100
*** HOLE CARDS ***
Dealt to PokerStarMan123 [Tc As]
dhduncan: calls 100
color_singleton has timed out
color_singleton: folds 
GillesdeH: calls 100
PokerStarMan123: calls 50
JeBoyDirk: checks 
*** FLOP *** [3h Th 3c]
PokerStarMan123: bets 300
JeBoyDirk: folds 
dhduncan has timed out
dhduncan: folds 
GillesdeH: calls 300
*** TURN *** [3h Th 3c] [Kc]
PokerStarMan123: checks 
GillesdeH: bets 945
PokerStarMan123: calls 945
*** RIVER *** [3h Th 3c Kc] [9c]
PokerStarMan123: checks 
GillesdeH: bets 2731
PokerStarMan123: folds 
Uncalled bet (2731) returned to GillesdeH
GillesdeH collected 2731 from pot
*** SUMMARY ***
Total pot 2890 | Rake 159 
Board [3h Th 3c Kc 9c]
Seat 1: color_singleton folded before Flop (didn't bet)
Seat 3: GillesdeH (button) collected (2731)
Seat 4: PokerStarMan123 (small blind) folded on the River
Seat 8: JeBoyDirk (big blind) folded on the Flop
Seat 9: dhduncan folded on the Flop



PokerStars Home Game Hand #226314284907: {DaPokaStars}  Hold'em No Limit (50/100) - 2021/04/29 17:18:06 ET
Table 'yes_sir' 9-max (Play Money) Seat #4 is the button
Seat 1: color_singleton (20969 in chips) 
Seat 2: manon327 (11948 in chips) 
Seat 3: GillesdeH (40901 in chips) 
Seat 4: PokerStarMan123 (3674 in chips) 
Seat 8: JeBoyDirk (10065 in chips) 
Seat 9: dhduncan (1678 in chips) 
JeBoyDirk: posts small blind 50
dhduncan: posts big blind 100
*** HOLE CARDS ***
Dealt to PokerStarMan123 [7s 8c]
color_singleton: folds 
manon327: folds 
GillesdeH: calls 100
PokerStarMan123: calls 100
JeBoyDirk: folds 
dhduncan: checks 
*** FLOP *** [Qs Jd 2h]
dhduncan: bets 100
GillesdeH: folds 
PokerStarMan123: folds 
Uncalled bet (100) returned to dhduncan
dhduncan collected 331 from pot
dhduncan: doesn't show hand 
*** SUMMARY ***
Total pot 350 | Rake 19 
Board [Qs Jd 2h]
Seat 1: color_singleton folded before Flop (didn't bet)
Seat 2: manon327 folded before Flop (didn't bet)
Seat 3: GillesdeH folded on the Flop
Seat 4: PokerStarMan123 (button) folded on the Flop
Seat 8: JeBoyDirk (small blind) folded before Flop
Seat 9: dhduncan (big blind) collected (331)



PokerStars Home Game Hand #226314297512: {DaPokaStars}  Hold'em No Limit (50/100) - 2021/04/29 17:18:28 ET
Table 'yes_sir' 9-max (Play Money) Seat #8 is the button
Seat 1: color_singleton (20969 in chips) 
Seat 2: manon327 (11948 in chips) 
Seat 3: GillesdeH (40801 in chips) 
Seat 4: PokerStarMan123 (3574 in chips) 
Seat 8: JeBoyDirk (10015 in chips) 
Seat 9: dhduncan (1909 in chips) 
dhduncan: posts small blind 50
color_singleton: posts big blind 100
*** HOLE CARDS ***
Dealt to PokerStarMan123 [5c 9s]
manon327: folds 
GillesdeH: calls 100
PokerStarMan123: folds 
JeBoyDirk: folds 
dhduncan: folds 
color_singleton: checks 
*** FLOP *** [Tc Kd 8c]
color_singleton: bets 118
GillesdeH: folds 
Uncalled bet (118) returned to color_singleton
color_singleton collected 236 from pot
color_singleton: doesn't show hand 
*** SUMMARY ***
Total pot 250 | Rake 14 
Board [Tc Kd 8c]
Seat 1: color_singleton (big blind) collected (236)
Seat 2: manon327 folded before Flop (didn't bet)
Seat 3: GillesdeH folded on the Flop
Seat 4: PokerStarMan123 folded before Flop (didn't bet)
Seat 8: JeBoyDirk (button) folded before Flop (didn't bet)
Seat 9: dhduncan (small blind) folded before Flop



PokerStars Home Game Hand #226314313401: {DaPokaStars}  Hold'em No Limit (50/100) - 2021/04/29 17:18:56 ET
Table 'yes_sir' 9-max (Play Money) Seat #9 is the button
Seat 1: color_singleton (21105 in chips) 
Seat 2: manon327 (11948 in chips) 
Seat 3: GillesdeH (40701 in chips) 
Seat 4: PokerStarMan123 (3574 in chips) 
Seat 8: JeBoyDirk (10015 in chips) 
Seat 9: dhduncan (1859 in chips) 
color_singleton: posts small blind 50
manon327: posts big blind 100
*** HOLE CARDS ***
Dealt to PokerStarMan123 [6c 2c]
GillesdeH: calls 100
PokerStarMan123: folds 
JeBoyDirk: folds 
dhduncan: calls 100
color_singleton: raises 300 to 400
manon327: calls 300
GillesdeH: calls 300
dhduncan: raises 300 to 700
color_singleton: calls 300
manon327: calls 300
GillesdeH: calls 300
*** FLOP *** [4h 9d 6h]
color_singleton: checks 
manon327: checks 
GillesdeH: checks 
dhduncan: bets 1159 and is all-in
color_singleton: folds 
manon327: calls 1159
GillesdeH: folds 
*** TURN *** [4h 9d 6h] [Ah]
*** RIVER *** [4h 9d 6h Ah] [9h]
*** SHOW DOWN ***
manon327: shows [Kh Jh] (a flush, Ace high)
dhduncan: shows [7d 7s] (two pair, Nines and Sevens)
manon327 collected 4837 from pot
*** SUMMARY ***
Total pot 5118 | Rake 281 
Board [4h 9d 6h Ah 9h]
Seat 1: color_singleton (small blind) folded on the Flop
Seat 2: manon327 (big blind) showed [Kh Jh] and won (4837) with a flush, Ace high
Seat 3: GillesdeH folded on the Flop
Seat 4: PokerStarMan123 folded before Flop (didn't bet)
Seat 8: JeBoyDirk folded before Flop (didn't bet)
Seat 9: dhduncan (button) showed [7d 7s] and lost with two pair, Nines and Sevens



PokerStars Home Game Hand #226314346259: {DaPokaStars}  Hold'em No Limit (50/100) - 2021/04/29 17:19:55 ET
Table 'yes_sir' 9-max (Play Money) Seat #1 is the button
Seat 1: color_singleton (20405 in chips) 
Seat 2: manon327 (14926 in chips) 
Seat 3: GillesdeH (40001 in chips) 
Seat 4: PokerStarMan123 (3574 in chips) 
Seat 8: JeBoyDirk (10015 in chips) 
manon327: posts small blind 50
GillesdeH: posts big blind 100
*** HOLE CARDS ***
Dealt to PokerStarMan123 [Js 2h]
PokerStarMan123: folds 
JeBoyDirk: folds 
color_singleton: folds 
manon327: calls 50
GillesdeH: checks 
*** FLOP *** [3c Qh Th]
manon327: checks 
GillesdeH: bets 189
manon327: folds 
Uncalled bet (189) returned to GillesdeH
GillesdeH collected 189 from pot
*** SUMMARY ***
Total pot 200 | Rake 11 
Board [3c Qh Th]
Seat 1: color_singleton (button) folded before Flop (didn't bet)
Seat 2: manon327 (small blind) folded on the Flop
Seat 3: GillesdeH (big blind) collected (189)
Seat 4: PokerStarMan123 folded before Flop (didn't bet)
Seat 8: JeBoyDirk folded before Flop (didn't bet)



PokerStars Home Game Hand #226314359209: {DaPokaStars}  Hold'em No Limit (50/100) - 2021/04/29 17:20:17 ET
Table 'yes_sir' 9-max (Play Money) Seat #2 is the button
Seat 1: color_singleton (20405 in chips) 
Seat 2: manon327 (14826 in chips) 
Seat 3: GillesdeH (40090 in chips) 
Seat 4: PokerStarMan123 (3574 in chips) 
Seat 8: JeBoyDirk (10015 in chips) 
Seat 9: dhduncan (9764 in chips) 
GillesdeH: posts small blind 50
PokerStarMan123: posts big blind 100
*** HOLE CARDS ***
Dealt to PokerStarMan123 [Tc 4c]
JeBoyDirk: folds 
dhduncan: folds 
dhduncan leaves the table
color_singleton: folds 
manon327: calls 100
GillesdeH: calls 50
PokerStarMan123: checks 
*** FLOP *** [6c 3h 7s]
GillesdeH: bets 283
PokerStarMan123: folds 
manon327: folds 
Uncalled bet (283) returned to GillesdeH
GillesdeH collected 283 from pot
*** SUMMARY ***
Total pot 300 | Rake 17 
Board [6c 3h 7s]
Seat 1: color_singleton folded before Flop (didn't bet)
Seat 2: manon327 (button) folded on the Flop
Seat 3: GillesdeH (small blind) collected (283)
Seat 4: PokerStarMan123 (big blind) folded on the Flop
Seat 8: JeBoyDirk folded before Flop (didn't bet)
Seat 9: dhduncan folded before Flop (didn't bet)



PokerStars Home Game Hand #226314377935: {DaPokaStars}  Hold'em No Limit (50/100) - 2021/04/29 17:20:51 ET
Table 'yes_sir' 9-max (Play Money) Seat #3 is the button
Seat 1: color_singleton (20405 in chips) 
Seat 2: manon327 (14726 in chips) 
Seat 3: GillesdeH (40273 in chips) 
Seat 4: PokerStarMan123 (3474 in chips) 
Seat 8: JeBoyDirk (10015 in chips) 
PokerStarMan123: posts small blind 50
JeBoyDirk: posts big blind 100
*** HOLE CARDS ***
Dealt to PokerStarMan123 [5c 9h]
color_singleton: folds 
manon327: folds 
GillesdeH: calls 100
PokerStarMan123: calls 50
JeBoyDirk: checks 
*** FLOP *** [Ks Qs Qc]
PokerStarMan123: checks 
JeBoyDirk: checks 
GillesdeH: checks 
*** TURN *** [Ks Qs Qc] [9s]
PokerStarMan123: checks 
JeBoyDirk: checks 
GillesdeH: checks 
*** RIVER *** [Ks Qs Qc 9s] [7h]
PokerStarMan123: checks 
JeBoyDirk: checks 
GillesdeH: checks 
*** SHOW DOWN ***
PokerStarMan123: shows [5c 9h] (two pair, Queens and Nines)
JeBoyDirk: shows [Jh 9c] (two pair, Queens and Nines)
GillesdeH: mucks hand 
PokerStarMan123 collected 142 from pot
JeBoyDirk collected 141 from pot
*** SUMMARY ***
Total pot 300 | Rake 17 
Board [Ks Qs Qc 9s 7h]
Seat 1: color_singleton folded before Flop (didn't bet)
Seat 2: manon327 folded before Flop (didn't bet)
Seat 3: GillesdeH (button) mucked [3h 6c]
Seat 4: PokerStarMan123 (small blind) showed [5c 9h] and won (142) with two pair, Queens and Nines
Seat 8: JeBoyDirk (big blind) showed [Jh 9c] and won (141) with two pair, Queens and Nines



PokerStars Home Game Hand #226314392781: {DaPokaStars}  Hold'em No Limit (50/100) - 2021/04/29 17:21:17 ET
Table 'yes_sir' 9-max (Play Money) Seat #4 is the button
Seat 1: color_singleton (20405 in chips) 
Seat 2: manon327 (14726 in chips) 
Seat 3: GillesdeH (40173 in chips) 
Seat 4: PokerStarMan123 (3516 in chips) 
Seat 8: JeBoyDirk (10056 in chips) 
JeBoyDirk: posts small blind 50
color_singleton: posts big blind 100
*** HOLE CARDS ***
Dealt to PokerStarMan123 [2h 2c]
manon327: calls 100
GillesdeH: calls 100
PokerStarMan123: calls 100
JeBoyDirk: calls 50
color_singleton: raises 200 to 300
manon327: folds 
GillesdeH: calls 200
PokerStarMan123: calls 200
JeBoyDirk: calls 200
*** FLOP *** [3s Ad Jd]
JeBoyDirk: checks 
color_singleton: checks 
GillesdeH: bets 614
PokerStarMan123: folds 
JeBoyDirk: folds 
color_singleton: folds 
Uncalled bet (614) returned to GillesdeH
GillesdeH collected 1228 from pot
*** SUMMARY ***
Total pot 1300 | Rake 72 
Board [3s Ad Jd]
Seat 1: color_singleton (big blind) folded on the Flop
Seat 2: manon327 folded before Flop
Seat 3: GillesdeH collected (1228)
Seat 4: PokerStarMan123 (button) folded on the Flop
Seat 8: JeBoyDirk (small blind) folded on the Flop



PokerStars Home Game Hand #226314419519: {DaPokaStars}  Hold'em No Limit (50/100) - 2021/04/29 17:22:05 ET
Table 'yes_sir' 9-max (Play Money) Seat #8 is the button
Seat 1: color_singleton (20105 in chips) 
Seat 2: manon327 (14626 in chips) 
Seat 3: GillesdeH (41101 in chips) 
Seat 4: PokerStarMan123 (3216 in chips) 
Seat 8: JeBoyDirk (9756 in chips) 
color_singleton: posts small blind 50
manon327: posts big blind 100
*** HOLE CARDS ***
Dealt to PokerStarMan123 [6h 3d]
GillesdeH: calls 100
PokerStarMan123: folds 
JeBoyDirk: folds 
color_singleton: folds 
manon327: checks 
*** FLOP *** [Jd Kd Jc]
manon327: bets 118
GillesdeH: folds 
Uncalled bet (118) returned to manon327
manon327 collected 236 from pot
*** SUMMARY ***
Total pot 250 | Rake 14 
Board [Jd Kd Jc]
Seat 1: color_singleton (small blind) folded before Flop
Seat 2: manon327 (big blind) collected (236)
Seat 3: GillesdeH folded on the Flop
Seat 4: PokerStarMan123 folded before Flop (didn't bet)
Seat 8: JeBoyDirk (button) folded before Flop (didn't bet)



PokerStars Home Game Hand #226314436343: {DaPokaStars}  Hold'em No Limit (50/100) - 2021/04/29 17:22:17 ET
Table 'yes_sir' 9-max (Play Money) Seat #1 is the button
Seat 1: color_singleton (20055 in chips) 
Seat 2: manon327 (14762 in chips) 
Seat 3: GillesdeH (41001 in chips) 
Seat 4: PokerStarMan123 (3216 in chips) 
Seat 8: JeBoyDirk (9756 in chips) 
manon327: posts small blind 50
GillesdeH: posts big blind 100
*** HOLE CARDS ***
Dealt to PokerStarMan123 [9h 9c]
PokerStarMan123: raises 300 to 400
JeBoyDirk: folds 
color_singleton: folds 
manon327: folds 
GillesdeH: calls 300
*** FLOP *** [7h 2d 5h]
GillesdeH: checks 
PokerStarMan123: bets 700
GillesdeH: calls 700
*** TURN *** [7h 2d 5h] [7c]
GillesdeH: checks 
PokerStarMan123: bets 2116 and is all-in
GillesdeH: folds 
Uncalled bet (2116) returned to PokerStarMan123
PokerStarMan123 collected 2126 from pot
*** SUMMARY ***
Total pot 2250 | Rake 124 
Board [7h 2d 5h 7c]
Seat 1: color_singleton (button) folded before Flop (didn't bet)
Seat 2: manon327 (small blind) folded before Flop
Seat 3: GillesdeH (big blind) folded on the Turn
Seat 4: PokerStarMan123 collected (2126)
Seat 8: JeBoyDirk folded before Flop (didn't bet)



PokerStars Home Game Hand #226314460027: {DaPokaStars}  Hold'em No Limit (50/100) - 2021/04/29 17:23:00 ET
Table 'yes_sir' 9-max (Play Money) Seat #2 is the button
Seat 1: color_singleton (20055 in chips) 
Seat 2: manon327 (14712 in chips) 
Seat 3: GillesdeH (39901 in chips) 
Seat 4: PokerStarMan123 (4242 in chips) 
Seat 8: JeBoyDirk (9756 in chips) 
GillesdeH: posts small blind 50
PokerStarMan123: posts big blind 100
*** HOLE CARDS ***
Dealt to PokerStarMan123 [3s 8c]
JeBoyDirk: folds 
color_singleton: raises 100 to 200
manon327: calls 200
GillesdeH: calls 150
PokerStarMan123: folds 
*** FLOP *** [Kc 6c 5d]
GillesdeH: checks 
color_singleton: bets 330
manon327: calls 330
GillesdeH: calls 330
*** TURN *** [Kc 6c 5d] [Td]
GillesdeH: checks 
color_singleton: bets 798
manon327: calls 798
GillesdeH: folds 
*** RIVER *** [Kc 6c 5d Td] [4s]
color_singleton: checks 
manon327: checks 
*** SHOW DOWN ***
color_singleton: shows [Ks 7d] (a pair of Kings)
manon327: mucks hand 
color_singleton collected 3105 from pot
*** SUMMARY ***
Total pot 3286 | Rake 181 
Board [Kc 6c 5d Td 4s]
Seat 1: color_singleton showed [Ks 7d] and won (3105) with a pair of Kings
Seat 2: manon327 (button) mucked [Ad Js]
Seat 3: GillesdeH (small blind) folded on the Turn
Seat 4: PokerStarMan123 (big blind) folded before Flop
Seat 8: JeBoyDirk folded before Flop (didn't bet)



PokerStars Home Game Hand #226314489935: {DaPokaStars}  Hold'em No Limit (50/100) - 2021/04/29 17:23:54 ET
Table 'yes_sir' 9-max (Play Money) Seat #3 is the button
Seat 1: color_singleton (21832 in chips) 
Seat 2: manon327 (13384 in chips) 
Seat 3: GillesdeH (39371 in chips) 
Seat 4: PokerStarMan123 (4142 in chips) 
Seat 8: JeBoyDirk (9756 in chips) 
PokerStarMan123: posts small blind 50
JeBoyDirk: posts big blind 100
*** HOLE CARDS ***
Dealt to PokerStarMan123 [6s 8d]
color_singleton: raises 200 to 300
manon327: folds 
GillesdeH: calls 300
PokerStarMan123: folds 
JeBoyDirk: calls 200
*** FLOP *** [7d 7c 3s]
JeBoyDirk: checks 
color_singleton: bets 898
GillesdeH: folds 
JeBoyDirk: folds 
Uncalled bet (898) returned to color_singleton
color_singleton collected 898 from pot
color_singleton: doesn't show hand 
*** SUMMARY ***
Total pot 950 | Rake 52 
Board [7d 7c 3s]
Seat 1: color_singleton collected (898)
Seat 2: manon327 folded before Flop (didn't bet)
Seat 3: GillesdeH (button) folded on the Flop
Seat 4: PokerStarMan123 (small blind) folded before Flop
Seat 8: JeBoyDirk (big blind) folded on the Flop



PokerStars Home Game Hand #226314508789: {DaPokaStars}  Hold'em No Limit (50/100) - 2021/04/29 17:24:28 ET
Table 'yes_sir' 9-max (Play Money) Seat #4 is the button
Seat 1: color_singleton (22430 in chips) 
Seat 2: manon327 (13384 in chips) 
Seat 3: GillesdeH (39071 in chips) 
Seat 4: PokerStarMan123 (4092 in chips) 
Seat 8: JeBoyDirk (9456 in chips) 
JeBoyDirk: posts small blind 50
color_singleton: posts big blind 100
*** HOLE CARDS ***
Dealt to PokerStarMan123 [7h 7d]
manon327: calls 100
GillesdeH: calls 100
PokerStarMan123: raises 300 to 400
JeBoyDirk: calls 350
color_singleton: folds 
manon327: calls 300
GillesdeH: calls 300
*** FLOP *** [8d 8h 3c]
JeBoyDirk: checks 
manon327: checks 
GillesdeH: checks 
PokerStarMan123: bets 900
JeBoyDirk: folds 
manon327: folds 
GillesdeH: calls 900
*** TURN *** [8d 8h 3c] [5h]
GillesdeH: bets 1653
PokerStarMan123: raises 1139 to 2792 and is all-in
GillesdeH: calls 1139
*** RIVER *** [8d 8h 3c 5h] [5s]
*** SHOW DOWN ***
GillesdeH: shows [4s 8s] (a full house, Eights full of Fives)
PokerStarMan123: shows [7h 7d] (two pair, Eights and Sevens)
GillesdeH collected 8584 from pot
*** SUMMARY ***
Total pot 9084 | Rake 500 
Board [8d 8h 3c 5h 5s]
Seat 1: color_singleton (big blind) folded before Flop
Seat 2: manon327 folded on the Flop
Seat 3: GillesdeH showed [4s 8s] and won (8584) with a full house, Eights full of Fives
Seat 4: PokerStarMan123 (button) showed [7h 7d] and lost with two pair, Eights and Sevens
Seat 8: JeBoyDirk (small blind) folded on the Flop



PokerStars Home Game Hand #226314550365: {DaPokaStars}  Hold'em No Limit (50/100) - 2021/04/29 17:25:45 ET
Table 'yes_sir' 9-max (Play Money) Seat #1 is the button
Seat 1: color_singleton (23022 in chips) 
Seat 2: manon327 (12884 in chips) 
Seat 3: GillesdeH (43263 in chips) 
Seat 4: PokerStarMan123 (10000 in chips) 
Seat 6: Klemtonius (9634 in chips) 
Seat 8: JeBoyDirk (9056 in chips) 
manon327: posts small blind 50
GillesdeH: posts big blind 100
*** HOLE CARDS ***
Dealt to PokerStarMan123 [9c Td]
PokerStarMan123: raises 200 to 300
Klemtonius: calls 300
JeBoyDirk: folds 
color_singleton: calls 300
manon327: folds 
GillesdeH: calls 200
*** FLOP *** [3d 6s Jd]
GillesdeH: checks 
PokerStarMan123: checks 
Klemtonius: checks 
color_singleton: checks 
*** TURN *** [3d 6s Jd] [7h]
GillesdeH: bets 590
PokerStarMan123: folds 
Klemtonius: folds 
color_singleton: calls 590
*** RIVER *** [3d 6s Jd 7h] [Jh]
GillesdeH: checks 
color_singleton: checks 
*** SHOW DOWN ***
GillesdeH: shows [4s 7d] (two pair, Jacks and Sevens)
color_singleton: mucks hand 
GillesdeH collected 2296 from pot
*** SUMMARY ***
Total pot 2430 | Rake 134 
Board [3d 6s Jd 7h Jh]
Seat 1: color_singleton (button) mucked [5s Qs]
Seat 2: manon327 (small blind) folded before Flop
Seat 3: GillesdeH (big blind) showed [4s 7d] and won (2296) with two pair, Jacks and Sevens
Seat 4: PokerStarMan123 folded on the Turn
Seat 6: Klemtonius folded on the Turn
Seat 8: JeBoyDirk folded before Flop (didn't bet)



PokerStars Home Game Hand #226314596092: {DaPokaStars}  Hold'em No Limit (50/100) - 2021/04/29 17:27:08 ET
Table 'yes_sir' 9-max (Play Money) Seat #2 is the button
Seat 1: color_singleton (22132 in chips) 
Seat 2: manon327 (12834 in chips) 
Seat 3: GillesdeH (44669 in chips) 
Seat 4: PokerStarMan123 (9700 in chips) 
Seat 6: Klemtonius (9334 in chips) 
Seat 8: JeBoyDirk (9056 in chips) 
GillesdeH: posts small blind 50
PokerStarMan123: posts big blind 100
*** HOLE CARDS ***
Dealt to PokerStarMan123 [Ts 7c]
Klemtonius: folds 
JeBoyDirk: folds 
color_singleton: raises 200 to 300
manon327: calls 300
GillesdeH: calls 250
PokerStarMan123: folds 
*** FLOP *** [Ac 9c Ad]
GillesdeH: checks 
color_singleton: checks 
manon327: checks 
*** TURN *** [Ac 9c Ad] [As]
GillesdeH: checks 
color_singleton: bets 472
manon327: folds 
GillesdeH: folds 
Uncalled bet (472) returned to color_singleton
color_singleton collected 945 from pot
color_singleton: doesn't show hand 
*** SUMMARY ***
Total pot 1000 | Rake 55 
Board [Ac 9c Ad As]
Seat 1: color_singleton collected (945)
Seat 2: manon327 (button) folded on the Turn
Seat 3: GillesdeH (small blind) folded on the Turn
Seat 4: PokerStarMan123 (big blind) folded before Flop
Seat 6: Klemtonius folded before Flop (didn't bet)
Seat 8: JeBoyDirk folded before Flop (didn't bet)



PokerStars Home Game Hand #226314611433: {DaPokaStars}  Hold'em No Limit (50/100) - 2021/04/29 17:27:37 ET
Table 'yes_sir' 9-max (Play Money) Seat #3 is the button
Seat 1: color_singleton (22777 in chips) 
Seat 2: manon327 (12534 in chips) 
Seat 3: GillesdeH (44369 in chips) 
Seat 4: PokerStarMan123 (9600 in chips) 
Seat 6: Klemtonius (9334 in chips) 
Seat 8: JeBoyDirk (9056 in chips) 
PokerStarMan123: posts small blind 50
Klemtonius: posts big blind 100
*** HOLE CARDS ***
Dealt to PokerStarMan123 [Ah 4s]
JeBoyDirk: calls 100
color_singleton: raises 200 to 300
manon327: folds 
GillesdeH: calls 300
PokerStarMan123: folds 
Klemtonius: calls 200
JeBoyDirk: calls 200
*** FLOP *** [7s Ad Jc]
Klemtonius: checks 
JeBoyDirk: checks 
color_singleton: checks 
GillesdeH: checks 
*** TURN *** [7s Ad Jc] [As]
Klemtonius: checks 
JeBoyDirk: checks 
color_singleton: checks 
GillesdeH: checks 
*** RIVER *** [7s Ad Jc As] [6c]
Klemtonius: checks 
JeBoyDirk: checks 
color_singleton: checks 
GillesdeH: checks 
*** SHOW DOWN ***
Klemtonius: shows [Ks 4d] (a pair of Aces)
JeBoyDirk: shows [9h 7h] (two pair, Aces and Sevens)
color_singleton: mucks hand 
GillesdeH: mucks hand 
JeBoyDirk collected 1181 from pot
*** SUMMARY ***
Total pot 1250 | Rake 69 
Board [7s Ad Jc As 6c]
Seat 1: color_singleton mucked [8h Kd]
Seat 2: manon327 folded before Flop (didn't bet)
Seat 3: GillesdeH (button) mucked [6s Th]
Seat 4: PokerStarMan123 (small blind) folded before Flop
Seat 6: Klemtonius (big blind) showed [Ks 4d] and lost with a pair of Aces
Seat 8: JeBoyDirk showed [9h 7h] and won (1181) with two pair, Aces and Sevens



PokerStars Home Game Hand #226314640737: {DaPokaStars}  Hold'em No Limit (50/100) - 2021/04/29 17:28:30 ET
Table 'yes_sir' 9-max (Play Money) Seat #4 is the button
Seat 1: color_singleton (22477 in chips) 
Seat 2: manon327 (12534 in chips) 
Seat 3: GillesdeH (44069 in chips) 
Seat 4: PokerStarMan123 (9550 in chips) 
Seat 6: Klemtonius (9034 in chips) 
Seat 8: JeBoyDirk (9937 in chips) 
Klemtonius: posts small blind 50
JeBoyDirk: posts big blind 100
*** HOLE CARDS ***
Dealt to PokerStarMan123 [As 6c]
color_singleton: raises 200 to 300
manon327: folds 
GillesdeH: calls 300
PokerStarMan123: folds 
Klemtonius: calls 250
JeBoyDirk: folds 
*** FLOP *** [9s Qd 3d]
Klemtonius: bets 472
color_singleton: folds 
GillesdeH: calls 472
*** TURN *** [9s Qd 3d] [8d]
Klemtonius: checks 
GillesdeH: checks 
*** RIVER *** [9s Qd 3d 8d] [Td]
Klemtonius: bets 918
GillesdeH: raises 918 to 1836
Klemtonius: folds 
Uncalled bet (918) returned to GillesdeH
GillesdeH collected 3572 from pot
*** SUMMARY ***
Total pot 3780 | Rake 208 
Board [9s Qd 3d 8d Td]
Seat 1: color_singleton folded on the Flop
Seat 2: manon327 folded before Flop (didn't bet)
Seat 3: GillesdeH collected (3572)
Seat 4: PokerStarMan123 (button) folded before Flop (didn't bet)
Seat 6: Klemtonius (small blind) folded on the River
Seat 8: JeBoyDirk (big blind) folded before Flop



PokerStars Home Game Hand #226314673906: {DaPokaStars}  Hold'em No Limit (50/100) - 2021/04/29 17:29:31 ET
Table 'yes_sir' 9-max (Play Money) Seat #6 is the button
Seat 1: color_singleton (22177 in chips) 
Seat 2: manon327 (12534 in chips) 
Seat 3: GillesdeH (45951 in chips) 
Seat 4: PokerStarMan123 (9550 in chips) 
Seat 6: Klemtonius (7344 in chips) 
Seat 8: JeBoyDirk (9837 in chips) 
JeBoyDirk: posts small blind 50
color_singleton: posts big blind 100
*** HOLE CARDS ***
Dealt to PokerStarMan123 [8d 6s]
manon327: folds 
GillesdeH has timed out
GillesdeH: folds 
PokerStarMan123: folds 
Klemtonius: calls 100
JeBoyDirk: folds 
color_singleton: checks 
*** FLOP *** [8c Ks 2c]
color_singleton: checks 
Klemtonius: checks 
*** TURN *** [8c Ks 2c] [7c]
color_singleton: bets 118
Klemtonius: folds 
Uncalled bet (118) returned to color_singleton
color_singleton collected 236 from pot
color_singleton: doesn't show hand 
*** SUMMARY ***
Total pot 250 | Rake 14 
Board [8c Ks 2c 7c]
Seat 1: color_singleton (big blind) collected (236)
Seat 2: manon327 folded before Flop (didn't bet)
Seat 3: GillesdeH folded before Flop (didn't bet)
Seat 4: PokerStarMan123 folded before Flop (didn't bet)
Seat 6: Klemtonius (button) folded on the Turn
Seat 8: JeBoyDirk (small blind) folded before Flop



PokerStars Home Game Hand #226314698841: {DaPokaStars}  Hold'em No Limit (50/100) - 2021/04/29 17:30:17 ET
Table 'yes_sir' 9-max (Play Money) Seat #8 is the button
Seat 1: color_singleton (22313 in chips) 
Seat 2: manon327 (12534 in chips) 
Seat 4: PokerStarMan123 (9550 in chips) 
Seat 6: Klemtonius (7244 in chips) 
Seat 8: JeBoyDirk (9787 in chips) 
color_singleton: posts small blind 50
manon327: posts big blind 100
*** HOLE CARDS ***
Dealt to PokerStarMan123 [7d Jc]
PokerStarMan123: calls 100
Klemtonius: folds 
JeBoyDirk: folds 
color_singleton: folds 
manon327: checks 
*** FLOP *** [4h 9h 7s]
manon327: checks 
PokerStarMan123: bets 200
manon327: folds 
Uncalled bet (200) returned to PokerStarMan123
PokerStarMan123 collected 236 from pot
*** SUMMARY ***
Total pot 250 | Rake 14 
Board [4h 9h 7s]
Seat 1: color_singleton (small blind) folded before Flop
Seat 2: manon327 (big blind) folded on the Flop
Seat 4: PokerStarMan123 collected (236)
Seat 6: Klemtonius folded before Flop (didn't bet)
Seat 8: JeBoyDirk (button) folded before Flop (didn't bet)



PokerStars Home Game Hand #226314710374: {DaPokaStars}  Hold'em No Limit (50/100) - 2021/04/29 17:30:39 ET
Table 'yes_sir' 9-max (Play Money) Seat #1 is the button
Seat 1: color_singleton (22263 in chips) 
Seat 2: manon327 (12434 in chips) 
Seat 4: PokerStarMan123 (9686 in chips) 
Seat 6: Klemtonius (7244 in chips) 
Seat 8: JeBoyDirk (9787 in chips) 
manon327: posts small blind 50
PokerStarMan123: posts big blind 100
*** HOLE CARDS ***
Dealt to PokerStarMan123 [8s 4c]
Klemtonius: calls 100
JeBoyDirk: calls 100
color_singleton: calls 100
manon327: folds 
PokerStarMan123: checks 
*** FLOP *** [Kd 5h Ad]
PokerStarMan123: checks 
Klemtonius: checks 
JeBoyDirk: checks 
color_singleton: checks 
*** TURN *** [Kd 5h Ad] [2h]
PokerStarMan123: checks 
Klemtonius: checks 
JeBoyDirk: checks 
color_singleton: checks 
*** RIVER *** [Kd 5h Ad 2h] [3h]
PokerStarMan123: bets 500
Klemtonius: folds 
JeBoyDirk: folds 
color_singleton: folds 
Uncalled bet (500) returned to PokerStarMan123
PokerStarMan123 collected 425 from pot
*** SUMMARY ***
Total pot 450 | Rake 25 
Board [Kd 5h Ad 2h 3h]
Seat 1: color_singleton (button) folded on the River
Seat 2: manon327 (small blind) folded before Flop
Seat 4: PokerStarMan123 (big blind) collected (425)
Seat 6: Klemtonius folded on the River
Seat 8: JeBoyDirk folded on the River



PokerStars Home Game Hand #226314732850: {DaPokaStars}  Hold'em No Limit (50/100) - 2021/04/29 17:31:17 ET
Table 'yes_sir' 9-max (Play Money) Seat #2 is the button
Seat 1: color_singleton (22163 in chips) 
Seat 2: manon327 (12384 in chips) 
Seat 4: PokerStarMan123 (10011 in chips) 
Seat 6: Klemtonius (7144 in chips) 
Seat 8: JeBoyDirk (9687 in chips) 
PokerStarMan123: posts small blind 50
Klemtonius: posts big blind 100
*** HOLE CARDS ***
Dealt to PokerStarMan123 [Qh 5c]
JeBoyDirk: raises 100 to 200
color_singleton: raises 200 to 400
manon327: folds 
PokerStarMan123: folds 
Klemtonius: calls 300
JeBoyDirk: calls 200
*** FLOP *** [Ac 2d 3s]
Klemtonius: checks 
JeBoyDirk: checks 
color_singleton: bets 590
Klemtonius: folds 
JeBoyDirk: raises 590 to 1180
color_singleton: folds 
Uncalled bet (590) returned to JeBoyDirk
JeBoyDirk collected 2296 from pot
*** SUMMARY ***
Total pot 2430 | Rake 134 
Board [Ac 2d 3s]
Seat 1: color_singleton folded on the Flop
Seat 2: manon327 (button) folded before Flop (didn't bet)
Seat 4: PokerStarMan123 (small blind) folded before Flop
Seat 6: Klemtonius (big blind) folded on the Flop
Seat 8: JeBoyDirk collected (2296)



PokerStars Home Game Hand #226314757484: {DaPokaStars}  Hold'em No Limit (50/100) - 2021/04/29 17:32:03 ET
Table 'yes_sir' 9-max (Play Money) Seat #4 is the button
Seat 1: color_singleton (21173 in chips) 
Seat 2: manon327 (12384 in chips) 
Seat 4: PokerStarMan123 (9961 in chips) 
Seat 6: Klemtonius (6744 in chips) 
Seat 8: JeBoyDirk (10993 in chips) 
Klemtonius: posts small blind 50
JeBoyDirk: posts big blind 100
*** HOLE CARDS ***
Dealt to PokerStarMan123 [9d Jc]
color_singleton: raises 100 to 200
manon327: calls 200
PokerStarMan123: raises 300 to 500
Klemtonius: folds 
JeBoyDirk: folds 
color_singleton: calls 300
manon327: folds 
*** FLOP *** [8s Qs 7s]
color_singleton: bets 1276
PokerStarMan123: folds 
Uncalled bet (1276) returned to color_singleton
color_singleton collected 1276 from pot
color_singleton: doesn't show hand 
*** SUMMARY ***
Total pot 1350 | Rake 74 
Board [8s Qs 7s]
Seat 1: color_singleton collected (1276)
Seat 2: manon327 folded before Flop
Seat 4: PokerStarMan123 (button) folded on the Flop
Seat 6: Klemtonius (small blind) folded before Flop
Seat 8: JeBoyDirk (big blind) folded before Flop



PokerStars Home Game Hand #226314774581: {DaPokaStars}  Hold'em No Limit (50/100) - 2021/04/29 17:32:34 ET
Table 'yes_sir' 9-max (Play Money) Seat #6 is the button
Seat 1: color_singleton (21949 in chips) 
Seat 2: manon327 (12184 in chips) 
Seat 4: PokerStarMan123 (9461 in chips) 
Seat 6: Klemtonius (6694 in chips) 
Seat 8: JeBoyDirk (10893 in chips) 
JeBoyDirk: posts small blind 50
color_singleton: posts big blind 100
*** HOLE CARDS ***
Dealt to PokerStarMan123 [4c 8h]
manon327: calls 100
PokerStarMan123: folds 
Klemtonius: calls 100
JeBoyDirk: calls 50
color_singleton: checks 
*** FLOP *** [As Ac Jc]
JeBoyDirk: checks 
color_singleton: checks 
manon327: checks 
Klemtonius: checks 
*** TURN *** [As Ac Jc] [8d]
JeBoyDirk: bets 100
color_singleton: folds 
manon327: folds 
Klemtonius: calls 100
*** RIVER *** [As Ac Jc 8d] [7s]
JeBoyDirk: bets 500
Klemtonius: folds 
Uncalled bet (500) returned to JeBoyDirk
JeBoyDirk collected 567 from pot
*** SUMMARY ***
Total pot 600 | Rake 33 
Board [As Ac Jc 8d 7s]
Seat 1: color_singleton (big blind) folded on the Turn
Seat 2: manon327 folded on the Turn
Seat 4: PokerStarMan123 folded before Flop (didn't bet)
Seat 6: Klemtonius (button) folded on the River
Seat 8: JeBoyDirk (small blind) collected (567)



PokerStars Home Game Hand #226314804209: {DaPokaStars}  Hold'em No Limit (50/100) - 2021/04/29 17:33:29 ET
Table 'yes_sir' 9-max (Play Money) Seat #8 is the button
Seat 1: color_singleton (21849 in chips) 
Seat 2: manon327 (12084 in chips) 
Seat 4: PokerStarMan123 (9461 in chips) 
Seat 6: Klemtonius (6494 in chips) 
Seat 8: JeBoyDirk (11260 in chips) 
color_singleton: posts small blind 50
manon327: posts big blind 100
*** HOLE CARDS ***
Dealt to PokerStarMan123 [7h Ah]
PokerStarMan123: raises 200 to 300
Klemtonius: calls 300
JeBoyDirk: folds 
color_singleton: folds 
manon327: calls 200
*** FLOP *** [9h Ac 6c]
manon327: checks 
PokerStarMan123: bets 500
Klemtonius: folds 
manon327: folds 
Uncalled bet (500) returned to PokerStarMan123
PokerStarMan123 collected 898 from pot
*** SUMMARY ***
Total pot 950 | Rake 52 
Board [9h Ac 6c]
Seat 1: color_singleton (small blind) folded before Flop
Seat 2: manon327 (big blind) folded on the Flop
Seat 4: PokerStarMan123 collected (898)
Seat 6: Klemtonius folded on the Flop
Seat 8: JeBoyDirk (button) folded before Flop (didn't bet)



PokerStars Home Game Hand #226314821561: {DaPokaStars}  Hold'em No Limit (50/100) - 2021/04/29 17:34:02 ET
Table 'yes_sir' 9-max (Play Money) Seat #1 is the button
Seat 1: color_singleton (21799 in chips) 
Seat 2: manon327 (11784 in chips) 
Seat 4: PokerStarMan123 (10059 in chips) 
Seat 6: Klemtonius (6194 in chips) 
Seat 8: JeBoyDirk (11260 in chips) 
manon327: posts small blind 50
PokerStarMan123: posts big blind 100
*** HOLE CARDS ***
Dealt to PokerStarMan123 [Th 3s]
GillesdeH is disconnected 
Klemtonius: raises 100 to 200
JeBoyDirk: calls 200
color_singleton: folds 
manon327: calls 150
PokerStarMan123: folds 
*** FLOP *** [7h Ks 5h]
manon327: checks 
Klemtonius: checks 
JeBoyDirk: checks 
*** TURN *** [7h Ks 5h] [Kd]
manon327: checks 
Klemtonius: checks 
JeBoyDirk: checks 
*** RIVER *** [7h Ks 5h Kd] [9d]
manon327: checks 
Klemtonius: checks 
JeBoyDirk: checks 
*** SHOW DOWN ***
manon327: shows [Qc Jc] (a pair of Kings)
Klemtonius: mucks hand 
JeBoyDirk: shows [8h Ah] (a pair of Kings - Ace kicker)
JeBoyDirk collected 661 from pot
*** SUMMARY ***
Total pot 700 | Rake 39 
Board [7h Ks 5h Kd 9d]
Seat 1: color_singleton (button) folded before Flop (didn't bet)
Seat 2: manon327 (small blind) showed [Qc Jc] and lost with a pair of Kings
Seat 4: PokerStarMan123 (big blind) folded before Flop
Seat 6: Klemtonius mucked [Js Tc]
Seat 8: JeBoyDirk showed [8h Ah] and won (661) with a pair of Kings



PokerStars Home Game Hand #226314838718: {DaPokaStars}  Hold'em No Limit (50/100) - 2021/04/29 17:34:34 ET
Table 'yes_sir' 9-max (Play Money) Seat #2 is the button
Seat 1: color_singleton (21799 in chips) 
Seat 2: manon327 (11584 in chips) 
Seat 4: PokerStarMan123 (9959 in chips) 
Seat 6: Klemtonius (5994 in chips) 
Seat 8: JeBoyDirk (11721 in chips) 
PokerStarMan123: posts small blind 50
Klemtonius: posts big blind 100
*** HOLE CARDS ***
Dealt to PokerStarMan123 [7h 9h]
JeBoyDirk: calls 100
color_singleton: folds 
manon327: calls 100
PokerStarMan123: calls 50
Klemtonius: checks 
*** FLOP *** [Qs 5c 9d]
PokerStarMan123: checks 
Klemtonius: checks 
JeBoyDirk: checks 
manon327: checks 
*** TURN *** [Qs 5c 9d] [9s]
PokerStarMan123: bets 200
Klemtonius: calls 200
JeBoyDirk: folds 
manon327: calls 200
*** RIVER *** [Qs 5c 9d 9s] [Kd]
PokerStarMan123 has timed out
PokerStarMan123: checks 
Klemtonius: bets 945
manon327: folds 
PokerStarMan123: raises 1055 to 2000
Klemtonius: raises 3694 to 5694 and is all-in
PokerStarMan123: calls 3694
*** SHOW DOWN ***
Klemtonius: shows [9c 4c] (three of a kind, Nines)
PokerStarMan123: shows [7h 9h] (three of a kind, Nines)
PokerStarMan123 collected 5854 from pot
Klemtonius collected 5853 from pot
*** SUMMARY ***
Total pot 12388 | Rake 681 
Board [Qs 5c 9d 9s Kd]
Seat 1: color_singleton folded before Flop (didn't bet)
Seat 2: manon327 (button) folded on the River
Seat 4: PokerStarMan123 (small blind) showed [7h 9h] and won (5854) with three of a kind, Nines
Seat 6: Klemtonius (big blind) showed [9c 4c] and won (5853) with three of a kind, Nines
Seat 8: JeBoyDirk folded on the Turn



PokerStars Home Game Hand #226314876222: {DaPokaStars}  Hold'em No Limit (50/100) - 2021/04/29 17:35:44 ET
Table 'yes_sir' 9-max (Play Money) Seat #4 is the button
Seat 1: color_singleton (21799 in chips) 
Seat 2: manon327 (11284 in chips) 
Seat 4: PokerStarMan123 (9819 in chips) 
Seat 6: Klemtonius (5853 in chips) 
Seat 8: JeBoyDirk (11621 in chips) 
Klemtonius: posts small blind 50
JeBoyDirk: posts big blind 100
*** HOLE CARDS ***
Dealt to PokerStarMan123 [Ah Ad]
color_singleton: folds 
manon327: folds 
PokerStarMan123: raises 300 to 400
Klemtonius: calls 350
JeBoyDirk: folds 
*** FLOP *** [5d Ts 7d]
Klemtonius: checks 
PokerStarMan123: bets 600
Klemtonius: folds 
Uncalled bet (600) returned to PokerStarMan123
PokerStarMan123 collected 850 from pot
*** SUMMARY ***
Total pot 900 | Rake 50 
Board [5d Ts 7d]
Seat 1: color_singleton folded before Flop (didn't bet)
Seat 2: manon327 folded before Flop (didn't bet)
Seat 4: PokerStarMan123 (button) collected (850)
Seat 6: Klemtonius (small blind) folded on the Flop
Seat 8: JeBoyDirk (big blind) folded before Flop



PokerStars Home Game Hand #226314898902: {DaPokaStars}  Hold'em No Limit (50/100) - 2021/04/29 17:36:27 ET
Table 'yes_sir' 9-max (Play Money) Seat #6 is the button
Seat 1: color_singleton (21799 in chips) 
Seat 2: manon327 (11284 in chips) 
Seat 4: PokerStarMan123 (10269 in chips) 
Seat 6: Klemtonius (5453 in chips) 
Seat 8: JeBoyDirk (11521 in chips) 
JeBoyDirk: posts small blind 50
color_singleton: posts big blind 100
*** HOLE CARDS ***
Dealt to PokerStarMan123 [Qs Ts]
manon327: folds 
PokerStarMan123: raises 300 to 400
Klemtonius: calls 400
JeBoyDirk: folds 
color_singleton: folds 
*** FLOP *** [Kh Jh Qd]
PokerStarMan123: bets 400
Klemtonius: folds 
Uncalled bet (400) returned to PokerStarMan123
PokerStarMan123 collected 898 from pot
*** SUMMARY ***
Total pot 950 | Rake 52 
Board [Kh Jh Qd]
Seat 1: color_singleton (big blind) folded before Flop
Seat 2: manon327 folded before Flop (didn't bet)
Seat 4: PokerStarMan123 collected (898)
Seat 6: Klemtonius (button) folded on the Flop
Seat 8: JeBoyDirk (small blind) folded before Flop



PokerStars Home Game Hand #226314920043: {DaPokaStars}  Hold'em No Limit (50/100) - 2021/04/29 17:36:49 ET
Table 'yes_sir' 9-max (Play Money) Seat #8 is the button
Seat 1: color_singleton (21699 in chips) 
Seat 2: manon327 (11284 in chips) 
Seat 4: PokerStarMan123 (10767 in chips) 
Seat 6: Klemtonius (5053 in chips) 
Seat 8: JeBoyDirk (11471 in chips) 
color_singleton: posts small blind 50
manon327: posts big blind 100
*** HOLE CARDS ***
Dealt to PokerStarMan123 [2s 8d]
PokerStarMan123: folds 
Klemtonius: raises 250 to 350
JeBoyDirk: folds 
color_singleton: calls 300
manon327: folds 
*** FLOP *** [5c 9c Kh]
color_singleton: checks 
Klemtonius: bets 756
color_singleton: folds 
Uncalled bet (756) returned to Klemtonius
Klemtonius collected 756 from pot
Klemtonius: doesn't show hand 
*** SUMMARY ***
Total pot 800 | Rake 44 
Board [5c 9c Kh]
Seat 1: color_singleton (small blind) folded on the Flop
Seat 2: manon327 (big blind) folded before Flop
Seat 4: PokerStarMan123 folded before Flop (didn't bet)
Seat 6: Klemtonius collected (756)
Seat 8: JeBoyDirk (button) folded before Flop (didn't bet)



PokerStars Home Game Hand #226314931879: {DaPokaStars}  Hold'em No Limit (50/100) - 2021/04/29 17:37:11 ET
Table 'yes_sir' 9-max (Play Money) Seat #1 is the button
Seat 1: color_singleton (21349 in chips) 
Seat 2: manon327 (11184 in chips) 
Seat 4: PokerStarMan123 (10767 in chips) 
Seat 6: Klemtonius (5459 in chips) 
Seat 8: JeBoyDirk (11471 in chips) 
manon327: posts small blind 50
PokerStarMan123: posts big blind 100
*** HOLE CARDS ***
Dealt to PokerStarMan123 [Kc Jh]
Klemtonius: raises 100 to 200
JeBoyDirk: calls 200
color_singleton: calls 200
manon327: calls 150
PokerStarMan123: calls 100
*** FLOP *** [Qh 8c 4c]
manon327: checks 
PokerStarMan123: bets 400
Klemtonius: raises 1745 to 2145
JeBoyDirk: folds 
color_singleton: calls 2145
manon327: folds 
PokerStarMan123: folds 
*** TURN *** [Qh 8c 4c] [6h]
Klemtonius: bets 3114 and is all-in
color_singleton: calls 3114
*** RIVER *** [Qh 8c 4c 6h] [9d]
*** SHOW DOWN ***
Klemtonius: shows [Qc 2c] (a pair of Queens)
color_singleton: shows [Jd Qs] (a pair of Queens - Jack kicker)
color_singleton collected 11263 from pot
*** SUMMARY ***
Total pot 11918 | Rake 655 
Board [Qh 8c 4c 6h 9d]
Seat 1: color_singleton (button) showed [Jd Qs] and won (11263) with a pair of Queens
Seat 2: manon327 (small blind) folded on the Flop
Seat 4: PokerStarMan123 (big blind) folded on the Flop
Seat 6: Klemtonius showed [Qc 2c] and lost with a pair of Queens
Seat 8: JeBoyDirk folded on the Flop



PokerStars Home Game Hand #226314958264: {DaPokaStars}  Hold'em No Limit (50/100) - 2021/04/29 17:38:01 ET
Table 'yes_sir' 9-max (Play Money) Seat #2 is the button
Seat 1: color_singleton (27153 in chips) 
Seat 2: manon327 (10984 in chips) 
Seat 4: PokerStarMan123 (10167 in chips) 
Seat 8: JeBoyDirk (11271 in chips) 
PokerStarMan123: posts small blind 50
JeBoyDirk: posts big blind 100
*** HOLE CARDS ***
Dealt to PokerStarMan123 [Kc Jc]
color_singleton: folds 
manon327: calls 100
PokerStarMan123: raises 300 to 400
JeBoyDirk: folds 
manon327: folds 
Uncalled bet (300) returned to PokerStarMan123
PokerStarMan123 collected 300 from pot
*** SUMMARY ***
Total pot 300 | Rake 0 
Seat 1: color_singleton folded before Flop (didn't bet)
Seat 2: manon327 (button) folded before Flop
Seat 4: PokerStarMan123 (small blind) collected (300)
Seat 8: JeBoyDirk (big blind) folded before Flop



PokerStars Home Game Hand #226314967084: {DaPokaStars}  Hold'em No Limit (50/100) - 2021/04/29 17:38:18 ET
Table 'yes_sir' 9-max (Play Money) Seat #4 is the button
Seat 1: color_singleton (27153 in chips) 
Seat 2: manon327 (10884 in chips) 
Seat 4: PokerStarMan123 (10367 in chips) 
Seat 8: JeBoyDirk (11171 in chips) 
JeBoyDirk: posts small blind 50
color_singleton: posts big blind 100
*** HOLE CARDS ***
Dealt to PokerStarMan123 [6c 8h]
manon327: folds 
PokerStarMan123: folds 
JeBoyDirk: folds 
Uncalled bet (50) returned to color_singleton
color_singleton collected 100 from pot
color_singleton: doesn't show hand 
*** SUMMARY ***
Total pot 100 | Rake 0 
Seat 1: color_singleton (big blind) collected (100)
Seat 2: manon327 folded before Flop (didn't bet)
Seat 4: PokerStarMan123 (button) folded before Flop (didn't bet)
Seat 8: JeBoyDirk (small blind) folded before Flop



PokerStars Home Game Hand #226314972142: {DaPokaStars}  Hold'em No Limit (50/100) - 2021/04/29 17:38:27 ET
Table 'yes_sir' 9-max (Play Money) Seat #8 is the button
Seat 1: color_singleton (27203 in chips) 
Seat 2: manon327 (10884 in chips) 
Seat 4: PokerStarMan123 (10367 in chips) 
Seat 6: Klemtonius (10000 in chips) 
Seat 8: JeBoyDirk (11121 in chips) 
color_singleton: posts small blind 50
manon327: posts big blind 100
Klemtonius: posts small & big blinds 150
*** HOLE CARDS ***
Dealt to PokerStarMan123 [7h 7s]
PokerStarMan123: raises 300 to 400
Klemtonius: calls 300
JeBoyDirk: folds 
color_singleton: calls 350
manon327: folds 
*** FLOP *** [Jc As 8s]
color_singleton: checks 
PokerStarMan123: checks 
Klemtonius: checks 
*** TURN *** [Jc As 8s] [5s]
color_singleton: checks 
PokerStarMan123: checks 
Klemtonius: bets 638
color_singleton: folds 
PokerStarMan123: folds 
Uncalled bet (638) returned to Klemtonius
Klemtonius collected 1276 from pot
Klemtonius: doesn't show hand 
*** SUMMARY ***
Total pot 1350 | Rake 74 
Board [Jc As 8s 5s]
Seat 1: color_singleton (small blind) folded on the Turn
Seat 2: manon327 (big blind) folded before Flop
Seat 4: PokerStarMan123 folded on the Turn
Seat 6: Klemtonius collected (1276)
Seat 8: JeBoyDirk (button) folded before Flop (didn't bet)



PokerStars Home Game Hand #226314991645: {DaPokaStars}  Hold'em No Limit (50/100) - 2021/04/29 17:39:05 ET
Table 'yes_sir' 9-max (Play Money) Seat #1 is the button
Seat 1: color_singleton (26803 in chips) 
Seat 2: manon327 (10784 in chips) 
Seat 4: PokerStarMan123 (9967 in chips) 
Seat 6: Klemtonius (10826 in chips) 
Seat 8: JeBoyDirk (11121 in chips) 
manon327: posts small blind 50
PokerStarMan123: posts big blind 100
*** HOLE CARDS ***
Dealt to PokerStarMan123 [3d 6s]
Klemtonius: calls 100
JeBoyDirk: folds 
color_singleton: calls 100
manon327: folds 
PokerStarMan123: checks 
*** FLOP *** [2h Ts Jh]
PokerStarMan123: checks 
Klemtonius: checks 
color_singleton: checks 
*** TURN *** [2h Ts Jh] [7c]
PokerStarMan123: checks 
Klemtonius: bets 165
color_singleton: folds 
PokerStarMan123: folds 
Uncalled bet (165) returned to Klemtonius
Klemtonius collected 331 from pot
Klemtonius: doesn't show hand 
*** SUMMARY ***
Total pot 350 | Rake 19 
Board [2h Ts Jh 7c]
Seat 1: color_singleton (button) folded on the Turn
Seat 2: manon327 (small blind) folded before Flop
Seat 4: PokerStarMan123 (big blind) folded on the Turn
Seat 6: Klemtonius collected (331)
Seat 8: JeBoyDirk folded before Flop (didn't bet)



PokerStars Home Game Hand #226315004299: {DaPokaStars}  Hold'em No Limit (50/100) - 2021/04/29 17:39:29 ET
Table 'yes_sir' 9-max (Play Money) Seat #2 is the button
Seat 1: color_singleton (26703 in chips) 
Seat 2: manon327 (10734 in chips) 
Seat 4: PokerStarMan123 (9867 in chips) 
Seat 6: Klemtonius (11057 in chips) 
Seat 8: JeBoyDirk (11121 in chips) 
PokerStarMan123: posts small blind 50
Klemtonius: posts big blind 100
*** HOLE CARDS ***
Dealt to PokerStarMan123 [Qd 7d]
JeBoyDirk: folds 
color_singleton: folds 
manon327: folds 
PokerStarMan123: calls 50
Klemtonius: raises 100 to 200
PokerStarMan123: calls 100
*** FLOP *** [Qc Tc 4s]
PokerStarMan123: bets 300
Klemtonius: calls 300
*** TURN *** [Qc Tc 4s] [6h]
PokerStarMan123: bets 600
Klemtonius: folds 
Uncalled bet (600) returned to PokerStarMan123
PokerStarMan123 collected 945 from pot
*** SUMMARY ***
Total pot 1000 | Rake 55 
Board [Qc Tc 4s 6h]
Seat 1: color_singleton folded before Flop (didn't bet)
Seat 2: manon327 (button) folded before Flop (didn't bet)
Seat 4: PokerStarMan123 (small blind) collected (945)
Seat 6: Klemtonius (big blind) folded on the Turn
Seat 8: JeBoyDirk folded before Flop (didn't bet)



PokerStars Home Game Hand #226315018659: {DaPokaStars}  Hold'em No Limit (50/100) - 2021/04/29 17:39:56 ET
Table 'yes_sir' 9-max (Play Money) Seat #4 is the button
Seat 1: color_singleton (26703 in chips) 
Seat 2: manon327 (10734 in chips) 
Seat 4: PokerStarMan123 (10312 in chips) 
Seat 6: Klemtonius (10557 in chips) 
Seat 8: JeBoyDirk (11121 in chips) 
Klemtonius: posts small blind 50
JeBoyDirk: posts big blind 100
*** HOLE CARDS ***
Dealt to PokerStarMan123 [Ah Ks]
color_singleton: raises 200 to 300
manon327: folds 
PokerStarMan123: calls 300
Klemtonius: folds 
JeBoyDirk: calls 200
*** FLOP *** [3s 6c Kc]
JeBoyDirk: checks 
color_singleton: bets 449
PokerStarMan123: raises 449 to 898
JeBoyDirk: folds 
color_singleton: calls 449
*** TURN *** [3s 6c Kc] [Js]
color_singleton: checks 
PokerStarMan123: bets 1000
color_singleton: calls 1000
*** RIVER *** [3s 6c Kc Js] [7h]
color_singleton: checks 
PokerStarMan123: bets 1700
color_singleton: calls 1700
*** SHOW DOWN ***
PokerStarMan123: shows [Ah Ks] (a pair of Kings)
color_singleton: mucks hand 
PokerStarMan123 collected 7698 from pot
*** SUMMARY ***
Total pot 8146 | Rake 448 
Board [3s 6c Kc Js 7h]
Seat 1: color_singleton mucked [Kd Td]
Seat 2: manon327 folded before Flop (didn't bet)
Seat 4: PokerStarMan123 (button) showed [Ah Ks] and won (7698) with a pair of Kings
Seat 6: Klemtonius (small blind) folded before Flop
Seat 8: JeBoyDirk (big blind) folded on the Flop



PokerStars Home Game Hand #226315037944: {DaPokaStars}  Hold'em No Limit (50/100) - 2021/04/29 17:40:33 ET
Table 'yes_sir' 9-max (Play Money) Seat #6 is the button
Seat 1: color_singleton (22805 in chips) 
Seat 2: manon327 (10734 in chips) 
Seat 4: PokerStarMan123 (14112 in chips) 
Seat 6: Klemtonius (10507 in chips) 
Seat 8: JeBoyDirk (10821 in chips) 
JeBoyDirk: posts small blind 50
color_singleton: posts big blind 100
*** HOLE CARDS ***
Dealt to PokerStarMan123 [5c 2h]
manon327: folds 
PokerStarMan123: folds 
Klemtonius: calls 100
JeBoyDirk: calls 50
color_singleton: raises 200 to 300
Klemtonius: calls 200
JeBoyDirk: calls 200
*** FLOP *** [9h 9d 7h]
JeBoyDirk: bets 500
color_singleton: calls 500
Klemtonius: folds 
*** TURN *** [9h 9d 7h] [3s]
JeBoyDirk: bets 1000
color_singleton: raises 1000 to 2000
JeBoyDirk: raises 1000 to 3000
color_singleton: calls 1000
*** RIVER *** [9h 9d 7h 3s] [Kd]
JeBoyDirk: bets 7021 and is all-in
color_singleton: folds 
Uncalled bet (7021) returned to JeBoyDirk
JeBoyDirk collected 7465 from pot
*** SUMMARY ***
Total pot 7900 | Rake 435 
Board [9h 9d 7h 3s Kd]
Seat 1: color_singleton (big blind) folded on the River
Seat 2: manon327 folded before Flop (didn't bet)
Seat 4: PokerStarMan123 folded before Flop (didn't bet)
Seat 6: Klemtonius (button) folded on the Flop
Seat 8: JeBoyDirk (small blind) collected (7465)



PokerStars Home Game Hand #226315077467: {DaPokaStars}  Hold'em No Limit (50/100) - 2021/04/29 17:41:49 ET
Table 'yes_sir' 9-max (Play Money) Seat #8 is the button
Seat 1: color_singleton (19005 in chips) 
Seat 2: manon327 (10734 in chips) 
Seat 4: PokerStarMan123 (14112 in chips) 
Seat 6: Klemtonius (10207 in chips) 
Seat 8: JeBoyDirk (14486 in chips) 
color_singleton: posts small blind 50
manon327: posts big blind 100
*** HOLE CARDS ***
Dealt to PokerStarMan123 [6h Qc]
PokerStarMan123: folds 
Klemtonius: calls 100
JeBoyDirk: folds 
color_singleton: calls 50
manon327: checks 
*** FLOP *** [2h 5h 3h]
color_singleton: bets 141
manon327: raises 141 to 282
Klemtonius: folds 
color_singleton: calls 141
*** TURN *** [2h 5h 3h] [6d]
color_singleton: checks 
manon327: bets 816
color_singleton: folds 
Uncalled bet (816) returned to manon327
manon327 collected 816 from pot
*** SUMMARY ***
Total pot 864 | Rake 48 
Board [2h 5h 3h 6d]
Seat 1: color_singleton (small blind) folded on the Turn
Seat 2: manon327 (big blind) collected (816)
Seat 4: PokerStarMan123 folded before Flop (didn't bet)
Seat 6: Klemtonius folded on the Flop
Seat 8: JeBoyDirk (button) folded before Flop (didn't bet)



PokerStars Home Game Hand #226315100385: {DaPokaStars}  Hold'em No Limit (50/100) - 2021/04/29 17:42:33 ET
Table 'yes_sir' 9-max (Play Money) Seat #1 is the button
Seat 1: color_singleton (18623 in chips) 
Seat 2: manon327 (11168 in chips) 
Seat 4: PokerStarMan123 (14112 in chips) 
Seat 6: Klemtonius (10107 in chips) 
Seat 8: JeBoyDirk (14486 in chips) 
manon327: posts small blind 50
PokerStarMan123: posts big blind 100
*** HOLE CARDS ***
Dealt to PokerStarMan123 [2d Ad]
Klemtonius: calls 100
JeBoyDirk: calls 100
color_singleton: raises 200 to 300
manon327: calls 250
PokerStarMan123: calls 200
Klemtonius: calls 200
JeBoyDirk: calls 200
*** FLOP *** [Qh 4h 8d]
manon327: checks 
PokerStarMan123: checks 
Klemtonius: checks 
JeBoyDirk: bets 600
color_singleton: calls 600
manon327: folds 
PokerStarMan123: folds 
Klemtonius: folds 
*** TURN *** [Qh 4h 8d] [9c]
JeBoyDirk: bets 1000
color_singleton: folds 
Uncalled bet (1000) returned to JeBoyDirk
JeBoyDirk collected 2551 from pot
*** SUMMARY ***
Total pot 2700 | Rake 149 
Board [Qh 4h 8d 9c]
Seat 1: color_singleton (button) folded on the Turn
Seat 2: manon327 (small blind) folded on the Flop
Seat 4: PokerStarMan123 (big blind) folded on the Flop
Seat 6: Klemtonius folded on the Flop
Seat 8: JeBoyDirk collected (2551)



PokerStars Home Game Hand #226315131483: {DaPokaStars}  Hold'em No Limit (50/100) - 2021/04/29 17:43:34 ET
Table 'yes_sir' 9-max (Play Money) Seat #2 is the button
Seat 1: color_singleton (17723 in chips) 
Seat 2: manon327 (10868 in chips) 
Seat 4: PokerStarMan123 (13812 in chips) 
Seat 6: Klemtonius (9807 in chips) 
Seat 8: JeBoyDirk (16137 in chips) 
PokerStarMan123: posts small blind 50
Klemtonius: posts big blind 100
*** HOLE CARDS ***
Dealt to PokerStarMan123 [Jc Js]
JeBoyDirk: calls 100
color_singleton: raises 100 to 200
manon327: folds 
PokerStarMan123: raises 300 to 500
Klemtonius: folds 
JeBoyDirk: calls 400
color_singleton: calls 300
*** FLOP *** [Ts 7c 3s]
PokerStarMan123: bets 1000
JeBoyDirk: folds 
color_singleton: folds 
Uncalled bet (1000) returned to PokerStarMan123
PokerStarMan123 collected 1512 from pot
*** SUMMARY ***
Total pot 1600 | Rake 88 
Board [Ts 7c 3s]
Seat 1: color_singleton folded on the Flop
Seat 2: manon327 (button) folded before Flop (didn't bet)
Seat 4: PokerStarMan123 (small blind) collected (1512)
Seat 6: Klemtonius (big blind) folded before Flop
Seat 8: JeBoyDirk folded on the Flop



PokerStars Home Game Hand #226315145555: {DaPokaStars}  Hold'em No Limit (50/100) - 2021/04/29 17:44:01 ET
Table 'yes_sir' 9-max (Play Money) Seat #4 is the button
Seat 1: color_singleton (17223 in chips) 
Seat 2: manon327 (10868 in chips) 
Seat 4: PokerStarMan123 (14824 in chips) 
Seat 6: Klemtonius (9707 in chips) 
Seat 8: JeBoyDirk (15637 in chips) 
Klemtonius: posts small blind 50
JeBoyDirk: posts big blind 100
*** HOLE CARDS ***
Dealt to PokerStarMan123 [7c 4d]
GillesdeH leaves the table
color_singleton: folds 
manon327: calls 100
PokerStarMan123: folds 
Klemtonius: calls 50
JeBoyDirk: checks 
*** FLOP *** [Jc 7h 2s]
Klemtonius: checks 
JeBoyDirk: checks 
manon327: checks 
*** TURN *** [Jc 7h 2s] [3c]
Klemtonius: checks 
JeBoyDirk: bets 200
manon327: folds 
Klemtonius: folds 
Uncalled bet (200) returned to JeBoyDirk
JeBoyDirk collected 283 from pot
*** SUMMARY ***
Total pot 300 | Rake 17 
Board [Jc 7h 2s 3c]
Seat 1: color_singleton folded before Flop (didn't bet)
Seat 2: manon327 folded on the Turn
Seat 4: PokerStarMan123 (button) folded before Flop (didn't bet)
Seat 6: Klemtonius (small blind) folded on the Turn
Seat 8: JeBoyDirk (big blind) collected (283)



PokerStars Home Game Hand #226315162165: {DaPokaStars}  Hold'em No Limit (50/100) - 2021/04/29 17:44:33 ET
Table 'yes_sir' 9-max (Play Money) Seat #6 is the button
Seat 1: color_singleton (17223 in chips) 
Seat 2: manon327 (10768 in chips) 
Seat 4: PokerStarMan123 (14824 in chips) 
Seat 6: Klemtonius (9607 in chips) 
Seat 8: JeBoyDirk (15820 in chips) 
JeBoyDirk: posts small blind 50
color_singleton: posts big blind 100
*** HOLE CARDS ***
Dealt to PokerStarMan123 [3s 2d]
manon327: folds 
PokerStarMan123: folds 
Klemtonius: calls 100
JeBoyDirk: calls 50
color_singleton: checks 
*** FLOP *** [7d 8d 7s]
JeBoyDirk: checks 
color_singleton: bets 283
Klemtonius: calls 283
JeBoyDirk: folds 
*** TURN *** [7d 8d 7s] [Kh]
color_singleton: checks 
Klemtonius: checks 
*** RIVER *** [7d 8d 7s Kh] [4d]
color_singleton: bets 818
Klemtonius: raises 818 to 1636
color_singleton: calls 818
*** SHOW DOWN ***
Klemtonius: shows [Kd 7h] (a full house, Sevens full of Kings)
color_singleton: mucks hand 
Klemtonius collected 3910 from pot
*** SUMMARY ***
Total pot 4138 | Rake 228 
Board [7d 8d 7s Kh 4d]
Seat 1: color_singleton (big blind) mucked [8c Ks]
Seat 2: manon327 folded before Flop (didn't bet)
Seat 4: PokerStarMan123 folded before Flop (didn't bet)
Seat 6: Klemtonius (button) showed [Kd 7h] and won (3910) with a full house, Sevens full of Kings
Seat 8: JeBoyDirk (small blind) folded on the Flop



PokerStars Home Game Hand #226315184622: {DaPokaStars}  Hold'em No Limit (50/100) - 2021/04/29 17:45:17 ET
Table 'yes_sir' 9-max (Play Money) Seat #8 is the button
Seat 1: color_singleton (15204 in chips) 
Seat 2: manon327 (10768 in chips) 
Seat 4: PokerStarMan123 (14824 in chips) 
Seat 6: Klemtonius (11498 in chips) 
Seat 8: JeBoyDirk (15720 in chips) 
color_singleton: posts small blind 50
manon327: posts big blind 100
*** HOLE CARDS ***
Dealt to PokerStarMan123 [Qc 5s]
PokerStarMan123: folds 
Klemtonius: raises 100 to 200
JeBoyDirk: calls 200
color_singleton: calls 150
manon327: calls 100
*** FLOP *** [7d Jc 2s]
color_singleton: checks 
manon327: checks 
Klemtonius: checks 
JeBoyDirk: checks 
*** TURN *** [7d Jc 2s] [8c]
color_singleton: checks 
manon327: checks 
Klemtonius: checks 
JeBoyDirk: bets 500
color_singleton: folds 
manon327: folds 
Klemtonius: folds 
Uncalled bet (500) returned to JeBoyDirk
JeBoyDirk collected 756 from pot
*** SUMMARY ***
Total pot 800 | Rake 44 
Board [7d Jc 2s 8c]
Seat 1: color_singleton (small blind) folded on the Turn
Seat 2: manon327 (big blind) folded on the Turn
Seat 4: PokerStarMan123 folded before Flop (didn't bet)
Seat 6: Klemtonius folded on the Turn
Seat 8: JeBoyDirk (button) collected (756)



PokerStars Home Game Hand #226315207072: {DaPokaStars}  Hold'em No Limit (50/100) - 2021/04/29 17:46:00 ET
Table 'yes_sir' 9-max (Play Money) Seat #1 is the button
Seat 1: color_singleton (15004 in chips) 
Seat 2: manon327 (10568 in chips) 
Seat 4: PokerStarMan123 (14824 in chips) 
Seat 6: Klemtonius (11298 in chips) 
Seat 8: JeBoyDirk (16276 in chips) 
manon327: posts small blind 50
PokerStarMan123: posts big blind 100
*** HOLE CARDS ***
Dealt to PokerStarMan123 [3d 8d]
Klemtonius: calls 100
JeBoyDirk: folds 
color_singleton has timed out
color_singleton: folds 
manon327: calls 50
PokerStarMan123: checks 
*** FLOP *** [4s 9h Qs]
manon327: checks 
PokerStarMan123: checks 
Klemtonius: checks 
*** TURN *** [4s 9h Qs] [8c]
manon327: bets 141
PokerStarMan123: calls 141
Klemtonius: folds 
*** RIVER *** [4s 9h Qs 8c] [4c]
manon327: bets 275
PokerStarMan123: calls 275
*** SHOW DOWN ***
manon327: shows [9c 8h] (two pair, Nines and Eights)
PokerStarMan123: mucks hand 
manon327 collected 1070 from pot
*** SUMMARY ***
Total pot 1132 | Rake 62 
Board [4s 9h Qs 8c 4c]
Seat 1: color_singleton (button) folded before Flop (didn't bet)
Seat 2: manon327 (small blind) showed [9c 8h] and won (1070) with two pair, Nines and Eights
Seat 4: PokerStarMan123 (big blind) mucked [3d 8d]
Seat 6: Klemtonius folded on the Turn
Seat 8: JeBoyDirk folded before Flop (didn't bet)



PokerStars Home Game Hand #226315232299: {DaPokaStars}  Hold'em No Limit (50/100) - 2021/04/29 17:46:49 ET
Table 'yes_sir' 9-max (Play Money) Seat #2 is the button
Seat 2: manon327 (11122 in chips) 
Seat 4: PokerStarMan123 (14308 in chips) 
Seat 6: Klemtonius (11198 in chips) 
Seat 8: JeBoyDirk (16276 in chips) 
PokerStarMan123: posts small blind 50
Klemtonius: posts big blind 100
*** HOLE CARDS ***
Dealt to PokerStarMan123 [7s 8c]
JeBoyDirk: calls 100
manon327: calls 100
PokerStarMan123: calls 50
Klemtonius: raises 400 to 500
JeBoyDirk: folds 
manon327: folds 
PokerStarMan123: folds 
Uncalled bet (400) returned to Klemtonius
Klemtonius collected 400 from pot
Klemtonius: doesn't show hand 
*** SUMMARY ***
Total pot 400 | Rake 0 
Seat 2: manon327 (button) folded before Flop
Seat 4: PokerStarMan123 (small blind) folded before Flop
Seat 6: Klemtonius (big blind) collected (400)
Seat 8: JeBoyDirk folded before Flop



PokerStars Home Game Hand #226315248782: {DaPokaStars}  Hold'em No Limit (50/100) - 2021/04/29 17:47:21 ET
Table 'yes_sir' 9-max (Play Money) Seat #4 is the button
Seat 2: manon327 (11022 in chips) 
Seat 4: PokerStarMan123 (14208 in chips) 
Seat 6: Klemtonius (11498 in chips) 
Seat 8: JeBoyDirk (16176 in chips) 
Klemtonius: posts small blind 50
JeBoyDirk: posts big blind 100
*** HOLE CARDS ***
Dealt to PokerStarMan123 [As 3h]
manon327: calls 100
PokerStarMan123: calls 100
Klemtonius: calls 50
JeBoyDirk: checks 
*** FLOP *** [7s 6c 5s]
Klemtonius: checks 
JeBoyDirk: checks 
manon327: checks 
PokerStarMan123: checks 
*** TURN *** [7s 6c 5s] [Jd]
Klemtonius: bets 189
JeBoyDirk: calls 189
manon327: calls 189
PokerStarMan123: folds 
*** RIVER *** [7s 6c 5s Jd] [Ts]
Klemtonius: checks 
JeBoyDirk: checks 
manon327: bets 914
Klemtonius: calls 914
JeBoyDirk: folds 
*** SHOW DOWN ***
manon327: shows [Qs 8c] (high card Queen)
Klemtonius: shows [Tc 4d] (a pair of Tens)
Klemtonius collected 2641 from pot
*** SUMMARY ***
Total pot 2795 | Rake 154 
Board [7s 6c 5s Jd Ts]
Seat 2: manon327 showed [Qs 8c] and lost with high card Queen
Seat 4: PokerStarMan123 (button) folded on the Turn
Seat 6: Klemtonius (small blind) showed [Tc 4d] and won (2641) with a pair of Tens
Seat 8: JeBoyDirk (big blind) folded on the River



PokerStars Home Game Hand #226315269472: {DaPokaStars}  Hold'em No Limit (50/100) - 2021/04/29 17:48:02 ET
Table 'yes_sir' 9-max (Play Money) Seat #6 is the button
Seat 1: color_singleton (15004 in chips) 
Seat 2: manon327 (9819 in chips) 
Seat 4: PokerStarMan123 (14108 in chips) 
Seat 6: Klemtonius (12936 in chips) 
Seat 8: JeBoyDirk (15887 in chips) 
JeBoyDirk: posts small blind 50
color_singleton: posts big blind 100
*** HOLE CARDS ***
Dealt to PokerStarMan123 [6s 3h]
manon327: folds 
PokerStarMan123: folds 
Klemtonius: calls 100
JeBoyDirk: calls 50
color_singleton: raises 300 to 400
Klemtonius: calls 300
JeBoyDirk: calls 300
*** FLOP *** [Qc Qh 4h]
JeBoyDirk: checks 
color_singleton: checks 
Klemtonius: checks 
*** TURN *** [Qc Qh 4h] [Td]
JeBoyDirk: bets 500
color_singleton: calls 500
Klemtonius: folds 
*** RIVER *** [Qc Qh 4h Td] [Kd]
JeBoyDirk: bets 1100
color_singleton: calls 1100
*** SHOW DOWN ***
JeBoyDirk: shows [9h Jh] (a straight, Nine to King)
color_singleton: mucks hand 
JeBoyDirk collected 4158 from pot
*** SUMMARY ***
Total pot 4400 | Rake 242 
Board [Qc Qh 4h Td Kd]
Seat 1: color_singleton (big blind) mucked [Ad Ah]
Seat 2: manon327 folded before Flop (didn't bet)
Seat 4: PokerStarMan123 folded before Flop (didn't bet)
Seat 6: Klemtonius (button) folded on the Turn
Seat 8: JeBoyDirk (small blind) showed [9h Jh] and won (4158) with a straight, Nine to King



PokerStars Home Game Hand #226315296287: {DaPokaStars}  Hold'em No Limit (50/100) - 2021/04/29 17:48:54 ET
Table 'yes_sir' 9-max (Play Money) Seat #8 is the button
Seat 1: color_singleton (13004 in chips) 
Seat 2: manon327 (9819 in chips) 
Seat 4: PokerStarMan123 (14108 in chips) 
Seat 6: Klemtonius (12536 in chips) 
Seat 8: JeBoyDirk (18045 in chips) 
color_singleton: posts small blind 50
manon327: posts big blind 100
*** HOLE CARDS ***
Dealt to PokerStarMan123 [Ad Qc]
PokerStarMan123: raises 300 to 400
Klemtonius: calls 400
JeBoyDirk: folds 
color_singleton: folds 
manon327: calls 300
*** FLOP *** [3d 4c Kh]
manon327: bets 590
PokerStarMan123: folds 
dockstarrr joins the table at seat #3 
Klemtonius: calls 590
*** TURN *** [3d 4c Kh] [8d]
manon327: checks 
Klemtonius: checks 
*** RIVER *** [3d 4c Kh 8d] [8s]
manon327: checks 
Klemtonius: checks 
*** SHOW DOWN ***
manon327: shows [Ks 7c] (two pair, Kings and Eights)
Klemtonius: mucks hand 
manon327 collected 2296 from pot
*** SUMMARY ***
Total pot 2430 | Rake 134 
Board [3d 4c Kh 8d 8s]
Seat 1: color_singleton (small blind) folded before Flop
Seat 2: manon327 (big blind) showed [Ks 7c] and won (2296) with two pair, Kings and Eights
Seat 4: PokerStarMan123 folded on the Flop
Seat 6: Klemtonius mucked [Ah 3c]
Seat 8: JeBoyDirk (button) folded before Flop (didn't bet)



PokerStars Home Game Hand #226315326139: {DaPokaStars}  Hold'em No Limit (50/100) - 2021/04/29 17:49:53 ET
Table 'yes_sir' 9-max (Play Money) Seat #1 is the button
Seat 1: color_singleton (12954 in chips) 
Seat 2: manon327 (11125 in chips) 
Seat 3: dockstarrr (10000 in chips) 
Seat 4: PokerStarMan123 (13708 in chips) 
Seat 6: Klemtonius (11546 in chips) 
Seat 8: JeBoyDirk (18045 in chips) 
manon327: posts small blind 50
dockstarrr: posts big blind 100
*** HOLE CARDS ***
Dealt to PokerStarMan123 [6s Jd]
PokerStarMan123: folds 
Klemtonius: calls 100
JeBoyDirk: calls 100
color_singleton: folds 
manon327: calls 50
dockstarrr: folds 
*** FLOP *** [4d 3c 4c]
dockstarrr leaves the table
manon327 has timed out
manon327: checks 
Klemtonius: checks 
JeBoyDirk: checks 
*** TURN *** [4d 3c 4c] [7h]
manon327 has timed out
manon327: checks 
Klemtonius: checks 
JeBoyDirk: checks 
*** RIVER *** [4d 3c 4c 7h] [2d]
manon327: checks 
Klemtonius: bets 189
JeBoyDirk: calls 189
manon327: calls 189
*** SHOW DOWN ***
Klemtonius: shows [Ks 8h] (a pair of Fours)
JeBoyDirk: shows [7d Ac] (two pair, Sevens and Fours)
manon327: mucks hand 
JeBoyDirk collected 914 from pot
*** SUMMARY ***
Total pot 967 | Rake 53 
Board [4d 3c 4c 7h 2d]
Seat 1: color_singleton (button) folded before Flop (didn't bet)
Seat 2: manon327 (small blind) mucked [Qd 2s]
Seat 3: dockstarrr (big blind) folded before Flop
Seat 4: PokerStarMan123 folded before Flop (didn't bet)
Seat 6: Klemtonius showed [Ks 8h] and lost with a pair of Fours
Seat 8: JeBoyDirk showed [7d Ac] and won (914) with two pair, Sevens and Fours



PokerStars Home Game Hand #226315366274: {DaPokaStars}  Hold'em No Limit (50/100) - 2021/04/29 17:51:12 ET
Table 'yes_sir' 9-max (Play Money) Seat #2 is the button
Seat 1: color_singleton (12954 in chips) 
Seat 2: manon327 (10836 in chips) 
Seat 4: PokerStarMan123 (13708 in chips) 
Seat 6: Klemtonius (11257 in chips) 
Seat 8: JeBoyDirk (18670 in chips) 
PokerStarMan123: posts small blind 50
Klemtonius: posts big blind 100
*** HOLE CARDS ***
Dealt to PokerStarMan123 [6d 5h]
dockstarrr joins the table at seat #9 
JeBoyDirk: folds 
color_singleton: raises 200 to 300
manon327: calls 300
PokerStarMan123: folds 
Klemtonius: calls 200
*** FLOP *** [7c 9s Ks]
Klemtonius: bets 898
color_singleton: folds 
manon327: folds 
Uncalled bet (898) returned to Klemtonius
Klemtonius collected 898 from pot
Klemtonius: doesn't show hand 
*** SUMMARY ***
Total pot 950 | Rake 52 
Board [7c 9s Ks]
Seat 1: color_singleton folded on the Flop
Seat 2: manon327 (button) folded on the Flop
Seat 4: PokerStarMan123 (small blind) folded before Flop
Seat 6: Klemtonius (big blind) collected (898)
Seat 8: JeBoyDirk folded before Flop (didn't bet)



PokerStars Home Game Hand #226315389483: {DaPokaStars}  Hold'em No Limit (50/100) - 2021/04/29 17:51:59 ET
Table 'yes_sir' 9-max (Play Money) Seat #4 is the button
Seat 1: color_singleton (12654 in chips) 
Seat 2: manon327 (10536 in chips) 
Seat 4: PokerStarMan123 (13658 in chips) 
Seat 6: Klemtonius (11855 in chips) 
Seat 8: JeBoyDirk (18670 in chips) 
Seat 9: dockstarrr (10000 in chips) 
Klemtonius: posts small blind 50
JeBoyDirk: posts big blind 100
dockstarrr: posts big blind 100
*** HOLE CARDS ***
Dealt to PokerStarMan123 [8s Kc]
dockstarrr: checks 
color_singleton: raises 300 to 400
manon327: folds 
PokerStarMan123: folds 
Klemtonius: folds 
JeBoyDirk: calls 300
dockstarrr: folds 
*** FLOP *** [Qc Ac 5s]
JeBoyDirk: checks 
color_singleton: bets 449
JeBoyDirk: calls 449
*** TURN *** [Qc Ac 5s] [7h]
JeBoyDirk: checks 
color_singleton: checks 
*** RIVER *** [Qc Ac 5s 7h] [6h]
JeBoyDirk: checks 
color_singleton: checks 
*** SHOW DOWN ***
JeBoyDirk: shows [2s Ad] (a pair of Aces)
color_singleton: mucks hand 
JeBoyDirk collected 1746 from pot
*** SUMMARY ***
Total pot 1848 | Rake 102 
Board [Qc Ac 5s 7h 6h]
Seat 1: color_singleton mucked [Td Js]
Seat 2: manon327 folded before Flop (didn't bet)
Seat 4: PokerStarMan123 (button) folded before Flop (didn't bet)
Seat 6: Klemtonius (small blind) folded before Flop
Seat 8: JeBoyDirk (big blind) showed [2s Ad] and won (1746) with a pair of Aces
Seat 9: dockstarrr folded before Flop (didn't bet)



PokerStars Home Game Hand #226315411338: {DaPokaStars}  Hold'em No Limit (50/100) - 2021/04/29 17:52:42 ET
Table 'yes_sir' 9-max (Play Money) Seat #6 is the button
Seat 1: color_singleton (11805 in chips) 
Seat 2: manon327 (10536 in chips) 
Seat 4: PokerStarMan123 (13658 in chips) 
Seat 6: Klemtonius (11805 in chips) 
Seat 8: JeBoyDirk (19567 in chips) 
Seat 9: dockstarrr (9900 in chips) 
JeBoyDirk: posts small blind 50
dockstarrr: posts big blind 100
*** HOLE CARDS ***
Dealt to PokerStarMan123 [Kc 5s]
color_singleton: folds 
manon327: calls 100
PokerStarMan123: folds 
Klemtonius: raises 100 to 200
JeBoyDirk: folds 
dockstarrr: folds 
manon327: calls 100
*** FLOP *** [5c Qc 9d]
manon327: bets 260
Klemtonius: calls 260
*** TURN *** [5c Qc 9d] [6d]
manon327: bets 505
Klemtonius: folds 
Uncalled bet (505) returned to manon327
manon327 collected 1011 from pot
*** SUMMARY ***
Total pot 1070 | Rake 59 
Board [5c Qc 9d 6d]
Seat 1: color_singleton folded before Flop (didn't bet)
Seat 2: manon327 collected (1011)
Seat 4: PokerStarMan123 folded before Flop (didn't bet)
Seat 6: Klemtonius (button) folded on the Turn
Seat 8: JeBoyDirk (small blind) folded before Flop
Seat 9: dockstarrr (big blind) folded before Flop



PokerStars Home Game Hand #226315438320: {DaPokaStars}  Hold'em No Limit (50/100) - 2021/04/29 17:53:37 ET
Table 'yes_sir' 9-max (Play Money) Seat #8 is the button
Seat 1: color_singleton (11805 in chips) 
Seat 2: manon327 (11087 in chips) 
Seat 4: PokerStarMan123 (13658 in chips) 
Seat 6: Klemtonius (11345 in chips) 
Seat 8: JeBoyDirk (19517 in chips) 
Seat 9: dockstarrr (9800 in chips) 
dockstarrr: posts small blind 50
color_singleton: posts big blind 100
*** HOLE CARDS ***
Dealt to PokerStarMan123 [3h Tc]
manon327: calls 100
PokerStarMan123: folds 
Klemtonius: calls 100
JeBoyDirk: calls 100
dockstarrr: calls 50
color_singleton: checks 
*** FLOP *** [4h 5h 6h]
dockstarrr: checks 
color_singleton: checks 
manon327: checks 
Klemtonius: checks 
JeBoyDirk: checks 
*** TURN *** [4h 5h 6h] [3c]
dockstarrr: checks 
color_singleton: checks 
manon327: checks 
Klemtonius: bets 100
JeBoyDirk: calls 100
dockstarrr: calls 100
color_singleton: calls 100
manon327: folds 
*** RIVER *** [4h 5h 6h 3c] [Ah]
dockstarrr: bets 425
color_singleton: calls 425
Klemtonius: folds 
JeBoyDirk: calls 425
*** SHOW DOWN ***
dockstarrr: shows [Kh 5s] (a flush, Ace high)
color_singleton: mucks hand 
JeBoyDirk: mucks hand 
dockstarrr collected 2055 from pot
*** SUMMARY ***
Total pot 2175 | Rake 120 
Board [4h 5h 6h 3c Ah]
Seat 1: color_singleton (big blind) mucked [Jh Qd]
Seat 2: manon327 folded on the Turn
Seat 4: PokerStarMan123 folded before Flop (didn't bet)
Seat 6: Klemtonius folded on the River
Seat 8: JeBoyDirk (button) mucked [As 2c]
Seat 9: dockstarrr (small blind) showed [Kh 5s] and won (2055) with a flush, Ace high



PokerStars Home Game Hand #226315483009: {DaPokaStars}  Hold'em No Limit (50/100) - 2021/04/29 17:55:08 ET
Table 'yes_sir' 9-max (Play Money) Seat #9 is the button
Seat 1: color_singleton (11180 in chips) 
Seat 2: manon327 (10987 in chips) 
Seat 4: PokerStarMan123 (13658 in chips) 
Seat 6: Klemtonius (11145 in chips) 
Seat 8: JeBoyDirk (18892 in chips) 
Seat 9: dockstarrr (11230 in chips) 
color_singleton: posts small blind 50
manon327: posts big blind 100
*** HOLE CARDS ***
Dealt to PokerStarMan123 [6c As]
PokerStarMan123: calls 100
Klemtonius: calls 100
JeBoyDirk: folds 
dockstarrr: folds 
color_singleton: folds 
manon327: checks 
*** FLOP *** [3c Tc 6h]
manon327: checks 
PokerStarMan123: checks 
Klemtonius: bets 100
manon327: calls 100
PokerStarMan123: calls 100
*** TURN *** [3c Tc 6h] [Ks]
manon327: bets 307
PokerStarMan123: folds 
Klemtonius: calls 307
*** RIVER *** [3c Tc 6h Ks] [7h]
manon327: bets 1194
Klemtonius: folds 
Uncalled bet (1194) returned to manon327
manon327 collected 1194 from pot
*** SUMMARY ***
Total pot 1264 | Rake 70 
Board [3c Tc 6h Ks 7h]
Seat 1: color_singleton (small blind) folded before Flop
Seat 2: manon327 (big blind) collected (1194)
Seat 4: PokerStarMan123 folded on the Turn
Seat 6: Klemtonius folded on the River
Seat 8: JeBoyDirk folded before Flop (didn't bet)
Seat 9: dockstarrr (button) folded before Flop (didn't bet)



PokerStars Home Game Hand #226315509375: {DaPokaStars}  Hold'em No Limit (50/100) - 2021/04/29 17:56:18 ET
Table 'yes_sir' 9-max (Play Money) Seat #1 is the button
Seat 1: color_singleton (11130 in chips) 
Seat 2: manon327 (11674 in chips) 
Seat 4: PokerStarMan123 (13458 in chips) 
Seat 6: Klemtonius (10638 in chips) 
Seat 8: JeBoyDirk (18892 in chips) 
Seat 9: dockstarrr (11230 in chips) 
manon327: posts small blind 50
PokerStarMan123: posts big blind 100
*** HOLE CARDS ***
Dealt to PokerStarMan123 [5d 8c]
Klemtonius: calls 100
JeBoyDirk: folds 
dockstarrr: calls 100
color_singleton: folds 
manon327: calls 50
PokerStarMan123: checks 
*** FLOP *** [4d Ad 5c]
manon327: bets 189
PokerStarMan123: calls 189
Klemtonius: folds 
dockstarrr: folds 
*** TURN *** [4d Ad 5c] [Jd]
manon327: bets 367
PokerStarMan123: folds 
Uncalled bet (367) returned to manon327
manon327 collected 735 from pot
*** SUMMARY ***
Total pot 778 | Rake 43 
Board [4d Ad 5c Jd]
Seat 1: color_singleton (button) folded before Flop (didn't bet)
Seat 2: manon327 (small blind) collected (735)
Seat 4: PokerStarMan123 (big blind) folded on the Turn
Seat 6: Klemtonius folded on the Flop
Seat 8: JeBoyDirk folded before Flop (didn't bet)
Seat 9: dockstarrr folded on the Flop



PokerStars Home Game Hand #226315539500: {DaPokaStars}  Hold'em No Limit (50/100) - 2021/04/29 17:57:24 ET
Table 'yes_sir' 9-max (Play Money) Seat #2 is the button
Seat 1: color_singleton (11130 in chips) 
Seat 2: manon327 (12120 in chips) 
Seat 4: PokerStarMan123 (13169 in chips) 
Seat 6: Klemtonius (10538 in chips) 
Seat 8: JeBoyDirk (18892 in chips) 
Seat 9: dockstarrr (11130 in chips) 
PokerStarMan123: posts small blind 50
Klemtonius: posts big blind 100
*** HOLE CARDS ***
Dealt to PokerStarMan123 [4d 4c]
JeBoyDirk: folds 
dockstarrr: folds 
color_singleton: folds 
manon327: calls 100
PokerStarMan123: raises 200 to 300
Klemtonius is disconnected 
Klemtonius has timed out while disconnected
Klemtonius: folds 
manon327: calls 200
*** FLOP *** [6s 8s 5h]
PokerStarMan123: bets 400
manon327: folds 
Uncalled bet (400) returned to PokerStarMan123
PokerStarMan123 collected 661 from pot
*** SUMMARY ***
Total pot 700 | Rake 39 
Board [6s 8s 5h]
Seat 1: color_singleton folded before Flop (didn't bet)
Seat 2: manon327 (button) folded on the Flop
Seat 4: PokerStarMan123 (small blind) collected (661)
Seat 6: Klemtonius (big blind) folded before Flop
Seat 8: JeBoyDirk folded before Flop (didn't bet)
Seat 9: dockstarrr folded before Flop (didn't bet)



PokerStars Home Game Hand #226315561187: {DaPokaStars}  Hold'em No Limit (50/100) - 2021/04/29 17:58:06 ET
Table 'yes_sir' 9-max (Play Money) Seat #4 is the button
Seat 1: color_singleton (11130 in chips) 
Seat 2: manon327 (11820 in chips) 
Seat 4: PokerStarMan123 (13530 in chips) 
Seat 8: JeBoyDirk (18892 in chips) 
Seat 9: dockstarrr (11130 in chips) 
JeBoyDirk: posts small blind 50
dockstarrr: posts big blind 100
*** HOLE CARDS ***
Dealt to PokerStarMan123 [Kc 4s]
color_singleton: folds 
manon327: calls 100
PokerStarMan123: folds 
JeBoyDirk: calls 50
dockstarrr: checks 
*** FLOP *** [4h 5h 2s]
JeBoyDirk: checks 
dockstarrr: bets 100
manon327: folds 
JeBoyDirk: calls 100
*** TURN *** [4h 5h 2s] [Ad]
JeBoyDirk: checks 
dockstarrr: bets 236
JeBoyDirk: folds 
Uncalled bet (236) returned to dockstarrr
dockstarrr collected 472 from pot
dockstarrr: doesn't show hand 
*** SUMMARY ***
Total pot 500 | Rake 28 
Board [4h 5h 2s Ad]
Seat 1: color_singleton folded before Flop (didn't bet)
Seat 2: manon327 folded on the Flop
Seat 4: PokerStarMan123 (button) folded before Flop (didn't bet)
Seat 8: JeBoyDirk (small blind) folded on the Turn
Seat 9: dockstarrr (big blind) collected (472)



PokerStars Home Game Hand #226315572018: {DaPokaStars}  Hold'em No Limit (50/100) - 2021/04/29 17:58:34 ET
Table 'yes_sir' 9-max (Play Money) Seat #8 is the button
Seat 1: color_singleton (11130 in chips) 
Seat 2: manon327 (11720 in chips) 
Seat 4: PokerStarMan123 (13530 in chips) 
Seat 8: JeBoyDirk (18692 in chips) 
Seat 9: dockstarrr (11402 in chips) 
dockstarrr: posts small blind 50
color_singleton: posts big blind 100
*** HOLE CARDS ***
Dealt to PokerStarMan123 [Ts 4h]
manon327: calls 100
PokerStarMan123: folds 
JeBoyDirk: calls 100
dockstarrr: calls 50
color_singleton: raises 200 to 300
manon327: calls 200
JeBoyDirk: calls 200
dockstarrr: folds 
*** FLOP *** [Kh 3d 5c]
color_singleton: bets 472
manon327: folds 
JeBoyDirk: folds 
Uncalled bet (472) returned to color_singleton
color_singleton collected 945 from pot
color_singleton: doesn't show hand 
*** SUMMARY ***
Total pot 1000 | Rake 55 
Board [Kh 3d 5c]
Seat 1: color_singleton (big blind) collected (945)
Seat 2: manon327 folded on the Flop
Seat 4: PokerStarMan123 folded before Flop (didn't bet)
Seat 8: JeBoyDirk (button) folded on the Flop
Seat 9: dockstarrr (small blind) folded before Flop



PokerStars Home Game Hand #226315584281: {DaPokaStars}  Hold'em No Limit (50/100) - 2021/04/29 17:59:06 ET
Table 'yes_sir' 9-max (Play Money) Seat #9 is the button
Seat 1: color_singleton (11775 in chips) 
Seat 2: manon327 (11420 in chips) 
Seat 4: PokerStarMan123 (13530 in chips) 
Seat 8: JeBoyDirk (18392 in chips) 
Seat 9: dockstarrr (11302 in chips) 
color_singleton: posts small blind 50
manon327: posts big blind 100
*** HOLE CARDS ***
Dealt to PokerStarMan123 [3s 6h]
PokerStarMan123: folds 
JeBoyDirk: folds 
dockstarrr: folds 
color_singleton: calls 50
manon327: checks 
*** FLOP *** [3d Kd Td]
color_singleton: bets 100
manon327: calls 100
*** TURN *** [3d Kd Td] [6d]
color_singleton: bets 378
manon327: folds 
Uncalled bet (378) returned to color_singleton
color_singleton collected 378 from pot
color_singleton: doesn't show hand 
*** SUMMARY ***
Total pot 400 | Rake 22 
Board [3d Kd Td 6d]
Seat 1: color_singleton (small blind) collected (378)
Seat 2: manon327 (big blind) folded on the Turn
Seat 4: PokerStarMan123 folded before Flop (didn't bet)
Seat 8: JeBoyDirk folded before Flop (didn't bet)
Seat 9: dockstarrr (button) folded before Flop (didn't bet)



PokerStars Home Game Hand #226315592533: {DaPokaStars}  Hold'em No Limit (50/100) - 2021/04/29 17:59:27 ET
Table 'yes_sir' 9-max (Play Money) Seat #1 is the button
Seat 1: color_singleton (11953 in chips) 
Seat 2: manon327 (11220 in chips) 
Seat 4: PokerStarMan123 (13530 in chips) 
Seat 6: Klemtonius (10438 in chips) 
Seat 8: JeBoyDirk (18392 in chips) 
Seat 9: dockstarrr (11302 in chips) 
manon327: posts small blind 50
PokerStarMan123: posts big blind 100
Klemtonius: posts small blind 50
*** HOLE CARDS ***
Dealt to PokerStarMan123 [Jc Tc]
Klemtonius: calls 100
JeBoyDirk: folds 
dockstarrr: folds 
color_singleton: raises 300 to 400
manon327: calls 350
PokerStarMan123: calls 300
Klemtonius: calls 300
*** FLOP *** [9d Ac 6d]
manon327: checks 
PokerStarMan123: checks 
Klemtonius: bets 100
color_singleton: raises 879 to 979
manon327: folds 
PokerStarMan123: folds 
Klemtonius: folds 
Uncalled bet (879) returned to color_singleton
color_singleton collected 1748 from pot
color_singleton: doesn't show hand 
*** SUMMARY ***
Total pot 1850 | Rake 102 
Board [9d Ac 6d]
Seat 1: color_singleton (button) collected (1748)
Seat 2: manon327 (small blind) folded on the Flop
Seat 4: PokerStarMan123 (big blind) folded on the Flop
Seat 6: Klemtonius folded on the Flop
Seat 8: JeBoyDirk folded before Flop (didn't bet)
Seat 9: dockstarrr folded before Flop (didn't bet)



PokerStars Home Game Hand #226315615879: {DaPokaStars}  Hold'em No Limit (50/100) - 2021/04/29 18:00:26 ET
Table 'yes_sir' 9-max (Play Money) Seat #2 is the button
Seat 1: color_singleton (13201 in chips) 
Seat 2: manon327 (10820 in chips) 
Seat 4: PokerStarMan123 (13130 in chips) 
Seat 6: Klemtonius (9888 in chips) 
Seat 8: JeBoyDirk (18392 in chips) 
Seat 9: dockstarrr (11302 in chips) 
PokerStarMan123: posts small blind 50
Klemtonius: posts big blind 100
*** HOLE CARDS ***
Dealt to PokerStarMan123 [9c 6h]
JeBoyDirk: calls 100
dockstarrr: folds 
color_singleton: raises 200 to 300
manon327: calls 300
PokerStarMan123: folds 
Klemtonius: calls 200
JeBoyDirk: calls 200
*** FLOP *** [Qh Tc Ac]
Klemtonius: checks 
JeBoyDirk: bets 500
color_singleton: calls 500
manon327: folds 
Klemtonius: calls 500
*** TURN *** [Qh Tc Ac] [2d]
Klemtonius: checks 
JeBoyDirk: checks 
color_singleton: checks 
*** RIVER *** [Qh Tc Ac 2d] [6d]
Klemtonius: checks 
JeBoyDirk: checks 
color_singleton: checks 
*** SHOW DOWN ***
Klemtonius: shows [7h 9h] (high card Ace)
JeBoyDirk: shows [8d Ah] (a pair of Aces)
color_singleton: mucks hand 
JeBoyDirk collected 2599 from pot
*** SUMMARY ***
Total pot 2750 | Rake 151 
Board [Qh Tc Ac 2d 6d]
Seat 1: color_singleton mucked [7c Kd]
Seat 2: manon327 (button) folded on the Flop
Seat 4: PokerStarMan123 (small blind) folded before Flop
Seat 6: Klemtonius (big blind) showed [7h 9h] and lost with high card Ace
Seat 8: JeBoyDirk showed [8d Ah] and won (2599) with a pair of Aces
Seat 9: dockstarrr folded before Flop (didn't bet)



PokerStars Home Game Hand #226315645470: {DaPokaStars}  Hold'em No Limit (50/100) - 2021/04/29 18:01:32 ET
Table 'yes_sir' 9-max (Play Money) Seat #4 is the button
Seat 1: color_singleton (12401 in chips) 
Seat 2: manon327 (10520 in chips) 
Seat 4: PokerStarMan123 (13080 in chips) 
Seat 6: Klemtonius (9088 in chips) 
Seat 8: JeBoyDirk (20191 in chips) 
Seat 9: dockstarrr (11302 in chips) 
Klemtonius: posts small blind 50
JeBoyDirk: posts big blind 100
*** HOLE CARDS ***
Dealt to PokerStarMan123 [Ah 4s]
dockstarrr: folds 
color_singleton: raises 200 to 300
manon327: folds 
PokerStarMan123: calls 300
Klemtonius: calls 250
JeBoyDirk: calls 200
*** FLOP *** [Td Jc Kh]
Klemtonius: checks 
JeBoyDirk: checks 
color_singleton: bets 1134
PokerStarMan123: folds 
Klemtonius: folds 
JeBoyDirk: folds 
Uncalled bet (1134) returned to color_singleton
color_singleton collected 1134 from pot
color_singleton: doesn't show hand 
*** SUMMARY ***
Total pot 1200 | Rake 66 
Board [Td Jc Kh]
Seat 1: color_singleton collected (1134)
Seat 2: manon327 folded before Flop (didn't bet)
Seat 4: PokerStarMan123 (button) folded on the Flop
Seat 6: Klemtonius (small blind) folded on the Flop
Seat 8: JeBoyDirk (big blind) folded on the Flop
Seat 9: dockstarrr folded before Flop (didn't bet)



PokerStars Home Game Hand #226315660360: {DaPokaStars}  Hold'em No Limit (50/100) - 2021/04/29 18:02:03 ET
Table 'yes_sir' 9-max (Play Money) Seat #6 is the button
Seat 1: color_singleton (13235 in chips) 
Seat 2: manon327 (10520 in chips) 
Seat 4: PokerStarMan123 (12780 in chips) 
Seat 6: Klemtonius (8788 in chips) 
Seat 8: JeBoyDirk (19891 in chips) 
Seat 9: dockstarrr (11302 in chips) 
JeBoyDirk: posts small blind 50
dockstarrr: posts big blind 100
*** HOLE CARDS ***
Dealt to PokerStarMan123 [Ts Td]
color_singleton: folds 
manon327: calls 100
PokerStarMan123: raises 400 to 500
Klemtonius: calls 500
JeBoyDirk: calls 450
dockstarrr: folds 
manon327: folds 
*** FLOP *** [9s 6h 9c]
JeBoyDirk: checks 
PokerStarMan123: bets 1000
Klemtonius: calls 1000
JeBoyDirk: folds 
*** TURN *** [9s 6h 9c] [Jc]
PokerStarMan123: checks 
Klemtonius: checks 
*** RIVER *** [9s 6h 9c Jc] [3d]
PokerStarMan123: bets 2000
Klemtonius: raises 3500 to 5500
PokerStarMan123: folds 
Uncalled bet (3500) returned to Klemtonius
Klemtonius collected 7276 from pot
Klemtonius: doesn't show hand 
*** SUMMARY ***
Total pot 7700 | Rake 424 
Board [9s 6h 9c Jc 3d]
Seat 1: color_singleton folded before Flop (didn't bet)
Seat 2: manon327 folded before Flop
Seat 4: PokerStarMan123 folded on the River
Seat 6: Klemtonius (button) collected (7276)
Seat 8: JeBoyDirk (small blind) folded on the Flop
Seat 9: dockstarrr (big blind) folded before Flop



PokerStars Home Game Hand #226315688493: {DaPokaStars}  Hold'em No Limit (50/100) - 2021/04/29 18:03:02 ET
Table 'yes_sir' 9-max (Play Money) Seat #8 is the button
Seat 1: color_singleton (13235 in chips) 
Seat 2: manon327 (10420 in chips) 
Seat 4: PokerStarMan123 (9280 in chips) 
Seat 6: Klemtonius (12564 in chips) 
Seat 8: JeBoyDirk (19391 in chips) 
Seat 9: dockstarrr (11202 in chips) 
dockstarrr: posts small blind 50
color_singleton: posts big blind 100
*** HOLE CARDS ***
Dealt to PokerStarMan123 [As Td]
manon327: calls 100
PokerStarMan123: raises 300 to 400
Klemtonius: folds 
JeBoyDirk: folds 
dockstarrr: folds 
color_singleton: folds 
manon327: calls 300
*** FLOP *** [3c 5d 9c]
manon327: checks 
PokerStarMan123: checks 
*** TURN *** [3c 5d 9c] [9h]
manon327: checks 
PokerStarMan123: checks 
*** RIVER *** [3c 5d 9c 9h] [7d]
manon327: checks 
PokerStarMan123: checks 
*** SHOW DOWN ***
manon327: shows [6s Ah] (a pair of Nines)
PokerStarMan123: shows [As Td] (a pair of Nines - Ace+Ten kicker)
PokerStarMan123 collected 898 from pot
*** SUMMARY ***
Total pot 950 | Rake 52 
Board [3c 5d 9c 9h 7d]
Seat 1: color_singleton (big blind) folded before Flop
Seat 2: manon327 showed [6s Ah] and lost with a pair of Nines
Seat 4: PokerStarMan123 showed [As Td] and won (898) with a pair of Nines
Seat 6: Klemtonius folded before Flop (didn't bet)
Seat 8: JeBoyDirk (button) folded before Flop (didn't bet)
Seat 9: dockstarrr (small blind) folded before Flop



PokerStars Home Game Hand #226315701288: {DaPokaStars}  Hold'em No Limit (50/100) - 2021/04/29 18:03:29 ET
Table 'yes_sir' 9-max (Play Money) Seat #9 is the button
Seat 1: color_singleton (13135 in chips) 
Seat 2: manon327 (10020 in chips) 
Seat 4: PokerStarMan123 (9778 in chips) 
Seat 6: Klemtonius (12564 in chips) 
Seat 8: JeBoyDirk (19391 in chips) 
Seat 9: dockstarrr (11152 in chips) 
color_singleton: posts small blind 50
manon327: posts big blind 100
*** HOLE CARDS ***
Dealt to PokerStarMan123 [Ts Td]
PokerStarMan123: raises 300 to 400
Klemtonius: folds 
JeBoyDirk: folds 
dockstarrr: folds 
color_singleton: calls 350
manon327: folds 
*** FLOP *** [8c 2d Jc]
color_singleton: checks 
PokerStarMan123: bets 500
color_singleton: folds 
Uncalled bet (500) returned to PokerStarMan123
PokerStarMan123 collected 850 from pot
*** SUMMARY ***
Total pot 900 | Rake 50 
Board [8c 2d Jc]
Seat 1: color_singleton (small blind) folded on the Flop
Seat 2: manon327 (big blind) folded before Flop
Seat 4: PokerStarMan123 collected (850)
Seat 6: Klemtonius folded before Flop (didn't bet)
Seat 8: JeBoyDirk folded before Flop (didn't bet)
Seat 9: dockstarrr (button) folded before Flop (didn't bet)



PokerStars Home Game Hand #226315713831: {DaPokaStars}  Hold'em No Limit (50/100) - 2021/04/29 18:03:55 ET
Table 'yes_sir' 9-max (Play Money) Seat #1 is the button
Seat 1: color_singleton (12735 in chips) 
Seat 2: manon327 (9920 in chips) 
Seat 4: PokerStarMan123 (10228 in chips) 
Seat 6: Klemtonius (12564 in chips) 
Seat 8: JeBoyDirk (19391 in chips) 
Seat 9: dockstarrr (11152 in chips) 
manon327: posts small blind 50
PokerStarMan123: posts big blind 100
*** HOLE CARDS ***
Dealt to PokerStarMan123 [8c 6c]
Klemtonius: raises 100 to 200
JeBoyDirk: calls 200
dockstarrr: folds 
color_singleton: calls 200
manon327: calls 150
PokerStarMan123: calls 100
*** FLOP *** [6d 2d Qh]
manon327: checks 
PokerStarMan123: checks 
Klemtonius: checks 
JeBoyDirk: checks 
color_singleton: checks 
*** TURN *** [6d 2d Qh] [Qs]
manon327: checks 
PokerStarMan123: checks 
Klemtonius: checks 
JeBoyDirk: checks 
color_singleton: bets 500
manon327: folds 
PokerStarMan123: calls 500
Klemtonius: folds 
JeBoyDirk: folds 
*** RIVER *** [6d 2d Qh Qs] [5h]
PokerStarMan123: checks 
color_singleton: checks 
*** SHOW DOWN ***
PokerStarMan123: shows [8c 6c] (two pair, Queens and Sixes)
color_singleton: mucks hand 
PokerStarMan123 collected 1890 from pot
*** SUMMARY ***
Total pot 2000 | Rake 110 
Board [6d 2d Qh Qs 5h]
Seat 1: color_singleton (button) mucked [6s 7h]
Seat 2: manon327 (small blind) folded on the Turn
Seat 4: PokerStarMan123 (big blind) showed [8c 6c] and won (1890) with two pair, Queens and Sixes
Seat 6: Klemtonius folded on the Turn
Seat 8: JeBoyDirk folded on the Turn
Seat 9: dockstarrr folded before Flop (didn't bet)



PokerStars Home Game Hand #226315743266: {DaPokaStars}  Hold'em No Limit (50/100) - 2021/04/29 18:04:57 ET
Table 'yes_sir' 9-max (Play Money) Seat #2 is the button
Seat 1: color_singleton (12035 in chips) 
Seat 2: manon327 (9720 in chips) 
Seat 4: PokerStarMan123 (11418 in chips) 
Seat 6: Klemtonius (12364 in chips) 
Seat 8: JeBoyDirk (19191 in chips) 
Seat 9: dockstarrr (11152 in chips) 
PokerStarMan123: posts small blind 50
Klemtonius: posts big blind 100
*** HOLE CARDS ***
Dealt to PokerStarMan123 [Jc Qd]
JeBoyDirk: calls 100
dockstarrr: folds 
color_singleton: folds 
manon327: folds 
PokerStarMan123: calls 50
Klemtonius: checks 
*** FLOP *** [Qh 8h 8d]
PokerStarMan123: bets 300
Klemtonius: calls 300
JeBoyDirk has timed out
JeBoyDirk: folds 
*** TURN *** [Qh 8h 8d] [Ac]
PokerStarMan123: checks 
Klemtonius: checks 
*** RIVER *** [Qh 8h 8d Ac] [Qc]
PokerStarMan123: bets 1000
Klemtonius: raises 1000 to 2000
PokerStarMan123: raises 2600 to 4600
Klemtonius: raises 7364 to 11964 and is all-in
PokerStarMan123: calls 6418 and is all-in
Uncalled bet (946) returned to Klemtonius
*** SHOW DOWN ***
Klemtonius: shows [Qs 7h] (a full house, Queens full of Eights)
PokerStarMan123: shows [Jc Qd] (a full house, Queens full of Eights)
PokerStarMan123 collected 10838 from pot
Klemtonius collected 10837 from pot
*** SUMMARY ***
Total pot 22936 | Rake 1261 
Board [Qh 8h 8d Ac Qc]
Seat 1: color_singleton folded before Flop (didn't bet)
Seat 2: manon327 (button) folded before Flop (didn't bet)
Seat 4: PokerStarMan123 (small blind) showed [Jc Qd] and won (10838) with a full house, Queens full of Eights
Seat 6: Klemtonius (big blind) showed [Qs 7h] and won (10837) with a full house, Queens full of Eights
Seat 8: JeBoyDirk folded on the Flop
Seat 9: dockstarrr folded before Flop (didn't bet)



PokerStars Home Game Hand #226315772417: {DaPokaStars}  Hold'em No Limit (50/100) - 2021/04/29 18:05:57 ET
Table 'yes_sir' 9-max (Play Money) Seat #4 is the button
Seat 1: color_singleton (12035 in chips) 
Seat 2: manon327 (9720 in chips) 
Seat 4: PokerStarMan123 (10838 in chips) 
Seat 6: Klemtonius (11783 in chips) 
Seat 9: dockstarrr (11152 in chips) 
Klemtonius: posts small blind 50
dockstarrr: posts big blind 100
*** HOLE CARDS ***
Dealt to PokerStarMan123 [Js 8c]
color_singleton: raises 200 to 300
manon327: folds 
PokerStarMan123 has timed out
PokerStarMan123: folds 
Klemtonius: calls 250
dockstarrr: calls 200
*** FLOP *** [5s Th Ad]
Klemtonius: checks 
dockstarrr: checks 
color_singleton: checks 
*** TURN *** [5s Th Ad] [7s]
Klemtonius: checks 
dockstarrr: checks 
color_singleton: checks 
*** RIVER *** [5s Th Ad 7s] [2c]
Klemtonius: bets 425
dockstarrr: folds 
color_singleton: folds 
Uncalled bet (425) returned to Klemtonius
Klemtonius collected 850 from pot
Klemtonius: doesn't show hand 
*** SUMMARY ***
Total pot 900 | Rake 50 
Board [5s Th Ad 7s 2c]
Seat 1: color_singleton folded on the River
Seat 2: manon327 folded before Flop (didn't bet)
Seat 4: PokerStarMan123 (button) folded before Flop (didn't bet)
Seat 6: Klemtonius (small blind) collected (850)
Seat 9: dockstarrr (big blind) folded on the River



PokerStars Home Game Hand #226315805562: {DaPokaStars}  Hold'em No Limit (50/100) - 2021/04/29 18:07:06 ET
Table 'yes_sir' 9-max (Play Money) Seat #6 is the button
Seat 1: color_singleton (11735 in chips) 
Seat 2: manon327 (9720 in chips) 
Seat 4: PokerStarMan123 (10838 in chips) 
Seat 6: Klemtonius (12333 in chips) 
Seat 9: dockstarrr (10852 in chips) 
dockstarrr: posts small blind 50
color_singleton: posts big blind 100
*** HOLE CARDS ***
Dealt to PokerStarMan123 [Js 5c]
manon327: calls 100
PokerStarMan123: folds 
Klemtonius: calls 100
dockstarrr: calls 50
color_singleton: checks 
*** FLOP *** [3s Kh 5h]
dockstarrr: checks 
color_singleton: bets 189
manon327: folds 
Klemtonius: calls 189
dockstarrr: folds 
*** TURN *** [3s Kh 5h] [8s]
color_singleton: bets 367
Klemtonius: calls 367
*** RIVER *** [3s Kh 5h 8s] [4d]
color_singleton: checks 
Klemtonius: checks 
*** SHOW DOWN ***
color_singleton: shows [2h 3d] (a pair of Threes)
Klemtonius: shows [Qh 8d] (a pair of Eights)
Klemtonius collected 1429 from pot
*** SUMMARY ***
Total pot 1512 | Rake 83 
Board [3s Kh 5h 8s 4d]
Seat 1: color_singleton (big blind) showed [2h 3d] and lost with a pair of Threes
Seat 2: manon327 folded on the Flop
Seat 4: PokerStarMan123 folded before Flop (didn't bet)
Seat 6: Klemtonius (button) showed [Qh 8d] and won (1429) with a pair of Eights
Seat 9: dockstarrr (small blind) folded on the Flop



PokerStars Home Game Hand #226315836838: {DaPokaStars}  Hold'em No Limit (50/100) - 2021/04/29 18:08:06 ET
Table 'yes_sir' 9-max (Play Money) Seat #9 is the button
Seat 1: color_singleton (11079 in chips) 
Seat 2: manon327 (9620 in chips) 
Seat 4: PokerStarMan123 (10838 in chips) 
Seat 6: Klemtonius (13106 in chips) 
Seat 8: JeBoyDirk (19091 in chips) 
Seat 9: dockstarrr (10752 in chips) 
color_singleton: posts small blind 50
manon327: posts big blind 100
JeBoyDirk: posts small & big blinds 150
*** HOLE CARDS ***
Dealt to PokerStarMan123 [8s Ks]
PokerStarMan123: calls 100
Klemtonius: calls 100
JeBoyDirk: checks 
dockstarrr: folds 
color_singleton: raises 200 to 300
manon327: calls 200
PokerStarMan123: calls 200
Klemtonius: calls 200
JeBoyDirk: folds 
*** FLOP *** [5c Qd Tc]
color_singleton: checks 
manon327: checks 
PokerStarMan123: checks 
Klemtonius: checks 
*** TURN *** [5c Qd Tc] [As]
color_singleton: checks 
manon327: bets 638
PokerStarMan123: folds 
Klemtonius: folds 
color_singleton: folds 
Uncalled bet (638) returned to manon327
manon327 collected 1276 from pot
*** SUMMARY ***
Total pot 1350 | Rake 74 
Board [5c Qd Tc As]
Seat 1: color_singleton (small blind) folded on the Turn
Seat 2: manon327 (big blind) collected (1276)
Seat 4: PokerStarMan123 folded on the Turn
Seat 6: Klemtonius folded on the Turn
Seat 8: JeBoyDirk folded before Flop (didn't bet)
Seat 9: dockstarrr (button) folded before Flop (didn't bet)



PokerStars Home Game Hand #226315859592: {DaPokaStars}  Hold'em No Limit (50/100) - 2021/04/29 18:08:54 ET
Table 'yes_sir' 9-max (Play Money) Seat #1 is the button
Seat 1: color_singleton (10779 in chips) 
Seat 2: manon327 (10596 in chips) 
Seat 4: PokerStarMan123 (10538 in chips) 
Seat 6: Klemtonius (12806 in chips) 
Seat 8: JeBoyDirk (18941 in chips) 
Seat 9: dockstarrr (10752 in chips) 
manon327: posts small blind 50
PokerStarMan123: posts big blind 100
*** HOLE CARDS ***
Dealt to PokerStarMan123 [5c Kc]
Klemtonius: calls 100
JeBoyDirk: calls 100
dockstarrr: folds 
color_singleton: folds 
manon327: calls 50
PokerStarMan123: checks 
*** FLOP *** [6h Qs 7h]
manon327: checks 
PokerStarMan123: checks 
Klemtonius: checks 
JeBoyDirk: checks 
*** TURN *** [6h Qs 7h] [7c]
manon327: checks 
PokerStarMan123: checks 
Klemtonius: bets 189
JeBoyDirk: folds 
manon327: folds 
PokerStarMan123 has timed out
PokerStarMan123: folds 
Uncalled bet (189) returned to Klemtonius
Klemtonius collected 378 from pot
Klemtonius: doesn't show hand 
*** SUMMARY ***
Total pot 400 | Rake 22 
Board [6h Qs 7h 7c]
Seat 1: color_singleton (button) folded before Flop (didn't bet)
Seat 2: manon327 (small blind) folded on the Turn
Seat 4: PokerStarMan123 (big blind) folded on the Turn
Seat 6: Klemtonius collected (378)
Seat 8: JeBoyDirk folded on the Turn
Seat 9: dockstarrr folded before Flop (didn't bet)



PokerStars Home Game Hand #226315887925: {DaPokaStars}  Hold'em No Limit (50/100) - 2021/04/29 18:09:54 ET
Table 'yes_sir' 9-max (Play Money) Seat #2 is the button
Seat 1: color_singleton (10779 in chips) 
Seat 2: manon327 (10496 in chips) 
Seat 4: PokerStarMan123 (10438 in chips) 
Seat 6: Klemtonius (13084 in chips) 
Seat 8: JeBoyDirk (18841 in chips) 
Seat 9: dockstarrr (10752 in chips) 
PokerStarMan123: posts small blind 50
Klemtonius: posts big blind 100
*** HOLE CARDS ***
Dealt to PokerStarMan123 [9h Jh]
JeBoyDirk: folds 
dockstarrr: raises 100 to 200
color_singleton: folds 
manon327: calls 200
PokerStarMan123: calls 150
Klemtonius: calls 100
*** FLOP *** [6s Qs Ks]
PokerStarMan123: checks 
Klemtonius: checks 
dockstarrr: bets 756
manon327: folds 
PokerStarMan123: folds 
Klemtonius: calls 756
*** TURN *** [6s Qs Ks] [Js]
Klemtonius: bets 2185
dockstarrr: folds 
Uncalled bet (2185) returned to Klemtonius
Klemtonius collected 2185 from pot
Klemtonius: doesn't show hand 
*** SUMMARY ***
Total pot 2312 | Rake 127 
Board [6s Qs Ks Js]
Seat 1: color_singleton folded before Flop (didn't bet)
Seat 2: manon327 (button) folded on the Flop
Seat 4: PokerStarMan123 (small blind) folded on the Flop
Seat 6: Klemtonius (big blind) collected (2185)
Seat 8: JeBoyDirk folded before Flop (didn't bet)
Seat 9: dockstarrr folded on the Turn



PokerStars Home Game Hand #226315923223: {DaPokaStars}  Hold'em No Limit (50/100) - 2021/04/29 18:11:10 ET
Table 'yes_sir' 9-max (Play Money) Seat #4 is the button
Seat 1: color_singleton (10779 in chips) 
Seat 2: manon327 (10296 in chips) 
Seat 4: PokerStarMan123 (10238 in chips) 
Seat 6: Klemtonius (14313 in chips) 
Seat 8: JeBoyDirk (18841 in chips) 
Seat 9: dockstarrr (9796 in chips) 
Klemtonius: posts small blind 50
JeBoyDirk: posts big blind 100
*** HOLE CARDS ***
Dealt to PokerStarMan123 [6s Kc]
dockstarrr: folds 
color_singleton: folds 
manon327: folds 
PokerStarMan123: folds 
Klemtonius: calls 50
JeBoyDirk: checks 
*** FLOP *** [4c 2c 2s]
Klemtonius: checks 
JeBoyDirk: checks 
*** TURN *** [4c 2c 2s] [7d]
Klemtonius: bets 100
JeBoyDirk: folds 
Uncalled bet (100) returned to Klemtonius
Klemtonius collected 189 from pot
Klemtonius: doesn't show hand 
*** SUMMARY ***
Total pot 200 | Rake 11 
Board [4c 2c 2s 7d]
Seat 1: color_singleton folded before Flop (didn't bet)
Seat 2: manon327 folded before Flop (didn't bet)
Seat 4: PokerStarMan123 (button) folded before Flop (didn't bet)
Seat 6: Klemtonius (small blind) collected (189)
Seat 8: JeBoyDirk (big blind) folded on the Turn
Seat 9: dockstarrr folded before Flop (didn't bet)



PokerStars Home Game Hand #226315947155: {DaPokaStars}  Hold'em No Limit (50/100) - 2021/04/29 18:12:01 ET
Table 'yes_sir' 9-max (Play Money) Seat #6 is the button
Seat 1: color_singleton (10779 in chips) 
Seat 2: manon327 (10296 in chips) 
Seat 4: PokerStarMan123 (10238 in chips) 
Seat 6: Klemtonius (14402 in chips) 
Seat 8: JeBoyDirk (18741 in chips) 
Seat 9: dockstarrr (9796 in chips) 
JeBoyDirk: posts small blind 50
dockstarrr: posts big blind 100
*** HOLE CARDS ***
Dealt to PokerStarMan123 [Tc 2d]
color_singleton: folds 
manon327: folds 
PokerStarMan123: folds 
Klemtonius: folds 
JeBoyDirk: folds 
Uncalled bet (50) returned to dockstarrr
dockstarrr collected 100 from pot
dockstarrr: doesn't show hand 
*** SUMMARY ***
Total pot 100 | Rake 0 
Seat 1: color_singleton folded before Flop (didn't bet)
Seat 2: manon327 folded before Flop (didn't bet)
Seat 4: PokerStarMan123 folded before Flop (didn't bet)
Seat 6: Klemtonius (button) folded before Flop (didn't bet)
Seat 8: JeBoyDirk (small blind) folded before Flop
Seat 9: dockstarrr (big blind) collected (100)



PokerStars Home Game Hand #226315951896: {DaPokaStars}  Hold'em No Limit (50/100) - 2021/04/29 18:12:11 ET
Table 'yes_sir' 9-max (Play Money) Seat #8 is the button
Seat 1: color_singleton (10779 in chips) 
Seat 2: manon327 (10296 in chips) 
Seat 4: PokerStarMan123 (10238 in chips) 
Seat 6: Klemtonius (14402 in chips) 
Seat 8: JeBoyDirk (18691 in chips) 
Seat 9: dockstarrr (9846 in chips) 
dockstarrr: posts small blind 50
color_singleton: posts big blind 100
*** HOLE CARDS ***
Dealt to PokerStarMan123 [7d 6d]
manon327: calls 100
PokerStarMan123 has timed out
PokerStarMan123: folds 
Klemtonius: raises 350 to 450
JeBoyDirk: folds 
dockstarrr: calls 400
color_singleton: calls 350
manon327: folds 
*** FLOP *** [Kh Kc Th]
dockstarrr: checks 
color_singleton: checks 
Klemtonius: bets 685
dockstarrr: folds 
color_singleton: folds 
Uncalled bet (685) returned to Klemtonius
Klemtonius collected 1370 from pot
Klemtonius: doesn't show hand 
*** SUMMARY ***
Total pot 1450 | Rake 80 
Board [Kh Kc Th]
Seat 1: color_singleton (big blind) folded on the Flop
Seat 2: manon327 folded before Flop
Seat 4: PokerStarMan123 folded before Flop (didn't bet)
Seat 6: Klemtonius collected (1370)
Seat 8: JeBoyDirk (button) folded before Flop (didn't bet)
Seat 9: dockstarrr (small blind) folded on the Flop



PokerStars Home Game Hand #226316085338: {DaPokaStars}  Hold'em No Limit (50/100) - 2021/04/29 18:16:31 ET
Table 'yes_sir' 9-max (Play Money) Seat #8 is the button
Seat 1: color_singleton (11407 in chips) 
Seat 2: manon327 (9496 in chips) 
Seat 4: PokerStarMan123 (10238 in chips) 
Seat 6: Klemtonius (13472 in chips) 
Seat 8: JeBoyDirk (21307 in chips) 
Seat 9: dockstarrr (7896 in chips) 
dockstarrr: posts small blind 50
color_singleton: posts big blind 100
PokerStarMan123: posts small & big blinds 150
*** HOLE CARDS ***
Dealt to PokerStarMan123 [9d 4c]
manon327: calls 100
PokerStarMan123: checks 
Klemtonius: raises 500 to 600
JeBoyDirk: folds 
dockstarrr: folds 
color_singleton: folds 
manon327: folds 
PokerStarMan123: folds 
Uncalled bet (500) returned to Klemtonius
Klemtonius collected 500 from pot
Klemtonius: doesn't show hand 
*** SUMMARY ***
Total pot 500 | Rake 0 
Seat 1: color_singleton (big blind) folded before Flop
Seat 2: manon327 folded before Flop
Seat 4: PokerStarMan123 folded before Flop (didn't bet)
Seat 6: Klemtonius collected (500)
Seat 8: JeBoyDirk (button) folded before Flop (didn't bet)
Seat 9: dockstarrr (small blind) folded before Flop



PokerStars Home Game Hand #226316096333: {DaPokaStars}  Hold'em No Limit (50/100) - 2021/04/29 18:16:55 ET
Table 'yes_sir' 9-max (Play Money) Seat #9 is the button
Seat 1: color_singleton (11307 in chips) 
Seat 2: manon327 (9396 in chips) 
Seat 4: PokerStarMan123 (10088 in chips) 
Seat 6: Klemtonius (13872 in chips) 
Seat 8: JeBoyDirk (21307 in chips) 
Seat 9: dockstarrr (7846 in chips) 
color_singleton: posts small blind 50
manon327: posts big blind 100
*** HOLE CARDS ***
Dealt to PokerStarMan123 [2c Ac]
PokerStarMan123: calls 100
Klemtonius: calls 100
JeBoyDirk: folds 
dockstarrr: folds 
color_singleton: calls 50
manon327: checks 
*** FLOP *** [5d 7d Jh]
color_singleton: checks 
manon327: checks 
PokerStarMan123: checks 
Klemtonius: bets 189
color_singleton: calls 189
manon327: folds 
PokerStarMan123: folds 
*** TURN *** [5d 7d Jh] [Qh]
color_singleton: checks 
Klemtonius: checks 
*** RIVER *** [5d 7d Jh Qh] [Kc]
color_singleton: checks 
Klemtonius: checks 
*** SHOW DOWN ***
color_singleton: shows [3c 5h] (a pair of Fives)
Klemtonius: mucks hand 
color_singleton collected 735 from pot
*** SUMMARY ***
Total pot 778 | Rake 43 
Board [5d 7d Jh Qh Kc]
Seat 1: color_singleton (small blind) showed [3c 5h] and won (735) with a pair of Fives
Seat 2: manon327 (big blind) folded on the Flop
Seat 4: PokerStarMan123 folded on the Flop
Seat 6: Klemtonius mucked [9d 6h]
Seat 8: JeBoyDirk folded before Flop (didn't bet)
Seat 9: dockstarrr (button) folded before Flop (didn't bet)



PokerStars Home Game Hand #226316132041: {DaPokaStars}  Hold'em No Limit (50/100) - 2021/04/29 18:18:13 ET
Table 'yes_sir' 9-max (Play Money) Seat #1 is the button
Seat 1: color_singleton (11753 in chips) 
Seat 2: manon327 (9296 in chips) 
Seat 4: PokerStarMan123 (9988 in chips) 
Seat 6: Klemtonius (13583 in chips) 
Seat 8: JeBoyDirk (21307 in chips) 
Seat 9: dockstarrr (7846 in chips) 
manon327: posts small blind 50
PokerStarMan123: posts big blind 100
*** HOLE CARDS ***
Dealt to PokerStarMan123 [7s Td]
Klemtonius: calls 100
JeBoyDirk: calls 100
dockstarrr: calls 100
color_singleton: folds 
manon327: folds 
PokerStarMan123: checks 
*** FLOP *** [5s Jd 5c]
PokerStarMan123: checks 
Klemtonius: checks 
JeBoyDirk: bets 300
dockstarrr: folds 
PokerStarMan123: folds 
Klemtonius: folds 
Uncalled bet (300) returned to JeBoyDirk
JeBoyDirk collected 425 from pot
*** SUMMARY ***
Total pot 450 | Rake 25 
Board [5s Jd 5c]
Seat 1: color_singleton (button) folded before Flop (didn't bet)
Seat 2: manon327 (small blind) folded before Flop
Seat 4: PokerStarMan123 (big blind) folded on the Flop
Seat 6: Klemtonius folded on the Flop
Seat 8: JeBoyDirk collected (425)
Seat 9: dockstarrr folded on the Flop



PokerStars Home Game Hand #226316145362: {DaPokaStars}  Hold'em No Limit (50/100) - 2021/04/29 18:18:43 ET
Table 'yes_sir' 9-max (Play Money) Seat #2 is the button
Seat 1: color_singleton (11753 in chips) 
Seat 2: manon327 (9246 in chips) 
Seat 4: PokerStarMan123 (9888 in chips) 
Seat 6: Klemtonius (13483 in chips) 
Seat 8: JeBoyDirk (21632 in chips) 
Seat 9: dockstarrr (7746 in chips) 
PokerStarMan123: posts small blind 50
Klemtonius: posts big blind 100
*** HOLE CARDS ***
Dealt to PokerStarMan123 [Kc Js]
JeBoyDirk: calls 100
dockstarrr: folds 
color_singleton: raises 200 to 300
manon327: folds 
PokerStarMan123: calls 250
Klemtonius: calls 200
JeBoyDirk: calls 200
*** FLOP *** [Jc Qs 7s]
PokerStarMan123: bets 300
Klemtonius: folds 
JeBoyDirk: folds 
color_singleton: calls 300
*** TURN *** [Jc Qs 7s] [7c]
PokerStarMan123: bets 900
color_singleton: folds 
Uncalled bet (900) returned to PokerStarMan123
PokerStarMan123 collected 1701 from pot
*** SUMMARY ***
Total pot 1800 | Rake 99 
Board [Jc Qs 7s 7c]
Seat 1: color_singleton folded on the Turn
Seat 2: manon327 (button) folded before Flop (didn't bet)
Seat 4: PokerStarMan123 (small blind) collected (1701)
Seat 6: Klemtonius (big blind) folded on the Flop
Seat 8: JeBoyDirk folded on the Flop
Seat 9: dockstarrr folded before Flop (didn't bet)



PokerStars Home Game Hand #226316159263: {DaPokaStars}  Hold'em No Limit (50/100) - 2021/04/29 18:19:13 ET
Table 'yes_sir' 9-max (Play Money) Seat #4 is the button
Seat 1: color_singleton (11153 in chips) 
Seat 2: manon327 (9246 in chips) 
Seat 4: PokerStarMan123 (10989 in chips) 
Seat 6: Klemtonius (13183 in chips) 
Seat 8: JeBoyDirk (21332 in chips) 
Seat 9: dockstarrr (7746 in chips) 
Klemtonius: posts small blind 50
JeBoyDirk: posts big blind 100
*** HOLE CARDS ***
Dealt to PokerStarMan123 [8s 2h]
dockstarrr: calls 100
color_singleton: folds 
manon327: calls 100
PokerStarMan123: folds 
Klemtonius: calls 50
JeBoyDirk: checks 
*** FLOP *** [3s 3h Kc]
Klemtonius: checks 
JeBoyDirk: checks 
dockstarrr: bets 100
manon327: raises 100 to 200
Klemtonius: folds 
JeBoyDirk: folds 
dockstarrr: calls 100
*** TURN *** [3s 3h Kc] [Js]
dockstarrr: bets 100
manon327: raises 100 to 200
dockstarrr: calls 100
*** RIVER *** [3s 3h Kc Js] [4d]
dockstarrr: bets 100
manon327: calls 100
*** SHOW DOWN ***
dockstarrr: shows [Kh 9h] (two pair, Kings and Threes)
manon327: shows [3c 7c] (three of a kind, Threes)
manon327 collected 1323 from pot
*** SUMMARY ***
Total pot 1400 | Rake 77 
Board [3s 3h Kc Js 4d]
Seat 1: color_singleton folded before Flop (didn't bet)
Seat 2: manon327 showed [3c 7c] and won (1323) with three of a kind, Threes
Seat 4: PokerStarMan123 (button) folded before Flop (didn't bet)
Seat 6: Klemtonius (small blind) folded on the Flop
Seat 8: JeBoyDirk (big blind) folded on the Flop
Seat 9: dockstarrr showed [Kh 9h] and lost with two pair, Kings and Threes



PokerStars Home Game Hand #226316187632: {DaPokaStars}  Hold'em No Limit (50/100) - 2021/04/29 18:20:16 ET
Table 'yes_sir' 9-max (Play Money) Seat #6 is the button
Seat 1: color_singleton (11153 in chips) 
Seat 2: manon327 (9969 in chips) 
Seat 4: PokerStarMan123 (10989 in chips) 
Seat 6: Klemtonius (13083 in chips) 
Seat 8: JeBoyDirk (21232 in chips) 
Seat 9: dockstarrr (7146 in chips) 
JeBoyDirk: posts small blind 50
dockstarrr: posts big blind 100
*** HOLE CARDS ***
Dealt to PokerStarMan123 [9s 6h]
color_singleton: folds 
manon327: calls 100
PokerStarMan123: folds 
Klemtonius: calls 100
JeBoyDirk: calls 50
dockstarrr: checks 
*** FLOP *** [Kh 3s Jd]
JeBoyDirk: checks 
dockstarrr: checks 
manon327: checks 
Klemtonius: checks 
*** TURN *** [Kh 3s Jd] [5c]
JeBoyDirk: checks 
dockstarrr: checks 
manon327: bets 189
Klemtonius: folds 
JeBoyDirk: calls 189
dockstarrr: folds 
*** RIVER *** [Kh 3s Jd 5c] [Tc]
JeBoyDirk: checks 
manon327: bets 367
JeBoyDirk: folds 
Uncalled bet (367) returned to manon327
manon327 collected 735 from pot
*** SUMMARY ***
Total pot 778 | Rake 43 
Board [Kh 3s Jd 5c Tc]
Seat 1: color_singleton folded before Flop (didn't bet)
Seat 2: manon327 collected (735)
Seat 4: PokerStarMan123 folded before Flop (didn't bet)
Seat 6: Klemtonius (button) folded on the Turn
Seat 8: JeBoyDirk (small blind) folded on the River
Seat 9: dockstarrr (big blind) folded on the Turn



PokerStars Home Game Hand #226316212531: {DaPokaStars}  Hold'em No Limit (50/100) - 2021/04/29 18:21:11 ET
Table 'yes_sir' 9-max (Play Money) Seat #8 is the button
Seat 1: color_singleton (11153 in chips) 
Seat 2: manon327 (10415 in chips) 
Seat 4: PokerStarMan123 (10989 in chips) 
Seat 6: Klemtonius (12983 in chips) 
Seat 8: JeBoyDirk (20943 in chips) 
color_singleton: posts small blind 50
manon327: posts big blind 100
*** HOLE CARDS ***
Dealt to PokerStarMan123 [4d 6h]
PokerStarMan123: folds 
Klemtonius: folds 
JeBoyDirk: folds 
color_singleton: calls 50
manon327: raises 100 to 200
color_singleton: calls 100
*** FLOP *** [Th Qs 3c]
color_singleton: bets 189
manon327: calls 189
*** TURN *** [Th Qs 3c] [6d]
color_singleton: checks 
manon327: bets 367
color_singleton: folds 
Uncalled bet (367) returned to manon327
manon327 collected 735 from pot
*** SUMMARY ***
Total pot 778 | Rake 43 
Board [Th Qs 3c 6d]
Seat 1: color_singleton (small blind) folded on the Turn
Seat 2: manon327 (big blind) collected (735)
Seat 4: PokerStarMan123 folded before Flop (didn't bet)
Seat 6: Klemtonius folded before Flop (didn't bet)
Seat 8: JeBoyDirk (button) folded before Flop (didn't bet)



PokerStars Home Game Hand #226316228965: {DaPokaStars}  Hold'em No Limit (50/100) - 2021/04/29 18:21:48 ET
Table 'yes_sir' 9-max (Play Money) Seat #1 is the button
Seat 1: color_singleton (10764 in chips) 
Seat 2: manon327 (10761 in chips) 
Seat 4: PokerStarMan123 (10989 in chips) 
Seat 6: Klemtonius (12983 in chips) 
Seat 8: JeBoyDirk (20943 in chips) 
manon327: posts small blind 50
PokerStarMan123: posts big blind 100
*** HOLE CARDS ***
Dealt to PokerStarMan123 [8c Ks]
Klemtonius: calls 100
JeBoyDirk: calls 100
color_singleton: folds 
manon327: folds 
PokerStarMan123: checks 
*** FLOP *** [9h 6h 2c]
PokerStarMan123: checks 
Klemtonius: bets 331
JeBoyDirk: folds 
PokerStarMan123: folds 
Uncalled bet (331) returned to Klemtonius
Klemtonius collected 331 from pot
Klemtonius: doesn't show hand 
*** SUMMARY ***
Total pot 350 | Rake 19 
Board [9h 6h 2c]
Seat 1: color_singleton (button) folded before Flop (didn't bet)
Seat 2: manon327 (small blind) folded before Flop
Seat 4: PokerStarMan123 (big blind) folded on the Flop
Seat 6: Klemtonius collected (331)
Seat 8: JeBoyDirk folded on the Flop



PokerStars Home Game Hand #226316240331: {DaPokaStars}  Hold'em No Limit (50/100) - 2021/04/29 18:22:13 ET
Table 'yes_sir' 9-max (Play Money) Seat #2 is the button
Seat 1: color_singleton (10764 in chips) 
Seat 2: manon327 (10711 in chips) 
Seat 4: PokerStarMan123 (10889 in chips) 
Seat 6: Klemtonius (13214 in chips) 
Seat 8: JeBoyDirk (20843 in chips) 
PokerStarMan123: posts small blind 50
Klemtonius: posts big blind 100
*** HOLE CARDS ***
Dealt to PokerStarMan123 [Th 5d]
JeBoyDirk: folds 
color_singleton: raises 200 to 300
manon327: calls 300
PokerStarMan123: folds 
Klemtonius: calls 200
*** FLOP *** [4c 8h 4h]
Klemtonius: checks 
color_singleton: checks 
manon327: checks 
*** TURN *** [4c 8h 4h] [Ad]
Klemtonius: checks 
color_singleton: bets 449
manon327: calls 449
Klemtonius: folds 
*** RIVER *** [4c 8h 4h Ad] [8c]
color_singleton: bets 873
manon327: calls 873
*** SHOW DOWN ***
color_singleton: shows [Ac 7c] (two pair, Aces and Eights)
manon327: shows [Ts As] (two pair, Aces and Eights - Ten kicker)
manon327 collected 3396 from pot
*** SUMMARY ***
Total pot 3594 | Rake 198 
Board [4c 8h 4h Ad 8c]
Seat 1: color_singleton showed [Ac 7c] and lost with two pair, Aces and Eights
Seat 2: manon327 (button) showed [Ts As] and won (3396) with two pair, Aces and Eights
Seat 4: PokerStarMan123 (small blind) folded before Flop
Seat 6: Klemtonius (big blind) folded on the Turn
Seat 8: JeBoyDirk folded before Flop (didn't bet)



PokerStars Home Game Hand #226316261605: {DaPokaStars}  Hold'em No Limit (50/100) - 2021/04/29 18:23:01 ET
Table 'yes_sir' 9-max (Play Money) Seat #4 is the button
Seat 1: color_singleton (9142 in chips) 
Seat 2: manon327 (12485 in chips) 
Seat 4: PokerStarMan123 (10839 in chips) 
Seat 6: Klemtonius (12914 in chips) 
Seat 8: JeBoyDirk (20843 in chips) 
Seat 9: dockstarrr (7046 in chips) 
Klemtonius: posts small blind 50
JeBoyDirk: posts big blind 100
dockstarrr: posts small blind 50
*** HOLE CARDS ***
Dealt to PokerStarMan123 [5d 8d]
dockstarrr: calls 100
color_singleton: folds 
manon327: calls 100
PokerStarMan123: calls 100
Klemtonius: folds 
JeBoyDirk: checks 
*** FLOP *** [Jd Ks Js]
JeBoyDirk: checks 
dockstarrr: checks 
manon327: bets 100
PokerStarMan123: folds 
JeBoyDirk: folds 
dockstarrr: calls 100
*** TURN *** [Jd Ks Js] [Qs]
dockstarrr: checks 
manon327: bets 100
dockstarrr: calls 100
*** RIVER *** [Jd Ks Js Qs] [8h]
dockstarrr: checks 
manon327: bets 850
dockstarrr: folds 
Uncalled bet (850) returned to manon327
manon327 collected 850 from pot
*** SUMMARY ***
Total pot 900 | Rake 50 
Board [Jd Ks Js Qs 8h]
Seat 1: color_singleton folded before Flop (didn't bet)
Seat 2: manon327 collected (850)
Seat 4: PokerStarMan123 (button) folded on the Flop
Seat 6: Klemtonius (small blind) folded before Flop
Seat 8: JeBoyDirk (big blind) folded on the Flop
Seat 9: dockstarrr folded on the River



PokerStars Home Game Hand #226316279541: {DaPokaStars}  Hold'em No Limit (50/100) - 2021/04/29 18:23:42 ET
Table 'yes_sir' 9-max (Play Money) Seat #6 is the button
Seat 1: color_singleton (9142 in chips) 
Seat 2: manon327 (13035 in chips) 
Seat 4: PokerStarMan123 (10739 in chips) 
Seat 6: Klemtonius (12864 in chips) 
Seat 8: JeBoyDirk (20743 in chips) 
Seat 9: dockstarrr (6696 in chips) 
JeBoyDirk: posts small blind 50
dockstarrr: posts big blind 100
*** HOLE CARDS ***
Dealt to PokerStarMan123 [2s 5h]
color_singleton: folds 
manon327: calls 100
PokerStarMan123: folds 
Klemtonius: calls 100
JeBoyDirk: calls 50
dockstarrr: checks 
*** FLOP *** [5d 8d 3s]
JeBoyDirk: checks 
dockstarrr: checks 
manon327: checks 
Klemtonius: bets 189
JeBoyDirk: folds 
dockstarrr: folds 
manon327: calls 189
*** TURN *** [5d 8d 3s] [6h]
manon327: checks 
Klemtonius: bets 367
manon327: calls 367
*** RIVER *** [5d 8d 3s 6h] [Td]
manon327: bets 1429
Klemtonius: folds 
Uncalled bet (1429) returned to manon327
manon327 collected 1429 from pot
*** SUMMARY ***
Total pot 1512 | Rake 83 
Board [5d 8d 3s 6h Td]
Seat 1: color_singleton folded before Flop (didn't bet)
Seat 2: manon327 collected (1429)
Seat 4: PokerStarMan123 folded before Flop (didn't bet)
Seat 6: Klemtonius (button) folded on the River
Seat 8: JeBoyDirk (small blind) folded on the Flop
Seat 9: dockstarrr (big blind) folded on the Flop



PokerStars Home Game Hand #226316303569: {DaPokaStars}  Hold'em No Limit (50/100) - 2021/04/29 18:24:36 ET
Table 'yes_sir' 9-max (Play Money) Seat #8 is the button
Seat 1: color_singleton (9142 in chips) 
Seat 2: manon327 (13808 in chips) 
Seat 4: PokerStarMan123 (10739 in chips) 
Seat 6: Klemtonius (12208 in chips) 
Seat 8: JeBoyDirk (20643 in chips) 
Seat 9: dockstarrr (6596 in chips) 
dockstarrr: posts small blind 50
color_singleton: posts big blind 100
*** HOLE CARDS ***
Dealt to PokerStarMan123 [7d 3d]
manon327: calls 100
PokerStarMan123: folds 
Klemtonius: raises 100 to 200
JeBoyDirk: folds 
dockstarrr: folds 
color_singleton: raises 200 to 400
manon327: folds 
Klemtonius: calls 200
*** FLOP *** [3h Ac 5c]
color_singleton: bets 449
Klemtonius: calls 449
*** TURN *** [3h Ac 5c] [5d]
color_singleton: checks 
Klemtonius: checks 
*** RIVER *** [3h Ac 5c 5d] [7c]
color_singleton: bets 873
Klemtonius: folds 
Uncalled bet (873) returned to color_singleton
color_singleton collected 1746 from pot
color_singleton: doesn't show hand 
*** SUMMARY ***
Total pot 1848 | Rake 102 
Board [3h Ac 5c 5d 7c]
Seat 1: color_singleton (big blind) collected (1746)
Seat 2: manon327 folded before Flop
Seat 4: PokerStarMan123 folded before Flop (didn't bet)
Seat 6: Klemtonius folded on the River
Seat 8: JeBoyDirk (button) folded before Flop (didn't bet)
Seat 9: dockstarrr (small blind) folded before Flop



PokerStars Home Game Hand #226316315883: {DaPokaStars}  Hold'em No Limit (50/100) - 2021/04/29 18:25:03 ET
Table 'yes_sir' 9-max (Play Money) Seat #9 is the button
Seat 1: color_singleton (10039 in chips) 
Seat 2: manon327 (13708 in chips) 
Seat 4: PokerStarMan123 (10739 in chips) 
Seat 6: Klemtonius (11359 in chips) 
Seat 8: JeBoyDirk (20643 in chips) 
Seat 9: dockstarrr (6546 in chips) 
color_singleton: posts small blind 50
manon327: posts big blind 100
*** HOLE CARDS ***
Dealt to PokerStarMan123 [7s 9d]
PokerStarMan123: folds 
Klemtonius: raises 100 to 200
JeBoyDirk: folds 
dockstarrr: folds 
color_singleton: calls 150
manon327: calls 100
*** FLOP *** [6s 6h 2c]
color_singleton: checks 
manon327: checks 
Klemtonius: checks 
*** TURN *** [6s 6h 2c] [Ac]
color_singleton: checks 
manon327: checks 
Klemtonius: bets 567
color_singleton: folds 
manon327: folds 
Uncalled bet (567) returned to Klemtonius
Klemtonius collected 567 from pot
Klemtonius: doesn't show hand 
*** SUMMARY ***
Total pot 600 | Rake 33 
Board [6s 6h 2c Ac]
Seat 1: color_singleton (small blind) folded on the Turn
Seat 2: manon327 (big blind) folded on the Turn
Seat 4: PokerStarMan123 folded before Flop (didn't bet)
Seat 6: Klemtonius collected (567)
Seat 8: JeBoyDirk folded before Flop (didn't bet)
Seat 9: dockstarrr (button) folded before Flop (didn't bet)



PokerStars Home Game Hand #226316328694: {DaPokaStars}  Hold'em No Limit (50/100) - 2021/04/29 18:25:32 ET
Table 'yes_sir' 9-max (Play Money) Seat #1 is the button
Seat 1: color_singleton (9839 in chips) 
Seat 2: manon327 (13508 in chips) 
Seat 4: PokerStarMan123 (10739 in chips) 
Seat 6: Klemtonius (11726 in chips) 
Seat 8: JeBoyDirk (20643 in chips) 
Seat 9: dockstarrr (6546 in chips) 
manon327: posts small blind 50
PokerStarMan123: posts big blind 100
*** HOLE CARDS ***
Dealt to PokerStarMan123 [Ac 3h]
Klemtonius: calls 100
JeBoyDirk: folds 
dockstarrr: folds 
color_singleton: raises 200 to 300
manon327: folds 
PokerStarMan123: folds 
Klemtonius: calls 200
*** FLOP *** [9c Qh 3c]
Klemtonius: checks 
color_singleton: checks 
*** TURN *** [9c Qh 3c] [4d]
Klemtonius: checks 
color_singleton: checks 
*** RIVER *** [9c Qh 3c 4d] [6d]
Klemtonius: checks 
color_singleton: checks 
*** SHOW DOWN ***
Klemtonius: shows [5s Th] (high card Queen)
color_singleton: shows [7c Ad] (high card Ace)
color_singleton collected 709 from pot
*** SUMMARY ***
Total pot 750 | Rake 41 
Board [9c Qh 3c 4d 6d]
Seat 1: color_singleton (button) showed [7c Ad] and won (709) with high card Ace
Seat 2: manon327 (small blind) folded before Flop
Seat 4: PokerStarMan123 (big blind) folded before Flop
Seat 6: Klemtonius showed [5s Th] and lost with high card Queen
Seat 8: JeBoyDirk folded before Flop (didn't bet)
Seat 9: dockstarrr folded before Flop (didn't bet)



PokerStars Home Game Hand #226316357305: {DaPokaStars}  Hold'em No Limit (50/100) - 2021/04/29 18:26:15 ET
Table 'yes_sir' 9-max (Play Money) Seat #2 is the button
Seat 1: color_singleton (10248 in chips) 
Seat 2: manon327 (13458 in chips) 
Seat 4: PokerStarMan123 (10639 in chips) 
Seat 6: Klemtonius (11426 in chips) 
Seat 8: JeBoyDirk (20643 in chips) 
Seat 9: dockstarrr (6546 in chips) 
PokerStarMan123: posts small blind 50
Klemtonius: posts big blind 100
*** HOLE CARDS ***
Dealt to PokerStarMan123 [Qh Qs]
JeBoyDirk: folds 
dockstarrr: calls 100
color_singleton: calls 100
manon327: folds 
PokerStarMan123: raises 400 to 500
Klemtonius: folds 
dockstarrr: folds 
color_singleton: calls 400
*** FLOP *** [Js Kc 8d]
PokerStarMan123: checks 
color_singleton: checks 
*** TURN *** [Js Kc 8d] [9c]
PokerStarMan123: bets 600
color_singleton: folds 
Uncalled bet (600) returned to PokerStarMan123
PokerStarMan123 collected 1134 from pot
*** SUMMARY ***
Total pot 1200 | Rake 66 
Board [Js Kc 8d 9c]
Seat 1: color_singleton folded on the Turn
Seat 2: manon327 (button) folded before Flop (didn't bet)
Seat 4: PokerStarMan123 (small blind) collected (1134)
Seat 6: Klemtonius (big blind) folded before Flop
Seat 8: JeBoyDirk folded before Flop (didn't bet)
Seat 9: dockstarrr folded before Flop



PokerStars Home Game Hand #226316372192: {DaPokaStars}  Hold'em No Limit (50/100) - 2021/04/29 18:26:49 ET
Table 'yes_sir' 9-max (Play Money) Seat #4 is the button
Seat 1: color_singleton (9748 in chips) 
Seat 2: manon327 (13458 in chips) 
Seat 4: PokerStarMan123 (11273 in chips) 
Seat 6: Klemtonius (11326 in chips) 
Seat 8: JeBoyDirk (20643 in chips) 
Seat 9: dockstarrr (6446 in chips) 
Klemtonius: posts small blind 50
JeBoyDirk: posts big blind 100
*** HOLE CARDS ***
Dealt to PokerStarMan123 [6s Td]
dockstarrr: calls 100
color_singleton: folds 
manon327: raises 100 to 200
PokerStarMan123: folds 
Klemtonius: calls 150
JeBoyDirk: folds 
dockstarrr: calls 100
*** FLOP *** [Kc Ah Kh]
Klemtonius: checks 
dockstarrr: checks 
JeBoyDirk leaves the table
manon327: bets 661
Klemtonius: folds 
dockstarrr: folds 
Uncalled bet (661) returned to manon327
manon327 collected 661 from pot
*** SUMMARY ***
Total pot 700 | Rake 39 
Board [Kc Ah Kh]
Seat 1: color_singleton folded before Flop (didn't bet)
Seat 2: manon327 collected (661)
Seat 4: PokerStarMan123 (button) folded before Flop (didn't bet)
Seat 6: Klemtonius (small blind) folded on the Flop
Seat 8: JeBoyDirk (big blind) folded before Flop
Seat 9: dockstarrr folded on the Flop



PokerStars Home Game Hand #226316385485: {DaPokaStars}  Hold'em No Limit (50/100) - 2021/04/29 18:27:19 ET
Table 'yes_sir' 9-max (Play Money) Seat #6 is the button
Seat 1: color_singleton (9748 in chips) 
Seat 2: manon327 (13919 in chips) 
Seat 4: PokerStarMan123 (11273 in chips) 
Seat 6: Klemtonius (11126 in chips) 
Seat 9: dockstarrr (6246 in chips) 
dockstarrr: posts small blind 50
color_singleton: posts big blind 100
*** HOLE CARDS ***
Dealt to PokerStarMan123 [5h Qd]
manon327: folds 
PokerStarMan123: folds 
Klemtonius: calls 100
dockstarrr: calls 50
color_singleton: checks 
*** FLOP *** [2d Ac Td]
dockstarrr: checks 
color_singleton: checks 
Klemtonius: bets 141
dockstarrr: folds 
color_singleton: folds 
Uncalled bet (141) returned to Klemtonius
Klemtonius collected 283 from pot
Klemtonius: doesn't show hand 
*** SUMMARY ***
Total pot 300 | Rake 17 
Board [2d Ac Td]
Seat 1: color_singleton (big blind) folded on the Flop
Seat 2: manon327 folded before Flop (didn't bet)
Seat 4: PokerStarMan123 folded before Flop (didn't bet)
Seat 6: Klemtonius (button) collected (283)
Seat 9: dockstarrr (small blind) folded on the Flop



PokerStars Home Game Hand #226316394874: {DaPokaStars}  Hold'em No Limit (50/100) - 2021/04/29 18:27:40 ET
Table 'yes_sir' 9-max (Play Money) Seat #9 is the button
Seat 1: color_singleton (9648 in chips) 
Seat 2: manon327 (13919 in chips) 
Seat 4: PokerStarMan123 (11273 in chips) 
Seat 6: Klemtonius (11309 in chips) 
Seat 9: dockstarrr (6146 in chips) 
color_singleton: posts small blind 50
manon327: posts big blind 100
*** HOLE CARDS ***
Dealt to PokerStarMan123 [Ts 3h]
PokerStarMan123: folds 
Klemtonius: raises 100 to 200
dockstarrr: calls 200
color_singleton: calls 150
manon327: folds 
*** FLOP *** [6s 4h 2c]
color_singleton: checks 
Klemtonius: bets 330
dockstarrr: folds 
color_singleton: calls 330
*** TURN *** [6s 4h 2c] [As]
color_singleton: checks 
Klemtonius: bets 1285
color_singleton: calls 1285
*** RIVER *** [6s 4h 2c As] [Jc]
color_singleton: bets 1857
Klemtonius: calls 1857
*** SHOW DOWN ***
color_singleton: shows [Ac Ks] (a pair of Aces)
Klemtonius: mucks hand 
color_singleton collected 7224 from pot
*** SUMMARY ***
Total pot 7644 | Rake 420 
Board [6s 4h 2c As Jc]
Seat 1: color_singleton (small blind) showed [Ac Ks] and won (7224) with a pair of Aces
Seat 2: manon327 (big blind) folded before Flop
Seat 4: PokerStarMan123 folded before Flop (didn't bet)
Seat 6: Klemtonius mucked [Ah 8s]
Seat 9: dockstarrr (button) folded on the Flop



PokerStars Home Game Hand #226316409924: {DaPokaStars}  Hold'em No Limit (50/100) - 2021/04/29 18:28:15 ET
Table 'yes_sir' 9-max (Play Money) Seat #1 is the button
Seat 1: color_singleton (13200 in chips) 
Seat 2: manon327 (13819 in chips) 
Seat 4: PokerStarMan123 (11273 in chips) 
Seat 6: Klemtonius (7637 in chips) 
Seat 9: dockstarrr (5946 in chips) 
manon327: posts small blind 50
PokerStarMan123: posts big blind 100
*** HOLE CARDS ***
Dealt to PokerStarMan123 [Kh 9s]
Klemtonius: raises 100 to 200
dockstarrr: folds 
color_singleton: folds 
manon327: folds 
PokerStarMan123: calls 100
*** FLOP *** [9h 3c 5d]
PokerStarMan123: bets 300
Klemtonius: calls 300
*** TURN *** [9h 3c 5d] [8s]
PokerStarMan123: bets 600
Klemtonius: calls 600
*** RIVER *** [9h 3c 5d 8s] [2d]
PokerStarMan123: bets 1300
Klemtonius: raises 1300 to 2600
PokerStarMan123: calls 1300
*** SHOW DOWN ***
Klemtonius: shows [6d 7d] (a straight, Five to Nine)
PokerStarMan123: mucks hand 
Klemtonius collected 7040 from pot
*** SUMMARY ***
Total pot 7450 | Rake 410 
Board [9h 3c 5d 8s 2d]
Seat 1: color_singleton (button) folded before Flop (didn't bet)
Seat 2: manon327 (small blind) folded before Flop
Seat 4: PokerStarMan123 (big blind) mucked [Kh 9s]
Seat 6: Klemtonius showed [6d 7d] and won (7040) with a straight, Five to Nine
Seat 9: dockstarrr folded before Flop (didn't bet)



PokerStars Home Game Hand #226316427136: {DaPokaStars}  Hold'em No Limit (50/100) - 2021/04/29 18:28:54 ET
Table 'yes_sir' 9-max (Play Money) Seat #2 is the button
Seat 1: color_singleton (13200 in chips) 
Seat 2: manon327 (13769 in chips) 
Seat 4: PokerStarMan123 (7573 in chips) 
Seat 6: Klemtonius (10977 in chips) 
Seat 9: dockstarrr (5946 in chips) 
PokerStarMan123: posts small blind 50
Klemtonius: posts big blind 100
*** HOLE CARDS ***
Dealt to PokerStarMan123 [7h Th]
dockstarrr: calls 100
color_singleton: raises 200 to 300
manon327: calls 300
PokerStarMan123: calls 250
Klemtonius: calls 200
dockstarrr: calls 200
*** FLOP *** [2d 3h 4d]
PokerStarMan123: checks 
Klemtonius: checks 
dockstarrr: checks 
color_singleton: checks 
manon327: checks 
*** TURN *** [2d 3h 4d] [9s]
PokerStarMan123: checks 
Klemtonius: checks 
dockstarrr: checks 
color_singleton: checks 
manon327: bets 1417
PokerStarMan123: folds 
Klemtonius: folds 
dockstarrr: folds 
color_singleton: folds 
Uncalled bet (1417) returned to manon327
manon327 collected 1417 from pot
*** SUMMARY ***
Total pot 1500 | Rake 83 
Board [2d 3h 4d 9s]
Seat 1: color_singleton folded on the Turn
Seat 2: manon327 (button) collected (1417)
Seat 4: PokerStarMan123 (small blind) folded on the Turn
Seat 6: Klemtonius (big blind) folded on the Turn
Seat 9: dockstarrr folded on the Turn



PokerStars Home Game Hand #226316450219: {DaPokaStars}  Hold'em No Limit (50/100) - 2021/04/29 18:29:47 ET
Table 'yes_sir' 9-max (Play Money) Seat #4 is the button
Seat 1: color_singleton (12900 in chips) 
Seat 2: manon327 (14886 in chips) 
Seat 4: PokerStarMan123 (7273 in chips) 
Seat 6: Klemtonius (10677 in chips) 
Seat 9: dockstarrr (5646 in chips) 
Klemtonius: posts small blind 50
dockstarrr: posts big blind 100
*** HOLE CARDS ***
Dealt to PokerStarMan123 [Ah Td]
color_singleton: folds 
manon327: calls 100
PokerStarMan123: raises 300 to 400
Klemtonius: calls 350
dockstarrr: folds 
manon327: folds 
*** FLOP *** [8h 3h 5s]
Klemtonius: checks 
PokerStarMan123: checks 
*** TURN *** [8h 3h 5s] [6c]
Klemtonius: checks 
PokerStarMan123: bets 500
Klemtonius: folds 
Uncalled bet (500) returned to PokerStarMan123
PokerStarMan123 collected 945 from pot
*** SUMMARY ***
Total pot 1000 | Rake 55 
Board [8h 3h 5s 6c]
Seat 1: color_singleton folded before Flop (didn't bet)
Seat 2: manon327 folded before Flop
Seat 4: PokerStarMan123 (button) collected (945)
Seat 6: Klemtonius (small blind) folded on the Turn
Seat 9: dockstarrr (big blind) folded before Flop



PokerStars Home Game Hand #226316466425: {DaPokaStars}  Hold'em No Limit (50/100) - 2021/04/29 18:30:24 ET
Table 'yes_sir' 9-max (Play Money) Seat #6 is the button
Seat 1: color_singleton (12900 in chips) 
Seat 2: manon327 (14786 in chips) 
Seat 4: PokerStarMan123 (7818 in chips) 
Seat 6: Klemtonius (10277 in chips) 
Seat 9: dockstarrr (5546 in chips) 
dockstarrr: posts small blind 50
color_singleton: posts big blind 100
*** HOLE CARDS ***
Dealt to PokerStarMan123 [7h 8h]
manon327: calls 100
PokerStarMan123: raises 300 to 400
Klemtonius: calls 400
dockstarrr: calls 350
color_singleton: calls 300
manon327: calls 300
*** FLOP *** [Jh 2h 9d]
dockstarrr: checks 
color_singleton: checks 
manon327: checks 
PokerStarMan123: bets 900
Klemtonius: folds 
dockstarrr: folds 
color_singleton: folds 
manon327: folds 
Uncalled bet (900) returned to PokerStarMan123
PokerStarMan123 collected 1890 from pot
*** SUMMARY ***
Total pot 2000 | Rake 110 
Board [Jh 2h 9d]
Seat 1: color_singleton (big blind) folded on the Flop
Seat 2: manon327 folded on the Flop
Seat 4: PokerStarMan123 collected (1890)
Seat 6: Klemtonius (button) folded on the Flop
Seat 9: dockstarrr (small blind) folded on the Flop



PokerStars Home Game Hand #226316489712: {DaPokaStars}  Hold'em No Limit (50/100) - 2021/04/29 18:31:16 ET
Table 'yes_sir' 9-max (Play Money) Seat #9 is the button
Seat 1: color_singleton (12500 in chips) 
Seat 2: manon327 (14386 in chips) 
Seat 4: PokerStarMan123 (9308 in chips) 
Seat 6: Klemtonius (9877 in chips) 
Seat 9: dockstarrr (5146 in chips) 
color_singleton: posts small blind 50
manon327: posts big blind 100
*** HOLE CARDS ***
Dealt to PokerStarMan123 [9s Ad]
PokerStarMan123: raises 300 to 400
Klemtonius: folds 
dockstarrr: folds 
color_singleton: calls 350
manon327: folds 
*** FLOP *** [6d Qc 2c]
color_singleton: checks 
PokerStarMan123: checks 
*** TURN *** [6d Qc 2c] [7d]
color_singleton: bets 425
PokerStarMan123: folds 
Uncalled bet (425) returned to color_singleton
color_singleton collected 850 from pot
color_singleton: doesn't show hand 
*** SUMMARY ***
Total pot 900 | Rake 50 
Board [6d Qc 2c 7d]
Seat 1: color_singleton (small blind) collected (850)
Seat 2: manon327 (big blind) folded before Flop
Seat 4: PokerStarMan123 folded on the Turn
Seat 6: Klemtonius folded before Flop (didn't bet)
Seat 9: dockstarrr (button) folded before Flop (didn't bet)



PokerStars Home Game Hand #226316498762: {DaPokaStars}  Hold'em No Limit (50/100) - 2021/04/29 18:31:37 ET
Table 'yes_sir' 9-max (Play Money) Seat #1 is the button
Seat 1: color_singleton (12950 in chips) 
Seat 2: manon327 (14286 in chips) 
Seat 4: PokerStarMan123 (8908 in chips) 
Seat 6: Klemtonius (9877 in chips) 
Seat 9: dockstarrr (5146 in chips) 
manon327: posts small blind 50
PokerStarMan123: posts big blind 100
*** HOLE CARDS ***
Dealt to PokerStarMan123 [5s Ks]
Klemtonius: folds 
dockstarrr: calls 100
color_singleton: raises 100 to 200
manon327: folds 
PokerStarMan123: calls 100
dockstarrr: calls 100
*** FLOP *** [8h Jd Kc]
PokerStarMan123: bets 300
dockstarrr: calls 300
color_singleton: calls 300
*** TURN *** [8h Jd Kc] [As]
PokerStarMan123: checks 
dockstarrr: bets 100
color_singleton: calls 100
PokerStarMan123: calls 100
*** RIVER *** [8h Jd Kc As] [Jc]
PokerStarMan123: bets 500
dockstarrr: calls 500
color_singleton: folds 
*** SHOW DOWN ***
PokerStarMan123: shows [5s Ks] (two pair, Kings and Jacks)
dockstarrr: shows [Kd Th] (two pair, Kings and Jacks)
PokerStarMan123 collected 1347 from pot
dockstarrr collected 1346 from pot
*** SUMMARY ***
Total pot 2850 | Rake 157 
Board [8h Jd Kc As Jc]
Seat 1: color_singleton (button) folded on the River
Seat 2: manon327 (small blind) folded before Flop
Seat 4: PokerStarMan123 (big blind) showed [5s Ks] and won (1347) with two pair, Kings and Jacks
Seat 6: Klemtonius folded before Flop (didn't bet)
Seat 9: dockstarrr showed [Kd Th] and won (1346) with two pair, Kings and Jacks



PokerStars Home Game Hand #226316518921: {DaPokaStars}  Hold'em No Limit (50/100) - 2021/04/29 18:32:22 ET
Table 'yes_sir' 9-max (Play Money) Seat #2 is the button
Seat 1: color_singleton (12350 in chips) 
Seat 2: manon327 (14236 in chips) 
Seat 4: PokerStarMan123 (9155 in chips) 
Seat 6: Klemtonius (9877 in chips) 
Seat 9: dockstarrr (5392 in chips) 
PokerStarMan123: posts small blind 50
Klemtonius: posts big blind 100
*** HOLE CARDS ***
Dealt to PokerStarMan123 [5d Jh]
dockstarrr: folds 
color_singleton: raises 100 to 200
manon327: folds 
PokerStarMan123: folds 
Klemtonius: raises 100 to 300
color_singleton: calls 100
*** FLOP *** [Tc 8c 7s]
Klemtonius: checks 
color_singleton: bets 307
Klemtonius: folds 
Uncalled bet (307) returned to color_singleton
color_singleton collected 614 from pot
color_singleton: doesn't show hand 
*** SUMMARY ***
Total pot 650 | Rake 36 
Board [Tc 8c 7s]
Seat 1: color_singleton collected (614)
Seat 2: manon327 (button) folded before Flop (didn't bet)
Seat 4: PokerStarMan123 (small blind) folded before Flop
Seat 6: Klemtonius (big blind) folded on the Flop
Seat 9: dockstarrr folded before Flop (didn't bet)



PokerStars Home Game Hand #226316531765: {DaPokaStars}  Hold'em No Limit (50/100) - 2021/04/29 18:32:51 ET
Table 'yes_sir' 9-max (Play Money) Seat #4 is the button
Seat 1: color_singleton (12664 in chips) 
Seat 2: manon327 (14236 in chips) 
Seat 4: PokerStarMan123 (9105 in chips) 
Seat 6: Klemtonius (9577 in chips) 
Seat 9: dockstarrr (5392 in chips) 
Klemtonius: posts small blind 50
dockstarrr: posts big blind 100
*** HOLE CARDS ***
Dealt to PokerStarMan123 [Kh Ad]
color_singleton: raises 200 to 300
manon327: folds 
PokerStarMan123: raises 500 to 800
Klemtonius: folds 
dockstarrr: calls 700
color_singleton: calls 500
*** FLOP *** [Qs 6c 2d]
dockstarrr: checks 
color_singleton: bets 2315
PokerStarMan123: folds 
dockstarrr: folds 
Uncalled bet (2315) returned to color_singleton
color_singleton collected 2315 from pot
color_singleton: doesn't show hand 
*** SUMMARY ***
Total pot 2450 | Rake 135 
Board [Qs 6c 2d]
Seat 1: color_singleton collected (2315)
Seat 2: manon327 folded before Flop (didn't bet)
Seat 4: PokerStarMan123 (button) folded on the Flop
Seat 6: Klemtonius (small blind) folded before Flop
Seat 9: dockstarrr (big blind) folded on the Flop



PokerStars Home Game Hand #226316548034: {DaPokaStars}  Hold'em No Limit (50/100) - 2021/04/29 18:33:28 ET
Table 'yes_sir' 9-max (Play Money) Seat #6 is the button
Seat 1: color_singleton (14179 in chips) 
Seat 2: manon327 (14236 in chips) 
Seat 4: PokerStarMan123 (8305 in chips) 
Seat 6: Klemtonius (9527 in chips) 
Seat 9: dockstarrr (4592 in chips) 
dockstarrr: posts small blind 50
color_singleton: posts big blind 100
*** HOLE CARDS ***
Dealt to PokerStarMan123 [8s Jc]
manon327: folds 
PokerStarMan123: folds 
Klemtonius: calls 100
dockstarrr: calls 50
color_singleton: checks 
*** FLOP *** [4h 4s 4d]
dockstarrr: checks 
color_singleton: checks 
Klemtonius: checks 
*** TURN *** [4h 4s 4d] [9c]
dockstarrr has timed out
dockstarrr: checks 
color_singleton: checks 
Klemtonius: checks 
*** RIVER *** [4h 4s 4d 9c] [2c]
dockstarrr: checks 
color_singleton: checks 
Klemtonius: checks 
*** SHOW DOWN ***
dockstarrr: shows [Ks Jh] (three of a kind, Fours)
color_singleton: mucks hand 
Klemtonius: mucks hand 
dockstarrr collected 283 from pot
*** SUMMARY ***
Total pot 300 | Rake 17 
Board [4h 4s 4d 9c 2c]
Seat 1: color_singleton (big blind) mucked [Qc 8d]
Seat 2: manon327 folded before Flop (didn't bet)
Seat 4: PokerStarMan123 folded before Flop (didn't bet)
Seat 6: Klemtonius (button) mucked [5s Th]
Seat 9: dockstarrr (small blind) showed [Ks Jh] and won (283) with three of a kind, Fours



PokerStars Home Game Hand #226316568956: {DaPokaStars}  Hold'em No Limit (50/100) - 2021/04/29 18:34:15 ET
Table 'yes_sir' 9-max (Play Money) Seat #9 is the button
Seat 1: color_singleton (14079 in chips) 
Seat 2: manon327 (14236 in chips) 
Seat 4: PokerStarMan123 (8305 in chips) 
Seat 6: Klemtonius (9427 in chips) 
Seat 9: dockstarrr (4775 in chips) 
color_singleton: posts small blind 50
manon327: posts big blind 100
*** HOLE CARDS ***
Dealt to PokerStarMan123 [6d Qs]
PokerStarMan123: folds 
Klemtonius: calls 100
dockstarrr: calls 100
color_singleton: raises 200 to 300
manon327: folds 
Klemtonius: folds 
dockstarrr: folds 
Uncalled bet (200) returned to color_singleton
color_singleton collected 400 from pot
color_singleton: doesn't show hand 
*** SUMMARY ***
Total pot 400 | Rake 0 
Seat 1: color_singleton (small blind) collected (400)
Seat 2: manon327 (big blind) folded before Flop
Seat 4: PokerStarMan123 folded before Flop (didn't bet)
Seat 6: Klemtonius folded before Flop
Seat 9: dockstarrr (button) folded before Flop



PokerStars Home Game Hand #226316581568: {DaPokaStars}  Hold'em No Limit (50/100) - 2021/04/29 18:34:44 ET
Table 'yes_sir' 9-max (Play Money) Seat #1 is the button
Seat 1: color_singleton (14379 in chips) 
Seat 2: manon327 (14136 in chips) 
Seat 4: PokerStarMan123 (8305 in chips) 
Seat 6: Klemtonius (9327 in chips) 
Seat 9: dockstarrr (4675 in chips) 
manon327: posts small blind 50
PokerStarMan123: posts big blind 100
*** HOLE CARDS ***
Dealt to PokerStarMan123 [4s 8c]
Klemtonius: calls 100
dockstarrr: calls 100
color_singleton: raises 200 to 300
manon327: folds 
PokerStarMan123: folds 
Klemtonius: calls 200
dockstarrr: calls 200
*** FLOP *** [8d 2h 9c]
Klemtonius: checks 
dockstarrr: bets 496
color_singleton: folds 
Klemtonius: folds 
Uncalled bet (496) returned to dockstarrr
dockstarrr collected 992 from pot
dockstarrr: doesn't show hand 
*** SUMMARY ***
Total pot 1050 | Rake 58 
Board [8d 2h 9c]
Seat 1: color_singleton (button) folded on the Flop
Seat 2: manon327 (small blind) folded before Flop
Seat 4: PokerStarMan123 (big blind) folded before Flop
Seat 6: Klemtonius folded on the Flop
Seat 9: dockstarrr collected (992)



PokerStars Home Game Hand #226316596987: {DaPokaStars}  Hold'em No Limit (50/100) - 2021/04/29 18:35:19 ET
Table 'yes_sir' 9-max (Play Money) Seat #2 is the button
Seat 1: color_singleton (14079 in chips) 
Seat 2: manon327 (14086 in chips) 
Seat 4: PokerStarMan123 (8205 in chips) 
Seat 6: Klemtonius (9027 in chips) 
Seat 9: dockstarrr (5367 in chips) 
PokerStarMan123: posts small blind 50
Klemtonius: posts big blind 100
*** HOLE CARDS ***
Dealt to PokerStarMan123 [3c 5c]
dockstarrr has timed out
dockstarrr: folds 
color_singleton: folds 
manon327: folds 
PokerStarMan123: calls 50
Klemtonius: raises 100 to 200
PokerStarMan123: calls 100
*** FLOP *** [Jh Ac 2d]
PokerStarMan123: checks 
Klemtonius: bets 189
PokerStarMan123: folds 
Uncalled bet (189) returned to Klemtonius
Klemtonius collected 378 from pot
Klemtonius: doesn't show hand 
*** SUMMARY ***
Total pot 400 | Rake 22 
Board [Jh Ac 2d]
Seat 1: color_singleton folded before Flop (didn't bet)
Seat 2: manon327 (button) folded before Flop (didn't bet)
Seat 4: PokerStarMan123 (small blind) folded on the Flop
Seat 6: Klemtonius (big blind) collected (378)
Seat 9: dockstarrr folded before Flop (didn't bet)



PokerStars Home Game Hand #226316611488: {DaPokaStars}  Hold'em No Limit (50/100) - 2021/04/29 18:35:51 ET
Table 'yes_sir' 9-max (Play Money) Seat #4 is the button
Seat 1: color_singleton (14079 in chips) 
Seat 2: manon327 (14086 in chips) 
Seat 4: PokerStarMan123 (8005 in chips) 
Seat 6: Klemtonius (9205 in chips) 
Seat 9: dockstarrr (5367 in chips) 
Klemtonius: posts small blind 50
dockstarrr: posts big blind 100
*** HOLE CARDS ***
Dealt to PokerStarMan123 [4d 6d]
color_singleton: folds 
manon327: calls 100
PokerStarMan123: calls 100
Klemtonius: raises 400 to 500
dockstarrr: calls 400
manon327: calls 400
PokerStarMan123: calls 400
*** FLOP *** [3c 7d 3s]
Klemtonius: checks 
dockstarrr: checks 
manon327: checks 
PokerStarMan123: checks 
*** TURN *** [3c 7d 3s] [Qc]
Klemtonius: checks 
dockstarrr: checks 
manon327: checks 
PokerStarMan123: checks 
*** RIVER *** [3c 7d 3s Qc] [4h]
Klemtonius: checks 
dockstarrr: checks 
manon327: checks 
PokerStarMan123: checks 
*** SHOW DOWN ***
Klemtonius: shows [Jh Ks] (a pair of Threes)
dockstarrr: shows [Ad 2d] (a pair of Threes - Ace kicker)
manon327: mucks hand 
PokerStarMan123: shows [4d 6d] (two pair, Fours and Threes)
PokerStarMan123 collected 1890 from pot
*** SUMMARY ***
Total pot 2000 | Rake 110 
Board [3c 7d 3s Qc 4h]
Seat 1: color_singleton folded before Flop (didn't bet)
Seat 2: manon327 mucked [Kd 8h]
Seat 4: PokerStarMan123 (button) showed [4d 6d] and won (1890) with two pair, Fours and Threes
Seat 6: Klemtonius (small blind) showed [Jh Ks] and lost with a pair of Threes
Seat 9: dockstarrr (big blind) showed [Ad 2d] and lost with a pair of Threes



PokerStars Home Game Hand #226316632312: {DaPokaStars}  Hold'em No Limit (50/100) - 2021/04/29 18:36:39 ET
Table 'yes_sir' 9-max (Play Money) Seat #6 is the button
Seat 1: color_singleton (14079 in chips) 
Seat 2: manon327 (13586 in chips) 
Seat 4: PokerStarMan123 (9395 in chips) 
Seat 6: Klemtonius (8705 in chips) 
Seat 9: dockstarrr (4867 in chips) 
dockstarrr: posts small blind 50
color_singleton: posts big blind 100
*** HOLE CARDS ***
Dealt to PokerStarMan123 [2d Ac]
manon327: folds 
PokerStarMan123: folds 
Klemtonius: raises 200 to 300
dockstarrr: calls 250
color_singleton: calls 200
*** FLOP *** [Kc 2s 4h]
dockstarrr: checks 
color_singleton: checks 
Klemtonius: bets 425
dockstarrr: folds 
color_singleton: folds 
Uncalled bet (425) returned to Klemtonius
Klemtonius collected 850 from pot
Klemtonius: doesn't show hand 
*** SUMMARY ***
Total pot 900 | Rake 50 
Board [Kc 2s 4h]
Seat 1: color_singleton (big blind) folded on the Flop
Seat 2: manon327 folded before Flop (didn't bet)
Seat 4: PokerStarMan123 folded before Flop (didn't bet)
Seat 6: Klemtonius (button) collected (850)
Seat 9: dockstarrr (small blind) folded on the Flop



PokerStars Home Game Hand #226316648469: {DaPokaStars}  Hold'em No Limit (50/100) - 2021/04/29 18:37:15 ET
Table 'yes_sir' 9-max (Play Money) Seat #9 is the button
Seat 1: color_singleton (13779 in chips) 
Seat 2: manon327 (13586 in chips) 
Seat 4: PokerStarMan123 (9395 in chips) 
Seat 6: Klemtonius (9255 in chips) 
Seat 9: dockstarrr (4567 in chips) 
color_singleton: posts small blind 50
manon327: posts big blind 100
*** HOLE CARDS ***
Dealt to PokerStarMan123 [Kd 9s]
PokerStarMan123: calls 100
Klemtonius: folds 
dockstarrr: folds 
color_singleton: calls 50
manon327: checks 
*** FLOP *** [3s 7s 5s]
color_singleton: checks 
manon327: checks 
PokerStarMan123: checks 
*** TURN *** [3s 7s 5s] [As]
color_singleton: bets 141
manon327: folds 
PokerStarMan123: calls 141
*** RIVER *** [3s 7s 5s As] [Td]
color_singleton: checks 
PokerStarMan123: bets 500
color_singleton has timed out
color_singleton: folds 
Uncalled bet (500) returned to PokerStarMan123
PokerStarMan123 collected 550 from pot
*** SUMMARY ***
Total pot 582 | Rake 32 
Board [3s 7s 5s As Td]
Seat 1: color_singleton (small blind) folded on the River
Seat 2: manon327 (big blind) folded on the Turn
Seat 4: PokerStarMan123 collected (550)
Seat 6: Klemtonius folded before Flop (didn't bet)
Seat 9: dockstarrr (button) folded before Flop (didn't bet)



PokerStars Home Game Hand #226316670290: {DaPokaStars}  Hold'em No Limit (50/100) - 2021/04/29 18:38:04 ET
Table 'yes_sir' 9-max (Play Money) Seat #1 is the button
Seat 1: color_singleton (13538 in chips) 
Seat 2: manon327 (13486 in chips) 
Seat 4: PokerStarMan123 (9704 in chips) 
Seat 6: Klemtonius (9255 in chips) 
Seat 9: dockstarrr (4567 in chips) 
manon327: posts small blind 50
PokerStarMan123: posts big blind 100
*** HOLE CARDS ***
Dealt to PokerStarMan123 [3c Ts]
Klemtonius: calls 100
dockstarrr: calls 100
color_singleton: calls 100
manon327: calls 50
PokerStarMan123: checks 
*** FLOP *** [4h 7s Qc]
manon327: checks 
PokerStarMan123: checks 
Klemtonius: checks 
dockstarrr: checks 
color_singleton: bets 236
manon327: folds 
PokerStarMan123: folds 
Klemtonius: folds 
dockstarrr: folds 
Uncalled bet (236) returned to color_singleton
color_singleton collected 472 from pot
color_singleton: doesn't show hand 
*** SUMMARY ***
Total pot 500 | Rake 28 
Board [4h 7s Qc]
Seat 1: color_singleton (button) collected (472)
Seat 2: manon327 (small blind) folded on the Flop
Seat 4: PokerStarMan123 (big blind) folded on the Flop
Seat 6: Klemtonius folded on the Flop
Seat 9: dockstarrr folded on the Flop



PokerStars Home Game Hand #226316683672: {DaPokaStars}  Hold'em No Limit (50/100) - 2021/04/29 18:38:35 ET
Table 'yes_sir' 9-max (Play Money) Seat #2 is the button
Seat 1: color_singleton (13910 in chips) 
Seat 2: manon327 (13386 in chips) 
Seat 4: PokerStarMan123 (9604 in chips) 
Seat 6: Klemtonius (9155 in chips) 
Seat 9: dockstarrr (4467 in chips) 
PokerStarMan123: posts small blind 50
Klemtonius: posts big blind 100
*** HOLE CARDS ***
Dealt to PokerStarMan123 [8d 3c]
dockstarrr: folds 
color_singleton: raises 100 to 200
manon327: calls 200
PokerStarMan123: folds 
Klemtonius: raises 100 to 300
color_singleton: calls 100
manon327: calls 100
*** FLOP *** [6h Qc 9h]
Klemtonius: checks 
color_singleton: bets 449
manon327: folds 
Klemtonius: folds 
Uncalled bet (449) returned to color_singleton
color_singleton collected 898 from pot
color_singleton: doesn't show hand 
*** SUMMARY ***
Total pot 950 | Rake 52 
Board [6h Qc 9h]
Seat 1: color_singleton collected (898)
Seat 2: manon327 (button) folded on the Flop
Seat 4: PokerStarMan123 (small blind) folded before Flop
Seat 6: Klemtonius (big blind) folded on the Flop
Seat 9: dockstarrr folded before Flop (didn't bet)



PokerStars Home Game Hand #226316700772: {DaPokaStars}  Hold'em No Limit (50/100) - 2021/04/29 18:39:14 ET
Table 'yes_sir' 9-max (Play Money) Seat #4 is the button
Seat 1: color_singleton (14508 in chips) 
Seat 2: manon327 (13086 in chips) 
Seat 4: PokerStarMan123 (9554 in chips) 
Seat 6: Klemtonius (8855 in chips) 
Seat 9: dockstarrr (4467 in chips) 
Klemtonius: posts small blind 50
dockstarrr: posts big blind 100
*** HOLE CARDS ***
Dealt to PokerStarMan123 [7d 4c]
color_singleton: folds 
manon327: folds 
PokerStarMan123: folds 
Klemtonius: calls 50
dockstarrr: checks 
*** FLOP *** [Ah Tc 8d]
Klemtonius: checks 
dockstarrr: checks 
*** TURN *** [Ah Tc 8d] [Qc]
Klemtonius: checks 
dockstarrr: checks 
*** RIVER *** [Ah Tc 8d Qc] [5s]
Klemtonius: checks 
dockstarrr: checks 
*** SHOW DOWN ***
Klemtonius: shows [8h 3d] (a pair of Eights)
dockstarrr: mucks hand 
Klemtonius collected 189 from pot
*** SUMMARY ***
Total pot 200 | Rake 11 
Board [Ah Tc 8d Qc 5s]
Seat 1: color_singleton folded before Flop (didn't bet)
Seat 2: manon327 folded before Flop (didn't bet)
Seat 4: PokerStarMan123 (button) folded before Flop (didn't bet)
Seat 6: Klemtonius (small blind) showed [8h 3d] and won (189) with a pair of Eights
Seat 9: dockstarrr (big blind) mucked [3s 6h]



PokerStars Home Game Hand #226316713860: {DaPokaStars}  Hold'em No Limit (50/100) - 2021/04/29 18:39:44 ET
Table 'yes_sir' 9-max (Play Money) Seat #6 is the button
Seat 1: color_singleton (14508 in chips) 
Seat 2: manon327 (13086 in chips) 
Seat 4: PokerStarMan123 (9554 in chips) 
Seat 6: Klemtonius (8944 in chips) 
Seat 9: dockstarrr (4367 in chips) 
dockstarrr: posts small blind 50
color_singleton: posts big blind 100
*** HOLE CARDS ***
Dealt to PokerStarMan123 [Jh 3c]
manon327: folds 
PokerStarMan123: folds 
Klemtonius: raises 100 to 200
dockstarrr: folds 
color_singleton: calls 100
*** FLOP *** [9s Ad 6c]
color_singleton: bets 212
Klemtonius: calls 212
*** TURN *** [9s Ad 6c] [9c]
color_singleton: checks 
Klemtonius: bets 413
color_singleton: folds 
Uncalled bet (413) returned to Klemtonius
Klemtonius collected 826 from pot
Klemtonius: doesn't show hand 
*** SUMMARY ***
Total pot 874 | Rake 48 
Board [9s Ad 6c 9c]
Seat 1: color_singleton (big blind) folded on the Turn
Seat 2: manon327 folded before Flop (didn't bet)
Seat 4: PokerStarMan123 folded before Flop (didn't bet)
Seat 6: Klemtonius (button) collected (826)
Seat 9: dockstarrr (small blind) folded before Flop



PokerStars Home Game Hand #226316725398: {DaPokaStars}  Hold'em No Limit (50/100) - 2021/04/29 18:40:11 ET
Table 'yes_sir' 9-max (Play Money) Seat #9 is the button
Seat 1: color_singleton (14096 in chips) 
Seat 2: manon327 (13086 in chips) 
Seat 4: PokerStarMan123 (9554 in chips) 
Seat 6: Klemtonius (9358 in chips) 
Seat 9: dockstarrr (4317 in chips) 
color_singleton: posts small blind 50
manon327: posts big blind 100
*** HOLE CARDS ***
Dealt to PokerStarMan123 [4h Jh]
PokerStarMan123 has timed out
PokerStarMan123: folds 
Klemtonius: calls 100
dockstarrr: folds 
color_singleton: folds 
manon327: checks 
*** FLOP *** [Ad 8d Kc]
manon327: checks 
Klemtonius: checks 
*** TURN *** [Ad 8d Kc] [9h]
manon327: checks 
Klemtonius: checks 
*** RIVER *** [Ad 8d Kc 9h] [Ks]
manon327: checks 
Klemtonius: checks 
*** SHOW DOWN ***
manon327: shows [5c 8c] (two pair, Kings and Eights)
Klemtonius: mucks hand 
manon327 collected 236 from pot
*** SUMMARY ***
Total pot 250 | Rake 14 
Board [Ad 8d Kc 9h Ks]
Seat 1: color_singleton (small blind) folded before Flop
Seat 2: manon327 (big blind) showed [5c 8c] and won (236) with two pair, Kings and Eights
Seat 4: PokerStarMan123 folded before Flop (didn't bet)
Seat 6: Klemtonius mucked [3s Ts]
Seat 9: dockstarrr (button) folded before Flop (didn't bet)



PokerStars Home Game Hand #226316787219: {DaPokaStars}  Hold'em No Limit (50/100) - 2021/04/29 18:42:35 ET
Table 'yes_sir' 9-max (Play Money) Seat #9 is the button
Seat 1: color_singleton (17609 in chips) 
Seat 2: manon327 (9399 in chips) 
Seat 4: PokerStarMan123 (9554 in chips) 
Seat 6: Klemtonius (9778 in chips) 
Seat 9: dockstarrr (3567 in chips) 
color_singleton: posts small blind 50
manon327: posts big blind 100
PokerStarMan123: posts small & big blinds 150
*** HOLE CARDS ***
Dealt to PokerStarMan123 [9s 2s]
PokerStarMan123: checks 
Klemtonius: folds 
dockstarrr: calls 100
color_singleton: raises 300 to 400
manon327: calls 300
PokerStarMan123: folds 
dockstarrr: calls 300
*** FLOP *** [Tc 2h Ah]
color_singleton: checks 
manon327: bets 638
dockstarrr: folds 
color_singleton: calls 638
*** TURN *** [Tc 2h Ah] [Kd]
color_singleton: bets 100
manon327: calls 100
*** RIVER *** [Tc 2h Ah Kd] [7d]
color_singleton: bets 1335
manon327: folds 
Uncalled bet (1335) returned to color_singleton
color_singleton collected 2671 from pot
color_singleton: doesn't show hand 
*** SUMMARY ***
Total pot 2826 | Rake 155 
Board [Tc 2h Ah Kd 7d]
Seat 1: color_singleton (small blind) collected (2671)
Seat 2: manon327 (big blind) folded on the River
Seat 4: PokerStarMan123 folded before Flop (didn't bet)
Seat 6: Klemtonius folded before Flop (didn't bet)
Seat 9: dockstarrr (button) folded on the Flop



PokerStars Home Game Hand #226316811120: {DaPokaStars}  Hold'em No Limit (50/100) - 2021/04/29 18:43:31 ET
Table 'yes_sir' 9-max (Play Money) Seat #1 is the button
Seat 1: color_singleton (19142 in chips) 
Seat 2: manon327 (8261 in chips) 
Seat 4: PokerStarMan123 (9404 in chips) 
Seat 6: Klemtonius (9778 in chips) 
Seat 9: dockstarrr (3167 in chips) 
manon327: posts small blind 50
PokerStarMan123: posts big blind 100
*** HOLE CARDS ***
Dealt to PokerStarMan123 [Js 9h]
Klemtonius: calls 100
dockstarrr: calls 100
color_singleton: folds 
manon327: calls 50
PokerStarMan123: checks 
*** FLOP *** [Kh 3s 3d]
manon327: bets 189
PokerStarMan123: folds 
Klemtonius: calls 189
dockstarrr: calls 189
*** TURN *** [Kh 3s 3d] [Jc]
manon327: bets 457
Klemtonius: raises 457 to 914
dockstarrr: folds 
manon327: calls 457
*** RIVER *** [Kh 3s 3d Jc] [Qd]
manon327: checks 
Klemtonius: bets 1320
manon327: folds 
Uncalled bet (1320) returned to Klemtonius
Klemtonius collected 2641 from pot
Klemtonius: doesn't show hand 
*** SUMMARY ***
Total pot 2795 | Rake 154 
Board [Kh 3s 3d Jc Qd]
Seat 1: color_singleton (button) folded before Flop (didn't bet)
Seat 2: manon327 (small blind) folded on the River
Seat 4: PokerStarMan123 (big blind) folded on the Flop
Seat 6: Klemtonius collected (2641)
Seat 9: dockstarrr folded on the Turn



PokerStars Home Game Hand #226316833130: {DaPokaStars}  Hold'em No Limit (50/100) - 2021/04/29 18:44:23 ET
Table 'yes_sir' 9-max (Play Money) Seat #2 is the button
Seat 1: color_singleton (19142 in chips) 
Seat 2: manon327 (7058 in chips) 
Seat 4: PokerStarMan123 (9304 in chips) 
Seat 6: Klemtonius (11216 in chips) 
Seat 9: dockstarrr (2878 in chips) 
PokerStarMan123: posts small blind 50
Klemtonius: posts big blind 100
*** HOLE CARDS ***
Dealt to PokerStarMan123 [8s As]
dockstarrr: folds 
color_singleton: folds 
manon327: folds 
PokerStarMan123: raises 300 to 400
Klemtonius: calls 300
*** FLOP *** [5c 6d 3s]
PokerStarMan123: bets 500
Klemtonius: calls 500
*** TURN *** [5c 6d 3s] [2s]
PokerStarMan123: bets 900
Klemtonius has timed out
Klemtonius: folds 
Uncalled bet (900) returned to PokerStarMan123
PokerStarMan123 collected 1701 from pot
*** SUMMARY ***
Total pot 1800 | Rake 99 
Board [5c 6d 3s 2s]
Seat 1: color_singleton folded before Flop (didn't bet)
Seat 2: manon327 (button) folded before Flop (didn't bet)
Seat 4: PokerStarMan123 (small blind) collected (1701)
Seat 6: Klemtonius (big blind) folded on the Turn
Seat 9: dockstarrr folded before Flop (didn't bet)



PokerStars Home Game Hand #226316858737: {DaPokaStars}  Hold'em No Limit (50/100) - 2021/04/29 18:45:24 ET
Table 'yes_sir' 9-max (Play Money) Seat #4 is the button
Seat 1: color_singleton (19142 in chips) 
Seat 2: manon327 (7058 in chips) 
Seat 4: PokerStarMan123 (10105 in chips) 
Seat 9: dockstarrr (2878 in chips) 
dockstarrr: posts small blind 50
color_singleton: posts big blind 100
*** HOLE CARDS ***
Dealt to PokerStarMan123 [Jd Ac]
manon327: folds 
PokerStarMan123: raises 300 to 400
dockstarrr: calls 350
color_singleton: calls 300
*** FLOP *** [8h 2c 3c]
dockstarrr: checks 
color_singleton: checks 
PokerStarMan123: bets 600
dockstarrr: folds 
color_singleton: folds 
Uncalled bet (600) returned to PokerStarMan123
PokerStarMan123 collected 1134 from pot
*** SUMMARY ***
Total pot 1200 | Rake 66 
Board [8h 2c 3c]
Seat 1: color_singleton (big blind) folded on the Flop
Seat 2: manon327 folded before Flop (didn't bet)
Seat 4: PokerStarMan123 (button) collected (1134)
Seat 9: dockstarrr (small blind) folded on the Flop



PokerStars Home Game Hand #226316874762: {DaPokaStars}  Hold'em No Limit (50/100) - 2021/04/29 18:46:02 ET
Table 'yes_sir' 9-max (Play Money) Seat #9 is the button
Seat 1: color_singleton (18742 in chips) 
Seat 2: manon327 (7058 in chips) 
Seat 4: PokerStarMan123 (10839 in chips) 
Seat 6: Klemtonius (10316 in chips) 
Seat 9: dockstarrr (2478 in chips) 
color_singleton: posts small blind 50
manon327: posts big blind 100
Klemtonius: posts small blind 50
*** HOLE CARDS ***
Dealt to PokerStarMan123 [Js Ah]
PokerStarMan123: raises 400 to 500
Klemtonius: folds 
dockstarrr: folds 
color_singleton: folds 
manon327: folds 
Uncalled bet (400) returned to PokerStarMan123
PokerStarMan123 collected 300 from pot
*** SUMMARY ***
Total pot 300 | Rake 0 
Seat 1: color_singleton (small blind) folded before Flop
Seat 2: manon327 (big blind) folded before Flop
Seat 4: PokerStarMan123 collected (300)
Seat 6: Klemtonius folded before Flop (didn't bet)
Seat 9: dockstarrr (button) folded before Flop (didn't bet)



PokerStars Home Game Hand #226316879027: {DaPokaStars}  Hold'em No Limit (50/100) - 2021/04/29 18:46:12 ET
Table 'yes_sir' 9-max (Play Money) Seat #1 is the button
Seat 1: color_singleton (18692 in chips) 
Seat 2: manon327 (6958 in chips) 
Seat 4: PokerStarMan123 (11039 in chips) 
Seat 6: Klemtonius (10266 in chips) 
Seat 9: dockstarrr (2478 in chips) 
manon327: posts small blind 50
PokerStarMan123: posts big blind 100
*** HOLE CARDS ***
Dealt to PokerStarMan123 [Ad Jh]
Klemtonius: calls 100
dockstarrr: folds 
color_singleton: calls 100
manon327: folds 
PokerStarMan123: raises 400 to 500
Klemtonius: calls 400
color_singleton: calls 400
*** FLOP *** [4c Tc Qh]
PokerStarMan123: checks 
Klemtonius: checks 
color_singleton: bets 732
PokerStarMan123: folds 
Klemtonius: folds 
Uncalled bet (732) returned to color_singleton
color_singleton collected 1465 from pot
color_singleton: doesn't show hand 
*** SUMMARY ***
Total pot 1550 | Rake 85 
Board [4c Tc Qh]
Seat 1: color_singleton (button) collected (1465)
Seat 2: manon327 (small blind) folded before Flop
Seat 4: PokerStarMan123 (big blind) folded on the Flop
Seat 6: Klemtonius folded on the Flop
Seat 9: dockstarrr folded before Flop (didn't bet)



PokerStars Home Game Hand #226316893398: {DaPokaStars}  Hold'em No Limit (50/100) - 2021/04/29 18:46:46 ET
Table 'yes_sir' 9-max (Play Money) Seat #2 is the button
Seat 1: color_singleton (19657 in chips) 
Seat 2: manon327 (6908 in chips) 
Seat 4: PokerStarMan123 (10539 in chips) 
Seat 6: Klemtonius (9766 in chips) 
Seat 9: dockstarrr (2478 in chips) 
PokerStarMan123: posts small blind 50
Klemtonius: posts big blind 100
*** HOLE CARDS ***
Dealt to PokerStarMan123 [Kd 9s]
dockstarrr: calls 100
color_singleton: folds 
manon327: folds 
PokerStarMan123: calls 50
Klemtonius: checks 
*** FLOP *** [4d 6d 5c]
PokerStarMan123: bets 200
Klemtonius: calls 200
dockstarrr: folds 
*** TURN *** [4d 6d 5c] [4s]
PokerStarMan123: checks 
Klemtonius: checks 
*** RIVER *** [4d 6d 5c 4s] [Ad]
PokerStarMan123: checks 
Klemtonius: bets 330
PokerStarMan123: folds 
Uncalled bet (330) returned to Klemtonius
Klemtonius collected 661 from pot
Klemtonius: doesn't show hand 
*** SUMMARY ***
Total pot 700 | Rake 39 
Board [4d 6d 5c 4s Ad]
Seat 1: color_singleton folded before Flop (didn't bet)
Seat 2: manon327 (button) folded before Flop (didn't bet)
Seat 4: PokerStarMan123 (small blind) folded on the River
Seat 6: Klemtonius (big blind) collected (661)
Seat 9: dockstarrr folded on the Flop



PokerStars Home Game Hand #226316916762: {DaPokaStars}  Hold'em No Limit (50/100) - 2021/04/29 18:47:42 ET
Table 'yes_sir' 9-max (Play Money) Seat #4 is the button
Seat 1: color_singleton (19657 in chips) 
Seat 2: manon327 (6908 in chips) 
Seat 4: PokerStarMan123 (10239 in chips) 
Seat 6: Klemtonius (10127 in chips) 
Seat 9: dockstarrr (2378 in chips) 
Klemtonius: posts small blind 50
dockstarrr: posts big blind 100
*** HOLE CARDS ***
Dealt to PokerStarMan123 [7h 4h]
color_singleton: folds 
manon327: calls 100
PokerStarMan123: calls 100
Klemtonius: calls 50
dockstarrr: checks 
*** FLOP *** [5d 9s 5c]
Klemtonius: checks 
dockstarrr: checks 
manon327: bets 100
PokerStarMan123: folds 
Klemtonius: calls 100
dockstarrr: folds 
*** TURN *** [5d 9s 5c] [Ad]
Klemtonius: checks 
manon327: bets 283
Klemtonius: folds 
Uncalled bet (283) returned to manon327
manon327 collected 567 from pot
*** SUMMARY ***
Total pot 600 | Rake 33 
Board [5d 9s 5c Ad]
Seat 1: color_singleton folded before Flop (didn't bet)
Seat 2: manon327 collected (567)
Seat 4: PokerStarMan123 (button) folded on the Flop
Seat 6: Klemtonius (small blind) folded on the Turn
Seat 9: dockstarrr (big blind) folded on the Flop



PokerStars Home Game Hand #226316936798: {DaPokaStars}  Hold'em No Limit (50/100) - 2021/04/29 18:48:29 ET
Table 'yes_sir' 9-max (Play Money) Seat #6 is the button
Seat 1: color_singleton (19657 in chips) 
Seat 2: manon327 (7275 in chips) 
Seat 4: PokerStarMan123 (10139 in chips) 
Seat 6: Klemtonius (9927 in chips) 
Seat 9: dockstarrr (2278 in chips) 
dockstarrr: posts small blind 50
color_singleton: posts big blind 100
*** HOLE CARDS ***
Dealt to PokerStarMan123 [4s 5s]
manon327: raises 100 to 200
PokerStarMan123: calls 200
Klemtonius: calls 200
dockstarrr: calls 150
color_singleton: calls 100
*** FLOP *** [Kd 7s 7c]
dockstarrr: bets 200
color_singleton: raises 672 to 872
manon327: folds 
PokerStarMan123: folds 
Klemtonius: folds 
dockstarrr: calls 672
*** TURN *** [Kd 7s 7c] [2h]
dockstarrr: bets 100
color_singleton: calls 100
*** RIVER *** [Kd 7s 7c 2h] [4d]
dockstarrr: checks 
color_singleton: checks 
*** SHOW DOWN ***
dockstarrr: shows [3s Kh] (two pair, Kings and Sevens)
color_singleton: mucks hand 
dockstarrr collected 2782 from pot
*** SUMMARY ***
Total pot 2944 | Rake 162 
Board [Kd 7s 7c 2h 4d]
Seat 1: color_singleton (big blind) mucked [8s 8h]
Seat 2: manon327 folded on the Flop
Seat 4: PokerStarMan123 folded on the Flop
Seat 6: Klemtonius (button) folded on the Flop
Seat 9: dockstarrr (small blind) showed [3s Kh] and won (2782) with two pair, Kings and Sevens



PokerStars Home Game Hand #226316971952: {DaPokaStars}  Hold'em No Limit (50/100) - 2021/04/29 18:49:17 ET
Table 'yes_sir' 9-max (Play Money) Seat #9 is the button
Seat 1: color_singleton (18485 in chips) 
Seat 2: manon327 (7075 in chips) 
Seat 4: PokerStarMan123 (9939 in chips) 
Seat 6: Klemtonius (9727 in chips) 
Seat 9: dockstarrr (3888 in chips) 
color_singleton: posts small blind 50
manon327: posts big blind 100
*** HOLE CARDS ***
Dealt to PokerStarMan123 [Jc 8s]
PokerStarMan123: calls 100
Klemtonius: calls 100
dockstarrr: folds 
color_singleton: calls 50
manon327: checks 
*** FLOP *** [6s 4c Jd]
color_singleton: checks 
manon327: checks 
PokerStarMan123: bets 300
Klemtonius: calls 300
color_singleton: folds 
manon327: folds 
*** TURN *** [6s 4c Jd] [Qc]
PokerStarMan123: checks 
Klemtonius: checks 
*** RIVER *** [6s 4c Jd Qc] [4s]
PokerStarMan123: bets 600
Klemtonius: folds 
Uncalled bet (600) returned to PokerStarMan123
PokerStarMan123 collected 945 from pot
*** SUMMARY ***
Total pot 1000 | Rake 55 
Board [6s 4c Jd Qc 4s]
Seat 1: color_singleton (small blind) folded on the Flop
Seat 2: manon327 (big blind) folded on the Flop
Seat 4: PokerStarMan123 collected (945)
Seat 6: Klemtonius folded on the River
Seat 9: dockstarrr (button) folded before Flop (didn't bet)



PokerStars Home Game Hand #226316987894: {DaPokaStars}  Hold'em No Limit (50/100) - 2021/04/29 18:49:56 ET
Table 'yes_sir' 9-max (Play Money) Seat #1 is the button
Seat 1: color_singleton (18385 in chips) 
Seat 2: manon327 (6975 in chips) 
Seat 4: PokerStarMan123 (10484 in chips) 
Seat 6: Klemtonius (9327 in chips) 
Seat 9: dockstarrr (3888 in chips) 
manon327: posts small blind 50
PokerStarMan123: posts big blind 100
*** HOLE CARDS ***
Dealt to PokerStarMan123 [8c Kh]
Klemtonius: raises 200 to 300
dockstarrr: folds 
color_singleton: calls 300
manon327: calls 250
PokerStarMan123: calls 200
*** FLOP *** [5c 7c 7h]
manon327: checks 
PokerStarMan123: checks 
Klemtonius: bets 567
color_singleton: calls 567
manon327: calls 567
PokerStarMan123: folds 
*** TURN *** [5c 7c 7h] [6h]
manon327: checks 
Klemtonius: bets 1370
color_singleton: folds 
manon327: folds 
Uncalled bet (1370) returned to Klemtonius
Klemtonius collected 2741 from pot
Klemtonius: doesn't show hand 
*** SUMMARY ***
Total pot 2901 | Rake 160 
Board [5c 7c 7h 6h]
Seat 1: color_singleton (button) folded on the Turn
Seat 2: manon327 (small blind) folded on the Turn
Seat 4: PokerStarMan123 (big blind) folded on the Flop
Seat 6: Klemtonius collected (2741)
Seat 9: dockstarrr folded before Flop (didn't bet)



PokerStars Home Game Hand #226317005578: {DaPokaStars}  Hold'em No Limit (50/100) - 2021/04/29 18:50:39 ET
Table 'yes_sir' 9-max (Play Money) Seat #2 is the button
Seat 1: color_singleton (17518 in chips) 
Seat 2: manon327 (6108 in chips) 
Seat 4: PokerStarMan123 (10184 in chips) 
Seat 6: Klemtonius (11201 in chips) 
Seat 9: dockstarrr (3888 in chips) 
PokerStarMan123: posts small blind 50
Klemtonius: posts big blind 100
*** HOLE CARDS ***
Dealt to PokerStarMan123 [Qc As]
dockstarrr: calls 100
color_singleton: raises 200 to 300
manon327: folds 
PokerStarMan123: calls 250
Klemtonius: calls 200
dockstarrr: calls 200
*** FLOP *** [Th Kd 6c]
PokerStarMan123: checks 
Klemtonius: checks 
dockstarrr: checks 
color_singleton: bets 567
PokerStarMan123: folds 
Klemtonius: folds 
dockstarrr: folds 
Uncalled bet (567) returned to color_singleton
color_singleton collected 1134 from pot
color_singleton: doesn't show hand 
*** SUMMARY ***
Total pot 1200 | Rake 66 
Board [Th Kd 6c]
Seat 1: color_singleton collected (1134)
Seat 2: manon327 (button) folded before Flop (didn't bet)
Seat 4: PokerStarMan123 (small blind) folded on the Flop
Seat 6: Klemtonius (big blind) folded on the Flop
Seat 9: dockstarrr folded on the Flop



PokerStars Home Game Hand #226317025257: {DaPokaStars}  Hold'em No Limit (50/100) - 2021/04/29 18:51:23 ET
Table 'yes_sir' 9-max (Play Money) Seat #4 is the button
Seat 1: color_singleton (18352 in chips) 
Seat 2: manon327 (6108 in chips) 
Seat 4: PokerStarMan123 (9884 in chips) 
Seat 6: Klemtonius (10901 in chips) 
Seat 9: dockstarrr (3588 in chips) 
Klemtonius: posts small blind 50
dockstarrr: posts big blind 100
*** HOLE CARDS ***
Dealt to PokerStarMan123 [9s 9c]
color_singleton: raises 200 to 300
manon327: calls 300
PokerStarMan123: calls 300
Klemtonius: calls 250
dockstarrr: calls 200
*** FLOP *** [8d 5c Ad]
Klemtonius: bets 708
dockstarrr: folds 
color_singleton: folds 
manon327: folds 
PokerStarMan123: calls 708
*** TURN *** [8d 5c Ad] [6s]
Klemtonius: bets 2756
PokerStarMan123: folds 
Uncalled bet (2756) returned to Klemtonius
Klemtonius collected 2756 from pot
Klemtonius: doesn't show hand 
*** SUMMARY ***
Total pot 2916 | Rake 160 
Board [8d 5c Ad 6s]
Seat 1: color_singleton folded on the Flop
Seat 2: manon327 folded on the Flop
Seat 4: PokerStarMan123 (button) folded on the Turn
Seat 6: Klemtonius (small blind) collected (2756)
Seat 9: dockstarrr (big blind) folded on the Flop



PokerStars Home Game Hand #226317039815: {DaPokaStars}  Hold'em No Limit (50/100) - 2021/04/29 18:51:58 ET
Table 'yes_sir' 9-max (Play Money) Seat #6 is the button
Seat 1: color_singleton (18052 in chips) 
Seat 2: manon327 (5808 in chips) 
Seat 4: PokerStarMan123 (8876 in chips) 
Seat 6: Klemtonius (12649 in chips) 
Seat 9: dockstarrr (3288 in chips) 
dockstarrr: posts small blind 50
color_singleton: posts big blind 100
*** HOLE CARDS ***
Dealt to PokerStarMan123 [7s 3d]
manon327: calls 100
PokerStarMan123: folds 
Klemtonius: folds 
dockstarrr: calls 50
color_singleton: checks 
*** FLOP *** [9s 3c 6c]
dockstarrr: checks 
color_singleton: bets 141
manon327: calls 141
dockstarrr: folds 
*** TURN *** [9s 3c 6c] [8d]
color_singleton: checks 
manon327: checks 
*** RIVER *** [9s 3c 6c 8d] [7d]
color_singleton: bets 550
manon327: folds 
Uncalled bet (550) returned to color_singleton
color_singleton collected 550 from pot
color_singleton: doesn't show hand 
*** SUMMARY ***
Total pot 582 | Rake 32 
Board [9s 3c 6c 8d 7d]
Seat 1: color_singleton (big blind) collected (550)
Seat 2: manon327 folded on the River
Seat 4: PokerStarMan123 folded before Flop (didn't bet)
Seat 6: Klemtonius (button) folded before Flop (didn't bet)
Seat 9: dockstarrr (small blind) folded on the Flop



PokerStars Home Game Hand #226317055545: {DaPokaStars}  Hold'em No Limit (50/100) - 2021/04/29 18:52:36 ET
Table 'yes_sir' 9-max (Play Money) Seat #9 is the button
Seat 1: color_singleton (18361 in chips) 
Seat 2: manon327 (5567 in chips) 
Seat 4: PokerStarMan123 (8876 in chips) 
Seat 6: Klemtonius (12649 in chips) 
Seat 9: dockstarrr (3188 in chips) 
color_singleton: posts small blind 50
manon327: posts big blind 100
*** HOLE CARDS ***
Dealt to PokerStarMan123 [Ac 5h]
PokerStarMan123: calls 100
Klemtonius: folds 
dockstarrr: folds 
color_singleton: raises 200 to 300
manon327: calls 200
PokerStarMan123: calls 200
*** FLOP *** [Qh 4s 5s]
color_singleton: checks 
manon327: checks 
PokerStarMan123: bets 400
color_singleton: calls 400
manon327: calls 400
*** TURN *** [Qh 4s 5s] [As]
color_singleton: checks 
manon327: bets 992
PokerStarMan123: calls 992
color_singleton: calls 992
*** RIVER *** [Qh 4s 5s As] [Ks]
color_singleton: checks 
manon327: bets 3875 and is all-in
PokerStarMan123: folds 
color_singleton: folds 
Uncalled bet (3875) returned to manon327
manon327 collected 4797 from pot
*** SUMMARY ***
Total pot 5076 | Rake 279 
Board [Qh 4s 5s As Ks]
Seat 1: color_singleton (small blind) folded on the River
Seat 2: manon327 (big blind) collected (4797)
Seat 4: PokerStarMan123 folded on the River
Seat 6: Klemtonius folded before Flop (didn't bet)
Seat 9: dockstarrr (button) folded before Flop (didn't bet)



PokerStars Home Game Hand #226317082992: {DaPokaStars}  Hold'em No Limit (50/100) - 2021/04/29 18:53:42 ET
Table 'yes_sir' 9-max (Play Money) Seat #1 is the button
Seat 1: color_singleton (16669 in chips) 
Seat 2: manon327 (8672 in chips) 
Seat 4: PokerStarMan123 (7184 in chips) 
Seat 6: Klemtonius (12649 in chips) 
Seat 9: dockstarrr (3188 in chips) 
manon327: posts small blind 50
PokerStarMan123: posts big blind 100
*** HOLE CARDS ***
Dealt to PokerStarMan123 [4d Js]
Klemtonius: raises 100 to 200
dockstarrr: folds 
color_singleton: raises 200 to 400
manon327: calls 350
PokerStarMan123: folds 
Klemtonius: calls 200
*** FLOP *** [7s 6s Kd]
manon327: checks 
Klemtonius: checks 
color_singleton: bets 1228
manon327: folds 
Klemtonius: folds 
Uncalled bet (1228) returned to color_singleton
color_singleton collected 1228 from pot
color_singleton: doesn't show hand 
*** SUMMARY ***
Total pot 1300 | Rake 72 
Board [7s 6s Kd]
Seat 1: color_singleton (button) collected (1228)
Seat 2: manon327 (small blind) folded on the Flop
Seat 4: PokerStarMan123 (big blind) folded before Flop
Seat 6: Klemtonius folded on the Flop
Seat 9: dockstarrr folded before Flop (didn't bet)



PokerStars Home Game Hand #226317095269: {DaPokaStars}  Hold'em No Limit (50/100) - 2021/04/29 18:54:12 ET
Table 'yes_sir' 9-max (Play Money) Seat #2 is the button
Seat 1: color_singleton (17497 in chips) 
Seat 2: manon327 (8272 in chips) 
Seat 4: PokerStarMan123 (7084 in chips) 
Seat 6: Klemtonius (12249 in chips) 
Seat 9: dockstarrr (3188 in chips) 
PokerStarMan123: posts small blind 50
Klemtonius: posts big blind 100
*** HOLE CARDS ***
Dealt to PokerStarMan123 [Th 4d]
dockstarrr: folds 
color_singleton: folds 
manon327: calls 100
PokerStarMan123: calls 50
Klemtonius: raises 200 to 300
manon327: calls 200
PokerStarMan123: folds 
*** FLOP *** [Ts Kd 6d]
Klemtonius: bets 661
manon327: calls 661
*** TURN *** [Ts Kd 6d] [4s]
Klemtonius: bets 1911
manon327: folds 
Uncalled bet (1911) returned to Klemtonius
Klemtonius collected 1911 from pot
Klemtonius: doesn't show hand 
*** SUMMARY ***
Total pot 2022 | Rake 111 
Board [Ts Kd 6d 4s]
Seat 1: color_singleton folded before Flop (didn't bet)
Seat 2: manon327 (button) folded on the Turn
Seat 4: PokerStarMan123 (small blind) folded before Flop
Seat 6: Klemtonius (big blind) collected (1911)
Seat 9: dockstarrr folded before Flop (didn't bet)



PokerStars Home Game Hand #226317111333: {DaPokaStars}  Hold'em No Limit (50/100) - 2021/04/29 18:54:46 ET
Table 'yes_sir' 9-max (Play Money) Seat #4 is the button
Seat 1: color_singleton (17497 in chips) 
Seat 2: manon327 (7311 in chips) 
Seat 4: PokerStarMan123 (6984 in chips) 
Seat 6: Klemtonius (13199 in chips) 
Seat 9: dockstarrr (3188 in chips) 
Klemtonius: posts small blind 50
dockstarrr: posts big blind 100
*** HOLE CARDS ***
Dealt to PokerStarMan123 [4s 2s]
color_singleton: raises 200 to 300
manon327: calls 300
PokerStarMan123: folds 
Klemtonius: calls 250
dockstarrr: folds 
*** FLOP *** [8h 9c 9h]
Klemtonius: checks 
color_singleton: checks 
manon327: checks 
*** TURN *** [8h 9c 9h] [Th]
Klemtonius: checks 
color_singleton: checks 
manon327: checks 
*** RIVER *** [8h 9c 9h Th] [As]
Klemtonius: checks 
color_singleton: checks 
manon327: checks 
*** SHOW DOWN ***
Klemtonius: shows [3s 5s] (a pair of Nines)
color_singleton: shows [Kd 3d] (a pair of Nines - Ace+King kicker)
manon327: shows [Kc 7d] (a pair of Nines)
color_singleton collected 473 from pot
manon327 collected 472 from pot
*** SUMMARY ***
Total pot 1000 | Rake 55 
Board [8h 9c 9h Th As]
Seat 1: color_singleton showed [Kd 3d] and won (473) with a pair of Nines
Seat 2: manon327 showed [Kc 7d] and won (472) with a pair of Nines
Seat 4: PokerStarMan123 (button) folded before Flop (didn't bet)
Seat 6: Klemtonius (small blind) showed [3s 5s] and lost with a pair of Nines
Seat 9: dockstarrr (big blind) folded before Flop



PokerStars Home Game Hand #226317122693: {DaPokaStars}  Hold'em No Limit (50/100) - 2021/04/29 18:55:17 ET
Table 'yes_sir' 9-max (Play Money) Seat #6 is the button
Seat 1: color_singleton (17670 in chips) 
Seat 2: manon327 (7483 in chips) 
Seat 4: PokerStarMan123 (6984 in chips) 
Seat 6: Klemtonius (12899 in chips) 
Seat 9: dockstarrr (3088 in chips) 
dockstarrr: posts small blind 50
color_singleton: posts big blind 100
*** HOLE CARDS ***
Dealt to PokerStarMan123 [Jd 5s]
manon327: calls 100
PokerStarMan123: folds 
Klemtonius: raises 200 to 300
dockstarrr: calls 250
color_singleton: calls 200
manon327: folds 
*** FLOP *** [7c Td Ts]
dockstarrr: checks 
color_singleton: checks 
Klemtonius: bets 472
dockstarrr: folds 
color_singleton: folds 
Uncalled bet (472) returned to Klemtonius
Klemtonius collected 945 from pot
Klemtonius: doesn't show hand 
*** SUMMARY ***
Total pot 1000 | Rake 55 
Board [7c Td Ts]
Seat 1: color_singleton (big blind) folded on the Flop
Seat 2: manon327 folded before Flop
Seat 4: PokerStarMan123 folded before Flop (didn't bet)
Seat 6: Klemtonius (button) collected (945)
Seat 9: dockstarrr (small blind) folded on the Flop



PokerStars Home Game Hand #226317134675: {DaPokaStars}  Hold'em No Limit (50/100) - 2021/04/29 18:55:54 ET
Table 'yes_sir' 9-max (Play Money) Seat #9 is the button
Seat 1: color_singleton (17370 in chips) 
Seat 2: manon327 (7383 in chips) 
Seat 4: PokerStarMan123 (6984 in chips) 
Seat 6: Klemtonius (13544 in chips) 
Seat 9: dockstarrr (2788 in chips) 
color_singleton: posts small blind 50
manon327: posts big blind 100
*** HOLE CARDS ***
Dealt to PokerStarMan123 [Tc 7h]
PokerStarMan123: folds 
Klemtonius: raises 250 to 350
dockstarrr: folds 
color_singleton: calls 300
manon327: calls 250
*** FLOP *** [Js 8h Ks]
color_singleton: checks 
manon327: bets 496
Klemtonius: raises 992 to 1488
color_singleton: folds 
manon327: folds 
Uncalled bet (992) returned to Klemtonius
Klemtonius collected 1930 from pot
Klemtonius: doesn't show hand 
*** SUMMARY ***
Total pot 2042 | Rake 112 
Board [Js 8h Ks]
Seat 1: color_singleton (small blind) folded on the Flop
Seat 2: manon327 (big blind) folded on the Flop
Seat 4: PokerStarMan123 folded before Flop (didn't bet)
Seat 6: Klemtonius collected (1930)
Seat 9: dockstarrr (button) folded before Flop (didn't bet)



PokerStars Home Game Hand #226317143225: {DaPokaStars}  Hold'em No Limit (50/100) - 2021/04/29 18:56:20 ET
Table 'yes_sir' 9-max (Play Money) Seat #1 is the button
Seat 1: color_singleton (17020 in chips) 
Seat 2: manon327 (6537 in chips) 
Seat 4: PokerStarMan123 (6984 in chips) 
Seat 6: Klemtonius (14628 in chips) 
Seat 9: dockstarrr (2788 in chips) 
manon327: posts small blind 50
PokerStarMan123: posts big blind 100
*** HOLE CARDS ***
Dealt to PokerStarMan123 [7c 9s]
Klemtonius: calls 100
dockstarrr: folds 
color_singleton: calls 100
manon327: folds 
PokerStarMan123: checks 
*** FLOP *** [6s 6c 8s]
PokerStarMan123: bets 300
Klemtonius: calls 300
color_singleton: calls 300
*** TURN *** [6s 6c 8s] [4c]
PokerStarMan123: bets 800
Klemtonius: folds 
color_singleton: calls 800
*** RIVER *** [6s 6c 8s 4c] [Qh]
PokerStarMan123: bets 1600
color_singleton: folds 
Uncalled bet (1600) returned to PokerStarMan123
PokerStarMan123 collected 2693 from pot
*** SUMMARY ***
Total pot 2850 | Rake 157 
Board [6s 6c 8s 4c Qh]
Seat 1: color_singleton (button) folded on the River
Seat 2: manon327 (small blind) folded before Flop
Seat 4: PokerStarMan123 (big blind) collected (2693)
Seat 6: Klemtonius folded on the Turn
Seat 9: dockstarrr folded before Flop (didn't bet)



PokerStars Home Game Hand #226317158018: {DaPokaStars}  Hold'em No Limit (50/100) - 2021/04/29 18:57:06 ET
Table 'yes_sir' 9-max (Play Money) Seat #2 is the button
Seat 1: color_singleton (15820 in chips) 
Seat 2: manon327 (6487 in chips) 
Seat 4: PokerStarMan123 (8477 in chips) 
Seat 6: Klemtonius (14228 in chips) 
PokerStarMan123: posts small blind 50
Klemtonius: posts big blind 100
*** HOLE CARDS ***
Dealt to PokerStarMan123 [5c 7d]
color_singleton: folds 
manon327: calls 100
PokerStarMan123: calls 50
Klemtonius: raises 100 to 200
manon327: calls 100
PokerStarMan123: calls 100
*** FLOP *** [5s 4s 2h]
PokerStarMan123: bets 400
Klemtonius: raises 4700 to 5100
manon327: folds 
PokerStarMan123: folds 
Uncalled bet (4700) returned to Klemtonius
Klemtonius collected 1323 from pot
Klemtonius: doesn't show hand 
*** SUMMARY ***
Total pot 1400 | Rake 77 
Board [5s 4s 2h]
Seat 1: color_singleton folded before Flop (didn't bet)
Seat 2: manon327 (button) folded on the Flop
Seat 4: PokerStarMan123 (small blind) folded on the Flop
Seat 6: Klemtonius (big blind) collected (1323)



PokerStars Home Game Hand #226317174911: {DaPokaStars}  Hold'em No Limit (50/100) - 2021/04/29 18:57:57 ET
Table 'yes_sir' 9-max (Play Money) Seat #4 is the button
Seat 1: color_singleton (15820 in chips) 
Seat 2: manon327 (6287 in chips) 
Seat 4: PokerStarMan123 (7877 in chips) 
Seat 6: Klemtonius (14951 in chips) 
Klemtonius: posts small blind 50
color_singleton: posts big blind 100
*** HOLE CARDS ***
Dealt to PokerStarMan123 [Jd 5c]
manon327: calls 100
PokerStarMan123: folds 
Klemtonius: raises 400 to 500
color_singleton: folds 
manon327: calls 400
*** FLOP *** [Kc 8h 9c]
Klemtonius: checks 
manon327: bets 519
Klemtonius: folds 
Uncalled bet (519) returned to manon327
manon327 collected 1039 from pot
*** SUMMARY ***
Total pot 1100 | Rake 61 
Board [Kc 8h 9c]
Seat 1: color_singleton (big blind) folded before Flop
Seat 2: manon327 collected (1039)
Seat 4: PokerStarMan123 (button) folded before Flop (didn't bet)
Seat 6: Klemtonius (small blind) folded on the Flop



PokerStars Home Game Hand #226317186533: {DaPokaStars}  Hold'em No Limit (50/100) - 2021/04/29 18:58:32 ET
Table 'yes_sir' 9-max (Play Money) Seat #6 is the button
Seat 1: color_singleton (15720 in chips) 
Seat 2: manon327 (6826 in chips) 
Seat 4: PokerStarMan123 (7877 in chips) 
Seat 6: Klemtonius (14451 in chips) 
color_singleton: posts small blind 50
manon327: posts big blind 100
*** HOLE CARDS ***
Dealt to PokerStarMan123 [9d 3d]
PokerStarMan123: folds 
Klemtonius: calls 100
color_singleton has timed out
color_singleton: folds 
manon327: checks 
*** FLOP *** [3c Th Kd]
manon327: checks 
Klemtonius: bets 236
manon327: folds 
Uncalled bet (236) returned to Klemtonius
Klemtonius collected 236 from pot
Klemtonius: doesn't show hand 
*** SUMMARY ***
Total pot 250 | Rake 14 
Board [3c Th Kd]
Seat 1: color_singleton (small blind) folded before Flop
Seat 2: manon327 (big blind) folded on the Flop
Seat 4: PokerStarMan123 folded before Flop (didn't bet)
Seat 6: Klemtonius (button) collected (236)



PokerStars Home Game Hand #226317203845: {DaPokaStars}  Hold'em No Limit (50/100) - 2021/04/29 18:59:25 ET
Table 'yes_sir' 9-max (Play Money) Seat #2 is the button
Seat 2: manon327 (6726 in chips) 
Seat 4: PokerStarMan123 (7877 in chips) 
Seat 6: Klemtonius (14587 in chips) 
Seat 9: dockstarrr (2788 in chips) 
PokerStarMan123: posts small blind 50
Klemtonius: posts big blind 100
dockstarrr: posts small & big blinds 150
*** HOLE CARDS ***
Dealt to PokerStarMan123 [4s 7c]
dockstarrr: checks 
manon327: calls 100
PokerStarMan123: calls 50
Klemtonius: checks 
*** FLOP *** [Qh Ts 3c]
PokerStarMan123: checks 
Klemtonius: checks 
dockstarrr: checks 
manon327: checks 
*** TURN *** [Qh Ts 3c] [Td]
PokerStarMan123: checks 
Klemtonius: bets 212
dockstarrr: folds 
manon327: folds 
PokerStarMan123: folds 
Uncalled bet (212) returned to Klemtonius
Klemtonius collected 425 from pot
Klemtonius: doesn't show hand 
*** SUMMARY ***
Total pot 450 | Rake 25 
Board [Qh Ts 3c Td]
Seat 2: manon327 (button) folded on the Turn
Seat 4: PokerStarMan123 (small blind) folded on the Turn
Seat 6: Klemtonius (big blind) collected (425)
Seat 9: dockstarrr folded on the Turn (didn't bet)



PokerStars Home Game Hand #226317213413: {DaPokaStars}  Hold'em No Limit (50/100) - 2021/04/29 18:59:54 ET
Table 'yes_sir' 9-max (Play Money) Seat #4 is the button
Seat 1: color_singleton (15670 in chips) 
Seat 2: manon327 (6626 in chips) 
Seat 4: PokerStarMan123 (7777 in chips) 
Seat 6: Klemtonius (14912 in chips) 
Seat 9: dockstarrr (2638 in chips) 
Klemtonius: posts small blind 50
dockstarrr: posts big blind 100
*** HOLE CARDS ***
Dealt to PokerStarMan123 [Qs Js]
color_singleton: raises 200 to 300
manon327: calls 300
PokerStarMan123: calls 300
Klemtonius: folds 
dockstarrr: calls 200
*** FLOP *** [4c Jh 3s]
dockstarrr: checks 
color_singleton: checks 
manon327: checks 
PokerStarMan123: bets 600
dockstarrr: folds 
color_singleton: calls 600
manon327: folds 
*** TURN *** [4c Jh 3s] [7s]
color_singleton: checks 
PokerStarMan123: bets 1300
color_singleton: folds 
Uncalled bet (1300) returned to PokerStarMan123
PokerStarMan123 collected 2315 from pot
*** SUMMARY ***
Total pot 2450 | Rake 135 
Board [4c Jh 3s 7s]
Seat 1: color_singleton folded on the Turn
Seat 2: manon327 folded on the Flop
Seat 4: PokerStarMan123 (button) collected (2315)
Seat 6: Klemtonius (small blind) folded before Flop
Seat 9: dockstarrr (big blind) folded on the Flop



PokerStars Home Game Hand #226317229279: {DaPokaStars}  Hold'em No Limit (50/100) - 2021/04/29 19:00:41 ET
Table 'yes_sir' 9-max (Play Money) Seat #6 is the button
Seat 1: color_singleton (14770 in chips) 
Seat 2: manon327 (6326 in chips) 
Seat 4: PokerStarMan123 (9192 in chips) 
Seat 6: Klemtonius (14862 in chips) 
Seat 9: dockstarrr (2338 in chips) 
dockstarrr: posts small blind 50
color_singleton: posts big blind 100
*** HOLE CARDS ***
Dealt to PokerStarMan123 [5h 2c]
manon327: calls 100
PokerStarMan123: folds 
Klemtonius: raises 350 to 450
dockstarrr: calls 400
color_singleton: folds 
manon327: calls 350
*** FLOP *** [Td 3s 9s]
dockstarrr: checks 
manon327: checks 
Klemtonius: bets 685
dockstarrr: calls 685
manon327: folds 
*** TURN *** [Td 3s 9s] [5c]
dockstarrr: checks 
Klemtonius: checks 
*** RIVER *** [Td 3s 9s 5c] [Jh]
dockstarrr: checks 
Klemtonius: checks 
*** SHOW DOWN ***
dockstarrr: shows [6d Ac] (high card Ace)
Klemtonius: shows [7s 7h] (a pair of Sevens)
Klemtonius collected 2665 from pot
*** SUMMARY ***
Total pot 2820 | Rake 155 
Board [Td 3s 9s 5c Jh]
Seat 1: color_singleton (big blind) folded before Flop
Seat 2: manon327 folded on the Flop
Seat 4: PokerStarMan123 folded before Flop (didn't bet)
Seat 6: Klemtonius (button) showed [7s 7h] and won (2665) with a pair of Sevens
Seat 9: dockstarrr (small blind) showed [6d Ac] and lost with high card Ace



PokerStars Home Game Hand #226317250540: {DaPokaStars}  Hold'em No Limit (50/100) - 2021/04/29 19:01:27 ET
Table 'yes_sir' 9-max (Play Money) Seat #9 is the button
Seat 1: color_singleton (14670 in chips) 
Seat 2: manon327 (5876 in chips) 
Seat 4: PokerStarMan123 (9192 in chips) 
Seat 6: Klemtonius (16392 in chips) 
Seat 9: dockstarrr (1203 in chips) 
color_singleton: posts small blind 50
manon327: posts big blind 100
*** HOLE CARDS ***
Dealt to PokerStarMan123 [5c Td]
PokerStarMan123: folds 
Klemtonius: calls 100
dockstarrr: folds 
color_singleton: raises 200 to 300
manon327: calls 200
Klemtonius: calls 200
*** FLOP *** [3s 8s 8d]
color_singleton: bets 425
manon327: folds 
Klemtonius: folds 
Uncalled bet (425) returned to color_singleton
color_singleton collected 850 from pot
color_singleton: doesn't show hand 
*** SUMMARY ***
Total pot 900 | Rake 50 
Board [3s 8s 8d]
Seat 1: color_singleton (small blind) collected (850)
Seat 2: manon327 (big blind) folded on the Flop
Seat 4: PokerStarMan123 folded before Flop (didn't bet)
Seat 6: Klemtonius folded on the Flop
Seat 9: dockstarrr (button) folded before Flop (didn't bet)



PokerStars Home Game Hand #226317258641: {DaPokaStars}  Hold'em No Limit (50/100) - 2021/04/29 19:01:48 ET
Table 'yes_sir' 9-max (Play Money) Seat #1 is the button
Seat 1: color_singleton (15220 in chips) 
Seat 2: manon327 (5576 in chips) 
Seat 4: PokerStarMan123 (9192 in chips) 
Seat 6: Klemtonius (16092 in chips) 
Seat 9: dockstarrr (1203 in chips) 
manon327: posts small blind 50
PokerStarMan123: posts big blind 100
*** HOLE CARDS ***
Dealt to PokerStarMan123 [9h 7d]
Klemtonius: calls 100
dockstarrr: calls 100
color_singleton: folds 
manon327: calls 50
PokerStarMan123: checks 
*** FLOP *** [Ad 3h Td]
manon327: bets 189
PokerStarMan123: folds 
Klemtonius: folds 
dockstarrr: folds 
Uncalled bet (189) returned to manon327
manon327 collected 378 from pot
*** SUMMARY ***
Total pot 400 | Rake 22 
Board [Ad 3h Td]
Seat 1: color_singleton (button) folded before Flop (didn't bet)
Seat 2: manon327 (small blind) collected (378)
Seat 4: PokerStarMan123 (big blind) folded on the Flop
Seat 6: Klemtonius folded on the Flop
Seat 9: dockstarrr folded on the Flop



PokerStars Home Game Hand #226317266887: {DaPokaStars}  Hold'em No Limit (50/100) - 2021/04/29 19:02:09 ET
Table 'yes_sir' 9-max (Play Money) Seat #2 is the button
Seat 1: color_singleton (15220 in chips) 
Seat 2: manon327 (5854 in chips) 
Seat 4: PokerStarMan123 (9092 in chips) 
Seat 6: Klemtonius (15992 in chips) 
Seat 9: dockstarrr (1103 in chips) 
PokerStarMan123: posts small blind 50
Klemtonius: posts big blind 100
*** HOLE CARDS ***
Dealt to PokerStarMan123 [Ts Qh]
dockstarrr: folds 
color_singleton: raises 200 to 300
manon327: folds 
PokerStarMan123: calls 250
Klemtonius: folds 
*** FLOP *** [3d 7d 9h]
PokerStarMan123: checks 
color_singleton: checks 
*** TURN *** [3d 7d 9h] [5d]
PokerStarMan123: checks 
color_singleton: bets 330
PokerStarMan123: calls 330
*** RIVER *** [3d 7d 9h 5d] [Qc]
PokerStarMan123: checks 
color_singleton: checks 
*** SHOW DOWN ***
PokerStarMan123: shows [Ts Qh] (a pair of Queens)
color_singleton: mucks hand 
PokerStarMan123 collected 1285 from pot
*** SUMMARY ***
Total pot 1360 | Rake 75 
Board [3d 7d 9h 5d Qc]
Seat 1: color_singleton mucked [2c Ac]
Seat 2: manon327 (button) folded before Flop (didn't bet)
Seat 4: PokerStarMan123 (small blind) showed [Ts Qh] and won (1285) with a pair of Queens
Seat 6: Klemtonius (big blind) folded before Flop
Seat 9: dockstarrr folded before Flop (didn't bet)



PokerStars Home Game Hand #226317280233: {DaPokaStars}  Hold'em No Limit (50/100) - 2021/04/29 19:02:43 ET
Table 'yes_sir' 9-max (Play Money) Seat #4 is the button
Seat 1: color_singleton (14590 in chips) 
Seat 2: manon327 (5854 in chips) 
Seat 4: PokerStarMan123 (9747 in chips) 
Seat 6: Klemtonius (15892 in chips) 
Seat 9: dockstarrr (1103 in chips) 
Klemtonius: posts small blind 50
dockstarrr: posts big blind 100
*** HOLE CARDS ***
Dealt to PokerStarMan123 [2s 9d]
color_singleton: raises 200 to 300
manon327: folds 
PokerStarMan123: folds 
Klemtonius: calls 250
dockstarrr: folds 
*** FLOP *** [8s Kc 4h]
Klemtonius: checks 
color_singleton: bets 330
Klemtonius: folds 
Uncalled bet (330) returned to color_singleton
color_singleton collected 661 from pot
color_singleton: doesn't show hand 
*** SUMMARY ***
Total pot 700 | Rake 39 
Board [8s Kc 4h]
Seat 1: color_singleton collected (661)
Seat 2: manon327 folded before Flop (didn't bet)
Seat 4: PokerStarMan123 (button) folded before Flop (didn't bet)
Seat 6: Klemtonius (small blind) folded on the Flop
Seat 9: dockstarrr (big blind) folded before Flop



PokerStars Home Game Hand #226317292204: {DaPokaStars}  Hold'em No Limit (50/100) - 2021/04/29 19:03:12 ET
Table 'yes_sir' 9-max (Play Money) Seat #6 is the button
Seat 1: color_singleton (14951 in chips) 
Seat 2: manon327 (5854 in chips) 
Seat 4: PokerStarMan123 (9747 in chips) 
Seat 6: Klemtonius (15592 in chips) 
Seat 9: dockstarrr (1003 in chips) 
dockstarrr: posts small blind 50
color_singleton: posts big blind 100
*** HOLE CARDS ***
Dealt to PokerStarMan123 [5h 6s]
manon327: calls 100
PokerStarMan123: calls 100
Klemtonius: calls 100
dockstarrr: calls 50
color_singleton: checks 
*** FLOP *** [Tc Jh As]
dockstarrr: checks 
color_singleton: checks 
manon327: bets 236
PokerStarMan123: folds 
Klemtonius: calls 236
dockstarrr: raises 236 to 472
color_singleton: folds 
manon327: calls 236
Klemtonius: raises 1436 to 1908
dockstarrr: calls 431 and is all-in
manon327: calls 1436
*** TURN *** [Tc Jh As] [6c]
manon327: checks 
Klemtonius: bets 4100
manon327: calls 3846 and is all-in
Uncalled bet (254) returned to Klemtonius
*** RIVER *** [Tc Jh As 6c] [3s]
*** SHOW DOWN ***
manon327: shows [Ac 7c] (a pair of Aces)
Klemtonius: shows [Kd Qc] (a straight, Ten to Ace)
Klemtonius collected 9169 from side pot
dockstarrr: shows [Qh Kh] (a straight, Ten to Ace)
dockstarrr collected 1516 from main pot
Klemtonius collected 1516 from main pot
*** SUMMARY ***
Total pot 12911 Main pot 3032. Side pot 9169. | Rake 710 
Board [Tc Jh As 6c 3s]
Seat 1: color_singleton (big blind) folded on the Flop
Seat 2: manon327 showed [Ac 7c] and lost with a pair of Aces
Seat 4: PokerStarMan123 folded on the Flop
Seat 6: Klemtonius (button) showed [Kd Qc] and won (10685) with a straight, Ten to Ace
Seat 9: dockstarrr (small blind) showed [Qh Kh] and won (1516) with a straight, Ten to Ace



PokerStars Home Game Hand #226317319702: {DaPokaStars}  Hold'em No Limit (50/100) - 2021/04/29 19:04:23 ET
Table 'yes_sir' 9-max (Play Money) Seat #9 is the button
Seat 1: color_singleton (14851 in chips) 
Seat 4: PokerStarMan123 (9647 in chips) 
Seat 6: Klemtonius (20423 in chips) 
Seat 9: dockstarrr (1516 in chips) 
color_singleton: posts small blind 50
PokerStarMan123: posts big blind 100
*** HOLE CARDS ***
Dealt to PokerStarMan123 [4s 7s]
Klemtonius: calls 100
dockstarrr: calls 100
color_singleton: calls 50
PokerStarMan123: checks 
*** FLOP *** [4h Ks 5c]
color_singleton: checks 
PokerStarMan123: checks 
Klemtonius: checks 
dockstarrr: bets 100
color_singleton: calls 100
PokerStarMan123: calls 100
Klemtonius: calls 100
*** TURN *** [4h Ks 5c] [Qs]
color_singleton: checks 
PokerStarMan123: bets 400
Klemtonius: folds 
dockstarrr: raises 400 to 800
color_singleton: folds 
PokerStarMan123: calls 400
*** RIVER *** [4h Ks 5c Qs] [As]
PokerStarMan123: checks 
dockstarrr: bets 100
PokerStarMan123: raises 2500 to 2600
dockstarrr: calls 416 and is all-in
Uncalled bet (2084) returned to PokerStarMan123
*** SHOW DOWN ***
PokerStarMan123: shows [4s 7s] (a flush, Ace high)
dockstarrr: shows [Kh Jc] (a pair of Kings)
PokerStarMan123 collected 3243 from pot
*** SUMMARY ***
Total pot 3432 | Rake 189 
Board [4h Ks 5c Qs As]
Seat 1: color_singleton (small blind) folded on the Turn
Seat 4: PokerStarMan123 (big blind) showed [4s 7s] and won (3243) with a flush, Ace high
Seat 6: Klemtonius folded on the Turn
Seat 9: dockstarrr (button) showed [Kh Jc] and lost with a pair of Kings



PokerStars Home Game Hand #226317341293: {DaPokaStars}  Hold'em No Limit (50/100) - 2021/04/29 19:05:18 ET
Table 'yes_sir' 9-max (Play Money) Seat #1 is the button
Seat 1: color_singleton (14651 in chips) 
Seat 4: PokerStarMan123 (11374 in chips) 
Seat 6: Klemtonius (20223 in chips) 
PokerStarMan123: posts small blind 50
Klemtonius: posts big blind 100
*** HOLE CARDS ***
Dealt to PokerStarMan123 [Tc 2c]
color_singleton: raises 100 to 200
PokerStarMan123: calls 150
Klemtonius: calls 100
*** FLOP *** [Jc Qh 8d]
dockstarrr leaves the table
PokerStarMan123: checks 
Klemtonius: checks 
color_singleton: bets 567
PokerStarMan123: folds 
Klemtonius: folds 
Uncalled bet (567) returned to color_singleton
color_singleton collected 567 from pot
color_singleton: doesn't show hand 
*** SUMMARY ***
Total pot 600 | Rake 33 
Board [Jc Qh 8d]
Seat 1: color_singleton (button) collected (567)
Seat 4: PokerStarMan123 (small blind) folded on the Flop
Seat 6: Klemtonius (big blind) folded on the Flop



PokerStars Home Game Hand #226317352260: {DaPokaStars}  Hold'em No Limit (50/100) - 2021/04/29 19:05:46 ET
Table 'yes_sir' 9-max (Play Money) Seat #4 is the button
Seat 1: color_singleton (15018 in chips) 
Seat 2: manon327 (10000 in chips) 
Seat 4: PokerStarMan123 (11174 in chips) 
Seat 6: Klemtonius (20023 in chips) 
Klemtonius: posts small blind 50
color_singleton: posts big blind 100
manon327: posts small & big blinds 150
*** HOLE CARDS ***
Dealt to PokerStarMan123 [5d 6c]
manon327: checks 
PokerStarMan123: calls 100
Klemtonius: raises 450 to 550
color_singleton: folds 
manon327: folds 
PokerStarMan123: calls 450
*** FLOP *** [9s Ad 8s]
Klemtonius: bets 638
PokerStarMan123: folds 
Uncalled bet (638) returned to Klemtonius
Klemtonius collected 1276 from pot
Klemtonius: doesn't show hand 
*** SUMMARY ***
Total pot 1350 | Rake 74 
Board [9s Ad 8s]
Seat 1: color_singleton (big blind) folded before Flop
Seat 2: manon327 folded before Flop (didn't bet)
Seat 4: PokerStarMan123 (button) folded on the Flop
Seat 6: Klemtonius (small blind) collected (1276)



PokerStars Home Game Hand #226317361271: {DaPokaStars}  Hold'em No Limit (50/100) - 2021/04/29 19:06:08 ET
Table 'yes_sir' 9-max (Play Money) Seat #6 is the button
Seat 1: color_singleton (14918 in chips) 
Seat 2: manon327 (9850 in chips) 
Seat 4: PokerStarMan123 (10624 in chips) 
Seat 6: Klemtonius (20749 in chips) 
color_singleton: posts small blind 50
manon327: posts big blind 100
*** HOLE CARDS ***
Dealt to PokerStarMan123 [6h 3s]
PokerStarMan123: folds 
Klemtonius: folds 
color_singleton: calls 50
manon327: checks 
*** FLOP *** [Jd Th 7s]
color_singleton: checks 
manon327: checks 
*** TURN *** [Jd Th 7s] [9d]
color_singleton: bets 189
manon327: calls 189
*** RIVER *** [Jd Th 7s 9d] [5h]
color_singleton: checks 
manon327: checks 
*** SHOW DOWN ***
color_singleton: shows [2s Qh] (high card Queen)
manon327: shows [9s 6s] (a pair of Nines)
manon327 collected 546 from pot
*** SUMMARY ***
Total pot 578 | Rake 32 
Board [Jd Th 7s 9d 5h]
Seat 1: color_singleton (small blind) showed [2s Qh] and lost with high card Queen
Seat 2: manon327 (big blind) showed [9s 6s] and won (546) with a pair of Nines
Seat 4: PokerStarMan123 folded before Flop (didn't bet)
Seat 6: Klemtonius (button) folded before Flop (didn't bet)



PokerStars Home Game Hand #226317371990: {DaPokaStars}  Hold'em No Limit (50/100) - 2021/04/29 19:06:36 ET
Table 'yes_sir' 9-max (Play Money) Seat #1 is the button
Seat 1: color_singleton (14629 in chips) 
Seat 2: manon327 (10107 in chips) 
Seat 4: PokerStarMan123 (10624 in chips) 
Seat 6: Klemtonius (20749 in chips) 
manon327: posts small blind 50
PokerStarMan123: posts big blind 100
*** HOLE CARDS ***
Dealt to PokerStarMan123 [Th 2h]
Klemtonius: raises 200 to 300
color_singleton: calls 300
manon327: calls 250
PokerStarMan123: calls 200
*** FLOP *** [Ac 2s 8h]
manon327: checks 
PokerStarMan123: checks 
Klemtonius: bets 567
color_singleton: calls 567
manon327: folds 
PokerStarMan123: folds 
*** TURN *** [Ac 2s 8h] [9s]
Klemtonius: checks 
color_singleton: checks 
*** RIVER *** [Ac 2s 8h 9s] [Ts]
Klemtonius: bets 1103
color_singleton: folds 
Uncalled bet (1103) returned to Klemtonius
Klemtonius collected 2206 from pot
Klemtonius: doesn't show hand 
*** SUMMARY ***
Total pot 2334 | Rake 128 
Board [Ac 2s 8h 9s Ts]
Seat 1: color_singleton (button) folded on the River
Seat 2: manon327 (small blind) folded on the Flop
Seat 4: PokerStarMan123 (big blind) folded on the Flop
Seat 6: Klemtonius collected (2206)



PokerStars Home Game Hand #226317385665: {DaPokaStars}  Hold'em No Limit (50/100) - 2021/04/29 19:07:10 ET
Table 'yes_sir' 9-max (Play Money) Seat #2 is the button
Seat 1: color_singleton (13762 in chips) 
Seat 2: manon327 (9807 in chips) 
Seat 4: PokerStarMan123 (10324 in chips) 
Seat 6: Klemtonius (22088 in chips) 
PokerStarMan123: posts small blind 50
Klemtonius: posts big blind 100
*** HOLE CARDS ***
Dealt to PokerStarMan123 [Qd 8c]
color_singleton: raises 100 to 200
manon327: folds 
PokerStarMan123: calls 150
Klemtonius: calls 100
*** FLOP *** [As Jc Kh]
PokerStarMan123: checks 
Klemtonius: checks 
color_singleton: bets 283
PokerStarMan123: folds 
Klemtonius: folds 
Uncalled bet (283) returned to color_singleton
color_singleton collected 567 from pot
color_singleton: doesn't show hand 
*** SUMMARY ***
Total pot 600 | Rake 33 
Board [As Jc Kh]
Seat 1: color_singleton collected (567)
Seat 2: manon327 (button) folded before Flop (didn't bet)
Seat 4: PokerStarMan123 (small blind) folded on the Flop
Seat 6: Klemtonius (big blind) folded on the Flop



PokerStars Home Game Hand #226317397868: {DaPokaStars}  Hold'em No Limit (50/100) - 2021/04/29 19:07:42 ET
Table 'yes_sir' 9-max (Play Money) Seat #4 is the button
Seat 1: color_singleton (14129 in chips) 
Seat 2: manon327 (9807 in chips) 
Seat 4: PokerStarMan123 (10124 in chips) 
Seat 6: Klemtonius (21888 in chips) 
Klemtonius: posts small blind 50
color_singleton: posts big blind 100
*** HOLE CARDS ***
Dealt to PokerStarMan123 [6s 9d]
manon327: folds 
PokerStarMan123: folds 
Klemtonius: raises 100 to 200
color_singleton: folds 
Uncalled bet (100) returned to Klemtonius
Klemtonius collected 200 from pot
Klemtonius: doesn't show hand 
*** SUMMARY ***
Total pot 200 | Rake 0 
Seat 1: color_singleton (big blind) folded before Flop
Seat 2: manon327 folded before Flop (didn't bet)
Seat 4: PokerStarMan123 (button) folded before Flop (didn't bet)
Seat 6: Klemtonius (small blind) collected (200)



PokerStars Home Game Hand #226317404824: {DaPokaStars}  Hold'em No Limit (50/100) - 2021/04/29 19:08:00 ET
Table 'yes_sir' 9-max (Play Money) Seat #6 is the button
Seat 1: color_singleton (14029 in chips) 
Seat 2: manon327 (9807 in chips) 
Seat 4: PokerStarMan123 (10124 in chips) 
Seat 6: Klemtonius (21988 in chips) 
color_singleton: posts small blind 50
manon327: posts big blind 100
*** HOLE CARDS ***
Dealt to PokerStarMan123 [3d Kd]
PokerStarMan123: calls 100
Klemtonius: calls 100
color_singleton: raises 200 to 300
manon327: folds 
PokerStarMan123: calls 200
Klemtonius: calls 200
*** FLOP *** [8d 8h 2h]
color_singleton: checks 
PokerStarMan123: checks 
Klemtonius: checks 
*** TURN *** [8d 8h 2h] [Kh]
color_singleton: bets 472
PokerStarMan123: calls 472
Klemtonius: calls 472
*** RIVER *** [8d 8h 2h Kh] [Qh]
color_singleton: bets 1200
PokerStarMan123: folds 
Klemtonius: folds 
Uncalled bet (1200) returned to color_singleton
color_singleton collected 2283 from pot
color_singleton: doesn't show hand 
*** SUMMARY ***
Total pot 2416 | Rake 133 
Board [8d 8h 2h Kh Qh]
Seat 1: color_singleton (small blind) collected (2283)
Seat 2: manon327 (big blind) folded before Flop
Seat 4: PokerStarMan123 folded on the River
Seat 6: Klemtonius (button) folded on the River



PokerStars Home Game Hand #226317426884: {DaPokaStars}  Hold'em No Limit (50/100) - 2021/04/29 19:08:57 ET
Table 'yes_sir' 9-max (Play Money) Seat #1 is the button
Seat 1: color_singleton (15540 in chips) 
Seat 2: manon327 (9707 in chips) 
Seat 4: PokerStarMan123 (9352 in chips) 
Seat 6: Klemtonius (21216 in chips) 
manon327: posts small blind 50
PokerStarMan123: posts big blind 100
*** HOLE CARDS ***
Dealt to PokerStarMan123 [7d Jc]
Klemtonius: folds 
color_singleton: raises 200 to 300
manon327: folds 
PokerStarMan123: calls 200
*** FLOP *** [7c Qh 9h]
PokerStarMan123: checks 
color_singleton: checks 
*** TURN *** [7c Qh 9h] [Jh]
PokerStarMan123: checks 
color_singleton: checks 
*** RIVER *** [7c Qh 9h Jh] [Th]
PokerStarMan123: checks 
color_singleton: bets 500
PokerStarMan123: folds 
Uncalled bet (500) returned to color_singleton
color_singleton collected 614 from pot
color_singleton: doesn't show hand 
*** SUMMARY ***
Total pot 650 | Rake 36 
Board [7c Qh 9h Jh Th]
Seat 1: color_singleton (button) collected (614)
Seat 2: manon327 (small blind) folded before Flop
Seat 4: PokerStarMan123 (big blind) folded on the River
Seat 6: Klemtonius folded before Flop (didn't bet)



PokerStars Home Game Hand #226317451573: {DaPokaStars}  Hold'em No Limit (50/100) - 2021/04/29 19:10:01 ET
Table 'yes_sir' 9-max (Play Money) Seat #2 is the button
Seat 1: color_singleton (15854 in chips) 
Seat 2: manon327 (9657 in chips) 
Seat 4: PokerStarMan123 (9052 in chips) 
Seat 6: Klemtonius (21216 in chips) 
PokerStarMan123: posts small blind 50
Klemtonius: posts big blind 100
*** HOLE CARDS ***
Dealt to PokerStarMan123 [Qs 9d]
color_singleton: raises 200 to 300
manon327: calls 300
PokerStarMan123: folds 
Klemtonius: calls 200
*** FLOP *** [Ks Ac Ts]
Klemtonius: checks 
color_singleton: checks 
manon327: checks 
*** TURN *** [Ks Ac Ts] [6s]
Klemtonius: checks 
color_singleton: checks 
manon327: checks 
*** RIVER *** [Ks Ac Ts 6s] [Jc]
Klemtonius: checks 
color_singleton: checks 
manon327: bets 898
Klemtonius: folds 
color_singleton: folds 
Uncalled bet (898) returned to manon327
manon327 collected 898 from pot
*** SUMMARY ***
Total pot 950 | Rake 52 
Board [Ks Ac Ts 6s Jc]
Seat 1: color_singleton folded on the River
Seat 2: manon327 (button) collected (898)
Seat 4: PokerStarMan123 (small blind) folded before Flop
Seat 6: Klemtonius (big blind) folded on the River



PokerStars Home Game Hand #226317477029: {DaPokaStars}  Hold'em No Limit (50/100) - 2021/04/29 19:11:00 ET
Table 'yes_sir' 9-max (Play Money) Seat #4 is the button
Seat 1: color_singleton (15554 in chips) 
Seat 2: manon327 (10255 in chips) 
Seat 4: PokerStarMan123 (9002 in chips) 
Seat 6: Klemtonius (20916 in chips) 
Klemtonius: posts small blind 50
color_singleton: posts big blind 100
*** HOLE CARDS ***
Dealt to PokerStarMan123 [4h 7s]
manon327: calls 100
PokerStarMan123: folds 
Klemtonius: calls 50
color_singleton: checks 
*** FLOP *** [Td 7h 6h]
Klemtonius: bets 141
color_singleton: raises 282 to 423
manon327: folds 
Klemtonius: raises 564 to 987
color_singleton: calls 564
*** TURN *** [Td 7h 6h] [Th]
Klemtonius: bets 100
color_singleton: raises 2800 to 2900
Klemtonius: folds 
Uncalled bet (2800) returned to color_singleton
color_singleton collected 2338 from pot
color_singleton: doesn't show hand 
*** SUMMARY ***
Total pot 2474 | Rake 136 
Board [Td 7h 6h Th]
Seat 1: color_singleton (big blind) collected (2338)
Seat 2: manon327 folded on the Flop
Seat 4: PokerStarMan123 (button) folded before Flop (didn't bet)
Seat 6: Klemtonius (small blind) folded on the Turn



PokerStars Home Game Hand #226317500298: {DaPokaStars}  Hold'em No Limit (50/100) - 2021/04/29 19:12:01 ET
Table 'yes_sir' 9-max (Play Money) Seat #6 is the button
Seat 1: color_singleton (16705 in chips) 
Seat 2: manon327 (10155 in chips) 
Seat 4: PokerStarMan123 (9002 in chips) 
Seat 6: Klemtonius (19729 in chips) 
color_singleton: posts small blind 50
manon327: posts big blind 100
*** HOLE CARDS ***
Dealt to PokerStarMan123 [Kh 4h]
PokerStarMan123: folds 
Klemtonius: folds 
color_singleton: folds 
Uncalled bet (50) returned to manon327
manon327 collected 100 from pot
*** SUMMARY ***
Total pot 100 | Rake 0 
Seat 1: color_singleton (small blind) folded before Flop
Seat 2: manon327 (big blind) collected (100)
Seat 4: PokerStarMan123 folded before Flop (didn't bet)
Seat 6: Klemtonius (button) folded before Flop (didn't bet)



PokerStars Home Game Hand #226317506153: {DaPokaStars}  Hold'em No Limit (50/100) - 2021/04/29 19:12:16 ET
Table 'yes_sir' 9-max (Play Money) Seat #1 is the button
Seat 1: color_singleton (16655 in chips) 
Seat 2: manon327 (10205 in chips) 
Seat 4: PokerStarMan123 (9002 in chips) 
Seat 6: Klemtonius (19729 in chips) 
manon327: posts small blind 50
PokerStarMan123: posts big blind 100
*** HOLE CARDS ***
Dealt to PokerStarMan123 [7d 2h]
Klemtonius: raises 100 to 200
color_singleton: raises 200 to 400
manon327: folds 
PokerStarMan123: folds 
Klemtonius: calls 200
*** FLOP *** [6d Qc Qs]
Klemtonius: bets 898
color_singleton: calls 898
*** TURN *** [6d Qc Qs] [Ah]
Klemtonius: checks 
color_singleton: bets 1297
Klemtonius: folds 
Uncalled bet (1297) returned to color_singleton
color_singleton collected 2595 from pot
color_singleton: doesn't show hand 
*** SUMMARY ***
Total pot 2746 | Rake 151 
Board [6d Qc Qs Ah]
Seat 1: color_singleton (button) collected (2595)
Seat 2: manon327 (small blind) folded before Flop
Seat 4: PokerStarMan123 (big blind) folded before Flop
Seat 6: Klemtonius folded on the Turn



PokerStars Home Game Hand #226317527411: {DaPokaStars}  Hold'em No Limit (50/100) - 2021/04/29 19:13:12 ET
Table 'yes_sir' 9-max (Play Money) Seat #4 is the button
Seat 1: color_singleton (17952 in chips) 
Seat 4: PokerStarMan123 (8902 in chips) 
Seat 6: Klemtonius (18431 in chips) 
Klemtonius: posts small blind 50
color_singleton: posts big blind 100
*** HOLE CARDS ***
Dealt to PokerStarMan123 [4s 5s]
PokerStarMan123: calls 100
Klemtonius: raises 100 to 200
color_singleton: raises 200 to 400
PokerStarMan123: calls 300
Klemtonius: calls 200
*** FLOP *** [Qs 6c 5h]
Klemtonius: bets 1134
color_singleton: calls 1134
PokerStarMan123: folds 
*** TURN *** [Qs 6c 5h] [6s]
Klemtonius: bets 3277
color_singleton: folds 
Uncalled bet (3277) returned to Klemtonius
Klemtonius collected 3277 from pot
Klemtonius: doesn't show hand 
*** SUMMARY ***
Total pot 3468 | Rake 191 
Board [Qs 6c 5h 6s]
Seat 1: color_singleton (big blind) folded on the Turn
Seat 4: PokerStarMan123 (button) folded on the Flop
Seat 6: Klemtonius (small blind) collected (3277)



PokerStars Home Game Hand #226317545142: {DaPokaStars}  Hold'em No Limit (50/100) - 2021/04/29 19:13:59 ET
Table 'yes_sir' 9-max (Play Money) Seat #6 is the button
Seat 1: color_singleton (16418 in chips) 
Seat 4: PokerStarMan123 (8502 in chips) 
Seat 6: Klemtonius (20174 in chips) 
color_singleton: posts small blind 50
PokerStarMan123: posts big blind 100
*** HOLE CARDS ***
Dealt to PokerStarMan123 [Qs Jd]
Klemtonius: calls 100
color_singleton: raises 200 to 300
PokerStarMan123: calls 200
Klemtonius: calls 200
*** FLOP *** [3h 3d Td]
color_singleton: bets 850
PokerStarMan123: folds 
Klemtonius: folds 
Uncalled bet (850) returned to color_singleton
color_singleton collected 850 from pot
color_singleton: doesn't show hand 
*** SUMMARY ***
Total pot 900 | Rake 50 
Board [3h 3d Td]
Seat 1: color_singleton (small blind) collected (850)
Seat 4: PokerStarMan123 (big blind) folded on the Flop
Seat 6: Klemtonius (button) folded on the Flop



PokerStars Home Game Hand #226317551900: {DaPokaStars}  Hold'em No Limit (50/100) - 2021/04/29 19:14:17 ET
Table 'yes_sir' 9-max (Play Money) Seat #1 is the button
Seat 1: color_singleton (16968 in chips) 
Seat 4: PokerStarMan123 (8202 in chips) 
Seat 6: Klemtonius (19874 in chips) 
PokerStarMan123: posts small blind 50
Klemtonius: posts big blind 100
*** HOLE CARDS ***
Dealt to PokerStarMan123 [Kh 2c]
color_singleton: folds 
PokerStarMan123: calls 50
Klemtonius: raises 100 to 200
PokerStarMan123: calls 100
*** FLOP *** [5d Kd Ks]
PokerStarMan123: checks 
Klemtonius: bets 189
PokerStarMan123: calls 189
*** TURN *** [5d Kd Ks] [4h]
PokerStarMan123: checks 
Klemtonius: checks 
*** RIVER *** [5d Kd Ks 4h] [7c]
PokerStarMan123: bets 2000
Klemtonius: folds 
Uncalled bet (2000) returned to PokerStarMan123
PokerStarMan123 collected 735 from pot
*** SUMMARY ***
Total pot 778 | Rake 43 
Board [5d Kd Ks 4h 7c]
Seat 1: color_singleton (button) folded before Flop (didn't bet)
Seat 4: PokerStarMan123 (small blind) collected (735)
Seat 6: Klemtonius (big blind) folded on the River



PokerStars Home Game Hand #226317563445: {DaPokaStars}  Hold'em No Limit (50/100) - 2021/04/29 19:14:47 ET
Table 'yes_sir' 9-max (Play Money) Seat #4 is the button
Seat 1: color_singleton (16968 in chips) 
Seat 2: manon327 (10155 in chips) 
Seat 4: PokerStarMan123 (8548 in chips) 
Seat 6: Klemtonius (19485 in chips) 
Klemtonius: posts small blind 50
color_singleton: posts big blind 100
manon327: posts small & big blinds 150
*** HOLE CARDS ***
Dealt to PokerStarMan123 [3h 8s]
manon327: raises 100 to 200
PokerStarMan123: folds 
Klemtonius: folds 
color_singleton: calls 100
*** FLOP *** [8d 6d Kd]
color_singleton: checks 
manon327: bets 236
color_singleton: calls 236
*** TURN *** [8d 6d Kd] [9d]
color_singleton: bets 459
manon327: folds 
Uncalled bet (459) returned to color_singleton
color_singleton collected 919 from pot
color_singleton: doesn't show hand 
*** SUMMARY ***
Total pot 972 | Rake 53 
Board [8d 6d Kd 9d]
Seat 1: color_singleton (big blind) collected (919)
Seat 2: manon327 folded on the Turn
Seat 4: PokerStarMan123 (button) folded before Flop (didn't bet)
Seat 6: Klemtonius (small blind) folded before Flop



PokerStars Home Game Hand #226317578074: {DaPokaStars}  Hold'em No Limit (50/100) - 2021/04/29 19:15:25 ET
Table 'yes_sir' 9-max (Play Money) Seat #6 is the button
Seat 1: color_singleton (17451 in chips) 
Seat 2: manon327 (9669 in chips) 
Seat 4: PokerStarMan123 (8548 in chips) 
Seat 6: Klemtonius (19435 in chips) 
color_singleton: posts small blind 50
manon327: posts big blind 100
*** HOLE CARDS ***
Dealt to PokerStarMan123 [Kc 3d]
PokerStarMan123: folds 
Klemtonius: calls 100
color_singleton: folds 
manon327: checks 
*** FLOP *** [Td 6d 8d]
manon327: checks 
Klemtonius: bets 118
manon327: folds 
Uncalled bet (118) returned to Klemtonius
Klemtonius collected 236 from pot
Klemtonius: doesn't show hand 
*** SUMMARY ***
Total pot 250 | Rake 14 
Board [Td 6d 8d]
Seat 1: color_singleton (small blind) folded before Flop
Seat 2: manon327 (big blind) folded on the Flop
Seat 4: PokerStarMan123 folded before Flop (didn't bet)
Seat 6: Klemtonius (button) collected (236)



PokerStars Home Game Hand #226317587770: {DaPokaStars}  Hold'em No Limit (50/100) - 2021/04/29 19:15:51 ET
Table 'yes_sir' 9-max (Play Money) Seat #1 is the button
Seat 1: color_singleton (17401 in chips) 
Seat 2: manon327 (9569 in chips) 
Seat 4: PokerStarMan123 (8548 in chips) 
Seat 6: Klemtonius (19571 in chips) 
manon327: posts small blind 50
PokerStarMan123: posts big blind 100
*** HOLE CARDS ***
Dealt to PokerStarMan123 [5c 7h]
Klemtonius: raises 250 to 350
color_singleton: calls 350
manon327: calls 300
PokerStarMan123: folds 
*** FLOP *** [8d 9h 7d]
manon327: checks 
Klemtonius: bets 1087
color_singleton: calls 1087
manon327: folds 
*** TURN *** [8d 9h 7d] [8h]
Klemtonius: bets 1570
color_singleton: calls 1570
*** RIVER *** [8d 9h 7d 8h] [Jc]
Klemtonius: bets 3200
color_singleton: calls 3200
*** SHOW DOWN ***
Klemtonius: shows [4d Ah] (a pair of Eights)
color_singleton: shows [5h Th] (a straight, Seven to Jack)
color_singleton collected 12156 from pot
*** SUMMARY ***
Total pot 12864 | Rake 708 
Board [8d 9h 7d 8h Jc]
Seat 1: color_singleton (button) showed [5h Th] and won (12156) with a straight, Seven to Jack
Seat 2: manon327 (small blind) folded on the Flop
Seat 4: PokerStarMan123 (big blind) folded before Flop
Seat 6: Klemtonius showed [4d Ah] and lost with a pair of Eights



PokerStars Home Game Hand #226317607855: {DaPokaStars}  Hold'em No Limit (50/100) - 2021/04/29 19:16:44 ET
Table 'yes_sir' 9-max (Play Money) Seat #2 is the button
Seat 1: color_singleton (23350 in chips) 
Seat 2: manon327 (9219 in chips) 
Seat 4: PokerStarMan123 (8448 in chips) 
Seat 6: Klemtonius (13364 in chips) 
PokerStarMan123: posts small blind 50
Klemtonius: posts big blind 100
*** HOLE CARDS ***
Dealt to PokerStarMan123 [8h 4c]
color_singleton: raises 300 to 400
manon327: folds 
PokerStarMan123: folds 
Klemtonius: calls 300
*** FLOP *** [8d Kh Qh]
Klemtonius: checks 
color_singleton: checks 
*** TURN *** [8d Kh Qh] [Ah]
Klemtonius: checks 
color_singleton: bets 401
Klemtonius: folds 
Uncalled bet (401) returned to color_singleton
color_singleton collected 803 from pot
color_singleton: doesn't show hand 
*** SUMMARY ***
Total pot 850 | Rake 47 
Board [8d Kh Qh Ah]
Seat 1: color_singleton collected (803)
Seat 2: manon327 (button) folded before Flop (didn't bet)
Seat 4: PokerStarMan123 (small blind) folded before Flop
Seat 6: Klemtonius (big blind) folded on the Turn



PokerStars Home Game Hand #226317623222: {DaPokaStars}  Hold'em No Limit (50/100) - 2021/04/29 19:17:20 ET
Table 'yes_sir' 9-max (Play Money) Seat #4 is the button
Seat 1: color_singleton (23753 in chips) 
Seat 2: manon327 (9219 in chips) 
Seat 4: PokerStarMan123 (8398 in chips) 
Seat 6: Klemtonius (12964 in chips) 
Klemtonius: posts small blind 50
color_singleton: posts big blind 100
*** HOLE CARDS ***
Dealt to PokerStarMan123 [9s Qs]
manon327: folds 
PokerStarMan123: calls 100
Klemtonius: raises 100 to 200
color_singleton: folds 
PokerStarMan123: calls 100
*** FLOP *** [As 8s 9c]
Klemtonius: checks 
PokerStarMan123: bets 400
Klemtonius: folds 
Uncalled bet (400) returned to PokerStarMan123
PokerStarMan123 collected 472 from pot
*** SUMMARY ***
Total pot 500 | Rake 28 
Board [As 8s 9c]
Seat 1: color_singleton (big blind) folded before Flop
Seat 2: manon327 folded before Flop (didn't bet)
Seat 4: PokerStarMan123 (button) collected (472)
Seat 6: Klemtonius (small blind) folded on the Flop



PokerStars Home Game Hand #226317631087: {DaPokaStars}  Hold'em No Limit (50/100) - 2021/04/29 19:17:41 ET
Table 'yes_sir' 9-max (Play Money) Seat #6 is the button
Seat 1: color_singleton (23653 in chips) 
Seat 2: manon327 (9219 in chips) 
Seat 4: PokerStarMan123 (8670 in chips) 
Seat 6: Klemtonius (12764 in chips) 
color_singleton: posts small blind 50
manon327: posts big blind 100
*** HOLE CARDS ***
Dealt to PokerStarMan123 [Qs Kc]
PokerStarMan123: raises 300 to 400
Klemtonius: folds 
color_singleton: calls 350
manon327: calls 300
*** FLOP *** [4c 4h 4s]
color_singleton: checks 
manon327: bets 100
PokerStarMan123: calls 100
color_singleton: calls 100
*** TURN *** [4c 4h 4s] [6h]
color_singleton: checks 
manon327: bets 100
PokerStarMan123: calls 100
color_singleton: calls 100
*** RIVER *** [4c 4h 4s 6h] [5d]
color_singleton: bets 1701
manon327: calls 1701
PokerStarMan123: folds 
*** SHOW DOWN ***
color_singleton: shows [5s Ac] (a full house, Fours full of Fives)
manon327: shows [7s 7d] (a full house, Fours full of Sevens)
manon327 collected 4916 from pot
*** SUMMARY ***
Total pot 5202 | Rake 286 
Board [4c 4h 4s 6h 5d]
Seat 1: color_singleton (small blind) showed [5s Ac] and lost with a full house, Fours full of Fives
Seat 2: manon327 (big blind) showed [7s 7d] and won (4916) with a full house, Fours full of Sevens
Seat 4: PokerStarMan123 folded on the River
Seat 6: Klemtonius (button) folded before Flop (didn't bet)



PokerStars Home Game Hand #226317651948: {DaPokaStars}  Hold'em No Limit (50/100) - 2021/04/29 19:18:37 ET
Table 'yes_sir' 9-max (Play Money) Seat #1 is the button
Seat 1: color_singleton (21352 in chips) 
Seat 2: manon327 (11834 in chips) 
Seat 4: PokerStarMan123 (8070 in chips) 
Seat 6: Klemtonius (12764 in chips) 
manon327: posts small blind 50
PokerStarMan123: posts big blind 100
*** HOLE CARDS ***
Dealt to PokerStarMan123 [9h 4h]
Klemtonius: raises 100 to 200
color_singleton: raises 200 to 400
manon327: calls 350
PokerStarMan123: calls 300
Klemtonius: raises 1600 to 2000
color_singleton: folds 
manon327: folds 
PokerStarMan123: folds 
Uncalled bet (1600) returned to Klemtonius
Klemtonius collected 1600 from pot
Klemtonius: doesn't show hand 
*** SUMMARY ***
Total pot 1600 | Rake 0 
Seat 1: color_singleton (button) folded before Flop
Seat 2: manon327 (small blind) folded before Flop
Seat 4: PokerStarMan123 (big blind) folded before Flop
Seat 6: Klemtonius collected (1600)



PokerStars Home Game Hand #226317665150: {DaPokaStars}  Hold'em No Limit (50/100) - 2021/04/29 19:19:12 ET
Table 'yes_sir' 9-max (Play Money) Seat #2 is the button
Seat 1: color_singleton (20952 in chips) 
Seat 2: manon327 (11434 in chips) 
Seat 4: PokerStarMan123 (7670 in chips) 
Seat 6: Klemtonius (13964 in chips) 
PokerStarMan123: posts small blind 50
Klemtonius: posts big blind 100
*** HOLE CARDS ***
Dealt to PokerStarMan123 [Ts Kh]
color_singleton: folds 
manon327: folds 
PokerStarMan123: raises 300 to 400
Klemtonius: calls 300
*** FLOP *** [Kd 2s 6d]
PokerStarMan123: checks 
Klemtonius: bets 378
PokerStarMan123: raises 522 to 900
Klemtonius: folds 
Uncalled bet (522) returned to PokerStarMan123
PokerStarMan123 collected 1470 from pot
*** SUMMARY ***
Total pot 1556 | Rake 86 
Board [Kd 2s 6d]
Seat 1: color_singleton folded before Flop (didn't bet)
Seat 2: manon327 (button) folded before Flop (didn't bet)
Seat 4: PokerStarMan123 (small blind) collected (1470)
Seat 6: Klemtonius (big blind) folded on the Flop



PokerStars Home Game Hand #226317675905: {DaPokaStars}  Hold'em No Limit (50/100) - 2021/04/29 19:19:41 ET
Table 'yes_sir' 9-max (Play Money) Seat #4 is the button
Seat 1: color_singleton (20952 in chips) 
Seat 2: manon327 (11434 in chips) 
Seat 4: PokerStarMan123 (8362 in chips) 
Seat 6: Klemtonius (13186 in chips) 
Klemtonius: posts small blind 50
color_singleton: posts big blind 100
*** HOLE CARDS ***
Dealt to PokerStarMan123 [2s 4h]
manon327: calls 100
PokerStarMan123: folds 
Klemtonius: calls 50
color_singleton: checks 
*** FLOP *** [6h 4s 7s]
Klemtonius: bets 141
color_singleton has timed out
color_singleton: folds 
manon327: folds 
Uncalled bet (141) returned to Klemtonius
Klemtonius collected 283 from pot
Klemtonius: doesn't show hand 
*** SUMMARY ***
Total pot 300 | Rake 17 
Board [6h 4s 7s]
Seat 1: color_singleton (big blind) folded on the Flop
Seat 2: manon327 folded on the Flop
Seat 4: PokerStarMan123 (button) folded before Flop (didn't bet)
Seat 6: Klemtonius (small blind) collected (283)



PokerStars Home Game Hand #226317691344: {DaPokaStars}  Hold'em No Limit (50/100) - 2021/04/29 19:20:14 ET
Table 'yes_sir' 9-max (Play Money) Seat #6 is the button
Seat 2: manon327 (11334 in chips) 
Seat 4: PokerStarMan123 (8362 in chips) 
Seat 6: Klemtonius (13369 in chips) 
manon327: posts small blind 50
PokerStarMan123: posts big blind 100
*** HOLE CARDS ***
Dealt to PokerStarMan123 [6s Ks]
Klemtonius: raises 200 to 300
manon327: calls 250
PokerStarMan123: calls 200
*** FLOP *** [5s 4d 3d]
manon327: checks 
PokerStarMan123: bets 500
Klemtonius: calls 500
manon327: folds 
*** TURN *** [5s 4d 3d] [As]
PokerStarMan123: bets 1000
Klemtonius: calls 1000
*** RIVER *** [5s 4d 3d As] [3c]
PokerStarMan123: bets 1700
Klemtonius: raises 3700 to 5400
PokerStarMan123: folds 
Uncalled bet (3700) returned to Klemtonius
Klemtonius collected 6898 from pot
Klemtonius: doesn't show hand 
*** SUMMARY ***
Total pot 7300 | Rake 402 
Board [5s 4d 3d As 3c]
Seat 2: manon327 (small blind) folded on the Flop
Seat 4: PokerStarMan123 (big blind) folded on the River
Seat 6: Klemtonius (button) collected (6898)



PokerStars Home Game Hand #226317714755: {DaPokaStars}  Hold'em No Limit (50/100) - 2021/04/29 19:21:17 ET
Table 'yes_sir' 9-max (Play Money) Seat #2 is the button
Seat 1: color_singleton (20852 in chips) 
Seat 2: manon327 (11034 in chips) 
Seat 4: PokerStarMan123 (4862 in chips) 
Seat 6: Klemtonius (16767 in chips) 
PokerStarMan123: posts small blind 50
Klemtonius: posts big blind 100
color_singleton: posts small blind 50
*** HOLE CARDS ***
Dealt to PokerStarMan123 [Ah 2c]
color_singleton: raises 100 to 200
manon327: folds 
PokerStarMan123: folds 
Klemtonius: calls 100
*** FLOP *** [9d 9c 3s]
Klemtonius: checks 
color_singleton: checks 
*** TURN *** [9d 9c 3s] [2d]
Klemtonius: checks 
color_singleton: bets 472
Klemtonius: folds 
Uncalled bet (472) returned to color_singleton
color_singleton collected 472 from pot
color_singleton: doesn't show hand 
*** SUMMARY ***
Total pot 500 | Rake 28 
Board [9d 9c 3s 2d]
Seat 1: color_singleton collected (472)
Seat 2: manon327 (button) folded before Flop (didn't bet)
Seat 4: PokerStarMan123 (small blind) folded before Flop
Seat 6: Klemtonius (big blind) folded on the Turn



PokerStars Home Game Hand #226317735045: {DaPokaStars}  Hold'em No Limit (50/100) - 2021/04/29 19:22:02 ET
Table 'yes_sir' 9-max (Play Money) Seat #4 is the button
Seat 1: color_singleton (21074 in chips) 
Seat 2: manon327 (11034 in chips) 
Seat 4: PokerStarMan123 (4812 in chips) 
Seat 6: Klemtonius (16567 in chips) 
Klemtonius: posts small blind 50
color_singleton: posts big blind 100
*** HOLE CARDS ***
Dealt to PokerStarMan123 [Kh 3d]
manon327: folds 
PokerStarMan123: calls 100
Klemtonius: raises 200 to 300
color_singleton: calls 200
PokerStarMan123: calls 200
*** FLOP *** [7s 3s 2s]
Klemtonius: bets 425
color_singleton: calls 425
PokerStarMan123: folds 
*** TURN *** [7s 3s 2s] [7d]
Klemtonius: bets 1654
color_singleton: calls 1654
*** RIVER *** [7s 3s 2s 7d] [Ts]
Klemtonius: bets 4780
color_singleton: calls 4780
*** SHOW DOWN ***
Klemtonius: shows [4h 4s] (a flush, Ten high)
color_singleton: shows [5s 7c] (a flush, Ten high - Five higher)
color_singleton collected 13814 from pot
*** SUMMARY ***
Total pot 14618 | Rake 804 
Board [7s 3s 2s 7d Ts]
Seat 1: color_singleton (big blind) showed [5s 7c] and won (13814) with a flush, Ten high
Seat 2: manon327 folded before Flop (didn't bet)
Seat 4: PokerStarMan123 (button) folded on the Flop
Seat 6: Klemtonius (small blind) showed [4h 4s] and lost with a flush, Ten high



PokerStars Home Game Hand #226317753145: {DaPokaStars}  Hold'em No Limit (50/100) - 2021/04/29 19:22:51 ET
Table 'yes_sir' 9-max (Play Money) Seat #6 is the button
Seat 1: color_singleton (27729 in chips) 
Seat 2: manon327 (11034 in chips) 
Seat 4: PokerStarMan123 (4512 in chips) 
Seat 6: Klemtonius (9408 in chips) 
color_singleton: posts small blind 50
manon327: posts big blind 100
*** HOLE CARDS ***
Dealt to PokerStarMan123 [8h 2s]
PokerStarMan123: folds 
Klemtonius: raises 100 to 200
color_singleton: calls 150
manon327: folds 
*** FLOP *** [Js 8d 3d]
color_singleton: checks 
Klemtonius: bets 100
color_singleton: calls 100
*** TURN *** [Js 8d 3d] [7c]
color_singleton: checks 
Klemtonius: checks 
*** RIVER *** [Js 8d 3d 7c] [2d]
color_singleton: checks 
Klemtonius: checks 
*** SHOW DOWN ***
color_singleton: shows [4h Th] (high card Jack)
Klemtonius: shows [As 3h] (a pair of Threes)
Klemtonius collected 661 from pot
*** SUMMARY ***
Total pot 700 | Rake 39 
Board [Js 8d 3d 7c 2d]
Seat 1: color_singleton (small blind) showed [4h Th] and lost with high card Jack
Seat 2: manon327 (big blind) folded before Flop
Seat 4: PokerStarMan123 folded before Flop (didn't bet)
Seat 6: Klemtonius (button) showed [As 3h] and won (661) with a pair of Threes



PokerStars Home Game Hand #226317768203: {DaPokaStars}  Hold'em No Limit (50/100) - 2021/04/29 19:23:31 ET
Table 'yes_sir' 9-max (Play Money) Seat #1 is the button
Seat 1: color_singleton (27429 in chips) 
Seat 2: manon327 (10934 in chips) 
Seat 4: PokerStarMan123 (4512 in chips) 
Seat 6: Klemtonius (9769 in chips) 
manon327: posts small blind 50
PokerStarMan123: posts big blind 100
*** HOLE CARDS ***
Dealt to PokerStarMan123 [Kd Ac]
Klemtonius: raises 250 to 350
color_singleton: folds 
manon327: folds 
PokerStarMan123: raises 450 to 800
Klemtonius: calls 450
*** FLOP *** [3c 9c Jh]
PokerStarMan123: checks 
Klemtonius: checks 
*** TURN *** [3c 9c Jh] [7d]
PokerStarMan123: checks 
Klemtonius: checks 
*** RIVER *** [3c 9c Jh 7d] [Td]
PokerStarMan123: checks 
Klemtonius: bets 3500
PokerStarMan123: folds 
Uncalled bet (3500) returned to Klemtonius
Klemtonius collected 1559 from pot
Klemtonius: doesn't show hand 
*** SUMMARY ***
Total pot 1650 | Rake 91 
Board [3c 9c Jh 7d Td]
Seat 1: color_singleton (button) folded before Flop (didn't bet)
Seat 2: manon327 (small blind) folded before Flop
Seat 4: PokerStarMan123 (big blind) folded on the River
Seat 6: Klemtonius collected (1559)



PokerStars Home Game Hand #226317782505: {DaPokaStars}  Hold'em No Limit (50/100) - 2021/04/29 19:24:10 ET
Table 'yes_sir' 9-max (Play Money) Seat #2 is the button
Seat 1: color_singleton (27429 in chips) 
Seat 2: manon327 (10884 in chips) 
Seat 4: PokerStarMan123 (3712 in chips) 
Seat 6: Klemtonius (10528 in chips) 
PokerStarMan123: posts small blind 50
Klemtonius: posts big blind 100
*** HOLE CARDS ***
Dealt to PokerStarMan123 [2c Qs]
color_singleton: raises 200 to 300
manon327: calls 300
PokerStarMan123: folds 
Klemtonius: calls 200
*** FLOP *** [Jh 7c 4d]
Klemtonius: checks 
color_singleton: checks 
manon327: checks 
*** TURN *** [Jh 7c 4d] [8h]
Klemtonius: checks 
color_singleton: bets 449
manon327: folds 
Klemtonius: folds 
Uncalled bet (449) returned to color_singleton
color_singleton collected 898 from pot
color_singleton: doesn't show hand 
*** SUMMARY ***
Total pot 950 | Rake 52 
Board [Jh 7c 4d 8h]
Seat 1: color_singleton collected (898)
Seat 2: manon327 (button) folded on the Turn
Seat 4: PokerStarMan123 (small blind) folded before Flop
Seat 6: Klemtonius (big blind) folded on the Turn



PokerStars Home Game Hand #226317793943: {DaPokaStars}  Hold'em No Limit (50/100) - 2021/04/29 19:24:41 ET
Table 'yes_sir' 9-max (Play Money) Seat #4 is the button
Seat 1: color_singleton (28027 in chips) 
Seat 2: manon327 (10584 in chips) 
Seat 4: PokerStarMan123 (3662 in chips) 
Seat 6: Klemtonius (10228 in chips) 
Klemtonius: posts small blind 50
color_singleton: posts big blind 100
*** HOLE CARDS ***
Dealt to PokerStarMan123 [5h Ac]
manon327: calls 100
PokerStarMan123: calls 100
Klemtonius: calls 50
color_singleton: checks 
*** FLOP *** [As 9h Kd]
Klemtonius: checks 
color_singleton: checks 
manon327: checks 
PokerStarMan123: bets 300
Klemtonius: folds 
color_singleton: folds 
manon327: folds 
Uncalled bet (300) returned to PokerStarMan123
PokerStarMan123 collected 378 from pot
*** SUMMARY ***
Total pot 400 | Rake 22 
Board [As 9h Kd]
Seat 1: color_singleton (big blind) folded on the Flop
Seat 2: manon327 folded on the Flop
Seat 4: PokerStarMan123 (button) collected (378)
Seat 6: Klemtonius (small blind) folded on the Flop



PokerStars Home Game Hand #226317802361: {DaPokaStars}  Hold'em No Limit (50/100) - 2021/04/29 19:25:04 ET
Table 'yes_sir' 9-max (Play Money) Seat #6 is the button
Seat 1: color_singleton (27927 in chips) 
Seat 2: manon327 (10484 in chips) 
Seat 4: PokerStarMan123 (3940 in chips) 
Seat 6: Klemtonius (10128 in chips) 
color_singleton: posts small blind 50
manon327: posts big blind 100
*** HOLE CARDS ***
Dealt to PokerStarMan123 [7h Js]
PokerStarMan123: calls 100
Klemtonius: calls 100
color_singleton: folds 
manon327: checks 
*** FLOP *** [5s 8h 6c]
manon327: checks 
PokerStarMan123: bets 300
Klemtonius: folds 
manon327: folds 
Uncalled bet (300) returned to PokerStarMan123
PokerStarMan123 collected 331 from pot
*** SUMMARY ***
Total pot 350 | Rake 19 
Board [5s 8h 6c]
Seat 1: color_singleton (small blind) folded before Flop
Seat 2: manon327 (big blind) folded on the Flop
Seat 4: PokerStarMan123 collected (331)
Seat 6: Klemtonius (button) folded on the Flop



PokerStars Home Game Hand #226317809076: {DaPokaStars}  Hold'em No Limit (50/100) - 2021/04/29 19:25:22 ET
Table 'yes_sir' 9-max (Play Money) Seat #1 is the button
Seat 1: color_singleton (27877 in chips) 
Seat 2: manon327 (10384 in chips) 
Seat 4: PokerStarMan123 (4171 in chips) 
Seat 6: Klemtonius (10028 in chips) 
manon327: posts small blind 50
PokerStarMan123: posts big blind 100
*** HOLE CARDS ***
Dealt to PokerStarMan123 [Td 2c]
Klemtonius: raises 100 to 200
color_singleton: calls 200
manon327: folds 
PokerStarMan123: calls 100
*** FLOP *** [6c Ah Ts]
PokerStarMan123: checks 
Klemtonius: checks 
color_singleton: checks 
*** TURN *** [6c Ah Ts] [5h]
PokerStarMan123: bets 300
Klemtonius: calls 300
color_singleton: folds 
*** RIVER *** [6c Ah Ts 5h] [5c]
PokerStarMan123: bets 600
Klemtonius: folds 
Uncalled bet (600) returned to PokerStarMan123
PokerStarMan123 collected 1181 from pot
*** SUMMARY ***
Total pot 1250 | Rake 69 
Board [6c Ah Ts 5h 5c]
Seat 1: color_singleton (button) folded on the Turn
Seat 2: manon327 (small blind) folded before Flop
Seat 4: PokerStarMan123 (big blind) collected (1181)
Seat 6: Klemtonius folded on the River



PokerStars Home Game Hand #226317818864: {DaPokaStars}  Hold'em No Limit (50/100) - 2021/04/29 19:25:49 ET
Table 'yes_sir' 9-max (Play Money) Seat #2 is the button
Seat 1: color_singleton (27677 in chips) 
Seat 2: manon327 (10334 in chips) 
Seat 4: PokerStarMan123 (4852 in chips) 
Seat 6: Klemtonius (9528 in chips) 
PokerStarMan123: posts small blind 50
Klemtonius: posts big blind 100
*** HOLE CARDS ***
Dealt to PokerStarMan123 [7c 4c]
color_singleton: folds 
manon327: calls 100
PokerStarMan123: calls 50
Klemtonius: checks 
*** FLOP *** [Jc Ac Qc]
PokerStarMan123: bets 200
Klemtonius: calls 200
manon327: calls 200
*** TURN *** [Jc Ac Qc] [4s]
PokerStarMan123: bets 900
Klemtonius: calls 900
manon327: folds 
*** RIVER *** [Jc Ac Qc 4s] [2c]
PokerStarMan123: checks 
Klemtonius: bets 2551
PokerStarMan123: folds 
Uncalled bet (2551) returned to Klemtonius
Klemtonius collected 2551 from pot
Klemtonius: doesn't show hand 
*** SUMMARY ***
Total pot 2700 | Rake 149 
Board [Jc Ac Qc 4s 2c]
Seat 1: color_singleton folded before Flop (didn't bet)
Seat 2: manon327 (button) folded on the Turn
Seat 4: PokerStarMan123 (small blind) folded on the River
Seat 6: Klemtonius (big blind) collected (2551)



PokerStars Home Game Hand #226317833502: {DaPokaStars}  Hold'em No Limit (50/100) - 2021/04/29 19:26:29 ET
Table 'yes_sir' 9-max (Play Money) Seat #4 is the button
Seat 1: color_singleton (27677 in chips) 
Seat 2: manon327 (10034 in chips) 
Seat 4: PokerStarMan123 (3652 in chips) 
Seat 6: Klemtonius (10879 in chips) 
Klemtonius: posts small blind 50
color_singleton: posts big blind 100
*** HOLE CARDS ***
Dealt to PokerStarMan123 [4d 7d]
manon327 has timed out
manon327: folds 
PokerStarMan123: calls 100
Klemtonius: calls 50
color_singleton: checks 
*** FLOP *** [4h Ad 5s]
Klemtonius: checks 
color_singleton: checks 
PokerStarMan123: checks 
*** TURN *** [4h Ad 5s] [Th]
Klemtonius: bets 283
color_singleton: folds 
PokerStarMan123: folds 
Uncalled bet (283) returned to Klemtonius
Klemtonius collected 283 from pot
Klemtonius: doesn't show hand 
*** SUMMARY ***
Total pot 300 | Rake 17 
Board [4h Ad 5s Th]
Seat 1: color_singleton (big blind) folded on the Turn
Seat 2: manon327 folded before Flop (didn't bet)
Seat 4: PokerStarMan123 (button) folded on the Turn
Seat 6: Klemtonius (small blind) collected (283)



PokerStars Home Game Hand #226317856523: {DaPokaStars}  Hold'em No Limit (50/100) - 2021/04/29 19:27:32 ET
Table 'yes_sir' 9-max (Play Money) Seat #6 is the button
Seat 1: color_singleton (27577 in chips) 
Seat 2: manon327 (10034 in chips) 
Seat 4: PokerStarMan123 (3552 in chips) 
Seat 6: Klemtonius (11062 in chips) 
color_singleton: posts small blind 50
manon327: posts big blind 100
*** HOLE CARDS ***
Dealt to PokerStarMan123 [8d Ts]
PokerStarMan123: folds 
Klemtonius: calls 100
color_singleton: raises 200 to 300
manon327: folds 
Klemtonius: calls 200
*** FLOP *** [3s 8c 8h]
color_singleton: bets 661
Klemtonius: folds 
Uncalled bet (661) returned to color_singleton
color_singleton collected 661 from pot
color_singleton: doesn't show hand 
*** SUMMARY ***
Total pot 700 | Rake 39 
Board [3s 8c 8h]
Seat 1: color_singleton (small blind) collected (661)
Seat 2: manon327 (big blind) folded before Flop
Seat 4: PokerStarMan123 folded before Flop (didn't bet)
Seat 6: Klemtonius (button) folded on the Flop



PokerStars Home Game Hand #226317871555: {DaPokaStars}  Hold'em No Limit (50/100) - 2021/04/29 19:27:53 ET
Table 'yes_sir' 9-max (Play Money) Seat #1 is the button
Seat 1: color_singleton (27938 in chips) 
Seat 2: manon327 (9934 in chips) 
Seat 4: PokerStarMan123 (3552 in chips) 
Seat 6: Klemtonius (10762 in chips) 
manon327: posts small blind 50
PokerStarMan123: posts big blind 100
*** HOLE CARDS ***
Dealt to PokerStarMan123 [Qc 3d]
Klemtonius: folds 
color_singleton: raises 200 to 300
manon327: calls 250
PokerStarMan123: folds 
*** FLOP *** [Ts Jh 5h]
manon327: checks 
color_singleton: checks 
*** TURN *** [Ts Jh 5h] [5s]
manon327: checks 
color_singleton: checks 
*** RIVER *** [Ts Jh 5h 5s] [7h]
manon327: bets 661
color_singleton: folds 
Uncalled bet (661) returned to manon327
manon327 collected 661 from pot
*** SUMMARY ***
Total pot 700 | Rake 39 
Board [Ts Jh 5h 5s 7h]
Seat 1: color_singleton (button) folded on the River
Seat 2: manon327 (small blind) collected (661)
Seat 4: PokerStarMan123 (big blind) folded before Flop
Seat 6: Klemtonius folded before Flop (didn't bet)



PokerStars Home Game Hand #226317880125: {DaPokaStars}  Hold'em No Limit (50/100) - 2021/04/29 19:28:16 ET
Table 'yes_sir' 9-max (Play Money) Seat #2 is the button
Seat 1: color_singleton (27638 in chips) 
Seat 2: manon327 (10295 in chips) 
Seat 4: PokerStarMan123 (3452 in chips) 
Seat 6: Klemtonius (10762 in chips) 
PokerStarMan123: posts small blind 50
Klemtonius: posts big blind 100
*** HOLE CARDS ***
Dealt to PokerStarMan123 [Ad 6s]
color_singleton: raises 200 to 300
manon327: calls 300
PokerStarMan123: calls 250
Klemtonius: calls 200
*** FLOP *** [Ks 4c 2c]
PokerStarMan123: checks 
Klemtonius: bets 567
color_singleton: calls 567
manon327: calls 567
PokerStarMan123: folds 
*** TURN *** [Ks 4c 2c] [Qs]
Klemtonius: checks 
color_singleton: checks 
manon327: checks 
*** RIVER *** [Ks 4c 2c Qs] [As]
Klemtonius: checks 
color_singleton: bets 1370
manon327: folds 
Klemtonius: folds 
Uncalled bet (1370) returned to color_singleton
color_singleton collected 2741 from pot
color_singleton: doesn't show hand 
*** SUMMARY ***
Total pot 2901 | Rake 160 
Board [Ks 4c 2c Qs As]
Seat 1: color_singleton collected (2741)
Seat 2: manon327 (button) folded on the River
Seat 4: PokerStarMan123 (small blind) folded on the Flop
Seat 6: Klemtonius (big blind) folded on the River



PokerStars Home Game Hand #226317908561: {DaPokaStars}  Hold'em No Limit (50/100) - 2021/04/29 19:29:29 ET
Table 'yes_sir' 9-max (Play Money) Seat #4 is the button
Seat 1: color_singleton (29512 in chips) 
Seat 2: manon327 (9428 in chips) 
Seat 4: PokerStarMan123 (3152 in chips) 
Seat 6: Klemtonius (9895 in chips) 
Klemtonius: posts small blind 50
color_singleton: posts big blind 100
*** HOLE CARDS ***
Dealt to PokerStarMan123 [4c Qh]
manon327: folds 
PokerStarMan123: calls 100
Klemtonius: calls 50
color_singleton: checks 
*** FLOP *** [6h Ad 9d]
Klemtonius: checks 
color_singleton: checks 
PokerStarMan123: checks 
*** TURN *** [6h Ad 9d] [5h]
Klemtonius: checks 
color_singleton: bets 141
PokerStarMan123: folds 
Klemtonius: calls 141
*** RIVER *** [6h Ad 9d 5h] [9s]
Klemtonius: bets 550
color_singleton: folds 
Uncalled bet (550) returned to Klemtonius
Klemtonius collected 550 from pot
Klemtonius: doesn't show hand 
*** SUMMARY ***
Total pot 582 | Rake 32 
Board [6h Ad 9d 5h 9s]
Seat 1: color_singleton (big blind) folded on the River
Seat 2: manon327 folded before Flop (didn't bet)
Seat 4: PokerStarMan123 (button) folded on the Turn
Seat 6: Klemtonius (small blind) collected (550)



PokerStars Home Game Hand #226317923570: {DaPokaStars}  Hold'em No Limit (50/100) - 2021/04/29 19:30:11 ET
Table 'yes_sir' 9-max (Play Money) Seat #6 is the button
Seat 1: color_singleton (29271 in chips) 
Seat 2: manon327 (9428 in chips) 
Seat 4: PokerStarMan123 (3052 in chips) 
Seat 6: Klemtonius (10204 in chips) 
color_singleton: posts small blind 50
manon327: posts big blind 100
*** HOLE CARDS ***
Dealt to PokerStarMan123 [2s 2d]
PokerStarMan123: raises 300 to 400
Klemtonius: calls 400
color_singleton: calls 350
manon327: folds 
*** FLOP *** [Kc Ts 6c]
color_singleton: checks 
PokerStarMan123: bets 700
Klemtonius: raises 700 to 1400
color_singleton: folds 
PokerStarMan123: folds 
Uncalled bet (700) returned to Klemtonius
Klemtonius collected 2551 from pot
Klemtonius: doesn't show hand 
*** SUMMARY ***
Total pot 2700 | Rake 149 
Board [Kc Ts 6c]
Seat 1: color_singleton (small blind) folded on the Flop
Seat 2: manon327 (big blind) folded before Flop
Seat 4: PokerStarMan123 folded on the Flop
Seat 6: Klemtonius (button) collected (2551)



PokerStars Home Game Hand #226317931268: {DaPokaStars}  Hold'em No Limit (50/100) - 2021/04/29 19:30:32 ET
Table 'yes_sir' 9-max (Play Money) Seat #1 is the button
Seat 1: color_singleton (28871 in chips) 
Seat 2: manon327 (9328 in chips) 
Seat 4: PokerStarMan123 (1952 in chips) 
Seat 6: Klemtonius (11655 in chips) 
manon327: posts small blind 50
PokerStarMan123: posts big blind 100
*** HOLE CARDS ***
Dealt to PokerStarMan123 [Td 2c]
Klemtonius: raises 200 to 300
color_singleton: calls 300
manon327: calls 250
PokerStarMan123: folds 
*** FLOP *** [7c 8d 6s]
manon327: checks 
Klemtonius: bets 472
color_singleton: calls 472
manon327: folds 
*** TURN *** [7c 8d 6s] [8c]
Klemtonius: checks 
color_singleton: checks 
*** RIVER *** [7c 8d 6s 8c] [3d]
Klemtonius: bets 918
color_singleton: raises 1182 to 2100
Klemtonius: calls 1182
*** SHOW DOWN ***
color_singleton: shows [5h 4c] (a straight, Four to Eight)
Klemtonius: mucks hand 
color_singleton collected 5806 from pot
*** SUMMARY ***
Total pot 6144 | Rake 338 
Board [7c 8d 6s 8c 3d]
Seat 1: color_singleton (button) showed [5h 4c] and won (5806) with a straight, Four to Eight
Seat 2: manon327 (small blind) folded on the Flop
Seat 4: PokerStarMan123 (big blind) folded before Flop
Seat 6: Klemtonius mucked [8h Ks]



PokerStars Home Game Hand #226317949601: {DaPokaStars}  Hold'em No Limit (50/100) - 2021/04/29 19:31:23 ET
Table 'yes_sir' 9-max (Play Money) Seat #2 is the button
Seat 1: color_singleton (31805 in chips) 
Seat 2: manon327 (9028 in chips) 
Seat 4: PokerStarMan123 (1852 in chips) 
Seat 6: Klemtonius (8783 in chips) 
PokerStarMan123: posts small blind 50
Klemtonius: posts big blind 100
*** HOLE CARDS ***
Dealt to PokerStarMan123 [7h 8h]
color_singleton: raises 200 to 300
manon327: folds 
PokerStarMan123: calls 250
Klemtonius: calls 200
*** FLOP *** [5c 2s 6d]
PokerStarMan123: bets 1552 and is all-in
Klemtonius: calls 1552
color_singleton: folds 
*** TURN *** [5c 2s 6d] [As]
*** RIVER *** [5c 2s 6d As] [3d]
*** SHOW DOWN ***
PokerStarMan123: shows [7h 8h] (high card Ace)
Klemtonius: shows [6c 9c] (a pair of Sixes)
Klemtonius collected 3784 from pot
*** SUMMARY ***
Total pot 4004 | Rake 220 
Board [5c 2s 6d As 3d]
Seat 1: color_singleton folded on the Flop
Seat 2: manon327 (button) folded before Flop (didn't bet)
Seat 4: PokerStarMan123 (small blind) showed [7h 8h] and lost with high card Ace
Seat 6: Klemtonius (big blind) showed [6c 9c] and won (3784) with a pair of Sixes



