PokerStars Home Game Hand #225604200615: {DaPokaStars}  Hold'em No Limit (50/100) - 2021/04/07 15:39:57 ET
Table 'agian and again' 9-max (Play Money) Seat #1 is the button
Seat 1: color_singleton (12321 in chips) 
Seat 2: dhduncan (8533 in chips) 
Seat 3: PokerStarMan123 (10000 in chips) 
Seat 8: HighCardJasper (8962 in chips) 
Seat 9: manon327 (8783 in chips) 
dhduncan: posts small blind 50
PokerStarMan123: posts big blind 100
*** HOLE CARDS ***
Dealt to PokerStarMan123 [4s 8s]
HighCardJasper: calls 100
manon327: calls 100
color_singleton: folds 
dhduncan: calls 50
PokerStarMan123: checks 
*** FLOP *** [8d 7h Kh]
dhduncan: checks 
PokerStarMan123: checks 
HighCardJasper: bets 100
manon327: raises 100 to 200
dhduncan: folds 
PokerStarMan123: folds 
HighCardJasper: calls 100
*** TURN *** [8d 7h Kh] [Jh]
HighCardJasper: checks 
manon327: bets 756
HighCardJasper: folds 
Uncalled bet (756) returned to manon327
manon327 collected 756 from pot
*** SUMMARY ***
Total pot 800 | Rake 44 
Board [8d 7h Kh Jh]
Seat 1: color_singleton (button) folded before Flop (didn't bet)
Seat 2: dhduncan (small blind) folded on the Flop
Seat 3: PokerStarMan123 (big blind) folded on the Flop
Seat 8: HighCardJasper folded on the Turn
Seat 9: manon327 collected (756)



PokerStars Home Game Hand #225604236459: {DaPokaStars}  Hold'em No Limit (50/100) - 2021/04/07 15:40:50 ET
Table 'agian and again' 9-max (Play Money) Seat #2 is the button
Seat 1: color_singleton (12321 in chips) 
Seat 2: dhduncan (8433 in chips) 
Seat 3: PokerStarMan123 (9900 in chips) 
Seat 8: HighCardJasper (8662 in chips) 
Seat 9: manon327 (9239 in chips) 
PokerStarMan123: posts small blind 50
HighCardJasper: posts big blind 100
*** HOLE CARDS ***
Dealt to PokerStarMan123 [Ks 4c]
manon327: calls 100
color_singleton: raises 200 to 300
dhduncan: folds 
PokerStarMan123: folds 
HighCardJasper: folds 
manon327: calls 200
*** FLOP *** [7h 6s Qc]
manon327: checks 
color_singleton: checks 
*** TURN *** [7h 6s Qc] [Td]
manon327: checks 
color_singleton: bets 354
manon327: folds 
Uncalled bet (354) returned to color_singleton
color_singleton collected 709 from pot
color_singleton: doesn't show hand 
*** SUMMARY ***
Total pot 750 | Rake 41 
Board [7h 6s Qc Td]
Seat 1: color_singleton collected (709)
Seat 2: dhduncan (button) folded before Flop (didn't bet)
Seat 3: PokerStarMan123 (small blind) folded before Flop
Seat 8: HighCardJasper (big blind) folded before Flop
Seat 9: manon327 folded on the Turn



PokerStars Home Game Hand #225604262436: {DaPokaStars}  Hold'em No Limit (50/100) - 2021/04/07 15:41:29 ET
Table 'agian and again' 9-max (Play Money) Seat #3 is the button
Seat 1: color_singleton (12730 in chips) 
Seat 2: dhduncan (8433 in chips) 
Seat 3: PokerStarMan123 (9850 in chips) 
Seat 8: HighCardJasper (8562 in chips) 
Seat 9: manon327 (8939 in chips) 
HighCardJasper: posts small blind 50
manon327: posts big blind 100
*** HOLE CARDS ***
Dealt to PokerStarMan123 [Kd 3c]
color_singleton: raises 200 to 300
dhduncan: folds 
PokerStarMan123: folds 
HighCardJasper: folds 
manon327 has timed out
manon327: folds 
Uncalled bet (200) returned to color_singleton
color_singleton collected 250 from pot
color_singleton: doesn't show hand 
*** SUMMARY ***
Total pot 250 | Rake 0 
Seat 1: color_singleton collected (250)
Seat 2: dhduncan folded before Flop (didn't bet)
Seat 3: PokerStarMan123 (button) folded before Flop (didn't bet)
Seat 8: HighCardJasper (small blind) folded before Flop
Seat 9: manon327 (big blind) folded before Flop



PokerStars Home Game Hand #225604286654: {DaPokaStars}  Hold'em No Limit (50/100) - 2021/04/07 15:42:04 ET
Table 'agian and again' 9-max (Play Money) Seat #8 is the button
Seat 1: color_singleton (12880 in chips) 
Seat 2: dhduncan (8433 in chips) 
Seat 3: PokerStarMan123 (9850 in chips) 
Seat 8: HighCardJasper (8512 in chips) 
color_singleton: posts small blind 50
dhduncan: posts big blind 100
*** HOLE CARDS ***
Dealt to PokerStarMan123 [Qh 2s]
PokerStarMan123: folds 
HighCardJasper: calls 100
color_singleton: raises 200 to 300
dhduncan: calls 200
HighCardJasper: calls 200
*** FLOP *** [5d 8d Kh]
color_singleton: bets 425
dhduncan: folds 
HighCardJasper: calls 425
*** TURN *** [5d 8d Kh] [Kc]
color_singleton: bets 827
HighCardJasper: calls 827
*** RIVER *** [5d 8d Kh Kc] [9s]
color_singleton: checks 
HighCardJasper: checks 
*** SHOW DOWN ***
color_singleton: shows [5c Ac] (two pair, Kings and Fives)
HighCardJasper: shows [Ks Qd] (three of a kind, Kings)
HighCardJasper collected 3217 from pot
*** SUMMARY ***
Total pot 3404 | Rake 187 
Board [5d 8d Kh Kc 9s]
Seat 1: color_singleton (small blind) showed [5c Ac] and lost with two pair, Kings and Fives
Seat 2: dhduncan (big blind) folded on the Flop
Seat 3: PokerStarMan123 folded before Flop (didn't bet)
Seat 8: HighCardJasper (button) showed [Ks Qd] and won (3217) with three of a kind, Kings



PokerStars Home Game Hand #225604319888: {DaPokaStars}  Hold'em No Limit (50/100) - 2021/04/07 15:42:53 ET
Table 'agian and again' 9-max (Play Money) Seat #1 is the button
Seat 1: color_singleton (11328 in chips) 
Seat 2: dhduncan (8133 in chips) 
Seat 3: PokerStarMan123 (9850 in chips) 
Seat 8: HighCardJasper (10177 in chips) 
dhduncan: posts small blind 50
PokerStarMan123: posts big blind 100
*** HOLE CARDS ***
Dealt to PokerStarMan123 [Tc 7c]
HighCardJasper: calls 100
color_singleton: folds 
dhduncan: calls 50
PokerStarMan123: checks 
*** FLOP *** [7h Ac 6h]
dhduncan: bets 100
PokerStarMan123: calls 100
HighCardJasper: folds 
*** TURN *** [7h Ac 6h] [3h]
dhduncan: bets 472
PokerStarMan123: folds 
Uncalled bet (472) returned to dhduncan
dhduncan collected 472 from pot
dhduncan: doesn't show hand 
*** SUMMARY ***
Total pot 500 | Rake 28 
Board [7h Ac 6h 3h]
Seat 1: color_singleton (button) folded before Flop (didn't bet)
Seat 2: dhduncan (small blind) collected (472)
Seat 3: PokerStarMan123 (big blind) folded on the Turn
Seat 8: HighCardJasper folded on the Flop



PokerStars Home Game Hand #225604350877: {DaPokaStars}  Hold'em No Limit (50/100) - 2021/04/07 15:43:39 ET
Table 'agian and again' 9-max (Play Money) Seat #2 is the button
Seat 1: color_singleton (11328 in chips) 
Seat 2: dhduncan (8405 in chips) 
Seat 3: PokerStarMan123 (9650 in chips) 
Seat 8: HighCardJasper (10077 in chips) 
PokerStarMan123: posts small blind 50
HighCardJasper: posts big blind 100
*** HOLE CARDS ***
Dealt to PokerStarMan123 [2s Ks]
color_singleton: folds 
dhduncan: calls 100
PokerStarMan123: calls 50
Klemtonius joins the table at seat #4 
HighCardJasper has timed out
HighCardJasper: checks 
*** FLOP *** [8h 9c 6d]
PokerStarMan123: checks 
HighCardJasper has timed out
HighCardJasper: checks 
dhduncan: checks 
*** TURN *** [8h 9c 6d] [4s]
PokerStarMan123: checks 
HighCardJasper has timed out
HighCardJasper: checks 
dhduncan: checks 
*** RIVER *** [8h 9c 6d 4s] [4h]
PokerStarMan123 has timed out
PokerStarMan123: checks 
HighCardJasper has timed out
HighCardJasper: checks 
dhduncan: checks 
*** SHOW DOWN ***
PokerStarMan123: shows [2s Ks] (a pair of Fours)
HighCardJasper: shows [9d 6h] (two pair, Nines and Sixes)
dhduncan: mucks hand 
HighCardJasper collected 283 from pot
*** SUMMARY ***
Total pot 300 | Rake 17 
Board [8h 9c 6d 4s 4h]
Seat 1: color_singleton folded before Flop (didn't bet)
Seat 2: dhduncan (button) mucked [Kc Th]
Seat 3: PokerStarMan123 (small blind) showed [2s Ks] and lost with a pair of Fours
Seat 8: HighCardJasper (big blind) showed [9d 6h] and won (283) with two pair, Nines and Sixes



PokerStars Home Game Hand #225604445079: {DaPokaStars}  Hold'em No Limit (50/100) - 2021/04/07 15:45:47 ET
Table 'agian and again' 9-max (Play Money) Seat #3 is the button
Seat 1: color_singleton (11328 in chips) 
Seat 2: dhduncan (8305 in chips) 
Seat 3: PokerStarMan123 (9550 in chips) 
Seat 8: HighCardJasper (10260 in chips) 
Seat 9: manon327 (8839 in chips) 
HighCardJasper: posts small blind 50
manon327: posts big blind 100
*** HOLE CARDS ***
Dealt to PokerStarMan123 [8s 2s]
color_singleton: calls 100
dhduncan: calls 100
PokerStarMan123: folds 
HighCardJasper: calls 50
manon327: checks 
*** FLOP *** [3c 5c 5s]
HighCardJasper: bets 100
manon327: folds 
color_singleton: calls 100
dhduncan: folds 
*** TURN *** [3c 5c 5s] [8c]
HighCardJasper: bets 200
color_singleton: folds 
Uncalled bet (200) returned to HighCardJasper
HighCardJasper collected 567 from pot
HighCardJasper: doesn't show hand 
*** SUMMARY ***
Total pot 600 | Rake 33 
Board [3c 5c 5s 8c]
Seat 1: color_singleton folded on the Turn
Seat 2: dhduncan folded on the Flop
Seat 3: PokerStarMan123 (button) folded before Flop (didn't bet)
Seat 8: HighCardJasper (small blind) collected (567)
Seat 9: manon327 (big blind) folded on the Flop



PokerStars Home Game Hand #225604491740: {DaPokaStars}  Hold'em No Limit (50/100) - 2021/04/07 15:46:42 ET
Table 'agian and again' 9-max (Play Money) Seat #8 is the button
Seat 1: color_singleton (11128 in chips) 
Seat 2: dhduncan (8205 in chips) 
Seat 3: PokerStarMan123 (9550 in chips) 
Seat 4: Klemtonius (10000 in chips) 
Seat 8: HighCardJasper (10627 in chips) 
Seat 9: manon327 (8739 in chips) 
manon327: posts small blind 50
color_singleton: posts big blind 100
Klemtonius: posts big blind 100
*** HOLE CARDS ***
Dealt to PokerStarMan123 [4c 7d]
dhduncan: calls 100
PokerStarMan123: folds 
Klemtonius: checks 
HighCardJasper: calls 100
manon327: folds 
color_singleton: checks 
*** FLOP *** [6s 6h 8c]
color_singleton: checks 
dhduncan: checks 
Klemtonius: checks 
HighCardJasper: checks 
*** TURN *** [6s 6h 8c] [3s]
color_singleton: checks 
dhduncan: checks 
Klemtonius: bets 425
HighCardJasper: folds 
color_singleton: folds 
dhduncan: folds 
Uncalled bet (425) returned to Klemtonius
Klemtonius collected 425 from pot
Klemtonius: doesn't show hand 
*** SUMMARY ***
Total pot 450 | Rake 25 
Board [6s 6h 8c 3s]
Seat 1: color_singleton (big blind) folded on the Turn
Seat 2: dhduncan folded on the Turn
Seat 3: PokerStarMan123 folded before Flop (didn't bet)
Seat 4: Klemtonius collected (425)
Seat 8: HighCardJasper (button) folded on the Turn
Seat 9: manon327 (small blind) folded before Flop



PokerStars Home Game Hand #225604530583: {DaPokaStars}  Hold'em No Limit (50/100) - 2021/04/07 15:47:39 ET
Table 'agian and again' 9-max (Play Money) Seat #9 is the button
Seat 1: color_singleton (11028 in chips) 
Seat 2: dhduncan (8105 in chips) 
Seat 3: PokerStarMan123 (9550 in chips) 
Seat 4: Klemtonius (10325 in chips) 
Seat 8: HighCardJasper (10527 in chips) 
Seat 9: manon327 (8689 in chips) 
color_singleton: posts small blind 50
dhduncan: posts big blind 100
*** HOLE CARDS ***
Dealt to PokerStarMan123 [3h 8d]
PokerStarMan123: folds 
Klemtonius: raises 100 to 200
HighCardJasper: calls 200
manon327: folds 
color_singleton: calls 150
dhduncan: calls 100
*** FLOP *** [2s Ad 9h]
color_singleton: checks 
dhduncan: bets 100
Klemtonius: raises 400 to 500
HighCardJasper: folds 
color_singleton: folds 
dhduncan: calls 400
*** TURN *** [2s Ad 9h] [3s]
dhduncan: checks 
Klemtonius: bets 850
dhduncan: calls 850
*** RIVER *** [2s Ad 9h 3s] [Qc]
dhduncan: checks 
Klemtonius: bets 3307
dhduncan has timed out
dhduncan: folds 
Uncalled bet (3307) returned to Klemtonius
Klemtonius collected 3307 from pot
Klemtonius: doesn't show hand 
*** SUMMARY ***
Total pot 3500 | Rake 193 
Board [2s Ad 9h 3s Qc]
Seat 1: color_singleton (small blind) folded on the Flop
Seat 2: dhduncan (big blind) folded on the River
Seat 3: PokerStarMan123 folded before Flop (didn't bet)
Seat 4: Klemtonius collected (3307)
Seat 8: HighCardJasper folded on the Flop
Seat 9: manon327 (button) folded before Flop (didn't bet)



PokerStars Home Game Hand #225604593350: {DaPokaStars}  Hold'em No Limit (50/100) - 2021/04/07 15:49:12 ET
Table 'agian and again' 9-max (Play Money) Seat #1 is the button
Seat 1: color_singleton (10828 in chips) 
Seat 3: PokerStarMan123 (9550 in chips) 
Seat 4: Klemtonius (12082 in chips) 
Seat 8: HighCardJasper (10327 in chips) 
Seat 9: manon327 (8689 in chips) 
PokerStarMan123: posts small blind 50
Klemtonius: posts big blind 100
*** HOLE CARDS ***
Dealt to PokerStarMan123 [Kh Ad]
HighCardJasper: calls 100
manon327: folds 
color_singleton: raises 100 to 200
PokerStarMan123: raises 300 to 500
Klemtonius: folds 
HighCardJasper: calls 400
color_singleton: calls 300
*** FLOP *** [2s Ac 7s]
PokerStarMan123: bets 800
HighCardJasper: folds 
color_singleton: raises 800 to 1600
PokerStarMan123: calls 800
*** TURN *** [2s Ac 7s] [8s]
PokerStarMan123: checks 
color_singleton: bets 2268
PokerStarMan123: calls 2268
*** RIVER *** [2s Ac 7s 8s] [9s]
PokerStarMan123: checks 
color_singleton: bets 6460 and is all-in
PokerStarMan123: folds 
Uncalled bet (6460) returned to color_singleton
color_singleton collected 8823 from pot
color_singleton: doesn't show hand 
*** SUMMARY ***
Total pot 9336 | Rake 513 
Board [2s Ac 7s 8s 9s]
Seat 1: color_singleton (button) collected (8823)
Seat 3: PokerStarMan123 (small blind) folded on the River
Seat 4: Klemtonius (big blind) folded before Flop
Seat 8: HighCardJasper folded on the Flop
Seat 9: manon327 folded before Flop (didn't bet)



PokerStars Home Game Hand #225604635232: {DaPokaStars}  Hold'em No Limit (50/100) - 2021/04/07 15:50:14 ET
Table 'agian and again' 9-max (Play Money) Seat #3 is the button
Seat 1: color_singleton (15283 in chips) 
Seat 2: dhduncan (6555 in chips) 
Seat 3: PokerStarMan123 (5182 in chips) 
Seat 4: Klemtonius (11982 in chips) 
Seat 8: HighCardJasper (9827 in chips) 
Seat 9: manon327 (8689 in chips) 
Klemtonius: posts small blind 50
HighCardJasper: posts big blind 100
dhduncan: posts small blind 50
*** HOLE CARDS ***
Dealt to PokerStarMan123 [4h 9d]
manon327: calls 100
color_singleton: folds 
dhduncan: folds 
PokerStarMan123: folds 
Klemtonius: calls 50
HighCardJasper: checks 
*** FLOP *** [6c 5c Qc]
Klemtonius: bets 331
HighCardJasper: folds 
manon327: folds 
Uncalled bet (331) returned to Klemtonius
Klemtonius collected 331 from pot
Klemtonius: doesn't show hand 
*** SUMMARY ***
Total pot 350 | Rake 19 
Board [6c 5c Qc]
Seat 1: color_singleton folded before Flop (didn't bet)
Seat 2: dhduncan folded before Flop (didn't bet)
Seat 3: PokerStarMan123 (button) folded before Flop (didn't bet)
Seat 4: Klemtonius (small blind) collected (331)
Seat 8: HighCardJasper (big blind) folded on the Flop
Seat 9: manon327 folded on the Flop



PokerStars Home Game Hand #225604652532: {DaPokaStars}  Hold'em No Limit (50/100) - 2021/04/07 15:50:40 ET
Table 'agian and again' 9-max (Play Money) Seat #4 is the button
Seat 1: color_singleton (15283 in chips) 
Seat 2: dhduncan (6505 in chips) 
Seat 3: PokerStarMan123 (5182 in chips) 
Seat 4: Klemtonius (12213 in chips) 
Seat 8: HighCardJasper (9727 in chips) 
Seat 9: manon327 (8589 in chips) 
HighCardJasper: posts small blind 50
manon327: posts big blind 100
*** HOLE CARDS ***
Dealt to PokerStarMan123 [5s 4d]
color_singleton: raises 200 to 300
dhduncan: calls 300
PokerStarMan123: folds 
Klemtonius: raises 200 to 500
HighCardJasper: folds 
manon327: calls 400
color_singleton: calls 200
dhduncan: calls 200
*** FLOP *** [8h 4s 2s]
manon327: checks 
color_singleton: bets 968
dhduncan: folds 
Klemtonius: raises 4932 to 5900
manon327: folds 
color_singleton: folds 
Uncalled bet (4932) returned to Klemtonius
Klemtonius collected 3767 from pot
Klemtonius: doesn't show hand 
*** SUMMARY ***
Total pot 3986 | Rake 219 
Board [8h 4s 2s]
Seat 1: color_singleton folded on the Flop
Seat 2: dhduncan folded on the Flop
Seat 3: PokerStarMan123 folded before Flop (didn't bet)
Seat 4: Klemtonius (button) collected (3767)
Seat 8: HighCardJasper (small blind) folded before Flop
Seat 9: manon327 (big blind) folded on the Flop



PokerStars Home Game Hand #225604681748: {DaPokaStars}  Hold'em No Limit (50/100) - 2021/04/07 15:51:24 ET
Table 'agian and again' 9-max (Play Money) Seat #8 is the button
Seat 1: color_singleton (13815 in chips) 
Seat 2: dhduncan (6005 in chips) 
Seat 3: PokerStarMan123 (5182 in chips) 
Seat 4: Klemtonius (14512 in chips) 
Seat 8: HighCardJasper (9677 in chips) 
Seat 9: manon327 (8089 in chips) 
manon327: posts small blind 50
color_singleton: posts big blind 100
*** HOLE CARDS ***
Dealt to PokerStarMan123 [Kh 2d]
dhduncan: calls 100
PokerStarMan123: folds 
Klemtonius: raises 100 to 200
HighCardJasper: calls 200
manon327: calls 150
color_singleton: calls 100
dhduncan: calls 100
*** FLOP *** [Qd 2h 5s]
manon327: checks 
color_singleton: checks 
dhduncan: checks 
Klemtonius: checks 
HighCardJasper: checks 
*** TURN *** [Qd 2h 5s] [Ad]
manon327: bets 472
color_singleton: folds 
dhduncan: calls 472
Klemtonius: calls 472
HighCardJasper: calls 472
*** RIVER *** [Qd 2h 5s Ad] [Jc]
manon327: bets 1364
dhduncan: calls 1364
Klemtonius: folds 
HighCardJasper: folds 
*** SHOW DOWN ***
manon327: shows [5c Ah] (two pair, Aces and Fives)
dhduncan: mucks hand 
manon327 collected 5307 from pot
*** SUMMARY ***
Total pot 5616 | Rake 309 
Board [Qd 2h 5s Ad Jc]
Seat 1: color_singleton (big blind) folded on the Turn
Seat 2: dhduncan mucked [Ac Kc]
Seat 3: PokerStarMan123 folded before Flop (didn't bet)
Seat 4: Klemtonius folded on the River
Seat 8: HighCardJasper (button) folded on the River
Seat 9: manon327 (small blind) showed [5c Ah] and won (5307) with two pair, Aces and Fives



PokerStars Home Game Hand #225604745803: {DaPokaStars}  Hold'em No Limit (50/100) - 2021/04/07 15:52:59 ET
Table 'agian and again' 9-max (Play Money) Seat #9 is the button
Seat 1: color_singleton (13615 in chips) 
Seat 2: dhduncan (3969 in chips) 
Seat 3: PokerStarMan123 (5182 in chips) 
Seat 4: Klemtonius (13840 in chips) 
Seat 8: HighCardJasper (9005 in chips) 
Seat 9: manon327 (11360 in chips) 
color_singleton: posts small blind 50
dhduncan: posts big blind 100
*** HOLE CARDS ***
Dealt to PokerStarMan123 [Jd 3s]
PokerStarMan123 has timed out
PokerStarMan123: folds 
Klemtonius: raises 300 to 400
HighCardJasper: folds 
manon327: calls 400
color_singleton: folds 
dhduncan: calls 300
*** FLOP *** [7h As 4d]
dhduncan: checks 
Klemtonius: checks 
manon327: checks 
*** TURN *** [7h As 4d] [Th]
dhduncan: checks 
Klemtonius: bets 1181
manon327: folds 
dhduncan: calls 1181
*** RIVER *** [7h As 4d Th] [3h]
dhduncan: checks 
Klemtonius: bets 1706
dhduncan: calls 1706
*** SHOW DOWN ***
Klemtonius: shows [Kh Tc] (a pair of Tens)
dhduncan: shows [Ad Ks] (a pair of Aces)
dhduncan collected 6638 from pot
*** SUMMARY ***
Total pot 7024 | Rake 386 
Board [7h As 4d Th 3h]
Seat 1: color_singleton (small blind) folded before Flop
Seat 2: dhduncan (big blind) showed [Ad Ks] and won (6638) with a pair of Aces
Seat 3: PokerStarMan123 folded before Flop (didn't bet)
Seat 4: Klemtonius showed [Kh Tc] and lost with a pair of Tens
Seat 8: HighCardJasper folded before Flop (didn't bet)
Seat 9: manon327 (button) folded on the Turn



PokerStars Home Game Hand #225604799973: {DaPokaStars}  Hold'em No Limit (50/100) - 2021/04/07 15:54:19 ET
Table 'agian and again' 9-max (Play Money) Seat #1 is the button
Seat 1: color_singleton (13565 in chips) 
Seat 2: dhduncan (7320 in chips) 
Seat 3: PokerStarMan123 (5182 in chips) 
Seat 4: Klemtonius (10553 in chips) 
Seat 8: HighCardJasper (9005 in chips) 
Seat 9: manon327 (10960 in chips) 
dhduncan: posts small blind 50
PokerStarMan123: posts big blind 100
*** HOLE CARDS ***
Dealt to PokerStarMan123 [As Qc]
Klemtonius: raises 250 to 350
HighCardJasper: calls 350
manon327: folds 
color_singleton: calls 350
dhduncan: calls 300
PokerStarMan123: calls 250
*** FLOP *** [4h 5d Ah]
dhduncan: checks 
PokerStarMan123: bets 900
Klemtonius: calls 900
HighCardJasper: folds 
color_singleton: calls 900
dhduncan: folds 
*** TURN *** [4h 5d Ah] [Tc]
PokerStarMan123: checks 
Klemtonius: checks 
color_singleton: bets 2102
PokerStarMan123: raises 1830 to 3932 and is all-in
Klemtonius: folds 
color_singleton: calls 1830
*** RIVER *** [4h 5d Ah Tc] [2d]
*** SHOW DOWN ***
PokerStarMan123: shows [As Qc] (a pair of Aces)
color_singleton: shows [Th Ac] (two pair, Aces and Tens)
color_singleton collected 11637 from pot
*** SUMMARY ***
Total pot 12314 | Rake 677 
Board [4h 5d Ah Tc 2d]
Seat 1: color_singleton (button) showed [Th Ac] and won (11637) with two pair, Aces and Tens
Seat 2: dhduncan (small blind) folded on the Flop
Seat 3: PokerStarMan123 (big blind) showed [As Qc] and lost with a pair of Aces
Seat 4: Klemtonius folded on the Turn
Seat 8: HighCardJasper folded on the Flop
Seat 9: manon327 folded before Flop (didn't bet)



PokerStars Home Game Hand #225604879335: {DaPokaStars}  Hold'em No Limit (50/100) - 2021/04/07 15:56:49 ET
Table 'agian and again' 9-max (Play Money) Seat #4 is the button
Seat 1: color_singleton (20020 in chips) 
Seat 2: dhduncan (6980 in chips) 
Seat 3: PokerStarMan123 (10000 in chips) 
Seat 4: Klemtonius (9314 in chips) 
Seat 8: HighCardJasper (8455 in chips) 
Seat 9: manon327 (10760 in chips) 
HighCardJasper: posts small blind 50
manon327: posts big blind 100
PokerStarMan123: posts small blind 50
*** HOLE CARDS ***
Dealt to PokerStarMan123 [4d 3s]
color_singleton: folds 
dhduncan: folds 
PokerStarMan123: calls 100
Klemtonius: calls 100
HighCardJasper: calls 50
manon327: checks 
*** FLOP *** [6s 8d Tc]
HighCardJasper: checks 
manon327: checks 
PokerStarMan123: checks 
Klemtonius: checks 
*** TURN *** [6s 8d Tc] [8c]
HighCardJasper: bets 200
manon327: folds 
PokerStarMan123: folds 
Klemtonius: raises 800 to 1000
HighCardJasper: folds 
Uncalled bet (800) returned to Klemtonius
Klemtonius collected 803 from pot
Klemtonius: doesn't show hand 
*** SUMMARY ***
Total pot 850 | Rake 47 
Board [6s 8d Tc 8c]
Seat 1: color_singleton folded before Flop (didn't bet)
Seat 2: dhduncan folded before Flop (didn't bet)
Seat 3: PokerStarMan123 folded on the Turn
Seat 4: Klemtonius (button) collected (803)
Seat 8: HighCardJasper (small blind) folded on the Turn
Seat 9: manon327 (big blind) folded on the Turn



PokerStars Home Game Hand #225604905267: {DaPokaStars}  Hold'em No Limit (50/100) - 2021/04/07 15:57:46 ET
Table 'agian and again' 9-max (Play Money) Seat #8 is the button
Seat 1: color_singleton (20020 in chips) 
Seat 2: dhduncan (6980 in chips) 
Seat 3: PokerStarMan123 (9850 in chips) 
Seat 4: Klemtonius (9817 in chips) 
Seat 8: HighCardJasper (8155 in chips) 
Seat 9: manon327 (10660 in chips) 
manon327: posts small blind 50
color_singleton: posts big blind 100
*** HOLE CARDS ***
Dealt to PokerStarMan123 [5d Js]
dhduncan: calls 100
PokerStarMan123: folds 
Klemtonius: raises 500 to 600
HighCardJasper: folds 
manon327: folds 
color_singleton: folds 
dhduncan: calls 500
*** FLOP *** [Jh 2h Ah]
dhduncan: checks 
Klemtonius: bets 638
dhduncan: calls 638
*** TURN *** [Jh 2h Ah] [2s]
dhduncan: bets 700
Klemtonius: raises 7879 to 8579 and is all-in
dhduncan: calls 5042 and is all-in
Uncalled bet (2837) returned to Klemtonius
*** RIVER *** [Jh 2h Ah 2s] [2c]
*** SHOW DOWN ***
dhduncan: shows [Ac 7s] (a full house, Deuces full of Aces)
Klemtonius: shows [Qs As] (a full house, Deuces full of Aces)
dhduncan collected 6667 from pot
Klemtonius collected 6667 from pot
*** SUMMARY ***
Total pot 14110 | Rake 776 
Board [Jh 2h Ah 2s 2c]
Seat 1: color_singleton (big blind) folded before Flop
Seat 2: dhduncan showed [Ac 7s] and won (6667) with a full house, Deuces full of Aces
Seat 3: PokerStarMan123 folded before Flop (didn't bet)
Seat 4: Klemtonius showed [Qs As] and won (6667) with a full house, Deuces full of Aces
Seat 8: HighCardJasper (button) folded before Flop (didn't bet)
Seat 9: manon327 (small blind) folded before Flop



PokerStars Home Game Hand #225604921662: {DaPokaStars}  Hold'em No Limit (50/100) - 2021/04/07 15:58:22 ET
Table 'agian and again' 9-max (Play Money) Seat #9 is the button
Seat 1: color_singleton (19920 in chips) 
Seat 2: dhduncan (6667 in chips) 
Seat 3: PokerStarMan123 (9850 in chips) 
Seat 4: Klemtonius (9504 in chips) 
Seat 8: HighCardJasper (8155 in chips) 
Seat 9: manon327 (10610 in chips) 
color_singleton: posts small blind 50
dhduncan: posts big blind 100
*** HOLE CARDS ***
Dealt to PokerStarMan123 [6s 4s]
PokerStarMan123: calls 100
Klemtonius: folds 
HighCardJasper: calls 100
manon327: calls 100
color_singleton: folds 
dhduncan: checks 
*** FLOP *** [Kd 5d 5c]
dhduncan: checks 
PokerStarMan123: checks 
HighCardJasper: bets 200
manon327: calls 200
dhduncan: calls 200
PokerStarMan123: folds 
*** TURN *** [Kd 5d 5c] [9h]
dhduncan: checks 
HighCardJasper: bets 200
manon327: folds 
dhduncan: calls 200
*** RIVER *** [Kd 5d 5c 9h] [6c]
dhduncan: checks 
HighCardJasper: checks 
*** SHOW DOWN ***
dhduncan: shows [8c 8d] (two pair, Eights and Fives)
HighCardJasper: shows [9d Td] (two pair, Nines and Fives)
HighCardJasper collected 1370 from pot
*** SUMMARY ***
Total pot 1450 | Rake 80 
Board [Kd 5d 5c 9h 6c]
Seat 1: color_singleton (small blind) folded before Flop
Seat 2: dhduncan (big blind) showed [8c 8d] and lost with two pair, Eights and Fives
Seat 3: PokerStarMan123 folded on the Flop
Seat 4: Klemtonius folded before Flop (didn't bet)
Seat 8: HighCardJasper showed [9d Td] and won (1370) with two pair, Nines and Fives
Seat 9: manon327 (button) folded on the Turn



PokerStars Home Game Hand #225604953667: {DaPokaStars}  Hold'em No Limit (50/100) - 2021/04/07 15:59:32 ET
Table 'agian and again' 9-max (Play Money) Seat #1 is the button
Seat 1: color_singleton (19870 in chips) 
Seat 2: dhduncan (6167 in chips) 
Seat 3: PokerStarMan123 (9750 in chips) 
Seat 4: Klemtonius (9504 in chips) 
Seat 8: HighCardJasper (9025 in chips) 
Seat 9: manon327 (10310 in chips) 
dhduncan: posts small blind 50
PokerStarMan123: posts big blind 100
*** HOLE CARDS ***
Dealt to PokerStarMan123 [Tc Ks]
Klemtonius: folds 
HighCardJasper: calls 100
manon327: calls 100
color_singleton: folds 
dhduncan: folds 
PokerStarMan123: checks 
*** FLOP *** [Qd Ah 3s]
PokerStarMan123: checks 
HighCardJasper: bets 200
manon327: calls 200
PokerStarMan123: folds 
*** TURN *** [Qd Ah 3s] [6h]
HighCardJasper: bets 300
manon327: folds 
Uncalled bet (300) returned to HighCardJasper
HighCardJasper collected 709 from pot
HighCardJasper: doesn't show hand 
*** SUMMARY ***
Total pot 750 | Rake 41 
Board [Qd Ah 3s 6h]
Seat 1: color_singleton (button) folded before Flop (didn't bet)
Seat 2: dhduncan (small blind) folded before Flop
Seat 3: PokerStarMan123 (big blind) folded on the Flop
Seat 4: Klemtonius folded before Flop (didn't bet)
Seat 8: HighCardJasper collected (709)
Seat 9: manon327 folded on the Turn



PokerStars Home Game Hand #225604971020: {DaPokaStars}  Hold'em No Limit (50/100) - 2021/04/07 16:00:09 ET
Table 'agian and again' 9-max (Play Money) Seat #2 is the button
Seat 1: color_singleton (19870 in chips) 
Seat 2: dhduncan (6117 in chips) 
Seat 3: PokerStarMan123 (9650 in chips) 
Seat 4: Klemtonius (9504 in chips) 
Seat 8: HighCardJasper (9434 in chips) 
Seat 9: manon327 (10010 in chips) 
PokerStarMan123: posts small blind 50
Klemtonius: posts big blind 100
*** HOLE CARDS ***
Dealt to PokerStarMan123 [Ks 3h]
HighCardJasper: raises 100 to 200
manon327: folds 
color_singleton has timed out
color_singleton: folds 
dhduncan: folds 
PokerStarMan123: folds 
Klemtonius: calls 100
*** FLOP *** [3c Ac Kc]
Klemtonius: checks 
HighCardJasper: checks 
*** TURN *** [3c Ac Kc] [2c]
Klemtonius: checks 
HighCardJasper: bets 200
Klemtonius: folds 
Uncalled bet (200) returned to HighCardJasper
HighCardJasper collected 425 from pot
HighCardJasper: doesn't show hand 
*** SUMMARY ***
Total pot 450 | Rake 25 
Board [3c Ac Kc 2c]
Seat 1: color_singleton folded before Flop (didn't bet)
Seat 2: dhduncan (button) folded before Flop (didn't bet)
Seat 3: PokerStarMan123 (small blind) folded before Flop
Seat 4: Klemtonius (big blind) folded on the Turn
Seat 8: HighCardJasper collected (425)
Seat 9: manon327 folded before Flop (didn't bet)



PokerStars Home Game Hand #225604995127: {DaPokaStars}  Hold'em No Limit (50/100) - 2021/04/07 16:00:58 ET
Table 'agian and again' 9-max (Play Money) Seat #3 is the button
Seat 2: dhduncan (6117 in chips) 
Seat 3: PokerStarMan123 (9600 in chips) 
Seat 4: Klemtonius (9304 in chips) 
Seat 8: HighCardJasper (9659 in chips) 
Seat 9: manon327 (10010 in chips) 
Klemtonius: posts small blind 50
HighCardJasper: posts big blind 100
*** HOLE CARDS ***
Dealt to PokerStarMan123 [Jd 9s]
manon327: calls 100
dhduncan: calls 100
PokerStarMan123: calls 100
Klemtonius: raises 500 to 600
HighCardJasper: calls 500
manon327: folds 
dhduncan: folds 
PokerStarMan123: folds 
*** FLOP *** [9h Jc 7s]
Klemtonius: bets 708
HighCardJasper: folds 
Uncalled bet (708) returned to Klemtonius
Klemtonius collected 1417 from pot
Klemtonius: doesn't show hand 
*** SUMMARY ***
Total pot 1500 | Rake 83 
Board [9h Jc 7s]
Seat 2: dhduncan folded before Flop
Seat 3: PokerStarMan123 (button) folded before Flop
Seat 4: Klemtonius (small blind) collected (1417)
Seat 8: HighCardJasper (big blind) folded on the Flop
Seat 9: manon327 folded before Flop



PokerStars Home Game Hand #225605023777: {DaPokaStars}  Hold'em No Limit (50/100) - 2021/04/07 16:01:49 ET
Table 'agian and again' 9-max (Play Money) Seat #4 is the button
Seat 1: color_singleton (19870 in chips) 
Seat 2: dhduncan (6017 in chips) 
Seat 3: PokerStarMan123 (9500 in chips) 
Seat 4: Klemtonius (10121 in chips) 
Seat 8: HighCardJasper (9059 in chips) 
Seat 9: manon327 (9910 in chips) 
HighCardJasper: posts small blind 50
manon327: posts big blind 100
*** HOLE CARDS ***
Dealt to PokerStarMan123 [5c 5s]
color_singleton: raises 100 to 200
dhduncan: folds 
PokerStarMan123: raises 200 to 400
Klemtonius: folds 
HighCardJasper: calls 350
manon327: calls 300
color_singleton: calls 200
*** FLOP *** [Ad 7d 6c]
HighCardJasper: checks 
manon327: bets 1512
color_singleton: calls 1512
PokerStarMan123: folds 
HighCardJasper: folds 
*** TURN *** [Ad 7d 6c] [Qd]
manon327: bets 4370
color_singleton: folds 
Uncalled bet (4370) returned to manon327
manon327 collected 4370 from pot
*** SUMMARY ***
Total pot 4624 | Rake 254 
Board [Ad 7d 6c Qd]
Seat 1: color_singleton folded on the Turn
Seat 2: dhduncan folded before Flop (didn't bet)
Seat 3: PokerStarMan123 folded on the Flop
Seat 4: Klemtonius (button) folded before Flop (didn't bet)
Seat 8: HighCardJasper (small blind) folded on the Flop
Seat 9: manon327 (big blind) collected (4370)



PokerStars Home Game Hand #225605055538: {DaPokaStars}  Hold'em No Limit (50/100) - 2021/04/07 16:02:38 ET
Table 'agian and again' 9-max (Play Money) Seat #8 is the button
Seat 1: color_singleton (17958 in chips) 
Seat 2: dhduncan (6017 in chips) 
Seat 3: PokerStarMan123 (9100 in chips) 
Seat 4: Klemtonius (10121 in chips) 
Seat 8: HighCardJasper (8659 in chips) 
Seat 9: manon327 (12368 in chips) 
manon327: posts small blind 50
color_singleton: posts big blind 100
*** HOLE CARDS ***
Dealt to PokerStarMan123 [Tc 2s]
dhduncan: folds 
PokerStarMan123: folds 
Klemtonius: calls 100
HighCardJasper: folds 
manon327: folds 
color_singleton: checks 
*** FLOP *** [6d 2c Kc]
color_singleton: checks 
Klemtonius: bets 100
color_singleton: folds 
Uncalled bet (100) returned to Klemtonius
Klemtonius collected 236 from pot
Klemtonius: doesn't show hand 
*** SUMMARY ***
Total pot 250 | Rake 14 
Board [6d 2c Kc]
Seat 1: color_singleton (big blind) folded on the Flop
Seat 2: dhduncan folded before Flop (didn't bet)
Seat 3: PokerStarMan123 folded before Flop (didn't bet)
Seat 4: Klemtonius collected (236)
Seat 8: HighCardJasper (button) folded before Flop (didn't bet)
Seat 9: manon327 (small blind) folded before Flop



PokerStars Home Game Hand #225605073492: {DaPokaStars}  Hold'em No Limit (50/100) - 2021/04/07 16:03:04 ET
Table 'agian and again' 9-max (Play Money) Seat #9 is the button
Seat 1: color_singleton (17858 in chips) 
Seat 2: dhduncan (6017 in chips) 
Seat 3: PokerStarMan123 (9100 in chips) 
Seat 4: Klemtonius (10257 in chips) 
Seat 8: HighCardJasper (8659 in chips) 
Seat 9: manon327 (12318 in chips) 
color_singleton: posts small blind 50
dhduncan: posts big blind 100
*** HOLE CARDS ***
Dealt to PokerStarMan123 [Js Kc]
PokerStarMan123: raises 300 to 400
Klemtonius: calls 400
HighCardJasper: folds 
manon327: calls 400
color_singleton: folds 
dhduncan: folds 
*** FLOP *** [6d 2h 4d]
PokerStarMan123: checks 
Klemtonius: checks 
manon327: checks 
*** TURN *** [6d 2h 4d] [6c]
PokerStarMan123: checks 
Klemtonius: bets 1276
manon327: folds 
PokerStarMan123: folds 
Uncalled bet (1276) returned to Klemtonius
Klemtonius collected 1276 from pot
Klemtonius: doesn't show hand 
*** SUMMARY ***
Total pot 1350 | Rake 74 
Board [6d 2h 4d 6c]
Seat 1: color_singleton (small blind) folded before Flop
Seat 2: dhduncan (big blind) folded before Flop
Seat 3: PokerStarMan123 folded on the Turn
Seat 4: Klemtonius collected (1276)
Seat 8: HighCardJasper folded before Flop (didn't bet)
Seat 9: manon327 (button) folded on the Turn



PokerStars Home Game Hand #225605098532: {DaPokaStars}  Hold'em No Limit (50/100) - 2021/04/07 16:03:41 ET
Table 'agian and again' 9-max (Play Money) Seat #1 is the button
Seat 1: color_singleton (17808 in chips) 
Seat 2: dhduncan (5917 in chips) 
Seat 3: PokerStarMan123 (8700 in chips) 
Seat 4: Klemtonius (11133 in chips) 
Seat 8: HighCardJasper (8659 in chips) 
Seat 9: manon327 (11918 in chips) 
dhduncan: posts small blind 50
PokerStarMan123: posts big blind 100
*** HOLE CARDS ***
Dealt to PokerStarMan123 [7d 6s]
Klemtonius: calls 100
HighCardJasper: calls 100
manon327: folds 
color_singleton: calls 100
dhduncan: calls 50
PokerStarMan123: checks 
*** FLOP *** [Ts Ah 3d]
dhduncan: checks 
PokerStarMan123: checks 
Klemtonius: checks 
HighCardJasper: checks 
color_singleton: checks 
*** TURN *** [Ts Ah 3d] [3h]
dhduncan: checks 
PokerStarMan123: checks 
Klemtonius: checks 
HighCardJasper: checks 
color_singleton: bets 236
dhduncan: folds 
PokerStarMan123: folds 
Klemtonius: folds 
HighCardJasper: folds 
Uncalled bet (236) returned to color_singleton
color_singleton collected 472 from pot
color_singleton: doesn't show hand 
*** SUMMARY ***
Total pot 500 | Rake 28 
Board [Ts Ah 3d 3h]
Seat 1: color_singleton (button) collected (472)
Seat 2: dhduncan (small blind) folded on the Turn
Seat 3: PokerStarMan123 (big blind) folded on the Turn
Seat 4: Klemtonius folded on the Turn
Seat 8: HighCardJasper folded on the Turn
Seat 9: manon327 folded before Flop (didn't bet)



PokerStars Home Game Hand #225605159989: {DaPokaStars}  Hold'em No Limit (50/100) - 2021/04/07 16:05:11 ET
Table 'agian and again' 9-max (Play Money) Seat #2 is the button
Seat 1: color_singleton (18180 in chips) 
Seat 2: dhduncan (5817 in chips) 
Seat 3: PokerStarMan123 (8600 in chips) 
Seat 4: Klemtonius (11033 in chips) 
Seat 8: HighCardJasper (8559 in chips) 
Seat 9: manon327 (11918 in chips) 
PokerStarMan123: posts small blind 50
Klemtonius: posts big blind 100
*** HOLE CARDS ***
Dealt to PokerStarMan123 [2s 6h]
HighCardJasper: calls 100
manon327: calls 100
color_singleton: folds 
dhduncan: calls 100
PokerStarMan123: calls 50
Klemtonius: checks 
*** FLOP *** [9c 8d Ad]
PokerStarMan123: checks 
Klemtonius: checks 
HighCardJasper: bets 200
manon327: calls 200
dhduncan: folds 
PokerStarMan123: folds 
Klemtonius: folds 
*** TURN *** [9c 8d Ad] [4d]
HighCardJasper: bets 200
manon327: folds 
Uncalled bet (200) returned to HighCardJasper
HighCardJasper collected 850 from pot
HighCardJasper: doesn't show hand 
*** SUMMARY ***
Total pot 900 | Rake 50 
Board [9c 8d Ad 4d]
Seat 1: color_singleton folded before Flop (didn't bet)
Seat 2: dhduncan (button) folded on the Flop
Seat 3: PokerStarMan123 (small blind) folded on the Flop
Seat 4: Klemtonius (big blind) folded on the Flop
Seat 8: HighCardJasper collected (850)
Seat 9: manon327 folded on the Turn



PokerStars Home Game Hand #225605190267: {DaPokaStars}  Hold'em No Limit (50/100) - 2021/04/07 16:05:55 ET
Table 'agian and again' 9-max (Play Money) Seat #3 is the button
Seat 1: color_singleton (18180 in chips) 
Seat 2: dhduncan (5717 in chips) 
Seat 3: PokerStarMan123 (8500 in chips) 
Seat 4: Klemtonius (10933 in chips) 
Seat 8: HighCardJasper (9109 in chips) 
Seat 9: manon327 (11618 in chips) 
Klemtonius: posts small blind 50
HighCardJasper: posts big blind 100
*** HOLE CARDS ***
Dealt to PokerStarMan123 [Qs 2d]
manon327: folds 
color_singleton: raises 300 to 400
dhduncan: calls 400
PokerStarMan123: folds 
Klemtonius: folds 
HighCardJasper: folds 
*** FLOP *** [8d Th Ac]
color_singleton: bets 449
dhduncan: calls 449
*** TURN *** [8d Th Ac] [7s]
color_singleton: checks 
dhduncan: bets 500
color_singleton: calls 500
*** RIVER *** [8d Th Ac 7s] [3h]
color_singleton: checks 
dhduncan: checks 
*** SHOW DOWN ***
color_singleton: shows [Jh Jc] (a pair of Jacks)
dhduncan: shows [7h Ah] (two pair, Aces and Sevens)
dhduncan collected 2691 from pot
*** SUMMARY ***
Total pot 2848 | Rake 157 
Board [8d Th Ac 7s 3h]
Seat 1: color_singleton showed [Jh Jc] and lost with a pair of Jacks
Seat 2: dhduncan showed [7h Ah] and won (2691) with two pair, Aces and Sevens
Seat 3: PokerStarMan123 (button) folded before Flop (didn't bet)
Seat 4: Klemtonius (small blind) folded before Flop
Seat 8: HighCardJasper (big blind) folded before Flop
Seat 9: manon327 folded before Flop (didn't bet)



PokerStars Home Game Hand #225605239511: {DaPokaStars}  Hold'em No Limit (50/100) - 2021/04/07 16:07:06 ET
Table 'agian and again' 9-max (Play Money) Seat #4 is the button
Seat 1: color_singleton (16831 in chips) 
Seat 2: dhduncan (7059 in chips) 
Seat 3: PokerStarMan123 (8500 in chips) 
Seat 4: Klemtonius (10883 in chips) 
Seat 8: HighCardJasper (9009 in chips) 
Seat 9: manon327 (11618 in chips) 
HighCardJasper: posts small blind 50
manon327: posts big blind 100
*** HOLE CARDS ***
Dealt to PokerStarMan123 [3d Ad]
color_singleton: folds 
dhduncan: folds 
PokerStarMan123: raises 200 to 300
Klemtonius: folds 
HighCardJasper: folds 
manon327: calls 200
*** FLOP *** [6s 8c 2s]
manon327: checks 
PokerStarMan123: checks 
*** TURN *** [6s 8c 2s] [Th]
manon327: checks 
PokerStarMan123: checks 
*** RIVER *** [6s 8c 2s Th] [Ac]
manon327: bets 100
PokerStarMan123: raises 400 to 500
manon327: raises 400 to 900
PokerStarMan123: calls 400
*** SHOW DOWN ***
manon327: shows [Jd As] (a pair of Aces)
PokerStarMan123: mucks hand 
manon327 collected 2315 from pot
*** SUMMARY ***
Total pot 2450 | Rake 135 
Board [6s 8c 2s Th Ac]
Seat 1: color_singleton folded before Flop (didn't bet)
Seat 2: dhduncan folded before Flop (didn't bet)
Seat 3: PokerStarMan123 mucked [3d Ad]
Seat 4: Klemtonius (button) folded before Flop (didn't bet)
Seat 8: HighCardJasper (small blind) folded before Flop
Seat 9: manon327 (big blind) showed [Jd As] and won (2315) with a pair of Aces



PokerStars Home Game Hand #225605279435: {DaPokaStars}  Hold'em No Limit (50/100) - 2021/04/07 16:08:04 ET
Table 'agian and again' 9-max (Play Money) Seat #8 is the button
Seat 1: color_singleton (16831 in chips) 
Seat 2: dhduncan (7059 in chips) 
Seat 3: PokerStarMan123 (7300 in chips) 
Seat 4: Klemtonius (10883 in chips) 
Seat 8: HighCardJasper (8959 in chips) 
Seat 9: manon327 (12733 in chips) 
manon327: posts small blind 50
color_singleton: posts big blind 100
*** HOLE CARDS ***
Dealt to PokerStarMan123 [9h Qs]
dhduncan: folds 
PokerStarMan123: calls 100
Klemtonius: raises 350 to 450
HighCardJasper: folds 
manon327: calls 400
color_singleton: folds 
PokerStarMan123: calls 350
*** FLOP *** [Qd Kc Ac]
manon327: bets 685
PokerStarMan123: folds 
Klemtonius: calls 685
*** TURN *** [Qd Kc Ac] [Th]
manon327: bets 1332
Klemtonius: raises 1332 to 2664
manon327: raises 1332 to 3996
Klemtonius: raises 5752 to 9748 and is all-in
manon327: calls 5752
*** RIVER *** [Qd Kc Ac Th] [7h]
*** SHOW DOWN ***
manon327: shows [Kh Jh] (a straight, Ten to Ace)
Klemtonius: shows [Jc Ts] (a straight, Ten to Ace)
manon327 collected 10545 from pot
Klemtonius collected 10544 from pot
*** SUMMARY ***
Total pot 22316 | Rake 1227 
Board [Qd Kc Ac Th 7h]
Seat 1: color_singleton (big blind) folded before Flop
Seat 2: dhduncan folded before Flop (didn't bet)
Seat 3: PokerStarMan123 folded on the Flop
Seat 4: Klemtonius showed [Jc Ts] and won (10544) with a straight, Ten to Ace
Seat 8: HighCardJasper (button) folded before Flop (didn't bet)
Seat 9: manon327 (small blind) showed [Kh Jh] and won (10545) with a straight, Ten to Ace



PokerStars Home Game Hand #225605315468: {DaPokaStars}  Hold'em No Limit (50/100) - 2021/04/07 16:08:57 ET
Table 'agian and again' 9-max (Play Money) Seat #9 is the button
Seat 1: color_singleton (16731 in chips) 
Seat 2: dhduncan (7059 in chips) 
Seat 3: PokerStarMan123 (6850 in chips) 
Seat 4: Klemtonius (10544 in chips) 
Seat 8: HighCardJasper (8959 in chips) 
Seat 9: manon327 (12395 in chips) 
color_singleton: posts small blind 50
dhduncan: posts big blind 100
*** HOLE CARDS ***
Dealt to PokerStarMan123 [9s Ts]
PokerStarMan123: raises 200 to 300
Klemtonius: folds 
HighCardJasper: calls 300
manon327: folds 
color_singleton: calls 250
dhduncan: calls 200
*** FLOP *** [Qd Th 6h]
color_singleton: checks 
dhduncan: checks 
PokerStarMan123: bets 600
HighCardJasper: folds 
color_singleton: calls 600
dhduncan: folds 
*** TURN *** [Qd Th 6h] [Jd]
color_singleton: bets 1134
PokerStarMan123: folds 
Uncalled bet (1134) returned to color_singleton
color_singleton collected 2268 from pot
color_singleton: doesn't show hand 
*** SUMMARY ***
Total pot 2400 | Rake 132 
Board [Qd Th 6h Jd]
Seat 1: color_singleton (small blind) collected (2268)
Seat 2: dhduncan (big blind) folded on the Flop
Seat 3: PokerStarMan123 folded on the Turn
Seat 4: Klemtonius folded before Flop (didn't bet)
Seat 8: HighCardJasper folded on the Flop
Seat 9: manon327 (button) folded before Flop (didn't bet)



PokerStars Home Game Hand #225605354478: {DaPokaStars}  Hold'em No Limit (50/100) - 2021/04/07 16:09:54 ET
Table 'agian and again' 9-max (Play Money) Seat #1 is the button
Seat 1: color_singleton (18099 in chips) 
Seat 2: dhduncan (6759 in chips) 
Seat 3: PokerStarMan123 (5950 in chips) 
Seat 4: Klemtonius (10544 in chips) 
Seat 8: HighCardJasper (8659 in chips) 
Seat 9: manon327 (12395 in chips) 
dhduncan: posts small blind 50
PokerStarMan123: posts big blind 100
*** HOLE CARDS ***
Dealt to PokerStarMan123 [8s 7s]
Klemtonius: raises 100 to 200
HighCardJasper: calls 200
manon327: folds 
color_singleton: folds 
dhduncan: folds 
PokerStarMan123: calls 100
*** FLOP *** [8c 5d Qc]
PokerStarMan123: checks 
Klemtonius: checks 
HighCardJasper: checks 
*** TURN *** [8c 5d Qc] [3s]
PokerStarMan123: bets 300
Klemtonius: folds 
HighCardJasper: calls 300
*** RIVER *** [8c 5d Qc 3s] [6s]
PokerStarMan123: checks 
HighCardJasper: checks 
*** SHOW DOWN ***
PokerStarMan123: shows [8s 7s] (a pair of Eights)
HighCardJasper: shows [Jh 8d] (a pair of Eights - Queen+Jack kicker)
HighCardJasper collected 1181 from pot
*** SUMMARY ***
Total pot 1250 | Rake 69 
Board [8c 5d Qc 3s 6s]
Seat 1: color_singleton (button) folded before Flop (didn't bet)
Seat 2: dhduncan (small blind) folded before Flop
Seat 3: PokerStarMan123 (big blind) showed [8s 7s] and lost with a pair of Eights
Seat 4: Klemtonius folded on the Turn
Seat 8: HighCardJasper showed [Jh 8d] and won (1181) with a pair of Eights
Seat 9: manon327 folded before Flop (didn't bet)



PokerStars Home Game Hand #225605381618: {DaPokaStars}  Hold'em No Limit (50/100) - 2021/04/07 16:10:34 ET
Table 'agian and again' 9-max (Play Money) Seat #2 is the button
Seat 1: color_singleton (18099 in chips) 
Seat 2: dhduncan (6709 in chips) 
Seat 3: PokerStarMan123 (5450 in chips) 
Seat 4: Klemtonius (10344 in chips) 
Seat 8: HighCardJasper (9340 in chips) 
Seat 9: manon327 (12395 in chips) 
PokerStarMan123: posts small blind 50
Klemtonius: posts big blind 100
*** HOLE CARDS ***
Dealt to PokerStarMan123 [Js Jd]
HighCardJasper: calls 100
manon327: raises 100 to 200
color_singleton: folds 
dhduncan: folds 
PokerStarMan123: raises 300 to 500
Klemtonius: calls 400
HighCardJasper: calls 400
manon327: calls 300
*** FLOP *** [5h Kc 6d]
PokerStarMan123: bets 1000
Klemtonius: folds 
HighCardJasper: folds 
manon327: calls 1000
*** TURN *** [5h Kc 6d] [6c]
PokerStarMan123: checks 
manon327: checks 
*** RIVER *** [5h Kc 6d 6c] [2h]
PokerStarMan123: bets 1300
manon327: calls 1300
*** SHOW DOWN ***
PokerStarMan123: shows [Js Jd] (two pair, Jacks and Sixes)
manon327: shows [Qh Qd] (two pair, Queens and Sixes)
manon327 collected 6237 from pot
*** SUMMARY ***
Total pot 6600 | Rake 363 
Board [5h Kc 6d 6c 2h]
Seat 1: color_singleton folded before Flop (didn't bet)
Seat 2: dhduncan (button) folded before Flop (didn't bet)
Seat 3: PokerStarMan123 (small blind) showed [Js Jd] and lost with two pair, Jacks and Sixes
Seat 4: Klemtonius (big blind) folded on the Flop
Seat 8: HighCardJasper folded on the Flop
Seat 9: manon327 showed [Qh Qd] and won (6237) with two pair, Queens and Sixes



PokerStars Home Game Hand #225605426521: {DaPokaStars}  Hold'em No Limit (50/100) - 2021/04/07 16:11:40 ET
Table 'agian and again' 9-max (Play Money) Seat #3 is the button
Seat 1: color_singleton (18099 in chips) 
Seat 2: dhduncan (6709 in chips) 
Seat 3: PokerStarMan123 (2650 in chips) 
Seat 4: Klemtonius (9844 in chips) 
Seat 8: HighCardJasper (8840 in chips) 
Seat 9: manon327 (15832 in chips) 
Klemtonius: posts small blind 50
HighCardJasper: posts big blind 100
*** HOLE CARDS ***
Dealt to PokerStarMan123 [Ts Qd]
manon327: calls 100
color_singleton: folds 
dhduncan: folds 
PokerStarMan123: raises 300 to 400
Klemtonius: folds 
HighCardJasper: folds 
manon327: calls 300
*** FLOP *** [3s 3c Ad]
manon327: checks 
PokerStarMan123: checks 
*** TURN *** [3s 3c Ad] [8h]
manon327: checks 
PokerStarMan123: checks 
*** RIVER *** [3s 3c Ad 8h] [4h]
manon327: bets 898
PokerStarMan123: folds 
Uncalled bet (898) returned to manon327
manon327 collected 898 from pot
*** SUMMARY ***
Total pot 950 | Rake 52 
Board [3s 3c Ad 8h 4h]
Seat 1: color_singleton folded before Flop (didn't bet)
Seat 2: dhduncan folded before Flop (didn't bet)
Seat 3: PokerStarMan123 (button) folded on the River
Seat 4: Klemtonius (small blind) folded before Flop
Seat 8: HighCardJasper (big blind) folded before Flop
Seat 9: manon327 collected (898)



PokerStars Home Game Hand #225605451164: {DaPokaStars}  Hold'em No Limit (50/100) - 2021/04/07 16:12:16 ET
Table 'agian and again' 9-max (Play Money) Seat #4 is the button
Seat 1: color_singleton (18099 in chips) 
Seat 2: dhduncan (6709 in chips) 
Seat 3: PokerStarMan123 (2250 in chips) 
Seat 4: Klemtonius (9794 in chips) 
Seat 8: HighCardJasper (8740 in chips) 
Seat 9: manon327 (16330 in chips) 
HighCardJasper: posts small blind 50
manon327: posts big blind 100
*** HOLE CARDS ***
Dealt to PokerStarMan123 [6d 7c]
color_singleton: folds 
dhduncan: calls 100
PokerStarMan123: calls 100
Klemtonius: calls 100
HighCardJasper: calls 50
manon327: checks 
*** FLOP *** [2d 3h As]
HighCardJasper: checks 
manon327: checks 
dhduncan: checks 
PokerStarMan123: checks 
Klemtonius: checks 
*** TURN *** [2d 3h As] [6s]
HighCardJasper: checks 
manon327: checks 
dhduncan: checks 
PokerStarMan123: bets 236
Klemtonius: calls 236
HighCardJasper: folds 
manon327: folds 
dhduncan: folds 
*** RIVER *** [2d 3h As 6s] [Jh]
PokerStarMan123: checks 
Klemtonius: bets 459
PokerStarMan123: calls 459
*** SHOW DOWN ***
Klemtonius: shows [3s 4h] (a pair of Threes)
PokerStarMan123: shows [6d 7c] (a pair of Sixes)
PokerStarMan123 collected 1786 from pot
*** SUMMARY ***
Total pot 1890 | Rake 104 
Board [2d 3h As 6s Jh]
Seat 1: color_singleton folded before Flop (didn't bet)
Seat 2: dhduncan folded on the Turn
Seat 3: PokerStarMan123 showed [6d 7c] and won (1786) with a pair of Sixes
Seat 4: Klemtonius (button) showed [3s 4h] and lost with a pair of Threes
Seat 8: HighCardJasper (small blind) folded on the Turn
Seat 9: manon327 (big blind) folded on the Turn



PokerStars Home Game Hand #225605496008: {DaPokaStars}  Hold'em No Limit (50/100) - 2021/04/07 16:13:22 ET
Table 'agian and again' 9-max (Play Money) Seat #8 is the button
Seat 1: color_singleton (18099 in chips) 
Seat 2: dhduncan (6609 in chips) 
Seat 3: PokerStarMan123 (3241 in chips) 
Seat 4: Klemtonius (8999 in chips) 
Seat 8: HighCardJasper (8640 in chips) 
color_singleton: posts small blind 50
dhduncan: posts big blind 100
*** HOLE CARDS ***
Dealt to PokerStarMan123 [8c 6h]
PokerStarMan123: folds 
Klemtonius: calls 100
HighCardJasper: calls 100
color_singleton: calls 50
dhduncan: checks 
*** FLOP *** [5c Ah 6c]
color_singleton: checks 
dhduncan: checks 
Klemtonius: checks 
HighCardJasper: checks 
*** TURN *** [5c Ah 6c] [As]
color_singleton: checks 
dhduncan: checks 
Klemtonius: checks 
HighCardJasper: checks 
*** RIVER *** [5c Ah 6c As] [4s]
color_singleton: checks 
dhduncan: bets 200
Klemtonius: folds 
HighCardJasper: folds 
color_singleton: folds 
Uncalled bet (200) returned to dhduncan
dhduncan collected 378 from pot
dhduncan: doesn't show hand 
*** SUMMARY ***
Total pot 400 | Rake 22 
Board [5c Ah 6c As 4s]
Seat 1: color_singleton (small blind) folded on the River
Seat 2: dhduncan (big blind) collected (378)
Seat 3: PokerStarMan123 folded before Flop (didn't bet)
Seat 4: Klemtonius folded on the River
Seat 8: HighCardJasper (button) folded on the River



PokerStars Home Game Hand #225605527391: {DaPokaStars}  Hold'em No Limit (50/100) - 2021/04/07 16:14:09 ET
Table 'agian and again' 9-max (Play Money) Seat #1 is the button
Seat 1: color_singleton (17999 in chips) 
Seat 2: dhduncan (6887 in chips) 
Seat 3: PokerStarMan123 (3241 in chips) 
Seat 4: Klemtonius (8899 in chips) 
Seat 8: HighCardJasper (8540 in chips) 
dhduncan: posts small blind 50
PokerStarMan123: posts big blind 100
*** HOLE CARDS ***
Dealt to PokerStarMan123 [8s 2c]
Klemtonius: calls 100
HighCardJasper: raises 200 to 300
color_singleton: folds 
dhduncan: folds 
PokerStarMan123: folds 
Klemtonius: calls 200
*** FLOP *** [5h Th 5c]
Klemtonius: checks 
HighCardJasper: bets 200
Klemtonius: folds 
Uncalled bet (200) returned to HighCardJasper
HighCardJasper collected 709 from pot
HighCardJasper: doesn't show hand 
*** SUMMARY ***
Total pot 750 | Rake 41 
Board [5h Th 5c]
Seat 1: color_singleton (button) folded before Flop (didn't bet)
Seat 2: dhduncan (small blind) folded before Flop
Seat 3: PokerStarMan123 (big blind) folded before Flop
Seat 4: Klemtonius folded on the Flop
Seat 8: HighCardJasper collected (709)



PokerStars Home Game Hand #225605552185: {DaPokaStars}  Hold'em No Limit (50/100) - 2021/04/07 16:14:46 ET
Table 'agian and again' 9-max (Play Money) Seat #2 is the button
Seat 1: color_singleton (17999 in chips) 
Seat 2: dhduncan (6837 in chips) 
Seat 3: PokerStarMan123 (3141 in chips) 
Seat 4: Klemtonius (8599 in chips) 
Seat 8: HighCardJasper (8949 in chips) 
PokerStarMan123: posts small blind 50
Klemtonius: posts big blind 100
*** HOLE CARDS ***
Dealt to PokerStarMan123 [9d 6h]
HighCardJasper: folds 
color_singleton: folds 
dhduncan: calls 100
PokerStarMan123: calls 50
Klemtonius: checks 
*** FLOP *** [Qs Td 7h]
PokerStarMan123: checks 
Klemtonius: bets 283
dhduncan: folds 
PokerStarMan123: folds 
Uncalled bet (283) returned to Klemtonius
Klemtonius collected 283 from pot
Klemtonius: doesn't show hand 
*** SUMMARY ***
Total pot 300 | Rake 17 
Board [Qs Td 7h]
Seat 1: color_singleton folded before Flop (didn't bet)
Seat 2: dhduncan (button) folded on the Flop
Seat 3: PokerStarMan123 (small blind) folded on the Flop
Seat 4: Klemtonius (big blind) collected (283)
Seat 8: HighCardJasper folded before Flop (didn't bet)



PokerStars Home Game Hand #225605574069: {DaPokaStars}  Hold'em No Limit (50/100) - 2021/04/07 16:15:18 ET
Table 'agian and again' 9-max (Play Money) Seat #3 is the button
Seat 1: color_singleton (17999 in chips) 
Seat 2: dhduncan (6737 in chips) 
Seat 3: PokerStarMan123 (3041 in chips) 
Seat 4: Klemtonius (8782 in chips) 
Seat 8: HighCardJasper (8949 in chips) 
Seat 9: manon327 (16230 in chips) 
Klemtonius: posts small blind 50
HighCardJasper: posts big blind 100
manon327: posts small blind 50
*** HOLE CARDS ***
Dealt to PokerStarMan123 [5c 2h]
manon327: calls 100
color_singleton: folds 
dhduncan: calls 100
PokerStarMan123: folds 
Klemtonius: raises 450 to 550
HighCardJasper: folds 
manon327: folds 
dhduncan: folds 
Uncalled bet (450) returned to Klemtonius
Klemtonius collected 450 from pot
Klemtonius: doesn't show hand 
*** SUMMARY ***
Total pot 450 | Rake 0 
Seat 1: color_singleton folded before Flop (didn't bet)
Seat 2: dhduncan folded before Flop
Seat 3: PokerStarMan123 (button) folded before Flop (didn't bet)
Seat 4: Klemtonius (small blind) collected (450)
Seat 8: HighCardJasper (big blind) folded before Flop
Seat 9: manon327 folded before Flop



PokerStars Home Game Hand #225605598570: {DaPokaStars}  Hold'em No Limit (50/100) - 2021/04/07 16:15:53 ET
Table 'agian and again' 9-max (Play Money) Seat #4 is the button
Seat 1: color_singleton (17999 in chips) 
Seat 2: dhduncan (6637 in chips) 
Seat 3: PokerStarMan123 (3041 in chips) 
Seat 4: Klemtonius (9132 in chips) 
Seat 8: HighCardJasper (8849 in chips) 
Seat 9: manon327 (16080 in chips) 
HighCardJasper: posts small blind 50
manon327: posts big blind 100
*** HOLE CARDS ***
Dealt to PokerStarMan123 [3s 9c]
color_singleton: folds 
dhduncan: folds 
PokerStarMan123: folds 
Klemtonius: folds 
HighCardJasper: calls 50
manon327: checks 
*** FLOP *** [3d Jd Ts]
HighCardJasper: bets 100
manon327: calls 100
*** TURN *** [3d Jd Ts] [2s]
HighCardJasper: bets 100
manon327: calls 100
*** RIVER *** [3d Jd Ts 2s] [Kc]
HighCardJasper: bets 100
manon327: folds 
Uncalled bet (100) returned to HighCardJasper
HighCardJasper collected 567 from pot
HighCardJasper: doesn't show hand 
*** SUMMARY ***
Total pot 600 | Rake 33 
Board [3d Jd Ts 2s Kc]
Seat 1: color_singleton folded before Flop (didn't bet)
Seat 2: dhduncan folded before Flop (didn't bet)
Seat 3: PokerStarMan123 folded before Flop (didn't bet)
Seat 4: Klemtonius (button) folded before Flop (didn't bet)
Seat 8: HighCardJasper (small blind) collected (567)
Seat 9: manon327 (big blind) folded on the River



PokerStars Home Game Hand #225605626835: {DaPokaStars}  Hold'em No Limit (50/100) - 2021/04/07 16:16:34 ET
Table 'agian and again' 9-max (Play Money) Seat #8 is the button
Seat 1: color_singleton (17999 in chips) 
Seat 2: dhduncan (6637 in chips) 
Seat 3: PokerStarMan123 (3041 in chips) 
Seat 4: Klemtonius (9132 in chips) 
Seat 8: HighCardJasper (9116 in chips) 
Seat 9: manon327 (15780 in chips) 
manon327: posts small blind 50
color_singleton: posts big blind 100
*** HOLE CARDS ***
Dealt to PokerStarMan123 [3c 7h]
dhduncan: folds 
PokerStarMan123: folds 
Klemtonius: raises 250 to 350
HighCardJasper: calls 350
manon327: folds 
color_singleton: folds 
*** FLOP *** [5d 9s 8d]
Klemtonius: bets 401
HighCardJasper: calls 401
*** TURN *** [5d 9s 8d] [Ad]
Klemtonius: bets 780
HighCardJasper: folds 
Uncalled bet (780) returned to Klemtonius
Klemtonius collected 1561 from pot
Klemtonius: doesn't show hand 
*** SUMMARY ***
Total pot 1652 | Rake 91 
Board [5d 9s 8d Ad]
Seat 1: color_singleton (big blind) folded before Flop
Seat 2: dhduncan folded before Flop (didn't bet)
Seat 3: PokerStarMan123 folded before Flop (didn't bet)
Seat 4: Klemtonius collected (1561)
Seat 8: HighCardJasper (button) folded on the Turn
Seat 9: manon327 (small blind) folded before Flop



PokerStars Home Game Hand #225605667655: {DaPokaStars}  Hold'em No Limit (50/100) - 2021/04/07 16:17:32 ET
Table 'agian and again' 9-max (Play Money) Seat #9 is the button
Seat 1: color_singleton (17899 in chips) 
Seat 2: dhduncan (6637 in chips) 
Seat 3: PokerStarMan123 (3041 in chips) 
Seat 4: Klemtonius (9942 in chips) 
Seat 8: HighCardJasper (8365 in chips) 
Seat 9: manon327 (15730 in chips) 
color_singleton: posts small blind 50
dhduncan: posts big blind 100
*** HOLE CARDS ***
Dealt to PokerStarMan123 [2h Jc]
PokerStarMan123: folds 
Klemtonius: calls 100
HighCardJasper: raises 100 to 200
manon327: calls 200
color_singleton: calls 150
dhduncan: calls 100
Klemtonius: calls 100
*** FLOP *** [3s 8s 2s]
color_singleton: checks 
dhduncan: checks 
Klemtonius: bets 945
HighCardJasper: folds 
manon327: folds 
color_singleton: folds 
dhduncan: folds 
Uncalled bet (945) returned to Klemtonius
Klemtonius collected 945 from pot
Klemtonius: doesn't show hand 
*** SUMMARY ***
Total pot 1000 | Rake 55 
Board [3s 8s 2s]
Seat 1: color_singleton (small blind) folded on the Flop
Seat 2: dhduncan (big blind) folded on the Flop
Seat 3: PokerStarMan123 folded before Flop (didn't bet)
Seat 4: Klemtonius collected (945)
Seat 8: HighCardJasper folded on the Flop
Seat 9: manon327 (button) folded on the Flop



PokerStars Home Game Hand #225605701358: {DaPokaStars}  Hold'em No Limit (50/100) - 2021/04/07 16:18:21 ET
Table 'agian and again' 9-max (Play Money) Seat #1 is the button
Seat 1: color_singleton (17699 in chips) 
Seat 2: dhduncan (6437 in chips) 
Seat 3: PokerStarMan123 (3041 in chips) 
Seat 4: Klemtonius (10687 in chips) 
Seat 8: HighCardJasper (8165 in chips) 
Seat 9: manon327 (15530 in chips) 
dhduncan: posts small blind 50
PokerStarMan123: posts big blind 100
*** HOLE CARDS ***
Dealt to PokerStarMan123 [3d Kd]
Klemtonius: calls 100
HighCardJasper: calls 100
manon327: raises 100 to 200
color_singleton: folds 
dhduncan: folds 
PokerStarMan123: calls 100
Klemtonius: calls 100
HighCardJasper: calls 100
*** FLOP *** [5s Tc Th]
PokerStarMan123: checks 
Klemtonius: checks 
HighCardJasper: checks 
manon327: bets 401
PokerStarMan123: folds 
Klemtonius: folds 
HighCardJasper: folds 
Uncalled bet (401) returned to manon327
manon327 collected 803 from pot
*** SUMMARY ***
Total pot 850 | Rake 47 
Board [5s Tc Th]
Seat 1: color_singleton (button) folded before Flop (didn't bet)
Seat 2: dhduncan (small blind) folded before Flop
Seat 3: PokerStarMan123 (big blind) folded on the Flop
Seat 4: Klemtonius folded on the Flop
Seat 8: HighCardJasper folded on the Flop
Seat 9: manon327 collected (803)



PokerStars Home Game Hand #225605753212: {DaPokaStars}  Hold'em No Limit (50/100) - 2021/04/07 16:19:36 ET
Table 'agian and again' 9-max (Play Money) Seat #2 is the button
Seat 1: color_singleton (17699 in chips) 
Seat 2: dhduncan (6387 in chips) 
Seat 3: PokerStarMan123 (2841 in chips) 
Seat 4: Klemtonius (10487 in chips) 
Seat 8: HighCardJasper (7965 in chips) 
Seat 9: manon327 (16133 in chips) 
PokerStarMan123: posts small blind 50
Klemtonius: posts big blind 100
*** HOLE CARDS ***
Dealt to PokerStarMan123 [Tc 4h]
HighCardJasper: folds 
manon327: calls 100
color_singleton: folds 
dhduncan: calls 100
PokerStarMan123: calls 50
Klemtonius: checks 
*** FLOP *** [Kd 6d Ts]
PokerStarMan123: checks 
Klemtonius: checks 
manon327: checks 
dhduncan: checks 
*** TURN *** [Kd 6d Ts] [8h]
PokerStarMan123: bets 200
Klemtonius: calls 200
manon327: calls 200
dhduncan has timed out
dhduncan: folds 
*** RIVER *** [Kd 6d Ts 8h] [Td]
PokerStarMan123: bets 900
Klemtonius: folds 
manon327: folds 
Uncalled bet (900) returned to PokerStarMan123
PokerStarMan123 collected 945 from pot
*** SUMMARY ***
Total pot 1000 | Rake 55 
Board [Kd 6d Ts 8h Td]
Seat 1: color_singleton folded before Flop (didn't bet)
Seat 2: dhduncan (button) folded on the Turn
Seat 3: PokerStarMan123 (small blind) collected (945)
Seat 4: Klemtonius (big blind) folded on the River
Seat 8: HighCardJasper folded before Flop (didn't bet)
Seat 9: manon327 folded on the River



PokerStars Home Game Hand #225605825356: {DaPokaStars}  Hold'em No Limit (50/100) - 2021/04/07 16:21:20 ET
Table 'agian and again' 9-max (Play Money) Seat #3 is the button
Seat 1: color_singleton (17699 in chips) 
Seat 2: dhduncan (6287 in chips) 
Seat 3: PokerStarMan123 (3486 in chips) 
Seat 8: HighCardJasper (7965 in chips) 
Seat 9: manon327 (15833 in chips) 
HighCardJasper: posts small blind 50
manon327: posts big blind 100
*** HOLE CARDS ***
Dealt to PokerStarMan123 [Ah 6c]
color_singleton: folds 
dhduncan: folds 
PokerStarMan123: raises 200 to 300
HighCardJasper: folds 
manon327: folds 
Uncalled bet (200) returned to PokerStarMan123
PokerStarMan123 collected 250 from pot
*** SUMMARY ***
Total pot 250 | Rake 0 
Seat 1: color_singleton folded before Flop (didn't bet)
Seat 2: dhduncan folded before Flop (didn't bet)
Seat 3: PokerStarMan123 (button) collected (250)
Seat 8: HighCardJasper (small blind) folded before Flop
Seat 9: manon327 (big blind) folded before Flop



PokerStars Home Game Hand #225605835216: {DaPokaStars}  Hold'em No Limit (50/100) - 2021/04/07 16:21:34 ET
Table 'agian and again' 9-max (Play Money) Seat #8 is the button
Seat 1: color_singleton (17699 in chips) 
Seat 2: dhduncan (6287 in chips) 
Seat 3: PokerStarMan123 (3636 in chips) 
Seat 8: HighCardJasper (7915 in chips) 
Seat 9: manon327 (15733 in chips) 
manon327: posts small blind 50
color_singleton: posts big blind 100
*** HOLE CARDS ***
Dealt to PokerStarMan123 [9s 9d]
dhduncan: calls 100
PokerStarMan123: raises 300 to 400
HighCardJasper: folds 
manon327: folds 
color_singleton: calls 300
Mafak2020 joins the table at seat #7 
dhduncan: folds 
*** FLOP *** [7s 8s 2h]
color_singleton: bets 898
PokerStarMan123: raises 2338 to 3236 and is all-in
color_singleton: calls 2338
*** TURN *** [7s 8s 2h] [Qc]
*** RIVER *** [7s 8s 2h Qc] [2d]
*** SHOW DOWN ***
color_singleton: shows [Jh Jc] (two pair, Jacks and Deuces)
PokerStarMan123: shows [9s 9d] (two pair, Nines and Deuces)
color_singleton collected 7014 from pot
*** SUMMARY ***
Total pot 7422 | Rake 408 
Board [7s 8s 2h Qc 2d]
Seat 1: color_singleton (big blind) showed [Jh Jc] and won (7014) with two pair, Jacks and Deuces
Seat 2: dhduncan folded before Flop
Seat 3: PokerStarMan123 showed [9s 9d] and lost with two pair, Nines and Deuces
Seat 8: HighCardJasper (button) folded before Flop (didn't bet)
Seat 9: manon327 (small blind) folded before Flop



PokerStars Home Game Hand #225605904853: {DaPokaStars}  Hold'em No Limit (50/100) - 2021/04/07 16:23:15 ET
Table 'agian and again' 9-max (Play Money) Seat #1 is the button
Seat 1: color_singleton (18249 in chips) 
Seat 2: dhduncan (5615 in chips) 
Seat 3: PokerStarMan123 (10000 in chips) 
Seat 7: Mafak2020 (13692 in chips) 
Seat 8: HighCardJasper (7343 in chips) 
Seat 9: manon327 (15583 in chips) 
dhduncan: posts small blind 50
PokerStarMan123: posts big blind 100
*** HOLE CARDS ***
Dealt to PokerStarMan123 [6h 5s]
Mafak2020: folds 
HighCardJasper: calls 100
manon327: folds 
color_singleton: raises 200 to 300
dhduncan: folds 
PokerStarMan123: calls 200
HighCardJasper: calls 200
*** FLOP *** [Qs 6d 7c]
PokerStarMan123: checks 
HighCardJasper: checks 
color_singleton: checks 
*** TURN *** [Qs 6d 7c] [4c]
PokerStarMan123: checks 
HighCardJasper: checks 
color_singleton: checks 
*** RIVER *** [Qs 6d 7c 4c] [Ts]
PokerStarMan123: bets 400
HighCardJasper: folds 
color_singleton: folds 
Uncalled bet (400) returned to PokerStarMan123
PokerStarMan123 collected 898 from pot
*** SUMMARY ***
Total pot 950 | Rake 52 
Board [Qs 6d 7c 4c Ts]
Seat 1: color_singleton (button) folded on the River
Seat 2: dhduncan (small blind) folded before Flop
Seat 3: PokerStarMan123 (big blind) collected (898)
Seat 7: Mafak2020 folded before Flop (didn't bet)
Seat 8: HighCardJasper folded on the River
Seat 9: manon327 folded before Flop (didn't bet)



PokerStars Home Game Hand #225605945074: {DaPokaStars}  Hold'em No Limit (50/100) - 2021/04/07 16:24:03 ET
Table 'agian and again' 9-max (Play Money) Seat #2 is the button
Seat 1: color_singleton (17949 in chips) 
Seat 2: dhduncan (5565 in chips) 
Seat 3: PokerStarMan123 (10598 in chips) 
Seat 7: Mafak2020 (13692 in chips) 
Seat 8: HighCardJasper (7043 in chips) 
Seat 9: manon327 (15583 in chips) 
PokerStarMan123: posts small blind 50
Mafak2020: posts big blind 100
*** HOLE CARDS ***
Dealt to PokerStarMan123 [6h 4c]
HighCardJasper: calls 100
manon327: calls 100
color_singleton: calls 100
dhduncan: folds 
PokerStarMan123: calls 50
Mafak2020: checks 
*** FLOP *** [5d 4s 5c]
PokerStarMan123: bets 200
Mafak2020: folds 
HighCardJasper: folds 
manon327: calls 200
color_singleton: folds 
*** TURN *** [5d 4s 5c] [7c]
PokerStarMan123: bets 400
manon327: calls 400
*** RIVER *** [5d 4s 5c 7c] [Ac]
PokerStarMan123: checks 
manon327: bets 1606
PokerStarMan123: folds 
Uncalled bet (1606) returned to manon327
manon327 collected 1606 from pot
*** SUMMARY ***
Total pot 1700 | Rake 94 
Board [5d 4s 5c 7c Ac]
Seat 1: color_singleton folded on the Flop
Seat 2: dhduncan (button) folded before Flop (didn't bet)
Seat 3: PokerStarMan123 (small blind) folded on the River
Seat 7: Mafak2020 (big blind) folded on the Flop
Seat 8: HighCardJasper folded on the Flop
Seat 9: manon327 collected (1606)



PokerStars Home Game Hand #225605976279: {DaPokaStars}  Hold'em No Limit (50/100) - 2021/04/07 16:24:48 ET
Table 'agian and again' 9-max (Play Money) Seat #3 is the button
Seat 1: color_singleton (17849 in chips) 
Seat 2: dhduncan (5565 in chips) 
Seat 3: PokerStarMan123 (9898 in chips) 
Seat 7: Mafak2020 (13592 in chips) 
Seat 8: HighCardJasper (6943 in chips) 
Seat 9: manon327 (16489 in chips) 
Mafak2020: posts small blind 50
HighCardJasper: posts big blind 100
*** HOLE CARDS ***
Dealt to PokerStarMan123 [7h 6s]
manon327: calls 100
color_singleton: folds 
dhduncan: folds 
PokerStarMan123: calls 100
Mafak2020: calls 50
HighCardJasper: checks 
*** FLOP *** [6c Qc 3h]
Mafak2020: checks 
HighCardJasper: checks 
manon327: bets 189
PokerStarMan123: folds 
Mafak2020: folds 
HighCardJasper: folds 
Uncalled bet (189) returned to manon327
manon327 collected 378 from pot
*** SUMMARY ***
Total pot 400 | Rake 22 
Board [6c Qc 3h]
Seat 1: color_singleton folded before Flop (didn't bet)
Seat 2: dhduncan folded before Flop (didn't bet)
Seat 3: PokerStarMan123 (button) folded on the Flop
Seat 7: Mafak2020 (small blind) folded on the Flop
Seat 8: HighCardJasper (big blind) folded on the Flop
Seat 9: manon327 collected (378)



PokerStars Home Game Hand #225606012975: {DaPokaStars}  Hold'em No Limit (50/100) - 2021/04/07 16:25:42 ET
Table 'agian and again' 9-max (Play Money) Seat #7 is the button
Seat 1: color_singleton (17849 in chips) 
Seat 2: dhduncan (5565 in chips) 
Seat 3: PokerStarMan123 (9798 in chips) 
Seat 4: Klemtonius (10187 in chips) 
Seat 7: Mafak2020 (13492 in chips) 
Seat 8: HighCardJasper (6843 in chips) 
Seat 9: manon327 (16767 in chips) 
HighCardJasper: posts small blind 50
manon327: posts big blind 100
Klemtonius: posts small & big blinds 150
*** HOLE CARDS ***
Dealt to PokerStarMan123 [Qc Qs]
color_singleton: calls 100
dhduncan: folds 
PokerStarMan123: raises 400 to 500
Klemtonius: calls 400
Mafak2020: raises 400 to 900
HighCardJasper: folds 
manon327: folds 
color_singleton: folds 
PokerStarMan123: calls 400
Klemtonius: calls 400
*** FLOP *** [6s Ts 7s]
PokerStarMan123: bets 1500
Klemtonius: folds 
Mafak2020: raises 1500 to 3000
PokerStarMan123: raises 5898 to 8898 and is all-in
Mafak2020: calls 5898
*** TURN *** [6s Ts 7s] [Tc]
*** RIVER *** [6s Ts 7s Tc] [7h]
*** SHOW DOWN ***
PokerStarMan123: shows [Qc Qs] (two pair, Queens and Tens)
Mafak2020: shows [Js As] (a flush, Ace high)
Mafak2020 collected 19652 from pot
*** SUMMARY ***
Total pot 20796 | Rake 1144 
Board [6s Ts 7s Tc 7h]
Seat 1: color_singleton folded before Flop
Seat 2: dhduncan folded before Flop (didn't bet)
Seat 3: PokerStarMan123 showed [Qc Qs] and lost with two pair, Queens and Tens
Seat 4: Klemtonius folded on the Flop
Seat 7: Mafak2020 (button) showed [Js As] and won (19652) with a flush, Ace high
Seat 8: HighCardJasper (small blind) folded before Flop
Seat 9: manon327 (big blind) folded before Flop



PokerStars Home Game Hand #225606100447: {DaPokaStars}  Hold'em No Limit (50/100) - 2021/04/07 16:27:49 ET
Table 'agian and again' 9-max (Play Money) Seat #9 is the button
Seat 1: color_singleton (17649 in chips) 
Seat 2: dhduncan (5565 in chips) 
Seat 3: PokerStarMan123 (10000 in chips) 
Seat 4: Klemtonius (9137 in chips) 
Seat 7: Mafak2020 (23718 in chips) 
Seat 8: HighCardJasper (6693 in chips) 
Seat 9: manon327 (16567 in chips) 
color_singleton: posts small blind 50
dhduncan: posts big blind 100
*** HOLE CARDS ***
Dealt to PokerStarMan123 [Jd 2s]
PokerStarMan123: folds 
Klemtonius: folds 
Mafak2020: folds 
HighCardJasper: folds 
manon327: folds 
color_singleton: calls 50
dhduncan: checks 
*** FLOP *** [4h 9d 7c]
color_singleton: bets 189
dhduncan: calls 189
*** TURN *** [4h 9d 7c] [Kd]
color_singleton: checks 
dhduncan: checks 
*** RIVER *** [4h 9d 7c Kd] [8s]
color_singleton: bets 273
dhduncan: calls 273
*** SHOW DOWN ***
color_singleton: shows [8c 6c] (a pair of Eights)
dhduncan: shows [5d 9c] (a pair of Nines)
dhduncan collected 1062 from pot
*** SUMMARY ***
Total pot 1124 | Rake 62 
Board [4h 9d 7c Kd 8s]
Seat 1: color_singleton (small blind) showed [8c 6c] and lost with a pair of Eights
Seat 2: dhduncan (big blind) showed [5d 9c] and won (1062) with a pair of Nines
Seat 3: PokerStarMan123 folded before Flop (didn't bet)
Seat 4: Klemtonius folded before Flop (didn't bet)
Seat 7: Mafak2020 folded before Flop (didn't bet)
Seat 8: HighCardJasper folded before Flop (didn't bet)
Seat 9: manon327 (button) folded before Flop (didn't bet)



PokerStars Home Game Hand #225606125835: {DaPokaStars}  Hold'em No Limit (50/100) - 2021/04/07 16:28:27 ET
Table 'agian and again' 9-max (Play Money) Seat #1 is the button
Seat 1: color_singleton (17087 in chips) 
Seat 2: dhduncan (6065 in chips) 
Seat 3: PokerStarMan123 (10000 in chips) 
Seat 4: Klemtonius (9137 in chips) 
Seat 7: Mafak2020 (23718 in chips) 
Seat 8: HighCardJasper (6693 in chips) 
Seat 9: manon327 (16567 in chips) 
dhduncan: posts small blind 50
PokerStarMan123: posts big blind 100
*** HOLE CARDS ***
Dealt to PokerStarMan123 [Tc Js]
Klemtonius: raises 250 to 350
Mafak2020: folds 
HighCardJasper: folds 
manon327: calls 350
color_singleton: folds 
dhduncan: folds 
PokerStarMan123: calls 250
*** FLOP *** [6c Ts 8h]
PokerStarMan123: bets 700
Klemtonius: folds 
manon327: folds 
Uncalled bet (700) returned to PokerStarMan123
PokerStarMan123 collected 1039 from pot
*** SUMMARY ***
Total pot 1100 | Rake 61 
Board [6c Ts 8h]
Seat 1: color_singleton (button) folded before Flop (didn't bet)
Seat 2: dhduncan (small blind) folded before Flop
Seat 3: PokerStarMan123 (big blind) collected (1039)
Seat 4: Klemtonius folded on the Flop
Seat 7: Mafak2020 folded before Flop (didn't bet)
Seat 8: HighCardJasper folded before Flop (didn't bet)
Seat 9: manon327 folded on the Flop



PokerStars Home Game Hand #225606167113: {DaPokaStars}  Hold'em No Limit (50/100) - 2021/04/07 16:29:19 ET
Table 'agian and again' 9-max (Play Money) Seat #2 is the button
Seat 1: color_singleton (17087 in chips) 
Seat 2: dhduncan (6015 in chips) 
Seat 3: PokerStarMan123 (10689 in chips) 
Seat 4: Klemtonius (8787 in chips) 
Seat 7: Mafak2020 (23718 in chips) 
Seat 8: HighCardJasper (6693 in chips) 
Seat 9: manon327 (16217 in chips) 
PokerStarMan123: posts small blind 50
Klemtonius: posts big blind 100
*** HOLE CARDS ***
Dealt to PokerStarMan123 [7c 5s]
Mafak2020: folds 
HighCardJasper: calls 100
manon327: calls 100
color_singleton: calls 100
dhduncan: calls 100
PokerStarMan123: calls 50
Klemtonius: checks 
*** FLOP *** [Jc 3d 2h]
PokerStarMan123: checks 
Klemtonius: checks 
HighCardJasper: checks 
manon327: checks 
color_singleton: checks 
dhduncan: checks 
*** TURN *** [Jc 3d 2h] [4h]
PokerStarMan123: checks 
Klemtonius: checks 
HighCardJasper: checks 
manon327: checks 
color_singleton: checks 
dhduncan: checks 
*** RIVER *** [Jc 3d 2h 4h] [6d]
PokerStarMan123: bets 500
Klemtonius: folds 
HighCardJasper: folds 
manon327: folds 
color_singleton: folds 
dhduncan: folds 
Uncalled bet (500) returned to PokerStarMan123
PokerStarMan123 collected 567 from pot
*** SUMMARY ***
Total pot 600 | Rake 33 
Board [Jc 3d 2h 4h 6d]
Seat 1: color_singleton folded on the River
Seat 2: dhduncan (button) folded on the River
Seat 3: PokerStarMan123 (small blind) collected (567)
Seat 4: Klemtonius (big blind) folded on the River
Seat 7: Mafak2020 folded before Flop (didn't bet)
Seat 8: HighCardJasper folded on the River
Seat 9: manon327 folded on the River



PokerStars Home Game Hand #225606218953: {DaPokaStars}  Hold'em No Limit (50/100) - 2021/04/07 16:30:37 ET
Table 'agian and again' 9-max (Play Money) Seat #3 is the button
Seat 1: color_singleton (16987 in chips) 
Seat 2: dhduncan (5915 in chips) 
Seat 3: PokerStarMan123 (11156 in chips) 
Seat 4: Klemtonius (8687 in chips) 
Seat 7: Mafak2020 (23718 in chips) 
Seat 8: HighCardJasper (6593 in chips) 
Seat 9: manon327 (16117 in chips) 
Klemtonius: posts small blind 50
Mafak2020: posts big blind 100
*** HOLE CARDS ***
Dealt to PokerStarMan123 [Qs 4c]
HighCardJasper: folds 
manon327: raises 100 to 200
color_singleton: folds 
dhduncan: calls 200
PokerStarMan123: folds 
Klemtonius: folds 
Mafak2020 has timed out
Mafak2020: folds 
*** FLOP *** [6c 6s 7c]
manon327: bets 520
dhduncan: calls 520
*** TURN *** [6c 6s 7c] [3h]
manon327: checks 
dhduncan: checks 
*** RIVER *** [6c 6s 7c 3h] [Jc]
manon327: checks 
dhduncan: checks 
*** SHOW DOWN ***
manon327: shows [Kh Ac] (a pair of Sixes)
dhduncan: shows [Kd 7s] (two pair, Sevens and Sixes)
dhduncan collected 1503 from pot
*** SUMMARY ***
Total pot 1590 | Rake 87 
Board [6c 6s 7c 3h Jc]
Seat 1: color_singleton folded before Flop (didn't bet)
Seat 2: dhduncan showed [Kd 7s] and won (1503) with two pair, Sevens and Sixes
Seat 3: PokerStarMan123 (button) folded before Flop (didn't bet)
Seat 4: Klemtonius (small blind) folded before Flop
Seat 7: Mafak2020 (big blind) folded before Flop
Seat 8: HighCardJasper folded before Flop (didn't bet)
Seat 9: manon327 showed [Kh Ac] and lost with a pair of Sixes



PokerStars Home Game Hand #225606269833: {DaPokaStars}  Hold'em No Limit (50/100) - 2021/04/07 16:31:51 ET
Table 'agian and again' 9-max (Play Money) Seat #4 is the button
Seat 1: color_singleton (16987 in chips) 
Seat 2: dhduncan (6698 in chips) 
Seat 3: PokerStarMan123 (11156 in chips) 
Seat 4: Klemtonius (8637 in chips) 
Seat 7: Mafak2020 (23618 in chips) 
Seat 8: HighCardJasper (6593 in chips) 
Seat 9: manon327 (15397 in chips) 
Mafak2020: posts small blind 50
HighCardJasper: posts big blind 100
*** HOLE CARDS ***
Dealt to PokerStarMan123 [Tc 4c]
manon327: calls 100
color_singleton: raises 100 to 200
dhduncan: folds 
PokerStarMan123: folds 
Klemtonius: calls 200
Mafak2020: calls 150
HighCardJasper: calls 100
manon327: calls 100
*** FLOP *** [Kd 5s 3c]
Mafak2020: checks 
HighCardJasper: checks 
manon327: bets 472
color_singleton: folds 
Klemtonius: calls 472
Mafak2020: calls 472
HighCardJasper: calls 472
*** TURN *** [Kd 5s 3c] [3h]
Mafak2020: checks 
HighCardJasper: checks 
manon327: checks 
Klemtonius: bets 2729
Mafak2020: calls 2729
HighCardJasper: folds 
manon327: folds 
*** RIVER *** [Kd 5s 3c 3h] [2d]
Mafak2020: checks 
Klemtonius: bets 5236 and is all-in
Mafak2020: calls 5236
*** SHOW DOWN ***
Klemtonius: shows [Kc 6s] (two pair, Kings and Threes)
Mafak2020: shows [6h 4h] (a straight, Deuce to Six)
Mafak2020 collected 17783 from pot
*** SUMMARY ***
Total pot 18818 | Rake 1035 
Board [Kd 5s 3c 3h 2d]
Seat 1: color_singleton folded on the Flop
Seat 2: dhduncan folded before Flop (didn't bet)
Seat 3: PokerStarMan123 folded before Flop (didn't bet)
Seat 4: Klemtonius (button) showed [Kc 6s] and lost with two pair, Kings and Threes
Seat 7: Mafak2020 (small blind) showed [6h 4h] and won (17783) with a straight, Deuce to Six
Seat 8: HighCardJasper (big blind) folded on the Turn
Seat 9: manon327 folded on the Turn



PokerStars Home Game Hand #225606350711: {DaPokaStars}  Hold'em No Limit (50/100) - 2021/04/07 16:33:53 ET
Table 'agian and again' 9-max (Play Money) Seat #7 is the button
Seat 1: color_singleton (16787 in chips) 
Seat 2: dhduncan (6698 in chips) 
Seat 3: PokerStarMan123 (11156 in chips) 
Seat 7: Mafak2020 (32764 in chips) 
Seat 8: HighCardJasper (5921 in chips) 
Seat 9: manon327 (14725 in chips) 
HighCardJasper: posts small blind 50
manon327: posts big blind 100
*** HOLE CARDS ***
Dealt to PokerStarMan123 [Th Ad]
color_singleton: folds 
dhduncan: folds 
PokerStarMan123: raises 200 to 300
Mafak2020: folds 
HighCardJasper: calls 250
manon327: folds 
*** FLOP *** [9c 2c Ah]
HighCardJasper: bets 300
PokerStarMan123: raises 300 to 600
HighCardJasper: calls 300
*** TURN *** [9c 2c Ah] [6s]
HighCardJasper: checks 
PokerStarMan123: bets 900
HighCardJasper: folds 
Uncalled bet (900) returned to PokerStarMan123
PokerStarMan123 collected 1795 from pot
*** SUMMARY ***
Total pot 1900 | Rake 105 
Board [9c 2c Ah 6s]
Seat 1: color_singleton folded before Flop (didn't bet)
Seat 2: dhduncan folded before Flop (didn't bet)
Seat 3: PokerStarMan123 collected (1795)
Seat 7: Mafak2020 (button) folded before Flop (didn't bet)
Seat 8: HighCardJasper (small blind) folded on the Turn
Seat 9: manon327 (big blind) folded before Flop



PokerStars Home Game Hand #225606391966: {DaPokaStars}  Hold'em No Limit (50/100) - 2021/04/07 16:34:55 ET
Table 'agian and again' 9-max (Play Money) Seat #8 is the button
Seat 1: color_singleton (16787 in chips) 
Seat 2: dhduncan (6698 in chips) 
Seat 3: PokerStarMan123 (12051 in chips) 
Seat 4: Klemtonius (10000 in chips) 
Seat 7: Mafak2020 (32764 in chips) 
Seat 8: HighCardJasper (5021 in chips) 
Seat 9: manon327 (14625 in chips) 
manon327: posts small blind 50
color_singleton: posts big blind 100
*** HOLE CARDS ***
Dealt to PokerStarMan123 [6h Jh]
dhduncan: folds 
PokerStarMan123: folds 
Klemtonius: calls 100
Mafak2020: calls 100
HighCardJasper: calls 100
manon327: folds 
color_singleton: checks 
*** FLOP *** [Ah 9c 3h]
color_singleton: checks 
Klemtonius: checks 
Mafak2020: checks 
HighCardJasper: checks 
*** TURN *** [Ah 9c 3h] [6d]
color_singleton: checks 
Klemtonius: checks 
Mafak2020: checks 
HighCardJasper: checks 
*** RIVER *** [Ah 9c 3h 6d] [5h]
color_singleton: checks 
Klemtonius: checks 
Mafak2020: checks 
HighCardJasper: bets 200
color_singleton: folds 
Klemtonius: folds 
Mafak2020: folds 
Uncalled bet (200) returned to HighCardJasper
HighCardJasper collected 425 from pot
HighCardJasper: doesn't show hand 
*** SUMMARY ***
Total pot 450 | Rake 25 
Board [Ah 9c 3h 6d 5h]
Seat 1: color_singleton (big blind) folded on the River
Seat 2: dhduncan folded before Flop (didn't bet)
Seat 3: PokerStarMan123 folded before Flop (didn't bet)
Seat 4: Klemtonius folded on the River
Seat 7: Mafak2020 folded on the River
Seat 8: HighCardJasper (button) collected (425)
Seat 9: manon327 (small blind) folded before Flop



PokerStars Home Game Hand #225606429890: {DaPokaStars}  Hold'em No Limit (50/100) - 2021/04/07 16:35:52 ET
Table 'agian and again' 9-max (Play Money) Seat #9 is the button
Seat 1: color_singleton (16687 in chips) 
Seat 2: dhduncan (6698 in chips) 
Seat 3: PokerStarMan123 (12051 in chips) 
Seat 4: Klemtonius (9900 in chips) 
Seat 7: Mafak2020 (32664 in chips) 
Seat 8: HighCardJasper (5346 in chips) 
Seat 9: manon327 (14575 in chips) 
color_singleton: posts small blind 50
dhduncan: posts big blind 100
*** HOLE CARDS ***
Dealt to PokerStarMan123 [8d Ks]
PokerStarMan123: calls 100
Klemtonius: folds 
Mafak2020: calls 100
HighCardJasper: folds 
manon327: calls 100
color_singleton: calls 50
dhduncan: checks 
*** FLOP *** [3c 7h Ad]
color_singleton: checks 
dhduncan: checks 
PokerStarMan123: checks 
Mafak2020: checks 
manon327: checks 
*** TURN *** [3c 7h Ad] [Ah]
color_singleton: checks 
dhduncan: checks 
PokerStarMan123: checks 
Mafak2020: checks 
manon327: checks 
*** RIVER *** [3c 7h Ad Ah] [5c]
color_singleton: bets 236
dhduncan: folds 
PokerStarMan123: folds 
Mafak2020: folds 
manon327: folds 
Uncalled bet (236) returned to color_singleton
color_singleton collected 472 from pot
color_singleton: doesn't show hand 
*** SUMMARY ***
Total pot 500 | Rake 28 
Board [3c 7h Ad Ah 5c]
Seat 1: color_singleton (small blind) collected (472)
Seat 2: dhduncan (big blind) folded on the River
Seat 3: PokerStarMan123 folded on the River
Seat 4: Klemtonius folded before Flop (didn't bet)
Seat 7: Mafak2020 folded on the River
Seat 8: HighCardJasper folded before Flop (didn't bet)
Seat 9: manon327 (button) folded on the River



PokerStars Home Game Hand #225606480217: {DaPokaStars}  Hold'em No Limit (50/100) - 2021/04/07 16:37:07 ET
Table 'agian and again' 9-max (Play Money) Seat #1 is the button
Seat 1: color_singleton (17059 in chips) 
Seat 2: dhduncan (6598 in chips) 
Seat 3: PokerStarMan123 (11951 in chips) 
Seat 4: Klemtonius (9900 in chips) 
Seat 7: Mafak2020 (32564 in chips) 
Seat 8: HighCardJasper (5346 in chips) 
Seat 9: manon327 (14475 in chips) 
dhduncan: posts small blind 50
PokerStarMan123: posts big blind 100
*** HOLE CARDS ***
Dealt to PokerStarMan123 [Jd 9h]
Klemtonius: raises 100 to 200
Mafak2020 has timed out
Mafak2020: folds 
HighCardJasper: raises 100 to 300
manon327: calls 300
color_singleton: folds 
dhduncan: calls 250
PokerStarMan123: calls 200
Klemtonius: calls 100
*** FLOP *** [Td 6s 5c]
dhduncan: checks 
PokerStarMan123: checks 
Klemtonius: bets 100
HighCardJasper: raises 100 to 200
manon327: folds 
dhduncan: folds 
PokerStarMan123: folds 
Klemtonius: folds 
Uncalled bet (100) returned to HighCardJasper
HighCardJasper collected 1606 from pot
HighCardJasper: doesn't show hand 
*** SUMMARY ***
Total pot 1700 | Rake 94 
Board [Td 6s 5c]
Seat 1: color_singleton (button) folded before Flop (didn't bet)
Seat 2: dhduncan (small blind) folded on the Flop
Seat 3: PokerStarMan123 (big blind) folded on the Flop
Seat 4: Klemtonius folded on the Flop
Seat 7: Mafak2020 folded before Flop (didn't bet)
Seat 8: HighCardJasper collected (1606)
Seat 9: manon327 folded on the Flop



PokerStars Home Game Hand #225606532029: {DaPokaStars}  Hold'em No Limit (50/100) - 2021/04/07 16:38:24 ET
Table 'agian and again' 9-max (Play Money) Seat #2 is the button
Seat 1: color_singleton (17059 in chips) 
Seat 2: dhduncan (6298 in chips) 
Seat 3: PokerStarMan123 (11651 in chips) 
Seat 4: Klemtonius (9500 in chips) 
Seat 7: Mafak2020 (32564 in chips) 
Seat 8: HighCardJasper (6552 in chips) 
Seat 9: manon327 (14175 in chips) 
PokerStarMan123: posts small blind 50
Klemtonius: posts big blind 100
*** HOLE CARDS ***
Dealt to PokerStarMan123 [7c 8s]
Mafak2020: raises 200 to 300
HighCardJasper: calls 300
manon327: calls 300
color_singleton: folds 
dhduncan: folds 
PokerStarMan123: calls 250
Klemtonius: calls 200
*** FLOP *** [Th 5h 4c]
PokerStarMan123: checks 
Klemtonius: checks 
Mafak2020: checks 
HighCardJasper: checks 
manon327: checks 
*** TURN *** [Th 5h 4c] [7s]
PokerStarMan123: checks 
Klemtonius: checks 
Mafak2020: checks 
HighCardJasper: checks 
manon327: checks 
*** RIVER *** [Th 5h 4c 7s] [2d]
PokerStarMan123: bets 800
Klemtonius: calls 800
Mafak2020: folds 
HighCardJasper: folds 
manon327: folds 
*** SHOW DOWN ***
PokerStarMan123: shows [7c 8s] (a pair of Sevens)
Klemtonius: shows [Ad 7h] (a pair of Sevens - Ace kicker)
Klemtonius collected 2929 from pot
*** SUMMARY ***
Total pot 3100 | Rake 171 
Board [Th 5h 4c 7s 2d]
Seat 1: color_singleton folded before Flop (didn't bet)
Seat 2: dhduncan (button) folded before Flop (didn't bet)
Seat 3: PokerStarMan123 (small blind) showed [7c 8s] and lost with a pair of Sevens
Seat 4: Klemtonius (big blind) showed [Ad 7h] and won (2929) with a pair of Sevens
Seat 7: Mafak2020 folded on the River
Seat 8: HighCardJasper folded on the River
Seat 9: manon327 folded on the River



PokerStars Home Game Hand #225606586451: {DaPokaStars}  Hold'em No Limit (50/100) - 2021/04/07 16:39:46 ET
Table 'agian and again' 9-max (Play Money) Seat #3 is the button
Seat 1: color_singleton (17059 in chips) 
Seat 3: PokerStarMan123 (10551 in chips) 
Seat 4: Klemtonius (11329 in chips) 
Seat 7: Mafak2020 (32264 in chips) 
Seat 8: HighCardJasper (6252 in chips) 
Seat 9: manon327 (13875 in chips) 
Klemtonius: posts small blind 50
Mafak2020: posts big blind 100
*** HOLE CARDS ***
Dealt to PokerStarMan123 [7c Kc]
HighCardJasper: folds 
manon327: calls 100
color_singleton: folds 
PokerStarMan123: calls 100
Klemtonius: calls 50
Mafak2020: raises 100 to 200
manon327: calls 100
PokerStarMan123: calls 100
Klemtonius: calls 100
*** FLOP *** [Qc 4s 9c]
Klemtonius: bets 100
Mafak2020: calls 100
manon327: calls 100
PokerStarMan123: raises 400 to 500
Klemtonius: folds 
Mafak2020: folds 
manon327: folds 
Uncalled bet (400) returned to PokerStarMan123
PokerStarMan123 collected 1134 from pot
*** SUMMARY ***
Total pot 1200 | Rake 66 
Board [Qc 4s 9c]
Seat 1: color_singleton folded before Flop (didn't bet)
Seat 3: PokerStarMan123 (button) collected (1134)
Seat 4: Klemtonius (small blind) folded on the Flop
Seat 7: Mafak2020 (big blind) folded on the Flop
Seat 8: HighCardJasper folded before Flop (didn't bet)
Seat 9: manon327 folded on the Flop



PokerStars Home Game Hand #225606639478: {DaPokaStars}  Hold'em No Limit (50/100) - 2021/04/07 16:41:06 ET
Table 'agian and again' 9-max (Play Money) Seat #4 is the button
Seat 1: color_singleton (17059 in chips) 
Seat 2: dhduncan (6298 in chips) 
Seat 3: PokerStarMan123 (11385 in chips) 
Seat 4: Klemtonius (11029 in chips) 
Seat 7: Mafak2020 (31964 in chips) 
Seat 8: HighCardJasper (6252 in chips) 
Seat 9: manon327 (13575 in chips) 
Mafak2020: posts small blind 50
HighCardJasper: posts big blind 100
*** HOLE CARDS ***
Dealt to PokerStarMan123 [3d 4c]
manon327: calls 100
color_singleton: folds 
dhduncan: calls 100
PokerStarMan123: folds 
Klemtonius said, "n"
Klemtonius: raises 100 to 200
Mafak2020: calls 150
HighCardJasper has timed out
HighCardJasper: folds 
manon327: calls 100
dhduncan: calls 100
*** FLOP *** [7h Ad 6h]
Mafak2020: checks 
manon327: checks 
dhduncan: checks 
Klemtonius: bets 850
Mafak2020 has timed out
Mafak2020: folds 
manon327: folds 
dhduncan: folds 
Uncalled bet (850) returned to Klemtonius
Klemtonius collected 850 from pot
Klemtonius: doesn't show hand 
*** SUMMARY ***
Total pot 900 | Rake 50 
Board [7h Ad 6h]
Seat 1: color_singleton folded before Flop (didn't bet)
Seat 2: dhduncan folded on the Flop
Seat 3: PokerStarMan123 folded before Flop (didn't bet)
Seat 4: Klemtonius (button) collected (850)
Seat 7: Mafak2020 (small blind) folded on the Flop
Seat 8: HighCardJasper (big blind) folded before Flop
Seat 9: manon327 folded on the Flop



PokerStars Home Game Hand #225606688967: {DaPokaStars}  Hold'em No Limit (50/100) - 2021/04/07 16:42:22 ET
Table 'agian and again' 9-max (Play Money) Seat #9 is the button
Seat 1: color_singleton (17059 in chips) 
Seat 2: dhduncan (6098 in chips) 
Seat 3: PokerStarMan123 (11385 in chips) 
Seat 4: Klemtonius (11679 in chips) 
Seat 9: manon327 (13375 in chips) 
color_singleton: posts small blind 50
dhduncan: posts big blind 100
*** HOLE CARDS ***
Dealt to PokerStarMan123 [9h Th]
PokerStarMan123: raises 200 to 300
Klemtonius: calls 300
manon327: calls 300
color_singleton: calls 250
dhduncan: folds 
*** FLOP *** [4h As Jd]
color_singleton: checks 
PokerStarMan123: checks 
Klemtonius: checks 
manon327: bets 614
color_singleton: calls 614
PokerStarMan123: folds 
Klemtonius: folds 
*** TURN *** [4h As Jd] [6c]
color_singleton: checks 
manon327: checks 
*** RIVER *** [4h As Jd 6c] [2h]
color_singleton: checks 
manon327: bets 2389
color_singleton: folds 
Uncalled bet (2389) returned to manon327
manon327 collected 2389 from pot
*** SUMMARY ***
Total pot 2528 | Rake 139 
Board [4h As Jd 6c 2h]
Seat 1: color_singleton (small blind) folded on the River
Seat 2: dhduncan (big blind) folded before Flop
Seat 3: PokerStarMan123 folded on the Flop
Seat 4: Klemtonius folded on the Flop
Seat 9: manon327 (button) collected (2389)



PokerStars Home Game Hand #225606721505: {DaPokaStars}  Hold'em No Limit (50/100) - 2021/04/07 16:43:12 ET
Table 'agian and again' 9-max (Play Money) Seat #1 is the button
Seat 1: color_singleton (16145 in chips) 
Seat 2: dhduncan (5998 in chips) 
Seat 3: PokerStarMan123 (11085 in chips) 
Seat 4: Klemtonius (11379 in chips) 
Seat 7: Mafak2020 (31764 in chips) 
Seat 9: manon327 (14850 in chips) 
dhduncan: posts small blind 50
PokerStarMan123: posts big blind 100
*** HOLE CARDS ***
Dealt to PokerStarMan123 [7s 2s]
Klemtonius: raises 100 to 200
Mafak2020: folds 
manon327: calls 200
color_singleton: folds 
dhduncan: calls 150
PokerStarMan123: calls 100
*** FLOP *** [3s 5h 4d]
dhduncan: checks 
PokerStarMan123: checks 
Klemtonius: checks 
manon327: checks 
*** TURN *** [3s 5h 4d] [Qc]
dhduncan: checks 
PokerStarMan123: checks 
Klemtonius: bets 100
manon327: folds 
dhduncan: folds 
PokerStarMan123: calls 100
*** RIVER *** [3s 5h 4d Qc] [4c]
juiceC2 joins the table at seat #6 
PokerStarMan123: checks 
Klemtonius: bets 945
PokerStarMan123: folds 
Uncalled bet (945) returned to Klemtonius
Klemtonius collected 945 from pot
Klemtonius: doesn't show hand 
*** SUMMARY ***
Total pot 1000 | Rake 55 
Board [3s 5h 4d Qc 4c]
Seat 1: color_singleton (button) folded before Flop (didn't bet)
Seat 2: dhduncan (small blind) folded on the Turn
Seat 3: PokerStarMan123 (big blind) folded on the River
Seat 4: Klemtonius collected (945)
Seat 7: Mafak2020 folded before Flop (didn't bet)
Seat 9: manon327 folded on the Turn



PokerStars Home Game Hand #225606777862: {DaPokaStars}  Hold'em No Limit (50/100) - 2021/04/07 16:44:39 ET
Table 'agian and again' 9-max (Play Money) Seat #2 is the button
Seat 1: color_singleton (16145 in chips) 
Seat 2: dhduncan (5798 in chips) 
Seat 3: PokerStarMan123 (10785 in chips) 
Seat 4: Klemtonius (12024 in chips) 
Seat 6: juiceC2 (10000 in chips) 
Seat 7: Mafak2020 (31764 in chips) 
Seat 8: HighCardJasper (6152 in chips) 
Seat 9: manon327 (14650 in chips) 
PokerStarMan123: posts small blind 50
Klemtonius: posts big blind 100
juiceC2: posts big blind 100
*** HOLE CARDS ***
Dealt to PokerStarMan123 [7d 7c]
juiceC2: raises 100 to 200
Mafak2020: folds 
HighCardJasper: calls 200
manon327: calls 200
color_singleton: folds 
dhduncan: calls 200
PokerStarMan123: calls 150
Klemtonius: raises 100 to 300
juiceC2: calls 100
HighCardJasper: calls 100
manon327: calls 100
dhduncan: calls 100
PokerStarMan123: calls 100
*** FLOP *** [Qd 5d Tc]
PokerStarMan123: checks 
Klemtonius: bets 1701
juiceC2: calls 1701
HighCardJasper: folds 
manon327: folds 
dhduncan: folds 
PokerStarMan123: folds 
*** TURN *** [Qd 5d Tc] [8s]
Klemtonius: bets 4916
juiceC2: folds 
Uncalled bet (4916) returned to Klemtonius
Klemtonius collected 4916 from pot
Klemtonius: doesn't show hand 
*** SUMMARY ***
Total pot 5202 | Rake 286 
Board [Qd 5d Tc 8s]
Seat 1: color_singleton folded before Flop (didn't bet)
Seat 2: dhduncan (button) folded on the Flop
Seat 3: PokerStarMan123 (small blind) folded on the Flop
Seat 4: Klemtonius (big blind) collected (4916)
Seat 6: juiceC2 folded on the Turn
Seat 7: Mafak2020 folded before Flop (didn't bet)
Seat 8: HighCardJasper folded on the Flop
Seat 9: manon327 folded on the Flop



PokerStars Home Game Hand #225606817435: {DaPokaStars}  Hold'em No Limit (50/100) - 2021/04/07 16:45:39 ET
Table 'agian and again' 9-max (Play Money) Seat #3 is the button
Seat 1: color_singleton (16145 in chips) 
Seat 2: dhduncan (5498 in chips) 
Seat 3: PokerStarMan123 (10485 in chips) 
Seat 4: Klemtonius (14939 in chips) 
Seat 6: juiceC2 (7999 in chips) 
Seat 7: Mafak2020 (31764 in chips) 
Seat 8: HighCardJasper (5852 in chips) 
Seat 9: manon327 (14350 in chips) 
Klemtonius: posts small blind 50
juiceC2: posts big blind 100
*** HOLE CARDS ***
Dealt to PokerStarMan123 [5h 7s]
Mafak2020: calls 100
HighCardJasper: calls 100
manon327: calls 100
color_singleton: calls 100
dhduncan: folds 
PokerStarMan123: folds 
Klemtonius: calls 50
juiceC2: checks 
*** FLOP *** [3h Kd As]
Klemtonius: bets 567
juiceC2: calls 567
Mafak2020: folds 
HighCardJasper: folds 
manon327: calls 567
color_singleton: folds 
*** TURN *** [3h Kd As] [Td]
Klemtonius: bets 2174
juiceC2: raises 2174 to 4348
manon327: folds 
Klemtonius: raises 2174 to 6522
juiceC2: raises 810 to 7332 and is all-in
Klemtonius: calls 810
*** RIVER *** [3h Kd As Td] [2h]
*** SHOW DOWN ***
Klemtonius: shows [Jc Ad] (a pair of Aces)
juiceC2: shows [Qs Js] (a straight, Ten to Ace)
juiceC2 collected 16032 from pot
*** SUMMARY ***
Total pot 16965 | Rake 933 
Board [3h Kd As Td 2h]
Seat 1: color_singleton folded on the Flop
Seat 2: dhduncan folded before Flop (didn't bet)
Seat 3: PokerStarMan123 (button) folded before Flop (didn't bet)
Seat 4: Klemtonius (small blind) showed [Jc Ad] and lost with a pair of Aces
Seat 6: juiceC2 (big blind) showed [Qs Js] and won (16032) with a straight, Ten to Ace
Seat 7: Mafak2020 folded on the Flop
Seat 8: HighCardJasper folded on the Flop
Seat 9: manon327 folded on the Turn



PokerStars Home Game Hand #225606854736: {DaPokaStars}  Hold'em No Limit (50/100) - 2021/04/07 16:46:36 ET
Table 'agian and again' 9-max (Play Money) Seat #4 is the button
Seat 1: color_singleton (16045 in chips) 
Seat 2: dhduncan (5498 in chips) 
Seat 3: PokerStarMan123 (10485 in chips) 
Seat 4: Klemtonius (6940 in chips) 
Seat 6: juiceC2 (16032 in chips) 
Seat 7: Mafak2020 (31664 in chips) 
Seat 8: HighCardJasper (5752 in chips) 
Seat 9: manon327 (13683 in chips) 
juiceC2: posts small blind 50
Mafak2020: posts big blind 100
*** HOLE CARDS ***
Dealt to PokerStarMan123 [8s 6d]
HighCardJasper: calls 100
manon327: folds 
color_singleton: calls 100
dhduncan: folds 
PokerStarMan123: calls 100
Klemtonius: raises 100 to 200
juiceC2: calls 150
Mafak2020: calls 100
HighCardJasper: calls 100
color_singleton: calls 100
PokerStarMan123: calls 100
*** FLOP *** [7s 6h Ks]
juiceC2: bets 800
Mafak2020: calls 800
HighCardJasper: folds 
color_singleton: folds 
PokerStarMan123: folds 
Klemtonius: folds 
*** TURN *** [7s 6h Ks] [Qs]
juiceC2: bets 1323
Mafak2020: calls 1323
*** RIVER *** [7s 6h Ks Qs] [3s]
juiceC2: bets 2573
Mafak2020: calls 2573
*** SHOW DOWN ***
juiceC2: shows [Jd Kd] (a pair of Kings)
Mafak2020: shows [9s Kc] (a flush, King high)
Mafak2020 collected 10009 from pot
*** SUMMARY ***
Total pot 10592 | Rake 583 
Board [7s 6h Ks Qs 3s]
Seat 1: color_singleton folded on the Flop
Seat 2: dhduncan folded before Flop (didn't bet)
Seat 3: PokerStarMan123 folded on the Flop
Seat 4: Klemtonius (button) folded on the Flop
Seat 6: juiceC2 (small blind) showed [Jd Kd] and lost with a pair of Kings
Seat 7: Mafak2020 (big blind) showed [9s Kc] and won (10009) with a flush, King high
Seat 8: HighCardJasper folded on the Flop
Seat 9: manon327 folded before Flop (didn't bet)



PokerStars Home Game Hand #225606910236: {DaPokaStars}  Hold'em No Limit (50/100) - 2021/04/07 16:48:01 ET
Table 'agian and again' 9-max (Play Money) Seat #6 is the button
Seat 1: color_singleton (15845 in chips) 
Seat 2: dhduncan (5498 in chips) 
Seat 3: PokerStarMan123 (10285 in chips) 
Seat 4: Klemtonius (6740 in chips) 
Seat 6: juiceC2 (11136 in chips) 
Seat 7: Mafak2020 (36777 in chips) 
Seat 8: HighCardJasper (5552 in chips) 
Seat 9: manon327 (13683 in chips) 
Mafak2020: posts small blind 50
HighCardJasper: posts big blind 100
*** HOLE CARDS ***
Dealt to PokerStarMan123 [Qh Jc]
manon327: calls 100
color_singleton: folds 
dhduncan: folds 
PokerStarMan123: calls 100
Klemtonius: calls 100
juiceC2: folds 
Mafak2020: calls 50
HighCardJasper: checks 
*** FLOP *** [Kd 7h 5d]
Mafak2020: checks 
HighCardJasper: checks 
manon327: checks 
PokerStarMan123: checks 
Klemtonius: bets 100
Mafak2020: calls 100
HighCardJasper: folds 
manon327: calls 100
PokerStarMan123: folds 
*** TURN *** [Kd 7h 5d] [7c]
Mafak2020: checks 
manon327: checks 
Klemtonius: checks 
*** RIVER *** [Kd 7h 5d 7c] [7d]
Mafak2020: bets 500
manon327: raises 500 to 1000
Klemtonius: folds 
Mafak2020: raises 1200 to 2200
manon327: calls 1200
*** SHOW DOWN ***
Mafak2020: shows [9h 5h] (a full house, Sevens full of Fives)
manon327: mucks hand 
Mafak2020 collected 4914 from pot
*** SUMMARY ***
Total pot 5200 | Rake 286 
Board [Kd 7h 5d 7c 7d]
Seat 1: color_singleton folded before Flop (didn't bet)
Seat 2: dhduncan folded before Flop (didn't bet)
Seat 3: PokerStarMan123 folded on the Flop
Seat 4: Klemtonius folded on the River
Seat 6: juiceC2 (button) folded before Flop (didn't bet)
Seat 7: Mafak2020 (small blind) showed [9h 5h] and won (4914) with a full house, Sevens full of Fives
Seat 8: HighCardJasper (big blind) folded on the Flop
Seat 9: manon327 mucked [4d Td]



PokerStars Home Game Hand #225606979550: {DaPokaStars}  Hold'em No Limit (50/100) - 2021/04/07 16:49:49 ET
Table 'agian and again' 9-max (Play Money) Seat #7 is the button
Seat 1: color_singleton (15845 in chips) 
Seat 2: dhduncan (5498 in chips) 
Seat 3: PokerStarMan123 (10185 in chips) 
Seat 4: Klemtonius (6540 in chips) 
Seat 6: juiceC2 (11136 in chips) 
Seat 7: Mafak2020 (39291 in chips) 
Seat 8: HighCardJasper (5452 in chips) 
Seat 9: manon327 (11283 in chips) 
HighCardJasper: posts small blind 50
manon327: posts big blind 100
*** HOLE CARDS ***
Dealt to PokerStarMan123 [Kh Qd]
color_singleton: folds 
dhduncan: calls 100
PokerStarMan123: raises 300 to 400
Klemtonius: folds 
juiceC2: calls 400
Mafak2020: calls 400
HighCardJasper: folds 
manon327: folds 
dhduncan: calls 300
*** FLOP *** [9c 6c Tc]
dhduncan: checks 
PokerStarMan123: checks 
juiceC2: checks 
Mafak2020: checks 
*** TURN *** [9c 6c Tc] [5d]
dhduncan: checks 
PokerStarMan123: checks 
juiceC2: checks 
Mafak2020: checks 
*** RIVER *** [9c 6c Tc 5d] [Ts]
dhduncan: checks 
PokerStarMan123: checks 
juiceC2: checks 
Mafak2020: checks 
*** SHOW DOWN ***
dhduncan: shows [Ad Qc] (a pair of Tens)
PokerStarMan123: mucks hand 
juiceC2: shows [2c 2s] (two pair, Tens and Deuces)
Mafak2020: shows [9d 8s] (two pair, Tens and Nines)
Mafak2020 collected 1654 from pot
*** SUMMARY ***
Total pot 1750 | Rake 96 
Board [9c 6c Tc 5d Ts]
Seat 1: color_singleton folded before Flop (didn't bet)
Seat 2: dhduncan showed [Ad Qc] and lost with a pair of Tens
Seat 3: PokerStarMan123 mucked [Kh Qd]
Seat 4: Klemtonius folded before Flop (didn't bet)
Seat 6: juiceC2 showed [2c 2s] and lost with two pair, Tens and Deuces
Seat 7: Mafak2020 (button) showed [9d 8s] and won (1654) with two pair, Tens and Nines
Seat 8: HighCardJasper (small blind) folded before Flop
Seat 9: manon327 (big blind) folded before Flop



PokerStars Home Game Hand #225607038671: {DaPokaStars}  Hold'em No Limit (50/100) - 2021/04/07 16:51:22 ET
Table 'agian and again' 9-max (Play Money) Seat #8 is the button
Seat 1: color_singleton (15845 in chips) 
Seat 2: dhduncan (5098 in chips) 
Seat 3: PokerStarMan123 (9785 in chips) 
Seat 4: Klemtonius (6540 in chips) 
Seat 6: juiceC2 (10736 in chips) 
Seat 7: Mafak2020 (40545 in chips) 
Seat 8: HighCardJasper (5402 in chips) 
Seat 9: manon327 (11183 in chips) 
manon327: posts small blind 50
color_singleton: posts big blind 100
*** HOLE CARDS ***
Dealt to PokerStarMan123 [4d Qs]
dhduncan: folds 
PokerStarMan123: folds 
Klemtonius: calls 100
juiceC2: folds 
Mafak2020: calls 100
HighCardJasper: calls 100
manon327: folds 
color_singleton: raises 400 to 500
Klemtonius: folds 
Mafak2020: calls 400
HighCardJasper: calls 400
*** FLOP *** [9c 6d 4h]
color_singleton: bets 1559
Mafak2020: folds 
HighCardJasper: calls 1559
*** TURN *** [9c 6d 4h] [Kd]
color_singleton: bets 4506
HighCardJasper: folds 
Uncalled bet (4506) returned to color_singleton
color_singleton collected 4506 from pot
color_singleton: doesn't show hand 
*** SUMMARY ***
Total pot 4768 | Rake 262 
Board [9c 6d 4h Kd]
Seat 1: color_singleton (big blind) collected (4506)
Seat 2: dhduncan folded before Flop (didn't bet)
Seat 3: PokerStarMan123 folded before Flop (didn't bet)
Seat 4: Klemtonius folded before Flop
Seat 6: juiceC2 folded before Flop (didn't bet)
Seat 7: Mafak2020 folded on the Flop
Seat 8: HighCardJasper (button) folded on the Turn
Seat 9: manon327 (small blind) folded before Flop



PokerStars Home Game Hand #225607089774: {DaPokaStars}  Hold'em No Limit (50/100) - 2021/04/07 16:52:42 ET
Table 'agian and again' 9-max (Play Money) Seat #9 is the button
Seat 1: color_singleton (18292 in chips) 
Seat 2: dhduncan (5098 in chips) 
Seat 3: PokerStarMan123 (9785 in chips) 
Seat 4: Klemtonius (6440 in chips) 
Seat 6: juiceC2 (10736 in chips) 
Seat 7: Mafak2020 (40045 in chips) 
Seat 8: HighCardJasper (3343 in chips) 
Seat 9: manon327 (11133 in chips) 
color_singleton: posts small blind 50
dhduncan: posts big blind 100
*** HOLE CARDS ***
Dealt to PokerStarMan123 [Th 9h]
PokerStarMan123: raises 300 to 400
Klemtonius: raises 300 to 700
juiceC2: calls 700
Mafak2020: folds 
HighCardJasper: folds 
manon327: folds 
color_singleton: folds 
dhduncan: folds 
PokerStarMan123: calls 300
*** FLOP *** [8d Ac 3d]
PokerStarMan123: checks 
Klemtonius: bets 2126
juiceC2: folds 
PokerStarMan123: folds 
Uncalled bet (2126) returned to Klemtonius
Klemtonius collected 2126 from pot
Klemtonius: doesn't show hand 
*** SUMMARY ***
Total pot 2250 | Rake 124 
Board [8d Ac 3d]
Seat 1: color_singleton (small blind) folded before Flop
Seat 2: dhduncan (big blind) folded before Flop
Seat 3: PokerStarMan123 folded on the Flop
Seat 4: Klemtonius collected (2126)
Seat 6: juiceC2 folded on the Flop
Seat 7: Mafak2020 folded before Flop (didn't bet)
Seat 8: HighCardJasper folded before Flop (didn't bet)
Seat 9: manon327 (button) folded before Flop (didn't bet)



PokerStars Home Game Hand #225607127635: {DaPokaStars}  Hold'em No Limit (50/100) - 2021/04/07 16:53:29 ET
Table 'agian and again' 9-max (Play Money) Seat #1 is the button
Seat 1: color_singleton (18242 in chips) 
Seat 2: dhduncan (4998 in chips) 
Seat 3: PokerStarMan123 (9085 in chips) 
Seat 4: Klemtonius (7866 in chips) 
Seat 6: juiceC2 (10036 in chips) 
Seat 7: Mafak2020 (40045 in chips) 
Seat 8: HighCardJasper (3343 in chips) 
Seat 9: manon327 (11133 in chips) 
dhduncan: posts small blind 50
PokerStarMan123: posts big blind 100
*** HOLE CARDS ***
Dealt to PokerStarMan123 [5s 4d]
Klemtonius: folds 
juiceC2: folds 
Mafak2020: calls 100
HighCardJasper: folds 
manon327: calls 100
color_singleton: folds 
dhduncan: folds 
PokerStarMan123: checks 
*** FLOP *** [7c 7s 5c]
PokerStarMan123: bets 200
Mafak2020: folds 
manon327: calls 200
*** TURN *** [7c 7s 5c] [Ac]
PokerStarMan123: checks 
manon327: bets 354
PokerStarMan123: calls 354
*** RIVER *** [7c 7s 5c Ac] [9c]
PokerStarMan123: checks 
manon327: bets 1378
PokerStarMan123: folds 
Uncalled bet (1378) returned to manon327
manon327 collected 1378 from pot
*** SUMMARY ***
Total pot 1458 | Rake 80 
Board [7c 7s 5c Ac 9c]
Seat 1: color_singleton (button) folded before Flop (didn't bet)
Seat 2: dhduncan (small blind) folded before Flop
Seat 3: PokerStarMan123 (big blind) folded on the River
Seat 4: Klemtonius folded before Flop (didn't bet)
Seat 6: juiceC2 folded before Flop (didn't bet)
Seat 7: Mafak2020 folded on the Flop
Seat 8: HighCardJasper folded before Flop (didn't bet)
Seat 9: manon327 collected (1378)



PokerStars Home Game Hand #225607166118: {DaPokaStars}  Hold'em No Limit (50/100) - 2021/04/07 16:54:30 ET
Table 'agian and again' 9-max (Play Money) Seat #2 is the button
Seat 1: color_singleton (18242 in chips) 
Seat 2: dhduncan (4948 in chips) 
Seat 3: PokerStarMan123 (8431 in chips) 
Seat 4: Klemtonius (7866 in chips) 
Seat 6: juiceC2 (10036 in chips) 
Seat 7: Mafak2020 (39945 in chips) 
Seat 8: HighCardJasper (3343 in chips) 
Seat 9: manon327 (11857 in chips) 
PokerStarMan123: posts small blind 50
Klemtonius: posts big blind 100
*** HOLE CARDS ***
Dealt to PokerStarMan123 [Ks 8c]
juiceC2: calls 100
Mafak2020: calls 100
HighCardJasper: folds 
manon327: calls 100
color_singleton: folds 
dhduncan: folds 
PokerStarMan123: calls 50
Klemtonius: checks 
*** FLOP *** [3h Jd 5c]
PokerStarMan123: checks 
Klemtonius: checks 
juiceC2: checks 
Mafak2020: checks 
manon327: checks 
*** TURN *** [3h Jd 5c] [Qh]
PokerStarMan123: checks 
Klemtonius: bets 100
juiceC2: calls 100
Mafak2020: calls 100
manon327: calls 100
PokerStarMan123: folds 
*** RIVER *** [3h Jd 5c Qh] [9c]
Klemtonius: checks 
juiceC2: checks 
Mafak2020: checks 
manon327: checks 
*** SHOW DOWN ***
Klemtonius: shows [4c Qs] (a pair of Queens)
juiceC2: mucks hand 
Mafak2020: mucks hand 
manon327: mucks hand 
Klemtonius collected 850 from pot
*** SUMMARY ***
Total pot 900 | Rake 50 
Board [3h Jd 5c Qh 9c]
Seat 1: color_singleton folded before Flop (didn't bet)
Seat 2: dhduncan (button) folded before Flop (didn't bet)
Seat 3: PokerStarMan123 (small blind) folded on the Turn
Seat 4: Klemtonius (big blind) showed [4c Qs] and won (850) with a pair of Queens
Seat 6: juiceC2 mucked [As 5d]
Seat 7: Mafak2020 mucked [6c Ah]
Seat 8: HighCardJasper folded before Flop (didn't bet)
Seat 9: manon327 mucked [Td Ad]



PokerStars Home Game Hand #225607206505: {DaPokaStars}  Hold'em No Limit (50/100) - 2021/04/07 16:55:36 ET
Table 'agian and again' 9-max (Play Money) Seat #3 is the button
Seat 1: color_singleton (18242 in chips) 
Seat 2: dhduncan (4948 in chips) 
Seat 3: PokerStarMan123 (8331 in chips) 
Seat 4: Klemtonius (8516 in chips) 
Seat 6: juiceC2 (9836 in chips) 
Seat 7: Mafak2020 (39745 in chips) 
Seat 8: HighCardJasper (3343 in chips) 
Seat 9: manon327 (11657 in chips) 
Klemtonius: posts small blind 50
juiceC2: posts big blind 100
*** HOLE CARDS ***
Dealt to PokerStarMan123 [Jc Kh]
Mafak2020: folds 
HighCardJasper: calls 100
manon327: folds 
color_singleton: calls 100
dhduncan: folds 
PokerStarMan123: raises 300 to 400
Klemtonius: folds 
juiceC2: folds 
HighCardJasper: folds 
color_singleton: calls 300
*** FLOP *** [Th 2d 9d]
color_singleton: bets 992
PokerStarMan123: calls 992
*** TURN *** [Th 2d 9d] [8h]
color_singleton: bets 2867
PokerStarMan123: folds 
Uncalled bet (2867) returned to color_singleton
color_singleton collected 2867 from pot
color_singleton: doesn't show hand 
*** SUMMARY ***
Total pot 3034 | Rake 167 
Board [Th 2d 9d 8h]
Seat 1: color_singleton collected (2867)
Seat 2: dhduncan folded before Flop (didn't bet)
Seat 3: PokerStarMan123 (button) folded on the Turn
Seat 4: Klemtonius (small blind) folded before Flop
Seat 6: juiceC2 (big blind) folded before Flop
Seat 7: Mafak2020 folded before Flop (didn't bet)
Seat 8: HighCardJasper folded before Flop
Seat 9: manon327 folded before Flop (didn't bet)



PokerStars Home Game Hand #225607232522: {DaPokaStars}  Hold'em No Limit (50/100) - 2021/04/07 16:56:22 ET
Table 'agian and again' 9-max (Play Money) Seat #4 is the button
Seat 1: color_singleton (19717 in chips) 
Seat 2: dhduncan (4948 in chips) 
Seat 3: PokerStarMan123 (6939 in chips) 
Seat 4: Klemtonius (8466 in chips) 
Seat 6: juiceC2 (9736 in chips) 
Seat 7: Mafak2020 (39745 in chips) 
Seat 8: HighCardJasper (3243 in chips) 
Seat 9: manon327 (11657 in chips) 
juiceC2: posts small blind 50
Mafak2020: posts big blind 100
*** HOLE CARDS ***
Dealt to PokerStarMan123 [5d 6s]
HighCardJasper: folds 
manon327: calls 100
color_singleton: folds 
dhduncan has timed out
dhduncan: folds 
PokerStarMan123: calls 100
Klemtonius: calls 100
juiceC2: calls 50
Mafak2020: checks 
*** FLOP *** [Jh Ts 4d]
juiceC2: checks 
Mafak2020: checks 
manon327: checks 
PokerStarMan123: checks 
Klemtonius: bets 472
juiceC2: folds 
Mafak2020: folds 
manon327: calls 472
PokerStarMan123: folds 
*** TURN *** [Jh Ts 4d] [3c]
manon327: checks 
Klemtonius: bets 1365
manon327: folds 
Uncalled bet (1365) returned to Klemtonius
Klemtonius collected 1365 from pot
Klemtonius: doesn't show hand 
*** SUMMARY ***
Total pot 1444 | Rake 79 
Board [Jh Ts 4d 3c]
Seat 1: color_singleton folded before Flop (didn't bet)
Seat 2: dhduncan folded before Flop (didn't bet)
Seat 3: PokerStarMan123 folded on the Flop
Seat 4: Klemtonius (button) collected (1365)
Seat 6: juiceC2 (small blind) folded on the Flop
Seat 7: Mafak2020 (big blind) folded on the Flop
Seat 8: HighCardJasper folded before Flop (didn't bet)
Seat 9: manon327 folded on the Turn



PokerStars Home Game Hand #225607265336: {DaPokaStars}  Hold'em No Limit (50/100) - 2021/04/07 16:57:37 ET
Table 'agian and again' 9-max (Play Money) Seat #6 is the button
Seat 1: color_singleton (19717 in chips) 
Seat 2: dhduncan (4948 in chips) 
Seat 3: PokerStarMan123 (6839 in chips) 
Seat 4: Klemtonius (9259 in chips) 
Seat 6: juiceC2 (9636 in chips) 
Seat 7: Mafak2020 (39645 in chips) 
Seat 8: HighCardJasper (3243 in chips) 
Seat 9: manon327 (11085 in chips) 
Mafak2020: posts small blind 50
HighCardJasper: posts big blind 100
*** HOLE CARDS ***
Dealt to PokerStarMan123 [7h 4s]
manon327: folds 
color_singleton: folds 
dhduncan: calls 100
PokerStarMan123: folds 
Klemtonius: folds 
juiceC2: calls 100
Mafak2020: calls 50
HighCardJasper: checks 
*** FLOP *** [Js 3h Qc]
Mafak2020: checks 
HighCardJasper: checks 
dhduncan: checks 
juiceC2: checks 
*** TURN *** [Js 3h Qc] [6s]
Mafak2020: checks 
HighCardJasper: bets 100
dhduncan: calls 100
juiceC2: calls 100
Mafak2020: calls 100
*** RIVER *** [Js 3h Qc 6s] [3s]
Mafak2020: checks 
HighCardJasper: bets 100
dhduncan: calls 100
juiceC2: calls 100
Mafak2020: calls 100
*** SHOW DOWN ***
HighCardJasper: shows [5h Jh] (two pair, Jacks and Threes)
dhduncan: shows [4h Qh] (two pair, Queens and Threes)
juiceC2: mucks hand 
Mafak2020: mucks hand 
dhduncan collected 1134 from pot
*** SUMMARY ***
Total pot 1200 | Rake 66 
Board [Js 3h Qc 6s 3s]
Seat 1: color_singleton folded before Flop (didn't bet)
Seat 2: dhduncan showed [4h Qh] and won (1134) with two pair, Queens and Threes
Seat 3: PokerStarMan123 folded before Flop (didn't bet)
Seat 4: Klemtonius folded before Flop (didn't bet)
Seat 6: juiceC2 (button) mucked [6h Ac]
Seat 7: Mafak2020 (small blind) mucked [Jd 8d]
Seat 8: HighCardJasper (big blind) showed [5h Jh] and lost with two pair, Jacks and Threes
Seat 9: manon327 folded before Flop (didn't bet)



PokerStars Home Game Hand #225607302127: {DaPokaStars}  Hold'em No Limit (50/100) - 2021/04/07 16:59:02 ET
Table 'agian and again' 9-max (Play Money) Seat #7 is the button
Seat 1: color_singleton (19717 in chips) 
Seat 2: dhduncan (5782 in chips) 
Seat 3: PokerStarMan123 (6839 in chips) 
Seat 4: Klemtonius (9259 in chips) 
Seat 6: juiceC2 (9336 in chips) 
Seat 7: Mafak2020 (39345 in chips) 
Seat 8: HighCardJasper (2943 in chips) 
Seat 9: manon327 (11085 in chips) 
HighCardJasper: posts small blind 50
manon327: posts big blind 100
*** HOLE CARDS ***
Dealt to PokerStarMan123 [4d Tc]
color_singleton: raises 200 to 300
dhduncan has timed out
dhduncan: folds 
PokerStarMan123: folds 
Klemtonius: calls 300
juiceC2: folds 
Mafak2020: folds 
HighCardJasper: folds 
manon327: calls 200
*** FLOP *** [8s 4s Qd]
manon327: checks 
color_singleton: checks 
Klemtonius: bets 898
manon327: folds 
color_singleton: raises 898 to 1796
Klemtonius: calls 898
*** TURN *** [8s 4s Qd] [Kc]
color_singleton: bets 4292
Klemtonius: folds 
Uncalled bet (4292) returned to color_singleton
color_singleton collected 4292 from pot
color_singleton: doesn't show hand 
*** SUMMARY ***
Total pot 4542 | Rake 250 
Board [8s 4s Qd Kc]
Seat 1: color_singleton collected (4292)
Seat 2: dhduncan folded before Flop (didn't bet)
Seat 3: PokerStarMan123 folded before Flop (didn't bet)
Seat 4: Klemtonius folded on the Turn
Seat 6: juiceC2 folded before Flop (didn't bet)
Seat 7: Mafak2020 (button) folded before Flop (didn't bet)
Seat 8: HighCardJasper (small blind) folded before Flop
Seat 9: manon327 (big blind) folded on the Flop



PokerStars Home Game Hand #225607325999: {DaPokaStars}  Hold'em No Limit (50/100) - 2021/04/07 16:59:56 ET
Table 'agian and again' 9-max (Play Money) Seat #8 is the button
Seat 1: color_singleton (21913 in chips) 
Seat 2: dhduncan (5782 in chips) 
Seat 3: PokerStarMan123 (6839 in chips) 
Seat 4: Klemtonius (7163 in chips) 
Seat 6: juiceC2 (9336 in chips) 
Seat 7: Mafak2020 (39345 in chips) 
Seat 8: HighCardJasper (2893 in chips) 
Seat 9: manon327 (10785 in chips) 
manon327: posts small blind 50
color_singleton: posts big blind 100
*** HOLE CARDS ***
Dealt to PokerStarMan123 [7s 8h]
dhduncan: folds 
PokerStarMan123: calls 100
Klemtonius: folds 
juiceC2: folds 
Mafak2020: calls 100
HighCardJasper: folds 
manon327: calls 50
color_singleton: checks 
*** FLOP *** [6c Qc Qh]
manon327: checks 
color_singleton: checks 
PokerStarMan123: checks 
Mafak2020: checks 
*** TURN *** [6c Qc Qh] [4c]
manon327: checks 
color_singleton: checks 
PokerStarMan123: checks 
Mafak2020: checks 
*** RIVER *** [6c Qc Qh 4c] [9d]
manon327: checks 
color_singleton: checks 
PokerStarMan123: checks 
Mafak2020: checks 
*** SHOW DOWN ***
manon327: shows [Kd 7c] (a pair of Queens)
color_singleton: mucks hand 
PokerStarMan123: mucks hand 
Mafak2020: shows [4d Jd] (two pair, Queens and Fours)
Mafak2020 collected 378 from pot
*** SUMMARY ***
Total pot 400 | Rake 22 
Board [6c Qc Qh 4c 9d]
Seat 1: color_singleton (big blind) mucked [8d Th]
Seat 2: dhduncan folded before Flop (didn't bet)
Seat 3: PokerStarMan123 mucked [7s 8h]
Seat 4: Klemtonius folded before Flop (didn't bet)
Seat 6: juiceC2 folded before Flop (didn't bet)
Seat 7: Mafak2020 showed [4d Jd] and won (378) with two pair, Queens and Fours
Seat 8: HighCardJasper (button) folded before Flop (didn't bet)
Seat 9: manon327 (small blind) showed [Kd 7c] and lost with a pair of Queens



PokerStars Home Game Hand #225607349775: {DaPokaStars}  Hold'em No Limit (50/100) - 2021/04/07 17:00:48 ET
Table 'agian and again' 9-max (Play Money) Seat #9 is the button
Seat 1: color_singleton (21813 in chips) 
Seat 2: dhduncan (5782 in chips) 
Seat 3: PokerStarMan123 (6739 in chips) 
Seat 4: Klemtonius (7163 in chips) 
Seat 6: juiceC2 (9336 in chips) 
Seat 7: Mafak2020 (39623 in chips) 
Seat 8: HighCardJasper (2893 in chips) 
Seat 9: manon327 (10685 in chips) 
color_singleton: posts small blind 50
dhduncan: posts big blind 100
*** HOLE CARDS ***
Dealt to PokerStarMan123 [3c Kh]
PokerStarMan123: folds 
Klemtonius: calls 100
juiceC2: folds 
Mafak2020: calls 100
HighCardJasper: raises 100 to 200
manon327: calls 200
color_singleton: calls 150
dhduncan: folds 
Klemtonius: calls 100
Mafak2020: calls 100
*** FLOP *** [3h 9s 4s]
color_singleton: checks 
Klemtonius: checks 
Mafak2020: checks 
HighCardJasper: checks 
manon327: checks 
*** TURN *** [3h 9s 4s] [Js]
color_singleton: bets 519
Klemtonius: calls 519
Mafak2020: folds 
HighCardJasper: folds 
manon327: folds 
*** RIVER *** [3h 9s 4s Js] [5d]
color_singleton: bets 1010
Klemtonius: folds 
Uncalled bet (1010) returned to color_singleton
color_singleton collected 2020 from pot
color_singleton: doesn't show hand 
*** SUMMARY ***
Total pot 2138 | Rake 118 
Board [3h 9s 4s Js 5d]
Seat 1: color_singleton (small blind) collected (2020)
Seat 2: dhduncan (big blind) folded before Flop
Seat 3: PokerStarMan123 folded before Flop (didn't bet)
Seat 4: Klemtonius folded on the River
Seat 6: juiceC2 folded before Flop (didn't bet)
Seat 7: Mafak2020 folded on the Turn
Seat 8: HighCardJasper folded on the Turn
Seat 9: manon327 (button) folded on the Turn



PokerStars Home Game Hand #225607381731: {DaPokaStars}  Hold'em No Limit (50/100) - 2021/04/07 17:01:47 ET
Table 'agian and again' 9-max (Play Money) Seat #1 is the button
Seat 1: color_singleton (23114 in chips) 
Seat 2: dhduncan (5682 in chips) 
Seat 3: PokerStarMan123 (6739 in chips) 
Seat 4: Klemtonius (6444 in chips) 
Seat 6: juiceC2 (9336 in chips) 
Seat 7: Mafak2020 (39423 in chips) 
Seat 8: HighCardJasper (2693 in chips) 
Seat 9: manon327 (10485 in chips) 
dhduncan: posts small blind 50
PokerStarMan123: posts big blind 100
*** HOLE CARDS ***
Dealt to PokerStarMan123 [7h 4d]
Klemtonius: folds 
juiceC2: folds 
Mafak2020: calls 100
HighCardJasper: calls 100
manon327: calls 100
color_singleton: raises 400 to 500
dhduncan: calls 450
PokerStarMan123 has timed out
PokerStarMan123: folds 
Mafak2020: calls 400
HighCardJasper: folds 
manon327: calls 400
*** FLOP *** [Ts 9d 5c]
dhduncan: checks 
Mafak2020: checks 
manon327: checks 
color_singleton: bets 2079
dhduncan: folds 
Mafak2020: folds 
manon327: folds 
Uncalled bet (2079) returned to color_singleton
color_singleton collected 2079 from pot
color_singleton: doesn't show hand 
*** SUMMARY ***
Total pot 2200 | Rake 121 
Board [Ts 9d 5c]
Seat 1: color_singleton (button) collected (2079)
Seat 2: dhduncan (small blind) folded on the Flop
Seat 3: PokerStarMan123 (big blind) folded before Flop
Seat 4: Klemtonius folded before Flop (didn't bet)
Seat 6: juiceC2 folded before Flop (didn't bet)
Seat 7: Mafak2020 folded on the Flop
Seat 8: HighCardJasper folded before Flop
Seat 9: manon327 folded on the Flop



PokerStars Home Game Hand #225607433801: {DaPokaStars}  Hold'em No Limit (50/100) - 2021/04/07 17:03:09 ET
Table 'agian and again' 9-max (Play Money) Seat #2 is the button
Seat 1: color_singleton (24693 in chips) 
Seat 2: dhduncan (5182 in chips) 
Seat 3: PokerStarMan123 (6639 in chips) 
Seat 4: Klemtonius (6444 in chips) 
Seat 6: juiceC2 (9336 in chips) 
Seat 7: Mafak2020 (38923 in chips) 
Seat 8: HighCardJasper (2593 in chips) 
Seat 9: manon327 (9985 in chips) 
PokerStarMan123: posts small blind 50
Klemtonius: posts big blind 100
*** HOLE CARDS ***
Dealt to PokerStarMan123 [4s 3d]
juiceC2: folds 
Mafak2020: calls 100
HighCardJasper: calls 100
manon327: calls 100
color_singleton: calls 100
dhduncan: calls 100
PokerStarMan123: calls 50
Klemtonius: raises 700 to 800
Mafak2020: calls 700
HighCardJasper: folds 
manon327: calls 700
color_singleton: folds 
dhduncan: calls 700
PokerStarMan123: folds 
*** FLOP *** [8d Tc 2d]
Klemtonius: bets 1653
Mafak2020: folds 
manon327: folds 
dhduncan: folds 
Uncalled bet (1653) returned to Klemtonius
Klemtonius collected 3307 from pot
Klemtonius: doesn't show hand 
*** SUMMARY ***
Total pot 3500 | Rake 193 
Board [8d Tc 2d]
Seat 1: color_singleton folded before Flop
Seat 2: dhduncan (button) folded on the Flop
Seat 3: PokerStarMan123 (small blind) folded before Flop
Seat 4: Klemtonius (big blind) collected (3307)
Seat 6: juiceC2 folded before Flop (didn't bet)
Seat 7: Mafak2020 folded on the Flop
Seat 8: HighCardJasper folded before Flop
Seat 9: manon327 folded on the Flop



PokerStars Home Game Hand #225607463732: {DaPokaStars}  Hold'em No Limit (50/100) - 2021/04/07 17:03:56 ET
Table 'agian and again' 9-max (Play Money) Seat #3 is the button
Seat 1: color_singleton (24593 in chips) 
Seat 2: dhduncan (4382 in chips) 
Seat 3: PokerStarMan123 (6539 in chips) 
Seat 4: Klemtonius (8951 in chips) 
Seat 6: juiceC2 (9336 in chips) 
Seat 7: Mafak2020 (38123 in chips) 
Seat 8: HighCardJasper (2493 in chips) 
Seat 9: manon327 (9185 in chips) 
Klemtonius: posts small blind 50
juiceC2: posts big blind 100
*** HOLE CARDS ***
Dealt to PokerStarMan123 [7d Js]
Mafak2020: raises 300 to 400
HighCardJasper: folds 
manon327: folds 
color_singleton: folds 
dhduncan: calls 400
PokerStarMan123: folds 
Klemtonius: calls 350
juiceC2: folds 
*** FLOP *** [5h 4d 3c]
Klemtonius: checks 
Mafak2020: checks 
dhduncan: checks 
*** TURN *** [5h 4d 3c] [Kh]
Klemtonius: bets 1228
Mafak2020: folds 
dhduncan: folds 
Uncalled bet (1228) returned to Klemtonius
Klemtonius collected 1228 from pot
Klemtonius: doesn't show hand 
*** SUMMARY ***
Total pot 1300 | Rake 72 
Board [5h 4d 3c Kh]
Seat 1: color_singleton folded before Flop (didn't bet)
Seat 2: dhduncan folded on the Turn
Seat 3: PokerStarMan123 (button) folded before Flop (didn't bet)
Seat 4: Klemtonius (small blind) collected (1228)
Seat 6: juiceC2 (big blind) folded before Flop
Seat 7: Mafak2020 folded on the Turn
Seat 8: HighCardJasper folded before Flop (didn't bet)
Seat 9: manon327 folded before Flop (didn't bet)



PokerStars Home Game Hand #225607490294: {DaPokaStars}  Hold'em No Limit (50/100) - 2021/04/07 17:04:36 ET
Table 'agian and again' 9-max (Play Money) Seat #4 is the button
Seat 1: color_singleton (24593 in chips) 
Seat 2: dhduncan (3982 in chips) 
Seat 3: PokerStarMan123 (6539 in chips) 
Seat 4: Klemtonius (9779 in chips) 
Seat 6: juiceC2 (9236 in chips) 
Seat 7: Mafak2020 (37723 in chips) 
Seat 8: HighCardJasper (2493 in chips) 
Seat 9: manon327 (9185 in chips) 
juiceC2: posts small blind 50
Mafak2020: posts big blind 100
*** HOLE CARDS ***
Dealt to PokerStarMan123 [7c As]
HighCardJasper: folds 
manon327: calls 100
color_singleton has timed out
color_singleton: folds 
dhduncan: folds 
PokerStarMan123: calls 100
Klemtonius: raises 100 to 200
juiceC2: calls 150
Mafak2020: calls 100
manon327: calls 100
PokerStarMan123: calls 100
*** FLOP *** [2s 8d 2c]
juiceC2: checks 
Mafak2020: bets 400
manon327: folds 
PokerStarMan123: folds 
Klemtonius: calls 400
juiceC2: folds 
*** TURN *** [2s 8d 2c] [Ad]
Mafak2020: checks 
Klemtonius: checks 
*** RIVER *** [2s 8d 2c Ad] [5c]
Mafak2020: checks 
Klemtonius: bets 850
Mafak2020: raises 850 to 1700
Klemtonius: calls 850
*** SHOW DOWN ***
Mafak2020: shows [8h 8c] (a full house, Eights full of Deuces)
Klemtonius: mucks hand 
Mafak2020 collected 4914 from pot
*** SUMMARY ***
Total pot 5200 | Rake 286 
Board [2s 8d 2c Ad 5c]
Seat 1: color_singleton folded before Flop (didn't bet)
Seat 2: dhduncan folded before Flop (didn't bet)
Seat 3: PokerStarMan123 folded on the Flop
Seat 4: Klemtonius (button) mucked [Ac 3c]
Seat 6: juiceC2 (small blind) folded on the Flop
Seat 7: Mafak2020 (big blind) showed [8h 8c] and won (4914) with a full house, Eights full of Deuces
Seat 8: HighCardJasper folded before Flop (didn't bet)
Seat 9: manon327 folded on the Flop



PokerStars Home Game Hand #225607553379: {DaPokaStars}  Hold'em No Limit (50/100) - 2021/04/07 17:06:12 ET
Table 'agian and again' 9-max (Play Money) Seat #6 is the button
Seat 2: dhduncan (3982 in chips) 
Seat 3: PokerStarMan123 (6339 in chips) 
Seat 4: Klemtonius (7479 in chips) 
Seat 6: juiceC2 (9036 in chips) 
Seat 7: Mafak2020 (40337 in chips) 
Seat 8: HighCardJasper (2493 in chips) 
Seat 9: manon327 (8985 in chips) 
Mafak2020: posts small blind 50
HighCardJasper: posts big blind 100
*** HOLE CARDS ***
Dealt to PokerStarMan123 [4s 6s]
manon327: calls 100
dhduncan: calls 100
PokerStarMan123: calls 100
Klemtonius: calls 100
juiceC2: folds 
Mafak2020: calls 50
HighCardJasper: checks 
*** FLOP *** [7d 5c 6c]
Mafak2020: checks 
HighCardJasper: checks 
manon327: bets 283
dhduncan: calls 283
PokerStarMan123: calls 283
Klemtonius: folds 
Mafak2020: calls 283
HighCardJasper: calls 283
*** TURN *** [7d 5c 6c] [8d]
Mafak2020: checks 
HighCardJasper: bets 2110 and is all-in
manon327: folds 
dhduncan: folds 
PokerStarMan123: calls 2110
Mafak2020: folds 
*** RIVER *** [7d 5c 6c 8d] [Qc]
*** SHOW DOWN ***
HighCardJasper: shows [4h Ad] (a straight, Four to Eight)
PokerStarMan123: shows [4s 6s] (a straight, Four to Eight)
HighCardJasper collected 2946 from pot
PokerStarMan123 collected 2946 from pot
*** SUMMARY ***
Total pot 6235 | Rake 343 
Board [7d 5c 6c 8d Qc]
Seat 2: dhduncan folded on the Turn
Seat 3: PokerStarMan123 showed [4s 6s] and won (2946) with a straight, Four to Eight
Seat 4: Klemtonius folded on the Flop
Seat 6: juiceC2 (button) folded before Flop (didn't bet)
Seat 7: Mafak2020 (small blind) folded on the Turn
Seat 8: HighCardJasper (big blind) showed [4h Ad] and won (2946) with a straight, Four to Eight
Seat 9: manon327 folded on the Turn



PokerStars Home Game Hand #225607618768: {DaPokaStars}  Hold'em No Limit (50/100) - 2021/04/07 17:07:52 ET
Table 'agian and again' 9-max (Play Money) Seat #7 is the button
Seat 1: color_singleton (24593 in chips) 
Seat 2: dhduncan (3599 in chips) 
Seat 3: PokerStarMan123 (6792 in chips) 
Seat 4: Klemtonius (7379 in chips) 
Seat 6: juiceC2 (9036 in chips) 
Seat 7: Mafak2020 (39954 in chips) 
Seat 8: HighCardJasper (2946 in chips) 
Seat 9: manon327 (8602 in chips) 
HighCardJasper: posts small blind 50
manon327: posts big blind 100
*** HOLE CARDS ***
Dealt to PokerStarMan123 [3h Qc]
color_singleton: folds 
dhduncan: calls 100
PokerStarMan123: folds 
Klemtonius: raises 100 to 200
juiceC2: folds 
Mafak2020: folds 
HighCardJasper: folds 
manon327: calls 100
dhduncan: raises 100 to 300
Klemtonius: calls 100
manon327: calls 100
*** FLOP *** [5d 7c Kh]
manon327: checks 
dhduncan: bets 898
Klemtonius: folds 
manon327: folds 
Uncalled bet (898) returned to dhduncan
dhduncan collected 898 from pot
dhduncan: doesn't show hand 
*** SUMMARY ***
Total pot 950 | Rake 52 
Board [5d 7c Kh]
Seat 1: color_singleton folded before Flop (didn't bet)
Seat 2: dhduncan collected (898)
Seat 3: PokerStarMan123 folded before Flop (didn't bet)
Seat 4: Klemtonius folded on the Flop
Seat 6: juiceC2 folded before Flop (didn't bet)
Seat 7: Mafak2020 (button) folded before Flop (didn't bet)
Seat 8: HighCardJasper (small blind) folded before Flop
Seat 9: manon327 (big blind) folded on the Flop



PokerStars Home Game Hand #225607659126: {DaPokaStars}  Hold'em No Limit (50/100) - 2021/04/07 17:08:53 ET
Table 'agian and again' 9-max (Play Money) Seat #8 is the button
Seat 1: color_singleton (24593 in chips) 
Seat 2: dhduncan (4197 in chips) 
Seat 3: PokerStarMan123 (6792 in chips) 
Seat 4: Klemtonius (7079 in chips) 
Seat 6: juiceC2 (9036 in chips) 
Seat 7: Mafak2020 (39954 in chips) 
Seat 8: HighCardJasper (2896 in chips) 
Seat 9: manon327 (8302 in chips) 
manon327: posts small blind 50
color_singleton: posts big blind 100
*** HOLE CARDS ***
Dealt to PokerStarMan123 [3s 3c]
dhduncan: folds 
PokerStarMan123: raises 200 to 300
Klemtonius: calls 300
juiceC2: calls 300
Mafak2020: calls 300
HighCardJasper: calls 300
manon327: calls 250
color_singleton: calls 200
*** FLOP *** [Td 9h Kd]
manon327: checks 
color_singleton: checks 
PokerStarMan123: checks 
Klemtonius: checks 
juiceC2: checks 
Mafak2020: checks 
HighCardJasper: checks 
*** TURN *** [Td 9h Kd] [3h]
manon327: checks 
color_singleton: checks 
PokerStarMan123: bets 1000
Klemtonius: folds 
juiceC2: folds 
Mafak2020: folds 
HighCardJasper: folds 
manon327: folds 
color_singleton: folds 
Uncalled bet (1000) returned to PokerStarMan123
PokerStarMan123 collected 1984 from pot
*** SUMMARY ***
Total pot 2100 | Rake 116 
Board [Td 9h Kd 3h]
Seat 1: color_singleton (big blind) folded on the Turn
Seat 2: dhduncan folded before Flop (didn't bet)
Seat 3: PokerStarMan123 collected (1984)
Seat 4: Klemtonius folded on the Turn
Seat 6: juiceC2 folded on the Turn
Seat 7: Mafak2020 folded on the Turn
Seat 8: HighCardJasper (button) folded on the Turn
Seat 9: manon327 (small blind) folded on the Turn



PokerStars Home Game Hand #225607711541: {DaPokaStars}  Hold'em No Limit (50/100) - 2021/04/07 17:10:13 ET
Table 'agian and again' 9-max (Play Money) Seat #9 is the button
Seat 1: color_singleton (24293 in chips) 
Seat 2: dhduncan (4197 in chips) 
Seat 3: PokerStarMan123 (8476 in chips) 
Seat 4: Klemtonius (6779 in chips) 
Seat 6: juiceC2 (8736 in chips) 
Seat 7: Mafak2020 (39654 in chips) 
Seat 8: HighCardJasper (2596 in chips) 
Seat 9: manon327 (8002 in chips) 
color_singleton: posts small blind 50
dhduncan: posts big blind 100
*** HOLE CARDS ***
Dealt to PokerStarMan123 [5d Qs]
PokerStarMan123: folds 
Klemtonius: folds 
juiceC2: folds 
Mafak2020: raises 100 to 200
HighCardJasper: calls 200
manon327: folds 
color_singleton: calls 150
dhduncan: calls 100
*** FLOP *** [9d 6d Kc]
color_singleton: checks 
dhduncan: checks 
Mafak2020: checks 
HighCardJasper: bets 200
color_singleton: folds 
dhduncan: calls 200
Mafak2020: calls 200
*** TURN *** [9d 6d Kc] [Ks]
dhduncan: checks 
Mafak2020: checks 
HighCardJasper: bets 200
dhduncan: folds 
Mafak2020: calls 200
*** RIVER *** [9d 6d Kc Ks] [6s]
Mafak2020: checks 
HighCardJasper: bets 1996 and is all-in
Mafak2020: folds 
Uncalled bet (1996) returned to HighCardJasper
HighCardJasper collected 1701 from pot
HighCardJasper: doesn't show hand 
*** SUMMARY ***
Total pot 1800 | Rake 99 
Board [9d 6d Kc Ks 6s]
Seat 1: color_singleton (small blind) folded on the Flop
Seat 2: dhduncan (big blind) folded on the Turn
Seat 3: PokerStarMan123 folded before Flop (didn't bet)
Seat 4: Klemtonius folded before Flop (didn't bet)
Seat 6: juiceC2 folded before Flop (didn't bet)
Seat 7: Mafak2020 folded on the River
Seat 8: HighCardJasper collected (1701)
Seat 9: manon327 (button) folded before Flop (didn't bet)



PokerStars Home Game Hand #225607762837: {DaPokaStars}  Hold'em No Limit (50/100) - 2021/04/07 17:11:31 ET
Table 'agian and again' 9-max (Play Money) Seat #1 is the button
Seat 1: color_singleton (24093 in chips) 
Seat 2: dhduncan (3797 in chips) 
Seat 3: PokerStarMan123 (8476 in chips) 
Seat 4: Klemtonius (6779 in chips) 
Seat 6: juiceC2 (8736 in chips) 
Seat 7: Mafak2020 (39054 in chips) 
Seat 8: HighCardJasper (3697 in chips) 
Seat 9: manon327 (8002 in chips) 
dhduncan: posts small blind 50
PokerStarMan123: posts big blind 100
*** HOLE CARDS ***
Dealt to PokerStarMan123 [4c 2s]
Klemtonius: folds 
juiceC2: calls 100
Mafak2020: folds 
HighCardJasper: folds 
manon327: folds 
color_singleton: folds 
dhduncan: calls 50
PokerStarMan123: checks 
*** FLOP *** [Td 7h 7c]
dhduncan: checks 
PokerStarMan123: checks 
juiceC2: bets 141
dhduncan: folds 
PokerStarMan123: folds 
Uncalled bet (141) returned to juiceC2
juiceC2 collected 283 from pot
juiceC2: doesn't show hand 
*** SUMMARY ***
Total pot 300 | Rake 17 
Board [Td 7h 7c]
Seat 1: color_singleton (button) folded before Flop (didn't bet)
Seat 2: dhduncan (small blind) folded on the Flop
Seat 3: PokerStarMan123 (big blind) folded on the Flop
Seat 4: Klemtonius folded before Flop (didn't bet)
Seat 6: juiceC2 collected (283)
Seat 7: Mafak2020 folded before Flop (didn't bet)
Seat 8: HighCardJasper folded before Flop (didn't bet)
Seat 9: manon327 folded before Flop (didn't bet)



PokerStars Home Game Hand #225607790203: {DaPokaStars}  Hold'em No Limit (50/100) - 2021/04/07 17:12:12 ET
Table 'agian and again' 9-max (Play Money) Seat #2 is the button
Seat 1: color_singleton (24093 in chips) 
Seat 2: dhduncan (3697 in chips) 
Seat 3: PokerStarMan123 (8376 in chips) 
Seat 4: Klemtonius (6779 in chips) 
Seat 6: juiceC2 (8919 in chips) 
Seat 7: Mafak2020 (39054 in chips) 
Seat 8: HighCardJasper (3697 in chips) 
Seat 9: manon327 (8002 in chips) 
PokerStarMan123: posts small blind 50
Klemtonius: posts big blind 100
*** HOLE CARDS ***
Dealt to PokerStarMan123 [9h 5h]
juiceC2: calls 100
Mafak2020: raises 100 to 200
HighCardJasper: calls 200
manon327: folds 
color_singleton: folds 
dhduncan: folds 
PokerStarMan123: folds 
Klemtonius: calls 100
juiceC2: calls 100
*** FLOP *** [Jd Kc 2s]
Klemtonius: checks 
juiceC2: checks 
Mafak2020: bets 800
HighCardJasper: folds 
Klemtonius: folds 
juiceC2: calls 800
*** TURN *** [Jd Kc 2s] [4c]
juiceC2: checks 
Mafak2020: bets 800
juiceC2: calls 800
*** RIVER *** [Jd Kc 2s 4c] [3s]
juiceC2: checks 
Mafak2020: checks 
*** SHOW DOWN ***
juiceC2: shows [6h Ks] (a pair of Kings)
Mafak2020: shows [Qh Kh] (a pair of Kings - Queen kicker)
Mafak2020 collected 3827 from pot
*** SUMMARY ***
Total pot 4050 | Rake 223 
Board [Jd Kc 2s 4c 3s]
Seat 1: color_singleton folded before Flop (didn't bet)
Seat 2: dhduncan (button) folded before Flop (didn't bet)
Seat 3: PokerStarMan123 (small blind) folded before Flop
Seat 4: Klemtonius (big blind) folded on the Flop
Seat 6: juiceC2 showed [6h Ks] and lost with a pair of Kings
Seat 7: Mafak2020 showed [Qh Kh] and won (3827) with a pair of Kings
Seat 8: HighCardJasper folded on the Flop
Seat 9: manon327 folded before Flop (didn't bet)



PokerStars Home Game Hand #225607828965: {DaPokaStars}  Hold'em No Limit (50/100) - 2021/04/07 17:13:11 ET
Table 'agian and again' 9-max (Play Money) Seat #3 is the button
Seat 1: color_singleton (24093 in chips) 
Seat 2: dhduncan (3697 in chips) 
Seat 3: PokerStarMan123 (8326 in chips) 
Seat 4: Klemtonius (6579 in chips) 
Seat 6: juiceC2 (7119 in chips) 
Seat 7: Mafak2020 (41081 in chips) 
Seat 8: HighCardJasper (3497 in chips) 
Seat 9: manon327 (8002 in chips) 
Klemtonius: posts small blind 50
juiceC2: posts big blind 100
*** HOLE CARDS ***
Dealt to PokerStarMan123 [9s Ah]
Mafak2020: folds 
HighCardJasper: calls 100
manon327: calls 100
color_singleton: raises 200 to 300
dhduncan: folds 
PokerStarMan123: calls 300
Klemtonius: calls 250
juiceC2: calls 200
HighCardJasper: folds 
manon327: calls 200
*** FLOP *** [3s Js 8s]
Klemtonius: bets 100
juiceC2: folds 
manon327: folds 
color_singleton: calls 100
PokerStarMan123: calls 100
*** TURN *** [3s Js 8s] [Qc]
Klemtonius: checks 
color_singleton: checks 
PokerStarMan123: checks 
*** RIVER *** [3s Js 8s Qc] [Ad]
Klemtonius: checks 
color_singleton: checks 
PokerStarMan123: bets 700
Klemtonius: folds 
color_singleton: folds 
Uncalled bet (700) returned to PokerStarMan123
PokerStarMan123 collected 1795 from pot
*** SUMMARY ***
Total pot 1900 | Rake 105 
Board [3s Js 8s Qc Ad]
Seat 1: color_singleton folded on the River
Seat 2: dhduncan folded before Flop (didn't bet)
Seat 3: PokerStarMan123 (button) collected (1795)
Seat 4: Klemtonius (small blind) folded on the River
Seat 6: juiceC2 (big blind) folded on the Flop
Seat 7: Mafak2020 folded before Flop (didn't bet)
Seat 8: HighCardJasper folded before Flop
Seat 9: manon327 folded on the Flop



PokerStars Home Game Hand #225607875234: {DaPokaStars}  Hold'em No Limit (50/100) - 2021/04/07 17:14:22 ET
Table 'agian and again' 9-max (Play Money) Seat #4 is the button
Seat 1: color_singleton (23693 in chips) 
Seat 2: dhduncan (3697 in chips) 
Seat 3: PokerStarMan123 (9721 in chips) 
Seat 4: Klemtonius (6179 in chips) 
Seat 6: juiceC2 (6819 in chips) 
Seat 7: Mafak2020 (41081 in chips) 
Seat 8: HighCardJasper (3397 in chips) 
Seat 9: manon327 (7702 in chips) 
juiceC2: posts small blind 50
Mafak2020: posts big blind 100
*** HOLE CARDS ***
Dealt to PokerStarMan123 [6h 8h]
HighCardJasper: calls 100
manon327: folds 
color_singleton: calls 100
dhduncan: calls 100
PokerStarMan123: calls 100
Klemtonius: calls 100
juiceC2: calls 50
Mafak2020: checks 
*** FLOP *** [7s 2d Tc]
juiceC2: checks 
Mafak2020: checks 
HighCardJasper: checks 
color_singleton: checks 
dhduncan: checks 
PokerStarMan123: checks 
Klemtonius: checks 
*** TURN *** [7s 2d Tc] [As]
juiceC2: checks 
Mafak2020: checks 
HighCardJasper: bets 200
color_singleton: folds 
dhduncan: folds 
PokerStarMan123: folds 
Klemtonius: calls 200
juiceC2: folds 
Mafak2020: calls 200
*** RIVER *** [7s 2d Tc As] [Ks]
Mafak2020: bets 500
HighCardJasper: raises 2228 to 2728
Klemtonius: folds 
Mafak2020: raises 2228 to 4956
HighCardJasper: calls 369 and is all-in
Uncalled bet (1859) returned to Mafak2020
*** SHOW DOWN ***
Mafak2020: shows [2s 9s] (a flush, Ace high)
HighCardJasper: shows [4s 5s] (a flush, Ace high - lower cards)
Mafak2020 collected 7082 from pot
*** SUMMARY ***
Total pot 7494 | Rake 412 
Board [7s 2d Tc As Ks]
Seat 1: color_singleton folded on the Turn
Seat 2: dhduncan folded on the Turn
Seat 3: PokerStarMan123 folded on the Turn
Seat 4: Klemtonius (button) folded on the River
Seat 6: juiceC2 (small blind) folded on the Turn
Seat 7: Mafak2020 (big blind) showed [2s 9s] and won (7082) with a flush, Ace high
Seat 8: HighCardJasper showed [4s 5s] and lost with a flush, Ace high
Seat 9: manon327 folded before Flop (didn't bet)



PokerStars Home Game Hand #225607957210: {DaPokaStars}  Hold'em No Limit (50/100) - 2021/04/07 17:16:28 ET
Table 'agian and again' 9-max (Play Money) Seat #6 is the button
Seat 1: color_singleton (23593 in chips) 
Seat 2: dhduncan (3597 in chips) 
Seat 3: PokerStarMan123 (9621 in chips) 
Seat 4: Klemtonius (5879 in chips) 
Seat 6: juiceC2 (6719 in chips) 
Seat 7: Mafak2020 (44766 in chips) 
Seat 9: manon327 (7702 in chips) 
Mafak2020: posts small blind 50
manon327: posts big blind 100
*** HOLE CARDS ***
Dealt to PokerStarMan123 [8d Ah]
color_singleton: raises 100 to 200
dhduncan: folds 
PokerStarMan123: calls 200
Klemtonius: calls 200
juiceC2: folds 
Mafak2020: folds 
manon327: calls 100
*** FLOP *** [7c 6c 3d]
manon327: checks 
color_singleton: bets 401
PokerStarMan123: calls 401
Klemtonius: folds 
manon327: calls 401
*** TURN *** [7c 6c 3d] [Qd]
manon327: checks 
color_singleton: bets 970
PokerStarMan123: folds 
manon327: folds 
Uncalled bet (970) returned to color_singleton
color_singleton collected 1940 from pot
color_singleton: doesn't show hand 
*** SUMMARY ***
Total pot 2053 | Rake 113 
Board [7c 6c 3d Qd]
Seat 1: color_singleton collected (1940)
Seat 2: dhduncan folded before Flop (didn't bet)
Seat 3: PokerStarMan123 folded on the Turn
Seat 4: Klemtonius folded on the Flop
Seat 6: juiceC2 (button) folded before Flop (didn't bet)
Seat 7: Mafak2020 (small blind) folded before Flop
Seat 9: manon327 (big blind) folded on the Turn



PokerStars Home Game Hand #225607990024: {DaPokaStars}  Hold'em No Limit (50/100) - 2021/04/07 17:17:19 ET
Table 'agian and again' 9-max (Play Money) Seat #7 is the button
Seat 1: color_singleton (24932 in chips) 
Seat 2: dhduncan (3597 in chips) 
Seat 3: PokerStarMan123 (9020 in chips) 
Seat 4: Klemtonius (5679 in chips) 
Seat 6: juiceC2 (6719 in chips) 
Seat 7: Mafak2020 (44716 in chips) 
Seat 9: manon327 (7101 in chips) 
manon327: posts small blind 50
color_singleton: posts big blind 100
*** HOLE CARDS ***
Dealt to PokerStarMan123 [6d 4c]
dhduncan: calls 100
PokerStarMan123: calls 100
Klemtonius: calls 100
juiceC2: folds 
Mafak2020: calls 100
manon327: calls 50
color_singleton: checks 
*** FLOP *** [Ks Qc Kh]
manon327: checks 
color_singleton: bets 283
dhduncan: folds 
PokerStarMan123: folds 
Klemtonius: folds 
Mafak2020: folds 
manon327: calls 283
*** TURN *** [Ks Qc Kh] [7h]
manon327: checks 
color_singleton: bets 551
manon327: folds 
Uncalled bet (551) returned to color_singleton
color_singleton collected 1102 from pot
color_singleton: doesn't show hand 
*** SUMMARY ***
Total pot 1166 | Rake 64 
Board [Ks Qc Kh 7h]
Seat 1: color_singleton (big blind) collected (1102)
Seat 2: dhduncan folded on the Flop
Seat 3: PokerStarMan123 folded on the Flop
Seat 4: Klemtonius folded on the Flop
Seat 6: juiceC2 folded before Flop (didn't bet)
Seat 7: Mafak2020 (button) folded on the Flop
Seat 9: manon327 (small blind) folded on the Turn



PokerStars Home Game Hand #225608023478: {DaPokaStars}  Hold'em No Limit (50/100) - 2021/04/07 17:18:10 ET
Table 'agian and again' 9-max (Play Money) Seat #9 is the button
Seat 1: color_singleton (25651 in chips) 
Seat 2: dhduncan (3497 in chips) 
Seat 3: PokerStarMan123 (8920 in chips) 
Seat 4: Klemtonius (5579 in chips) 
Seat 6: juiceC2 (6719 in chips) 
Seat 7: Mafak2020 (44616 in chips) 
Seat 8: HighCardJasper (10000 in chips) 
Seat 9: manon327 (6718 in chips) 
color_singleton: posts small blind 50
dhduncan: posts big blind 100
HighCardJasper: posts small & big blinds 150
*** HOLE CARDS ***
Dealt to PokerStarMan123 [Kh 5s]
PokerStarMan123: folds 
Klemtonius: raises 100 to 200
juiceC2: calls 200
Mafak2020: calls 200
HighCardJasper: raises 100 to 300
manon327: folds 
color_singleton: folds 
dhduncan: calls 200
Klemtonius: calls 100
juiceC2: calls 100
Mafak2020: calls 100
*** FLOP *** [Qc 9s Qs]
dhduncan: checks 
Klemtonius: checks 
juiceC2: checks 
Mafak2020: checks 
HighCardJasper: checks 
*** TURN *** [Qc 9s Qs] [Qh]
dhduncan: checks 
Klemtonius: checks 
juiceC2: checks 
Mafak2020: checks 
HighCardJasper: bets 756
dhduncan: calls 756
Klemtonius: folds 
juiceC2: calls 756
Mafak2020: folds 
*** RIVER *** [Qc 9s Qs Qh] [4d]
dhduncan: bets 2441 and is all-in
juiceC2: folds 
HighCardJasper: calls 2441
*** SHOW DOWN ***
dhduncan: shows [9h 3h] (a full house, Queens full of Nines)
HighCardJasper: shows [Jc Jh] (a full house, Queens full of Jacks)
HighCardJasper collected 8269 from pot
*** SUMMARY ***
Total pot 8750 | Rake 481 
Board [Qc 9s Qs Qh 4d]
Seat 1: color_singleton (small blind) folded before Flop
Seat 2: dhduncan (big blind) showed [9h 3h] and lost with a full house, Queens full of Nines
Seat 3: PokerStarMan123 folded before Flop (didn't bet)
Seat 4: Klemtonius folded on the Turn
Seat 6: juiceC2 folded on the River
Seat 7: Mafak2020 folded on the Turn
Seat 8: HighCardJasper showed [Jc Jh] and won (8269) with a full house, Queens full of Jacks
Seat 9: manon327 (button) folded before Flop (didn't bet)



PokerStars Home Game Hand #225608096647: {DaPokaStars}  Hold'em No Limit (50/100) - 2021/04/07 17:20:04 ET
Table 'agian and again' 9-max (Play Money) Seat #1 is the button
Seat 1: color_singleton (25601 in chips) 
Seat 3: PokerStarMan123 (8920 in chips) 
Seat 4: Klemtonius (5279 in chips) 
Seat 6: juiceC2 (5663 in chips) 
Seat 7: Mafak2020 (44316 in chips) 
Seat 8: HighCardJasper (14722 in chips) 
Seat 9: manon327 (6718 in chips) 
PokerStarMan123: posts small blind 50
Klemtonius: posts big blind 100
*** HOLE CARDS ***
Dealt to PokerStarMan123 [Js 3h]
juiceC2: calls 100
Mafak2020: folds 
HighCardJasper: raises 200 to 300
manon327: folds 
color_singleton: calls 300
PokerStarMan123: folds 
Klemtonius: calls 200
juiceC2: calls 200
*** FLOP *** [5s Ac 8c]
Klemtonius: bets 100
juiceC2: calls 100
HighCardJasper: raises 1200 to 1300
color_singleton: folds 
Klemtonius: folds 
juiceC2: folds 
Uncalled bet (1200) returned to HighCardJasper
HighCardJasper collected 1465 from pot
HighCardJasper: doesn't show hand 
*** SUMMARY ***
Total pot 1550 | Rake 85 
Board [5s Ac 8c]
Seat 1: color_singleton (button) folded on the Flop
Seat 3: PokerStarMan123 (small blind) folded before Flop
Seat 4: Klemtonius (big blind) folded on the Flop
Seat 6: juiceC2 folded on the Flop
Seat 7: Mafak2020 folded before Flop (didn't bet)
Seat 8: HighCardJasper collected (1465)
Seat 9: manon327 folded before Flop (didn't bet)



PokerStars Home Game Hand #225608151778: {DaPokaStars}  Hold'em No Limit (50/100) - 2021/04/07 17:21:29 ET
Table 'agian and again' 9-max (Play Money) Seat #3 is the button
Seat 1: color_singleton (25301 in chips) 
Seat 2: dhduncan (10000 in chips) 
Seat 3: PokerStarMan123 (8870 in chips) 
Seat 4: Klemtonius (4879 in chips) 
Seat 6: juiceC2 (5263 in chips) 
Seat 7: Mafak2020 (44316 in chips) 
Seat 8: HighCardJasper (15787 in chips) 
Seat 9: manon327 (6718 in chips) 
Klemtonius: posts small blind 50
juiceC2: posts big blind 100
dhduncan: posts small blind 50
*** HOLE CARDS ***
Dealt to PokerStarMan123 [5h 9s]
Mafak2020: raises 200 to 300
HighCardJasper: folds 
manon327: folds 
color_singleton: folds 
dhduncan: calls 300
PokerStarMan123: folds 
Klemtonius: calls 250
juiceC2: calls 200
*** FLOP *** [2d 4c Qd]
Klemtonius: checks 
juiceC2: checks 
Mafak2020: bets 600
dhduncan: calls 600
Klemtonius: folds 
juiceC2: calls 600
*** TURN *** [2d 4c Qd] [8c]
juiceC2: checks 
Mafak2020: bets 900
dhduncan: calls 900
juiceC2: calls 900
*** RIVER *** [2d 4c Qd 8c] [4d]
juiceC2: checks 
Mafak2020: checks 
dhduncan: bets 5434
juiceC2: folds 
Mafak2020: folds 
Uncalled bet (5434) returned to dhduncan
dhduncan collected 5434 from pot
dhduncan: doesn't show hand 
*** SUMMARY ***
Total pot 5750 | Rake 316 
Board [2d 4c Qd 8c 4d]
Seat 1: color_singleton folded before Flop (didn't bet)
Seat 2: dhduncan collected (5434)
Seat 3: PokerStarMan123 (button) folded before Flop (didn't bet)
Seat 4: Klemtonius (small blind) folded on the Flop
Seat 6: juiceC2 (big blind) folded on the River
Seat 7: Mafak2020 folded on the River
Seat 8: HighCardJasper folded before Flop (didn't bet)
Seat 9: manon327 folded before Flop (didn't bet)



PokerStars Home Game Hand #225608214662: {DaPokaStars}  Hold'em No Limit (50/100) - 2021/04/07 17:23:08 ET
Table 'agian and again' 9-max (Play Money) Seat #4 is the button
Seat 1: color_singleton (25301 in chips) 
Seat 2: dhduncan (13584 in chips) 
Seat 3: PokerStarMan123 (8870 in chips) 
Seat 4: Klemtonius (4579 in chips) 
Seat 6: juiceC2 (3463 in chips) 
Seat 7: Mafak2020 (42516 in chips) 
Seat 8: HighCardJasper (15787 in chips) 
Seat 9: manon327 (6718 in chips) 
juiceC2: posts small blind 50
Mafak2020: posts big blind 100
*** HOLE CARDS ***
Dealt to PokerStarMan123 [Jh 9s]
HighCardJasper: folds 
manon327: folds 
color_singleton: folds 
dhduncan: calls 100
PokerStarMan123: calls 100
Klemtonius: calls 100
juiceC2: calls 50
Mafak2020: checks 
*** FLOP *** [8s 7s 6c]
juiceC2: checks 
Mafak2020: checks 
dhduncan: bets 100
PokerStarMan123: raises 100 to 200
Klemtonius: calls 200
juiceC2: calls 200
Mafak2020: calls 200
dhduncan: calls 100
*** TURN *** [8s 7s 6c] [3h]
juiceC2: checks 
Mafak2020: checks 
dhduncan: checks 
PokerStarMan123: checks 
Klemtonius: checks 
*** RIVER *** [8s 7s 6c 3h] [3d]
juiceC2: checks 
Mafak2020: checks 
dhduncan: checks 
PokerStarMan123: checks 
Klemtonius: checks 
*** SHOW DOWN ***
juiceC2: shows [7c Qc] (two pair, Sevens and Threes)
Mafak2020: shows [Th 8c] (two pair, Eights and Threes)
dhduncan: mucks hand 
PokerStarMan123: mucks hand 
Klemtonius: mucks hand 
Mafak2020 collected 1417 from pot
*** SUMMARY ***
Total pot 1500 | Rake 83 
Board [8s 7s 6c 3h 3d]
Seat 1: color_singleton folded before Flop (didn't bet)
Seat 2: dhduncan mucked [Qs As]
Seat 3: PokerStarMan123 mucked [Jh 9s]
Seat 4: Klemtonius (button) mucked [4c Jd]
Seat 6: juiceC2 (small blind) showed [7c Qc] and lost with two pair, Sevens and Threes
Seat 7: Mafak2020 (big blind) showed [Th 8c] and won (1417) with two pair, Eights and Threes
Seat 8: HighCardJasper folded before Flop (didn't bet)
Seat 9: manon327 folded before Flop (didn't bet)



PokerStars Home Game Hand #225608282296: {DaPokaStars}  Hold'em No Limit (50/100) - 2021/04/07 17:24:49 ET
Table 'agian and again' 9-max (Play Money) Seat #6 is the button
Seat 1: color_singleton (25301 in chips) 
Seat 2: dhduncan (13284 in chips) 
Seat 3: PokerStarMan123 (8570 in chips) 
Seat 4: Klemtonius (4279 in chips) 
Seat 6: juiceC2 (3163 in chips) 
Seat 7: Mafak2020 (43633 in chips) 
Seat 8: HighCardJasper (15787 in chips) 
Seat 9: manon327 (6718 in chips) 
Mafak2020: posts small blind 50
HighCardJasper: posts big blind 100
*** HOLE CARDS ***
Dealt to PokerStarMan123 [4h 4c]
manon327: calls 100
color_singleton: calls 100
dhduncan: folds 
PokerStarMan123: raises 300 to 400
Klemtonius: calls 400
juiceC2: folds 
Mafak2020: calls 350
HighCardJasper: calls 300
manon327: folds 
color_singleton: calls 300
*** FLOP *** [Js 3d 5s]
Mafak2020: checks 
HighCardJasper: checks 
color_singleton: checks 
PokerStarMan123: bets 600
Klemtonius: calls 600
Mafak2020: folds 
HighCardJasper: folds 
color_singleton: folds 
*** TURN *** [Js 3d 5s] [9c]
PokerStarMan123: bets 1300
Klemtonius: folds 
Uncalled bet (1300) returned to PokerStarMan123
PokerStarMan123 collected 3118 from pot
*** SUMMARY ***
Total pot 3300 | Rake 182 
Board [Js 3d 5s 9c]
Seat 1: color_singleton folded on the Flop
Seat 2: dhduncan folded before Flop (didn't bet)
Seat 3: PokerStarMan123 collected (3118)
Seat 4: Klemtonius folded on the Turn
Seat 6: juiceC2 (button) folded before Flop (didn't bet)
Seat 7: Mafak2020 (small blind) folded on the Flop
Seat 8: HighCardJasper (big blind) folded on the Flop
Seat 9: manon327 folded before Flop



PokerStars Home Game Hand #225608340312: {DaPokaStars}  Hold'em No Limit (50/100) - 2021/04/07 17:26:20 ET
Table 'agian and again' 9-max (Play Money) Seat #7 is the button
Seat 1: color_singleton (24901 in chips) 
Seat 2: dhduncan (13284 in chips) 
Seat 3: PokerStarMan123 (10688 in chips) 
Seat 4: Klemtonius (3279 in chips) 
Seat 6: juiceC2 (3163 in chips) 
Seat 7: Mafak2020 (43233 in chips) 
Seat 8: HighCardJasper (15387 in chips) 
Seat 9: manon327 (6618 in chips) 
HighCardJasper: posts small blind 50
manon327: posts big blind 100
*** HOLE CARDS ***
Dealt to PokerStarMan123 [5d 5h]
color_singleton: folds 
dhduncan: folds 
PokerStarMan123: raises 300 to 400
Klemtonius: calls 400
juiceC2: calls 400
Mafak2020: calls 400
HighCardJasper: folds 
manon327: calls 300
*** FLOP *** [Js 2d 6s]
manon327: checks 
PokerStarMan123: checks 
Klemtonius: checks 
juiceC2: checks 
Mafak2020: checks 
*** TURN *** [Js 2d 6s] [6d]
manon327: checks 
PokerStarMan123: bets 1000
Klemtonius: folds 
juiceC2: folds 
Mafak2020: folds 
manon327: folds 
Uncalled bet (1000) returned to PokerStarMan123
PokerStarMan123 collected 1937 from pot
*** SUMMARY ***
Total pot 2050 | Rake 113 
Board [Js 2d 6s 6d]
Seat 1: color_singleton folded before Flop (didn't bet)
Seat 2: dhduncan folded before Flop (didn't bet)
Seat 3: PokerStarMan123 collected (1937)
Seat 4: Klemtonius folded on the Turn
Seat 6: juiceC2 folded on the Turn
Seat 7: Mafak2020 (button) folded on the Turn
Seat 8: HighCardJasper (small blind) folded before Flop
Seat 9: manon327 (big blind) folded on the Turn



PokerStars Home Game Hand #225608386382: {DaPokaStars}  Hold'em No Limit (50/100) - 2021/04/07 17:27:33 ET
Table 'agian and again' 9-max (Play Money) Seat #8 is the button
Seat 1: color_singleton (24901 in chips) 
Seat 2: dhduncan (13284 in chips) 
Seat 3: PokerStarMan123 (12225 in chips) 
Seat 4: Klemtonius (2879 in chips) 
Seat 6: juiceC2 (2763 in chips) 
Seat 7: Mafak2020 (42833 in chips) 
Seat 8: HighCardJasper (15337 in chips) 
Seat 9: manon327 (6218 in chips) 
manon327: posts small blind 50
color_singleton: posts big blind 100
*** HOLE CARDS ***
Dealt to PokerStarMan123 [9h Kh]
dhduncan: calls 100
PokerStarMan123: calls 100
Klemtonius: folds 
juiceC2: folds 
Mafak2020: calls 100
HighCardJasper: raises 100 to 200
manon327: folds 
color_singleton: calls 100
dhduncan: calls 100
PokerStarMan123: calls 100
Mafak2020: calls 100
*** FLOP *** [Ad As 3d]
color_singleton: checks 
dhduncan: checks 
PokerStarMan123: checks 
Mafak2020: bets 500
HighCardJasper: folds 
color_singleton: calls 500
dhduncan: calls 500
PokerStarMan123: folds 
*** TURN *** [Ad As 3d] [7c]
color_singleton: checks 
dhduncan: checks 
Mafak2020: checks 
*** RIVER *** [Ad As 3d 7c] [7h]
color_singleton: checks 
dhduncan: bets 400
Mafak2020: folds 
color_singleton: folds 
Uncalled bet (400) returned to dhduncan
dhduncan collected 2410 from pot
dhduncan: doesn't show hand 
*** SUMMARY ***
Total pot 2550 | Rake 140 
Board [Ad As 3d 7c 7h]
Seat 1: color_singleton (big blind) folded on the River
Seat 2: dhduncan collected (2410)
Seat 3: PokerStarMan123 folded on the Flop
Seat 4: Klemtonius folded before Flop (didn't bet)
Seat 6: juiceC2 folded before Flop (didn't bet)
Seat 7: Mafak2020 folded on the River
Seat 8: HighCardJasper (button) folded on the Flop
Seat 9: manon327 (small blind) folded before Flop



PokerStars Home Game Hand #225608462482: {DaPokaStars}  Hold'em No Limit (50/100) - 2021/04/07 17:29:12 ET
Table 'agian and again' 9-max (Play Money) Seat #9 is the button
Seat 1: color_singleton (24201 in chips) 
Seat 2: dhduncan (14994 in chips) 
Seat 3: PokerStarMan123 (12025 in chips) 
Seat 4: Klemtonius (2879 in chips) 
Seat 6: juiceC2 (2763 in chips) 
Seat 7: Mafak2020 (42133 in chips) 
Seat 8: HighCardJasper (15137 in chips) 
Seat 9: manon327 (6168 in chips) 
color_singleton: posts small blind 50
dhduncan: posts big blind 100
*** HOLE CARDS ***
Dealt to PokerStarMan123 [5d 4d]
PokerStarMan123: calls 100
Klemtonius: folds 
juiceC2: calls 100
Mafak2020: calls 100
HighCardJasper: calls 100
manon327: calls 100
color_singleton: calls 50
dhduncan: checks 
*** FLOP *** [6h Jd 7h]
color_singleton: checks 
dhduncan: checks 
PokerStarMan123: bets 400
juiceC2: calls 400
Mafak2020: calls 400
HighCardJasper: folds 
manon327: folds 
color_singleton: folds 
dhduncan: folds 
*** TURN *** [6h Jd 7h] [7c]
PokerStarMan123: bets 1000
juiceC2: calls 1000
Mafak2020: calls 1000
*** RIVER *** [6h Jd 7h 7c] [Td]
PokerStarMan123: checks 
juiceC2: checks 
Mafak2020: bets 1300
PokerStarMan123: folds 
juiceC2: folds 
Uncalled bet (1300) returned to Mafak2020
Mafak2020 collected 4630 from pot
Mafak2020: doesn't show hand 
*** SUMMARY ***
Total pot 4900 | Rake 270 
Board [6h Jd 7h 7c Td]
Seat 1: color_singleton (small blind) folded on the Flop
Seat 2: dhduncan (big blind) folded on the Flop
Seat 3: PokerStarMan123 folded on the River
Seat 4: Klemtonius folded before Flop (didn't bet)
Seat 6: juiceC2 folded on the River
Seat 7: Mafak2020 collected (4630)
Seat 8: HighCardJasper folded on the Flop
Seat 9: manon327 (button) folded on the Flop



PokerStars Home Game Hand #225608522218: {DaPokaStars}  Hold'em No Limit (50/100) - 2021/04/07 17:30:48 ET
Table 'agian and again' 9-max (Play Money) Seat #1 is the button
Seat 1: color_singleton (24101 in chips) 
Seat 2: dhduncan (14894 in chips) 
Seat 3: PokerStarMan123 (10525 in chips) 
Seat 4: Klemtonius (2879 in chips) 
Seat 6: juiceC2 (1263 in chips) 
Seat 7: Mafak2020 (45263 in chips) 
Seat 8: HighCardJasper (15037 in chips) 
Seat 9: manon327 (6068 in chips) 
dhduncan: posts small blind 50
PokerStarMan123: posts big blind 100
*** HOLE CARDS ***
Dealt to PokerStarMan123 [5h Ad]
Klemtonius: folds 
juiceC2: folds 
Mafak2020: calls 100
HighCardJasper: calls 100
manon327: calls 100
color_singleton: folds 
dhduncan: folds 
PokerStarMan123: checks 
*** FLOP *** [8c 4c 2c]
PokerStarMan123: checks 
Mafak2020: checks 
HighCardJasper: checks 
manon327: bets 100
PokerStarMan123: folds 
Mafak2020: folds 
HighCardJasper: calls 100
*** TURN *** [8c 4c 2c] [7d]
HighCardJasper: checks 
manon327: bets 307
HighCardJasper: folds 
Uncalled bet (307) returned to manon327
manon327 collected 614 from pot
*** SUMMARY ***
Total pot 650 | Rake 36 
Board [8c 4c 2c 7d]
Seat 1: color_singleton (button) folded before Flop (didn't bet)
Seat 2: dhduncan (small blind) folded before Flop
Seat 3: PokerStarMan123 (big blind) folded on the Flop
Seat 4: Klemtonius folded before Flop (didn't bet)
Seat 6: juiceC2 folded before Flop (didn't bet)
Seat 7: Mafak2020 folded on the Flop
Seat 8: HighCardJasper folded on the Turn
Seat 9: manon327 collected (614)



PokerStars Home Game Hand #225608551232: {DaPokaStars}  Hold'em No Limit (50/100) - 2021/04/07 17:31:34 ET
Table 'agian and again' 9-max (Play Money) Seat #2 is the button
Seat 1: color_singleton (24101 in chips) 
Seat 2: dhduncan (14844 in chips) 
Seat 3: PokerStarMan123 (10425 in chips) 
Seat 4: Klemtonius (2879 in chips) 
Seat 6: juiceC2 (1263 in chips) 
Seat 7: Mafak2020 (45163 in chips) 
Seat 8: HighCardJasper (14837 in chips) 
Seat 9: manon327 (6482 in chips) 
PokerStarMan123: posts small blind 50
Klemtonius: posts big blind 100
*** HOLE CARDS ***
Dealt to PokerStarMan123 [5c 2s]
juiceC2: folds 
Mafak2020: calls 100
HighCardJasper: folds 
manon327: folds 
color_singleton: folds 
dhduncan: calls 100
PokerStarMan123: calls 50
Klemtonius: checks 
*** FLOP *** [4d Qc 6s]
PokerStarMan123: checks 
Klemtonius: checks 
Mafak2020: bets 200
dhduncan: folds 
PokerStarMan123: folds 
Klemtonius: folds 
Uncalled bet (200) returned to Mafak2020
Mafak2020 collected 378 from pot
Mafak2020: doesn't show hand 
*** SUMMARY ***
Total pot 400 | Rake 22 
Board [4d Qc 6s]
Seat 1: color_singleton folded before Flop (didn't bet)
Seat 2: dhduncan (button) folded on the Flop
Seat 3: PokerStarMan123 (small blind) folded on the Flop
Seat 4: Klemtonius (big blind) folded on the Flop
Seat 6: juiceC2 folded before Flop (didn't bet)
Seat 7: Mafak2020 collected (378)
Seat 8: HighCardJasper folded before Flop (didn't bet)
Seat 9: manon327 folded before Flop (didn't bet)



PokerStars Home Game Hand #225608582384: {DaPokaStars}  Hold'em No Limit (50/100) - 2021/04/07 17:32:24 ET
Table 'agian and again' 9-max (Play Money) Seat #3 is the button
Seat 1: color_singleton (24101 in chips) 
Seat 2: dhduncan (14744 in chips) 
Seat 3: PokerStarMan123 (10325 in chips) 
Seat 4: Klemtonius (2779 in chips) 
Seat 6: juiceC2 (1263 in chips) 
Seat 7: Mafak2020 (45441 in chips) 
Seat 8: HighCardJasper (14837 in chips) 
Seat 9: manon327 (6482 in chips) 
Klemtonius: posts small blind 50
juiceC2: posts big blind 100
*** HOLE CARDS ***
Dealt to PokerStarMan123 [Js 8s]
Mafak2020: calls 100
HighCardJasper: calls 100
manon327: folds 
color_singleton: calls 100
dhduncan: folds 
PokerStarMan123: calls 100
Klemtonius: calls 50
juiceC2: checks 
*** FLOP *** [4s 2s Ks]
Klemtonius: bets 283
juiceC2: calls 283
Mafak2020: folds 
HighCardJasper: folds 
color_singleton: folds 
PokerStarMan123: raises 283 to 566
Klemtonius: calls 283
juiceC2: folds 
*** TURN *** [4s 2s Ks] [6h]
Klemtonius: bets 2113 and is all-in
PokerStarMan123: calls 2113
*** RIVER *** [4s 2s Ks 6h] [3h]
*** SHOW DOWN ***
Klemtonius: shows [9c 9s] (a pair of Nines)
PokerStarMan123: shows [Js 8s] (a flush, King high)
PokerStarMan123 collected 5898 from pot
*** SUMMARY ***
Total pot 6241 | Rake 343 
Board [4s 2s Ks 6h 3h]
Seat 1: color_singleton folded on the Flop
Seat 2: dhduncan folded before Flop (didn't bet)
Seat 3: PokerStarMan123 (button) showed [Js 8s] and won (5898) with a flush, King high
Seat 4: Klemtonius (small blind) showed [9c 9s] and lost with a pair of Nines
Seat 6: juiceC2 (big blind) folded on the Flop
Seat 7: Mafak2020 folded on the Flop
Seat 8: HighCardJasper folded on the Flop
Seat 9: manon327 folded before Flop (didn't bet)



PokerStars Home Game Hand #225608615222: {DaPokaStars}  Hold'em No Limit (50/100) - 2021/04/07 17:33:17 ET
Table 'agian and again' 9-max (Play Money) Seat #6 is the button
Seat 1: color_singleton (24001 in chips) 
Seat 2: dhduncan (14744 in chips) 
Seat 3: PokerStarMan123 (13444 in chips) 
Seat 6: juiceC2 (880 in chips) 
Seat 7: Mafak2020 (45341 in chips) 
Seat 8: HighCardJasper (14737 in chips) 
Seat 9: manon327 (6482 in chips) 
Mafak2020: posts small blind 50
HighCardJasper: posts big blind 100
*** HOLE CARDS ***
Dealt to PokerStarMan123 [4d 8s]
manon327: calls 100
color_singleton: folds 
dhduncan: calls 100
PokerStarMan123: folds 
juiceC2: folds 
Mafak2020: calls 50
HighCardJasper: checks 
*** FLOP *** [7h 4s Th]
Mafak2020: checks 
HighCardJasper: checks 
manon327: checks 
dhduncan: checks 
*** TURN *** [7h 4s Th] [Qd]
Mafak2020: checks 
HighCardJasper: bets 200
manon327: folds 
dhduncan: folds 
Mafak2020: folds 
Uncalled bet (200) returned to HighCardJasper
HighCardJasper collected 378 from pot
HighCardJasper: doesn't show hand 
*** SUMMARY ***
Total pot 400 | Rake 22 
Board [7h 4s Th Qd]
Seat 1: color_singleton folded before Flop (didn't bet)
Seat 2: dhduncan folded on the Turn
Seat 3: PokerStarMan123 folded before Flop (didn't bet)
Seat 6: juiceC2 (button) folded before Flop (didn't bet)
Seat 7: Mafak2020 (small blind) folded on the Turn
Seat 8: HighCardJasper (big blind) collected (378)
Seat 9: manon327 folded on the Turn



PokerStars Home Game Hand #225608639699: {DaPokaStars}  Hold'em No Limit (50/100) - 2021/04/07 17:33:57 ET
Table 'agian and again' 9-max (Play Money) Seat #7 is the button
Seat 1: color_singleton (24001 in chips) 
Seat 2: dhduncan (14644 in chips) 
Seat 3: PokerStarMan123 (13444 in chips) 
Seat 4: Klemtonius (10000 in chips) 
Seat 6: juiceC2 (880 in chips) 
Seat 7: Mafak2020 (45241 in chips) 
Seat 8: HighCardJasper (15015 in chips) 
Seat 9: manon327 (6382 in chips) 
HighCardJasper: posts small blind 50
manon327: posts big blind 100
*** HOLE CARDS ***
Dealt to PokerStarMan123 [2h 6d]
color_singleton: folds 
dhduncan: calls 100
PokerStarMan123: folds 
Klemtonius: raises 100 to 200
juiceC2: calls 200
Mafak2020: calls 200
HighCardJasper: calls 150
manon327: folds 
dhduncan: calls 100
*** FLOP *** [Qh 3d 3c]
HighCardJasper: checks 
dhduncan: checks 
Klemtonius: checks 
juiceC2: checks 
Mafak2020: checks 
*** TURN *** [Qh 3d 3c] [5h]
HighCardJasper: checks 
dhduncan: checks 
Klemtonius: checks 
juiceC2: checks 
Mafak2020: checks 
*** RIVER *** [Qh 3d 3c 5h] [3h]
HighCardJasper: checks 
dhduncan: checks 
Klemtonius: checks 
juiceC2: checks 
Mafak2020: checks 
*** SHOW DOWN ***
HighCardJasper: shows [5s Kd] (a full house, Threes full of Fives)
dhduncan: mucks hand 
Klemtonius: mucks hand 
juiceC2: mucks hand 
Mafak2020: mucks hand 
HighCardJasper collected 1039 from pot
*** SUMMARY ***
Total pot 1100 | Rake 61 
Board [Qh 3d 3c 5h 3h]
Seat 1: color_singleton folded before Flop (didn't bet)
Seat 2: dhduncan mucked [Ac Ks]
Seat 3: PokerStarMan123 folded before Flop (didn't bet)
Seat 4: Klemtonius mucked [8d Kh]
Seat 6: juiceC2 mucked [Ad 8h]
Seat 7: Mafak2020 (button) mucked [8c 9d]
Seat 8: HighCardJasper (small blind) showed [5s Kd] and won (1039) with a full house, Threes full of Fives
Seat 9: manon327 (big blind) folded before Flop



PokerStars Home Game Hand #225608685340: {DaPokaStars}  Hold'em No Limit (50/100) - 2021/04/07 17:35:05 ET
Table 'agian and again' 9-max (Play Money) Seat #8 is the button
Seat 1: color_singleton (24001 in chips) 
Seat 2: dhduncan (14444 in chips) 
Seat 3: PokerStarMan123 (13444 in chips) 
Seat 4: Klemtonius (9800 in chips) 
Seat 6: juiceC2 (680 in chips) 
Seat 7: Mafak2020 (45041 in chips) 
Seat 8: HighCardJasper (15854 in chips) 
Seat 9: manon327 (6282 in chips) 
manon327: posts small blind 50
color_singleton: posts big blind 100
*** HOLE CARDS ***
Dealt to PokerStarMan123 [9h Js]
dhduncan: folds 
PokerStarMan123: folds 
Klemtonius: calls 100
juiceC2: raises 580 to 680 and is all-in
Mafak2020: folds 
HighCardJasper: folds 
manon327: calls 630
color_singleton: calls 580
Klemtonius: folds 
*** FLOP *** [Kd Ad 8d]
manon327: checks 
color_singleton: checks 
*** TURN *** [Kd Ad 8d] [Qc]
manon327: bets 2022
color_singleton: folds 
Uncalled bet (2022) returned to manon327
*** RIVER *** [Kd Ad 8d Qc] [4s]
*** SHOW DOWN ***
manon327: shows [Kc 4c] (two pair, Kings and Fours)
juiceC2: shows [2d Jc] (high card Ace)
manon327 collected 2022 from pot
*** SUMMARY ***
Total pot 2140 | Rake 118 
Board [Kd Ad 8d Qc 4s]
Seat 1: color_singleton (big blind) folded on the Turn
Seat 2: dhduncan folded before Flop (didn't bet)
Seat 3: PokerStarMan123 folded before Flop (didn't bet)
Seat 4: Klemtonius folded before Flop
Seat 6: juiceC2 showed [2d Jc] and lost with high card Ace
Seat 7: Mafak2020 folded before Flop (didn't bet)
Seat 8: HighCardJasper (button) folded before Flop (didn't bet)
Seat 9: manon327 (small blind) showed [Kc 4c] and won (2022) with two pair, Kings and Fours



PokerStars Home Game Hand #225608711790: {DaPokaStars}  Hold'em No Limit (50/100) - 2021/04/07 17:35:48 ET
Table 'agian and again' 9-max (Play Money) Seat #9 is the button
Seat 1: color_singleton (23321 in chips) 
Seat 2: dhduncan (14444 in chips) 
Seat 3: PokerStarMan123 (13444 in chips) 
Seat 4: Klemtonius (9700 in chips) 
Seat 7: Mafak2020 (45041 in chips) 
Seat 8: HighCardJasper (15854 in chips) 
Seat 9: manon327 (7624 in chips) 
color_singleton: posts small blind 50
dhduncan: posts big blind 100
*** HOLE CARDS ***
Dealt to PokerStarMan123 [8s 8c]
PokerStarMan123: raises 200 to 300
Klemtonius: calls 300
Mafak2020: folds 
HighCardJasper: calls 300
manon327: folds 
color_singleton: folds 
dhduncan: folds 
*** FLOP *** [6d Ks 7s]
PokerStarMan123: bets 500
Klemtonius: folds 
HighCardJasper: folds 
Uncalled bet (500) returned to PokerStarMan123
PokerStarMan123 collected 992 from pot
*** SUMMARY ***
Total pot 1050 | Rake 58 
Board [6d Ks 7s]
Seat 1: color_singleton (small blind) folded before Flop
Seat 2: dhduncan (big blind) folded before Flop
Seat 3: PokerStarMan123 collected (992)
Seat 4: Klemtonius folded on the Flop
Seat 7: Mafak2020 folded before Flop (didn't bet)
Seat 8: HighCardJasper folded on the Flop
Seat 9: manon327 (button) folded before Flop (didn't bet)



PokerStars Home Game Hand #225608731083: {DaPokaStars}  Hold'em No Limit (50/100) - 2021/04/07 17:36:19 ET
Table 'agian and again' 9-max (Play Money) Seat #1 is the button
Seat 1: color_singleton (23271 in chips) 
Seat 2: dhduncan (14344 in chips) 
Seat 3: PokerStarMan123 (14136 in chips) 
Seat 4: Klemtonius (9400 in chips) 
Seat 6: juiceC2 (10000 in chips) 
Seat 7: Mafak2020 (45041 in chips) 
Seat 8: HighCardJasper (15554 in chips) 
Seat 9: manon327 (7624 in chips) 
dhduncan: posts small blind 50
PokerStarMan123: posts big blind 100
*** HOLE CARDS ***
Dealt to PokerStarMan123 [Jh Ks]
Klemtonius: calls 100
juiceC2: folds 
Mafak2020: folds 
HighCardJasper: calls 100
manon327: calls 100
color_singleton: raises 200 to 300
dhduncan: folds 
PokerStarMan123: calls 200
Klemtonius: calls 200
HighCardJasper: calls 200
manon327: folds 
*** FLOP *** [8h Th 6c]
PokerStarMan123: checks 
Klemtonius: checks 
HighCardJasper: checks 
color_singleton: bets 700
PokerStarMan123: folds 
Klemtonius: folds 
HighCardJasper: folds 
Uncalled bet (700) returned to color_singleton
color_singleton collected 1276 from pot
color_singleton: doesn't show hand 
*** SUMMARY ***
Total pot 1350 | Rake 74 
Board [8h Th 6c]
Seat 1: color_singleton (button) collected (1276)
Seat 2: dhduncan (small blind) folded before Flop
Seat 3: PokerStarMan123 (big blind) folded on the Flop
Seat 4: Klemtonius folded on the Flop
Seat 6: juiceC2 folded before Flop (didn't bet)
Seat 7: Mafak2020 folded before Flop (didn't bet)
Seat 8: HighCardJasper folded on the Flop
Seat 9: manon327 folded before Flop



PokerStars Home Game Hand #225608768405: {DaPokaStars}  Hold'em No Limit (50/100) - 2021/04/07 17:37:21 ET
Table 'agian and again' 9-max (Play Money) Seat #2 is the button
Seat 1: color_singleton (24247 in chips) 
Seat 2: dhduncan (14294 in chips) 
Seat 3: PokerStarMan123 (13836 in chips) 
Seat 4: Klemtonius (9100 in chips) 
Seat 6: juiceC2 (10000 in chips) 
Seat 7: Mafak2020 (45041 in chips) 
Seat 8: HighCardJasper (15254 in chips) 
Seat 9: manon327 (7524 in chips) 
PokerStarMan123: posts small blind 50
Klemtonius: posts big blind 100
*** HOLE CARDS ***
Dealt to PokerStarMan123 [6h Td]
juiceC2: calls 100
Mafak2020: folds 
HighCardJasper: folds 
manon327: calls 100
color_singleton: calls 100
dhduncan: calls 100
PokerStarMan123: calls 50
Klemtonius: raises 100 to 200
juiceC2: calls 100
manon327: calls 100
color_singleton: calls 100
dhduncan: calls 100
PokerStarMan123: calls 100
*** FLOP *** [3c Qc 9s]
PokerStarMan123: checks 
Klemtonius: checks 
juiceC2: checks 
manon327: checks 
color_singleton: checks 
dhduncan: checks 
*** TURN *** [3c Qc 9s] [8c]
PokerStarMan123: checks 
Klemtonius: checks 
juiceC2: bets 567
manon327: folds 
color_singleton: folds 
dhduncan: folds 
PokerStarMan123: folds 
Klemtonius: calls 567
*** RIVER *** [3c Qc 9s 8c] [7c]
Klemtonius: checks 
juiceC2: bets 1103
Klemtonius: folds 
Uncalled bet (1103) returned to juiceC2
juiceC2 collected 2206 from pot
juiceC2: doesn't show hand 
*** SUMMARY ***
Total pot 2334 | Rake 128 
Board [3c Qc 9s 8c 7c]
Seat 1: color_singleton folded on the Turn
Seat 2: dhduncan (button) folded on the Turn
Seat 3: PokerStarMan123 (small blind) folded on the Turn
Seat 4: Klemtonius (big blind) folded on the River
Seat 6: juiceC2 collected (2206)
Seat 7: Mafak2020 folded before Flop (didn't bet)
Seat 8: HighCardJasper folded before Flop (didn't bet)
Seat 9: manon327 folded on the Turn



PokerStars Home Game Hand #225608814314: {DaPokaStars}  Hold'em No Limit (50/100) - 2021/04/07 17:38:37 ET
Table 'agian and again' 9-max (Play Money) Seat #3 is the button
Seat 1: color_singleton (24047 in chips) 
Seat 2: dhduncan (14094 in chips) 
Seat 3: PokerStarMan123 (13636 in chips) 
Seat 4: Klemtonius (8333 in chips) 
Seat 6: juiceC2 (11439 in chips) 
Seat 7: Mafak2020 (45041 in chips) 
Seat 8: HighCardJasper (15254 in chips) 
Seat 9: manon327 (7324 in chips) 
Klemtonius: posts small blind 50
juiceC2: posts big blind 100
*** HOLE CARDS ***
Dealt to PokerStarMan123 [Jc 5s]
Mafak2020: calls 100
HighCardJasper: calls 100
manon327: calls 100
color_singleton: folds 
dhduncan: folds 
PokerStarMan123: folds 
Klemtonius: calls 50
juiceC2: checks 
*** FLOP *** [Ks Kc Ts]
Klemtonius: checks 
juiceC2: bets 236
Mafak2020: folds 
HighCardJasper: folds 
manon327: raises 236 to 472
Klemtonius: folds 
juiceC2: calls 236
*** TURN *** [Ks Kc Ts] [8h]
juiceC2: bets 682
manon327: raises 682 to 1364
juiceC2: folds 
Uncalled bet (682) returned to manon327
manon327 collected 2654 from pot
*** SUMMARY ***
Total pot 2808 | Rake 154 
Board [Ks Kc Ts 8h]
Seat 1: color_singleton folded before Flop (didn't bet)
Seat 2: dhduncan folded before Flop (didn't bet)
Seat 3: PokerStarMan123 (button) folded before Flop (didn't bet)
Seat 4: Klemtonius (small blind) folded on the Flop
Seat 6: juiceC2 (big blind) folded on the Turn
Seat 7: Mafak2020 folded on the Flop
Seat 8: HighCardJasper folded on the Flop
Seat 9: manon327 collected (2654)



PokerStars Home Game Hand #225608847450: {DaPokaStars}  Hold'em No Limit (50/100) - 2021/04/07 17:39:31 ET
Table 'agian and again' 9-max (Play Money) Seat #4 is the button
Seat 1: color_singleton (24047 in chips) 
Seat 2: dhduncan (14094 in chips) 
Seat 3: PokerStarMan123 (13636 in chips) 
Seat 4: Klemtonius (8233 in chips) 
Seat 6: juiceC2 (10185 in chips) 
Seat 7: Mafak2020 (44941 in chips) 
Seat 8: HighCardJasper (15154 in chips) 
Seat 9: manon327 (8724 in chips) 
juiceC2: posts small blind 50
Mafak2020: posts big blind 100
*** HOLE CARDS ***
Dealt to PokerStarMan123 [9h Ks]
HighCardJasper: calls 100
manon327: folds 
color_singleton: folds 
dhduncan: folds 
PokerStarMan123: raises 250 to 350
Klemtonius: folds 
juiceC2: folds 
Mafak2020: calls 250
HighCardJasper: folds 
*** FLOP *** [Qc 6c Th]
Mafak2020: checks 
PokerStarMan123: checks 
*** TURN *** [Qc 6c Th] [Kc]
Mafak2020: checks 
PokerStarMan123: bets 400
Mafak2020: folds 
Uncalled bet (400) returned to PokerStarMan123
PokerStarMan123 collected 803 from pot
*** SUMMARY ***
Total pot 850 | Rake 47 
Board [Qc 6c Th Kc]
Seat 1: color_singleton folded before Flop (didn't bet)
Seat 2: dhduncan folded before Flop (didn't bet)
Seat 3: PokerStarMan123 collected (803)
Seat 4: Klemtonius (button) folded before Flop (didn't bet)
Seat 6: juiceC2 (small blind) folded before Flop
Seat 7: Mafak2020 (big blind) folded on the Turn
Seat 8: HighCardJasper folded before Flop
Seat 9: manon327 folded before Flop (didn't bet)



PokerStars Home Game Hand #225608871765: {DaPokaStars}  Hold'em No Limit (50/100) - 2021/04/07 17:40:11 ET
Table 'agian and again' 9-max (Play Money) Seat #7 is the button
Seat 1: color_singleton (24047 in chips) 
Seat 2: dhduncan (14094 in chips) 
Seat 3: PokerStarMan123 (14089 in chips) 
Seat 4: Klemtonius (8233 in chips) 
Seat 7: Mafak2020 (44591 in chips) 
Seat 8: HighCardJasper (15054 in chips) 
Seat 9: manon327 (8724 in chips) 
HighCardJasper: posts small blind 50
manon327: posts big blind 100
*** HOLE CARDS ***
Dealt to PokerStarMan123 [5h Td]
color_singleton: folds 
dhduncan: calls 100
PokerStarMan123: folds 
Klemtonius: calls 100
Mafak2020: calls 100
HighCardJasper: calls 50
manon327: checks 
*** FLOP *** [Qs 3c 9h]
HighCardJasper: checks 
manon327: checks 
dhduncan: checks 
Klemtonius: bets 100
Mafak2020: calls 100
HighCardJasper: calls 100
manon327: folds 
dhduncan: calls 100
*** TURN *** [Qs 3c 9h] [Kd]
HighCardJasper: checks 
dhduncan: checks 
Klemtonius: checks 
Mafak2020: checks 
*** RIVER *** [Qs 3c 9h Kd] [4c]
HighCardJasper: checks 
dhduncan: checks 
Klemtonius: checks 
Mafak2020: checks 
*** SHOW DOWN ***
HighCardJasper: shows [5d As] (high card Ace)
dhduncan: shows [Ah 8d] (high card Ace - King+Queen+Nine+Eight kicker)
Klemtonius: shows [9d 7d] (a pair of Nines)
Mafak2020: shows [Qh Ts] (a pair of Queens)
Mafak2020 collected 850 from pot
*** SUMMARY ***
Total pot 900 | Rake 50 
Board [Qs 3c 9h Kd 4c]
Seat 1: color_singleton folded before Flop (didn't bet)
Seat 2: dhduncan showed [Ah 8d] and lost with high card Ace
Seat 3: PokerStarMan123 folded before Flop (didn't bet)
Seat 4: Klemtonius showed [9d 7d] and lost with a pair of Nines
Seat 7: Mafak2020 (button) showed [Qh Ts] and won (850) with a pair of Queens
Seat 8: HighCardJasper (small blind) showed [5d As] and lost with high card Ace
Seat 9: manon327 (big blind) folded on the Flop



PokerStars Home Game Hand #225608909042: {DaPokaStars}  Hold'em No Limit (50/100) - 2021/04/07 17:41:13 ET
Table 'agian and again' 9-max (Play Money) Seat #8 is the button
Seat 1: color_singleton (24047 in chips) 
Seat 2: dhduncan (13894 in chips) 
Seat 3: PokerStarMan123 (14089 in chips) 
Seat 4: Klemtonius (8033 in chips) 
Seat 7: Mafak2020 (45241 in chips) 
Seat 8: HighCardJasper (14854 in chips) 
Seat 9: manon327 (8624 in chips) 
manon327: posts small blind 50
color_singleton: posts big blind 100
*** HOLE CARDS ***
Dealt to PokerStarMan123 [Kc 5d]
dhduncan: folds 
PokerStarMan123: folds 
Klemtonius: raises 100 to 200
Mafak2020: calls 200
HighCardJasper: folds 
manon327: calls 150
color_singleton: calls 100
*** FLOP *** [9s Ts Qh]
manon327: checks 
color_singleton: checks 
Klemtonius: bets 100
Mafak2020: folds 
manon327: calls 100
color_singleton: folds 
*** TURN *** [9s Ts Qh] [4d]
manon327: checks 
Klemtonius: bets 472
manon327: folds 
Uncalled bet (472) returned to Klemtonius
Klemtonius collected 945 from pot
Klemtonius: doesn't show hand 
*** SUMMARY ***
Total pot 1000 | Rake 55 
Board [9s Ts Qh 4d]
Seat 1: color_singleton (big blind) folded on the Flop
Seat 2: dhduncan folded before Flop (didn't bet)
Seat 3: PokerStarMan123 folded before Flop (didn't bet)
Seat 4: Klemtonius collected (945)
Seat 7: Mafak2020 folded on the Flop
Seat 8: HighCardJasper (button) folded before Flop (didn't bet)
Seat 9: manon327 (small blind) folded on the Turn



PokerStars Home Game Hand #225608934035: {DaPokaStars}  Hold'em No Limit (50/100) - 2021/04/07 17:41:55 ET
Table 'agian and again' 9-max (Play Money) Seat #9 is the button
Seat 1: color_singleton (23847 in chips) 
Seat 2: dhduncan (13894 in chips) 
Seat 3: PokerStarMan123 (14089 in chips) 
Seat 4: Klemtonius (8678 in chips) 
Seat 7: Mafak2020 (45041 in chips) 
Seat 8: HighCardJasper (14854 in chips) 
Seat 9: manon327 (8324 in chips) 
color_singleton: posts small blind 50
dhduncan: posts big blind 100
*** HOLE CARDS ***
Dealt to PokerStarMan123 [Ts 2d]
PokerStarMan123: folds 
Klemtonius: calls 100
Mafak2020: raises 100 to 200
HighCardJasper: calls 200
manon327: calls 200
color_singleton: calls 150
dhduncan: calls 100
Klemtonius: calls 100
*** FLOP *** [2c Qh 9h]
color_singleton: checks 
dhduncan: checks 
Klemtonius: bets 1134
Mafak2020: calls 1134
HighCardJasper: calls 1134
manon327: folds 
color_singleton: folds 
dhduncan: folds 
*** TURN *** [2c Qh 9h] [4h]
Klemtonius: bets 4349
Mafak2020: folds 
HighCardJasper: calls 4349
*** RIVER *** [2c Qh 9h 4h] [3s]
Klemtonius: bets 2995 and is all-in
HighCardJasper: folds 
Uncalled bet (2995) returned to Klemtonius
Klemtonius collected 12568 from pot
Klemtonius: doesn't show hand 
*** SUMMARY ***
Total pot 13300 | Rake 732 
Board [2c Qh 9h 4h 3s]
Seat 1: color_singleton (small blind) folded on the Flop
Seat 2: dhduncan (big blind) folded on the Flop
Seat 3: PokerStarMan123 folded before Flop (didn't bet)
Seat 4: Klemtonius collected (12568)
Seat 7: Mafak2020 folded on the Turn
Seat 8: HighCardJasper folded on the River
Seat 9: manon327 (button) folded on the Flop



PokerStars Home Game Hand #225608982556: {DaPokaStars}  Hold'em No Limit (50/100) - 2021/04/07 17:43:16 ET
Table 'agian and again' 9-max (Play Money) Seat #1 is the button
Seat 1: color_singleton (23647 in chips) 
Seat 2: dhduncan (13694 in chips) 
Seat 3: PokerStarMan123 (14089 in chips) 
Seat 4: Klemtonius (15563 in chips) 
Seat 6: juiceC2 (10135 in chips) 
Seat 7: Mafak2020 (43707 in chips) 
Seat 8: HighCardJasper (9171 in chips) 
Seat 9: manon327 (8124 in chips) 
dhduncan: posts small blind 50
PokerStarMan123: posts big blind 100
*** HOLE CARDS ***
Dealt to PokerStarMan123 [7c Ac]
Klemtonius: folds 
juiceC2: calls 100
Mafak2020: raises 100 to 200
HighCardJasper: calls 200
manon327: raises 100 to 300
color_singleton: folds 
dhduncan: folds 
PokerStarMan123: calls 200
juiceC2: calls 200
Mafak2020: calls 100
HighCardJasper: calls 100
*** FLOP *** [8c Ad 2c]
PokerStarMan123: checks 
juiceC2: checks 
Mafak2020: bets 300
HighCardJasper: folds 
manon327: raises 2065 to 2365
PokerStarMan123: calls 2365
juiceC2: folds 
Mafak2020: folds 
*** TURN *** [8c Ad 2c] [7s]
PokerStarMan123: checks 
manon327: bets 5459 and is all-in
PokerStarMan123: calls 5459
*** RIVER *** [8c Ad 2c 7s] [4d]
*** SHOW DOWN ***
PokerStarMan123: shows [7c Ac] (two pair, Aces and Sevens)
manon327: shows [Ah Kh] (a pair of Aces)
PokerStarMan123 collected 16536 from pot
*** SUMMARY ***
Total pot 17498 | Rake 962 
Board [8c Ad 2c 7s 4d]
Seat 1: color_singleton (button) folded before Flop (didn't bet)
Seat 2: dhduncan (small blind) folded before Flop
Seat 3: PokerStarMan123 (big blind) showed [7c Ac] and won (16536) with two pair, Aces and Sevens
Seat 4: Klemtonius folded before Flop (didn't bet)
Seat 6: juiceC2 folded on the Flop
Seat 7: Mafak2020 folded on the Flop
Seat 8: HighCardJasper folded on the Flop
Seat 9: manon327 showed [Ah Kh] and lost with a pair of Aces



PokerStars Home Game Hand #225609048911: {DaPokaStars}  Hold'em No Limit (50/100) - 2021/04/07 17:44:54 ET
Table 'agian and again' 9-max (Play Money) Seat #2 is the button
Seat 1: color_singleton (23647 in chips) 
Seat 2: dhduncan (13644 in chips) 
Seat 3: PokerStarMan123 (22501 in chips) 
Seat 4: Klemtonius (15563 in chips) 
Seat 6: juiceC2 (9835 in chips) 
Seat 7: Mafak2020 (43107 in chips) 
Seat 8: HighCardJasper (8871 in chips) 
PokerStarMan123: posts small blind 50
Klemtonius: posts big blind 100
*** HOLE CARDS ***
Dealt to PokerStarMan123 [Td Jd]
juiceC2: calls 100
Mafak2020: folds 
HighCardJasper: calls 100
color_singleton: calls 100
dhduncan: folds 
PokerStarMan123: calls 50
Klemtonius: raises 100 to 200
juiceC2: calls 100
HighCardJasper: calls 100
color_singleton: calls 100
PokerStarMan123: calls 100
*** FLOP *** [Kc 3c Kd]
PokerStarMan123: checks 
Klemtonius: checks 
juiceC2: checks 
HighCardJasper: checks 
color_singleton: bets 500
PokerStarMan123: folds 
Klemtonius: raises 500 to 1000
juiceC2: folds 
HighCardJasper: calls 1000
color_singleton: calls 500
*** TURN *** [Kc 3c Kd] [8d]
Klemtonius: checks 
HighCardJasper: checks 
color_singleton: checks 
*** RIVER *** [Kc 3c Kd 8d] [8s]
Klemtonius: bets 1890
HighCardJasper: calls 1890
color_singleton: folds 
*** SHOW DOWN ***
Klemtonius: shows [8h Kh] (a full house, Kings full of Eights)
HighCardJasper: mucks hand 
Klemtonius collected 7352 from pot
*** SUMMARY ***
Total pot 7780 | Rake 428 
Board [Kc 3c Kd 8d 8s]
Seat 1: color_singleton folded on the River
Seat 2: dhduncan (button) folded before Flop (didn't bet)
Seat 3: PokerStarMan123 (small blind) folded on the Flop
Seat 4: Klemtonius (big blind) showed [8h Kh] and won (7352) with a full house, Kings full of Eights
Seat 6: juiceC2 folded on the Flop
Seat 7: Mafak2020 folded before Flop (didn't bet)
Seat 8: HighCardJasper mucked [8c Qc]



PokerStars Home Game Hand #225609101264: {DaPokaStars}  Hold'em No Limit (50/100) - 2021/04/07 17:46:23 ET
Table 'agian and again' 9-max (Play Money) Seat #3 is the button
Seat 1: color_singleton (22447 in chips) 
Seat 2: dhduncan (13644 in chips) 
Seat 3: PokerStarMan123 (22301 in chips) 
Seat 4: Klemtonius (19825 in chips) 
Seat 6: juiceC2 (9635 in chips) 
Seat 7: Mafak2020 (43107 in chips) 
Seat 8: HighCardJasper (5781 in chips) 
Seat 9: manon327 (10000 in chips) 
Klemtonius: posts small blind 50
juiceC2: posts big blind 100
*** HOLE CARDS ***
Dealt to PokerStarMan123 [Jc 9d]
Mafak2020: calls 100
HighCardJasper: folds 
manon327: folds 
color_singleton: calls 100
dhduncan: folds 
PokerStarMan123: folds 
Klemtonius: calls 50
juiceC2: checks 
*** FLOP *** [Jd Js Ad]
Klemtonius: checks 
juiceC2: checks 
Mafak2020: checks 
color_singleton: checks 
*** TURN *** [Jd Js Ad] [8c]
Klemtonius: checks 
juiceC2: bets 189
Mafak2020: calls 189
color_singleton: folds 
Klemtonius: folds 
*** RIVER *** [Jd Js Ad 8c] [7h]
juiceC2: checks 
Mafak2020: checks 
*** SHOW DOWN ***
juiceC2: shows [6d 3d] (a pair of Jacks)
Mafak2020: shows [Qd 8h] (two pair, Jacks and Eights)
Mafak2020 collected 735 from pot
*** SUMMARY ***
Total pot 778 | Rake 43 
Board [Jd Js Ad 8c 7h]
Seat 1: color_singleton folded on the Turn
Seat 2: dhduncan folded before Flop (didn't bet)
Seat 3: PokerStarMan123 (button) folded before Flop (didn't bet)
Seat 4: Klemtonius (small blind) folded on the Turn
Seat 6: juiceC2 (big blind) showed [6d 3d] and lost with a pair of Jacks
Seat 7: Mafak2020 showed [Qd 8h] and won (735) with two pair, Jacks and Eights
Seat 8: HighCardJasper folded before Flop (didn't bet)
Seat 9: manon327 folded before Flop (didn't bet)



PokerStars Home Game Hand #225609137030: {DaPokaStars}  Hold'em No Limit (50/100) - 2021/04/07 17:47:24 ET
Table 'agian and again' 9-max (Play Money) Seat #4 is the button
Seat 1: color_singleton (22347 in chips) 
Seat 2: dhduncan (13644 in chips) 
Seat 3: PokerStarMan123 (22301 in chips) 
Seat 4: Klemtonius (19725 in chips) 
Seat 6: juiceC2 (9346 in chips) 
Seat 7: Mafak2020 (43553 in chips) 
Seat 8: HighCardJasper (5781 in chips) 
Seat 9: manon327 (10000 in chips) 
juiceC2: posts small blind 50
Mafak2020: posts big blind 100
*** HOLE CARDS ***
Dealt to PokerStarMan123 [8d Jd]
HighCardJasper: folds 
manon327: calls 100
color_singleton: folds 
dhduncan: folds 
PokerStarMan123: calls 100
Klemtonius: calls 100
juiceC2: calls 50
Mafak2020: checks 
*** FLOP *** [4h 7c Kd]
juiceC2: checks 
Mafak2020: checks 
manon327: checks 
PokerStarMan123: checks 
Klemtonius: checks 
*** TURN *** [4h 7c Kd] [7s]
juiceC2: checks 
Mafak2020: checks 
manon327: checks 
PokerStarMan123: checks 
Klemtonius: checks 
*** RIVER *** [4h 7c Kd 7s] [Jc]
juiceC2: bets 236
Mafak2020: folds 
manon327: folds 
PokerStarMan123: calls 236
Klemtonius: folds 
*** SHOW DOWN ***
juiceC2: shows [Js Qc] (two pair, Jacks and Sevens)
PokerStarMan123: shows [8d Jd] (two pair, Jacks and Sevens)
juiceC2 collected 460 from pot
PokerStarMan123 collected 459 from pot
*** SUMMARY ***
Total pot 972 | Rake 53 
Board [4h 7c Kd 7s Jc]
Seat 1: color_singleton folded before Flop (didn't bet)
Seat 2: dhduncan folded before Flop (didn't bet)
Seat 3: PokerStarMan123 showed [8d Jd] and won (459) with two pair, Jacks and Sevens
Seat 4: Klemtonius (button) folded on the River
Seat 6: juiceC2 (small blind) showed [Js Qc] and won (460) with two pair, Jacks and Sevens
Seat 7: Mafak2020 (big blind) folded on the River
Seat 8: HighCardJasper folded before Flop (didn't bet)
Seat 9: manon327 folded on the River



PokerStars Home Game Hand #225609173328: {DaPokaStars}  Hold'em No Limit (50/100) - 2021/04/07 17:48:25 ET
Table 'agian and again' 9-max (Play Money) Seat #6 is the button
Seat 1: color_singleton (22347 in chips) 
Seat 2: dhduncan (13644 in chips) 
Seat 3: PokerStarMan123 (22424 in chips) 
Seat 4: Klemtonius (19625 in chips) 
Seat 6: juiceC2 (9470 in chips) 
Seat 7: Mafak2020 (43453 in chips) 
Seat 8: HighCardJasper (5781 in chips) 
Seat 9: manon327 (9900 in chips) 
Mafak2020: posts small blind 50
HighCardJasper: posts big blind 100
*** HOLE CARDS ***
Dealt to PokerStarMan123 [Qc Ah]
manon327: folds 
color_singleton: calls 100
dhduncan: calls 100
PokerStarMan123: raises 300 to 400
Klemtonius: calls 400
juiceC2: folds 
Mafak2020: calls 350
HighCardJasper: calls 300
color_singleton: calls 300
dhduncan: calls 300
*** FLOP *** [9d Th 7h]
Mafak2020: bets 400
HighCardJasper: folds 
color_singleton: folds 
dhduncan: calls 400
PokerStarMan123: folds 
Klemtonius: calls 400
*** TURN *** [9d Th 7h] [8h]
Mafak2020: checks 
dhduncan: bets 1000
Klemtonius: raises 1000 to 2000
Mafak2020: folds 
dhduncan: calls 1000
*** RIVER *** [9d Th 7h 8h] [Qd]
dhduncan: bets 7182
Klemtonius: raises 9643 to 16825 and is all-in
dhduncan: calls 3662 and is all-in
Uncalled bet (5981) returned to Klemtonius
*** SHOW DOWN ***
Klemtonius: shows [Jd 7d] (a straight, Eight to Queen)
dhduncan: shows [8s Js] (a straight, Eight to Queen)
dhduncan collected 13839 from pot
Klemtonius collected 13838 from pot
*** SUMMARY ***
Total pot 29288 | Rake 1611 
Board [9d Th 7h 8h Qd]
Seat 1: color_singleton folded on the Flop
Seat 2: dhduncan showed [8s Js] and won (13839) with a straight, Eight to Queen
Seat 3: PokerStarMan123 folded on the Flop
Seat 4: Klemtonius showed [Jd 7d] and won (13838) with a straight, Eight to Queen
Seat 6: juiceC2 (button) folded before Flop (didn't bet)
Seat 7: Mafak2020 (small blind) folded on the Turn
Seat 8: HighCardJasper (big blind) folded on the Flop
Seat 9: manon327 folded before Flop (didn't bet)



PokerStars Home Game Hand #225609225410: {DaPokaStars}  Hold'em No Limit (50/100) - 2021/04/07 17:49:55 ET
Table 'agian and again' 9-max (Play Money) Seat #7 is the button
Seat 1: color_singleton (21947 in chips) 
Seat 2: dhduncan (13839 in chips) 
Seat 3: PokerStarMan123 (22024 in chips) 
Seat 4: Klemtonius (19819 in chips) 
Seat 6: juiceC2 (9470 in chips) 
Seat 7: Mafak2020 (42653 in chips) 
Seat 8: HighCardJasper (5381 in chips) 
Seat 9: manon327 (9900 in chips) 
HighCardJasper: posts small blind 50
manon327: posts big blind 100
*** HOLE CARDS ***
Dealt to PokerStarMan123 [3c 6d]
color_singleton: raises 200 to 300
dhduncan: calls 300
PokerStarMan123: folds 
Klemtonius: calls 300
juiceC2: folds 
Mafak2020: folds 
HighCardJasper: calls 250
manon327: calls 200
*** FLOP *** [Kd 4s Td]
HighCardJasper: checks 
manon327: checks 
color_singleton: checks 
dhduncan: checks 
Klemtonius: checks 
*** TURN *** [Kd 4s Td] [Tc]
HighCardJasper: checks 
manon327: checks 
color_singleton: checks 
dhduncan: checks 
Klemtonius: checks 
*** RIVER *** [Kd 4s Td Tc] [6s]
HighCardJasper: checks 
manon327: checks 
color_singleton: checks 
dhduncan: checks 
Klemtonius: checks 
*** SHOW DOWN ***
HighCardJasper: shows [7c Qc] (a pair of Tens)
manon327: shows [7s Ah] (a pair of Tens - Ace kicker)
color_singleton: mucks hand 
dhduncan: shows [3s Kc] (two pair, Kings and Tens)
Klemtonius: mucks hand 
dhduncan collected 1417 from pot
*** SUMMARY ***
Total pot 1500 | Rake 83 
Board [Kd 4s Td Tc 6s]
Seat 1: color_singleton mucked [9c Qd]
Seat 2: dhduncan showed [3s Kc] and won (1417) with two pair, Kings and Tens
Seat 3: PokerStarMan123 folded before Flop (didn't bet)
Seat 4: Klemtonius mucked [8c Js]
Seat 6: juiceC2 folded before Flop (didn't bet)
Seat 7: Mafak2020 (button) folded before Flop (didn't bet)
Seat 8: HighCardJasper (small blind) showed [7c Qc] and lost with a pair of Tens
Seat 9: manon327 (big blind) showed [7s Ah] and lost with a pair of Tens



PokerStars Home Game Hand #225609269682: {DaPokaStars}  Hold'em No Limit (50/100) - 2021/04/07 17:51:10 ET
Table 'agian and again' 9-max (Play Money) Seat #8 is the button
Seat 1: color_singleton (21647 in chips) 
Seat 2: dhduncan (14956 in chips) 
Seat 3: PokerStarMan123 (22024 in chips) 
Seat 4: Klemtonius (19519 in chips) 
Seat 6: juiceC2 (9470 in chips) 
Seat 7: Mafak2020 (42653 in chips) 
Seat 8: HighCardJasper (5081 in chips) 
Seat 9: manon327 (9600 in chips) 
manon327: posts small blind 50
color_singleton: posts big blind 100
*** HOLE CARDS ***
Dealt to PokerStarMan123 [Js Qc]
dhduncan: folds 
PokerStarMan123: raises 300 to 400
Klemtonius: calls 400
juiceC2: folds 
Mafak2020: folds 
HighCardJasper: folds 
manon327: calls 350
color_singleton: calls 300
*** FLOP *** [3h Qh 7d]
manon327: checks 
color_singleton: checks 
PokerStarMan123: bets 700
Klemtonius: calls 700
manon327: folds 
color_singleton: folds 
*** TURN *** [3h Qh 7d] [As]
PokerStarMan123: checks 
Klemtonius: bets 1417
PokerStarMan123: calls 1417
*** RIVER *** [3h Qh 7d As] [4d]
PokerStarMan123: checks 
Klemtonius: checks 
*** SHOW DOWN ***
PokerStarMan123: shows [Js Qc] (a pair of Queens)
Klemtonius: mucks hand 
PokerStarMan123 collected 5513 from pot
*** SUMMARY ***
Total pot 5834 | Rake 321 
Board [3h Qh 7d As 4d]
Seat 1: color_singleton (big blind) folded on the Flop
Seat 2: dhduncan folded before Flop (didn't bet)
Seat 3: PokerStarMan123 showed [Js Qc] and won (5513) with a pair of Queens
Seat 4: Klemtonius mucked [Qd 9c]
Seat 6: juiceC2 folded before Flop (didn't bet)
Seat 7: Mafak2020 folded before Flop (didn't bet)
Seat 8: HighCardJasper (button) folded before Flop (didn't bet)
Seat 9: manon327 (small blind) folded on the Flop



PokerStars Home Game Hand #225609306289: {DaPokaStars}  Hold'em No Limit (50/100) - 2021/04/07 17:52:13 ET
Table 'agian and again' 9-max (Play Money) Seat #9 is the button
Seat 1: color_singleton (21247 in chips) 
Seat 2: dhduncan (14956 in chips) 
Seat 3: PokerStarMan123 (25020 in chips) 
Seat 4: Klemtonius (17002 in chips) 
Seat 6: juiceC2 (9470 in chips) 
Seat 7: Mafak2020 (42653 in chips) 
Seat 8: HighCardJasper (5081 in chips) 
Seat 9: manon327 (9200 in chips) 
color_singleton: posts small blind 50
dhduncan: posts big blind 100
*** HOLE CARDS ***
Dealt to PokerStarMan123 [Kh Th]
PokerStarMan123: raises 300 to 400
Klemtonius: folds 
juiceC2: calls 400
Mafak2020: calls 400
HighCardJasper: folds 
manon327: folds 
color_singleton: calls 350
dhduncan: folds 
*** FLOP *** [Qc Td 8d]
color_singleton: bets 803
PokerStarMan123: folds 
juiceC2: folds 
Mafak2020: calls 803
*** TURN *** [Qc Td 8d] [6s]
color_singleton: bets 1562
Mafak2020: folds 
Uncalled bet (1562) returned to color_singleton
color_singleton collected 3124 from pot
color_singleton: doesn't show hand 
*** SUMMARY ***
Total pot 3306 | Rake 182 
Board [Qc Td 8d 6s]
Seat 1: color_singleton (small blind) collected (3124)
Seat 2: dhduncan (big blind) folded before Flop
Seat 3: PokerStarMan123 folded on the Flop
Seat 4: Klemtonius folded before Flop (didn't bet)
Seat 6: juiceC2 folded on the Flop
Seat 7: Mafak2020 folded on the Turn
Seat 8: HighCardJasper folded before Flop (didn't bet)
Seat 9: manon327 (button) folded before Flop (didn't bet)



PokerStars Home Game Hand #225609340692: {DaPokaStars}  Hold'em No Limit (50/100) - 2021/04/07 17:53:14 ET
Table 'agian and again' 9-max (Play Money) Seat #1 is the button
Seat 1: color_singleton (23168 in chips) 
Seat 2: dhduncan (14856 in chips) 
Seat 3: PokerStarMan123 (24620 in chips) 
Seat 4: Klemtonius (17002 in chips) 
Seat 6: juiceC2 (9070 in chips) 
Seat 7: Mafak2020 (41450 in chips) 
Seat 8: HighCardJasper (5081 in chips) 
Seat 9: manon327 (9200 in chips) 
dhduncan: posts small blind 50
PokerStarMan123: posts big blind 100
*** HOLE CARDS ***
Dealt to PokerStarMan123 [3c 9d]
Klemtonius: raises 100 to 200
juiceC2: folds 
Mafak2020: calls 200
HighCardJasper: calls 200
manon327: folds 
color_singleton: folds 
dhduncan: folds 
PokerStarMan123: folds 
*** FLOP *** [Jd As Kd]
Klemtonius: checks 
Mafak2020: checks 
HighCardJasper: checks 
*** TURN *** [Jd As Kd] [7d]
Klemtonius: bets 709
Mafak2020: folds 
HighCardJasper: folds 
Uncalled bet (709) returned to Klemtonius
Klemtonius collected 709 from pot
Klemtonius: doesn't show hand 
*** SUMMARY ***
Total pot 750 | Rake 41 
Board [Jd As Kd 7d]
Seat 1: color_singleton (button) folded before Flop (didn't bet)
Seat 2: dhduncan (small blind) folded before Flop
Seat 3: PokerStarMan123 (big blind) folded before Flop
Seat 4: Klemtonius collected (709)
Seat 6: juiceC2 folded before Flop (didn't bet)
Seat 7: Mafak2020 folded on the Turn
Seat 8: HighCardJasper folded on the Turn
Seat 9: manon327 folded before Flop (didn't bet)



PokerStars Home Game Hand #225609365321: {DaPokaStars}  Hold'em No Limit (50/100) - 2021/04/07 17:53:56 ET
Table 'agian and again' 9-max (Play Money) Seat #2 is the button
Seat 1: color_singleton (23168 in chips) 
Seat 2: dhduncan (14806 in chips) 
Seat 3: PokerStarMan123 (24520 in chips) 
Seat 4: Klemtonius (17511 in chips) 
Seat 6: juiceC2 (9070 in chips) 
Seat 7: Mafak2020 (41250 in chips) 
Seat 8: HighCardJasper (4881 in chips) 
Seat 9: manon327 (9200 in chips) 
PokerStarMan123: posts small blind 50
Klemtonius: posts big blind 100
*** HOLE CARDS ***
Dealt to PokerStarMan123 [6c 2d]
juiceC2: folds 
Mafak2020: calls 100
HighCardJasper: calls 100
manon327: raises 100 to 200
color_singleton: calls 200
dhduncan: folds 
PokerStarMan123: folds 
Klemtonius: calls 100
Mafak2020: calls 100
HighCardJasper: calls 100
*** FLOP *** [As Qc 5d]
Klemtonius: checks 
Mafak2020: checks 
HighCardJasper: checks 
manon327: bets 496
color_singleton: folds 
Klemtonius: folds 
Mafak2020: calls 496
HighCardJasper: folds 
*** TURN *** [As Qc 5d] [8s]
Mafak2020: checks 
manon327: bets 1930
Mafak2020: calls 1930
*** RIVER *** [As Qc 5d 8s] [9s]
Mafak2020: checks 
manon327: checks 
*** SHOW DOWN ***
Mafak2020: shows [Ah 4s] (a pair of Aces)
manon327: mucks hand 
Mafak2020 collected 5577 from pot
*** SUMMARY ***
Total pot 5902 | Rake 325 
Board [As Qc 5d 8s 9s]
Seat 1: color_singleton folded on the Flop
Seat 2: dhduncan (button) folded before Flop (didn't bet)
Seat 3: PokerStarMan123 (small blind) folded before Flop
Seat 4: Klemtonius (big blind) folded on the Flop
Seat 6: juiceC2 folded before Flop (didn't bet)
Seat 7: Mafak2020 showed [Ah 4s] and won (5577) with a pair of Aces
Seat 8: HighCardJasper folded on the Flop
Seat 9: manon327 mucked [Ks Kd]



PokerStars Home Game Hand #225609402719: {DaPokaStars}  Hold'em No Limit (50/100) - 2021/04/07 17:55:02 ET
Table 'agian and again' 9-max (Play Money) Seat #3 is the button
Seat 1: color_singleton (22968 in chips) 
Seat 2: dhduncan (14806 in chips) 
Seat 3: PokerStarMan123 (24470 in chips) 
Seat 4: Klemtonius (17311 in chips) 
Seat 6: juiceC2 (9070 in chips) 
Seat 7: Mafak2020 (44201 in chips) 
Seat 8: HighCardJasper (4681 in chips) 
Seat 9: manon327 (6574 in chips) 
Klemtonius: posts small blind 50
juiceC2: posts big blind 100
*** HOLE CARDS ***
Dealt to PokerStarMan123 [8c Qc]
Mafak2020: calls 100
HighCardJasper: calls 100
manon327: calls 100
color_singleton: raises 300 to 400
dhduncan: folds 
PokerStarMan123: folds 
Klemtonius: folds 
juiceC2: calls 300
Mafak2020: calls 300
HighCardJasper: calls 300
manon327: calls 300
*** FLOP *** [5h 9s 3d]
juiceC2: checks 
Mafak2020: checks 
HighCardJasper: checks 
manon327: checks 
color_singleton: checks 
*** TURN *** [5h 9s 3d] [8h]
juiceC2: checks 
Mafak2020: checks 
HighCardJasper: bets 200
manon327: folds 
color_singleton: calls 200
juiceC2: folds 
Mafak2020: calls 200
*** RIVER *** [5h 9s 3d 8h] [Kc]
Mafak2020: checks 
HighCardJasper: checks 
color_singleton: checks 
*** SHOW DOWN ***
Mafak2020: shows [Ts Th] (a pair of Tens)
HighCardJasper: mucks hand 
color_singleton: mucks hand 
Mafak2020 collected 2504 from pot
*** SUMMARY ***
Total pot 2650 | Rake 146 
Board [5h 9s 3d 8h Kc]
Seat 1: color_singleton mucked [Jc Ad]
Seat 2: dhduncan folded before Flop (didn't bet)
Seat 3: PokerStarMan123 (button) folded before Flop (didn't bet)
Seat 4: Klemtonius (small blind) folded before Flop
Seat 6: juiceC2 (big blind) folded on the Turn
Seat 7: Mafak2020 showed [Ts Th] and won (2504) with a pair of Tens
Seat 8: HighCardJasper mucked [Qh 2h]
Seat 9: manon327 folded on the Turn



PokerStars Home Game Hand #225609440902: {DaPokaStars}  Hold'em No Limit (50/100) - 2021/04/07 17:56:30 ET
Table 'agian and again' 9-max (Play Money) Seat #4 is the button
Seat 1: color_singleton (22368 in chips) 
Seat 2: dhduncan (14806 in chips) 
Seat 3: PokerStarMan123 (24470 in chips) 
Seat 4: Klemtonius (17261 in chips) 
Seat 6: juiceC2 (8670 in chips) 
Seat 7: Mafak2020 (46105 in chips) 
Seat 8: HighCardJasper (4081 in chips) 
Seat 9: manon327 (6174 in chips) 
juiceC2: posts small blind 50
Mafak2020: posts big blind 100
*** HOLE CARDS ***
Dealt to PokerStarMan123 [Tc 6d]
HighCardJasper: calls 100
manon327: raises 100 to 200
color_singleton: folds 
dhduncan: folds 
PokerStarMan123: folds 
Klemtonius: calls 200
juiceC2: folds 
Mafak2020: calls 100
HighCardJasper: calls 100
*** FLOP *** [8s 2d Ks]
Mafak2020: checks 
HighCardJasper: checks 
manon327: checks 
Klemtonius: checks 
*** TURN *** [8s 2d Ks] [Js]
Mafak2020: checks 
HighCardJasper: checks 
manon327: checks 
Klemtonius: checks 
*** RIVER *** [8s 2d Ks Js] [4d]
Mafak2020: bets 300
HighCardJasper: folds 
manon327: calls 300
Klemtonius: folds 
*** SHOW DOWN ***
Mafak2020: shows [Kc 4c] (two pair, Kings and Fours)
manon327: mucks hand 
Mafak2020 collected 1370 from pot
*** SUMMARY ***
Total pot 1450 | Rake 80 
Board [8s 2d Ks Js 4d]
Seat 1: color_singleton folded before Flop (didn't bet)
Seat 2: dhduncan folded before Flop (didn't bet)
Seat 3: PokerStarMan123 folded before Flop (didn't bet)
Seat 4: Klemtonius (button) folded on the River
Seat 6: juiceC2 (small blind) folded before Flop
Seat 7: Mafak2020 (big blind) showed [Kc 4c] and won (1370) with two pair, Kings and Fours
Seat 8: HighCardJasper folded on the River
Seat 9: manon327 mucked [Ts Ad]



PokerStars Home Game Hand #225609477639: {DaPokaStars}  Hold'em No Limit (50/100) - 2021/04/07 17:57:42 ET
Table 'agian and again' 9-max (Play Money) Seat #6 is the button
Seat 1: color_singleton (22368 in chips) 
Seat 2: dhduncan (14806 in chips) 
Seat 3: PokerStarMan123 (24470 in chips) 
Seat 4: Klemtonius (17061 in chips) 
Seat 6: juiceC2 (8620 in chips) 
Seat 7: Mafak2020 (46975 in chips) 
Seat 8: HighCardJasper (3881 in chips) 
Seat 9: manon327 (5674 in chips) 
Mafak2020: posts small blind 50
HighCardJasper: posts big blind 100
*** HOLE CARDS ***
Dealt to PokerStarMan123 [Jc 6d]
manon327: folds 
color_singleton: folds 
dhduncan: folds 
PokerStarMan123: folds 
Klemtonius: raises 100 to 200
juiceC2: calls 200
Mafak2020: raises 100 to 300
HighCardJasper: folds 
Klemtonius: calls 100
juiceC2: calls 100
*** FLOP *** [Js Ks Td]
Mafak2020: bets 500
Klemtonius: calls 500
juiceC2: folds 
*** TURN *** [Js Ks Td] [Kc]
Mafak2020: checks 
Klemtonius: bets 2500
Mafak2020: raises 2500 to 5000
Klemtonius: folds 
Uncalled bet (2500) returned to Mafak2020
Mafak2020 collected 6615 from pot
Mafak2020: doesn't show hand 
*** SUMMARY ***
Total pot 7000 | Rake 385 
Board [Js Ks Td Kc]
Seat 1: color_singleton folded before Flop (didn't bet)
Seat 2: dhduncan folded before Flop (didn't bet)
Seat 3: PokerStarMan123 folded before Flop (didn't bet)
Seat 4: Klemtonius folded on the Turn
Seat 6: juiceC2 (button) folded on the Flop
Seat 7: Mafak2020 (small blind) collected (6615)
Seat 8: HighCardJasper (big blind) folded before Flop
Seat 9: manon327 folded before Flop (didn't bet)



PokerStars Home Game Hand #225609503330: {DaPokaStars}  Hold'em No Limit (50/100) - 2021/04/07 17:58:44 ET
Table 'agian and again' 9-max (Play Money) Seat #7 is the button
Seat 1: color_singleton (22368 in chips) 
Seat 2: dhduncan (14806 in chips) 
Seat 3: PokerStarMan123 (24470 in chips) 
Seat 4: Klemtonius (13761 in chips) 
Seat 6: juiceC2 (8320 in chips) 
Seat 7: Mafak2020 (50290 in chips) 
Seat 8: HighCardJasper (3781 in chips) 
Seat 9: manon327 (5674 in chips) 
HighCardJasper: posts small blind 50
manon327: posts big blind 100
*** HOLE CARDS ***
Dealt to PokerStarMan123 [Jc 9d]
color_singleton: folds 
dhduncan: folds 
PokerStarMan123: calls 100
Klemtonius: raises 100 to 200
juiceC2: calls 200
Mafak2020: calls 200
HighCardJasper: calls 150
manon327: folds 
PokerStarMan123: calls 100
*** FLOP *** [6h 8s Ac]
HighCardJasper: checks 
PokerStarMan123: checks 
Klemtonius: checks 
juiceC2: checks 
Mafak2020: checks 
*** TURN *** [6h 8s Ac] [7s]
HighCardJasper: checks 
PokerStarMan123: checks 
Klemtonius: checks 
juiceC2: checks 
Mafak2020: checks 
*** RIVER *** [6h 8s Ac 7s] [Ah]
HighCardJasper: checks 
PokerStarMan123: checks 
Klemtonius: checks 
juiceC2: checks 
Mafak2020: checks 
*** SHOW DOWN ***
HighCardJasper: shows [9c 4c] (a pair of Aces)
PokerStarMan123: shows [Jc 9d] (a pair of Aces - Jack kicker)
Klemtonius: shows [5h 5d] (two pair, Aces and Fives)
juiceC2: mucks hand 
Mafak2020: mucks hand 
Klemtonius collected 1039 from pot
*** SUMMARY ***
Total pot 1100 | Rake 61 
Board [6h 8s Ac 7s Ah]
Seat 1: color_singleton folded before Flop (didn't bet)
Seat 2: dhduncan folded before Flop (didn't bet)
Seat 3: PokerStarMan123 showed [Jc 9d] and lost with a pair of Aces
Seat 4: Klemtonius showed [5h 5d] and won (1039) with two pair, Aces and Fives
Seat 6: juiceC2 mucked [Th Qc]
Seat 7: Mafak2020 (button) mucked [Qd 3d]
Seat 8: HighCardJasper (small blind) showed [9c 4c] and lost with a pair of Aces
Seat 9: manon327 (big blind) folded before Flop



PokerStars Home Game Hand #225609529572: {DaPokaStars}  Hold'em No Limit (50/100) - 2021/04/07 17:59:48 ET
Table 'agian and again' 9-max (Play Money) Seat #8 is the button
Seat 1: color_singleton (22368 in chips) 
Seat 2: dhduncan (14806 in chips) 
Seat 3: PokerStarMan123 (24270 in chips) 
Seat 4: Klemtonius (14600 in chips) 
Seat 6: juiceC2 (8120 in chips) 
Seat 7: Mafak2020 (50090 in chips) 
Seat 8: HighCardJasper (3581 in chips) 
Seat 9: manon327 (5574 in chips) 
manon327: posts small blind 50
color_singleton: posts big blind 100
*** HOLE CARDS ***
Dealt to PokerStarMan123 [2d Ad]
dhduncan: calls 100
PokerStarMan123: calls 100
Klemtonius: raises 450 to 550
juiceC2: folds 
Mafak2020: folds 
HighCardJasper: folds 
manon327: folds 
color_singleton: calls 450
dhduncan: calls 450
PokerStarMan123: calls 450
*** FLOP *** [9s Qd Kc]
color_singleton: checks 
dhduncan: checks 
PokerStarMan123: checks 
Klemtonius: bets 2126
color_singleton: folds 
dhduncan: folds 
PokerStarMan123: folds 
Uncalled bet (2126) returned to Klemtonius
Klemtonius collected 2126 from pot
Klemtonius: doesn't show hand 
*** SUMMARY ***
Total pot 2250 | Rake 124 
Board [9s Qd Kc]
Seat 1: color_singleton (big blind) folded on the Flop
Seat 2: dhduncan folded on the Flop
Seat 3: PokerStarMan123 folded on the Flop
Seat 4: Klemtonius collected (2126)
Seat 6: juiceC2 folded before Flop (didn't bet)
Seat 7: Mafak2020 folded before Flop (didn't bet)
Seat 8: HighCardJasper (button) folded before Flop (didn't bet)
Seat 9: manon327 (small blind) folded before Flop



PokerStars Home Game Hand #225609550182: {DaPokaStars}  Hold'em No Limit (50/100) - 2021/04/07 18:00:35 ET
Table 'agian and again' 9-max (Play Money) Seat #9 is the button
Seat 1: color_singleton (21818 in chips) 
Seat 2: dhduncan (14256 in chips) 
Seat 3: PokerStarMan123 (23720 in chips) 
Seat 4: Klemtonius (16176 in chips) 
Seat 6: juiceC2 (8120 in chips) 
Seat 7: Mafak2020 (50090 in chips) 
Seat 8: HighCardJasper (3581 in chips) 
Seat 9: manon327 (5524 in chips) 
color_singleton: posts small blind 50
dhduncan: posts big blind 100
*** HOLE CARDS ***
Dealt to PokerStarMan123 [8h Ad]
PokerStarMan123 has timed out
PokerStarMan123: folds 
Klemtonius: calls 100
juiceC2: folds 
Mafak2020: calls 100
HighCardJasper: calls 100
manon327: calls 100
color_singleton: calls 50
dhduncan: checks 
*** FLOP *** [Tc 7h 5s]
color_singleton: checks 
dhduncan: checks 
Klemtonius: checks 
Mafak2020: checks 
HighCardJasper: checks 
manon327: checks 
*** TURN *** [Tc 7h 5s] [Qh]
color_singleton: checks 
dhduncan: checks 
Klemtonius: checks 
Mafak2020: checks 
HighCardJasper: checks 
manon327: bets 283
color_singleton: folds 
dhduncan: folds 
Klemtonius: folds 
Mafak2020: folds 
HighCardJasper: folds 
Uncalled bet (283) returned to manon327
manon327 collected 567 from pot
*** SUMMARY ***
Total pot 600 | Rake 33 
Board [Tc 7h 5s Qh]
Seat 1: color_singleton (small blind) folded on the Turn
Seat 2: dhduncan (big blind) folded on the Turn
Seat 3: PokerStarMan123 folded before Flop (didn't bet)
Seat 4: Klemtonius folded on the Turn
Seat 6: juiceC2 folded before Flop (didn't bet)
Seat 7: Mafak2020 folded on the Turn
Seat 8: HighCardJasper folded on the Turn
Seat 9: manon327 (button) collected (567)



PokerStars Home Game Hand #225609587945: {DaPokaStars}  Hold'em No Limit (50/100) - 2021/04/07 18:01:52 ET
Table 'agian and again' 9-max (Play Money) Seat #1 is the button
Seat 1: color_singleton (21718 in chips) 
Seat 2: dhduncan (14156 in chips) 
Seat 3: PokerStarMan123 (23720 in chips) 
Seat 4: Klemtonius (16076 in chips) 
Seat 6: juiceC2 (8120 in chips) 
Seat 7: Mafak2020 (49990 in chips) 
Seat 8: HighCardJasper (3481 in chips) 
Seat 9: manon327 (5991 in chips) 
dhduncan: posts small blind 50
PokerStarMan123: posts big blind 100
*** HOLE CARDS ***
Dealt to PokerStarMan123 [3d 4d]
Klemtonius: calls 100
juiceC2: calls 100
Mafak2020: folds 
HighCardJasper: calls 100
manon327: calls 100
color_singleton: raises 200 to 300
dhduncan: folds 
PokerStarMan123: calls 200
Klemtonius: calls 200
juiceC2: calls 200
HighCardJasper: calls 200
manon327: calls 200
*** FLOP *** [Qc 7s Jc]
PokerStarMan123: checks 
Klemtonius: checks 
juiceC2: checks 
HighCardJasper: checks 
manon327: bets 874
color_singleton: calls 874
PokerStarMan123: folds 
Klemtonius: calls 874
juiceC2: folds 
HighCardJasper: folds 
*** TURN *** [Qc 7s Jc] [6h]
Klemtonius: checks 
manon327: checks 
color_singleton: bets 2113
Klemtonius: folds 
manon327: folds 
Uncalled bet (2113) returned to color_singleton
color_singleton collected 4226 from pot
color_singleton: doesn't show hand 
*** SUMMARY ***
Total pot 4472 | Rake 246 
Board [Qc 7s Jc 6h]
Seat 1: color_singleton (button) collected (4226)
Seat 2: dhduncan (small blind) folded before Flop
Seat 3: PokerStarMan123 (big blind) folded on the Flop
Seat 4: Klemtonius folded on the Turn
Seat 6: juiceC2 folded on the Flop
Seat 7: Mafak2020 folded before Flop (didn't bet)
Seat 8: HighCardJasper folded on the Flop
Seat 9: manon327 folded on the Turn



PokerStars Home Game Hand #225609638649: {DaPokaStars}  Hold'em No Limit (50/100) - 2021/04/07 18:03:23 ET
Table 'agian and again' 9-max (Play Money) Seat #3 is the button
Seat 1: color_singleton (24770 in chips) 
Seat 3: PokerStarMan123 (23420 in chips) 
Seat 4: Klemtonius (14902 in chips) 
Seat 6: juiceC2 (7820 in chips) 
Seat 7: Mafak2020 (49990 in chips) 
Seat 8: HighCardJasper (3181 in chips) 
Seat 9: manon327 (4817 in chips) 
Klemtonius: posts small blind 50
juiceC2: posts big blind 100
*** HOLE CARDS ***
Dealt to PokerStarMan123 [Ts 8c]
Mafak2020: calls 100
HighCardJasper: calls 100
manon327: calls 100
color_singleton: raises 200 to 300
PokerStarMan123 has timed out
PokerStarMan123: folds 
Klemtonius: calls 250
juiceC2: calls 200
Mafak2020: calls 200
HighCardJasper: folds 
manon327: folds 
*** FLOP *** [9d 7h Td]
Klemtonius: checks 
juiceC2: checks 
Mafak2020: checks 
color_singleton: checks 
*** TURN *** [9d 7h Td] [Tc]
Klemtonius: checks 
juiceC2: checks 
Mafak2020: checks 
color_singleton: bets 661
Klemtonius: folds 
juiceC2: folds 
Mafak2020: calls 661
*** RIVER *** [9d 7h Td Tc] [Kd]
Mafak2020: checks 
color_singleton: checks 
*** SHOW DOWN ***
Mafak2020: shows [9h Ah] (two pair, Tens and Nines)
color_singleton: mucks hand 
Mafak2020 collected 2572 from pot
*** SUMMARY ***
Total pot 2722 | Rake 150 
Board [9d 7h Td Tc Kd]
Seat 1: color_singleton mucked [As Jh]
Seat 3: PokerStarMan123 (button) folded before Flop (didn't bet)
Seat 4: Klemtonius (small blind) folded on the Turn
Seat 6: juiceC2 (big blind) folded on the Turn
Seat 7: Mafak2020 showed [9h Ah] and won (2572) with two pair, Tens and Nines
Seat 8: HighCardJasper folded before Flop
Seat 9: manon327 folded before Flop



PokerStars Home Game Hand #225609737708: {DaPokaStars}  Hold'em No Limit (50/100) - 2021/04/07 18:06:20 ET
Table 'agian and again' 9-max (Play Money) Seat #7 is the button
Seat 1: color_singleton (22871 in chips) 
Seat 2: dhduncan (13656 in chips) 
Seat 3: PokerStarMan123 (23420 in chips) 
Seat 4: Klemtonius (17491 in chips) 
Seat 6: juiceC2 (7020 in chips) 
Seat 7: Mafak2020 (51051 in chips) 
Seat 8: HighCardJasper (2681 in chips) 
Seat 9: manon327 (4417 in chips) 
HighCardJasper: posts small blind 50
manon327: posts big blind 100
*** HOLE CARDS ***
Dealt to PokerStarMan123 [Ks 8c]
color_singleton: folds 
dhduncan: calls 100
PokerStarMan123: calls 100
Klemtonius: calls 100
juiceC2: folds 
Mafak2020: folds 
HighCardJasper: calls 50
manon327: checks 
*** FLOP *** [Kh Qc 4h]
HighCardJasper: checks 
manon327: checks 
dhduncan: checks 
PokerStarMan123: bets 300
Klemtonius: raises 536 to 836
HighCardJasper: folds 
manon327: folds 
dhduncan has timed out
dhduncan: folds 
PokerStarMan123: calls 536
*** TURN *** [Kh Qc 4h] [Ts]
PokerStarMan123: checks 
Klemtonius: checks 
*** RIVER *** [Kh Qc 4h Ts] [Kc]
PokerStarMan123: bets 1300
Klemtonius: folds 
Uncalled bet (1300) returned to PokerStarMan123
PokerStarMan123 collected 2053 from pot
*** SUMMARY ***
Total pot 2172 | Rake 119 
Board [Kh Qc 4h Ts Kc]
Seat 1: color_singleton folded before Flop (didn't bet)
Seat 2: dhduncan folded on the Flop
Seat 3: PokerStarMan123 collected (2053)
Seat 4: Klemtonius folded on the River
Seat 6: juiceC2 folded before Flop (didn't bet)
Seat 7: Mafak2020 (button) folded before Flop (didn't bet)
Seat 8: HighCardJasper (small blind) folded on the Flop
Seat 9: manon327 (big blind) folded on the Flop



PokerStars Home Game Hand #225609777195: {DaPokaStars}  Hold'em No Limit (50/100) - 2021/04/07 18:07:31 ET
Table 'agian and again' 9-max (Play Money) Seat #8 is the button
Seat 1: color_singleton (22871 in chips) 
Seat 3: PokerStarMan123 (24537 in chips) 
Seat 4: Klemtonius (16555 in chips) 
Seat 6: juiceC2 (7020 in chips) 
Seat 7: Mafak2020 (51051 in chips) 
Seat 8: HighCardJasper (2581 in chips) 
Seat 9: manon327 (4317 in chips) 
manon327: posts small blind 50
color_singleton: posts big blind 100
*** HOLE CARDS ***
Dealt to PokerStarMan123 [6h Jc]
PokerStarMan123: folds 
Klemtonius: folds 
juiceC2: raises 100 to 200
Mafak2020: calls 200
HighCardJasper: calls 200
manon327: folds 
color_singleton: calls 100
*** FLOP *** [Jd 7s 3d]
color_singleton: checks 
juiceC2: bets 401
Mafak2020: folds 
HighCardJasper: folds 
color_singleton: calls 401
*** TURN *** [Jd 7s 3d] [8s]
color_singleton: checks 
juiceC2: bets 1561
color_singleton: calls 1561
*** RIVER *** [Jd 7s 3d 8s] [2s]
color_singleton: checks 
juiceC2: bets 4858 and is all-in
color_singleton: calls 4858
*** SHOW DOWN ***
juiceC2: shows [Ah Ac] (a pair of Aces)
color_singleton: shows [6s 5s] (a flush, Eight high)
color_singleton collected 13693 from pot
*** SUMMARY ***
Total pot 14490 | Rake 797 
Board [Jd 7s 3d 8s 2s]
Seat 1: color_singleton (big blind) showed [6s 5s] and won (13693) with a flush, Eight high
Seat 3: PokerStarMan123 folded before Flop (didn't bet)
Seat 4: Klemtonius folded before Flop (didn't bet)
Seat 6: juiceC2 showed [Ah Ac] and lost with a pair of Aces
Seat 7: Mafak2020 folded on the Flop
Seat 8: HighCardJasper (button) folded on the Flop
Seat 9: manon327 (small blind) folded before Flop



PokerStars Home Game Hand #225609812925: {DaPokaStars}  Hold'em No Limit (50/100) - 2021/04/07 18:08:35 ET
Table 'agian and again' 9-max (Play Money) Seat #9 is the button
Seat 1: color_singleton (29544 in chips) 
Seat 2: dhduncan (13556 in chips) 
Seat 3: PokerStarMan123 (24537 in chips) 
Seat 4: Klemtonius (16555 in chips) 
Seat 7: Mafak2020 (50851 in chips) 
Seat 8: HighCardJasper (2381 in chips) 
Seat 9: manon327 (4267 in chips) 
color_singleton: posts small blind 50
dhduncan: posts big blind 100
*** HOLE CARDS ***
Dealt to PokerStarMan123 [2s Th]
PokerStarMan123: folds 
Klemtonius: folds 
Mafak2020: calls 100
HighCardJasper: calls 100
manon327: calls 100
color_singleton: calls 50
dhduncan: checks 
*** FLOP *** [Tc 9s 3c]
color_singleton: bets 236
dhduncan: folds 
Mafak2020: raises 236 to 472
HighCardJasper: calls 472
manon327: calls 472
color_singleton: calls 236
*** TURN *** [Tc 9s 3c] [8c]
color_singleton: checks 
Mafak2020: checks 
HighCardJasper: bets 1809 and is all-in
manon327: folds 
color_singleton: folds 
Mafak2020: calls 1809
*** RIVER *** [Tc 9s 3c 8c] [Kd]
*** SHOW DOWN ***
Mafak2020: shows [Td 9h] (two pair, Tens and Nines)
HighCardJasper: shows [2c 5c] (a flush, Ten high)
HighCardJasper collected 5676 from pot
*** SUMMARY ***
Total pot 6006 | Rake 330 
Board [Tc 9s 3c 8c Kd]
Seat 1: color_singleton (small blind) folded on the Turn
Seat 2: dhduncan (big blind) folded on the Flop
Seat 3: PokerStarMan123 folded before Flop (didn't bet)
Seat 4: Klemtonius folded before Flop (didn't bet)
Seat 7: Mafak2020 showed [Td 9h] and lost with two pair, Tens and Nines
Seat 8: HighCardJasper showed [2c 5c] and won (5676) with a flush, Ten high
Seat 9: manon327 (button) folded on the Turn



PokerStars Home Game Hand #225609851697: {DaPokaStars}  Hold'em No Limit (50/100) - 2021/04/07 18:09:45 ET
Table 'agian and again' 9-max (Play Money) Seat #1 is the button
Seat 1: color_singleton (28972 in chips) 
Seat 2: dhduncan (13456 in chips) 
Seat 3: PokerStarMan123 (24537 in chips) 
Seat 4: Klemtonius (16555 in chips) 
Seat 6: juiceC2 (10000 in chips) 
Seat 7: Mafak2020 (48470 in chips) 
Seat 8: HighCardJasper (5676 in chips) 
Seat 9: manon327 (3695 in chips) 
dhduncan: posts small blind 50
PokerStarMan123: posts big blind 100
*** HOLE CARDS ***
Dealt to PokerStarMan123 [Ac 6d]
Klemtonius: raises 100 to 200
juiceC2: folds 
Mafak2020: folds 
HighCardJasper: calls 200
manon327: folds 
color_singleton: folds 
dhduncan: folds 
PokerStarMan123: calls 100
*** FLOP *** [Jd 2c Kd]
PokerStarMan123: checks 
Klemtonius: checks 
HighCardJasper: checks 
*** TURN *** [Jd 2c Kd] [6h]
PokerStarMan123: checks 
Klemtonius: bets 614
HighCardJasper: folds 
PokerStarMan123: folds 
Uncalled bet (614) returned to Klemtonius
Klemtonius collected 614 from pot
Klemtonius: doesn't show hand 
*** SUMMARY ***
Total pot 650 | Rake 36 
Board [Jd 2c Kd 6h]
Seat 1: color_singleton (button) folded before Flop (didn't bet)
Seat 2: dhduncan (small blind) folded before Flop
Seat 3: PokerStarMan123 (big blind) folded on the Turn
Seat 4: Klemtonius collected (614)
Seat 6: juiceC2 folded before Flop (didn't bet)
Seat 7: Mafak2020 folded before Flop (didn't bet)
Seat 8: HighCardJasper folded on the Turn
Seat 9: manon327 folded before Flop (didn't bet)



PokerStars Home Game Hand #225609871970: {DaPokaStars}  Hold'em No Limit (50/100) - 2021/04/07 18:10:22 ET
Table 'agian and again' 9-max (Play Money) Seat #2 is the button
Seat 1: color_singleton (28972 in chips) 
Seat 2: dhduncan (13406 in chips) 
Seat 3: PokerStarMan123 (24337 in chips) 
Seat 4: Klemtonius (16969 in chips) 
Seat 6: juiceC2 (10000 in chips) 
Seat 7: Mafak2020 (48470 in chips) 
Seat 8: HighCardJasper (5476 in chips) 
Seat 9: manon327 (3695 in chips) 
PokerStarMan123: posts small blind 50
Klemtonius: posts big blind 100
*** HOLE CARDS ***
Dealt to PokerStarMan123 [Ts 7h]
juiceC2: folds 
Mafak2020: raises 100 to 200
HighCardJasper: calls 200
manon327: folds 
color_singleton: folds 
dhduncan: calls 200
PokerStarMan123: folds 
Klemtonius: calls 100
*** FLOP *** [7c Kd Ad]
Klemtonius: checks 
Mafak2020: checks 
HighCardJasper: checks 
dhduncan: checks 
*** TURN *** [7c Kd Ad] [9h]
Klemtonius: checks 
Mafak2020: checks 
HighCardJasper: checks 
dhduncan: checks 
*** RIVER *** [7c Kd Ad 9h] [3d]
Klemtonius: checks 
Mafak2020: checks 
HighCardJasper: bets 401
dhduncan: folds 
Klemtonius: folds 
Mafak2020: calls 401
*** SHOW DOWN ***
HighCardJasper: shows [Ks 6c] (a pair of Kings)
Mafak2020: mucks hand 
HighCardJasper collected 1561 from pot
*** SUMMARY ***
Total pot 1652 | Rake 91 
Board [7c Kd Ad 9h 3d]
Seat 1: color_singleton folded before Flop (didn't bet)
Seat 2: dhduncan (button) folded on the River
Seat 3: PokerStarMan123 (small blind) folded before Flop
Seat 4: Klemtonius (big blind) folded on the River
Seat 6: juiceC2 folded before Flop (didn't bet)
Seat 7: Mafak2020 mucked [Jc Jd]
Seat 8: HighCardJasper showed [Ks 6c] and won (1561) with a pair of Kings
Seat 9: manon327 folded before Flop (didn't bet)



PokerStars Home Game Hand #225609918772: {DaPokaStars}  Hold'em No Limit (50/100) - 2021/04/07 18:11:47 ET
Table 'agian and again' 9-max (Play Money) Seat #3 is the button
Seat 1: color_singleton (28972 in chips) 
Seat 2: dhduncan (13206 in chips) 
Seat 3: PokerStarMan123 (24287 in chips) 
Seat 4: Klemtonius (16769 in chips) 
Seat 6: juiceC2 (10000 in chips) 
Seat 7: Mafak2020 (47869 in chips) 
Seat 8: HighCardJasper (6436 in chips) 
Seat 9: manon327 (3695 in chips) 
Klemtonius: posts small blind 50
juiceC2: posts big blind 100
*** HOLE CARDS ***
Dealt to PokerStarMan123 [7c 6h]
Mafak2020: folds 
HighCardJasper: calls 100
manon327: calls 100
color_singleton: folds 
dhduncan: folds 
PokerStarMan123: calls 100
Klemtonius: calls 50
juiceC2: checks 
*** FLOP *** [Td 5h 9s]
Klemtonius: checks 
juiceC2: checks 
HighCardJasper: checks 
manon327: checks 
PokerStarMan123: checks 
*** TURN *** [Td 5h 9s] [5d]
Klemtonius: checks 
juiceC2: checks 
HighCardJasper: checks 
manon327: checks 
PokerStarMan123: checks 
*** RIVER *** [Td 5h 9s 5d] [3s]
Klemtonius: checks 
juiceC2: checks 
HighCardJasper: bets 236
manon327: folds 
PokerStarMan123: folds 
Klemtonius: folds 
juiceC2: calls 236
*** SHOW DOWN ***
HighCardJasper: shows [3h 9h] (two pair, Nines and Fives)
juiceC2: shows [9d Js] (two pair, Nines and Fives - Jack kicker)
juiceC2 collected 919 from pot
*** SUMMARY ***
Total pot 972 | Rake 53 
Board [Td 5h 9s 5d 3s]
Seat 1: color_singleton folded before Flop (didn't bet)
Seat 2: dhduncan folded before Flop (didn't bet)
Seat 3: PokerStarMan123 (button) folded on the River
Seat 4: Klemtonius (small blind) folded on the River
Seat 6: juiceC2 (big blind) showed [9d Js] and won (919) with two pair, Nines and Fives
Seat 7: Mafak2020 folded before Flop (didn't bet)
Seat 8: HighCardJasper showed [3h 9h] and lost with two pair, Nines and Fives
Seat 9: manon327 folded on the River



PokerStars Home Game Hand #225609964971: {DaPokaStars}  Hold'em No Limit (50/100) - 2021/04/07 18:13:12 ET
Table 'agian and again' 9-max (Play Money) Seat #4 is the button
Seat 1: color_singleton (28972 in chips) 
Seat 2: dhduncan (13206 in chips) 
Seat 3: PokerStarMan123 (24187 in chips) 
Seat 4: Klemtonius (16669 in chips) 
Seat 6: juiceC2 (10583 in chips) 
Seat 7: Mafak2020 (47869 in chips) 
Seat 8: HighCardJasper (6100 in chips) 
Seat 9: manon327 (3595 in chips) 
juiceC2: posts small blind 50
Mafak2020: posts big blind 100
*** HOLE CARDS ***
Dealt to PokerStarMan123 [7d 6c]
HighCardJasper: folds 
manon327: calls 100
color_singleton: calls 100
dhduncan: folds 
PokerStarMan123: calls 100
Klemtonius: calls 100
juiceC2: calls 50
Mafak2020: checks 
*** FLOP *** [Ad 8d Qd]
juiceC2: checks 
Mafak2020: checks 
manon327: checks 
color_singleton: checks 
PokerStarMan123: checks 
Klemtonius: checks 
*** TURN *** [Ad 8d Qd] [4s]
juiceC2: checks 
Mafak2020: checks 
manon327: checks 
color_singleton: checks 
PokerStarMan123: checks 
Klemtonius: checks 
*** RIVER *** [Ad 8d Qd 4s] [Ks]
juiceC2: bets 283
Mafak2020: folds 
manon327: folds 
color_singleton: calls 283
PokerStarMan123: folds 
Klemtonius: folds 
*** SHOW DOWN ***
juiceC2: shows [3d Kc] (a pair of Kings)
color_singleton: mucks hand 
juiceC2 collected 1102 from pot
*** SUMMARY ***
Total pot 1166 | Rake 64 
Board [Ad 8d Qd 4s Ks]
Seat 1: color_singleton mucked [Js 8s]
Seat 2: dhduncan folded before Flop (didn't bet)
Seat 3: PokerStarMan123 folded on the River
Seat 4: Klemtonius (button) folded on the River
Seat 6: juiceC2 (small blind) showed [3d Kc] and won (1102) with a pair of Kings
Seat 7: Mafak2020 (big blind) folded on the River
Seat 8: HighCardJasper folded before Flop (didn't bet)
Seat 9: manon327 folded on the River



PokerStars Home Game Hand #225610018800: {DaPokaStars}  Hold'em No Limit (50/100) - 2021/04/07 18:14:52 ET
Table 'agian and again' 9-max (Play Money) Seat #6 is the button
Seat 1: color_singleton (28589 in chips) 
Seat 2: dhduncan (13206 in chips) 
Seat 3: PokerStarMan123 (24087 in chips) 
Seat 4: Klemtonius (16569 in chips) 
Seat 6: juiceC2 (11302 in chips) 
Seat 7: Mafak2020 (47769 in chips) 
Seat 8: HighCardJasper (6100 in chips) 
Seat 9: manon327 (3495 in chips) 
Mafak2020: posts small blind 50
HighCardJasper: posts big blind 100
*** HOLE CARDS ***
Dealt to PokerStarMan123 [Ah 7c]
manon327: folds 
color_singleton: raises 200 to 300
dhduncan: folds 
PokerStarMan123: calls 300
Klemtonius: folds 
juiceC2: calls 300
Mafak2020: raises 200 to 500
HighCardJasper: folds 
color_singleton: calls 200
PokerStarMan123: calls 200
juiceC2: calls 200
*** FLOP *** [3c 7d 9h]
Mafak2020: checks 
color_singleton: checks 
PokerStarMan123: checks 
juiceC2: checks 
*** TURN *** [3c 7d 9h] [Qs]
Mafak2020: checks 
color_singleton: checks 
PokerStarMan123: checks 
juiceC2: checks 
*** RIVER *** [3c 7d 9h Qs] [Ts]
Mafak2020: checks 
color_singleton: bets 1000
PokerStarMan123: folds 
juiceC2: folds 
Mafak2020: raises 1000 to 2000
color_singleton: calls 1000
*** SHOW DOWN ***
Mafak2020: shows [Tc 9c] (two pair, Tens and Nines)
color_singleton: shows [Js Ks] (a straight, Nine to King)
color_singleton collected 5764 from pot
*** SUMMARY ***
Total pot 6100 | Rake 336 
Board [3c 7d 9h Qs Ts]
Seat 1: color_singleton showed [Js Ks] and won (5764) with a straight, Nine to King
Seat 2: dhduncan folded before Flop (didn't bet)
Seat 3: PokerStarMan123 folded on the River
Seat 4: Klemtonius folded before Flop (didn't bet)
Seat 6: juiceC2 (button) folded on the River
Seat 7: Mafak2020 (small blind) showed [Tc 9c] and lost with two pair, Tens and Nines
Seat 8: HighCardJasper (big blind) folded before Flop
Seat 9: manon327 folded before Flop (didn't bet)



PokerStars Home Game Hand #225610076698: {DaPokaStars}  Hold'em No Limit (50/100) - 2021/04/07 18:16:38 ET
Table 'agian and again' 9-max (Play Money) Seat #7 is the button
Seat 1: color_singleton (31853 in chips) 
Seat 2: dhduncan (13206 in chips) 
Seat 3: PokerStarMan123 (23587 in chips) 
Seat 4: Klemtonius (16569 in chips) 
Seat 6: juiceC2 (10802 in chips) 
Seat 7: Mafak2020 (45269 in chips) 
Seat 8: HighCardJasper (6000 in chips) 
Seat 9: manon327 (3495 in chips) 
HighCardJasper: posts small blind 50
manon327: posts big blind 100
*** HOLE CARDS ***
Dealt to PokerStarMan123 [As 6d]
color_singleton: folds 
dhduncan: folds 
PokerStarMan123: calls 100
Klemtonius: raises 100 to 200
juiceC2: calls 200
Mafak2020: calls 200
HighCardJasper: folds 
manon327: folds 
PokerStarMan123: calls 100
*** FLOP *** [7s 4d 8d]
PokerStarMan123: checks 
Klemtonius: checks 
juiceC2: checks 
Mafak2020: checks 
*** TURN *** [7s 4d 8d] [Js]
PokerStarMan123: checks 
Klemtonius: checks 
juiceC2: checks 
Mafak2020: checks 
*** RIVER *** [7s 4d 8d Js] [Kc]
PokerStarMan123: checks 
Klemtonius: checks 
juiceC2: checks 
Mafak2020: bets 400
PokerStarMan123: folds 
Klemtonius: folds 
juiceC2: folds 
Uncalled bet (400) returned to Mafak2020
Mafak2020 collected 898 from pot
Mafak2020: doesn't show hand 
*** SUMMARY ***
Total pot 950 | Rake 52 
Board [7s 4d 8d Js Kc]
Seat 1: color_singleton folded before Flop (didn't bet)
Seat 2: dhduncan folded before Flop (didn't bet)
Seat 3: PokerStarMan123 folded on the River
Seat 4: Klemtonius folded on the River
Seat 6: juiceC2 folded on the River
Seat 7: Mafak2020 (button) collected (898)
Seat 8: HighCardJasper (small blind) folded before Flop
Seat 9: manon327 (big blind) folded before Flop



PokerStars Home Game Hand #225610124099: {DaPokaStars}  Hold'em No Limit (50/100) - 2021/04/07 18:18:07 ET
Table 'agian and again' 9-max (Play Money) Seat #8 is the button
Seat 1: color_singleton (31853 in chips) 
Seat 2: dhduncan (13206 in chips) 
Seat 3: PokerStarMan123 (23387 in chips) 
Seat 4: Klemtonius (16369 in chips) 
Seat 6: juiceC2 (10602 in chips) 
Seat 7: Mafak2020 (45967 in chips) 
Seat 8: HighCardJasper (5950 in chips) 
Seat 9: manon327 (3395 in chips) 
manon327: posts small blind 50
color_singleton: posts big blind 100
*** HOLE CARDS ***
Dealt to PokerStarMan123 [4d Ah]
dhduncan: calls 100
PokerStarMan123: calls 100
Klemtonius: raises 450 to 550
juiceC2: folds 
Mafak2020: calls 550
HighCardJasper: folds 
manon327: folds 
color_singleton: folds 
dhduncan: folds 
PokerStarMan123: folds 
*** FLOP *** [Qc Jc 5h]
Klemtonius: checks 
Mafak2020: checks 
*** TURN *** [Qc Jc 5h] [4c]
Klemtonius: bets 685
Mafak2020: folds 
Uncalled bet (685) returned to Klemtonius
Klemtonius collected 1370 from pot
Klemtonius: doesn't show hand 
*** SUMMARY ***
Total pot 1450 | Rake 80 
Board [Qc Jc 5h 4c]
Seat 1: color_singleton (big blind) folded before Flop
Seat 2: dhduncan folded before Flop
Seat 3: PokerStarMan123 folded before Flop
Seat 4: Klemtonius collected (1370)
Seat 6: juiceC2 folded before Flop (didn't bet)
Seat 7: Mafak2020 folded on the Turn
Seat 8: HighCardJasper (button) folded before Flop (didn't bet)
Seat 9: manon327 (small blind) folded before Flop



PokerStars Home Game Hand #225610151911: {DaPokaStars}  Hold'em No Limit (50/100) - 2021/04/07 18:19:00 ET
Table 'agian and again' 9-max (Play Money) Seat #9 is the button
Seat 1: color_singleton (31753 in chips) 
Seat 2: dhduncan (13106 in chips) 
Seat 3: PokerStarMan123 (23287 in chips) 
Seat 4: Klemtonius (17189 in chips) 
Seat 6: juiceC2 (10602 in chips) 
Seat 7: Mafak2020 (45417 in chips) 
Seat 8: HighCardJasper (5950 in chips) 
Seat 9: manon327 (3345 in chips) 
color_singleton: posts small blind 50
dhduncan: posts big blind 100
*** HOLE CARDS ***
Dealt to PokerStarMan123 [Td 8s]
PokerStarMan123: folds 
Klemtonius: folds 
juiceC2: calls 100
Mafak2020: folds 
HighCardJasper: calls 100
manon327: calls 100
color_singleton: raises 200 to 300
dhduncan: folds 
juiceC2: calls 200
HighCardJasper: calls 200
manon327: calls 200
*** FLOP *** [Jh Kh 2h]
color_singleton: checks 
juiceC2: checks 
HighCardJasper: bets 614
manon327: raises 614 to 1228
color_singleton: calls 1228
juiceC2: folds 
HighCardJasper: folds 
*** TURN *** [Jh Kh 2h] [9c]
color_singleton: bets 2065
manon327: calls 1817 and is all-in
Uncalled bet (248) returned to color_singleton
*** RIVER *** [Jh Kh 2h 9c] [Ad]
*** SHOW DOWN ***
color_singleton: shows [Qh Ah] (a flush, Ace high)
manon327: shows [Jd Th] (a pair of Jacks)
color_singleton collected 7564 from pot
*** SUMMARY ***
Total pot 8004 | Rake 440 
Board [Jh Kh 2h 9c Ad]
Seat 1: color_singleton (small blind) showed [Qh Ah] and won (7564) with a flush, Ace high
Seat 2: dhduncan (big blind) folded before Flop
Seat 3: PokerStarMan123 folded before Flop (didn't bet)
Seat 4: Klemtonius folded before Flop (didn't bet)
Seat 6: juiceC2 folded on the Flop
Seat 7: Mafak2020 folded before Flop (didn't bet)
Seat 8: HighCardJasper folded on the Flop
Seat 9: manon327 (button) showed [Jd Th] and lost with a pair of Jacks



PokerStars Home Game Hand #225610197782: {DaPokaStars}  Hold'em No Limit (50/100) - 2021/04/07 18:20:27 ET
Table 'agian and again' 9-max (Play Money) Seat #1 is the button
Seat 1: color_singleton (35972 in chips) 
Seat 2: dhduncan (13006 in chips) 
Seat 3: PokerStarMan123 (23287 in chips) 
Seat 4: Klemtonius (17189 in chips) 
Seat 6: juiceC2 (10302 in chips) 
Seat 7: Mafak2020 (45417 in chips) 
Seat 8: HighCardJasper (5036 in chips) 
dhduncan: posts small blind 50
PokerStarMan123: posts big blind 100
*** HOLE CARDS ***
Dealt to PokerStarMan123 [Kc 2d]
Klemtonius: raises 100 to 200
juiceC2: folds 
Mafak2020: calls 200
HighCardJasper: calls 200
color_singleton: calls 200
dhduncan: folds 
PokerStarMan123: calls 100
*** FLOP *** [9d Td 5d]
PokerStarMan123: checks 
Klemtonius: bets 992
Mafak2020: raises 992 to 1984
HighCardJasper: folds 
color_singleton: folds 
PokerStarMan123: folds 
Klemtonius: calls 992
*** TURN *** [9d Td 5d] [4s]
manon327 leaves the table
Klemtonius: checks 
Mafak2020: checks 
*** RIVER *** [9d Td 5d 4s] [5c]
Klemtonius: bets 15005 and is all-in
Mafak2020: calls 15005
*** SHOW DOWN ***
Klemtonius: shows [Jc Ks] (a pair of Fives)
Mafak2020: shows [3d 7d] (a flush, Ten high)
Mafak2020 collected 33101 from pot
*** SUMMARY ***
Total pot 35028 | Rake 1927 
Board [9d Td 5d 4s 5c]
Seat 1: color_singleton (button) folded on the Flop
Seat 2: dhduncan (small blind) folded before Flop
Seat 3: PokerStarMan123 (big blind) folded on the Flop
Seat 4: Klemtonius showed [Jc Ks] and lost with a pair of Fives
Seat 6: juiceC2 folded before Flop (didn't bet)
Seat 7: Mafak2020 showed [3d 7d] and won (33101) with a flush, Ten high
Seat 8: HighCardJasper folded on the Flop



PokerStars Home Game Hand #225610243707: {DaPokaStars}  Hold'em No Limit (50/100) - 2021/04/07 18:21:39 ET
Table 'agian and again' 9-max (Play Money) Seat #2 is the button
Seat 1: color_singleton (35772 in chips) 
Seat 2: dhduncan (12956 in chips) 
Seat 3: PokerStarMan123 (23087 in chips) 
Seat 6: juiceC2 (10302 in chips) 
Seat 7: Mafak2020 (61329 in chips) 
Seat 8: HighCardJasper (4836 in chips) 
PokerStarMan123: posts small blind 50
juiceC2: posts big blind 100
*** HOLE CARDS ***
Dealt to PokerStarMan123 [7c 4d]
Mafak2020: calls 100
HighCardJasper: calls 100
color_singleton: folds 
dhduncan: folds 
PokerStarMan123: folds 
juiceC2: checks 
*** FLOP *** [6h 2h Tc]
juiceC2: checks 
Mafak2020: checks 
HighCardJasper: checks 
*** TURN *** [6h 2h Tc] [As]
juiceC2: checks 
Mafak2020: checks 
HighCardJasper: checks 
*** RIVER *** [6h 2h Tc As] [Jc]
juiceC2: bets 331
Mafak2020: folds 
HighCardJasper: folds 
Uncalled bet (331) returned to juiceC2
juiceC2 collected 331 from pot
juiceC2: doesn't show hand 
*** SUMMARY ***
Total pot 350 | Rake 19 
Board [6h 2h Tc As Jc]
Seat 1: color_singleton folded before Flop (didn't bet)
Seat 2: dhduncan (button) folded before Flop (didn't bet)
Seat 3: PokerStarMan123 (small blind) folded before Flop
Seat 6: juiceC2 (big blind) collected (331)
Seat 7: Mafak2020 folded on the River
Seat 8: HighCardJasper folded on the River



PokerStars Home Game Hand #225610280872: {DaPokaStars}  Hold'em No Limit (50/100) - 2021/04/07 18:22:50 ET
Table 'agian and again' 9-max (Play Money) Seat #3 is the button
Seat 1: color_singleton (35772 in chips) 
Seat 2: dhduncan (12956 in chips) 
Seat 3: PokerStarMan123 (23037 in chips) 
Seat 6: juiceC2 (10533 in chips) 
Seat 7: Mafak2020 (61229 in chips) 
Seat 8: HighCardJasper (4736 in chips) 
juiceC2: posts small blind 50
Mafak2020: posts big blind 100
*** HOLE CARDS ***
Dealt to PokerStarMan123 [4d Qh]
HighCardJasper: calls 100
color_singleton: calls 100
dhduncan: calls 100
PokerStarMan123: folds 
juiceC2: folds 
Mafak2020: checks 
*** FLOP *** [9d 2c Ah]
Mafak2020: checks 
HighCardJasper: checks 
color_singleton: checks 
dhduncan: checks 
*** TURN *** [9d 2c Ah] [Kd]
Mafak2020: checks 
HighCardJasper: checks 
color_singleton: bets 212
dhduncan: calls 212
Mafak2020: calls 212
HighCardJasper: folds 
*** RIVER *** [9d 2c Ah Kd] [5s]
Mafak2020: checks 
color_singleton: checks 
Klemtonius leaves the table
dhduncan: checks 
*** SHOW DOWN ***
Mafak2020: shows [Qs 7d] (high card Ace)
color_singleton: shows [Kc 3c] (a pair of Kings)
dhduncan: shows [Qc Kh] (a pair of Kings - Ace+Queen kicker)
dhduncan collected 1026 from pot
*** SUMMARY ***
Total pot 1086 | Rake 60 
Board [9d 2c Ah Kd 5s]
Seat 1: color_singleton showed [Kc 3c] and lost with a pair of Kings
Seat 2: dhduncan showed [Qc Kh] and won (1026) with a pair of Kings
Seat 3: PokerStarMan123 (button) folded before Flop (didn't bet)
Seat 6: juiceC2 (small blind) folded before Flop
Seat 7: Mafak2020 (big blind) showed [Qs 7d] and lost with high card Ace
Seat 8: HighCardJasper folded on the Turn



PokerStars Home Game Hand #225610322454: {DaPokaStars}  Hold'em No Limit (50/100) - 2021/04/07 18:24:06 ET
Table 'agian and again' 9-max (Play Money) Seat #6 is the button
Seat 1: color_singleton (35460 in chips) 
Seat 2: dhduncan (13670 in chips) 
Seat 3: PokerStarMan123 (23037 in chips) 
Seat 6: juiceC2 (10483 in chips) 
Seat 7: Mafak2020 (60917 in chips) 
Seat 8: HighCardJasper (4636 in chips) 
Mafak2020: posts small blind 50
HighCardJasper: posts big blind 100
*** HOLE CARDS ***
Dealt to PokerStarMan123 [3s Tc]
color_singleton: raises 200 to 300
dhduncan: folds 
PokerStarMan123: folds 
juiceC2: folds 
Mafak2020: folds 
HighCardJasper: calls 200
*** FLOP *** [7c 4h 4c]
HighCardJasper: checks 
color_singleton: checks 
*** TURN *** [7c 4h 4c] [5h]
HighCardJasper: checks 
color_singleton: bets 307
HighCardJasper: folds 
Uncalled bet (307) returned to color_singleton
color_singleton collected 614 from pot
color_singleton: doesn't show hand 
*** SUMMARY ***
Total pot 650 | Rake 36 
Board [7c 4h 4c 5h]
Seat 1: color_singleton collected (614)
Seat 2: dhduncan folded before Flop (didn't bet)
Seat 3: PokerStarMan123 folded before Flop (didn't bet)
Seat 6: juiceC2 (button) folded before Flop (didn't bet)
Seat 7: Mafak2020 (small blind) folded before Flop
Seat 8: HighCardJasper (big blind) folded on the Turn



PokerStars Home Game Hand #225610336614: {DaPokaStars}  Hold'em No Limit (50/100) - 2021/04/07 18:24:33 ET
Table 'agian and again' 9-max (Play Money) Seat #7 is the button
Seat 1: color_singleton (35774 in chips) 
Seat 2: dhduncan (13670 in chips) 
Seat 3: PokerStarMan123 (23037 in chips) 
Seat 6: juiceC2 (10483 in chips) 
Seat 7: Mafak2020 (60867 in chips) 
Seat 8: HighCardJasper (4336 in chips) 
HighCardJasper: posts small blind 50
color_singleton: posts big blind 100
*** HOLE CARDS ***
Dealt to PokerStarMan123 [4h Th]
dhduncan: folds 
PokerStarMan123: folds 
juiceC2: calls 100
Mafak2020: calls 100
HighCardJasper: calls 50
color_singleton: checks 
*** FLOP *** [4d 7c 2h]
HighCardJasper: checks 
color_singleton: checks 
juiceC2: checks 
Mafak2020: checks 
*** TURN *** [4d 7c 2h] [Qd]
HighCardJasper: checks 
color_singleton: checks 
juiceC2: checks 
Mafak2020: checks 
*** RIVER *** [4d 7c 2h Qd] [Ah]
HighCardJasper: checks 
color_singleton: checks 
juiceC2: bets 378
Mafak2020: folds 
HighCardJasper: folds 
color_singleton: folds 
Uncalled bet (378) returned to juiceC2
juiceC2 collected 378 from pot
juiceC2: doesn't show hand 
*** SUMMARY ***
Total pot 400 | Rake 22 
Board [4d 7c 2h Qd Ah]
Seat 1: color_singleton (big blind) folded on the River
Seat 2: dhduncan folded before Flop (didn't bet)
Seat 3: PokerStarMan123 folded before Flop (didn't bet)
Seat 6: juiceC2 collected (378)
Seat 7: Mafak2020 (button) folded on the River
Seat 8: HighCardJasper (small blind) folded on the River



PokerStars Home Game Hand #225610362815: {DaPokaStars}  Hold'em No Limit (50/100) - 2021/04/07 18:25:24 ET
Table 'agian and again' 9-max (Play Money) Seat #8 is the button
Seat 1: color_singleton (35674 in chips) 
Seat 2: dhduncan (13670 in chips) 
Seat 3: PokerStarMan123 (23037 in chips) 
Seat 6: juiceC2 (10761 in chips) 
Seat 7: Mafak2020 (60767 in chips) 
Seat 8: HighCardJasper (4236 in chips) 
color_singleton: posts small blind 50
dhduncan: posts big blind 100
*** HOLE CARDS ***
Dealt to PokerStarMan123 [As 8c]
PokerStarMan123: calls 100
juiceC2: raises 200 to 300
Mafak2020: folds 
HighCardJasper: calls 300
color_singleton: folds 
dhduncan: calls 200
PokerStarMan123: calls 200
*** FLOP *** [Td Qc 7h]
dhduncan: checks 
PokerStarMan123: checks 
juiceC2: bets 500
HighCardJasper: folds 
dhduncan: folds 
PokerStarMan123: folds 
Uncalled bet (500) returned to juiceC2
juiceC2 collected 1181 from pot
juiceC2: doesn't show hand 
*** SUMMARY ***
Total pot 1250 | Rake 69 
Board [Td Qc 7h]
Seat 1: color_singleton (small blind) folded before Flop
Seat 2: dhduncan (big blind) folded on the Flop
Seat 3: PokerStarMan123 folded on the Flop
Seat 6: juiceC2 collected (1181)
Seat 7: Mafak2020 folded before Flop (didn't bet)
Seat 8: HighCardJasper (button) folded on the Flop



PokerStars Home Game Hand #225610383771: {DaPokaStars}  Hold'em No Limit (50/100) - 2021/04/07 18:26:05 ET
Table 'agian and again' 9-max (Play Money) Seat #1 is the button
Seat 1: color_singleton (35624 in chips) 
Seat 2: dhduncan (13370 in chips) 
Seat 3: PokerStarMan123 (22737 in chips) 
Seat 6: juiceC2 (11642 in chips) 
Seat 7: Mafak2020 (60767 in chips) 
Seat 8: HighCardJasper (3936 in chips) 
dhduncan: posts small blind 50
PokerStarMan123: posts big blind 100
*** HOLE CARDS ***
Dealt to PokerStarMan123 [Qs Jc]
juiceC2: raises 200 to 300
Mafak2020: calls 300
HighCardJasper: folds 
color_singleton: calls 300
dhduncan: calls 250
PokerStarMan123: calls 200
*** FLOP *** [3c Qd Jd]
dhduncan: checks 
PokerStarMan123: checks 
juiceC2: bets 708
Mafak2020: folds 
color_singleton: calls 708
dhduncan: calls 708
PokerStarMan123: raises 1092 to 1800
juiceC2: raises 9542 to 11342 and is all-in
color_singleton: folds 
dhduncan: folds 
PokerStarMan123: calls 9542
*** TURN *** [3c Qd Jd] [7d]
*** RIVER *** [3c Qd Jd 7d] [4d]
*** SHOW DOWN ***
PokerStarMan123: shows [Qs Jc] (two pair, Queens and Jacks)
juiceC2: shows [Ad Ah] (a flush, Ace high)
juiceC2 collected 24192 from pot
*** SUMMARY ***
Total pot 25600 | Rake 1408 
Board [3c Qd Jd 7d 4d]
Seat 1: color_singleton (button) folded on the Flop
Seat 2: dhduncan (small blind) folded on the Flop
Seat 3: PokerStarMan123 (big blind) showed [Qs Jc] and lost with two pair, Queens and Jacks
Seat 6: juiceC2 showed [Ad Ah] and won (24192) with a flush, Ace high
Seat 7: Mafak2020 folded on the Flop
Seat 8: HighCardJasper folded before Flop (didn't bet)



PokerStars Home Game Hand #225610428855: {DaPokaStars}  Hold'em No Limit (50/100) - 2021/04/07 18:27:34 ET
Table 'agian and again' 9-max (Play Money) Seat #2 is the button
Seat 1: color_singleton (34616 in chips) 
Seat 2: dhduncan (12362 in chips) 
Seat 3: PokerStarMan123 (11095 in chips) 
Seat 6: juiceC2 (24192 in chips) 
Seat 7: Mafak2020 (60467 in chips) 
Seat 8: HighCardJasper (3936 in chips) 
PokerStarMan123: posts small blind 50
juiceC2: posts big blind 100
*** HOLE CARDS ***
Dealt to PokerStarMan123 [5c 3c]
Mafak2020: calls 100
HighCardJasper: calls 100
color_singleton: raises 200 to 300
dhduncan: calls 300
PokerStarMan123: calls 250
juiceC2: calls 200
Mafak2020: folds 
HighCardJasper: folds 
*** FLOP *** [6c Ks Qh]
PokerStarMan123: checks 
juiceC2: checks 
color_singleton: checks 
dhduncan: checks 
*** TURN *** [6c Ks Qh] [4c]
PokerStarMan123: checks 
juiceC2: bets 100
color_singleton: raises 400 to 500
dhduncan: folds 
PokerStarMan123: folds 
juiceC2: calls 400
*** RIVER *** [6c Ks Qh 4c] [9h]
juiceC2: checks 
color_singleton: bets 1134
juiceC2: calls 1134
*** SHOW DOWN ***
color_singleton: shows [4d 4h] (three of a kind, Fours)
juiceC2: mucks hand 
color_singleton collected 4411 from pot
*** SUMMARY ***
Total pot 4668 | Rake 257 
Board [6c Ks Qh 4c 9h]
Seat 1: color_singleton showed [4d 4h] and won (4411) with three of a kind, Fours
Seat 2: dhduncan (button) folded on the Turn
Seat 3: PokerStarMan123 (small blind) folded on the Turn
Seat 6: juiceC2 (big blind) mucked [Tc Kd]
Seat 7: Mafak2020 folded before Flop
Seat 8: HighCardJasper folded before Flop



PokerStars Home Game Hand #225610472925: {DaPokaStars}  Hold'em No Limit (50/100) - 2021/04/07 18:29:02 ET
Table 'agian and again' 9-max (Play Money) Seat #3 is the button
Seat 1: color_singleton (37093 in chips) 
Seat 2: dhduncan (12062 in chips) 
Seat 3: PokerStarMan123 (10795 in chips) 
Seat 6: juiceC2 (22258 in chips) 
Seat 7: Mafak2020 (60367 in chips) 
Seat 8: HighCardJasper (3836 in chips) 
juiceC2: posts small blind 50
Mafak2020: posts big blind 100
*** HOLE CARDS ***
Dealt to PokerStarMan123 [6s Qh]
HighCardJasper: calls 100
color_singleton: calls 100
dhduncan: calls 100
PokerStarMan123: folds 
juiceC2: calls 50
Mafak2020: checks 
*** FLOP *** [Kc Ad 5h]
juiceC2: checks 
Mafak2020: checks 
HighCardJasper: checks 
color_singleton: checks 
dhduncan: checks 
*** TURN *** [Kc Ad 5h] [Ts]
juiceC2: checks 
Mafak2020: checks 
HighCardJasper: checks 
color_singleton: checks 
dhduncan: checks 
*** RIVER *** [Kc Ad 5h Ts] [Jh]
juiceC2: checks 
Mafak2020: checks 
HighCardJasper: checks 
color_singleton: checks 
dhduncan: checks 
*** SHOW DOWN ***
juiceC2: shows [7h 8d] (high card Ace)
Mafak2020: shows [4h 9d] (high card Ace - King+Jack+Ten+Nine kicker)
HighCardJasper: shows [9h 6h] (high card Ace)
color_singleton: mucks hand 
dhduncan: shows [8s Qs] (a straight, Ten to Ace)
dhduncan collected 472 from pot
*** SUMMARY ***
Total pot 500 | Rake 28 
Board [Kc Ad 5h Ts Jh]
Seat 1: color_singleton mucked [8h 7c]
Seat 2: dhduncan showed [8s Qs] and won (472) with a straight, Ten to Ace
Seat 3: PokerStarMan123 (button) folded before Flop (didn't bet)
Seat 6: juiceC2 (small blind) showed [7h 8d] and lost with high card Ace
Seat 7: Mafak2020 (big blind) showed [4h 9d] and lost with high card Ace
Seat 8: HighCardJasper showed [9h 6h] and lost with high card Ace



PokerStars Home Game Hand #225610503364: {DaPokaStars}  Hold'em No Limit (50/100) - 2021/04/07 18:30:03 ET
Table 'agian and again' 9-max (Play Money) Seat #6 is the button
Seat 1: color_singleton (36993 in chips) 
Seat 2: dhduncan (12434 in chips) 
Seat 3: PokerStarMan123 (10795 in chips) 
Seat 6: juiceC2 (22158 in chips) 
Seat 7: Mafak2020 (60267 in chips) 
Seat 8: HighCardJasper (3736 in chips) 
Mafak2020: posts small blind 50
HighCardJasper: posts big blind 100
*** HOLE CARDS ***
Dealt to PokerStarMan123 [Kd 7c]
color_singleton: folds 
dhduncan: folds 
PokerStarMan123: calls 100
juiceC2: calls 100
Mafak2020: calls 50
HighCardJasper: raises 200 to 300
PokerStarMan123: calls 200
juiceC2: calls 200
Mafak2020: calls 200
*** FLOP *** [Ad 6d Js]
Mafak2020: bets 1400
HighCardJasper: folds 
PokerStarMan123: folds 
juiceC2: folds 
Uncalled bet (1400) returned to Mafak2020
Mafak2020 collected 1134 from pot
Mafak2020: doesn't show hand 
*** SUMMARY ***
Total pot 1200 | Rake 66 
Board [Ad 6d Js]
Seat 1: color_singleton folded before Flop (didn't bet)
Seat 2: dhduncan folded before Flop (didn't bet)
Seat 3: PokerStarMan123 folded on the Flop
Seat 6: juiceC2 (button) folded on the Flop
Seat 7: Mafak2020 (small blind) collected (1134)
Seat 8: HighCardJasper (big blind) folded on the Flop



PokerStars Home Game Hand #225610527901: {DaPokaStars}  Hold'em No Limit (50/100) - 2021/04/07 18:30:52 ET
Table 'agian and again' 9-max (Play Money) Seat #7 is the button
Seat 1: color_singleton (36993 in chips) 
Seat 2: dhduncan (12434 in chips) 
Seat 3: PokerStarMan123 (10495 in chips) 
Seat 6: juiceC2 (21858 in chips) 
Seat 7: Mafak2020 (61101 in chips) 
Seat 8: HighCardJasper (3436 in chips) 
HighCardJasper: posts small blind 50
color_singleton: posts big blind 100
*** HOLE CARDS ***
Dealt to PokerStarMan123 [9h 7c]
dhduncan: calls 100
PokerStarMan123: calls 100
juiceC2: calls 100
Mafak2020: calls 100
HighCardJasper: calls 50
color_singleton: checks 
*** FLOP *** [Qc 4d Qd]
HighCardJasper: checks 
color_singleton: bets 567
dhduncan: folds 
PokerStarMan123: folds 
juiceC2: folds 
Mafak2020 has timed out
Mafak2020: folds 
HighCardJasper: folds 
Uncalled bet (567) returned to color_singleton
color_singleton collected 567 from pot
color_singleton: doesn't show hand 
*** SUMMARY ***
Total pot 600 | Rake 33 
Board [Qc 4d Qd]
Seat 1: color_singleton (big blind) collected (567)
Seat 2: dhduncan folded on the Flop
Seat 3: PokerStarMan123 folded on the Flop
Seat 6: juiceC2 folded on the Flop
Seat 7: Mafak2020 (button) folded on the Flop
Seat 8: HighCardJasper (small blind) folded on the Flop



PokerStars Home Game Hand #225610550873: {DaPokaStars}  Hold'em No Limit (50/100) - 2021/04/07 18:31:37 ET
Table 'agian and again' 9-max (Play Money) Seat #8 is the button
Seat 1: color_singleton (37460 in chips) 
Seat 2: dhduncan (12334 in chips) 
Seat 3: PokerStarMan123 (10395 in chips) 
Seat 6: juiceC2 (21758 in chips) 
Seat 7: Mafak2020 (61001 in chips) 
Seat 8: HighCardJasper (3336 in chips) 
color_singleton: posts small blind 50
dhduncan: posts big blind 100
*** HOLE CARDS ***
Dealt to PokerStarMan123 [7s 5h]
PokerStarMan123: folds 
juiceC2: calls 100
Mafak2020: folds 
HighCardJasper: calls 100
color_singleton: calls 50
dhduncan: checks 
*** FLOP *** [5c 4s 3d]
color_singleton: bets 189
dhduncan: calls 189
juiceC2: calls 189
HighCardJasper: calls 189
*** TURN *** [5c 4s 3d] [2c]
color_singleton: bets 546
dhduncan: calls 546
juiceC2: calls 546
HighCardJasper: folds 
*** RIVER *** [5c 4s 3d 2c] [2s]
color_singleton: bets 1320
dhduncan: folds 
juiceC2: folds 
Uncalled bet (1320) returned to color_singleton
color_singleton collected 2640 from pot
color_singleton: doesn't show hand 
*** SUMMARY ***
Total pot 2794 | Rake 154 
Board [5c 4s 3d 2c 2s]
Seat 1: color_singleton (small blind) collected (2640)
Seat 2: dhduncan (big blind) folded on the River
Seat 3: PokerStarMan123 folded before Flop (didn't bet)
Seat 6: juiceC2 folded on the River
Seat 7: Mafak2020 folded before Flop (didn't bet)
Seat 8: HighCardJasper (button) folded on the Turn



